う ん こ	う ん こ
じ ゅ ひ	じ ゅ ひ
ふ じ ょ	ふ じ ょ
ず の う	ず の う
ふ ゆ う	ふ ゆ う
か と う	か と う
う と い	う と い
と ん ま	と ん ま
あ か い	あ か い
あ け ち	あ け ち
そ う き	そ う き
き よ う	き よ う
ま ね る	ま ね る
び せ い	び せ い
ひ っ し	ひ っ し
き の う	き の う
い わ お	い わ お
し ふ う	し ふ う
め い し	め い し
み ゃ く	み ゃ く
え ん ご	え ん ご
き え ん	き え ん
き ろ う	き ろ う
ど う か	ど う か
い て ん	い て ん
え ん し	え ん し
し い な	し い な
と し ゅ	と し ゅ
う え き	う え き
そ う み	そ う み
め い よ	め い よ
か き ょ	か き ょ
よ う り	よ う り
お そ う	お そ う
い ち い	い ち い
ど と う	ど と う
し い れ	し い れ
い だ い	い だ い
に お う	に お う
じ ゃ け	じ ゃ け
よ そ う	よ そ う
ご ほ う	ご ほ う
さ ど う	さ ど う
げ ど う	げ ど う
ご う ん	ご う ん
か い ん	か い ん
き ほ う	き ほ う
し ょ く	し ょ く
へ い か	へ い か
と う ど	と う ど
し め い	し め い
げ い ご	げ い ご
お ん ぶ	お ん ぶ
お さ え	お さ え
ぎ い ん	ぎ い ん
せ い ぎ	せ い ぎ
だ ん な	だ ん な
あ ら い	あ ら い
も う す	も う す
も う し	も う し
わ そ う	わ そ う
ほ ん ま	ほ ん ま
こ う こ	こ う こ
ひ う ん	ひ う ん
い は ん	い は ん
し ゅ と	し ゅ と
め い ろ	め い ろ
く ろ う	く ろ う
れ い ど	れ い ど
ろ う と	ろ う と
か じ ょ	か じ ょ
あ お ぐ	あ お ぐ
そ せ い	そ せ い
か じ ゅ	か じ ゅ
と お す	と お す
ほ う こ	ほ う こ
よ せ い	よ せ い
お い て	お い て
い と い	い と い
と う や	と う や
い っ こ	い っ こ
と お る	と お る
う す い	う す い
こ う ざ	こ う ざ
て い し	て い し
あ お き	あ お き
こ て い	こ て い
て い ぎ	て い ぎ
お ん そ	お ん そ
し じ ょ	し じ ょ
つ う わ	つ う わ
や ろ う	や ろ う
さ こ う	さ こ う
き ど う	き ど う
こ う ふ	こ う ふ
あ お ば	あ お ば
つ う ろ	つ う ろ
と う ぶ	と う ぶ
こ ん い	こ ん い
じ ん い	じ ん い
ぼ う ど	ぼ う ど
ろ そ う	ろ そ う
に ん む	に ん む
げ こ う	げ こ う
て ん い	て ん い
ひ ゃ く	ひ ゃ く
ぎ ゃ ふ	ぎ ゃ ふ
こ し ょ	こ し ょ
ろ て い	ろ て い
よ う ぐ	よ う ぐ
ど う ぎ	ど う ぎ
か ん い	か ん い
ゆ え ん	ゆ え ん
ど う き	ど う き
か し ょ	か し ょ
む つ う	む つ う
へ い し	へ い し
ほ ろ う	ほ ろ う
ほ へ い	ほ へ い
ほ う か	ほ う か
ど あ い	ど あ い
せ い ぶ	せ い ぶ
が ご う	が ご う
ぴ え ん	ぴ え ん
ふ と う	ふ と う
ら い う	ら い う
あ い ぼ	あ い ぼ
こ お り	こ お り
ふ う ど	ふ う ど
ほ う が	ほ う が
ら て い	ら て い
う お ざ	う お ざ
そ う ぎ	そ う ぎ
れ い じ	れ い じ
し へ い	し へ い
い ん ぶ	い ん ぶ
わ め い	わ め い
ほ う ひ	ほ う ひ
ひ い き	ひ い き
き ぐ う	き ぐ う
ね う お	ね う お
り ゆ う	り ゆ う
ゆ う ぎ	ゆ う ぎ
き ょ か	き ょ か
じ し ょ	じ し ょ
い せ ん	い せ ん
ひ ど う	ひ ど う
は ろ う	は ろ う
そ う わ	そ う わ
す く う	す く う
だ と う	だ と う
ゆ う が	ゆ う が
か て い	か て い
お そ い	お そ い
し ゅ ぎ	し ゅ ぎ
そ う び	そ う び
ぞ う き	ぞ う き
こ め い	こ め い
し せ い	し せ い
よ め い	よ め い
む の う	む の う
あ え ぐ	あ え ぐ
し ゅ ゆ	し ゅ ゆ
ろ う か	ろ う か
と お で	と お で
こ う じ	こ う じ
ま ん ま	ま ん ま
ぶ ど う	ぶ ど う
ふ う き	ふ う き
て い じ	て い じ
じ ゃ び	じ ゃ び
れ い し	れ い し
ち じ ょ	ち じ ょ
せ い や	せ い や
ほ ぜ い	ほ ぜ い
こ ち ゃ	こ ち ゃ
り け い	り け い
ぎ ん み	ぎ ん み
ば あ い	ば あ い
と そ う	と そ う
ひ へ い	ひ へ い
ご お ん	ご お ん
じ ゅ ふ	じ ゅ ふ
ぼ う し	ぼ う し
ご う ぎ	ご う ぎ
か し ゃ	か し ゃ
ほ す う	ほ す う
こ い ん	こ い ん
よ け い	よ け い
お え る	お え る
れ っ し	れ っ し
き ご う	き ご う
え ら い	え ら い
よ う び	よ う び
じ ょ し	じ ょ し
い ら い	い ら い
ふ ほ う	ふ ほ う
い あ つ	い あ つ
お も う	お も う
し ゅ び	し ゅ び
ろ う し	ろ う し
お そ ん	お そ ん
も し ゅ	も し ゅ
は せ い	は せ い
ほ う り	ほ う り
し し ょ	し し ょ
む こ う	む こ う
じ ゅ よ	じ ゅ よ
の う か	の う か
び お ん	び お ん
ど う も	ど う も
し ゃ く	し ゃ く
ほ せ い	ほ せ い
こ う き	こ う き
あ へ ん	あ へ ん
こ ふ う	こ ふ う
で あ う	で あ う
ふ け い	ふ け い
と こ う	と こ う
さ よ う	さ よ う
ご う ご	ご う ご
ゆ う し	ゆ う し
よ う そ	よ う そ
き す う	き す う
あ ん た	あ ん た
て っ さ	て っ さ
ほ し い	ほ し い
あ お さ	あ お さ
じ ゅ そ	じ ゅ そ
び こ う	び こ う
ま て い	ま て い
ず あ ん	ず あ ん
こ う や	こ う や
う ま い	う ま い
め の う	め の う
き ぼ う	き ぼ う
き じ ょ	き じ ょ
な ん い	な ん い
と う き	と う き
く る う	く る う
の う ふ	の う ふ
あ ま い	あ ま い
え ん か	え ん か
ご ざ	ご ざ
ゆ う や	ゆ う や
こ せ い	こ せ い
じ ろ う	じ ろ う
た う え	た う え
ほ か	ほ か
な る	な る
へ そ	へ そ
ゆ ず	ゆ ず
か す	か す
ぼ つ	ぼ つ
ね つ	ね つ
ど う し	ど う し
と こ	と こ
わ き	わ き
み け	み け
こ ぐ	こ ぐ
き ら	き ら
け る	け る
み と	み と
け が	け が
さ と	さ と
ひ も	ひ も
く ま	く ま
べ っ し	べ っ し
あ ん こ	あ ん こ
ど こ う	ど こ う
ど べ い	ど べ い
う ろ ん	う ろ ん
り ん ね	り ん ね
ぎ お ん	ぎ お ん
ゆ う ど	ゆ う ど
か せ い	か せ い
す も う	す も う
せ い り	せ い り
ふ ご う	ふ ご う
り ゃ く	り ゃ く
し き ょ	し き ょ
ざ ほ う	ざ ほ う
れ い む	れ い む
よ う こ	よ う こ
い た ん	い た ん
ば ん め	ば ん め
ご う じ	ご う じ
さ ん ま	さ ん ま
ど う ぐ	ど う ぐ
あ お る	あ お る
ほ う き	ほ う き
ぞ う ご	ぞ う ご
よ う じ	よ う じ
ひ ぼ う	ひ ぼ う
そ す う	そ す う
く ふ う	く ふ う
む そ う	む そ う
じ ゃ ま	じ ゃ ま
ば せ い	ば せ い
ど う せ	ど う せ
ち ほ う	ち ほ う
し ど う	し ど う
し ゃ み	し ゃ み
ひ ろ お	ひ ろ お
ふ し ゃ	ふ し ゃ
ぎ め い	ぎ め い
か ん な	か ん な
け い か	け い か
あ ん ず	あ ん ず
き れ い	き れ い
せ い し	せ い し
え が お	え が お
ふ え ん	ふ え ん
と け い	と け い
そ う ち	そ う ち
ず ろ う	ず ろ う
ぐ せ い	ぐ せ い
か へ い	か へ い
ゆ う わ	ゆ う わ
い か ん	い か ん
し ょ す	し ょ す
し ょ き	し ょ き
あ そ ん	あ そ ん
い け ん	い け ん
よ う か	よ う か
せ い ぐ	せ い ぐ
う こ ん	う こ ん
ば し ょ	ば し ょ
め い が	め い が
せ い じ	せ い じ
に お い	に お い
つ ご う	つ ご う
あ い ぶ	あ い ぶ
く ど う	く ど う
が ろ う	が ろ う
か い い	か い い
え ん そ	え ん そ
び よ う	び よ う
み あ い	み あ い
あ い な	あ い な
は ん い	は ん い
か の う	か の う
い わ い	い わ い
こ う ご	こ う ご
か ろ う	か ろ う
お ま え	お ま え
こ う ぎ	こ う ぎ
よ ぼ う	よ ぼ う
い し ん	い し ん
き ょ く	き ょ く
ね ぼ う	ね ぼ う
た こ う	た こ う
し ゅ ひ	し ゅ ひ
ゆ せ い	ゆ せ い
こ う ら	こ う ら
け い こ	け い こ
ふ せ い	ふ せ い
あ え る	あ え る
こ ぞ う	こ ぞ う
ぎ ゃ く	ぎ ゃ く
み て い	み て い
く と う	く と う
つ う か	つ う か
う た う	う た う
じ ゃ く	じ ゃ く
え ん ど	え ん ど
ご よ う	ご よ う
も う こ	も う こ
ふ う か	ふ う か
と う は	と う は
え ぐ い	え ぐ い
ぞ う に	ぞ う に
だ し ゃ	だ し ゃ
と う た	と う た
や お い	や お い
ふ め い	ふ め い
せ い ち	せ い ち
あ い よ	あ い よ
あ ら う	あ ら う
ど う け	ど う け
ゆ う じ	ゆ う じ
よ ほ う	よ ほ う
ゆ と う	ゆ と う
あ い ご	あ い ご
ご へ い	ご へ い
い ぜ ん	い ぜ ん
お し い	お し い
ほ て い	ほ て い
た ん の う	た ん の う
き ゅ う じ	き ゅ う じ
ど き ょ う	ど き ょ う
し ょ い ん	し ょ い ん
ら ん お う	ら ん お う
り ゅ う か	り ゅ う か
じ ょ う り	じ ょ う り
よ っ し ゃ	よ っ し ゃ
じ ょ そ う	じ ょ そ う
わ ぎ ゅ う	わ ぎ ゅ う
と う そ う	と う そ う
れ い て い	れ い て い
に ゅ う ぶ	に ゅ う ぶ
に っ す う	に っ す う
き ゅ う り	き ゅ う り
ち り ょ う	ち り ょ う
せ い そ う	せ い そ う
と う ご う	と う ご う
く う こ う	く う こ う
き ょ う と	き ょ う と
ふ ひ ょ う	ふ ひ ょ う
こ ひ ょ う	こ ひ ょ う
し ょ う ぶ	し ょ う ぶ
じ ょ う き	じ ょ う き
し し ょ う	し し ょ う
し ょ き ゅ う	し ょ き ゅ う
ぎ ょ う こ う	ぎ ょ う こ う
し ょ う ぼ う	し ょ う ぼ う
の う じ ょ う	の う じ ょ う
ぼ う ち ょ う	ぼ う ち ょ う
せ い し ゅ う	せ い し ゅ う
し ょ う ど う	し ょ う ど う
ち ゅ う ち ょ	ち ゅ う ち ょ
き ょ う そ う	き ょ う そ う
り っ し ゅ う	り っ し ゅ う
り ょ う し ゃ	り ょ う し ゃ
し ゅ っ し ゃ	し ゅ っ し ゃ
み ょ う が	み ょ う が
よ う じ ょ う	よ う じ ょ う
き ゅ う け い	き ゅ う け い
そ う に ょ う	そ う に ょ う
の う し ょ う	の う し ょ う
こ う り ょ う	こ う り ょ う
り ゅ う お ん	り ゅ う お ん
き ゅ う ご う	き ゅ う ご う
し ょ う よ う	し ょ う よ う
ど う し ょ う	ど う し ょ う
ど う よ う	ど う よ う
は っ し ゃ	は っ し ゃ
せ ん も う	せ ん も う
す う け い	す う け い
い い あ う	い い あ う
あ ん せ い	あ ん せ い
ど う せ い	ど う せ い
は っ せ い	は っ せ い
き ょ と う	き ょ と う
じ ょ う ら	じ ょ う ら
と う い ん	と う い ん
け い と う	け い と う
え ん ま ん	え ん ま ん
し ょ う み	し ょ み
じ ゅ う じ	じ ゅ う じ
こ ち ょ う	こ ち ょ う
こ う ご う	こ う ご う
あ ん し ょ	あ ん し ょ
ぎ じ ょ う	ぎ じ ょ う
ど う こ う	ど う こ う
じ ょ ゆ う	じ ょ ゆ う
ど じ ょ う	ど じ ょ う
ゆ う の う	ゆ う の う
か っ せ い	か っ せ い
し ゅ と う	し ゅ と う
ほ う ぎ ょ	ほ う ぎ ょ
へ い そ う	へ い そ う
じ ょ う と	じ ょ う と
ま ん え い	ま ん え い
し ゅ こ う	し ゅ こ う
り ょ う し	り ょ う し
が ち ょ う	が ち ょ う
れ い ち ゃ	れ い ち ゃ
う ん で い	う ん で い
ひ き ょ う	ひ き ょ う
じ ん め い	じ ん め い
し ゅ う き	し ゅ う き
ち ょ う ふ	ち ょ う ふ
よ ん じ ゅ う	よ そ
こ き ゅ う	こ き ゅ う
ひ ょ う か	ひ ょ う か
ど う い う	ど う い う
え ん じ ょ	え ん じ ょ
こ う め い	こ う め い
ご う て い	ご う て い
あ ん ま ん	あ ん ま ん
か に ゅ う	か に ゅ う
か し ょ う	か し ょ う
い ん け い	い ん け い
じ ょ う こ	じ ょ う こ
ち ゅ う せ い	ち ゅ う せ い
そ う び ょ う	そ う び ょ う
く う ち ゅ う	く う ち ゅ う
き ょ に ゅ う	き ょ に ゅ う
お ん き ょ う	お ん き ょ う
き ょ う ほ う	き ょ う ほ う
さ っ し ょ う	さ っ し ょ う
れ い き ゅ う	れ い き ゅ う
じ ょ う せ い	じ ょ う せ い
し ゅ う い ん	し ゅ う い ん
ほ う ぎ ゅ う	ほ う ぎ ゅ う
て い き ゅ う	て い き ゅ う
し ょ う と う	し ょ う と う
し ゃ き ょ う	し ゃ き ょ う
じ ょ う い ん	じ ょ う い ん
き ょ う よ う	き ょ う よ う
ゆ う じ ょ う	ゆ う じ ょ う
す う り ょ う	す う り ょ う
に ゅ う こ う	に ゅ う こ う
じ ゅ し ょ う	じ ゅ し ょ う
あ い じ ょ う	あ い じ ょ う
き ゅ う の う	き ゅ う の う
じ ゅ う ど う	じ ゅ う ど う
じ ょ う お ん	じ ょ う お ん
し ょ う め い	し ょ う め い
し ょ う じ ゅ う	し ょ う じ ゅ う
し ゅ う し ょ う	し ゅ う し ょ う
ぎ ょ う し ゅ う	ぎ ょ う し ゅ う
し ゅ う ち ゅ う	し ゅ う ち ゅ う
き ょ う し ょ う	き ょ う し ょ う
き ょ う ち ょ う	き ょ う ち ょ う
き ゅ う し ょ う	き ゅ う し ょ う
じ ゅ う き ゅ う	じ ゅ う き ゅ う
し ゅ う し ゅ う	し ゅ う し ゅ う
じ ょ う ち ゅ う	じ ょ う ち ゅ う
ち ょ う に ゅ う	ち ょ う に ゅ う
し ょ う し ょ う	し ょ う し ょ う
き ょ う ど う	き ょ う ど う
き ょ う ぼ う	き ょ う ぼ う
き ゅ う そ う	き ゅ う そ う
ど う じ ょ う	ど う じ ょ う
び ょ う め い	び ょ う め い
ほ う じ ょ う	ほ う じ ょ う
き ょ う し ゃ	き ょ う し ゃ
き ゅ う へ い	き ゅ う へ い
け い じ ょ う	け い じ ょ う
こ う き ゅ う	こ う き ゅ う
け っ し ょ う	け っ し ょ う
つ う ち ょ う	つ う ち ょ う
じ ゅ う え ん	じ ゅ う え ん
て い じ ゅ う	て い じ ゅ う
し ょ う す う	し ょ う す う
せ っ し ょ う	せ っ し ょ う
に ゅ う せ い	に ゅ う せ い
じ ゅ き ょ う	じ ゅ き ょ う
よ う し ょ う	よ う し ょ う
ち ゅ う と う	ち ゅ う と う
へ い じ ょ う	へ い じ ょ う
ち ょ う れ い	ち ょ う れ い
し ゅ う め い	し ゅ う め い
ど う み ょ う	ど う み ょ う
の う に ゅ う	の う に ゅ う
じ ょ う し ゃ	じ ょ う し ゃ
ほ う し ゅ う	ほ う し ゅ う
ち ょ う し ょ	ち ょ う し ょ
ふ う ひ ょ う	ふ う ひ ょ う
ぞ う し ょ う	ぞ う し ょ う
め い し ょ う	め い し ょ う
せ い び ょ う	せ い び ょ う
ま っ し ょ う	ま っ し ょ う
び ょ う ど う	び ょ う ど う
り ゅ う ど う	り ゅ う ど う
あ い し ゅ う	あ い し ゅ う
ろ う き ゅ う	ろ う き ゅ う
ほ う き ょ う	ほ う き ょ う
こ う し ょ う	こ う し ょ う
と う じ ょ う	と う じ ょ う
し ょ う じ ょ	し ょ う じ ょ
え ん し ゅ う	え ん し ゅ う
こ う ぎ ょ う	こ う ぎ ょ う
き ょ う じ ゅ	き ょ う じ ゅ
ほ う ち ょ う	ほ う ち ょ う
じ ゅ う よ う	じ ゅ う よ う
じ ゅ み ょ う	じ ゅ み ょ う
め い り ょ う	め い り ょ う
り ょ う が	り ょ う が
き ょ う え ん	き ょ う え ん
い っ ぴ ょ う	い っ ぴ ょ う
ほ う ち ゅ う	ほ う ち ゅ う
ど う り ょ う	ど う り ょ う
し ょ う こ う	し ょ う こ う
ゆ う し ゅ う	ゆ う し ゅ う
よ う ち ょ う	よ う ち ょ う
れ い ち ょ う	れ い ち ょ う
け い り ゅ う	け い り ゅ う
じ ゅ に ゅ う	じ ゅ に ゅ う
ぎ ゅ う し ゃ	ぎ ゅ う し ゃ
ご ち ょ う	ご ち ょ う
び ょ う じ	び ょ う じ
び ょ う き	び ょ う き
い っ さ い	い っ さ い
せ い て い	せ い て い
た き ょ う	た き ょ う
と う け い	と う け い
ち ょ う ぼ	ち ょ う ぼ
も う え ん	も う え ん
じ ち ょ う	じ ち ょ う
せ ん め い	せ ん め い
こ う ど う	こ う ど う
と う し ゅ	と う し ゅ
ぼ う ろ う	ぼ う ろ う
ひ き ゅ う	ひ き ゅ う
か き ゅ う	か き ゅ う
に ゅ う か	に ゅ う か
く き ょ う	く き ょ う
ぜ ん も う	ぜ ん も う
ほ う じ ょ	ほ う じ ょ
そ う め い	そ う め い
し ょ う こ	し ょ う こ
そ う ぐ う	そ う ぐ う
か じ ゅ う	か じ ゅ う
え ん え ん	え ん え ん
ぜ ん え い	ぜ ん え い
お お う そ	お お う そ
び っ し ゅ	び っ し ゅ
ほ う て い	ほ う て い
け い こ う	け い こ う
い っ と う	い っ と う
せ い ゆ う	せ い ゆ う
し ょ う ふ	し ょ う ふ
ふ し ょ う	ふ し ょ う
ほ う そ う	ほ う そ う
え っ と う	え っ と う
せ い れ い	せ い れ い
ほ う と う	ほ う と う
ほ う の う	ほ う の う
あ ん こ う	あ ん こ う
ま し ょ う	ま し ょ う
こ う い う	こ う い う
し し ゅ う	し し ゅ う
ひ ち ょ う	ひ ち ょ う
の う よ う	の う よ う
こ う し ゅ	こ う し ゅ
お っ さ ん	お っ さ ん
し ゅ ほ う	し ゅ ほ う
お っ く う	お っ く う
ち ゅ う さ	ち ゅ う さ
と う き ょ	と う き ょ
に ゅ う ひ	に ゅ う ひ
に ゅ う こ	に ゅ う こ
と う し ゃ	と う し ゃ
め い れ い	め い れ い
め い そ う	め い そ う
こ う え ん	こ う え ん
け ん め い	け ん め い
お い し い	お い し い
へ い し ゃ	へ い し ゃ
り ゅ う め	り ゅ う め
ぼ う ゆ う	ぼ う ゆ う
き ょ う じ	き ょ う じ
ち ゅ う ひ	ち ゅ う ひ
し ゅ う そ	し ゅ う そ
じ ゆ う	じ ゆ う
そ そ う	そ そ う
わ し ょ	わ し ょ
と お く	と お く
ろ う ば	ろ う ば
り よ う	り よ う
じ じ ょ	じ じ ょ
あ つ い	あ つ い
じ ゅ い ん	じ ゅ い ん
ま に ゅ う	ま に ゅ う
ち ょ う り	ち ょ う り
ふ う ろ う	ふ う ろ う
く ぎ ょ う	く ぎ ょ う
む き ゅ う	む き ゅ う
お お ぐ い	お お ぐ い
お じ ゃ ん	お じ ゃ ん
ら し ゅ う	ら し ゅ う
ゆ う せ い	ゆ う せ い
つ う こ う	つ う こ う
そ う せ い	そ う せ い
じ ゅ う に	じ ゅ う に
す う す う	す う す う
れ い せ い	れ い せ い
え ん な い	え ん な い
こ う く う	こ う く う
ほ ん の う	ほ ん の う
そ う と う	そ う と う
ゆ う そ う	ゆ う そ う
あ ん の ん	あ ん の ん
ぎ ょ う し	ぎ ょ う し
ほ う よ う	ほ う よ う
べ っ そ う	べ っ そ う
よ う ふ う	よ う ふ う
ご き ょ う	ご き ょ う
そ う こ う	そ う こ う
じ ょ う じ	じ ょ う じ
ぎ ょ う ぎ	ぎ ょ う ぎ
せ ん の う	せ ん の う
か ぎ ゅ う	か ぎ ゅ う
ゆ う す う	ゆ う す う
と う ほ う	と う ほ う
よ ち ょ う	よ ち ょ う
し ょ う そ	し ょ う そ
び ょ う ぶ	び ょ う ぶ
は っ そ う	は っ そ う
そ う い う	そ う い う
と う て い	と う て い
ゆ う ゆ う	ゆ う ゆ う
て ん も う	て ん も う
ろ う し ゃ	ろ う し ゃ
よ う よ う	よ う よ う
い ん せ い	い ん せ い
じ き ょ う	じ き ょ う
せ い と う	せ い と う
ぼ う こ う	ぼ う こ う
と う と う	と う と う
ろ う ほ う	ろ う ほ う
ぞ う し ょ	ぞ う し ょ
じ ょ て い	じ ょ て い
て っ せ い	て っ せ い
ぎ ょ う ざ	ぎ ょ う ざ
し ゃ せ い	し ゃ せ い
じ じ ょ う	じ じ ょ う
お う す い	お う す い
し ゃ ど う	し ゃ ど う
き ゅ う ぼ	き ゅ う ぼ
そ う し ゅ	そ う し ゅ
り ゅ う じ	り ゅ う じ
し ょ ぐ う	し ょ ぐ う
と う げ い	と う げ い
こ う り ょ	こ う り ょ
ゆ う と う	ゆ う と う
き ゅ う よ	き ゅ う よ
も う し ゃ	も う し ゃ
ぜ い せ い	ぜ い せ い
り ょ う り	り ょ う り
き ょ せ い	き ょ せ い
り ゅ う し	り ゅ う し
ち ょ う ど	ち ょ う ど
す う せ い	す う せ い
と う お ん	と う お ん
よ う ぎ ょ	よ う ぎ ょ
し ょ う が	し ょ う が
て い ぼ う	て い ぼ う
ご う ほ う	ご う ほ う
し ょ う り	し ょ う り
き ゅ う ご	き ゅ う ご
え ん ぺ い	え ん ぺ い
し ゅ え ん	し ゅ え ん
し ゃ て い	し ゃ て い
こ う う ん	こ う う ん
じ ょ う わ	じ ょ う わ
ご ぎ ゅ う	ご ぎ ゅ う
け い め い	け い め い
よ う せ い	よ う せ い
あ い ぞ う	あ い ぞ う
お う れ ん	お う れ ん
き ょ う む	き ょ う む
ぎ ょ も う	ぎ ょ も う
ど う と う	ど う と う
ひ ょ う ご	ひ ょ う ご
じ ゅ う ど	じ ゅ う ど
い ん じ ゃ	い ん じ ゃ
じ ょ す う	じ ょ す う
ほ う せ い	ほ う せ い
へ ん め い	へ ん め い
へ い あ ん	へ い あ ん
し ゅ ぞ う	し ゅ ぞ う
ば に ゅ う	ば に ゅ う
り し ゅ う	り し ゅ う
じ ょ う ろ	じ ょ う ろ
し ゅ よ う	し ゅ よ う
り ゅ う は	り ゅ う は
こ う せ い	こ う せ い
お う て ん	お う て ん
も う と う	も う と う
じ び ょ う	じ び ょ う
め し	め し
ぐ う ぐ う	ぐ う ぐ う
ぼ う ぎ ょ	ぼ う ぎ ょ
が り ょ う	が り ょ う
ひ っ し ゃ	ひ っ し ゃ
ほ う ゆ う	ほ う ゆ う
て じ ょ う	て じ ょ う
き ゅ う ひ	き ゅ う ひ
く じ ゅ う	く じ ゅ う
と う よ う	と う よ う
ざ ひ ょ う	ざ ひ ょ う
と う あ ん	と う あ ん
ぼ け	ぼ け
す き	す き
し な	し な
ふ つ	ふ つ
ぐ り	ぐ り
ひ な	ひ な
ぶ ゆ	ぶ ゆ
も し	も し
げ き	げ き
ま め	ま め
ち り	ち り
ふ た	ふ た
な ど	な ど
く も	く も
か が	か げ
き す	き す
け り	け り
ぬ か	ぬ か
さ よ	さ よ
た け	た け
け た	け た
た つ	た つ
く ず	く ず
ぎ し	ぎ し
ね る	ね る
り つ	り つ
や け	や け
へ や	へ や
や む	や む
び わ	び わ
こ ら	こ ら
よ す	よ す
ど く	ど く
す ず	す ず
く ぎ	く ぎ
つ か	つ か
さ ば	さ ば
さ さ	さ さ
ら ち	ら ち
そ し	そ し
む す	む す
つ つ	つ つ
ご ま	ご ま
ぜ ひ	ぜ ひ
な か	な か
く ろ	く ろ
こ じ	こ じ
み そ	み そ
み ち	み ち
す じ	す じ
か と	か と
ば ね	ば ね
わ せ	わ せ
は て	は て
よ き	よ き
は る	は る
く き	く き
も つ	も つ
さ ぞ	さ ぞ
か し	か し
な み	な み
で る	で る
へ び	へ び
こ る	こ る
た る	た る
す み	す み
が か	が か
な ら	な ら
と め	と め
ち ご	ち ご
き か	き か
か る	か る
と ら	と ら
わ け	わ け
ほ る	ほ る
す り	す り
ふ か	ふ か
み み	み み
に こ	に こ
ば ば	ば ば
か ぶ	か ぶ
ぼ く	ぼ く
す げ	す げ
は こ	は こ
よ り	よ り
ひ ひ	ひ ひ
か じ	か じ
か の	か の
か ら	か ら
つ く	つ く
ゆ る	ゆ る
そ ば	そ ば
そ く	そ く
し る	し る
み ぎ	み ぎ
と ぐ	と ぐ
た め	た め
く そ	く そ
だ つ	だ つ
ち ず	ち ず
は じ	は じ
き ば	き ば
よ め	よ め
べ ろ	べ ろ
に れ	に れ
と ほ	と ほ
か ね	か ね
さ ぎ	さ ぎ
ち ぶ	ち ぶ
に じ	に じ
と む	と む
の せ	の せ
げ じ	げ じ
に て	に て
せ み	せ み
す す	す す
ば か	ば か
わ に	わ に
み き	み き
よ も	よ も
に せ	に せ
り か	り か
さ ま	さ ま
た て	た て
じ し	じ し
べ そ	べ そ
ま て	ま て
さ わ	さ わ
め ず	め ず
く む	く む
へ り	へ り
わ し	わ し
な た	な た
ぼ し	ぼ し
な べ	な べ
す む	す む
き ね	き ね
の り	の り
し と	し と
ぎ じ	ぎ じ
ら く	ら く
や し	や し
か か	か か
ぎ ふ	ぎ ふ
は ら	は ら
ず る	ず る
し の	し の
も ち	も ち
し ば	し ば
ど の	ど の
よ そ	よ そ
て め	て め
け さ	け さ
と く	と く
こ め	こ め
き と	き と
は か	は か
き し	き し
そ で	そ で
ど こ	ど こ
や こ	や こ
だ す	だ す
し つ	し つ
よ こ	よ こ
さ し	さ し
き が	き が
し く	し く
べ ら	べ ら
ふ ね	ふ ね
つ な	つ な
ど ら	ど ら
さ す	さ す
じ そ	じ そ
む ぎ	む ぎ
さ き	さ き
く げ	く げ
ぬ る	ぬ る
べ し	べ し
な ぜ	な ぜ
ご く	ご く
ほ す	ほ す
わ れ	わ れ
た れ	た れ
つ れ	つ れ
か な	か な
ほ ほ	ほ ほ
は く	は く
り き	り き
わ く	わ く
が き	が き
ま る	ま る
ほ り	ほ り
わ て	わ て
ぬ ぐ	ぬ ぐ
こ く	こ く
く り	く り
じ ぼ	じ ぼ
び く	び く
れ つ	れ つ
す ぐ	す ぐ
ま こ	ま こ
つ る	つ る
よ む	よ む
む く	む く
し ま	し ま
な ま	な ま
つ ゆ	つ ゆ
ご ご	ご ご
り ろ	り ろ
で す	で す
か ゆ	か ゆ
ふ む	ふ む
ゆ か	ゆ か
ふ る	ふ る
む し	む し
け す	け す
は な	は な
ざ く	ざ く
か ぐ	か ぐ
そ れ	そ れ
た こ	た こ
ざ ら	ざ ら
ど や	ど や
な き	な き
と げ	と げ
こ す	こ す
は ぐ	は ぐ
ぼ や	ぼ や
よ ぶ	よ ぶ
も む	も む
ぶ た	ぶ た
な だ	な だ
は で	は で
す そ	す そ
か ぎ	か ぎ
す ぎ	す ぎ
び き	び き
む な	む な
ふ じ	ふ じ
ひ こ	ひ こ
び み	び み
こ し	こ し
む き	む き
か ひ	か ひ
す し	す し
は ぎ	は ぎ
す か	す か
た く	た く
ま く	ま く
ひ き	ひ き
つ が	つ が
か わ	か わ
ひ ら	ひ ら
た み	た み
は め	は め
と す	と す
そ の	そ の
つ ぐ	つ ぐ
な わ	な わ
か ず	か ず
ま ち	ま ち
つ や	つ や
か く	か く
な つ	な つ
よ は	よ は
は と	は と
し に	し に
ふ わ	ふ わ
は つ	は つ
つ ば	つ ば
ひ だ	ひ だ
き よ	き よ
わ ら	わ ら
に る	に る
ち び	ち び
ま か	ま か
か ま	か ま
は げ	は げ
ひ し	ひ し
そ る	そ る
と み	と み
や ぎ	や ぎ
し め	し め
む け	む け
こ む	こ む
ひ ざ	ひ ざ
そ つ	そ つ
や ま	や ま
や る	や る
ゆ ば	ゆ ば
ふ り	ふ り
も さ	も さ
そ ぐ	そ ぐ
つ て	つ て
が し	が し
ま た	ま た
や み	や み
の ど	の ど
み せ	み せ
す る	す る
と り	と り
ご じ	ご じ
き り	き り
と じ	と じ
け ら	け ら
よ ぎ	よ ぎ
や ぐ	や ぐ
ぶ す	ぶ す
と ぶ	と ぶ
て き	て き
も と	も と
め で	め で
わ た	わ た
と ど	と ど
く る	く る
み の	み の
で ば	で ば
こ ひ	こ ひ
み や	み や
ま つ	ま つ
ぐ ち	ぐ ち
ふ ぐ	ふ ぐ
か む	か む
ま け	ま け
か ぜ	か ぜ
も み	も み
だ く	だ く
げ た	げ た
ゆ り	ゆ り
な に	な に
け ど	け ど
く に	く に
に わ	に わ
こ と	こ と
は よ	は よ
な な	な な
べ き	べ き
し み	し み
ひ る	ひ る
ふ け	ふ け
ろ わ	ろ わ
の き	の き
し ふ	し ふ
む だ	む だ
と も	と も
ね こ	ね こ
さ け	さ け
く ど	く ど
む ね	む ね
さ ゆ	さ ゆ
み ろ	み ろ
か み	か み
ら ま	ら ま
せ き	せ き
ち と	ち と
き み	き み
つ め	つ め
さ る	さ る
ゆ き	ゆ き
せ じ	せ じ
ち か	ち か
し む	し む
た だ	た だ
ぎ ざ	ぎ ざ
む ら	む ら
ち め	ち め
か め	か め
ほ ら	ほ ら
と ぎ	と ぎ
し も	し も
た か	た か
が ま	が ま
く わ	く わ
き ざ	き ざ
や く	や く
ご し	ご し
て つ	て つ
れ き	れ き
み な	み な
つ べ	つ べ
ち な	ち な
や ぶ	や ぶ
す な	す な
ひ つ	ひ つ
か ふ	か ふ
は き	は き
は み	は み
と ち	と ち
の る	の る
な す	な す
た ば	た ば
ひ び	ひ び
じ き	じ き
は ね	は ね
が わ	が わ
だ き	だ き
し ぬ	し ぬ
わ る	わ る
か に	か に
く く	く く
は む	は む
す ら	す ら
は た	は た
そ き	そ き
ま で	ま で
か こ	か こ
く じ	く じ
す ね	す ね
も ぐ	も ぐ
き ず	き ず
ひ ご	ひ ご
ご は	ご は
た じ	た じ
ふ よ	ふ よ
か り	か り
の し	の し
た し	た し
ぶ り	ぶ り
ご さ	ご さ
く さ	く さ
や じ	や じ
ま ま	ま ま
が そ	が そ
さ め	さ め
へ た	へ た
て ら	て ら
こ び	こ び
ま き	ま き
よ せ	よ せ
た す	た す
て る	て る
か も	か も
そ ご	そ ご
か ど	か ど
せ め	せ め
こ ま	こ ま
な む	な む
つ ま	つ ま
な し	な し
は し	は し
や ご	や ご
か ご	か ご
ぽ ご	ぽ ご
よ く	よ く
と る	と る
し わ	し わ
の み	の み
た び	た び
ひ ゆ	ひ ゆ
ご ろ	ご ろ
よ み	よ み
そ こ	そ こ
な は	な は
ひ じ	ひ じ
か つ	か つ
だ に	だ に
ほ ど	ほ ど
じ み	じ み
も も	も も
じ ち	じ ち
ど れ	ど れ
は せ	は せ
ゆ げ	ゆ げ
み る	み る
ち る	ち る
ふ ち	ふ ち
き き	き き
さ が	さ が
し ろ	し ろ
へ る	へ る
と ま	と ま
ほ し	ほ し
な く	な く
や に	や に
ば ぐ	ば ぐ
だ れ	だ れ
は や	は や
す い	す い
ち え	ち え
あ な	あ な
う け	う け
あ き	あ き
え り	え り
お る	お る
か う	か う
な い	な い
い こ	い こ み き
は え	は え
ね ん	ね ん
り ん	り ん
ぜ ん	ぜ ん
ど <<unk>>	ど <unk>
と <<unk>>	と <unk>
お の	お の
む <<unk>>	む <unk>
す う	す う
お び	お び
こ い	こ い
い わ	い わ
い ね	い ね
う そ	う そ
は い	は い
お ろ	お ろ
あ ぶ	あ ぶ
ぐ ぁ	ぐ ぁ
た ん	た ん
い ば	い ば
あ ま	あ ま
は ん	は ん
き え	き え
い き	い き
え る	え る
う み	う み
い ご	い ご
だ い	だ い
う す	う す
い ぼ	い ぼ
し お	し お
さ い	さ い
ま え	ま え
い や	い や
い と	い と
う ど	う ど
ほ ぁ	ほ ぁ
よ い	よ い
い け	い け
う ば	う ば
え ま	え ま
い ま	い ま
わ ん	わ ん
い も	い も
め ん	め ん
あ ね	あ ね
こ え	こ え
あ み	あ み
あ に	あ に
い ぎ	い ぎ
あ ご	あ ご
あ だ	あ だ
い み	い み
う ち	う ち
い む	い む
い じ	い じ
こ ん	こ ん
お き	お き
え し	え し
く ぇ	く ぇ
お ば	お ば
あ と	あ と
あ ゆ	あ ゆ
う た	う た
お れ	お れ
あ ら	あ ら
も え	も え
い ざ	い ざ
だ ん	だ ん
あ む	あ む
さ ん	さ ん
な ん	な ん
っ て	っ て
あ さ	あ さ
ん で	ん で
び ん	び ん
あ か	あ か
あ わ	あ わ
う に	う に
く ん	く ん
ご い	ご い
う で	う で
い く	い く
お そ	お そ
え き	え き
き も	き も
が ん	が ん
ぐ <<unk>>	ぐ <unk>
け ん	け ん
な お	な お
せ ん	せ ん
う め	う め
た え	た え
ば ん	ば ん
お り	お り
お く	お く
し ゅ い	し ゅ い
て ん	て ん
き ん	き ん
あ ん な	あ ん な
し ゃ い	し ゃ い
お ん な	お ん な
う ん も	う ん も
ご う い	ご う い
ず い い	ず い い
ま わ り	か い
い せ い	い せ い
ろ う あ	ろ う あ
ほ う い	ほ う い
せ い う	せ い う
あ れ い	あ れ い
あ え ん	あ え ん
お う ど	お う ど
い お ん	い お ん
い し ょ	い し ょ
と え い	と え い
し お う	し お う
こ う い	こ う い
あ お い	あ お い
ぞ う お	ぞ う お
お う じ	お う じ
い し い	い し い
い っ し	い っ し
お う か	お う か
え い よ	え い よ
う じ	う じ
お う ぼ う	お う ぼ う
じ ょ う お う	じ ょ う お う
い っ し ゅ う	い っ し ゅ う
お う こ う	お う こ う
ま さ か り	え つ
い し ゅ う	い し ゅ う
い っ せ い	い っ せ い
え い ほ う	え い ほ う
お う へ い	お う へ い
お う じ ゃ	お う じ ゃ
い っ し ょ	い っ し ょ
え い ぞ う	え い ぞ う
い き ょ う	い き ょ う
い り ょ う	い り ょ う
へ ん	へ ん
い こ み き	い こ み き
ち ゅ う い	ち ゅ う い
こ う え い	こ う え い
う ん め い	う ん め い
い え い え	い え い え
ぼ う え い	ぼ う え い
お お せ	お う せ
あ の う	あ の う
お う せ	お う せ
と お い	と お い
こ う お	こ う お
い ん も	い ん も
え そ	え そ
お じ	お じ
う か	う か
ふ い	ふ い
い し	い し
う さ	う さ
あ て	あ て
も ん	も ん
ざ ん	ざ ん
お や	お や
い つ	い つ
ぎ ん	ぎ ん
い ぬ	い ぬ
い ち	い ち
あ れ	あ れ
え つ	え つ
ふ え	ふ え
え び	え び
あ る	あ る
う る	う る
か お	か お
い ろ	い ろ
ず い	ず い
ぼ ん	ぼ ん
ぐ ん	ぐ ん
う き	う き
あ の	あ の
ほ <<unk>>	ほ ぁ
も い	も い
あ せ	あ せ
い そ	い そ
あ ざ	あ ざ
さ え	さ え
げ ん	げ ん
と ぇ	と ぇ
い た	い た
ぶ ん	ぶ ん
じ ん	じ ん
お け	お け
あ つ	あ つ
お し	お し
わ い	わ い
え さ	え さ
つ え	つ え
と い	と い
お ち	お ち
ふ ん	ふ ん
う り	う り
く ぁ	く ぁ
あ け	あ け
ぽ い	ぽ い
う ら	う ら
あ じ	あ じ
あ く	あ く
け <<unk>>	け <unk>
び ゃ	び ゃ
ひ ぇ	ひ ぇ
と お	え ん
ち ゃ	ち ゃ
ひ ゅ	ひ ゅ
<<unk>> ゅ	び ゅ
じ ぇ	じ ぇ
は ぁ	は ぁ
ゆ う	ゆ う
う ん	う ん
お い	お い
き ゃ	き ゃ
ま あ	ま あ
れ い	れ い
し ゃ	し ゃ
み ょ	み ょ
ふ <<unk>>	ふ <unk>
あ お	あ お
み ゅ	み ゅ
じ ゃ	じ ゃ
<<unk>> ゅ	<unk> ゅ
ほ お	ほ お
う い	う い
ち ょ	ち ょ
っ す	っ す
ぎ ょ	ぎ ょ
ど <<unk>>	ど <unk>
あ ん	あ ん
や あ	や あ
の う	の う
<<unk>> ぇ	<unk> ぇ
え ん	え ん
う え	う え
ぎ ゅ	ぎ ゅ
ぴ ゅ	ぴ ゅ
<<unk>> ょ	び ょ
い う	い う
う <<unk>>	う <unk>
つ <<unk>>	つ <unk>
う ぇ	う ぇ
か た ち	か た ち
ち ゅ う	ち ゅ う
り ゅ う	り ゅ う
ひ ょ う	ひ ょ う
ち ょ う	ち ょ う
き ょ う	き ょ う
き ゅ う	き ゅ う
じ ゅ う	じ ゅ う
し ゅ う	し ゅ う
び ょ う	び ょ う
お お う	お お う
に ゃ	に ゃ
い い え	い い え
と こ ろ	と こ ろ
に ょ う	に ょ う
っ し ゃ	っ し ゃ
り ょ う	り ょ う
じ ょ う	じ ょ う
お お い	お お い
き つ ね あ ざ み	き つ ね あ ざ み
い え	い え
じ ょ	じ ょ
い ん	い ん
あ う	あ う
ね え	ね え
ぞ う	ぞ う
<<unk>> ゃ	び ゃ
お ん	お ん
び ぇ	び ぇ
さ ぁ	さ ぁ
ぴ ぇ	ぴ ぇ
ぎ ゃ	ぎ ゃ
き い	き い
か <<unk>>	か <unk>
ど う	ど う
き ぇ	き ぇ
お え	お え
ぼ う	ぼ う
び ゅ	び ゅ
り ぇ	り ぇ
く う	く う
て い れ	て い れ
で ん ぱ	で ん ぱ
あ が く	あ が く
だ ん ち	だ ん ち
わ い ろ	わ い ろ
た い き	た い き
た え ま	た え ま
あ ら た	あ ら た
お と る	お と る
り ん り	り ん り
こ ご え	こ ご え
て ん ぷ	て ん ぷ
ほ そ い	ほ そ い
お き じ	お き じ
お し や	お し や
い き か	い き か
が っ ぴ	が っ ぴ
た ど ん	た ど ん
で ば ん	で ば ん
さ っ き	さ っ き
う ら み	う ら み
あ か ね	あ か ね
し さ ん	し さ ん
ぜ ん ち	ぜ ん ち
か ん ろ	か ん ろ
う ず ら	う ず ら
あ が る	あ が る
が く い	が く い
と い し	と い し
く さ い	く さ い
ま し お	ま し お
き り ん	き り ん
ず る い	ず る い
か さ ん	か さ ん
き こ ん	き こ ん
こ す い	こ す い
ひ く い	ひ く い
べ ん ざ	べ ん ざ
や せ ん	や せ ん
つ が う	つ が う
け っ か	け っ か
い な む	い な む
つ い か	つ い か
て ん ち	て ん ち
と っ ぱ	と っ ぱ
ち か う	ち か う
そ っ ぽ	そ っ ぽ
あ ず さ	あ ず さ
ふ は い	ふ は い
ゆ る い	ゆ る い
れ ん が	れ ん が
さ ん げ	さ ん げ
ば っ か	ば っ か
う づ き	う づ き
ざ ん し	ざ ん し
に ん き	に ん き
ぐ ん ぴ	ぐ ん ぴ
き ん じ	き ん じ
ほ ん や	ほ ん や
は い び	は い び
ね ん ざ	ね ん ざ
や ま い	や ま い
し ん ぱ	し ん ぱ
ぜ ん と	ぜ ん と
し ん と	し ん と
い な か	い な か
り ん ぴ	り ん ぴ
い か が	い か が
ま す い	ま す い
わ か い	わ か い
い つ か	い つ か
か ん び	か ん び
う ぷ る	う ぷ る
お ろ す	お ろ す
あ ら す	あ ら す
だ い ぶ	だ い ぶ
じ て ん	じ て ん
じ っ か	じ っ か
む か う	む か う
ち ん ご	ち ん ご
お よ そ	お よ そ
い ま や	い ま や
う め き	う め き
だ か ん	だ か ん
あ ら ら	あ ら ら
や ば い	や ば い
あ ち ら	あ ち ら
と み ん	と み ん
ね ん ぴ	ね ん ぴ
け つ い	け つ い
よ し お	よ し お
さ ん ば	さ ん ば
て あ て	て あ て
い か り	い か り
え も と	え も と
え り か	え り か
て ら う	て ら う
ど だ い	ど だ い
そ い ね	そ い ね
こ ま い	こ ま い
た え ず	た え ず
に る い	に る い
な が い	な が い
あ さ ね	あ さ ね
れ ん ち	れ ん ち
げ っ か	げ っ か
な ん ら	な ん ら
う が つ	う が つ
う げ つ	う げ つ
こ や ま	お や ま
ふ え る	ふ え る
さ む い	さ む い
う ち わ	う ち わ
げ ん き	げ ん き
て っ き	て っ き
こ ん ど	こ ん ど
あ ま み	あ ま み
ち ん ぽ	ち ん ぽ
し せ ん	し せ ん
か い そ	か い そ
き ん こ	き ん こ
げ ん ぎ	げ ん ぎ
お も り	お も り
さ ん ち	さ ん ち
ち あ き	ち あ き
ぎ ろ ん	ぎ ろ ん
ぐ ん て	ぐ ん て
あ て る	あ て る
の ろ い	の ろ い
み う ら	み う ら
う つ ろ	う つ ろ
す ま う	す ま う
か い し	か い し
ま け ん	ま け ん
ふ る い	ふ る い
の ん き	の ん き
さ ら う	さ ら う
だ ん こ	だ ん こ
ぼ っ か	ぼ っ か
い び つ	い び つ
に く い	に く い
あ わ や	あ わ や
た い じ	た い じ
あ な た	あ な た
き ん て	き ん て
り ん ち	り ん ち
は え る	は え る
う ろ こ	う ろ こ
い せ つ	い せ つ
い ろ り	い ろ り
か げ え	か げ え
こ っ ち	こ っ ち
ゆ さ ん	ゆ さ ん
あ と り	あ と り
え ば ら	え ば ら
い つ も	い つ も
は い か	は い か
う ご く	う ご く
ご っ こ	ご っ こ
う わ さ	う わ さ
ふ じ ん	ふ じ ん
あ く ば	あ く ば
に だ い	に だ い
お ど る	お ど る
ま ず い	ま ず い
う き わ	う き わ
ぼ は ん	ぼ は ん
そ が い	そ が い
か い か	か い か
ね お ち	ね お ち
こ が お	こ が お
お め め	お め め
ふ だ ん	ふ だ ん
し た い	し た い
せ っ き	せ っ き
か ば ん	か ば ん
や い ず	や い ず
さ だ お	さ だ お
う ず く	う ず く
は い る	は い る
え び す	え び す
あ ら て	あ ら て
あ か じ	あ か じ
ぐ し ん	ぐ し ん
ぶ ら い	ぶ ら い
み か ん	み か ん
て ん じ	て ん じ
か つ お	か つ お
も っ か	も っ か
せ だ い	せ だ い
の ろ う	の ろ う
お か す	お か す
い と こ	い と こ
お か ね	お か ね
さ い か	さ い か
う り こ	う り こ
つ か い	つ か い
そ ろ う	そ ろ う
ほ か ん	ほ か ん
せ っ ぱ	せ っ ぱ
ろ ん ぱ	ろ ん ぱ
ご つ い	ご つ い
い そ く	い そ く
ず が い	ず が い
よ ろ い	よ ろ い
し ん じ	し ん じ
ぼ ん ご	ぼ ん ご
ろ ん り	ろ ん り
た い し	た い し
め ま い	め ま い
ふ か い	ふ か い
か げ ん	か げ ん
い く つ	い く つ
か な う	か な う
き く ん	き く ん
つ ど う	つ ど う
さ さ い	さ さ い
き え る	き え る
り っ ぱ	り っ ぱ
む ろ ん	む ろ ん
か っ け	か っ け
や す い	や す い
い び く	い び く
ひ た ん	ひ た ん
じ め ん	じ め ん
ま ん じ	ま ん じ
ふ り ん	ふ り ん
た さ い	た さ い
さ な え	さ な え
た ん ら	た ん ら
い っ ぺ ん	い っ ぺ ん
せ ん こ う	せ ん こ う
せ い さ ん	せ い さ ん
え ん だ い	え ん だ い
こ う に ん	こ う に ん
し ゅ ざ ん	し ゅ ざ ん
き ょ て ん	き ょ て ん
こ ん ご う	こ ん ご う
ふ う り ん	ふ う り ん
も の い い	も の い い
へ い ざ ん	へ い ざ ん
ど う て ん	ど う て ん
ご じ ゅ ん	ご じ ゅ ん
ふ う じ ん	ふ う じ ん
け ん き ょ	け ん き ょ
の う み ん	の う み ん
し ょ る い	し ょ る い
ほ う ま ん	ほ う ま ん
も お ん な	も お ん な
よ う か い	よ う か い
ぎ ょ ぐ ん	ぎ ょ ぐ ん
き ょ き ん	き ょ き ん
つ い そ う	つ い そ う
う わ な り	ご さ い
し ょ た い	し ょ た い
ほ ん ね ん	ほ ん ね ん
が ん し ゃ	が ん し ゃ
け っ し ん	け っ し ん
あ い け ん	あ い け ん
せ ん し ゃ	せ ん し ゃ
た い お ん	た い お ん
お う こ く	お う こ く
さ ん ぞ う	さ ん ぞ う
こ う だ い	こ う だ い
ち ょ っ と	ち ょ っ と
し っ そ う	し っ そ う
な い じ ょ	な い じ ょ
か っ せ ん	か っ せ ん
う れ し い	う れ し い
ま ん よ う	ま ん よ う
だ っ こ う	だ っ こ う
ほ う し ん	ほ う し ん
た い ふ う	た い ふ う
が ん ゆ う	が ん ゆ う
の う ひ ん	の う ひ ん
し ん み ん	し ん み ん
せ い い く	せ い い く
な い そ う	な い そ う
め い じ ん	め い じ ん
え ん る い	え ん る い
ち ょ ろ い	ち ょ ろ い
け い か ん	け い か ん
し ゃ だ ん	し ゃ だ ん
ご う け ん	ご う け ん
れ い げ ん	れ い げ ん
せ い け ん	せ い け ん
ぞ う し ん	ぞ う し ん
お は よ う	お は よ う
よ う て ん	よ う て ん
ぐ う げ ん	ぐ う げ ん
え ん え き	え ん え き
じ ゅ な ん	じ ゅ な ん
か ん て い	か ん て い
け ん け い	け ん け い
お お び る	お お び る
じ ょ た い	じ ょ た い
し ゅ た い	し ゅ た い
め い か い	め い か い
あ い が ん	あ い が ん
ば ん ご う	ば ん ご う
よ う き ん	よ う き ん
し ん じ ゅ	し ん じ ゅ
し ょ く い	し ょ く い
て ん し ゅ	て ん し ゅ
え ん ぺ ん	え ん ぺ ん
で ん し ゃ	で ん し ゃ
こ う な い	こ う な い
し ん ぺ い	し ん ぺ い
じ ゅ か ん	じ ゅ か ん
よ う か ん	よ う か ん
た い ぺ い	た い ぺ い
し ん せ い	し ん せ い
あ や う い	あ や う い
げ っ ぺ い	げ っ ぺ い
あ ん た い	あ ん た い
い き お い	い き お い
そ う い や	そ う い や
み ん せ い	み ん せ い
ど ん そ う	ど ん そ う
し ん ち ゃ	し ん ち ゃ
は い い ろ	は い い ろ
つ う し ん	つ う し ん
さ つ え い	さ つ え い
と ん し ゃ	と ん し ゃ
い っ た い	い っ た い
れ い こ ん	れ い こ ん
し ゅ ん き	し ゅ ん き
ゆ う か い	ゆ う か い
あ っ さ く	あ っ さ く
お か し い	お か し い
あ ん な に	あ ん な に
か ん え ん	か ん え ん
ね ん り ょ	ね ん り ょ
め っ ち ゃ	め っ ち ゃ
し ん ご う	し ん ご う
お き ゃ く	お き ゃ く
だ ん ね ん	だ ん ね ん
け い ま い	け い ま い
い っ ぱ い	い っ ぱ い
す い ぼ う	す い ぼ う
お い う つ	お い う つ
よ う へ ん	よ う へ ん
お お が た	お お が た
じ ゅ ん か	じ ゅ ん か
じ ゃ あ く	じ ゃ あ く
せ ん せ い	せ ん せ い
け い ざ い	け い ざ い
れ ん あ い	れ ん あ い
の う ず い	の う ず い
お お き に	お お き に
ば い す う	ば い す う
き ん よ う	き ん よ う
か い そ う	か い そ う
と う ば ん	と う ば ん
せ っ と う	せ っ と う
と う べ ん	と う べ ん
お お で き	お お で き
し ょ く ん	し ょ く ん
へ ん ぼ う	へ ん ぼ う
か ん お ん	か ん お ん
あ し ゅ ら	あ し ゅ ら
お ん い き	お ん い き
こ う ふ ん	こ う ふ ん
こ う ざ い	こ う ざ い
ほ ん こ う	ほ ん こ う
こ う は い	こ う は い
そ う か い	そ う か い
な い て い	な い て い
た い し ゃ	た い し ゃ
と う さ ん	と う さ ん
う れ え る	う れ え る
う る お い	う る お い
れ ん ぎ ょ	れ ん ぎ ょ
あ っ さ り	あ っ さ り
ど う な い	ど う な い
た い ほ う	た い ほ う
と う じ ん	と う じ ん
し ん ね ん	し ん ね ん
か ん こ う	か ん こ う
け い さ い	け い さ い
ど っ き ょ	ど っ き ょ
ま ん え ん	ま ん え ん
の う な い	の う な い
で ん て い	で ん て い
め い ば ん	め い ば ん
ま っ こ う	ま っ こ う
ご っ ち ゃ	ご っ ち ゃ
ほ ん し ょ	ほ ん し ょ
て ん く う	て ん く う
こ う げ ん	こ う げ ん
じ ょ き ん	じ ょ き ん
ち ん し ゃ	ち ん し ゃ
ぼ う ぜ ん	ぼ う ぜ ん
そ う ざ い	そ う ざ い
ぼ う だ い	ぼ う だ い
ほ う め ん	ほ う め ん
あ ん ぜ ん	あ ん ぜ ん
は い き ょ	は い き ょ
せ い い き	せ い い き
あ ん も ち	あ ん も ち
い ん ら ん	い ん ら ん
か ん し ょ	か ん し ょ
ま っ と う	ま っ と う
こ う ざ ん	こ う ざ ん
た い そ う	た い そ う
お お が ま	お お が ま
べ ん じ ょ	べ ん じ ょ
い し ょ く	い し ょ く
せ い し ん	せ い し ん
か い え ん	か い え ん
け っ こ う	け っ こ う
し ゅ さ い	し ゅ さ い
あ い ま い	あ い ま い
ぎ ゅ っ と	ぎ ゅ っ と
お お る り	お お る り
せ い だ ん	せ い だ ん
す い ぞ う	す い ぞ う
お お み ず	お お み ず
れ ん ご う	れ ん ご う
れ い さ い	れ い さ い
ざ い ご う	ざ い ご う
せ い ぞ ん	せ い ぞ ん
け ん も ん	け ん も ん
げ ん こ う	げ ん こ う
か ん い ん	か ん い ん
お も ち ゃ	お も ち ゃ
ざ っ さ ん	ざ っ さ ん
か っ こ う	か っ こ う
て ん な い	て ん な い
い っ ぽ ん	い っ ぽ ん
で ん じ ゅ	で ん じ ゅ
せ い す い	せ い す い
き ょ こ ん	き ょ こ ん
じ ん ど う	じ ん ど う
て っ こ う	て っ こ う
め ん ぜ い	め ん ぜ い
さ ん こ う	さ ん こ う
し ん し ゃ	し ん し ゃ
お っ き い	お っ き い
ら ん し ょ	ら ん し ょ
は い ゆ う	は い ゆ う
ら い こ う	ら い こ う
な い よ う	な い よ う
せ い ね ん	せ い ね ん
だ ん い ん	だ ん い ん
い あ ん ふ	い あ ん ふ
じ っ き	じ っ き
め い ぶ ん	め い ぶ ん
な い し ょ	な い し ょ
じ ょ げ ん	じ ょ げ ん
そ う う け	そ う う け
だ っ ぽ う	だ っ ぽ う
け い り ん	け い り ん
ど う た い	ど う た い
か ん す う	か ん す う
す い と う	す い と う
し ょ ね ん	し ょ ね ん
せ い か い	せ い か い
お お も じ	お お も じ
あ ん ざ ん	あ ん ざ ん
み た い	み た い
え さ し	え さ し
は ん か	は ん か
て ん し	て ん し
じ ろ ん	じ ろ ん
あ た ご	あ た ご
ふ く い	ふ く い
か ん け	か ん け
び で ん	び で ん
ば れ ん	ば れ ん
あ か り	あ か り
わ る い	わ る い
せ ん じ	せ ん じ
ね が い	ね が い
き じ ん	き じ ん
あ き や	あ き や
い さ つ	い さ つ
い て ざ	い て ざ
あ る じ	あ る じ
あ ず き	あ ず き
お へ や	お へ や
が い か	が い か
え ひ め	え ひ め
あ ゆ む	あ ゆ む
お に び	お に び
お わ り	お わ り
し ぜ ん	し ぜ ん
ぶ ん こ	ぶ ん こ
い た で	い た で
そ っ ぱ	そ っ ぱ
ま が ん	ま が ん
ぶ ん ご	ぶ ん ご
あ ば ら	あ ば ら
た ん ぽ	た ん ぽ
ご は ん	ご は ん
ち ん こ	ち ん こ
め う し	め う し
か ん じ	か ん じ
と た ん	と た ん
と ざ ん	と ざ ん
ば け ん	ば け ん
し ん し	し ん し
お き て	お き て
に ほ ん	に ほ ん
あ た し	あ た し
か る い	か る い
か な い	か な い
め っ た	め っ た
ね あ げ	ね あ げ
ら ん ご	ら ん ご
さ い た	さ い た
は か い	は か い
せ ま い	せ ま い
だ し ん	だ し ん
た お す	た お す
あ ぶ ら	あ ぶ ら
か ん ぶ	か ん ぶ
う ま み	う ま み
お と な	お と な
ず っ と	ず っ と
ぴ ん と	ぴ ん と
ぶ ん り	ぶ ん り
ら ん し	ら ん し
こ き ん	こ き ん
こ え る	こ え る
ぼ せ ん	ぼ せ ん
じ か い	じ か い
ま ど う	ま ど う
う て き	う て き
た い こ	た い こ
む か え	む か え
お ど す	お ど す
て ま え	て ま え
そ ん き	そ ん き
た ん す	た ん す
だ い す	だ い す
い の り	い の り
お の れ	お の れ
う し つ	う し つ
ぜ げ ん	ぜ げ ん
ね が お	ね が お
お と め	お と め
て ん ぐ	て ん ぐ
し ば い	し ば い
ね い き	ね い き
ね ら う	ね ら う
い ば ら	い ば ら
せ ん ぷ	せ ん ぷ
す ご い	す ご い
し っ ぽ	し っ ぽ
ば め ん	ば め ん
う け る	う け る
あ く び	あ く び
な ん て	な ん て
よ け ん	よ け ん
ほ っ け	ほ っ け
い れ こ	い れ こ
と し ん	と し ん
あ ら し	あ ら し
あ げ は	あ げ は
い わ く	い わ く
し め ん	し め ん
ふ ん ぼ	ふ ん ぼ
ね ん し	ね ん し
く る い	く る い
て ん き	て ん き
い も り	い も り
い ば る	い ば る
さ え る	さ え る
し は い	し は い
や ら ん	や ら ん
い す ず	い す ず
け ん か	け ん か
は お り	は お り
お く る	お く る
た い か	た い か
れ っ か	れ っ か
あ わ す	あ わ す
わ っ ぱ	わ っ ぱ
う め く	う め く
し ん ろ	し ん ろ
と っ て	と っ て
だ け ん	だ け ん
い ぬ か	い ぬ か
わ さ ん	わ さ ん
こ わ い	こ わ い
な ん か	な ん か
う さ ぎ	う さ ぎ
か い ず	か い ず
め ん か	め ん か
や が い	や が い
お り る	お り る
ふ び ん	ふ び ん
ふ ん ど	ふ ん ど
ぶ ぶ ん	ぶ ぶ ん
か え す	か え す
こ っ か	こ っ か
な ん で	な ん で
は や い	は や い
た い く	た い く
あ や め	あ や め
ぎ ん が	ぎ ん が
お こ す	お こ す
ね む い	ね む い
い ち ぶ	い ち ぶ
み え る	み え る
っ て ば	っ て ば
き ん し	き ん し
か ん ぽ	か ん ぽ
ど ぶ ん	ど ぶ ん
か ず お	か ず お
し ん ら	し ん ら
さ ん ぽ	さ ん ぽ
け は い	け は い
お で こ	お で こ
し げ お	し げ お
ほ ん き	ほ ん き
と き ん	と き ん
い ろ け	い ろ け
い く た	い く た
さ か ん	さ か ん
お か ら	お か ら
や っ き	や っ き
い れ る	い れ る
ひ で ん	ひ で ん
あ ば く	あ ば く
え み こ	え み こ
あ か し	あ か し
ほ た い	ほ た い
ぎ ぐ ん	ぎ ぐ ん
い ち や	い ち や
で か い	で か い
た か い	た か い
う す め	う す め
き ら う	き ら う
め ん し	め ん し
ひ め ん	ひ め ん
べ ん ぴ	べ ん ぴ
み つ お	み つ お
お し り	お し り
そ な え	そ な え
ふ と い	ふ と い
お や じ	お や じ
ぐ た い	ぐ た い
り か ん	り か ん
う め る	う め る
い な ご	い な ご
か ざ い	か ざ い
く ろ い	く ろ い
か す い	か す い
は も ん	は も ん
せ ん ど	せ ん ど
か い さ	か い さ
き だ い	き だ い
な お き	な お き
か た い	か た い
で ん わ	で ん わ
と く い	と く い
に な う	に な う
よ あ つ	よ あ つ
に お し	に お し
ぐ ん か	ぐ ん か
さ せ ん	さ せ ん
あ れ る	あ れ る
る い じ	る い じ
い ず こ	い ず こ
い じ る	い じ る
ず き ん	ず き ん
あ く む	あ く む
あ つ し	あ つ し
あ び る	あ び る
か さ い	か さ い
し け ん	し け ん
あ け び	あ け び
う で わ	う で わ
つ い ぞ	つ い ぞ
し で ん	し で ん
き そ ん	き そ ん
い や す	い や す
が い ご	が い ご
て ん が	て ん が
ぜ ん ぶ	ぜ ん ぶ
け ん じ	け ん じ
い か す	い か す
あ ら め	あ ら め
き つ い	き つ い
な な え	な な え
は い そ	は い そ
み ぶ ん	み ぶ ん
ま と う	ま と う
ぼ か ん	ぼ か ん
す い か	す い か
い ち か	い ち か
ひ ま ん	ひ ま ん
む ず い	む ず い
ろ か い	ろ か い
り さ ん	り さ ん
や さ い	や さ い
と っ き	と っ き
お か し	お か し
も っ と	も っ と
ひ ど い	ひ ど い
は さ ん	は さ ん
い る す	い る す
す ん か	す ん か
ほ え る	ほ え る
う ま る	う ま る
お び る	お び る
あ が き	あ が き
ち が う	ち が う
お か み	お か み
あ も く	あ も く
が ら ん	が ら ん
ち が い	ち が い
い ふ く	い ふ く
う な じ	う な じ
す く い	す く い
い ち ご	い ち ご
な ご ん	な ご ん
り え き	り え き
お と す	お と す
お も に	お も に
ぎ ん ぽ	ぎ ん ぽ
ぐ げ ん	ぐ げ ん
ほ て ん	ほ て ん
つ く え	つ く え
か ん き	か ん き
ふ ん か	ふ ん か
ふ さ い	ふ さ い
ひ ん ぷ	ひ ん ぷ
い つ き	い つ き
お り ど	お り ど
ら せ ん	ら せ ん
ぶ ぜ ん	ぶ ぜ ん
え ご ま	え ご ま
よ げ ん	よ げ ん
で ん か	で ん か
い か だ	い か だ
お こ る	お こ る
し ざ い	し ざ い
お ろ か	お ろ か
ゆ ら い	ゆ ら い
あ わ れ	あ わ れ
か っ ぱ	か っ ぱ
た っ て	た っ て
ず さ ん	ず さ ん
お よ び	お よ び
い な ほ	い な ほ
め あ て	め あ て
し ま う	し ま う
た え る	た え る
た い だ	た い だ
そ ん ご	そ ん ご
む っ と	む っ と
あ だ な	あ だ な
ろ だ い	ろ だ い
あ ぶ る	あ ぶ る
り く い	り く い
で っ ぱ	で っ ぱ
お よ ぶ	お よ ぶ
し ま い	し ま い
こ ず え	こ ず え
う つ る	う つ る
む ご ん	む ご ん
う か つ	う か つ
お も や	お も や
け ん ぎ	け ん ぎ
か い ご	か い ご
す い ふ	す い ふ
き っ と	き っ と
ふ ら ん	ふ ら ん
じ ま い	じ ま い
い な せ	い な せ
ろ ば ん	ろ ば ん
じ ん ぎ	じ ん ぎ
て ん か	て ん か
あ に き	あ に き
ぼ っ き	ぼ っ き
う り て	う り て
ひ ん し	ひ ん し
お な か	お な か
ご か ん	ご か ん
い の る	い の る
か え る	か え る
い わ し	い わ し
あ じ む	あ じ む
げ せ ん	げ せ ん
ゆ え に	ゆ え に
な ん ぼ	な ん ぼ
こ い し	こ い し
が っ こ	が っ こ
え ら ぶ	え ら ぶ
じ っ と	じ っ と
お そ け	お そ け
か ら い	か ら い
び じ ん	び じ ん
な お す	な お す
ま か い	ま か い
び ざ い	び ざ い
や よ い	や よ い
れ ん ご	れ ん ご
は な え	は な え
お よ ぎ	お よ ぎ
も ろ い	も ろ い
ど ん き	ど ん き
り っ か	り っ か
そ く い	そ く い
ゆ げ ん	ゆ げ ん
お ろ ち	お ろ ち
は い き	は い き
の う ま	の う ま
い す <<unk>>	い す ず
が っ か	が っ か
あ て じ	あ て じ
や じ ん	や じ ん
き い ろ	き い ろ
う せ る	う せ る
う わ ば	う わ ば
だ っ こ	だ っ こ
て る お	て る お
う か ぶ	う か ぶ
だ ん わ	だ ん わ
と も え	と も え
か こ ん	か こ ん
あ び こ	あ び こ
わ ん さ	わ ん さ
け ん ご	け ん ご
し か ん	し か ん
い る か	い る か
こ り ん	こ り ん
い か け	い か け
は っ と	は っ と
は く い	は く い
さ い ふ	さ い ふ
ぜ ん き	ぜ ん き
ち て ん	ち て ん
す あ し	す あ し
さ さ え	さ さ え
か だ ん	か だ ん
が ぜ ん	が ぜ ん
ま ど い	ま ど い
け ん し	け ん し
に っ き	に っ き
い の ち	い の ち
ふ せ ん	ふ せ ん
や ら い	や ら い
じ り ん	じ り ん
さ と い	さ と い
お む つ	お む つ
あ ゆ み	あ ゆ み
お き る	お き る
か っ て	か っ て
み ち お	み ち お
お と り	お と り
ご し ん	ご し ん
ぼ ん ぷ	ぼ ん ぷ
い ず れ	い ず れ
い ぼ じ	い ぼ じ
や か い	や か い
か ん し	か ん し
ふ い ご	ふ い ご
ぶ ひ ん	ぶ ひ ん
ふ と ん	ふ と ん
は い ふ	は い ふ
あ る く	あ る く
は っ ぱ	は っ ぱ
じ ま ん	じ ま ん
お と こ	お と こ
か は ん	か は ん
げ ん ば	げ ん ば
い ず み	い ず み
は た ん	は た ん
ふ そ ん	ふ そ ん
げ ん が	げ ん が
つ か う	つ か う
こ も ん	こ も ん
し ん わ	し ん わ
あ け る	あ け る
ま よ う	ま よ う
え く ぼ	え く ぼ
ゆ く え	ゆ く え
げ ん や	げ ん や
は だ ん	は だ ん
い ち ど	い ち ど
ま い こ	ま い こ
す い じ	す い じ
そ に ん	そ に ん
わ ら い	わ ら い
て あ し	て あ し
が い や	が い や
ほ っ ぺ	ほ っ ぺ
む か い	む か い
う わ べ	う わ べ
か ば う	か ば う
し お り	し お り
あ ぐ り	あ ぐ り
ど か ん	ど か ん
あ さ ひ	あ さ ひ
ら い き	ら い き
や か ん	や か ん
い た む	い た む
か ま う	か ま う
で ん き	で ん き
た ち え	た ち え
れ ん こ	れ ん こ
わ ご ん	わ ご ん
む は い	む は い
ま い る	ま い る
ご め ん	ご め ん
あ し ゆ	あ し ゆ
あ ざ み	あ ざ み
ち ょ う ち ょ う	ち ょ う ち ょ う
さ ぎ ょ う へ ん か く か つ よ う	さ ぎ ょ う へ ん か く か つ よ う
ら ぎ ょ う へ ん か く か つ よ う	ら ぎ ょ う へ ん か く か つ よ う
じ ょ う き ゅ う	じ ょ う き ゅ う
ひ ょ う ち ょ う	ひ ょ う ち ょ う
き ょ う じ ょ う	き ょ う じ ょ う
ち ょ う し ょ う	ち ょ う し ょ う
じ ょ う じ ょ う	じ ょ う じ ょ う
び ょ う し ょ う	び ょ う し ょ う
く ら し	く ら し
つ き み	つ き み
ど く ろ	ど く ろ
の り こ	の り こ
や す む	や す む
ゆ も じ	ゆ も じ
と ば し	と ば し
か ぶ れ	か ぶ れ
は ち す	は ち す
わ か れ	わ か れ
ま ね く	ま ね く
ぞ ろ め	ぞ ろ め
た ぎ る	た ぎ る
さ け び	さ け び
ぬ け る	ぬ け る
ふ か ひ	ふ か ひ
み し て	み し て
も や す	も や す
や く ご	や く ご
は か く	は か く
は ぐ き	は ぐ き
か す む	か す む
す な ば	す な ば
ふ け る	ふ け る
く ぐ つ	く ぐ つ
ゆ と り	ゆ と り
け や き	け や き
さ ら す	さ ら す
そ く ど	そ く ど
わ ら じ	わ ら じ
わ れ る	わ れ る
せ び ろ	せ び ろ
さ さ る	さ さ る
し め る	し め る
す ま た	す ま た
た か さ	た か さ
ほ こ り	ほ こ り
ひ ば ち	ひ ば ち
こ わ す	こ わ す
し ま る	し ま る
か も め	か も め
に じ む	に じ む
て つ じ	て つ じ
た た ら	た た ら
ね つ け	ね つ け
し ぼ る	し ぼ る
へ ち ま	へ ち ま
む つ き	む つ き
な な つ	な な つ
た む け	た む け
せ か す	せ か す
め ざ し	め ざ し
す す る	す す る
ち か ら	ち か ら
ず ぼ し	ず ぼ し
か く ど	か く ど
た め し	た め し
せ つ ど	せ つ ど
さ び る	さ び る
こ け つ	こ け つ
み な す	み な す
が く し	が く し
み こ む	み こ む
ほ め る	ほ め る
ね か す	ね か す
と も み	と も み
ゆ び わ	ゆ び わ
ふ き つ	ふ き つ
し じ つ	し じ つ
き に ち	き に ち
ひ や す	ひ や す
な ず き	な ず き
つ づ り	つ づ り
さ け る	さ け る
で じ ま	で じ ま
そ よ ぐ	そ よ ぐ
た か が	た か が
み は る	み は る
と か す	と か す
つ が る	つ が る
ま た ね	ま た ね
だ が し	だ が し
か け つ	か け つ
ぬ れ る	ぬ れ る
や け ど	や け ど
ま わ る	ま わ る
ま わ す	ま わ す
ま け る	ま け る
じ こ く	じ こ く
た ま る	た ま る
も し も	も し も
わ さ び	わ さ び
ひ ろ し	ひ ろ し
に ぎ り	に ぎ り
り れ き	り れ き
な な め	な な め
ま じ き	ま じ き
く さ き	く さ き
か け る	か け る
じ わ り	じ わ り
ざ せ き	ざ せ き
よ た か	よ た か
よ ど む	よ ど む
は く り	は く り
か た み	か た み
ひ だ ち	ひ だ ち
し ぶ つ	し ぶ つ
だ い じ ん	だ い じ ん
く き ち ゃ	く き ち ゃ
い ろ い ろ	い ろ い ろ
お し ま い	お し ま い
ば っ す る	ば っ す る
ま っ し ろ	ま っ し ろ
か げ ろ う	か げ ろ う
ち く せ い	ち く せ い
み を う る	み を う る
か く め い	か く め い
か い ざ ん	か い ざ ん
ろ う か く	ろ う か く
よ う や く	よ う や く
こ う が く	こ う が く
だ つ ぜ い	だ つ ぜ い
ひ ふ え ん	ひ ふ え ん
た ま し い	た ま し い
し ん げ ん	し ん げ ん
ひ こ う き	ひ こ う き
こ う て つ	こ う て つ
た い な い	た い な い
せ っ か ん	せ っ か ん
お し い れ	お し い れ
ば い た ん	ば い た ん
ゆ う よ く	ゆ う よ く
し ち よ う	し ち よ う
さ く し ゅ	さ く し ゅ
た い め ん	た い め ん
い と し い	い と し い
お の お の	お の お の
れ い げ つ	れ い げ つ
ど ん て ん	ど ん て ん
め い か く	め い か く
お い た つ	お い た つ
て ん て ん	て ん て ん
れ い も つ	れ い も つ
か い が い	か い が い
し り あ い	し り あ い
が ん た ん	が ん た ん
ぶ っ け ん	ぶ っ け ん
ほ っ か ん	ほ っ か ん
や か ら	や か ら
め ん で ん	め ん で ん
く や し い	く や し い
れ ん こ ん	れ ん こ ん
ふ じ ょ し	ふ じ ょ し
む し ょ く	む し ょ く
ふ じ と う	ふ じ と う
り ゃ く ず	り ゃ く ず
け ん た い	け ん た い
か い し ん	か い し ん
け い し き	け い し き
ど く し ょ	ど く し ょ
へ ん た い	へ ん た い
こ ぐ ま	こ ぐ ま
ぱ く り	ぱ く り
こ た つ	こ た つ
ま ゆ げ	ま ゆ げ
て か き	て か き
は げ む	は げ む
ひ こ く	ひ こ く
つ な ぐ	つ な ぐ
に よ り	に よ り
ひ か り	ひ か り
し め す	し め す
や ら せ	や ら せ
く く る	く く る
し も だ	し も だ
し て き	し て き
け む り	け む り
さ ま す	さ ま す
か や く	か や く
た め る	た め る
し か る	し か る
だ つ じ	だ つ じ
さ ら し	さ ら し
み ち る	み ち る
ふ け つ	ふ け つ
む す こ	む す こ
だ ま る	だ ま る
さ だ め	さ だ め
ぼ く り	ぼ く り
び よ く	び よ く
ば ふ だ	ば ふ だ
め く ら	め く ら
は ね る	は ね る
て き ち	て き ち
か ず み	か ず み
つ か る	つ か る
そ く や	そ く や
ひ る む	ひ る む
さ げ る	さ げ る
も も か	も も か
よ せ る	よ せ る
つ る す	つ る す
ぼ や く	ぼ や く
は ず す	は ず す
ふ わ り	ふ わ り
と れ る	と れ る
す さ む	す さ む
き だ て	き だ て
の こ り	の こ り
と よ じ	と よ じ
つ り ぐ	つ り ぐ
の ど か	の ど か
と じ る	と じ る
も ど き	も ど き
く ば る	く ば る
き も の	き も の
は や る	は や る
ひ る ま	ひ る ま
が く と	が く と
か か し	か か し
な ら く	な ら く
や く ざ	や く ざ
そ ぞ ろ	そ ぞ ろ
な じ る	な じ る
ね む る	ね む る
も ど る	も ど る
こ ぼ れ	こ ぼ れ
せ び れ	せ び れ
も や し	も や し
く ぼ み	く ぼ み
せ り ふ	せ り ふ
か が り	か が り
ふ た り	ふ た り
ふ き や	ふ き や
す ば る	す ば る
さ ぎ し	さ ぎ し
か り な	か り な
ふ れ る	ふ れ る
け れ ど	け れ ど
ひ そ む	ひ そ む
き そ く	き そ く
く す み	く す み
ひ つ ぎ	ひ つ ぎ
む け る	む け る
は や く	は や く
よ な が	よ な が
び も く	び も く
ふ か す	ふ か す
や し か	や し か
か ら だ	か ら だ
と ぐ ら	と ぐ ら
し れ つ	し れ つ
ま ひ わ	ま ひ わ
さ が す	さ が す
ひ ぐ ま	ひ ぐ ま
み や ぶ	み や ぶ
し ら が	し ら が
た ね だ	た ね だ
ふ は つ	ふ は つ
く さ び	く さ び
こ も る	こ も る
な げ く	な げ く
な め こ	な め こ
こ く る	こ く る
の ば す	の ば す
と も き	と も き
み み ず	み み ず
か す み	か す み
ゆ か た	ゆ か た
と ば く	と ば く
が れ き	が れ き
ひ り き	ひ り き
そ し る	そ し る
し き り	し き り
ひ で り	ひ で り
は げ る	は げ る
か わ く	か わ く
み の り	み の り
も が く	も が く
め と る	め と る
も み じ	も み じ
は ぶ く	は ぶ く
か し わ	か し わ
み せ る	み せ る
た く し	た く し
め じ ろ	め じ ろ
わ ち き	わ ち き
さ ら ち	さ ら ち
ぼ こ く	ぼ こ く
な め る	な め る
さ な ぎ	さ な ぎ
は や ね	は や ね
は や め	は や め
は ら す	は ら す
か た て	か た て
つ く す	つ く す
か た く	か た く
ば く は	ば く は
ね づ く	ね づ く
め で る	め で る
は だ ぎ	は だ ぎ
す べ て	す べ て
ひ づ め	ひ づ め
め ぐ み	め ぐ み
わ れ ら	わ れ ら
か せ ぐ	か せ ぐ
ひ か る	ひ か る
き れ る	き れ る
さ と つ	さ と つ
つ の る	つ の る
よ こ す	よ こ す
ご じ つ	ご じ つ
や け る	や け る
よ な か	よ な か
た く や	た く や
ぬ が す	ぬ が す
こ さ か	こ さ か
む や み	む や み
せ た け	せ た け
く ら べ	く ら べ
ば ら す	ば ら す
な の に	な の に
こ く ど	こ く ど
し そ つ	し そ つ
は つ ご	は つ ご
ひ め る	ひ め る
く も り	く も り
な か ば	な か ば
け ら ば	け ら ば
せ ぼ ね	せ ぼ ね
し に せ	し に せ
き れ て	き れ て
す ご す	す ご す
わ わ る	わ わ る
こ と し	こ と し
で き る	で き る
や し ろ	や し ろ
か せ き	か せ き
か げ き	か げ き
く だ く	く だ く
か た な	か た な
こ ぼ し	こ ぼ し
さ が く	さ が く
ま ぐ ろ	ま ぐ ろ
さ す が	さ す が
ゆ づ る	ゆ づ る
か か る	か か る
こ ぶ り	こ ぶ り
じ ご く	じ ご く
ほ こ ら	ほ こ ら
や か た	や か た
み か た	み か た
た も と	た も と
ち ら す	ち ら す
ち な む	ち な む
ふ せ ぐ	ふ せ ぐ
み そ ち	み そ ち
ゆ が み	ゆ が み
た た く	た た く
ね ぐ ら	ね ぐ ら
か か す	か か す
ひ そ か	ひ そ か
と ま る	と ま る
ま ぐ れ	ま ぐ れ
む だ げ	む だ げ
た に ま	た に ま
ど ぼ く	ど ぼ く
し げ る	し げ る
ま ゆ み	ま ゆ み
み ず こ	み ず こ
け が わ	け が わ
か わ す	か わ す
み や げ	み や げ
し ぶ る	し ぶ る
す み び	す み び
も ぬ け	も ぬ け
さ か な	さ か な
そ く ず	そ く ず
し ま ね	し ま ね
く ぎ る	く ぎ る
ま じ め	ま じ め
き し べ	き し べ
し つ ぎ	し つ ぎ
も と む	も と む
こ ぜ に	こ ぜ に
に こ げ	に こ げ
さ べ つ	さ べ つ
は し り	は し り
し の ぐ	し の ぐ
ず し き	ず し き
は た け	は た け
よ し こ	よ し こ
く に こ	く に こ
ば く が	ば く が
さ そ り	さ そ り
り き む	り き む
す ご く	す ご く
じ か く	じ か く
ま つ る	ま つ る
よ し の	よ し の
む す び	む す び
こ こ ろ	こ こ ろ
せ な か	せ な か
ひ ね る	ひ ね る
な や む	な や む
か そ る	か そ る
た ざ わ	た ざ わ
ふ じ み	ふ じ み
み さ こ	み さ こ
か わ り	か わ り
つ ぶ る	つ ぶ る
は こ べ	は こ べ
し ら せ	し ら せ
は か ば	は か ば
ね も と	ね も と
へ ん ざ い	へ ん ざ い
こ ろ ぶ	こ ろ ぶ
か た は	か た は
き の こ	き の こ
た れ る	た れ る
た こ く	た こ く
く ら げ	く ら げ
こ く じ	こ く じ
こ く ち	こ く ち
ご が つ	ご が つ
て が る	て が る
な ま り	な ま り
そ く す	そ く す
ふ う じ て	ふ う じ て
へ い が く	へ い が く
げ ん か ん	げ ん か ん
よ う き し	よ う き し
は く せ い	は く せ い
へ ん さ い	へ ん さ い
あ つ あ つ	あ つ あ つ
な り け い	な り け い
ず い え き	ず い え き
ふ く い ん	ふ く い ん
う っ と り	う っ と り
せ ん ば ん	せ ん ば ん
あ か て ん	あ か て ん
ゆ う れ つ	ゆ う れ つ
だ い い ち	だ い い ち
ほ う じ る	ほ う じ る
は ん し ん	は ん し ん
て ん か ん	て ん か ん
ぎ ょ く ろ	ぎ ょ く ろ
び ゃ く し	び ゃ く し
ぎ ょ た く	ぎ ょ た く
つ う れ つ	つ う れ つ
こ ん し ん	こ ん し ん
い ち だ ん	い ち だ ん
か ん が い	か ん が い
あ げ あ げ	あ げ あ げ
な れ あ い	な れ あ い
り し ょ く	り し ょ く
ち ゃ か す	ち ゃ か す
ど う ぎ ご	ど う ぎ ご
し ん ぜ ん	し ん ぜ ん
や く す う	や く す う
ほ ん し ん	ほ ん し ん
き ょ だ く	き ょ だ く
い じ い じ	い じ い じ
み じ ゅ く	み じ ゅ く
け い す け	け い す け
ら い ね ん	ら い ね ん
き ゃ く ま	き ゃ く ま
こ く ど う	こ く ど う
さ い せ ん	さ い せ ん
ち ゃ づ け	ち ゃ づ け
じ ん ざ い	じ ん ざ い
ど く し ゃ	ど く し ゃ
て っ き ん	て っ き ん
だ い た い	だ い た い
く し ゃ み	く し ゃ み
も う け る	も う け る
い た っ て	い た っ て
む ぞ う さ	む ぞ う さ
さ ば ひ い	さ ば ひ い
と う と つ	と う と つ
う え ち ち	う え ち ち
げ ん め つ	げ ん め つ
ざ ん き ん	ざ ん き ん
に ん じ ん	に ん じ ん
た い が ん	た い が ん
ね ん ま つ	ね ん ま つ
も う か る	も う か る
き ん が ん	き ん が ん
す い さ ん	す い さ ん
じ ゆ う か	じ ゆ う か
い く ね ん	い く ね ん
こ ん ざ い	こ ん ざ い
は ん て ん	は ん て ん
ぼ う こ く	ぼ う こ く
ど く せ い	ど く せ い
せ き え ん	せ き え ん
あ お も の	あ お も の
ぼ う じ つ	ぼ う じ つ
か い が ん	か い が ん
よ め い り	よ め い り
ざ ん し ん	ざ ん し ん
は い そ ん	は い そ ん
か い か ん	か い か ん
ふ れ あ う	ふ れ あ う
せ つ い ん	せ つ い ん
が い せ ん	が い せ ん
ち ま よ う	ち ま よ う
か く し ゅ	か く し ゅ
お ん ど く	お ん ど く
よ う し き	よ う し き
は ん ば い	は ん ば い
い い だ す	い い だ す
ふ じ い ろ	ふ じ い ろ
せ ん さ い	せ ん さ い
そ う し て	そ う し て
し お し お	し お し お
ま じ ゅ つ	ま じ ゅ つ
げ ん き ん	げ ん き ん
お ち い る	お ち い る
ら い ひ ん	ら い ひ ん
そ く じ ょ	そ く じ ょ
じ ゅ つ ご	じ ゅ つ ご
ふ か の う	ふ か の う
う か う か	う か う か
こ お ら す	こ お ら す
せ い れ き	せ い れ き
こ う そ つ	こ う そ つ
か ん ぱ い	か ん ぱ い
さ び し い	さ び し い
ま ん け ん	ま ん け ん
め い も く	め い も く
べ ん か い	べ ん か い
さ ん み つ	さ ん み つ
あ じ さ い	あ じ さ い
こ う さ つ	こ う さ つ
じ ん け ん	じ ん け ん
ち ん こ ん	ち ん こ ん
あ ん し つ	あ ん し つ
ぜ ん め つ	ぜ ん め つ
こ っ せ つ	こ っ せ つ
ぶ あ つ い	ぶ あ つ い
こ う ぞ く	こ う ぞ く
と び う お	と び う お
げ ん ざ い	げ ん ざ い
お い ぼ れ	お い ぼ れ
い せ え び	い せ え び
し な つ う	し な つ う
に ち よ う	に ち よ う
お っ ち ぬ	お っ ち ぬ
お え か き	お え か き
こ う そ く	こ う そ く
は っ け ん	は っ け ん
こ く ぼ う	こ く ぼ う
あ ら が う	あ ら が う
け ん ざ い	け ん ざ い
よ び こ う	よ び こ う
し ん し ん	し ん し ん
さ と う や	さ と う や
ま え お き	ま え お き
と う と ぶ	と う と ぶ
ほ ご し ゃ	ほ ご し ゃ
い く せ ん	い く せ ん
ち り ょ く	ち り ょ く
く う げ き	く う げ き
も く そ う	も く そ う
す い れ ん	す い れ ん
ほ ん に ん	ほ ん に ん
け っ ぱ ん	け っ ぱ ん
お さ な い	お さ な い
す っ ぽ ん	す っ ぽ ん
あ る い は	あ る い は
も ん だ い	も ん だ い
も っ た い	も っ た い
ま に あ う	ま に あ う
と う な す	と う な す
こ っ そ り	こ っ そ り
ね つ ぞ う	ね つ ぞ う
さ ん だ ん	さ ん だ ん
る い さ ん	る い さ ん
ほ ら あ な	ほ ら あ な
ゆ し ゅ つ	ゆ し ゅ つ
な ん な ら	な ん な ら
い ち ら ん	い ち ら ん
け ん ば い	け ん ば い
し ん か ん	し ん か ん
さ い わ い	さ い わ い
し っ く い	し っ く い
け ん え き	け ん え き
す い い き	す い い き
ふ く そ う	ふ く そ う
こ う け つ	こ う け つ
ぜ ん ぱ い	ぜ ん ぱ い
う え さ ま	う え さ ま
こ ん た ん	こ ん た ん
で ん し ん	で ん し ん
も ん じ ん	も ん じ ん
い ち も ん	い ち も ん
き ょ ぜ つ	き ょ ぜ つ
お こ な う	お こ な う
つ き あ い	つ き あ い
ち い さ な	ち い さ な
か い わ い	か い わ い
か ん ら ん	か ん ら ん
て い せ つ	て い せ つ
は つ え ん	は つ え ん
が く い ん	が く い ん
そ ん げ ん	そ ん げ ん
へ ん さ ん	へ ん さ ん
よ う こ そ	よ う こ そ
て ん ま つ	て ん ま つ
み し よ う	み し よ う
に ん げ ん	に ん げ ん
し ゃ が む	し ゃ が む
か え う た	か え う た
う ぐ い す	う ぐ い す
か ん ば ん	か ん ば ん
あ じ わ い	あ じ わ い
お ぼ え る	お ぼ え る
た め い き	た め い き
ば い き ん	ば い き ん
び し ょ く	び し ょ く
え ん ぴ つ	え ん ぴ つ
ば っ さ り	ば っ さ り
せ ん え つ	せ ん え つ
が い で ん	が い で ん
せ ん か い	せ ん か い
は ん ざ い	は ん ざ い
か み あ う	か み あ う
ぎ ょ に く	ぎ ょ に く
き じ ゅ つ	き じ ゅ つ
す い ぜ ん	す い ぜ ん
も う ど く	も う ど く
て い ぞ く	て い ぞ く
こ う に ち	こ う に ち
た い が い	た い が い
は い が ん	は い が ん
お か え り	お か え り
ぜ い た く	ぜ い た く
い っ か く	い っ か く
は く め い	は く め い
ま ん な か	ま ん な か
と く ほ う	と く ほ う
れ き せ い	れ き せ い
お ん よ み	お ん よ み
け い さ く	け い さ く
の う み そ	の う み そ
ち ょ く し	ち ょ く し
ま ど う し	ま ど う し
さ え も ん	さ え も ん
し い た け	し い た け
じ ょ じ し	じ ょ じ し
さ い で ん	さ い で ん
が く し ゃ	が く し ゃ
の う さ つ	の う さ つ
じ ど う し	じ ど う し
か ん て ん	か ん て ん
な ん べ ん	な ん べ ん
た ん お し	た ん お し
い よ い よ	い よ い よ
き ん だ ん	き ん だ ん
ざ っ こ ん	ざ っ こ ん
ゆ う な ぎ	ゆ う な ぎ
お ん ど り	お ん ど り
か え し ん	か え し ん
ど う せ き	ど う せ き
し ん り ん	し ん り ん
と く し ゃ	と く し ゃ
た い く ん	た い く ん
か い は い	か い は い
け い て き	け い て き
て ん け ん	て ん け ん
ぜ っ た い	ぜ っ た い
り ゃ く ご	り ゃ く ご
か ん せ ん	か ん せ ん
お も た い	お も た い
い い き る	い い き る
べ ん か ん	べ ん か ん
ら い は ん	ら い は ん
ず っ し り	ず っ し り
こ う こ く	こ う こ く
の う り つ	の う り つ
じ ゆ う ど	じ ゆ う ど
な い し ん	な い し ん
か わ い い	か わ い い
げ き そ う	げ き そ う
ざ つ よ う	ざ つ よ う
じ ん ら い	じ ん ら い
だ い え つ	だ い え つ
ぞ う け つ	ぞ う け つ
し ろ う と	し ろ う と
す い が い	す い が い
ご ち そ う	ご ち そ う
あ き び ん	あ き び ん
め め し い	め め し い
だ ん た い	だ ん た い
も よ お す	も よ お す
と く よ う	と く よ う
か い き ん	か い き ん
ひ ん だ い	ひ ん だ い
さ い に ん	さ い に ん
あ さ い ろ	あ さ い ろ
そ の う え	そ の う え
こ う も り	こ う も り
ら い か ん	ら い か ん
け っ ぽ ん	け っ ぽ ん
あ ら か ん	あ ら か ん
だ じ ゃ れ	だ じ ゃ れ
に く ぼ う	に く ぼ う
せ い こ つ	せ い こ つ
い ん ち き	い ん ち き
せ っ き ん	せ っ き ん
す っ ぴ ん	す っ ぴ ん
う ぶ ご え	う ぶ ご え
さ い か い	さ い か い
も ち い る	も ち い る
つ き あ う	つ き あ う
み っ せ つ	み っ せ つ
と う ご く	と う ご く
さ し ぼ う	さ し ぼ う
お ま ん こ	お ま ん こ
ゆ う だ ち	ゆ う だ ち
そ う ぎ や	そ う ぎ や
け っ こ ん	け っ こ ん
か い だ い	か い だ い
た の し い	た の し い
ぶ き ょ く	ぶ き ょ く
と く れ い	と く れ い
ち い さ め	ち い さ め
き き い る	き き い る
た ち い る	た ち い る
い ん れ つ	い ん れ つ
た い は い	た い は い
た ん れ ん	た ん れ ん
と う し つ	と う し つ
お べ っ か	お べ っ か
み っ か ん	み っ か ん
い ち ね ん	い ち ね ん
あ た え る	あ た え る
に ち べ い	に ち べ い
し ゅ じ く	し ゅ じ く
び い し き	び い し き
ひ っ そ り	ひ っ そ り
ほ う り き	ほ う り き
か し ょ く	か し ょ く
す い せ ん	す い せ ん
こ ん ら ん	こ ん ら ん
だ ん が ん	だ ん が ん
ふ ん い き	ふ ん い き
に じ め い	に じ め い
ふ く ご う	ふ く ご う
ひ ん せ ん	ひ ん せ ん
ほ お じ ろ	ほ お じ ろ
び じ ゅ つ	び じ ゅ つ
あ さ っ て	あ さ っ て
ろ う そ く	ろ う そ く
こ く め い	こ く め い
ま ん て ん	ま ん て ん
あ お も り	あ お も り
は い え き	は い え き
お び え る	お び え る
が い じ ん	が い じ ん
お ま い つ	お ま い つ
あ ざ と い	あ ざ と い
ふ ん ま つ	ふ ん ま つ
あ ひ さ ん	あ ひ さ ん
よ う そ ろ	よ う そ ろ
じ ど う か	じ ど う か
け ん さ ん	け ん さ ん
こ う そ ふ	こ う そ ふ
さ ん か ん	さ ん か ん
う ら な い	う ら な い
き ん だ い	き ん だ い
あ い さ つ	あ い さ つ
べ っ ぴ ん	べ っ ぴ ん
び じ ゃ く	び じ ゃ く
こ お ろ ぎ	こ お ろ ぎ
い だ て ん	い だ て ん
あ り あ け	あ り あ け
せ き う ん	せ き う ん
い ち ば ん	い ち ば ん
ほ し ょ く	ほ し ょ く
じ ゅ ら く	じ ゅ ら く
は り あ う	は り あ う
な ん た い	な ん た い
せ い き か	せ い き か
ふ ん ぱ ん	ふ ん ぱ ん
こ き ゃ く	こ き ゃ く
し ん が い	し ん が い
じ し ゅ く	じ し ゅ く
び ん せ ん	び ん せ ん
ほ ん た い	ほ ん た い
は ん だ ん	は ん だ ん
い や し い	い や し い
お て ん ば	お て ん ば
げ ん か い	げ ん か い
は い せ ん	は い せ ん
こ う せ つ	こ う せ つ
ぜ ん ぶ ん	ぜ ん ぶ ん
す う が く	す う が く
あ い に く	あ い に く
て い て つ	て い て つ
き ん ら ん	き ん ら ん
て き よ う	て き よ う
か ん た ん	か ん た ん
て っ か い	て っ か い
ま え う り	ま え う り
じ ん べ え	じ ん べ え
う か が う	う か が う
ゆ う ど く	ゆ う ど く
い ざ よ い	い ざ よ い
ど う か つ	ど う か つ
あ ぶ な い	あ ぶ な い
は い か い	は い か い
ご う せ つ	ご う せ つ
い け に え	い け に え
し ん ぶ ん	し ん ぶ ん
せ ん だ い	せ ん だ い
て い れ つ	て い れ つ
か い け ん	か い け ん
せ っ て ん	せ っ て ん
か ん ぜ ん	か ん ぜ ん
お じ さ ん	お じ さ ん
こ う た く	こ う た く
が っ て ん	が っ て ん
お も い で	お も い で
ご う だ つ	ご う だ つ
ち っ こ い	ち っ こ い
は っ て ん	は っ て ん
あ ん き も	あ ん き も
さ ん け ん	さ ん け ん
げ し ゅ く	げ し ゅ く
た い わ ん	た い わ ん
す い ろ ん	す い ろ ん
さ い た い	さ い た い
べ い こ く	べ い こ く
さ ん た い	さ ん た い
ざ ん に ん	ざ ん に ん
ふ う ぞ く	ふ う ぞ く
た い ざ ん	た い ざ ん
と う み つ	と う み つ
ほ う こ く	ほ う こ く
お し え る	お し え る
こ く ゆ う	こ く ゆ う
ま が る	ま が る
め い や く	め い や く
は く し ょ	は く し ょ
お ぎ な う	お ぎ な う
だ い だ い	だ い だ い
べ つ め い	べ つ め い
ほ ん ま る	ほ ん ま る
す い た い	す い た い
ぜ っ ぴ ん	ぜ っ ぴ ん
も っ き ん	も っ き ん
あ さ お き	あ さ お き
い き う め	い き う め
こ く そ う	こ く そ う
み つ ぐ	み つ ぐ
は な み	は な み
ま さ る	ま さ る
ひ ら ま	ひ ら ま
さ が る	さ が る
し か く	し か く
ぴ た り	ぴ た り
ら ふ く	ら ふ く
た ち き	た ち き
ゆ る ぎ	ゆ る ぎ
た め す	た め す
す ぎ る	す ぎ る
か れ は	か れ は
の こ す	の こ す
ね か ら	ね か ら
す も も	す も も
わ た る	わ た る
ね む け	ね む け
さ て つ	さ て つ
ひ も の	ひ も の
み ど り	み ど り
に せ き	に せ き
り が く	り が く
り ざ や	り ざ や
な か れ	な か れ
ね ど こ	ね ど こ
し ば し	し ば し
せ め て	せ め て
ま つ り	ま つ り
ふ り こ	ふ り こ
め げ る	め げ る
な ま ず	な ま ず
へ き ち	へ き ち
ら く だ	ら く だ
き こ り	き こ り
く だ る	く だ る
も じ る	も じ る
き ざ む	き ざ む
ひ さ く	ひ さ く
み よ し	み よ し
く ろ め	く ろ め
し ふ く	し ふ く
ひ ろ み	ひ ろ み
た く み	た く み
し か け	し か け
こ の む	こ の む
ち び る	ち び る
じ か に	じ か に
ず れ る	ず れ る
く ず し	く ず し
き せ つ	き せ つ
そ ん し	ま ご こ
か く り	か く り
は か ま	は か ま
や き ば	や き ば
ど て ら	ど て ら
か た る	か た る
す す め	す す め
ま ぜ る	ま ぜ る
た た り	た た り
ち <<unk>> む	ち <unk> む
ほ た る	ほ た る
わ き げ	わ き げ
も つ れ	も つ れ
ま も り	ま も り
さ わ る	さ わ る
つ よ び	つ よ び
な ら す	な ら す
ひ よ わ	ひ よ わ
む て き	む て き
す わ る	す わ る
ひ よ け	ひ よ け
ふ こ く	ふ こ く
か り も	か り も
か れ つ	か れ つ
す き ま	す き ま
ざ く ろ	ざ く ろ
す み だ	す み だ
た ぐ る	た ぐ る
な ば な	な ば な
か く さ	か く さ
け じ め	け じ め
し き る	し き る
た け し	た け し
ゆ き ち	ゆ き ち
だ け ど	だ け ど
ま つ げ	ま つ げ
ま ど べ	ま ど べ
な た ね	な た ね
た け だ	た け だ
め し べ	め し べ
ふ ぐ り	ふ ぐ り
つ づ み	つ づ み
き ま ま	き ま ま
き が る	き が る
か し ま	か し ま
つ ま る	つ ま る
そ だ ち	そ だ ち
み や の	み や の
さ き に	さ き に
せ が れ	せ が れ
ぼ く し	ぼ く し
こ か げ	こ か げ
も ぐ ら	も ぐ ら
は が ね	は が ね
さ と す	さ と す
め が ね	め が ね
か れ る	か れ る
く ぎ り	く ぎ り
ぎ せ き	ぎ せ き
た た む	た た む
し こ ろ	し こ ろ
は つ か	は つ か
と さ か	と さ か
ま つ ち	ま つ ち
ひ と め	ひ と め
そ そ ぐ	そ そ ぐ
な ず な	な ず な
か た ぎ	か た ぎ
じ さ つ	じ さ つ
む し る	む し る
み ず ぎ	み ず ぎ
ま す み	ま す み
ひ で し	ひ で し
ま ふ ゆ	ま ふ ゆ
た だ し	た だ し
か わ る	か わ る
く ら む	く ら む
な ま み	な ま み
み た す	み た す
せ つ わ	せ つ わ
そ ら め	そ ら め
ぎ ぞ く	ぎ ぞ く
ひ と り	ひ と り
が く ひ	が く ひ
や ぶ る	や ぶ る
な つ き	な つ き
ま く る	ま く る
は か り	は か り
た べ る	た べ る
か じ き	か じ き
ぞ く け	ぞ く け
つ か れ	つ か れ
よ せ つ	よ せ つ
と け る	と け る
の が す	の が す
わ ら べ	わ ら べ
そ わ か	そ わ か
み か ず	み か ず
ほ ろ り	ほ ろ り
し ず く	し ず く
こ と ば	こ と ば
も と る	も と る
わ ら わ	わ ら わ
も て る	も て る
ね び き	ね び き
つ く り	つ く り
き し む	き し む
つ み れ	つ み れ
て ば た	て ば た
か ざ け	か ざ け
ひ た る	ひ た る
ふ し ぎ	ふ し ぎ
ほ ね み	ほ ね み
つ ば さ	つ ば さ
ね ま き	ね ま き
み が く	み が く
じ も と	じ も と
は め る	は め る
ふ さ ぐ	ふ さ ぐ
ず ば り	ず ば り
た し か	た し か
ほ ぐ す	ほ ぐ す
は ま る	は ま る
ち ま き	ち ま き
く せ に	く せ に
そ こ く	そ こ く
が か ざ	が か ざ
が さ つ	が さ つ
や た ら	や た ら
よ み ち	よ み ち
す け る	す け る
し か り	し か り
び く に	び く に
た か ら	た か ら
と よ た	と よ た
わ る ぎ	わ る ぎ
く じ ら	く じ ら
き が ね	き が ね
せ が む	せ が む
ひ た す	ひ た す
き な こ	き な こ
す ず き	す ず き
な ぐ る	な ぐ る
し ず か	し ず か
か げ り	か げ り
な れ る	な れ る
と も る	と も る
と つ ぐ	と つ ぐ
な が ら	な が ら
ま ざ る	ま ざ る
ま な ぶ	ま な ぶ
か し ら	か し ら
へ だ て	へ だ て
ね か た	ね か た
も ぎ り	も ぎ り
ぼ さ つ	ぼ さ つ
す て る	す て る
し の び	し の び
め が み	め が み
こ ま ち	こ ま ち
ひ の で	ひ の で
の ぞ む	の ぞ む
な が れ	な が れ
は さ む	は さ む
ね ず み	ね ず み
に が て	に が て
よ や く	よ や く
と ど く	と ど く
こ な す	こ な す
ま さ き	ま さ き
そ ら す	そ ら す
た か ね	た か ね
ひ ろ き	ひ ろ き
こ ぼ す	こ ぼ す
か な り	か な り
そ ぼ ろ	そ ぼ ろ
ま さ と	ま さ と
は か た	は か た
と げ る	と げ る
ゆ き こ	ゆ き こ
し た じ	し た じ
は き け	は き け
ど く そ	ど く そ
し の ぶ	し の ぶ
こ が す	こ が す
こ が き	こ が き
ふ も と	ふ も と
さ か た	さ か た
ま く つ	ま く つ
な く す	な く す
か が む	か が む
な で る	な で る
ば く ち	ば く ち
よ く も	よ く も
の こ る	の こ る
わ け る	わ け る
す ね る	す ね る
ち く じ	ち く じ
ど そ く	ど そ く
む か で	む か で
ほ と け	ほ と け
し た て	し た て
つ ぶ す	つ ぶ す
つ め る	つ め る
ろ だ な	ろ だ な
も し か	も し か
ね こ ぜ	ね こ ぜ
そ む く	そ む く
は ち く	は ち く
し け る	し け る
げ ど く	げ ど く
む し ろ	む し ろ
に ぶ る	に ぶ る
つ づ る	つ づ る
ま げ る	ま げ る
み ろ く	み ろ く
ほ こ る	ほ こ る
と き わ	と き わ
や は り	や は り
ど ち ら	ど ち ら
た る む	た る む
し ぐ れ	し ぐ れ
き ま り	き ま り
き か く	き か く
か し こ	か し こ
つ む る	つ む る
ひ な た	ひ な た
も は や	も は や
き ま る	き ま る
り く つ	り く つ
ま き こ	ま き こ
ぽ つ り	ぽ つ り
ま つ ろ	ま つ ろ
つ ぼ る	つ ぼ る
そ し て	そ し て
か ふ か	か ふ か
か さ む	か さ む
ま も る	ま も る
く せ げ	く せ げ
ひ ら た	ひ ら た
に や く	に や く
じ み こ	じ み こ
て さ き	て さ き
に わ か	に わ か
く ず す	く ず す
は な す	は な す
ぬ る ぽ	ぬ る ぽ
ぞ く す	ぞ く す
ふ く む	ふ く む
よ わ み	よ わ み
ま き す	ま き す
な ご や	な ご や
か わ ら	か わ ら
ほ く ぎ	ほ く ぎ
む せ ぶ	む せ ぶ
ら く ご	ら く ご
り り く	り り く
ま く ら	ま く ら
ま ほ し	ま ほ し
み と る	み と る
ひ だ き	ひ だ き
た か す	た か す
じ こ る	じ こ る
み じ め	み じ め
た よ る	た よ る
は し ご	は し ご
か ら す	か ら す
や め る	や め る
ゆ か り	ゆ か り
ば く ろ	ば く ろ
そ し き	そ し き
も ら す	も ら す
ま す め	ま す め
か じ ば	か じ ば
の り き	の り き
ち ぎ る	ち ぎ る
て ぎ わ	て ぎ わ
な に せ	な に せ
ひ が し	ひ が し
ち ち ご	ち ち ご
く ろ み	く ろ み
せ ま る	せ ま る
き た す	き た す
か も く	か も く
に や す	に や す
ら ぶ か	ら ぶ か
た の む	た の む
に ぎ る	に ぎ る
ね り こ	ね り こ
は ざ ま	は ざ ま
は た す	は た す
つ く ね	つ く ね
な か ま	な か ま
み や こ	み や こ
こ の み	こ の み
だ る ま	だ る ま
な が さ	な が さ
し ろ ざ	し ろ ざ
た わ け	た わ け
な ら ぶ	な ら ぶ
ざ せ つ	ざ せ つ
は づ き	は づ き
ち ど り	ち ど り
こ と み	こ と み
し る し	し る し
か じ る	か じ る
く る す	く る す
き り は	き り は
む か し	む か し
も れ る	も れ る
か が み	か が み
こ づ ち	こ づ ち
こ ど も	こ ど も
た た み	た た み
き つ ね	き つ ね
と く む	と く む
ば け る	ば け る
そ め る	そ め る
か ぎ る	か ぎ る
か く じ	か く じ
と ぐ ろ	と ぐ ろ
め ぐ る	め ぐ る
ぬ ら す	ぬ ら す
や く も	や く も
ぐ ち る	ぐ ち る
な が の	な が の
て な み	て な み
や す み	や す み
こ ま る	こ ま る
や ま と	や ま と
こ む ぎ	こ む ぎ
ふ つ か	ふ つ か
す ず め	す ず め
こ が ら	こ が ら
し ら ぎ	し ら ぎ
た だ に	た だ に
さ か さ	さ か さ
た づ な	た づ な
こ ば む	こ ば む
さ ぐ る	さ ぐ る
と け つ	と け つ
わ か る	わ か る
と か げ	と か げ
ち と せ	ち と せ
ま つ ば	ま つ ば
た も つ	た も つ
ま も の	ま も の
き ざ し	き ざ し
た れ め	た れ め
ゆ る む	ゆ る む
た て る	た て る
ど げ ざ	ど げ ざ
け が に	け が に
め ざ す	め ざ す
つ わ り	つ わ り
き わ み	き わ み
て つ や	て つ や
や も り	や も り
こ さ め	こ さ め
こ ど く	こ ど く
な さ る	な さ る
は じ き	は じ き
か さ ね	か さ ね
せ ち な	せ ち な
ふ や す	ふ や す
さ と る	さ と る
し す る	し す る
せ め る	せ め る
ひ ば く	ひ ば く
そ だ つ	そ だ つ
さ く ら	さ く ら
つ げ る	つ げ る
ま か す	ま か す
ば り き	ば り き
く ず ゆ	く ず ゆ
す で に	す で に
は や し	は や し
と に ち	と に ち
く ぐ る	く ぐ る
は が す	は が す
か つ ら	か つ ら
か ぎ や	か ぎ や
の が れ	の が れ
の び る	の び る
と も こ	と も こ
け な げ	け な げ
よ ぎ り	よ ぎ り
は つ わ	は つ わ
と て も	と て も
そ れ る	そ れ る
こ つ ぶ	こ つ ぶ
ま さ し	ま さ し
く や み	く や み
ま ひ る	ま ひ る
ゆ た か	ゆ た か
と め る	と め る
み ご と	み ご と
め だ つ	め だ つ
や す で	や す で
す み れ	す み れ
だ ま す	だ ま す
は に わ	は に わ
さ ば く	さ ば く
ち し き	ち し き
の ぼ る	の ぼ る
す べ る	す べ る
て だ て	て だ て
じ び き	じ び き
た の み	た の み
し た ら	し た ら
ま る で	ま る で
し か も	し か も
ま こ と	ま こ と
じ ど り	じ ど り
ち せ つ	ち せ つ
さ わ り	さ わ り
だ さ く	だ さ く
が く ふ	が く ふ
み な み	み な み
す く む	す く む
ず ろ く	ず ろ く
か ぎ り	か ぎ り
ち く び	ち く び
け な す	け な す
や る き	や る き
わ か な	わ か な
や み よ	や み よ
の ぞ く	の ぞ く
は れ る	は れ る
と り こ	と り こ
わ か す	わ か す
く び れ	く び れ
わ た り	わ た り
の じ こ	の じ こ
は だ し	は だ し
か ら む	か ら む
じ ち き	じ ち き
な が す	な が す
き ず く	き ず く
て ぶ れ	て ぶ れ
か つ ま	か つ ま
た ど る	た ど る
び ち く	び ち く
と く に	と く に
は さ み	は さ み
や つ ら	や つ ら
は ば む	は ば む
て ん け い	て ん け い
お い ら ん	お い ら ん
は ん す う	は ん す う
こ う ね ん	こ う ね ん
と う か ん	と う か ん
り っ と う	り っ と う
し ょ は ん	し ょ は ん
よ う ば い	よ う ば い
え ん で ん	え ん で ん
あ ら ま あ	あ ら ま あ
お ん あ つ	お ん あ つ
ま ん ま ん	ま ん ま ん
ど う な ん	ど う な ん
て ん こ う	て ん こ う
す い ほ う	す い ほ う
し ゅ だ い	し ゅ だ い
あ く と う	あ く と う
と う み ん	と う み ん
れ ん と う	れ ん と う
ほ ん と う	ほ ん と う
か ん げ い	か ん げ い
か ん な ん	か ん な ん
れ い が い	れ い が い
あ ん う つ	あ ん う つ
じ ゅ り あ	じ ゅ り あ
ぐ ん そ う	ぐ ん そ う
と う け ん	と う け ん
じ ゅ で ん	じ ゅ で ん
い ち い ち	い ち い ち
き ん ぼ う	き ん ぼ う
と う ぜ ん	と う ぜ ん
か ん ゆ う	か ん ゆ う
ふ じ ゅ ん	ふ じ ゅ ん
せ ん べ い	せ ん べ い
け い ら ん	け い ら ん
た ん よ う	た ん よ う
へ い ぜ ん	へ い ぜ ん
と う が い	と う が い
ど う い ご	ど う い ご
そ う か ん	そ う か ん
ば っ す い	ば っ す い
わ っ そ ん	わ っ そ ん
お し ゃ れ	お し ゃ れ
と う は ん	と う は ん
な い せ い	な い せ い
だ ん と う	だ ん と う
と う た ん	と う た ん
と う て ん	と う て ん
つ い ほ う	つ い ほ う
ほ ん ぽ う	ほ ん ぽ う
も ん ど う	も ん ど う
し ん し ゅ	し ん し ゅ
た い よ う	た い よ う
だ い け い	だ い け い
た い す う	た い す う
え ん じ ん	え ん じ ん
ら ん ま ん	ら ん ま ん
え ん て ん	え ん て ん
へ い か い	へ い か い
ほ う で ん	ほ う で ん
せ い さ い	せ い さ い
ゆ う う つ	ゆ う う つ
め ん ど う	め ん ど う
さ っ し ん	さ っ し ん
い り ょ く	い り ょ く
だ ん せ い	だ ん せ い
ら ん ぼ う	ら ん ぼ う
い っ す る	い っ す る
ろ う じ ん	ろ う じ ん
け ん ぽ う	け ん ぽ う
た い て い	た い て い
な ん こ う	な ん こ う
ろ ん そ う	ろ ん そ う
お お か み	お お か み
せ ん れ い	せ ん れ い
か ん じ ゅ	か ん じ ゅ
い た し ゃ	い た し ゃ
し ゅ け ん	し ゅ け ん
い し ゅ く	い し ゅ く
け っ そ ん	け っ そ ん
ぜ ん ぼ う	ぜ ん ぼ う
へ い め ん	へ い め ん
し ん そ う	し ん そ う
せ い せ ん	せ い せ ん
あ ん し ん	あ ん し ん
か い と う	か い と う
な い く う	な い く う
て ん す う	て ん す う
ふ う ぶ ん	ふ う ぶ ん
せ い か ん	せ い か ん
が ん ね ん	が ん ね ん
せ い ば い	せ い ば い
し ん つ う	し ん つ う
し ん ぼ う	し ん ぼ う
ざ っ と う	ざ っ と う
か い こ う	か い こ う
ち ん こ う	ち ん こ う
は い け い	は い け い
ど う ね ん	ど う ね ん
ま い そ う	ま い そ う
ば い お ん	ば い お ん
た い せ い	た い せ い
お お か た	お お か た
の う こ ん	の う こ ん
ち ん つ う	ち ん つ う
て い き ん	て い き ん
れ い す い	れ い す い
た ん し ょ	た ん し ょ
て き お う	て き お う
ふ う き ん	ふ う き ん
た い き ょ	た い き ょ
に ん じ ゃ	に ん じ ゃ
な い ぞ う	な い ぞ う
み ん ぺ い	み ん ぺ い
ほ う べ ん	ほ う べ ん
ぜ っ こ う	ぜ っ こ う
お お ご ま	お お ご ま
ぶ っ し ん	ぶ っ し ん
お お も と	お お も と
ゆ う ざ い	ゆ う ざ い
た ん あ ん	た ん あ ん
こ う で ん	こ う で ん
し ゅ じ ん	し ゅ じ ん
し っ し ん	し っ し ん
き ゃ っ か	き ゃ っ か
あ ん ま り	あ ん ま り
し ゅ っ ぴ	し ゅ っ ぴ
こ う が い	こ う が い
て じ ゅ ん	て じ ゅ ん
つ う き ん	つ う き ん
し ょ け ん	し ょ け ん
ざ ん ね ん	ざ ん ね ん
よ う だ い	よ う だ い
い き ょ く	い き ょ く
ほ お づ え	ほ お づ え
そ ん き ょ	そ ん き ょ
れ い ば い	れ い ば い
せ い て ん	せ い て ん
が ん こ う	が ん こ う
こ く お う	こ く お う
と う だ い	と う だ い
が い よ う	が い よ う
じ ん ぞ う	じ ん ぞ う
げ ん ま い	げ ん ま い
ら ん し ゃ	ら ん し ゃ
ざ ん て い	ざ ん て い
け い し ん	け い し ん
ほ う ざ い	ほ う ざ い
ふ う す い	ふ う す い
じ ゅ ん び	じ ゅ ん び
し ゅ か ん	し ゅ か ん
さ ん じ ょ	さ ん じ ょ
せ い た ん	せ い た ん
り っ こ う	り っ こ う
い っ け ん	い っ け ん
し ん ま い	し ん ま い
し ょ し ん	し ょ し ん
さ ん ま い	さ ん ま い
こ ん れ い	こ ん れ い
さ い こ う	さ い こ う
せ き え い	せ き え い
ぎ ん こ う	ぎ ん こ う
て ん と う	て ん と う
よ う と ん	よ う と ん
ふ ん ど う	ふ ん ど う
お ぎ ゃ る	お ぎ ゃ る
か い よ う	か い よ う
じ ゅ ん じ	じ ゅ ん じ
ば ん ね ん	ば ん ね ん
お お は し	お お は し
す い こ う	す い こ う
こ う は ん	こ う は ん
か い ろ う	か い ろ う
こ う い ち	こ う い ち
ぼ う じ ん	ぼ う じ ん
お っ ぱ い	お っ ぱ い
お じ う え	お じ う え
か い ほ う	か い ほ う
き じ ゅ ん	き じ ゅ ん
と う ち ゃ ん	と う ち ゃ ん
ま ん じ ゅ う	ま ん じ ゅ う
ほ っ き ょ う	ほ っ き ょ う
へ ん し ゅ う	へ ん し ゅ う
び ょ う へ ん	び ょ う へ ん
じ ゅ ん ね ん	じ ゅ ん ね ん
だ ん ち ょ う	だ ん ち ょ う
だ い き ょ う	だ い き ょ う
ち ょ う な ん	ち ょ う な ん
げ ん り ゅ う	げ ん り ゅ う
が ん り ょ う	が ん り ょ う
こ う じ ゅ ん	こ う じ ゅ ん
は い ち ょ う	は い ち ょ う
ば ん ち ょ う	ば ん ち ょ う
じ ゅ ん な ん	じ ゅ ん な ん
お お ず も う	お お ず も う
け ん し ゅ う	け ん し ゅ う
き ょ っ こ う	き ょ っ こ う
し ゅ う ね ん	し ゅ う ね ん
し ん ぴ ょ う	し ん ぴ ょ う
し ん り ょ う	し ん り ょ う
き ゅ う げ ん	き ゅ う げ ん
し ょ う せ ん	し ょ う せ ん
い っ し ょ く	い っ し ょ く
じ ゅ う は ん	じ ゅ う は ん
り ゅ う た い	り ゅ う た い
き ょ う け ん	き ょ う け ん
ふ い ち ょ う	ふ い ち ょ う
い せ い し ゃ	い せ い し ゃ
り ょ う き ん	り ょ う き ん
で ん ぴ ょ う	で ん ぴ ょ う
す い り ょ う	す い り ょ う
べ ん し ょ う	べ ん し ょ う
ね ん し ゅ う	ね ん し ゅ う
し ん ち ゅ う	し ん ち ゅ う
じ ょ う け ん	じ ょ う け ん
か い じ ゅ う	か い じ ゅ う
り ょ っ こ う	り ょ っ こ う
り ょ う け ん	り ょ う け ん
に ゅ う た い	に ゅ う た い
し ゅ う た い	し ゅ う た い
り ょ う か い	り ょ う か い
し ょ う い ち	し ょ う い ち
じ ゅ ん こ う	じ ゅ ん こ う
は ん し ょ う	は ん し ょ う
こ う い し ょ う	こ う い し ょ う
き ょ う て ん	き ょ う て ん
さ い し ょ う	さ い し ょ う
お う り ょ く	お う り ょ く
に ゅ う ら い	に ゅ う ら い
り ん し ょ う	り ん し ょ う
つ い じ ゅ う	つ い じ ゅ う
ち ょ う せ ん	ち ょ う せ ん
ほ う お う ざ	ほ う お う ざ
だ い み ょ う	だ い み ょ う
り ょ う い き	り ょ う い き
あ ん の じ ょ う	あ ん の じ ょ う
か い り ゅ う	か い り ゅ う
ひ ょ う じ ゅ ん	ひ ょ う じ ゅ ん
り ゅ う せ い う	り ゅ う せ い う
じ ゅ ん き ょ う	じ ゅ ん き ょ う
じ ゅ ん し ょ う	じ ゅ ん し ょ う
じ ゅ ん し ゅ う	じ ゅ ん し ゅ う
し ょ っ ち ゅ う	し ょ っ ち ゅ う
お ん み ょ う じ	お ん み ょ う じ
ち ょ っ き ゅ う	ち ょ っ き ゅ う
じ ゃ っ き ゅ う	じ ゃ っ き ゅ う
じ ゅ か い	じ ゅ か い
じ ゅ う お く	じ ゅ う お く
に ゅ う か ん	に ゅ う か ん
ひ ょ う い つ	ひ ょ う い つ
き ょ う だ い	き ょ う だ い
し ゅ う か ん	し ゅ う か ん
す い じ ょ う	す い じ ょ う
き ゅ う ね ん	き ゅ う ね ん
せ ん き ゅ う	せ ん き ゅ う
き ん き ゅ う	き ん き ゅ う
ち ゅ う り ん	ち ゅ う り ん
さ ん ぎ ょ う	さ ん ぎ ょ う
ひ ょ う ざ ん	ひ ょ う ざ ん
だ ん し ょ う	だ ん し ょ う
れ ん じ ょ う	れ ん じ ょ う
け っ き ゅ う	け っ き ゅ う
は い き ょ う	は い き ょ う
は っ ち ゅ う	は っ ち ゅ う
し ょ う け ん	し ょ う け ん
ね ん じ ゅ う	ね ん じ ゅ う
ね っ き ょ う	ね っ き ょ う
じ ゅ う ぜ ん	じ ゅ う ぜ ん
は っ ぴ ょ う	は っ ぴ ょ う
は い き ゅ う	は い き ゅ う
り ゅ う い き	り ゅ う い き
ち ょ う て ん	ち ょ う て ん
じ ゅ う ざ い	じ ゅ う ざ い
さ い ち ょ う	さ い ち ょ う
ま い し ゅ う	ま い し ゅ う
ぜ ん し ょ う	ぜ ん し ょ う
し っ ち ょ う	し っ ち ょ う
ほ ん し ゅ う	ほ ん し ゅ う
さ ぎ ょ う い	さ ぎ ょ う い
ど ん ち ょ う	ど ん ち ょ う
じ ょ う げ ん	じ ょ う げ ん
た い り ゅ う	た い り ゅ う
た い し ゅ う	た い し ゅ う
し ゅ っ ぺ い	し ゅ っ ぺ い
き ょ う じ ん	き ょ う じ ん
げ ん じ ょ う	げ ん じ ょ う
し ょ う ま ん	し ょ う ま ん
し ん し ょ う	し ん し ょ う
じ ゅ う で ん	じ ゅ う で ん
じ ゅ う り ん	じ ゅ う り ん
せ ん し ゅ う	せ ん し ゅ う
か ん ち ょ う	か ん ち ょ う
じ ゅ う み ん	じ ゅ う み ん
ど う か ん	ど う か ん
じ ゅ う さ ん	じ ゅ う さ ん
し ゅ う さ ん	し ゅ う さ ん
ぶ ん し ゅ う	ぶ ん し ゅ う
ち ゅ う し ん	ち ゅ う し ん
が ん き ゅ う	が ん き ゅ う
り っ き ょ う	り っ き ょ う
き ょ う く ん	き ょ う く ん
な ん じ ゅ う	な ん じ ゅ う
し ん き ゅ う	し ん き ゅ う
が ん き ょ う	が ん き ょ う
へ ん じ ょ う	へ ん じ ょ う
じ ょ う だ ん	じ ょ う だ ん
が い ち ょ う	が い ち ょ う
せ ん じ ょ う	せ ん じ ょ う
で ん り ゅ う	で ん り ゅ う
か ん り ょ う	か ん り ょ う
し ゅ っ こ う	し ゅ っ こ う
ひ ょ う ば ん	ひ ょ う ば ん
さ っ ち ゅ う	さ っ ち ゅ う
ね ん し ょ う	ね ん し ょ う
し ょ う す い	し ょ う す い
ふ そ う お う	ふ そ う お う
ね っ ち ゅ う	ね っ ち ゅ う
ち ゅ う た い	ち ゅ う た い
せ い し ゅ ん	せ い し ゅ ん
り ょ う さ ん	り ょ う さ ん
ひ ょ う て ん	ひ ょ う て ん
し ゅ う ら い	し ゅ う ら い
お っ し ゃ る	お っ し ゃ る
す い り ゅ う	す い り ゅ う
ち ょ う へ ん	ち ょ う へ ん
ざ ん に ゅ う	ざ ん に ゅ う
え い り ょ く	え い り ょ く
ず い し ょ う	ず い し ょ う
だ い し ょ う	だ い し ょ う
せ ん き ょ う	せ ん き ょ う
ほ う じ ゅ ん	ほ う じ ゅ ん
き ん ち ょ う	き ん ち ょ う
ち ょ う か い	ち ょ う か い
ご い し ゅ う	ご い し ゅ う
り ょ う げ ん	り ょ う げ ん
ら ん ち ょ う	ら ん ち ょ う
け ん ぎ ょ う	け ん ぎ ょ う
り ん ぎ ょ う	り ん ぎ ょ う
さ っ き ゅ う	さ っ き ゅ う
さ い り ょ う	さ い り ょ う
さ い じ ょ う	さ い じ ょ う
ぶ っ き ょ う	ぶ っ き ょ う
ち ょ う だ い	ち ょ う だ い
し ゅ う ぶ ん	し ゅ う ぶ ん
ま ん り ょ う	ま ん り ょ う
ら ん ち ゅ う	ら ん ち ゅ う
し ん じ ゅ う	し ん じ ゅ う
あ ら あ ら	あ ら あ ら
き ょ う に ん	き ょ う に ん
き ゅ う き ん	き ゅ う き ん
ひ ょ う か い	ひ ょ う か い
ほ ん ち ょ う	ほ ん ち ょ う
さ ん ち ょ う	さ ん ち ょ う
し ょ う ひ ん	し ょ う ひ ん
き ゅ う す い	き ゅ う す い
じ ゅ う が い	じ ゅ う が い
れ ん し ゅ う	れ ん し ゅ う
き ょ う ね ん	き ょ う ね ん
か く お び	か く お び
あ ざ む く	あ ざ む く
あ か な す	あ か な す
し っ か り	し っ か り
し ろ ん ぼ	し ろ ん ぼ
さ く ひ ん	さ く ひ ん
か る さ ん	か る さ ん
う た ひ め	う た ひ め
お か し な	お か し な
あ の か た	あ の か た
な お さ ら	な お さ ら
ぽ ん こ つ	ぽ ん こ つ
ま る が お	ま る が お
か し こ い	か し こ い
ほ ら が い	ほ ら が い
か い け つ	か い け つ
あ わ せ る	あ わ せ る
が り べ ん	が り べ ん
い れ ず み	い れ ず ず み
た や す い	た や す い
と っ と り	と っ と り
と な え る	と な え る
い じ め る	い じ め る
か ん さ つ	か ん さ つ
は ん べ つ	は ん べ つ
お ま も り	お ま も り
か ら か う	か ら か う
い た わ る	い た わ る
ら く だ い	ら く だ い
い ぶ か る	い ぶ か る
こ く み ん	こ く み ん
な ん だ か	な ん だ か
お ろ そ か	お ろ そ か
す ば や い	す ば や い
し ん じ つ	し ん じ つ
お こ も り	お こ も り
に ほ ん ご	に ほ ん ご
い く ら か	い く ら か
さ さ え る	さ さ え る
あ か は た	あ か は た
れ つ あ く	れ つ あ く
こ い び と	こ い び と
ふ し ぜ ん	ふ し ぜ ん
い ざ な み	い ざ な み
う な が す	う な が す
さ え ず る	さ え ず る
う ら や む	う ら や む
か ん ぷ く	か ん ぷ く
ざ っ こ く	ざ っ こ く
い そ し む	い そ し む
つ い と つ	つ い と つ
う ら や み	う ら や み
た だ し い	た だ し い
か く は ん	か く は ん
い ぬ つ げ	い ぬ つ げ
ほ ほ え む	ほ ほ え む
あ や と り	あ や と り
せ っ か く	せ っ か く
あ き ぞ ら	あ き ぞ ら
さ い た ま	さ い た ま
は い た つ	は い た つ
か け ざ ん	か け ざ ん
が ん ば れ	が ん ば れ
あ ば れ る	あ ば れ る
し ん が た	し ん が た
ね ん ぶ つ	ね ん ぶ つ
ひ っ ぱ る	ひ っ ぱ る
さ え ぎ る	さ え ぎ る
か ん れ き	か ん れ き
ふ え ふ き	ふ え ふ き
さ ま よ う	さ ま よ う
か お だ し	か お だ し
ひ と ま え	ひ と ま え
の の て ん	の の て ん
さ っ か く	さ っ か く
あ く せ く	あ く せ く
し た が う	し た が う
お ま か せ	お ま か せ
い し わ た	い し わ た
な ん が つ	な ん が つ
も の お き	も の お き
た げ ん ご	た げ ん ご
あ か つ き	あ か つ き
の っ か る	の っ か る
か い た く	か い た く
ふ っ か つ	ふ っ か つ
と き お り	と き お り
お く れ げ	お く れ げ
お て な み	お て な み
ぞ っ か く	ぞ っ か く
げ つ め ん	げ つ め ん
ま か な い	ま か な い
あ わ れ み	あ わ れ み
む な し い	む な し い
あ し ば や	あ し ば や
な い じ つ	な い じ つ
く わ し い	く わ し い
た い れ つ	た い れ つ
あ け が た	あ け が た
な り ぎ ん	な り ぎ ん
く い こ む	く い こ む
ふ か か い	ふ か か い
す い そ く	す い そ く
う ら む き	う ら む き
あ な ど る	あ な ど る
あ ざ ら し	あ ざ ら し
た め ら い	た め ら い
た お や か	た お や か
ざ ぶ と ん	ざ ぶ と ん
せ つ な い	せ つ な い
の ん び り	の ん び り
と こ と ん	と こ と ん
い と な む	い と な む
た ん こ ぶ	た ん こ ぶ
う た わ り	う た わ り
お ち つ く	お ち つ く
た ん ぽ ぽ	た ん ぽ ぽ
い や が る	い や が る
い ち や く	い ち や く
お ど か す	お ど か す
あ て こ む	あ て こ む
は な び え	は な び え
に く る い	に く る い
ま ぶ し い	ま ぶ し い
お ど ろ き	お ど ろ き
か ん ぶ つ	か ん ぶ つ
が ん せ き	が ん せ き
む っ く り	む っ く り
ら ん こ く	ら ん こ く
か ん ご ふ	か ん ご ふ
は ん ぎ ご	は ん ぎ ご
か け が え	か け が え
か い さ つ	か い さ つ
お そ ら く	お そ ら く
じ ち た い	じ ち た い
し し ま い	し し ま い
し れ っ と	し れ っ と
い け ば な	い け ば な
か い げ つ	か い げ つ
く ろ う と	く ろ う と
ば ん こ く	ば ん こ く
と も あ れ	と も あ れ
し ん ち く	し ん ち く
く っ き り	く っ き り
は や べ ん	は や べ ん
つ た な い	つ た な い
お ふ く ろ	お ふ く ろ
う ち と み	う ち と み
し ろ あ り	し ろ あ り
ふ ち い し	ふ ち い し
う ろ つ く	う ろ つ く
た ゆ た う	た ゆ た う
は む か う	は む か う
ぎ ふ け ん	ぎ ふ け ん
こ く え き	こ く え き
こ ぶ う し	こ ぶ う し
ど く ぜ ん	ど く ぜ ん
ね が え り	ね が え り
げ ん ち ご	げ ん ち ご
そ ん し つ	そ ん し つ
は く さ い	は く さ い
み じ ん こ	み じ ん こ
な ん こ つ	な ん こ つ
だ い ひ つ	だ い ひ つ
つ い ば む	つ い ば む
あ み だ な	あ み だ な
む い し き	む い し き
う わ つ く	う わ つ く
ひ っ こ む	ひ っ こ む
さ い は て	さ い は て
め ん せ き	め ん せ き
お そ わ る	お そ わ る
と ま ど う	と ま ど う
い ろ づ け	い ろ づ け
し ん ぼ く	し ん ぼ く
つ ち か う	つ ち か う
し ん ぶ つ	し ん ぶ つ
し つ こ い	し つ こ い
し ん ぴ つ	し ん ぴ つ
と っ く り	と っ く り
か ん こ れ	か ん こ れ
み ん こ く	み ん こ く
け っ た く	け っ た く
ば く す い	ば く す い
じ つ げ ん	じ つ げ ん
あ り の こ	あ り の こ
さ か い め	さ か い め
ぶ っ か け	ぶ っ か け
す ん げ き	す ん げ き
あ つ ひ ろ	あ つ ひ ろ
す い さ つ	す い さ つ
あ く と く	あ く と く
ば い こ く	ば い こ く
あ や ま る	あ や ま る
ふ じ さ ん	ふ じ さ ん
か い し め	か い し め
あ き か ぜ	あ き か ぜ
た い さ く	た い さ く
か ん か じ	か ん か じ
お れ さ ま	お れ さ ま
に く へ ん	に く へ ん
み に く い	み に く い
あ れ は だ	あ れ は だ
う ら ぎ り	う ら ぎ り
は っ と り	は っ と り
か ん と く	か ん と く
お に よ め	お に よ め
い れ も の	い れ も の
じ つ だ ん	じ つ だ ん
う ず ま き	う ず ま き
げ ん こ つ	げ ん こ つ
か ん こ く	か ん こ く
ま え ぶ れ	ま え ぶ れ
わ り あ て	わ り あ て
は つ ば い	は つ ば い
か よ わ い	か よ わ い
な が い す	な が い す
い か け や	い か け や
ひ き ざ ん	ひ き ざ ん
そ び え る	そ び え る
や す う り	や す う り
す い と る	す い と る
く ろ し お	く ろ し お
さ が け ん	さ が け ん
う な ば ら	う な ば ら
な げ う つ	な げ う つ
ぬ か ば え	ぬ か ば え
ぶ さ い く	ぶ さ い く
さ か え る	さ か え る
や こ ぜ ん	や こ ぜ ん
ふ る ま い	ふ る ま い
は く ぎ ん	は く ぎ ん
み お さ め	み お さ め
き ん よ く	き ん よ く
じ ん そ く	じ ん そ く
め で た い	め で た い
ふ る え る	ふ る え る
は か な い	は か な い
さ っ ぱ り	さ っ ぱ り
ね こ す い	ね こ す い
ち り め ん	ち り め ん
あ ば ず れ	あ ば ず れ
た と え る	た と え る
し く ん し	し く ん し
は ら い せ	は ら い せ
あ か べ こ	あ か べ こ
の り か え	の り か え
が ら ん び	が ら ん び
の っ と る	の っ と る
あ つ め る	あ つ め る
き く き ん	き く き ん
こ い ぶ み	こ い ぶ み
が い す る	が い す る
あ り が と	あ り が と
が ん や く	が ん や く
つ ぐ な う	つ ぐ な う
だ ん ど り	だ ん ど り
ぼ ん や り	ぼ ん や り
ふ な よ い	ふ な よ い
か ん す る	か ん す る
み ず う ち	み ず う ち
も み あ げ	も み あ げ
ぎ も ん ふ	ぎ も ん ふ
ら く さ ん	ら く さ ん
ぶ ん ど き	ぶ ん ど き
つ い た ち	つ い た ち
う ち こ み	う ち こ み
う け も つ	う け も つ
も っ と も	も っ と も
あ と か ぶ	あ と か ぶ
あ か む つ	あ か む つ
あ た く し	あ た く し
そ ん た く	そ ん た く
あ そ び ば	あ そ び ば
お く そ こ	お く そ こ
あ ざ や か	あ ざ や か
い じ わ る	い じ わ る
し つ ね ん	し つ ね ん
と っ と と	と っ と と
か く ら ん	か く ら ん
あ ま ね く	あ ま ね く
さ く っ と	さ く っ と
い ち こ ろ	い ち こ ろ
け ん ぱ く	け ん ぱ く
て ん そ く	て ん そ く
が い こ く	が い こ く
さ ん ぷ く	さ ん ぷ く
と ぼ し い	と ぼ し い
ま な い た	ま な い た
た い り つ	た い り つ
し あ わ せ	し あ わ せ
し ぶ と い	し ぶ と い
お も む く	お も む く
つ い ら く	つ い ら く
い ま ど き	い ま ど き
ざ ん ぷ く	ざ ん ぷ く
し り う ち	し り う ち
お た と も	お た と も
ば く だ い	ば く だ い
あ ま で ら	あ ま で ら
お り が み	お り が み
わ が は い	わ が は い
ひ よ わ い	ひ よ わ い
に ん に く	に ん に く
あ や か る	あ や か る
さ く も ん	さ く も ん
か い ぞ く	か い ぞ く
つ ゆ あ け	つ ゆ あ け
き ん け り	き ん け り
あ と が き	あ と が き
ぶ ん か つ	ぶ ん か つ
か か え る	か か え る
こ っ こ く	こ っ こ く
あ ま ぐ も	あ ま ぐ も
た お れ る	た お れ る
そ な え る	そ な え る
つ か え る	つ か え る
お か ざ わ	お か ざ わ
ば つ ぐ ん	ば つ ぐ ん
て ん ぷ ら	て ん ぷ ら
め し か え	め し か え
と ふ ざ い	と ふ ざ い
げ ん し ろ	げ ん し ろ
う わ ご と	う わ ご と
う わ が き	う わ が き
ふ ま え る	ふ ま え る
ま ち が う	ま ち が う
い ま だ に	い ま だ に
み み あ て	み み あ て
い た だ く	い た だ く
は や ば ん	は や ば ん
と と の う	と と の う
ば い き ゃ く	ば い き ゃ く
か っ ぽ う ぎ	か っ ぽ う ぎ
し ん ち ょ く	し ん ち ょ く
き ん し ゅ く	き ん し ゅ く
し ゅ ん せ つ	し ゅ ん せ つ
し ゅ ん じ つ	し ゅ ん じ つ
お お わ ら わ	お お わ ら わ
も う こ う ま	も う こ う ま
す い り ょ く	す い り ょ く
そ う こ ば ん	そ う こ ば ん
ら せ ん け い	ら せ ん け い
か い ぞ う ど	か い ぞ う ど
う る わ し い	う る わ し い
し ん ご う き	し ん ご う き
け っ と う ち	け っ と う ち
こ ん じ ゃ く	こ ん じ ゃ く
さ い し ょ く	さ い し ょ く
お ろ か し い	お ろ か し い
ま ん ま る い	ま ん ま る い
む か ん ど う	む か ん ど う
じ ゅ く み ん	じ ゅ く み ん
し ょ く ざ い	し ょ く ざ い
ひ ょ う ご け ん	ひ ょ う ご け ん
ば た ん き ゅ う	ば た ん き ゅ う
ど う こ う か い	ど う こ う か い
え い せ い と し	え い せ い と し
ご ぜ ん ち ゅ う	ご ぜ ん ち ゅ う
か え ん び ん	か え ん び ん
か ん き こ う	か ん き こ う
が い り ゃ く	が い り ゃ く
じ ゅ ん け つ	じ ゅ ん け つ
き ん り ょ く	き ん り ょ く
か い し ょ く	か い し ょ く
あ っ け な い	あ っ け な い
こ し ょ ば い	こ し ょ ば い
に り ん し ゃ	に り ん し ゃ
い い か げ ん	い い か げ ん
ま て ん ろ う	ま て ん ろ う
い い こ な す	い い こ な す
さ ん ま い め	さ ん ま い め
だ ん し ょ く	だ ん し ょ く
し し ゃ か い	し し ゃ か い
ば ん ぺ い ゆ	ば ん ぺ い ゆ
し ゅ つ る い	し ゅ つ る い
し ょ く が ん	し ょ く が ん
こ ん し ょ く	こ ん し ょ く
だ い く ん い	だ い く ん い
け ん お ん き	け ん お ん き
ほ い く え ん	ほ い く え ん
そ ん し ょ く	そ ん し ょ く
ひ こ う せ ん	ひ こ う せ ん
ご い り ょ く	ご い り ょ く
か わ い そ う	か わ い そ う
と ざ ん し ゃ	と ざ ん し ゃ
あ く し ゅ み	あ く し ゅ み
り っ こ う ほ	り っ こ う ほ
ご り ん と う	ご り ん と う
に り ん そ う	に り ん そ う
き か い せ い	き か い せ い
す い じ ゃ く	す い じ ゃ く
ら っ か せ い	ら っ か せ い
だ い ほ っ さ	だ い ほ っ さ
せ ん く し ゃ	せ ん く し ゃ
お し ゃ ぶ り	お し ゃ ぶ り
う け い れ る	う け い れ る
ち ゃ く す い	ち ゃ く す い
し ん ち ゃ く	し ん ち ゃ く
か っ さ ら う	か っ さ ら う
ひ さ い し ゃ	ひ さ い し ゃ
ご よ う ろ ん	ご よ う ろ ん
あ っ た か い	あ っ た か い
し ゃ く い ち	し ゃ く い ち
ば ん こ う ば	ば ん こ う ば
た い よ う け い	た い よ う け い
た い り ょ く	た い り ょ く
ひ ゃ く ま ん	ひ ゃ く ま ん
ち ょ っ か く	ち ょ っ か く
げ ん し ゅ つ	げ ん し ゅ つ
し ん し お ん	し ん し お ん
ひ ゃ く せ ん	ひ ゃ く せ ん
し ん き ろ う	し ん き ろ う
も う こ は ん	も う こ は ん
げ ん と う き	げ ん と う き
さ っ か し ょ う	さ っ か し ょ う
さ ん じ ょ う き	さ ん じ ょ う き
り ょ う じ か ん	り ょ う じ か ん
う っ と う し い	う っ と う し い
か ん れ い し ゃ	か ん れ い し ゃ
う ら び ょ う し	う ら び ょ う し
そ う い く ふ う	そ う い く ふ う
ち ょ う じ か ん	ち ょ う じ か ん
だ い き ゅ う し	だ い き ゅ う し
ゆ う ど う だ ん	ゆ う ど う だ ん
ぶ っ し ゅ か ん	ぶ っ し ゅ か ん
こ う く う び ん	こ う く う び ん
が い む し ょ う	が い む し ょ う
け ん じ ょ う ご	け ん じ ょ う ご
こ う い っ て ん	こ う い っ て ん
い ん よ う す い	い ん よ う す い
だ い じ ょ う ぶ	だ い じ ょ う ぶ
せ ん け い せ い	せ ん け い せ い
さ ん じ ゅ う し	さ ん じ ゅ う し
じ ん ば き ゅ う	じ ん ば き ゅ う
き ち ょ う め ん	き ち ょ う め ん
し ゅ う え き か	し ゅ う え き か
じ ょ そ う ざ い	じ ょ そ う ざ い
の う さ い ぼ う	の う さ い ぼ う
よ う が っ こ う	よ う が っ こ う
ほ う す い ほ う	ほ う す い ほ う
せ い さ ん え ん	せ い さ ん え ん
く ん し ゅ せ い	く ん し ゅ せ い
え ん そ う か い	え ん そ う か い
こ う て ん せ い	こ う て ん せ い
わ せ い え い ご	わ せ い え い ご
し ょ う か た い	し ょ う か た い
か い き ょ う と	か い き ょ う と
し ょ う が な い	し ょ う が な い
さ っ ぷ う け い	さ っ ぷ う け い
の う ど う た い	の う ど う た い
け ん ぎ ゅ う か	け ん ぎ ゅ う か
あ げ は ち ょ う	あ げ は ち ょ う
こ う せ い ざ い	こ う せ い ざ い
し ょ う ね ん ば	し ょ う ね ん ば
に じ ゅ う い ち	に じ ゅ う い ち
ひ ょ う ぎ か い	ひ ょ う ぎ か い
さ い し ゅ う び	さ い し ゅ う び
は ち ゅ う る い	は ち ゅ う る い
さ い こ う せ い	さ い こ う せ い
じ ょ う ま え や	じ ょ う ま え や
せ い い っ ぱ い	せ い い っ ぱ い
と う め い た い	と う め い た い
ひ ゃ っ か せ い	ひ ゃ っ か せ い
は っ け し ょ う	は っ け し ょ う
て ん が じ ゅ う	て ん が じ ゅ う
に っ き ち ょ う	に っ き ち ょ う
に じ ゅ う さ ん	に じ ゅ う さ ん
こ う け っ と う	こ う け っ と う
ぼ う え き ふ う	ぼ う え き ふ う
だ い お う い か	だ い お う い か
じ ゅ う で ん き	じ ゅ う で ん き
か い し ゃ い ん	か い し ゃ い ん
す い ろ き ょ う	す い ろ き ょ う
た か ん し ょ う	た か ん し ょ う
し ょ う か せ ん	し ょ う か せ ん
だ い き ぎ ょ う	だ い き ぎ ょ う
ひ ょ う が い じ	ひ ょ う が い じ
あ い ぞ う ば ん	あ い ぞ う ば ん
ま し ょ う め ん	ま し ょ う め ん
み し ょ う ぶ ん	み し ょ う ぶ ん
よ じ ょ う は ん	よ じ ょ う は ん
ど う そ う か い	ど う そ う か い
は っ ぽ う し ゅ	は っ ぽ う し ゅ
じ ょ う た い か	じ ょ う た い か
か ん せ い け い	か ん せ い け い
べ ん ぎ じ ょ う	べ ん ぎ じ ょ う
じ ゅ う す い そ	じ ゅ う す い そ
ど う そ じ ん	ど う そ じ ん
ほ う し ゃ せ ん	ほ う し ゃ せ ん
ち ゅ う か ん し	ち ゅ う か ん し
へ ん と う え ん	へ ん と う え ん
ゆ う め い じ ん	ゆ う め い じ ん
ゆ う け ん し ゃ	ゆ う け ん し ゃ
い ら っ し ゃ る	い ら っ し ゃ る
と お せ ん ぼ う	と お せ ん ぼ う
き ょ う ぎ か い	き ょ う ぎ か い
そ う ぞ う し い	そ う ぞ う し い
は い れ つ	は い れ つ
あ こ が れ	あ こ が れ
き た な い	き た な い
よ こ ぶ え	よ こ ぶ え
き ぬ い と	き ぬ い と
し ら ぬ い	し ら ぬ い
う つ む く	う つ む く
み な さ ん	み な さ ん
せ っ か ち	せ っ か ち
ち び っ こ	ち び っ こ
ね っ か ら	ね っ か ら
な か い ま	な か い ま
は い せ き	は い せ き
か い か く	か い か く
ず ぶ と い	ず ぶ と い
や く ぶ ん	や く ぶ ん
は ご い た	は ご い た
さ か ら う	さ か ら う
て つ だ う	て つ だ う
あ だ ば な	あ だ ば な
は ら ば い	は ら ば い
つ き ん ぼ う	つ き ん ぼ う
た い ぎ ゃ く	た い ぎ ゃ く
ぶ っ ち ゃ け	ぶ っ ち ゃ け
こ ん に ゃ く	こ ん に ゃ く
び ん な ん ご	び ん な ん ご
け ん じ ゅ つ	け ん じ ゅ つ
お め で と う	お め で と う
ふ と う え き	ふ と う え き
わ か ん な い	わ か ん な い
せ っ け い ず	せ っ け い ず
け い た い そ	け い た い そ
む か え る	む か え る
き か ん し ゃ	き か ん し ゃ
か ん じ ゅ く	か ん じ ゅ く
か い へ い き	か い へ い き
ぜ っ ぺ き	ぜ っ ぺ き
み な お す	み な お す
こ ま ぶ え	こ ま ぶ え
い て つ く	い て つ く
か い こ く	か い こ く
か し か ん	か し か ん
い し だ て	い し だ て
い か れ る	い か れ る
お に ぎ り	お に ぎ り
か く す い	か く す い
う ち が け	う ち が け
と っ く に	と っ く に
よ い や み	よ い や み
が た お ち	が た お ち
た い ば つ	た い ば つ
か っ ぱ つ	か っ ぱ つ
か り う た	か り う た
や け あ と	や け あ と
だ み ご え	だ み ご え
か や き ん	か や き ん
あ れ こ れ	あ れ こ れ
は じ ら う	は じ ら う
ば ん ぶ つ	ば ん ぶ つ
ざ ん こ く	ざ ん こ く
め ん ど り	め ん ど り
あ し も と	あ し も と
ほ ん わ か	ほ ん わ か
か ん か つ	か ん か つ
て ぬ ぐ い	て ぬ ぐ い
そ こ な う	そ こ な う
か え で か	か え で か
な い み つ	な い み つ
え だ ま め	え だ ま め
は く し ん	は く し ん
に ん ち ど	に ん ち ど
ば っ ち り	ば っ ち り
ま き ぞ え	ま き ぞ え
い や ら し い	い や ら し い
よ く あ つ	よ く あ つ
や っ ぱ り	や っ ぱ り
あ か が み	あ か が み
が く ぜ ん	が く ぜ ん
い し か り	い し か り
き ず あ と	き ず あ と
と く し ん	と く し ん
み ん ぞ く	み ん ぞ く
こ ん せ つ	こ ん せ つ
い け ん ら ん	い け ん ら ん
ぐ ん ま け ん	ぐ ん ま け ん
せ っ と う ご	せ っ と う ご
ぶ ど う だ ん	ぶ ど う だ ん
し ょ く か ん	し ょ く か ん
ち て い じ ん	ち て い じ ん
じ ゅ ん た く	じ ゅ ん た く
ぜ ん せ い き	ぜ ん せ い き
が っ き ょ く	が っ き ょ く
け ん じ ろ う	け ん じ ろ う
じ せ い し ん	じ せ い し ん
し ん し ょ く	し ん し ょ く
ぎ ぜ ん し ゃ	ぎ ぜ ん し ゃ
さ い ほ う し	さ い ほ う し
ぶ が い し ゃ	ぶ が い し ゃ
し ょ く に ん	し ょ く に ん
へ ん き ょ く	へ ん き ょ く
し せ き え い	し せ き え い
し ょ く わ ん	し ょ く わ ん
ゆ う き た い	ゆ う き た い
に ほ ん と う	に ほ ん と う
は か い し ゃ	は か い し ゃ
あ ん ざ ん し	あ ん ざ ん し
も ん ち ゃ く	も ん ち ゃ く
か ん そ う き	か ん そ う き
だ ん り ょ く	だ ん り ょ く
ぬ ん ち ゃ く	ぬ ん ち ゃ く
お ん な も の	お ん な も の
に る い し ゅ	に る い し ゅ
こ う い し つ	こ う い し つ
ね ん し ゅ つ	ね ん し ゅ つ
ち ん せ い か	ち ん せ い か
ほ う い か く	ほ う い か く
か ん し ょ く	か ん し ょ く
す い ち ょ く	す い ち ょ く
せ い ぞ ろ い	せ い ぞ ろ い
し へ ん け い	し へ ん け い
お ん な の こ	お ん な の こ
う で ず も う	う で ず も う
お し ゃ べ り	お し ゃ べ り
ち ん じ ゅ つ	ち ん じ ゅ つ
げ ん き ょ く	げ ん き ょ く
こ う ば し い	こ う ば し い
し ょ じ に ん	し ょ じ に ん
に ほ ん し ゅ	に ほ ん し ゅ
し ゃ だ ん き	し ゃ だ ん き
こ う き あ つ	こ う き あ つ
き っ さ て ん	き っ さ て ん
し ぎ ん え ん	し ぎ ん え ん
い ま わ し い	い ま わ し い
ほ ん き ょ く	ほ ん き ょ く
ち ょ く め ん	ち ょ く め ん
ぶ ん こ う き	ぶ ん こ う き
お っ ぱ ら う	お っ ぱ ら う
ふ だ ん そ う	ふ だ ん そ う
い い な ず け	い い な ず け
ひ こ う し ん	ひ こ う し ん
じ み ん と う	じ み ん と う
か が い し ゃ	か が い し ゃ
い そ が し い	い そ が し い
お ち ん ち ん	お ち ん ち ん
く っ き ょ く	く っ き ょ く
よ う で ん き	よ う で ん き
あ り が と う	あ り が と う
で ん ど う し	で ん ど う し
ひ げ ん す う	ひ げ ん す う
お と な し い	お と な し い
き ん ち ゃ く	き ん ち ゃ く
み し ん じ ゃ	み し ん じ ゃ
く る お し い	く る お し い
か ん よ う ご	か ん よ う ご
せ い が い ふ	せ い が い ふ
ひ け ん し ゃ	ひ け ん し ゃ
ひ っ か く	ひ っ か く
か ざ ん と う	か ざ ん と う
ふ か い お ん	ふ か い お ん
し ゅ っ ぱ つ	し ゅ っ ぱ つ
し ぜ ん す う	し ぜ ん す う
あ め も よ う	あ め も よ う
う こ ん い ろ	う こ ん い ろ
き ょ く げ ん	き ょ く げ ん
う だ い じ ん	う だ い じ ん
ば ん か じ ゅ	ば ん か じ ゅ
か つ え き	か つ え き
ひ ん こ く	ひ ん こ く
か い せ つ	か い せ つ
せ っ と く	せ っ と く
や き い も	や き い も
あ か る む	あ か る む
べ つ あ か	べ つ あ か
は く ら い	は く ら い
ま る み え	ま る み え
い ま さ ら	い ま さ ら
た ま の お	た ま の お
し だ い に	し だ い に
さ い さ つ	さ い さ つ
こ く が い	こ く が い
な ん ぼ く	な ん ぼ く
て つ び ん	て つ び ん
な ん ご く	な ん ご く
す ず ら ん	す ず ら ん
ま か な う	ま か な う
お め か し	お め か し
は い せ つ	は い せ つ
げ ん か く	げ ん か く
く わ え る	く わ え る
お や す み	お や す み
こ づ か い	こ づ か い
き ん じ つ	き ん じ つ
ぶ り っ こ	ぶ り っ こ
に く し ん	に く し ん
ど ん ぶ り	ど ん ぶ り
す く な い	す く な い
せ ん て つ	せ ん て つ
い わ ゆ る	い わ ゆ る
あ み も の	あ み も の
ざ ん が く	ざ ん が く
ま ば ゆ い	ま ば ゆ い
と ぎ か い	と ぎ か い
ば く え き	ば く え き
て っ き り	て っ き り
は く が ん	は く が ん
で そ ろ う	で そ ろ う
わ く せ ん	わ く せ ん
あ て に げ	あ て に げ
げ き だ ん	げ き だ ん
が ん が れ	が ん が れ
き ん て き	き ん て き
う そ ひ め	う そ ひ め
ひ か え め	ひ か え め
し ん ぷ く	し ん ぷ く
あ す な ろ	あ す な ろ
え き が く	え き が く
す っ き り	す っ き り
で ん た つ	で ん た つ
や っ ぱ し	や っ ぱ し
こ ん や く	こ ん や く
か な し い	か な し い
い き な り	い き な り
に お わ す	に お わ す
う ま ぬ し	う ま ぬ し
た っ ぴ つ	た っ ぴ つ
う か べ る	う か べ る
す い ろ く	す い ろ く
あ ら ゆ る	あ ら ゆ る
く み は ん	く み は ん
い わ ほ り	い わ ほ り
は い ざ ら	は い ざ ら
た だ よ う	た だ よ う
つ く ろ う	つ く ろ う
あ か は な	あ か は な
せ ん せ き	せ ん せ き
う た た ね	う た た ね
い ろ ざ と	い ろ ざ と
あ く に ち	あ く に ち
か ん ご し	か ん ご し
あ ご ひ げ	あ ご ひ げ
ふ っ く ら	ふ っ く ら
で ん げ き	で ん げ き
そ く い き	そ く い き
し ん ど く	し ん ど く
お ぶ さ る	お ぶ さ る
ひ あ が る	ひ あ が る
め ん し き	め ん し き
ば ん ぐ み	ば ん ぐ み
あ つ ま る	あ つ ま る
ん と す る	ん と す る
も の お と	も の お と
し ん ぱ く	し ん ぱ く
よ ろ し い	よ ろ し い
き り ん じ	き り ん じ
は や お し	は や お し
う け と る	う け と る
ご く あ く	ご く あ く
し あ が り	し あ が り
か ん ぺ き	か ん ぺ き
し み い る	し み い る
あ さ く ら	あ さ く ら
こ ん ぜ つ	こ ん ぜ つ
こ く れ ん	こ く れ ん
ば く し ん	ば く し ん
は っ き り	は っ き り
た て ぶ え	た て ぶ え
し ま っ た	し ま っ た
が い こ つ	が い こ つ
あ ず ま や	あ ず ま や
い ま か れ	い ま か れ
ま っ く ら	ま っ く ら
あ さ ひ る	あ さ ひ る
か な え る	か な え る
ま い に ち	ま い に ち
よ し あ き	よ し あ き
ほ く し ん	ほ く し ん
い の し し	い の し し
さ わ ら ん	さ わ ら ん
か り ち ん	か り ち ん
し ん そ つ	し ん そ つ
お く れ る	お く れ る
こ く じ ん	こ く じ ん
さ ん し た	さ ん し た
ほ く だ い	ほ く だ い
ま っ く ろ	ま っ く ろ
あ ら ぶ る	あ ら ぶ る
こ な い だ	こ な い だ
あ め だ ま	あ め だ ま
ざ い に ち	ざ い に ち
や さ し い	や さ し い
い な な く	い な な く
い ち じ く	い ち じ く
か き あ げ	か き あ げ
い ら つ こ	い ら つ こ
お さ め る	お さ め る
な が い き	な が い き
か い だ く	か い だ く
き か え る	き か え る
け わ し い	け わ し い
し っ か く	し っ か く
く わ え て	く わ え て
げ ん こ く	げ ん こ く
い く ば く	い く ば く
ど ん よ り	ど ん よ り
お さ が め	お さ が め
な か お れ	な か お れ
と ら え る	と ら え る
な ん く せ	な ん く せ
あ な ど り	あ な ど り
は が ゆ い	は が ゆ い
つ っ こ む	つ っ こ む
い り こ む	い り こ む
め っ き り	め っ き り
は つ げ ん	は つ げ ん
で ん と つ	で ん と つ
お そ れ る	お そ れ る
た た か い	た た か い
つ っ ぱ り	つ っ ぱ り
ゆ わ え る	ゆ わ え る
ど さ ん こ	ど さ ん こ
ざ ん と く	ざ ん と く
し お か ら	し お か ら
う ち け す	う ち け す
つ い や す	つ い や す
お さ ま る	お さ ま る
じ つ ざ い	じ つ ざ い
な い か く	な い か く
さ い げ つ	さ い げ つ
き り ん ざ	き り ん ざ
お し き る	お し き る
お ひ さ ま	お ひ さ ま
た い じ や	た い じ や
く っ ぷ く	く っ ぷ く
げ ん げ つ	げ ん げ つ
り ん せ つ	り ん せ つ
あ ら す じ	あ ら す じ
か ん た く	か ん た く
い つ わ る	い つ わ る
あ け ぼ の	あ け ぼ の
そ ん ら く	そ ん ら く
か ぎ っ こ	か ぎ っ こ
し ん さ つ	し ん さ つ
れ っ き と	れ っ き と
よ つ ば い	よ つ ば い
め の ま え	め の ま え
お と め ざ	お と め ざ
は な う た	は な う た
う わ づ み	う わ づ み
く ん よ み	く ん よ み
お か し や	お か し や
ひ え き る	ひ え き る
あ ふ れ る	あ ふ れ る
と つ ぜ ん	と つ ぜ ん
し つ げ ん	し つ げ ん
へ っ ぽ こ	へ っ ぽ こ
あ や ぶ む	あ や ぶ む
お ど ろ く	お ど ろ く
き ん に く	き ん に く
さ つ が い	さ つ が い
こ く ば ん	こ く ば ん
ふ く じ ん	ふ く じ ん
む ち う つ	む ち う つ
き え さ る	き え さ る
ど ぶ い た	ど ぶ い た
ほ と ん ど	ほ と ん ど
は げ し い	は げ し い
ま す ら お	ま す ら お
き は ん じ	き は ん じ
だ い や く	だ い や く
せ き ぐ ん	せ き ぐ ん
う ち が わ	う ち が わ
た い せ き	た い せ き
た く さ ん	た く さ ん
こ く す い	こ く す い
が い は く	が い は く
あ や め る	あ や め る
ぶ ん せ き	ぶ ん せ き
こ た え る	こ た え る
い つ わ り	い つ わ り
お と わ れ	お と わ れ
さ ん ぶ つ	さ ん ぶ つ
す い こ む	す い こ む
き ん せ つ	き ん せ つ
よ く あ さ	よ く あ さ
は く ま い	は く ま い
き び し い	き び し い
か ぞ え る	か ぞ え る
つ い せ き	つ い せ き
ま ん き つ	ま ん き つ
み あ き る	み あ き る
う ち も も	う ち も も
さ つ い れ	さ つ い れ
な い そ ふ	な い そ ふ
ち が え る	ち が え る
げ ん つ き	げ ん つ き
ち ば け ん	ち ば け ん
ね つ け ん	ね つ け ん
ひ き い る	ひ き い る
ひ ん や り	ひ ん や り
こ こ ろ え	こ こ ろ え
い つ し か	い つ し か
か い じ つ	か い じ つ
つ っ こ み	つ っ こ み
ら ん ぱ つ	ら ん ぱ つ
し ん や く	し ん や く
さ い せ き	さ い せ き
も っ ぱ ら	も っ ぱ ら
め す い ぬ	め す い ぬ
も だ え る	も だ え る
こ ん ぺ き	こ ん ぺ き
ふ る ま う	ふ る ま う
ま え だ て	ま え だ て
さ ん さ く	さ ん さ く
と っ こ つ	と っ こ つ
し ん せ つ	し ん せ つ
か ざ あ な	か ざ あ な
き た え る	き た え る
お き ぬ け	お き ぬ け
た ん ぱ く	た ん ぱ く
こ っ か ら	こ っ か ら
ふ ら ん き	ふ ら ん き
こ ご え る	こ ご え る
に く ま ん	に く ま ん
な む さ ん	な む さ ん
め が な い	め が な い
に じ か い	に じ か い
た め ら う	た め ら う
い き も の	い き も の
お も ね る	お も ね る
ぞ ん じ る	ぞ ん じ る
お だ て る	お だ て る
あ が め る	あ が め る
さ い す る	さ い す る
せ っ ぱ く	せ っ ぱ く
か く だ い	か く だ い
せ ん べ つ	せ ん べ つ
す っ か り	す っ か り
か ん ぼ つ	か ん ぼ つ
う つ そ み	う つ そ み
け ん さ つ	け ん さ つ
ど っ か ら	ど っ か ら
お だ や か	お だ や か
た う な ぎ	た う な ぎ
す い ば く	す い ば く
た た か う	た た か う
び っ く り	び っ く り
あ ら か た	あ ら か た
し は ら い	し は ら い
あ わ て る	あ わ て る
か の う ば	か の う ば
き あ ん こ う	き あ ん こ う
じ ょ う ぎ ざ	じ ょ う ぎ ざ
し ょ う せ つ	し ょ う せ つ
ち ゅ ん て ん	ち ゅ ん て ん
ぞ く し ょ う	ぞ く し ょ う
ざ っ し ょ く	ざ っ し ょ く
に ゅ う か く	に ゅ う か く
さ ん る い	さ ん る い
さ っ さ と	さ っ さ と
う る さ い	う る さ い
ふ く ろ う	ふ く ろ う
じ し ょ け い	じ し ょ け い
ど う い た い	ど う い た い
し ょ っ ぱ い	し ょ っ ぱ い
ふ う り ょ く	ふ う り ょ く
じ ょ う ね つ	じ ょ う ね つ
ぎ ゃ ん な き	ぎ ゃ ん な き
ち ゃ ん ぽ ん	ち ゃ ん ぽ ん
お ん ど け い	お ん ど け い
ち ょ っ か ん	ち ょ っ か ん
や そ き ょ う	や そ き ょ う
か っ こ い い	か っ こ い い
ご う ど う し	ご う ど う し
と く ど う	と く ど う
か い め ん	か い め ん
み え み え	み え み え
い ん が し	い ん が し
ゆ い し ん	ゆ い し ん
ま ち あ い	ま ち あ い
う た ご え	う た ご え
ど う し て	ど う し て
つ う こ く	つ う こ く
た い か い	た い か い
た い さ ん	た い さ ん
し ょ せ き	し ょ せ き
い ち ご ん	い ち ご ん
ね ん か ん	ね ん か ん
す い さ い	す い さ い
ぜ つ え ん	ぜ つ え ん
け び い し	け び い し
ば き ゃ く	ば き ゃ く
た ん こ ん	た ん こ ん
ば く お ん	ば く お ん
い ん れ き	い ん れ き
そ う ど く	そ う ど く
あ い つ ら	あ い つ ら
か ら あ げ	か ら あ げ
は ち じ ゅ う	は ち じ ゅ う
じ ょ う や く	じ ょ う や く
ぶ ん み ゃ く	ぶ ん み ゃ く
し ゅ ん か ん	し ゅ ん か ん
け い ほ う き	け い ほ う き
に じ ゅ う ご	に じ ゅ う ご
よ う じ ゅ つ	よ う じ ゅ つ
ち ゃ い ろ い	ち ゃ い ろ い
そ く り ょ う	そ く り ょ う
か く ぎ ょ う	か く ぎ ょ う
ぎ じ ょ う ご	ぎ じ ょ う ご
き ゅ う し き	き ゅ う し き
ゆ う え ん ち	ゆ う え ん ち
て い ち ゃ く	て い ち ゃ く
い と お し い	い と お し い
ふ ろ う し ゃ	ふ ろ う し ゃ
お ち ゃ だ い	お ち ゃ だ い
か っ そ う ろ	か っ そ う ろ
が く し ょ う	が く し ょ う
ち ゅ う ご く	ち ゅ う ご く
か て い け い	か て い け い
そ り ゅ う し	そ り ゅ う し
ほ う し ゅ つ	ほ う し ゅ つ
の う り ょ く	の う り ょ く
じ ゅ う ぞ く	じ ゅ う ぞ く
え ん せ い か	え ん せ い か
し ょ く ど う	し ょ く ど う
ご う が し ゃ	ご う が し ゃ
し せ い ど う	し せ い ど う
き ょ く と う	き ょ く と う
よ う し ょ く	よ う し ょ く
し ぼ う こ う	し ぼ う こ う
か じ ゅ え ん	か じ ゅ え ん
し し き ゅ う	し し き ゅ う
ち ゃ く せ い	ち ゃ く せ い
そ つ に ゅ う	そ つ に ゅ う
ぶ あ い そ う	ぶ あ い そ う
さ く ち ょ う	さ く ち ょ う
ぜ つ み ょ う	ぜ つ み ょ う
か く ち ょ う	か く ち ょ う
ど く し ょ う	ど く し ょ う
し ゅ ん げ ん	し ゅ ん げ ん
た ん い け い	た ん い け い
じ ゅ う し ち	じ ゅ う し ち
せ い し ゅ く	せ い し ゅ く
お ん な が お	お ん な が お
ち ょ う て き	ち ょ う て き
し ゅ ん ま く	し ゅ ん ま く
か く の う	か く の う
よ く よ う	よ く よ う
せ ん げ ん	せ ん げ ん
い く ぶ ん	い く ぶ ん
ほ う む る	ほ う む る
う み う ま	う み う ま
は っ か い	は っ か い
せ っ け ん	せ っ け ん
あ る あ る	あ る あ る
し ゃ ば く	し ゃ ば く
は ん だ い	は ん だ い
こ っ く ん	こ っ く ん
ひ ん ぱ ん	ひ ん ぱ ん
き ょ は く	き ょ は く
み え け ん	み え け ん
し ん で ん	し ん で ん
そ う じ ふ	そ う じ ふ
ら く よ う	ら く よ う
き ん い ろ	き ん い ろ
さ だ あ き	さ だ あ き
り く そ う	り く そ う
ほ っ そ り	ほ っ そ り
あ い ふ く	あ い ふ く
せ ん た ん	せ ん た ん
み と お す	み と お す
に ょ じ つ	に ょ じ つ
ま け い ぬ	ま け い ぬ
ぼ う び き	ぼ う び き
ど う ぶ つ	ど う ぶ つ
そ ん が い	そ ん が い
し ち せ い	し ち せ い
よ う ず み	よ う ず み
し ん ぺ ん	し ん ぺ ん
え ん か く	え ん か く
と う ま つ	と う ま つ
ぶ っ せ つ	ぶ っ せ つ
と ら ぞ う	と ら ぞ う
ふ じ ゆ う	ふ じ ゆ う
ひ つ よ う	ひ つ よ う
お い つ く	お い つ く
た い ざ い	た い ざ い
あ い く ち	あ い く ち
わ く せ い	わ く せ い
と し う え	と し う え
せ い さ く	せ い さ く
そ ん か い	そ ん か い
じ っ け ん	じ っ け ん
ほ お ず き	ほ お ず き
じ ん せ ん	じ ん せ ん
ど う じ る	ど う じ る
ぞ う が め	ぞ う が め
は い め ん	は い め ん
こ う ふ く	こ う ふ く
さ い し ん	さ い し ん
う で ま え	う で ま え
す っ ぱ い	す っ ぱ い
け ん し ん	け ん し ん
す ず し い	す ず し い
ぐ っ す り	ぐ っ す り
こ む そ う	こ む そ う
ぶ っ た い	ぶ っ た い
ぶ よ う か	ぶ よ う か
も く と う	も く と う
そ ん だ い	そ ん だ い
ゆ う す け	ゆ う す け
か い た い	か い た い
し ん か い	し ん か い
え つ ら ん	え つ ら ん
ち ん も く	ち ん も く
は つ れ い	は つ れ い
う き う き	う き う き
ち り ゃ く	ち り ゃ く
だ ん せ ん	だ ん せ ん
ひ っ さ つ	ひ っ さ つ
き り ょ く	き り ょ く
う る お す	う る お す
す い げ ん	す い げ ん
あ お ぎ り	あ お ぎ り
じ ん ぶ ん	じ ん ぶ ん
せ ん ば い	せ ん ば い
こ く え ん	こ く え ん
し ゅ ぞ く	し ゅ ぞ く
か ん な ぎ	か ん な ぎ
こ お り や	こ お り や
け い じ か	け い じ か
せ ん め つ	せ ん め つ
た ん ま つ	た ん ま つ
び ん か ん	び ん か ん
せ い や く	せ い や く
う た い て	う た い て
け い べ つ	け い べ つ
う ん ち く	う ん ち く
め い じ る	め い じ る
あ い つ ぐ	あ い つ ぐ
え ん た く	え ん た く
り ゅ う た ろ う	り ゅ う た ろ う
あ ん な い し ょ	あ ん な い し ょ
い ち ゃ い ち ゃ	い ち ゃ い ち ゃ
え い い ん ぼ ん	え い い ん ぼ ん
ほ う こ う せ い	ほ う こ う せ い
せ い よ う ふ う	せ い よ う ふ う
わ よ う ち ゅ う	わ よ う ち ゅ う
と う ち ょ う き	と う ち ょ う き
う ち ゅ う じ ん	う ち ゅ う じ ん
ほ し ゅ う こ う	ほ し ゅ う こ う
あ お げ い と う	あ お げ い と う
ち ゅ う し ょ く	ち ゅ う し ょ く
じ ょ う む い ん	じ ょ う む い ん
こ う ご う せ い	こ う ご う せ い
い ん と う お ん	い ん と う お ん
と う き ょ う と	と う き ょ う と
け い し ち ょ う	け い し ち ょ う
と う ぼ う し ゃ	と う ぼ う し ゃ
い ら っ し ゃ い	い ら っ し ゃ い
ち ょ う お ん ぷ	ち ょ う お ん ぷ
け い り ゅ う し	け い り ゅ う し
し ゅ う ど う ふ	し ゅ う ど う ふ
し ょ く ち ゅ う	し ょ く ち ゅ う
と う せ い ふ う	と う せ い ふ う
ゆ う し ょ く	ゆ う し ょ く
も く ひ ょ う	も く ひ ょ う
み ょ う せ き	み ょ う せ き
と け い そ う	と け い そ う
ぎ ゅ う じ る	ぎ ゅ う じ る
し ょ う せ き	し ょ う せ き
じ ゃ く し ゃ	じ ゃ く し ゃ
お お じ し ん	お お じ し ん
お う ご ん ひ	お う ご ん ひ
り く ち ゅ う	り く ち ゅ う
お か あ さ ん	お か あ さ ん
に ゅ う せ き	に ゅ う せ き
ぎ ょ う し ゅ く	ぎ ょ う し ゅ く
は く じ ょ う	は く じ ょ う
り よ う し ゃ	り よ う し ゃ
ふ く し ゅ う	ふ く し ゅ う
り ょ う と り	り ょ う と り
し ょ う ぞ く	し ょ う ぞ く
し ゃ っ き ん	し ゃ っ き ん
ひ じ ょ う す う	ひ じ ょ う す う
り て い ひ ょ う	り て い ひ ょ う
り ゅ う き ょ く	り ゅ う き ょ く
ひ ゃ く じ ゅ う	ひ ゃ く じ ゅ う
ど う せ い あ い	ど う せ い あ い
じ ゅ う て い お ん	じ ゅ う て い お ん
ほ う ろ う し ゃ	ほ う ろ う し ゃ
し ん ち ょ う い	し ん ち ょ う い
か ん み り ょ う	か ん み り ょ う
じ ょ う し ょ く	じ ょ う し ょ く
う い う い し い	う い う い し い
し し ゅ う び ょ う	し し ゅ う び ょ う
む じ ゅ う り ょ う	む じ ゅ う り ょ う
し ゅ う ど う し ゃ	し ゅ う ど う し ゃ
そ う ぎ ょ き ゅ う	そ う ぎ ょ き ゅ う
き ゅ う せ い し ゅ	き ゅ う せ い し ゅ
き ょ じ ゅ う し ゃ	き ょ じ ゅ う し ゃ
そ う じ ゅ う し	そ う じ ゅ う し
し ょ う え ん せ い	し ょ う え ん せ い
し ょ う ぼ う し ょ	し ょ う ぼ う し ょ
き ょ う ぎ じ ょ う	き ょ う ぎ じ ょ う
て い し ゃ じ ょ う	て い し ゃ じ ょ う
し ゅ う き ひ ょ う	し ゅ う き ひ ょ う
き ょ う ふ し ょ う	き ょ う ふ し ょ う
う ん ど う り ょ う	う ん ど う り ょ う
こ う り ょ う し ゅ	こ う り ょ う し ゅ
ほ う へ い き ゅ う	ほ う へ い き ゅ う
え ん ち ゅ う ひ ょ う	え ん ち ゅ う ひ ょ う
じ ゅ う こ う ぎ ょ う	じ ゅ う こ う ぎ ょ う
と う き ょ う ぶ	と う き ょ う ぶ
き せ い ち ゅ う	き せ い ち ゅ う
き ょ う り ょ く	き ょ う り ょ く
し ょ き ち ょ う	し ょ き ち ょ う
し ょ う す う は	し ょ う す う は
ち ゅ う り ゃ く	ち ゅ う り ゃ く
り ょ う じ ょ く	り ょ う じ ょ く
ふ よ う り ょ う	ふ よ う り ょ う
そ う ぞ う し ゅ	そ う ぞ う し ゅ
お う え ん だ ん	お う え ん だ ん
じ ょ し り ょ う	じ ょ し り ょ う
か ん む り ょ う	か ん む り ょ う
ど う み ゃ く	ど う み ゃ く
あ い し ょ う か	あ い し ょ う か
は ん え い ゆ う	は ん え い ゆ う
り ょ う り し ゅ	り ょ う り し ゅ
ち ょ く ち ょ う	ち ょ く ち ょ う
け い り ょ う き	け い り ょ う き
お じ い ち ゃ ん	お じ い ち ゃ ん
じ ゅ ん じ ゅ ん	じ ゅ ん じ ゅ ん
し ゅ う じ ょ し	し ゅ う じ ょ し
り そ う き ょ う	り そ う き ょ う
あ り ゅ う さ ん	あ り ゅ う さ ん
し ょ っ か ん	し ょ っ か ん
は く ち ょ う	は く ち ょ う
え ん き せ い	え ん き せ い
お ね え さ ん	お ね え さ ん
か と う せ い	か と う せ い
こ う と う は	こ う と う は
し ゅ う そ く	し ゅ う そ く
ゆ う り ょ く	ゆ う り ょ く
し て ん の う	し て ん の う
ど う し ゅ つ	ど う し ゅ つ
じ ょ う で き	じ ょ う で き
お お い ぬ ざ	お お い ぬ ざ
け い は ん な	け い は ん な
ち じ ょ う は	ち じ ょ う は
き ゅ う し ふ	き ゅ う し ふ
ち ょ う や く	ち ょ う や く
き ょ し ゅ つ	き ょ し ゅ つ
ぼ っ ち ゃ ん	ぼ っ ち ゃ ん
し ょ う か き	し ょ う か き
に く し ょ う	に く し ょ う
じ ゅ う じ ろ	じ ゅ う じ ろ
し ゅ っ き ん	し ゅ っ き ん
き ょ し ょ く	き ょ し ょ く
じ ょ う は つ	じ ょ う は つ
せ い き ょ く	せ い き ょ く
と く ち ゅ う	と く ち ゅ う
じ ゅ く せ い	じ ゅ く せ い
ひ り ゅ う ず	ひ り ゅ う ず
お と う さ ん	お と う さ ん
き ょ う ら く	き ょ う ら く
ひ ょ う す る	ひ ょ う す る
し ゅ う か く	し ゅ う か く
え ん ち ょ く	え ん ち ょ く
せ い と う か	せ い と う か
い い ん か い	い い ん か い
て い こ う き	て い こ う き
こ う つ ご う	こ う つ ご う
ち っ ち ゃ い	ち っ ち ゃ い
げ い じ ゅ つ	げ い じ ゅ つ
じ ょ う る り	じ ょ う る り
い け い れ ん	い け い れ ん
う ろ お ぼ え	う ろ お ぼ え
お お い ち ざ	お お い ち ざ
じ ゆ う と う	じ ゆ う と う
じ え い た い	じ え い た い
し ょ う や く	し ょ う や く
じ っ し ょ く	じ っ し ょ く
き ゅ う げ き	き ゅ う げ き
こ う ち し ょ	こ う ち し ょ
こ う は い い	こ う は い い
り ゅ う が く	り ゅ う が く
や じ ゅ う は	や じ ゅ う は
あ か ん べ え	あ か ん べ え
こ う り ゃ く	こ う り ゃ く
し ゅ く せ い	し ゅ く せ い
ご く ち ゅ う	ご く ち ゅ う
か ず お お い	か ず お お い
け い き ょ く	け い き ょ く
ひ ょ う か く	ひ ょ う か く
じ ょ き ょ く	じ ょ き ょ く
す い じ ゅ ん	す い じ ゅ ん
よ う き ょ く	よ う き ょ く
ぐ う き せ い	ぐ う き せ い
し ゅ う さ く	し ゅ う さ く
い ぜ ん け い	い ぜ ん け い
じ ょ う ざ ぶ	じ ょ う ざ ぶ
し ど う し ゃ	し ど う し ゃ
ろ く じ ゅ う	ろ く じ ゅ う
せ い り ょ く	せ い り ょ く
よ う り ょ く	よ う り ょ く
ち ょ う し つ	ち ょ う し つ
え ん し ょ く	え ん し ょ く
て り ょ う り	て り ょ う り
そ う い え ば	そ う い え ば
か の う ほ う	か の う ほ う
ち ゅ う ぜ つ	ち ゅ う ぜ つ
あ ん ち ょ く	あ ん ち ょ く
お じ い さ ん	お じ い さ ん
じ ど う し ゃ	じ ど う し ゃ
し ょ う し つ	し ょ う し つ
り ょ く ち ゃ	り ょ く ち ゃ
お っ と せ い	お っ と せ い
り ょ う し つ	り ょ う し つ
ち ゅ う そ つ	ち ゅ う そ つ
ち ょ う は つ	ち ょ う は つ
ふ く ぎ ょ う	ふ く ぎ ょ う
せ い じ ゅ つ	せ い じ ゅ つ
ふ け し ゅ う	ふ け し ゅ う
に く じ ゅ う	に く じ ゅ う
か こ き ゅ う	か こ き ゅ う
き ぎ ょ う か	き ぎ ょ う か
は く し ゅ う	は く し ゅ う
ふ よ う し ゃ	ふ よ う し ゃ
だ っ し ょ く	だ っ し ょ く
ひ ふ び ょ う	ひ ふ び ょ う
か い あ げ る	か い あ げ る
ふ め い か く	ふ め い か く
お も い つ く	お も い つ く
き が く る う	き が く る う
か い ら い し	か い ら い し
あ ざ わ ら う	あ ざ わ ら う
ま す い ざ い	ま す い ざ い
と し お い る	と し お い る
ば か ら し い	ば か ら し い
ど ろ じ あ い	ど ろ じ あ い
ば く め い き	ば く め い き
か じ つ し ゅ	か じ つ し ゅ
あ つ ら え る	あ つ ら え る
た い わ ん ご	た い わ ん ご
お そ ろ し い	お そ ろ し い
は ぐ き お ん	は ぐ き お ん
あ め あ が り	あ め あ が り
か げ む し ゃ	か げ む し ゃ
し は い に ん	し は い に ん
そ ら も よ う	そ ら も よ う
し お か ら い	し お か ら い
め ざ ま し い	め ざ ま し い
う ろ た え る	う ろ た え る
だ い さ ん き	だ い さ ん き
は ま じ ゅ つ	は ま じ ゅ つ
み お ぼ え る	み お ぼ え る
か ざ ん が ん	か ざ ん が ん
ふ さ わ し い	ふ さ わ し い
と も じ ろ う	と も じ ろ う
お も い つ き	お も い つ き
よ い ゆ め を	よ い ゆ め を
り こ し ゅ ぎ	り こ し ゅ ぎ
ほ う り こ む	ほ う り こ む
い り え わ に	い り え わ に
た ん し だ い	た ん し だ い
ち ゃ く り く	ち ゃ く り く
や わ は だ	や わ は だ
や ま ふ だ	や ま ふ だ
な み か ぜ	な み か ぜ
と つ く に	と つ く に
し ば し ば	し ば し ば
ふ み き り	ふ み き り
む ら が る	む ら が る
ぎ り ぎ り	ぎ り ぎ り
き ら き ら	き ら き ら
か か わ る	か か わ る
こ こ の か	こ こ の か
か ら だ き	か ら だ き
ね す ご す	ね す ご す
の ぶ は る	の ぶ は る
き り が み	き り が み
む き だ し	む き だ し
た ば ね る	た ば ね る
ま め が ら	ま め が ら
き り ふ だ	き り ふ だ
こ う こ が く	こ う こ が く
じ か ん た い	じ か ん た い
ま っ く ろ い	ま っ く ろ い
だ ん ま つ ま	だ ん ま つ ま
に く ら し い	に く ら し い
た か の ぶ	た か の ぶ
じ ね ず み	じ ね ず み
こ づ つ み	こ づ つ み
ど う ぎ ょ う	み ち ゆ き
な や ま す	な や ま す
つ ぶ や く	つ ぶ や く
し ま ぐ に	し ま ぐ に
ご ぼ ご ぼ	ご ぼ ご ぼ
か ざ く ち	か ざ く ち
が に ま た	が に ま た
き か く か	き か く か
か た め る	か た め る
ず ぞ う が く	ず ぞ う が く
あ い だ が ら	あ い だ が ら
と し ょ し つ	と し ょ し つ
す い さ ん か	す い さ ん か
め ぐ り あ う	め ぐ り あ う
す い は ん き	す い は ん き
あ た た か い	あ た た か い
し ぼ う ぞ く	し ぼ う ぞ く
ば く が と う	ば く が と う
し や く し ょ	し や く し ょ
か そ う て き	か そ う て き
て ん じ か い	て ん じ か い
す い し ん き	す い し ん き
え げ つ な い	え げ つ な い
し め ん た い	し め ん た い
お い か け る	お い か け る
び ゃ く ろ く	び ゃ く ろ く
み ゃ く は く	み ゃ く は く
め ん た い こ	め ん た い こ
か ん が え る	か ん が え る
し ゃ く し ぎ	し ゃ く し ぎ
う で じ ま ん	う で じ ま ん
う え き ば ち	う え き ば ち
じ ゆ う せ き	じ ゆ う せ き
は く あ か ん	は く あ か ん
ひ う ち い し	ひ う ち い し
し ん じ だ い	し ん じ だ い
お も い や り	お も い や り
び し ょ ぬ れ	び し ょ ぬ れ
ひ っ か え す	ひ っ か え す
ま く じ ゃ く	ま く じ ゃ く
う り は ら う	う り は ら う
ま い お ち る	ま い お ち る
う そ を つ く	う そ を つ く
ち ん あ な ご	ち ん あ な ご
に ひ ゃ く ご	に ひ ゃ く ご
さ し い れ る	さ し い れ る
し ゃ が れ る	し ゃ が れ る
が ん も ど き	が ん も ど き
つ い し け ん	つ い し け ん
き ね ん ひ ん	き ね ん ひ ん
お と し あ な	お と し あ な
り っ た い し	り っ た い し
ね つ き う お	ね つ き う お
も ん だ い じ	も ん だ い じ
お と こ が お	お と こ が お
か し ま し い	か し ま し い
む こ う が わ	む こ う が わ
こ お り が し	こ お り が し
ぎ ゃ く ば り	ぎ ゃ く ば り
ほ う り だ す	ほ う り だ す
い ん さ つ き	い ん さ つ き
に ち よ う び	に ち よ う び
あ ほ く さ い	あ ほ く さ い
な つ か し い	な つ か し い
り ゃ く だ つ	り ゃ く だ つ
さ く ら そ う	さ く ら そ う
せ い か が く	せ い か が く
か っ た る い	か っ た る い
し し ゃ し つ	し し ゃ し つ
し ゃ く や く	し ゃ く や く
ぎ ゃ く さ つ	ぎ ゃ く さ つ
て き し ゅ つ	て き し ゅ つ
か み さ ま	か み さ ま
ち ゃ ば た け	ち ゃ ば た け
い さ ま し い	い さ ま し い
お と ろ え る	お と ろ え る
す な あ ら し	す な あ ら し
ぶ ん か け ん	ぶ ん か け ん
ほ ん る い だ	ほ ん る い だ
ぶ ん か ざ い	ぶ ん か ざ い
ね つ お せ ん	ね つ お せ ん
く ち ぶ り	く ち ぶ り
け つ ぞ く	け つ ぞ く
し な や か	し な や か
ど く さ つ	ど く さ つ
か し だ し	か し だ し
む ね や け	む ね や け
ま さ よ し	ま さ よ し
も た れ る	も た れ る
か ず ゆ き	か ず ゆ き
す こ や か	す こ や か
ぶ つ か る	ぶ つ か る
に げ み ち	に げ み ち
は ち み つ	は ち み つ
こ し ふ り	こ し ふ り
は り き る	は り き る
み ち ひ さ	み ち ひ さ
さ や と り	さ や と り
て わ た す	て わ た す
も と め る	も と め る
か わ ぐ ち	か わ ぐ ち
た ま わ る	た ま わ る
さ す け ね	さ す け ね
み ち ゆ き	み ち ゆ き
ひ そ ひ そ	ひ そ ひ そ
な が し め	な が し め
は ず れ る	は ず れ る
ほ ぐ れ る	ほ ぐ れ る
つ れ だ す	つ れ だ す
く ね く ね	く ね く ね
そ む け る	そ む け る
み が わ り	み が わ り
は に か む	は に か む
も ち だ す	も ち だ す
と り き め	と り き め
は や が き	は や が き
や す も の	や す も の
や ま が た	や ま が た
ま る ま る	ま る ま る
て つ く ず	て つ く ず
は ぐ る ま	は ぐ る ま
く じ ら ざ	く じ ら ざ
ふ た し か	ふ た し か
た か ら か	た か ら か
ま さ ゆ め	ま さ ゆ め
く る し み	く る し み
ひ ろ や ま	ひ ろ や ま
よ し き り	よ し き り
の み こ み	の み こ み
さ さ げ る	さ さ げ る
は る ま き	は る ま き
せ わ や き	せ わ や き
み だ し ご	み だ し ご
ま な ざ し	ま な ざ し
か け じ く	か け じ く
か か げ る	か か げ る
に じ ま す	に じ ま す
ゆ き ぞ ら	ゆ き ぞ ら
が く が く	が く が く
こ と わ ざ	こ と わ ざ
つ け も の	つ け も の
た く ら む	た く ら む
く び か せ	く び か せ
ひ と た ち	ひ と た ち
く ち ば し	く ち ば し
ぐ ら つ く	ぐ ら つ く
は じ ま る	は じ ま る
む か つ く	む か つ く
も ち ぬ し	も ち ぬ し
て づ く り	て づ く り
さ さ く れ	さ さ く れ
ち や ほ や	ち や ほ や
か が や く	か が や く
ず た ず た	ず た ず た
な か だ ち	な か だ ち
も く ろ む	も く ろ む
ぼ こ く ご	ぼ こ く ご
つ と め る	つ と め る
き は つ ゆ	き は つ ゆ
へ き れ き	へ き れ き
と り と め	と り と め
た び び と	た び び と
は ち す か	は ち す か
た ま ね ぎ	た ま ね ぎ
な に よ り	な に よ り
も つ れ る	も つ れ る
よ こ じ ま	よ こ じ ま
な め く じ	な め く じ
し ず め る	し ず め る
く つ し た	く つ し た
よ し ふ み	よ し ふ み
は こ せ こ	は こ せ こ
さ ぞ か し	さ ぞ か し
と ぎ れ る	と ぎ れ る
て つ が く	て つ が く
す な の み	す な の み
ま か せ る	ま か せ る
ふ く ら む	ふ く ら む
は や び き	は や び き
は ち ど り	は ち ど り
た ち よ る	た ち よ る
や す ひ ろ	や す ひ ろ
じ つ ろ く	じ つ ろ く
べ り べ り	べ り べ り
つ か れ る	つ か れ る
ず ぶ ぬ れ	ず ぶ ぬ れ
ち か み ち	ち か み ち
こ ち と ら	こ ち と ら
さ つ ば つ	さ つ ば つ
ほ つ れ る	ほ つ れ る
も の す る	も の す る
ふ か よ み	ふ か よ み
ぬ け が ら	ぬ け が ら
な か よ し	な か よ し
み つ げ つ	み つ げ つ
な ま ぐ さ	な ま ぐ さ
て か が み	て か が み
と も か く	と も か く
や ら れ る	や ら れ る
で か け る	で か け る
ひ き ず る	ひ き ず る
み ご ろ し	み ご ろ し
み け ね こ	み け ね こ
き ま ぐ れ	き ま ぐ れ
ほ ろ ぼ す	ほ ろ ぼ す
は ら は ら	は ら は ら
は ら か ら	は ら か ら
た す け る	た す け る
か ら ぼ り	か ら ぼ り
さ わ や か	さ わ や か
と み く じ	と み く じ
げ き か ら	げ き か ら
そ れ よ り	そ れ よ り
き し な み	き し な み
け じ ら み	け じ ら み
や ま か わ	や ま か わ
ひ ら い し ん	ひ ら い し ん
か く た る	か く た る
や す や ど	や す や ど
も の ご し	も の ご し
せ と も の	せ と も の
ひ ら め き	ひ ら め き
ひ や か し	ひ や か し
よ ろ し く	よ ろ し く
よ み だ す	よ み だ す
せ っ し お ん ど	せ っ し お ん ど
え ん せ い て き	え ん せ い て き
り っ ぽ う た い	り っ ぽ う た い
ら ん さ い ぼ う	ら ん さ い ぼ う
ぼ う ね ん か い	ぼ う ね ん か い
あ く し ゅ か い	あ く し ゅ か い
こ う て い て き	こ う て い て き
ど れ い せ い ど	ど れ い せ い ど
ほ じ ょ ど う し	ほ じ ょ ど う し
ゆ う せ い が く	ゆ う せ い が く
あ っ と い う ま	あ っ と い う ま
せ い か ん た い	せ い か ん た い
し ゃ よ う ぞ く	し ゃ よ う ぞ く
あ ん し じ ゅ つ	あ ん し じ ゅ つ
お お い か く す	お お い か く す
ご う か ん は ん	ご う か ん は ん
じ ゃ か じ ゃ か	じ ゃ か じ ゃ か
へ ん と う せ ん	へ ん と う せ ん
ぜ ん え い て き	ぜ ん え い て き
も う さ い か ん	も う さ い か ん
は い す い こ う	は い す い こ う
お べ ん ち ゃ ら	お べ ん ち ゃ ら
ろ し ゅ つ け い	ろ し ゅ つ け い
ご ち ゃ く ち ゃ	ご ち ゃ く ち ゃ
こ ん ご う さ ん	こ ん ご う さ ん
か の う ど う し	か の う ど う し
し ん ぱ ん い ん	し ん ぱ ん い ん
い し が ん と う	い し が ん と う
さ ら そ う じ ゅ	さ ら そ う じ ゅ
ど せ き り ゅ う	ど せ き り ゅ う
ち ゅ う か そ ば	ち ゅ う か そ ば
ぐ し ゃ ぐ し ゃ	ぐ し ゃ ぐ し ゃ
き ゅ う け つ き	き ゅ う け つ き
と う し ん だ い	と う し ん だ い
び ょ う り が く	び ょ う り が く
せ ん て ん せ い	せ ん て ん せ い
ご ち ゃ ご ち ゃ	ご ち ゃ ご ち ゃ
き ゃ く し ょ く	き ゃ く し ょ く
は ん ば い い ん	は ん ば い い ん
く っ き ょ く い	く っ き ょ く い
ぜ つ ふ ち ょ う	ぜ つ ふ ち ょ う
し ゅ う じ が く	し ゅ う じ が く
げ ん せ い だ い	げ ん せ い だ い
か じ ょ う が き	か じ ょ う が き
い っ ぽ ん み ち	い っ ぽ ん み ち
い も う と ぶ ん	い も う と ぶ ん
ち ゅ う ご く か	ち ゅ う ご く か
じ ょ が く せ い	じ ょ が く せ い
か く は ん の う	か く は ん の う
せ い め い せ つ	せ い め い せ つ
は ん ば い し ゃ	は ん ば い し ゃ
に ょ ろ に ょ ろ	に ょ ろ に ょ ろ
し ゃ く よ う ご	し ゃ く よ う ご
う ん で い の さ	う ん で い の さ
ま ち ど お し い	ま ち ど お し い
ゆ う え つ か ん	ゆ う え つ か ん
の う ど う て き	の う ど う て き
は く ち ょ う ざ	は く ち ょ う ざ
き ょ ろ き ょ ろ	き ょ ろ き ょ ろ
し ち ょ う り つ	し ち ょ う り つ
い ち ね ん せ い	い ち ね ん せ い
が い こ う か ん	が い こ う か ん
し ん せ い だ い	し ん せ い だ い
け い は ん ざ い	け い は ん ざ い
せ ん ざ ん こ う	せ ん ざ ん こ う
は い せ ん し ゃ	は い せ ん し ゃ
あ っ と う て き	あ っ と う て き
い ち に ん ま え	い ち に ん ま え
じ ゆ う し ゅ ぎ	じ ゆ う し ゅ ぎ
し ん ぶ ん し ゃ	し ん ぶ ん し ゃ
に じ ゅ う ぞ こ	に じ ゅ う ぞ こ
い ん げ ん ま め	い ん げ ん ま め
し ょ う わ く せ い	し ょ う わ く せ い
り ょ う げ ん の ひ	り ょ う げ ん の ひ
き ょ り き ょ う ぎ	き ょ り き ょ う ぎ
げ い じ ゅ つ せ い	げ い じ ゅ つ せ い
じ ゅ し ょ う し き	じ ゅ し ょ う し き
お う だ ん ほ ど う	お う だ ん ほ ど う
だ い ち ょ う き ん	だ い ち ょ う き ん
こ う せ い き ょ く	こ う せ い き ょ く
こ う れ い じ ゅ つ	こ う れ い じ ゅ つ
さ ん じ ょ う こ ん	さ ん じ ょ う こ ん
し ゅ う ぶ ん て ん	し ゅ う ぶ ん て ん
か ん せ ん し ょ う	か ん せ ん し ょ う
り ゅ う が く せ い	り ゅ う が く せ い
か い ち ょ う ふ ん	か い ち ょ う ふ ん
む じ ゅ う り ょ く	む じ ゅ う り ょ く
ち ゅ う ど く せ い	ち ゅ う ど く せ い
だ い ひ ょ う だ ん	だ い ひ ょ う だ ん
び ょ う げ ん た い	び ょ う げ ん た い
せ い よ う し ょ う ぎ	せ い よ う し ょ う ぎ
ゆ う き ゅ う き ゅ う か	ゆ う き ゅ う き ゅ う か
し ょ ぎ ょ う む じ ょ う	し ょ ぎ ょ う む じ ょ う
き ょ う ど う し ゅ っ し	き ょ う ど う し ゅ っ し
と う ひ ょ う よ う し	と う ひ ょ う よ う し
だ い ど う し ょ う い	だ い ど う し ょ う い
ご だ い み ょ う お う	ご だ い み ょ う お う
い っ ぽ う つ う こ う	い っ ぽ う つ う こ う
そ う り き ょ う せ い	そ う り き ょ う せ い
だ い じ ょ う か ん	だ い じ ょ う か ん
か じ ょ う せ っ し ゅ	か じ ょ う せ っ し ゅ
び ょ う ど う し ゅ ぎ	び ょ う ど う し ゅ ぎ
ぼ う し ょ く ぎ ょ う	ぼ う し ょ く ぎ ょ う
こ う き ょ う き ょ く	こ う き ょ う き ょ く
し ょ う ち ょ う て き	し ょ う ち ょ う て き
は ん き ょ う て い い	は ん き ょ う て い い
ぞ う お ひ ょ う げ ん	ぞ う お ひ ょ う げ ん
き ょ う そ う き ょ く	き ょ う そ う き ょ く
こ く り ゅ う こ う	こ く り ゅ う こ う
し ょ せ い じ ゅ つ	し ょ せ い じ ゅ つ
ち ゅ う で ん き ん	ち ゅ う で ん き ん
ぼ い ん ち ょ う わ	ぼ い ん ち ょ う わ
う ん ど う お ん ち	う ん ど う お ん ち
し し ょ ご き ょ う	し し ょ ご き ょ う
せ っ し ょ う せ き	せ っ し ょ う せ き
て ん の う へ い か	て ん の う へ い か
ち ょ っ か っ こ う	ち ょ っ か っ こ う
ち ゅ う か ん け ん	ち ゅ う か ん け ん
そ う め い き ょ く	そ う め い き ょ く
し ん こ っ ち ょ う	し ん こ っ ち ょ う
ち ゅ う さ い に ん	ち ゅ う さ い に ん
し し ゃ ご に ゅ う	し し ゃ ご に ゅ う
ぜ い じ ゃ く せ い	ぜ い じ ゃ く せ い
と う ひ ょ う り つ	と う ひ ょ う り つ
た げ ん う ち ゅ う	た げ ん う ち ゅ う
こ う ぶ ん と う い	こ う ぶ ん と う い
は っ け っ き ゅ う	は っ け っ き ゅ う
し ょ う で ん き ん	し ょ う で ん き ん
に じ ゅ う ひ て い	に じ ゅ う ひ て い
み ん ち ょ う た い	み ん ち ょ う た い
じ ゅ ん よ う か ん	じ ゅ ん よ う か ん
さ ん じ ゅ う い ち	さ ん じ ゅ う い ち
あ か ち ょ う ち ん	あ か ち ょ う ち ん
そ つ ぎ ょ う せ い	そ つ ぎ ょ う せ い
じ っ た い き ょ う	じ っ た い き ょ う
す い へ い せ ん	す い へ い せ ん
さ ん だ ん じ ゅ う	さ ん だ ん じ ゅ う
て ん び ん き ゅ う	て ん び ん き ゅ う
い っ す ん ぼ う し	い っ す ん ぼ う し
す い せ ん じ ょ う	す い せ ん じ ょ う
ほ う し ゅ つ お ん	ほ う し ゅ つ お ん
け ん き ゅ う か い	け ん き ゅ う か い
に ゅ う ど う ぐ も	に ゅ う ど う ぐ も
れ い き ゃ く と う	れ い き ゃ く と う
ざ と う む し	ざ と う む し
ね ん が っ ぴ	ね ん が っ ぴ
す ば ら し い	す ば ら し い
ち せ い が く	ち せ い が く
え ん び ふ く	え ん び ふ く
だ い じ な い	だ い じ な い
む か え う つ	む か え う つ
れ っ か い か	れ っ か い か
い ぶ か し い	い ぶ か し い
と く は い ん	と く は い ん
ゆ ず り あ う	ゆ ず り あ う
か く せ い き	か く せ い き
こ ん ば ん わ	こ ん ば ん わ
ご う り て き	ご う り て き
み ま い き ん	み ま い き ん
め だ し ぼ う	め だ し ぼ う
の ぼ り ぼ う	の ぼ り ぼ う
た い き け ん	た い き け ん
こ く ゆ う か	こ く ゆ う か
が っ て ん し	が っ て ん し
う ら が え し	う ら が え し
め い せ き む	め い せ き む
あ ん ら く し	あ ん ら く し
す さ ま じ い	す さ ま じ い
せ い く ら べ	せ い く ら べ
あ ど け な い	あ ど け な い
か い あ わ せ	か い あ わ せ
ち ょ く り つ	ち ょ く り つ
さ と う き び	さ と う き び
し が い せ ん	し が い せ ん
み ゃ く せ き	み ゃ く せ き
し ん げ ん ち	し ん げ ん ち
お も し ろ い	お も し ろ い
あ か ぐ ろ い	あ か ぐ ろ い
そ う し た ら	そ う し た ら
せ い じ て き	せ い じ て き
さ よ う な ら	さ よ う な ら
よ じ せ い く	よ じ せ い く
や ぶ こ う じ	や ぶ こ う じ
り ゃ く れ き	り ゃ く れ き
そ っ け な い	そ っ け な い
し ん び が ん	し ん び が ん
い っ て よ し	い っ て よ し
い ろ あ せ る	い ろ あ せ る
ら し ん ば ん	ら し ん ば ん
か い き せ ん	か い き せ ん
へ や ち ゃ く	へ や ち ゃ く
ち ゃ く だ つ	ち ゃ く だ つ
く じ ゃ く ざ	く じ ゃ く ざ
い わ て け ん	い わ て け ん
や や こ し い	や や こ し い
し ょ く も つ	し ょ く も つ
し ん の す け	し ん の す け
し ゅ ら ば る	し ゅ ら ば る
う す わ ら い	う す わ ら い
ふ し ん じ ん	ふ し ん じ ん
と い え ど も	と い え ど も
な や ま し い	な や ま し い
お も い だ す	お も い だ す
と い あ わ せ	と い あ わ せ
う ち お と す	う ち お と す
あ さ の か い	あ さ の か い
ご ち ゃ ま ぜ	ご ち ゃ ま ぜ
き り つ せ い	き り つ せ い
が い ら い ご	が い ら い ご
う し ん し つ	う し ん し つ
し せ い か つ	し せ い か つ
あ り が た い	あ り が た い
お も い た つ	お も い た つ
は と ど け い	は と ど け い
お ま え た ち	お ま え た ち
も ど か し い	も ど か し い
か ん さ い ぼ う	か ん さ い ぼ う
ざ ゆ う の め い	ざ ゆ う の め い
け ん い し ゅ ぎ	け ん い し ゅ ぎ
ち の う し す う	ち の う し す う
ね つ き き ゅ う	ね つ き き ゅ う
て ん び ん ぼ う	て ん び ん ぼ う
ほ う っ て お く	ほ う っ て お く
こ ん ご う り ん	こ ん ご う り ん
り っ ぽ う こ ん	り っ ぽ う こ ん
し じ ゅ う か ら	し じ ゅ う か ら
し ん だ い し ゃ	し ん だ い し ゃ
か き ゅ う て き	か き ゅ う て き
こ う ぶ ん ろ ん	こ う ぶ ん ろ ん
ゆ う で ん た い	ゆ う で ん た い
ら ん は ん し ゃ	ら ん は ん し ゃ
ほ っ か い ど う	ほ っ か い ど う
ね つ ぼ う そ う	ね つ ぼ う そ う
じ ゃ こ う ね こ	じ ゃ こ う ね こ
う ん ど う ぐ つ	う ん ど う ぐ つ
い っ ぱ ん じ ん	い っ ぱ ん じ ん
し ょ と く ぜ い	し ょ と く ぜ い
と け い こ う じ	と け い こ う じ
し ゅ つ り ょ く	し ゅ つ り ょ く
は た し じ ょ う	は た し じ ょ う
せ い か つ お ん	せ い か つ お ん
り そ う し ゅ ぎ	り そ う し ゅ ぎ
え ん ぶ き ょ く	え ん ぶ き ょ く
し ょ う げ き は	し ょ う げ き は
す う が く し ゃ	す う が く し ゃ
ひ ん こ ん し ゃ	ひ ん こ ん し ゃ
こ う こ く と う	こ う こ く と う
の う が く し ゃ	の う が く し ゃ
う ち べ ん け い	う ち べ ん け い
れ っ と う か ん	れ っ と う か ん
び し ょ び し ょ	び し ょ び し ょ
ゆ う こ う て き	ゆ う こ う て き
き は つ せ い	き は つ せ い
な ん だ っ て	な ん だ っ て
み ゃ く ら く	み ゃ く ら く
し ん り せ ん	し ん り せ ん
あ ら れ い し	あ ら れ い し
か し お ん ど	か し お ん ど
か ご う ぶ つ	か ご う ぶ つ
な ま り い ろ	な ま り い ろ
り れ き し ょ	り れ き し ょ
さ ら あ ら い	さ ら あ ら い
む げ ん だ い	む げ ん だ い
て き ち ょ く	て き ち ょ く
も じ ど お り	も じ ど お り
う す ぐ ら い	う す ぐ ら い
ぶ か つ ど う	ぶ か つ ど う
も う し で る	も う し で る
き ご う が く	き ご う が く
せ ん り が ん	せ ん り が ん
え ぞ お お か み	え ぞ お お か み
せ い す う が た	せ い す う が た
ゆ う か い は ん	ゆ う か い は ん
ふ う そ く け い	ふ う そ く け い
お も い ど お り	お も い ど お り
ち ん つ う ざ い	ち ん つ う ざ い
し ゅ を い れ る	し ゅ を い れ る
そ う ぞ う て き	そ う ぞ う て き
こ う へ い む し	こ う へ い む し
ほ し が る	ほ し が る
が い よ う ら ん	が い よ う ら ん
あ く し ゅ け ん	あ く し ゅ け ん
と っ て お き	と っ て お き
し て い せ き	し て い せ き
お ろ し う り	お ろ し う り
ひ て い て き	ひ て い て き
お な い ど し	お な い ど し
す い あ げ る	す い あ げ る
ゆ だ ね る	ゆ だ ね る
よ そ ゆ き	よ そ ゆ き
す け ひ ろ	す け ひ ろ
た ず ね る	た ず ね る
ひ ぐ ら し	ひ ぐ ら し
か き と る	か き と る
つ く ひ よ	つ く ひ よ
と し こ し	と し こ し
た か と び	た か と び
く じ け る	く じ け る
か け ご と	か け ご と
ふ が ふ が	ふ が ふ が
よ な よ な	よ な よ な
ね た き り	ね た き り
こ く そ く	こ く そ く
む ず む ず	む ず む ず
み な ぎ る	み な ぎ る
と も が ら	と も が ら
ひ よ め き	ひ よ め き
と り こ む	と り こ む
く ま も と	く ま も と
へ り く つ	へ り く つ
げ じ げ じ	げ じ げ じ
か た が た	か た が た
き ら め く	き ら め く
ぼ く た ち	ぼ く た ち
し ら さ ぎ	し ら さ ぎ
つ ぶ や き	つ ぶ や き
ね ば ね ば	ね ば ね ば
ぬ け だ す	ぬ け だ す
す き ず き	す き ず き
し か け る	し か け る
く さ わ け	く さ わ け
が く ぶ ち	が く ぶ ち
は た ら き	は た ら き
き つ つ き	き つ つ き
ひ こ ぼ し	ひ こ ぼ し
で く わ す	で く わ す
す ご す ご	す ご す ご
み つ め る	み つ め る
ま る め る	ま る め る
ど く と く	ど く と く
か ず か ず	か ず か ず
は る さ め	は る さ め
し ら せ る	し ら せ る
せ ば ま る	せ ば ま る
み つ か る	み つ か る
ま す ま す	ま す ま す
な ら は ら	な ら は ら
な か も り	な か も り
た ち ま ち	た ち ま ち
ま ご つ く	ま ご つ く
か み な り	か み な り
た く ろ く	た く ろ く
み な れ る	み な れ る
よ し ゆ き	よ し ゆ き
は く し つ	は く し つ
や ま ね こ	や ま ね こ
な な ふ し	な な ふ し
そ だ て る	そ だ て る
や ま が ら	や ま が ら
こ く も つ	こ く も つ
な る ほ ど	な る ほ ど
さ ほ ひ め	さ ほ ひ め
み ち た か	み ち た か
さ み だ れ	さ み だ れ
ま ふ た つ	ま ふ た つ
か く れ ご	か く れ ご
ひ ろ ゆ き	ひ ろ ゆ き
も ち き り	も ち き り
は や じ に	は や じ に
か さ ぶ た	か さ ぶ た
か り と る	か り と る
よ ろ こ び	よ ろ こ び
つ じ ぎ り	つ じ ぎ り
と ど め る	と ど め る
は け ぐ ち	は け ぐ ち
ざ つ が く	ざ つ が く
こ り つ は	こ り つ は
や ま ぐ ち	や ま ぐ ち
か た ま り	か た ま り
よ そ も の	よ そ も の
し た し む	し た し む
じ き ば き	じ き ば き
べ ら べ ら	べ ら べ ら
や り か た	や り か た
ひ と づ て	ひ と づ て
と ど け る	と ど け る
そ も そ も	そ も そ も
さ き だ つ	さ き だ つ
し か め る	し か め る
ひ と ざ と	ひ と ざ と
ま た が る	ま た が る
か ま ぼ こ	か ま ぼ こ
す ず な り	す ず な り
は ら だ ち	は ら だ ち
よ こ は ば	よ こ は ば
て み じ か	て み じ か
て る の ぶ	て る の ぶ
け れ ど も	け れ ど も
み つ ば ち	み つ ば ち
く つ ろ ぐ	く つ ろ ぐ
の り も の	の り も の
け し と ぶ	け し と ぶ
み な さ ま	み な さ ま
か な ぶ み	か な ぶ み
や ま ほ ど	や ま ほ ど
ひ た む き	ひ た む き
こ め か み	こ め か み
わ し ば な	わ し ば な
ひ ぎ つ ね	ひ ぎ つ ね
た か め る	た か め る
ひ ろ め る	ひ ろ め る
つ よ ま る	つ よ ま る
ほ し が き	ほ し が き
の の し る	の の し る
も く ろ み	も く ろ み
な か ゆ び	な か ゆ び
ご ず め ず	ご ず め ず
に ぎ や か	に ぎ や か
く に ゆ き	く に ゆ き
む さ ぼ る	む さ ぼ る
よ く ば り	よ く ば り
ば ら ま く	ば ら ま く
に ち ぼ つ	に ち ぼ つ
み み ず く	み み ず く
な つ ぞ ら	な つ ぞ ら
ふ ゆ ふ く	ふ ゆ ふ く
む ら ま つ	む ら ま つ
く ち な し	く ち な し
た び た び	た び た び
ぶ る ぶ る	ぶ る ぶ る
む し け ら	む し け ら
か ご し ま	か ご し ま
ふ き だ し	ふ き だ し
た た ず む	た た ず む
か み ま き	か み ま き
ど ら や き	ど ら や き
な づ け る	な づ け る
ま つ わ る	ま つ わ る
た め か げ	た め か げ
ひ ろ げ る	ひ ろ げ る
に く し み	に く し み
こ と わ り	こ と わ り
け と ば す	け と ば す
ち ら つ く	ち ら つ く
つ ら ね る	つ ら ね る
こ く ふ く	こ く ふ く
こ れ ま で	こ れ ま で
は な は だ	は な は だ
さ か み せ	さ か み せ
し く じ る	し く じ る
と り け す	と り け す
た ま ゆ ら	た ま ゆ ら
ひ で み つ	ひ で み つ
ず る ず る	ず る ず る
し め き り	し め き り
く ち の は	く ち の は
も と づ く	も と づ く
ひ と き れ	ひ と き れ
と く べ つ	と く べ つ
め ぐ す り	め ぐ す り
ひ れ ふ す	ひ れ ふ す
な ぞ に く	な ぞ に く
と く し つ	と く し つ
の ら ね こ	の ら ね こ
し き た り	し き た り
た ち き る	た ち き る
と び だ す	と び だ す
ふ ゆ ぞ ら	ふ ゆ ぞ ら
ひ そ め る	ひ そ め る
そ こ ね る	そ こ ね る
や く す る	や く す る
も の さ し	も の さ し
と り ま く	と り ま く
む じ る し	む じ る し
す く め る	す く め る
も て な す	も て な す
と り く む	と り く む
さ く れ つ	さ く れ つ
こ つ つ ぼ	こ つ つ ぼ
ご ろ つ き	ご ろ つ き
と り つ く	と り つ く
ぴ か ぴ か	ぴ か ぴ か
く さ ば な	く さ ば な
く ち び る	く ち び る
や み く も	や み く も
と り だ す	と り だ す
す な は ま	す な は ま
ひ ら が な	ひ ら が な
ぼ た も ち	ぼ た も ち
そ ろ そ ろ	そ ろ そ ろ
ま た た び	ま た た び
か み だ な	か み だ な
か き だ し	か き だ し
ち か て つ	ち か て つ
す な わ ち	す な わ ち
ひ ろ み つ	ひ ろ み つ
は な む け	は な む け
ふ る き ず	ふ る き ず
み わ た す	み わ た す
ふ み づ き	ふ み づ き
た か ま る	た か ま る
ま じ わ り	ま じ わ り
か な し み	か な し み
や れ や れ	や れ や れ
だ ら だ ら	だ ら だ ら
こ も ご も	こ も ご も
み だ れ ば	み だ れ ば
む ら む ら	む ら む ら
か ち ぼ し	か ち ぼ し
ま ち ま ち	ま ち ま ち
ひ ろ ふ み	ひ ろ ふ み
も の ま ね	も の ま ね
で す か ら	で す か ら
か く べ つ	か く べ つ
つ じ つ ま	つ じ つ ま
ほ と ぼ り	ほ と ぼ り
や け く そ	や け く そ
こ じ し ざ	こ じ し ざ
き り さ く	き り さ く
の ど も と	の ど も と
わ れ わ れ	わ れ わ れ
み ぎ が わ	み ぎ が わ
な げ な わ	な げ な わ
ど ろ が め	ど ろ が め
ど ち ざ め	ど ち ざ め
ぞ ろ ぞ ろ	ぞ ろ ぞ ろ
ひ か れ る	ひ か れ る
さ さ や か	さ さ や か
き よ め る	き よ め る
ふ り こ む	ふ り こ む
き り と る	き り と る
そ ら み み	そ ら み み
ぶ ち こ む	ぶ ち こ む
ゆ き ひ ろ	ゆ き ひ ろ
そ な わ る	そ な わ る
ち ち の ひ	ち ち の ひ
ざ る そ ば	ざ る そ ば
や り く り	や り く り
く ろ み つ	く ろ み つ
か か わ り	か か わ り
ふ ざ け る	ふ ざ け る
わ り び き	わ り び き
つ た わ る	つ た わ る
は つ も の	は つ も の
よ わ め る	よ わ め る
ま ど ろ む	ま ど ろ む
た け ぐ し	た け ぐ し
よ ろ け る	よ ろ け る
く し く も	く し く も
ま と め る	ま と め る
け つ け つ	け つ け つ
ふ た ま た	ふ た ま た
き た こ れ	き た こ れ
か さ ば る	か さ ば る
し た た か	し た た か
ち <<unk>> め る	ち <unk> め る
ど れ ど れ	ど れ ど れ
の り き る	の り き る
は び こ る	は び こ る
さ ら な る	さ ら な る
ち ぎ れ る	ち ぎ れ る
き ま り じ	き ま り じ
ぷ に ぷ に	ぷ に ぷ に
こ わ れ る	こ わ れ る
ぶ ら つ く	ぶ ら つ く
は ね つ き	は ね つ き
は み が き	は み が き
も ち つ け	も ち つ け
し と や か	し と や か
か た す み	か た す み
れ き し か	れ き し か
く も ざ る	く も ざ る
な ま ご み	な ま ご み
と め が ね	と め が ね
や わ ら ぐ	や わ ら ぐ
ふ く れ る	ふ く れ る
ひ る め し	ひ る め し
さ び つ く	さ び つ く
く わ だ て	く わ だ て
か ら も の	か ら も の
ひ ろ が る	ひ ろ が る
ば ら に く	ば ら に く
き く ら げ	き く ら げ
つ ら な る	つ ら な る
く ず れ る	く ず れ る
と も ゆ き	と も ゆ き
か ぶ れ る	か ぶ れ る
の り ま さ	の り ま さ
し た て る	し た て る
か ま き り	か ま き り
く ず し じ	く ず し じ
ね す が た	ね す が た
ひ き さ く	ひ き さ く
ひ さ び さ	ひ さ び さ
こ と な る	こ と な る
く わ が た	く わ が た
こ れ か ら	こ れ か ら
ふ ら ふ ら	ふ ら ふ ら
た か な る	た か な る
こ く は つ	こ く は つ
ご ま か し	ご ま か し
な に も の	な に も の
の み こ む	の み こ む
か り そ め	か り そ め
き か が く	き か が く
は し ば し	は し ば し
は く が く	は く が く
か な ざ わ	か な ざ わ
く る く る	く る く る
た ぷ た ぷ	た ぷ た ぷ
ち ら か る	ち ら か る
と き め く	と き め く
と こ む し	と こ む し
へ た く そ	へ た く そ
か べ が み	か べ が み
な く な る	な く な る
か じ き ざ	か じ き ざ
ひ と な か	ひ と な か
ほ の ぼ の	ほ の ぼ の
や ま で ら	や ま で ら
き に す る	き に す る
ぺ ら ぺ ら	ぺ ら ぺ ら
か み が た	か み が た
も し も し	も し も し
は じ め る	は じ め る
つ と ま る	つ と ま る
み ち づ れ	み ち づ れ
は な ぞ の	は な ぞ の
さ さ や く	さ さ や く
も ふ も ふ	も ふ も ふ
な つ く さ	な つ く さ
こ ぼ れ る	こ ぼ れ る
ほ し ざ め	ほ し ざ め
ま だ ま だ	ま だ ま だ
く だ さ る	く だ さ る
ふ た ご ざ	ふ た ご ざ
ふ た た び	ふ た た び
し た た る	し た た る
く ま の み	く ま の み
ぱ ら ぱ ら	ぱ ら ぱ ら
ふ さ が る	ふ さ が る
す ず は く	す ず は く
つ け こ む	つ け こ む
に わ と こ	に わ と こ
は き だ す	は き だ す
た て つ く	た て つ く
み か づ き	み か づ き
ゆ る め る	ゆ る め る
な か だ し	な か だ し
と か げ ざ	と か げ ざ
し ろ は ら	し ろ は ら
か く と く	か く と く
も ち さ る	も ち さ る
か く れ る	か く れ る
ま つ ひ ら	ま つ ひ ら
の き さ き	の き さ き
か け も の	か け も の
か け が わ	か け が わ
ま き こ む	ま き こ む
し ら け る	し ら け る
も じ ば け	も じ ば け
ひ で た か	ひ で た か
わ か れ る	わ か れ る
つ き か げ	つ き か げ
と じ こ み	と じ こ み
か く り つ	か く り つ
む な ぐ ら	む な ぐ ら
よ し ひ ろ	よ し ひ ろ
か も し か	か も し か
や す め る	や す め る
く わ わ る	く わ わ る
よ び か け	よ び か け
さ ざ な み	さ ざ な み
ま さ ひ ろ	ま さ ひ ろ
よ ろ こ ぶ	よ ろ こ ぶ
と し よ り	と し よ り
ま よ な か	ま よ な か
そ わ そ わ	そ わ そ わ
に げ こ む	に げ こ む
つ る は し	つ る は し
と こ ろ で	と こ ろ で
ね ぼ け る	ね ぼ け る
ば ら ば ら	ば ら ば ら
は く だ つ	は く だ つ
み つ も る	み つ も る
な が め る	な が め る
か な が わ	か な が わ
つ ま さ き	つ ま さ き
み か け る	み か け る
く ろ か み	く ろ か み
じ す べ り	じ す べ り
て こ ず る	て こ ず る
し と め る	し と め る
ほ れ ぼ れ	ほ れ ぼ れ
さ と や ま	さ と や ま
も た ら す	も た ら す
や ぶ さ め	や ぶ さ め
ま さ く に	ま さ く に
た ま ぐ し	た ま ぐ し
せ つ ぞ く	せ つ ぞ く
に し ご り	に し ご り
か ぶ さ る	か ぶ さ る
よ こ は ま	よ こ は ま
み み な り	み み な り
ゆ き づ り	ゆ き づ り
き こ な す	き こ な す
す ま せ る	す ま せ る
ゆ る や か	ゆ る や か
わ が ま ま	わ が ま ま
ひ き つ け	ひ き つ け
て る ひ で	て る ひ で
た か ふ み	た か ふ み
ひ ら め く	ひ ら め く
つ ま ず く	つ ま ず く
さ く て き	さ く て き
さ よ な ら	さ よ な ら
は た ら く	は た ら く
は や め る	は や め る
し き べ つ	し き べ つ
と ど ろ く	と ど ろ く
こ く せ き	こ く せ き
よ り み ち	よ り み ち
こ な ゆ き	こ な ゆ き
す ら す ら	す ら す ら
と び ち る	と び ち る
と も だ ち	と も だ ち
ま ぼ ろ し	ま ぼ ろ し
よ こ が み	よ こ が み
た て が み	た て が み
ち ら ば る	ち ら ば る
ご ま か す	ご ま か す
と し ご ろ	と し ご ろ
ま つ か ぜ	ま つ か ぜ
ま た ま た	ま た ま た
ぐ る ぐ る	ぐ る ぐ る
つ つ し む	つ つ し む
て か て か	て か て か
は り が み	は り が み
な だ め る	な だ め る
し ら た ま	し ら た ま
す ぼ ま る	す ぼ ま る
さ ず か る	さ ず か る
く ら べ る	く ら べ る
か ぶ ぬ し	か ぶ ぬ し
ど く は く	ど く は く
ま と ま り	ま と ま り
ね そ べ る	ね そ べ る
よ み こ む	よ み こ む
や す ら ぎ	や す ら ぎ
く さ の ね	く さ の ね
ま み れ る	ま み れ る
つ れ さ る	つ れ さ る
の び や か	の び や か
こ ろ が る	こ ろ が る
つ ち ぐ も	つ ち ぐ も
て が け る	て が け る
し ろ く ま	し ろ く ま
も く さ つ	も く さ つ
こ と か く	こ と か く
ぞ く ら く	ぞ く ら く
し ろ ま め	し ろ ま め
す ご ろ く	す ご ろ く
や す た か	や す た か
さ く ら ぎ	さ く ら ぎ
な ら べ る	な ら べ る
み ち す じ	み ち す じ
と も ひ ろ	と も ひ ろ
に く よ く	に く よ く
な げ や り	な げ や り
か く ま く	か く ま く
た ち ば な	た ち ば な
こ れ だ け	こ れ だ け
む ね ぽ ち	む ね ぽ ち
と り く み	と り く み
こ く べ つ	こ く べ つ
と く さ つ	と く さ つ
な ら わ し	な ら わ し
す こ ぶ る	す こ ぶ る
み ず か ら	み ず か ら
や く ど し	や く ど し
は じ ま り	は じ ま り
す ぼ め る	す ぼ め る
か ま く ら	か ま く ら
さ か む け	さ か む け
こ く じ ら	こ く じ ら
し た ど り	し た ど り
ひ き だ す	ひ き だ す
つ か ま る	つ か ま る
さ か み ち	さ か み ち
く ろ ね こ	く ろ ね こ
よ る が た	よ る が た
ひ や か す	ひ や か す
と き ど き	と き ど き
つ ぶ れ る	つ ぶ れ る
て ぬ か り	て ぬ か り
や く そ く	や く そ く
さ し ひ く	さ し ひ く
に わ と り	に わ と り
じ つ げ つ	じ つ げ つ
ぞ く ぞ く	ぞ く ぞ く
は さ ま る	は さ ま る
し の や き	し の や き
か た づ け	か た づ け
た か は し	た か は し
ば く ち く	ば く ち く
て さ ば き	て さ ば き
こ と さ ら	こ と さ ら
も た つ く	も た つ く
く れ た け	く れ た け
つ ま び く	つ ま び く
か た こ り	か た こ り
ひ ろ し ま	ひ ろ し ま
す み や か	す み や か
な ぞ な ぞ	な ぞ な ぞ
た か な し	た か な し
ひ と び と	ひ と び と
こ と わ る	こ と わ る
し な ぎ れ	し な ぎ れ
く ず か ご	く ず か ご
き さ ら ぎ	き さ ら ぎ
の び の び	の び の び
き ず つ く	き ず つ く
ま が た ま	ま が た ま
こ こ ろ み	こ こ ろ み
な ぜ な ら	な ぜ な ら
ま つ む し	ま つ む し
か な ら ず	か な ら ず
と も よ し	と も よ し
き ま じ め	き ま じ め
な が れ る	な が れ る
く ま な く	く ま な く
ぶ た ぎ り	ぶ た ぎ り
た き が わ	た き が わ
し ょ う ね ん あ い	し ょ う ね ん あ い
し ょ う ど う が い	し ょ う ど う が い
さ ん け っ し ょ う	さ ん け っ し ょ う
し ょ う が っ こ う	し ょ う が っ こ う
え ん で ん り ゅ う	え ん で ん り ゅ う
し ょ う も う ひ ん	し ょ う も う ひ ん
け ん ぎ ゅ う せ い	け ん ぎ ゅ う せ い
さ ん し ょ う う お	さ ん し ょ う う お
ぜ ん し ょ う と う	ぜ ん し ょ う と う
じ ょ う し ゃ け ん	じ ょ う し ゃ け ん
か ん り ょ う せ い	か ん り ょ う せ い
り ゅ う ぜ ん こ う	り ゅ う ぜ ん こ う
り ゅ う せ ん け い	り ゅ う せ ん け い
お う じ ょ う ぎ わ	お う じ ょ う ぎ わ
そ う じ ゅ う か ん	そ う じ ゅ う か ん
け ん じ ょ う し ゃ	け ん じ ょ う し ゃ
は ん し ゃ き ょ う	は ん し ゃ き ょ う
え き め い ひ ょ う	え き め い ひ ょ う
ち ゅ う き え い ご	ち ゅ う き え い ご
り ょ う き ん じ ょ	り ょ う き ん じ ょ
え ん ち ょ う せ ん	え ん ち ょ う せ ん
た い よ う し ゅ う	た い よ う し ゅ う
か い ち ゅ う ど け い	か い ど け い
じ ゅ ん き ょ う し ゃ	じ ゅ ん き ょ う し ゃ
え い よ う ふ り ょ う	え い よ う ふ り ょ う
し ょ う か ん じ ゅ う	し ょ う か ん じ ゅ う
お お は く ち ょ う	お お は く ち ょ う
き ょ う ど う た い	き ょ う ど う た い
と う じ ょ う け ん	と う じ ょ う け ん
へ い じ ょ う し ん	へ い じ ょ う し ん
ぼ う ち ょ う ざ い	ぼ う ち ょ う ざ い
ひ ょ う じ ゅ ん じ	ひ ょ う じ ゅ ん じ
き ょ う え い も じ	き ょ う え い も じ
け ん き ゅ う い ん	け ん き ゅ う い ん
ち ゅ う き ん と う	ち ゅ う き ん と う
ち ょ う し ん せ い	ち ょ う し ん せ い
き ょ う は ん し ゃ	き ょ う は ん し ゃ
ま っ し ょ う め ん	ま っ し ょ う め ん
ほ う き ょ う に ん	ほ う き ょ う に ん
ほ っ ぴ ょ う よ う	ほ っ ぴ ょ う よ う
は い こ う じ ょ う	は い こ う じ ょ う
で き そ こ な い	で き そ こ な い
し に ぞ こ な い	し に ぞ こ な い
あ し た れ ぼ し	あ し た れ ぼ し
ふ な く い む し	ふ な く い む し
か ま び す し い	か ま び す し い
つ く り あ げ る	つ く り あ げ る
じ じ つ ご に ん	じ じ つ ご に ん
う わ さ ば な し	う わ さ ば な し
か ぎ を に ぎ る	か ぎ を に ぎ る
い た だ き ま す	い た だ き ま す
ご ら ん に な る	ご ら ん に な る
き く の せ っ く	き く の せ っ く
す が た を け す	す が た を け す
ま ち に ま っ た	ま ち に ま っ た
こ い こ が れ る	こ い こ が れ る
き ず き あ げ る	き ず き あ げ る
つ か い ふ る し	つ か い ふ る し
て ん じ く が く	て ん じ く が く
は せ さ ん じ る	は せ さ ん じ る
た ぬ き ね い り	た ぬ き ね い り
う し み つ ど き	う し み つ ど き
か い さ つ ぐ ち	か い さ つ ぐ ち
お し す す め る	お し す す め る
お と こ ご こ ろ	お と こ ご こ ろ
ま ぐ れ あ た り	ま ぐ れ あ た り
ち か ら づ よ い	ち か ら づ よ い
う け た ま わ る	う け た ま わ る
い ち か ば ち か	い ち か ば ち か
か ら す と ん び	か ら す と ん び
は ら い も ど し	は ら い も ど し
す が す が し い	す が す が し い
な か ま い し き	な か ま い し き
は り あ わ せ る	は り あ わ せ る
ふ く さ ん ぶ つ	ふ く さ ん ぶ つ
く ま も と け ん	く ま も と け ん
う ち ほ ろ ぼ す	う ち ほ ろ ぼ す
か ぶ と あ わ せ	か ぶ と あ わ せ
き づ か わ し い	き づ か わ し い
は い せ つ ぶ つ	は い せ つ ぶ つ
や ま た い こ く	や ま た い こ く
わ ず ら わ し い	わ ず ら わ し い
か み の け ざ	か み の け ざ
も し か し て	も し か し て
や つ ぎ ば や	や つ ぎ ば や
こ し か け る	こ し か け る
た き つ け る	た き つ け る
は ぐ ら か す	は ぐ ら か す
や く だ て る	や く だ て る
か ら み つ く	か ら み つ く
は な づ ま り	は な づ ま り
き ず つ け る	き ず つ け る
と き ふ せ る	と き ふ せ る
ね こ ろ が る	ね こ ろ が る
ま く ら な げ	ま く ら な げ
だ き し め る	だ き し め る
ち く さ つ ば	ち く さ つ ば
と り か か る	と り か か る
な が ば な し	な が ば な し
つ ば く ら め	つ ば く ら め
ひ る や す み	ひ る や す み
は ら は ち ぶ	は ら は ち ぶ
た ま ぶ く ろ	た ま ぶ く ろ
ゆ き づ ま る	ゆ き づ ま る
ぬ れ そ ぼ つ	ぬ れ そ ぼ つ
は じ し ら ず	は じ し ら ず
た そ が れ る	た そ が れ る
な ら ず も の	な ら ず も の
む ね つ ぶ し	む ね つ ぶ し
ひ き こ な す	ひ き こ な す
じ ご う じ と く	じ ご う じ と く
し ぼ り こ む	し ぼ り こ む
さ し か か る	さ し か か る
か ち ほ こ る	か ち ほ こ る
た し か め る	た し か め る
か が み も ち	か が み も ち
こ こ ろ み る	こ こ ろ み る
ふ り し ぼ る	ふ り し ぼ る
し に か け る	し に か け る
や く づ く り	や く づ く り
す べ か ら く	す べ か ら く
ふ み つ け る	ふ み つ け る
も の が た り	も の が た り
わ け へ だ て	わ け へ だ て
と ば し き じ	と ば し き じ
は じ さ ら し	は じ さ ら し
よ だ れ か け	よ だ れ か け
さ か の ぼ る	さ か の ぼ る
た ど り つ く	た ど り つ く
き ぬ の み ち	き ぬ の み ち
す き ば さ み	す き ば さ み
き せ き て き	き せ き て き
や り と げ る	や り と げ る
は し わ た し	は し わ た し
ひ が し が わ	ひ が し が わ
は く ら い ひ ん	は く ら い ひ ん
か し わ も ち	か し わ も ち
き き は ず す	き き は ず す
つ か ま つ る	つ か ま つ る
く た び れ る	く た び れ る
よ び か け る	よ び か け る
れ き し て き	れ き し て き
な み だ が ち	な み だ が ち
ひ ろ い あ げ る	ひ ろ い あ げ る
す け そ う だ ら	す け そ う だ ら
こ く し む そ う	こ く し む そ う
ふ く お か け ん	ふ く お か け ん
う ち わ げ ん か	う ち わ げ ん か
わ た し た ち	わ た し た ち
お い で に な る	お い で に な る
せ き が い せ ん	せ き が い せ ん
あ ら れ も な い	あ ら れ も な い
に く だ ん せ ん	に く だ ん せ ん
む ね さ ん ず ん	む ね さ ん ず ん
せ き に ん か ん	せ き に ん か ん
し ん は つ ば い	し ん は つ ば い
か い ぞ く せ ん	か い ぞ く せ ん
た ま む し い ろ	た ま む し い ろ
く じ ゃ く せ き	く じ ゃ く せ き
み っ と も な い	み っ と も な い
へ り く だ る	へ り く だ る
だ ま り こ む	だ ま り こ む
こ も り ぐ ま	こ も り ぐ ま
も ち き た る	も ち き た る
し が み つ く	し が み つ く
こ な べ だ て	こ な べ だ て
り く つ づ き	り く つ づ き
ひ ざ が し ら	ひ ざ が し ら
ま る た ご や	ま る た ご や
な つ か し む	な つ か し む
や ま わ さ び	や ま わ さ び
た ち つ く す	た ち つ く す
た め に な る	た め に な る
か た な か じ	か た な か じ
か み や す り	か み や す り
た だ し が き	た だ し が き
も ち は こ ぶ	も ち は こ ぶ
く み た て る	く み た て る
き り ひ ら く	き り ひ ら く
は ら が へ る	は ら が へ る
ぶ ら さ げ る	ぶ ら さ げ る
き き な が す	き き な が す
こ ま り ま す	こ ま り ま す
ゆ き づ ま り	ゆ き づ ま り
こ と ご と く	こ と ご と く
ね じ ま わ し	ね じ ま わ し
き り が や つ	き り が や つ
ど ろ ま み れ	ど ろ ま み れ
く ち ず さ む	く ち ず さ む
ふ じ ば か ま	ふ じ ば か ま
め だ ま や き	め だ ま や き
つ の め ど り	つ の め ど り
は だ で し る	は だ で し る
た ぶ ら か す	た ぶ ら か す
し の び こ む	し の び こ む
か も し だ す	か も し だ す
は や と ち り	は や と ち り
き り ぎ り す	き り ぎ り す
さ し さ わ り	さ し さ わ り
ひ き た て る	ひ き た て る
こ じ つ け る	こ じ つ け る
と り か こ む	と り か こ む
な が が た な	な が が た な
く だ ら ご と	く だ ら ご と
ぎ む づ け る	ぎ む づ け る
た し な め る	た し な め る
な な し ゆ び	な な し ゆ び
か み こ な す	か み こ な す
ば く げ き き	ば く げ き き
む す び つ く	む す び つ く
ふ な か せ つ	ふ な か せ つ
か ぶ と む し	か ぶ と む し
と り し ま る	と り し ま る
か ぐ ら ざ か	か ぐ ら ざ か
か み し め る	か み し め る
し ま な が し	し ま な が し
き そ く て き	き そ く て き
か が り か ご	か が り か ご
む す び つ き	む す び つ き
か ぐ ら す ず	か ぐ ら す ず
さ か さ よ み	さ か さ よ み
は な ざ か り	は な ざ か り
か わ ら ひ わ	か わ ら ひ わ
つ く り た け	つ く り た け
さ な だ ひ も	さ な だ ひ も
こ じ つ よ み	こ じ つ よ み
み と ど け る	み と ど け る
ぶ ら さ が る	ぶ ら さ が る
む す め む こ	む す め む こ
か け ま わ る	か け ま わ る
き き お と す	き き お と す
な ま ご ろ し	な ま ご ろ し
く き わ か め	く き わ か め
も の が た る	も の が た る
と び ま わ る	と び ま わ る
さ ら け だ す	さ ら け だ す
か き ま わ す	か き ま わ す
ま き も ど す	ま き も ど す
つ き と め る	つ き と め る
な み だ ぐ む	な み だ ぐ む
こ ど も の ひ	こ ど も の ひ
か き み だ す	か き み だ す
な ま け ぐ ま	な ま け ぐ ま
め じ ろ ざ め	め じ ろ ざ め
と り と め る	と り と め る
く る み わ り	く る み わ り
く ろ れ き し	く ろ れ き し
な が れ だ す	な が れ だ す
す べ り だ し	す べ り だ し
か ぎ ま わ る	か ぎ ま わ る
か が み も じ	か が み も じ
こ ら し め る	こ ら し め る
か け ぬ け る	か け ぬ け る
か ね ま わ り	か ね ま わ り
む こ く せ き	む こ く せ き
つ き つ め る	つ き つ め る
と り の ぞ く	と り の ぞ く
ひ ざ の さ ら	ひ ざ の さ ら
み ず が め ざ	み ず が め ざ
や わ ら げ る	や わ ら げ る
は し り が き	は し り が き
ま な む す め	ま な む す め
し り こ だ ま	し り こ だ ま
つ く り だ す	つ く り だ す
や く り が く	や く り が く
つ が ざ く ら	つ が ざ く ら
く つ か く し	く つ か く し
ま つ り ご と	ま つ り ご と
ふ く ろ ぐ ま	ふ く ろ ぐ ま
で き る だ け	で き る だ け
で き ご こ ろ	で き ご こ ろ
も く て き ご	も く て き ご
は し ご ざ け	は し ご ざ け
す な ね ず み	す な ね ず み
ふ く ふ く し	ふ く ふ く し
ふ る わ せ る	ふ る わ せ る
さ る す べ り	さ る す べ り
ふ き な ら す	ふ き な ら す
み み か ざ り	み み か ざ り
つ き す す む	つ き す す む
み せ か け る	み せ か け る
つ く り も の	つ く り も の
み く ら べ る	み く ら べ る
み や び や か	み や び や か
か ぶ と が に	か ぶ と が に
す き な だ け	す き な だ け
く び に な る	く び に な る
ふ く ぶ く ろ	ふ く ぶ く ろ
ひ き つ け る	ひ き つ け る
つ か さ ど る	つ か さ ど る
の ど ぼ と け	の ど ぼ と け
ひ め は じ め	ひ め は じ め
い ぬ の と お ぼ え	い ぬ の と お ぼ え
ぜ っ た い れ い ど	ぜ っ た い れ い ど
せ い じ が く し ゃ	せ い じ が く し ゃ
か も つ れ っ し ゃ	か も つ れ っ し ゃ
に ほ ん お お か み	に ほ ん お お か み
ち ん こ ん き ょ く	ち ん こ ん き ょ く
か そ く ど び ょ う	か そ く ど び ょ う
に ひ ゃ く と お か	に ひ ゃ く と お か
で ん き つ う し ん	で ん き つ う し ん
そ う こ う の つ ま	そ う こ う の つ ま
せ っ ち ゃ く ざ い	せ っ ち ゃ く ざ い
み や こ の じ ょ う	み や こ の じ ょ う
ぜ ん た い し ゅ ぎ	ぜ ん た い し ゅ ぎ
ゆ う れ い や し き	ゆ う れ い や し き
ぶ か ん は い え ん	ぶ か ん は い え ん
つ な み け い ほ う	つ な み け い ほ う
ほ う む だ い じ ん	ほ う む だ い じ ん
こ て い ば い た い	こ て い ば い た い
た い げ ん そ う ご	た い げ ん そ う ご
く へ ん と う す い	く へ ん と う す い
し ゃ じ つ し ゅ ぎ	し ゃ じ つ し ゅ ぎ
か り し ゃ く ほ う	か り し ゃ く ほ う
ろ め ん で ん し ゃ	ろ め ん で ん し ゃ
な ん き ょ く か い	な ん き ょ く か い
は ん だ ん り ょ く	は ん だ ん り ょ く
れ ん き ん じ ゅ つ	れ ん き ん じ ゅ つ
な い し ゅ っ け つ	な い し ゅ っ け つ
あ い こ く し ゅ ぎ	あ い こ く し ゅ ぎ
ご く ら く ち ょ う	ご く ら く ち ょ う
ひ め い を あ げ る	ひ め い を あ げ る
こ う だ い む へ ん	こ う だ い む へ ん
ほ ろ ほ ろ ち ょ う	ほ ろ ほ ろ ち ょ う
ち ょ う は つ ぞ く	ち ょ う は つ ぞ く
ち ょ っ か ん て き	ち ょ っ か ん て き
よ ん き ょ く か ん	よ ん き ょ く か ん
じ き ゅ う じ そ く	じ き ゅ う じ そ く
く び な が り ゅ う	く び な が り ゅ う
ひ ゅ う が の く に	ひ ゅ う が の く に
き か い せ い た い	き か い せ い た い
さ ん き ょ く か ん	さ ん き ょ く か ん
い ち よ う ぶ ん ぷ	い ち よ う ぶ ん ぷ
た い ぎ ゃ く ざ い	た い ぎ ゃ く ざ い
せ い よ う わ さ び	せ い よ う わ さ び
ま ん か ん し ょ く	ま ん か ん し ょ く
じ ん こ う げ ん ご	じ ん こ う げ ん ご
せ ん い こ う が く	せ ん い こ う が く
つ じ じ ど う し ゃ	つ じ じ ど う し ゃ
び し ゃ も ん て ん	び し ゃ も ん て ん
し せ い か ん せ ん	し せ い か ん せ ん
す え お そ ろ し い	す え お そ ろ し い
に く し ょ く け い	に く し ょ く け い
へ い り つ じ ょ し	へ い り つ じ ょ し
に じ ゅ う ご に ち	に じ ゅ う ご に ち
さ い み ん り ょ う ほ う	さ い み ん り ょ う ほ う
じ ぎ ょ う け い か く	じ ぎ ょ う け い か く
い っ さ ん か ち っ そ	い っ さ ん か ち っ そ
な い せ い か ん し ょ う	な い せ い か ん し ょ う
よ う け い せ い じ ゅ く	よ う け い せ い じ ゅ く
け い か く う ん き ゅ う	け い か く う ん き ゅ う
た ん さ ん い ん り ょ う	た ん さ ん い ん り ょ う
り ょ う く う し ん ぱ ん	り ょ う く う し ん ぱ ん
ざ い り ゅ う ほ う じ ん	ざ い り ゅ う ほ う じ ん
ち ょ う え つ か ん す う	ち ょ う え つ か ん す う
か い ち ゅ う で ん と う	か い ち ゅ う で ん と う
じ げ し ょ う め い し ょ	じ げ し ょ う め い し ょ
ち ょ う せ ん は ん と う	ち ょ う せ ん は ん と う
さ し み ぼ う ち ょ う	さ し み ぼ う ち ょ う
こ う ち ょ う ど う ぶ つ	こ う ち ょ う ど う ぶ つ
じ ゅ ぎ ょ う さ ん か ん	じ ゅ ぎ ょ う さ ん か ん
く う き せ い じ ょ う き	く う き せ い じ ょ う き
ひ ゃ く に ん い っ し ゅ	ひ ゃ く に ん い っ し ゅ
し ゅ っ し ん せ い ぶ ん	し ゅ っ し ん せ い ぶ ん
し ょ う ぜ ん て い せ ん	し ょ う ぜ ん て い せ ん
だ い じ ょ う ぶ っ き ょ う	だ い じ ょ う ぶ っ き ょ う
ほ し ゅ う じ ゅ ぎ ょ う こ う	ほ し ゅ う じ ゅ ぎ ょ う こ う
じ ょ う み ゃ く ち ゅ う し ゃ	じ ょ う み ゃ く ち ゅ う し ゃ
ち ょ う て い し ゅ う は お ん	ち ょ う て い し ゅ う は お ん
き ょ う せ い ろ う ど う し ょ う	き ょ う せ い ろ う ど う し ょ う
き ょ う せ い し ゅ う よ う じ ょ	き ょ う せ い し ゅ う よ う じ ょ
さ ん じ ゅ う す い そ	さ ん じ ゅ う す い そ
し ぜ ん げ ん し ょ う	し ぜ ん げ ん し ょ う
せ い し ゅ ん じ だ い	せ い し ゅ ん じ だ い
ご う べ ん が い し ゃ	ご う べ ん が い し ゃ
り が く り ょ う ほ う	り が く り ょ う ほ う
じ い し き か じ ょ う	じ い し き か じ ょ う
い ち ご ん ほ う お ん	い ち ご ん ほ う お ん
ひ じ ょ う か い だ ん	ひ じ ょ う か い だ ん
し ゃ く し じ ょ う ぎ	し ゃ く し じ ょ う ぎ
だ い す う か ん す う	だ い す う か ん す う
だ ん が ん れ っ し ゃ	だ ん が ん れ っ し ゃ
か ん が い む り ょ う	か ん が い む り ょ う
み ん か ん ほ う そ う	み ん か ん ほ う そ う
け ん こ う し ん さ	け ん こ う し ん さ
し ん け い さ い ぼ う	し ん け い さ い ぼ う
に ほ ん か い り ゅ う	に ほ ん か い り ゅ う
う ち ゅ う た ん さ き	う ち ゅ う た ん さ き
だ い え い て い こ く	だ い え い て い こ く
け い た い ば ん ご う	け い た い ば ん ご う
む せ い せ い し ょ く	む せ い せ い し ょ く
そ う で ん そ う か い	そ う で ん そ う か い
か え ん ほ う し ゃ き	か え ん ほ う し ゃ き
そ う か い そ う で ん	そ う か い そ う で ん
て い し ょ と く し ゃ	て い し ょ と く し ゃ
て ん ね ん お ん せ ん	て ん ね ん お ん せ ん
し ぜ ん か ん き ょ う	し ぜ ん か ん き ょ う
た い せ き が ん	た い せ き が ん
そ そ っ か し い	そ そ っ か し い
い ば ら き べ ん	い ば ら き べ ん
い ろ あ ざ や か	い ろ あ ざ や か
す う じ く こ く	す う じ く こ く
そ く ば い か い	そ く ば い か い
に じ そ う さ く	に じ そ う さ く
き か こ う が く	き か こ う が く
ら し ん ば ん ざ	ら し ん ば ん ざ
で あ い が し ら	で あ い が し ら
ば く は つ お ん	ば く は つ お ん
す い ぞ く か ん	す い ぞ く か ん
し ぜ ん げ ん ご	し ぜ ん げ ん ご
き ど あ い ら く	き ど あ い ら く
げ ん じ つ か ん	げ ん じ つ か ん
い ば ら き け ん	い ば ら き け ん
る い ご じ て ん	る い ご じ て ん
ほ く し ん ろ ん	ほ く し ん ろ ん
ま ん を じ す る	ま ん を じ す る
み じ ゅ く も の	み じ ゅ く も の
ま が ま が し い	ま が ま が し い
ま っ か ん が に	ま っ か ん が に
よ じ じ ゅ く ご	よ じ じ ゅ く ご
ぜ っ た い て き	ぜ っ た い て き
む な ぐ る し い	む な ぐ る し い
ほ お じ ろ ざ め	ほ お じ ろ ざ め
な い は ん そ く	な い は ん そ く
ち ん ち ろ り ん	ち ん ち ろ り ん
ぜ つ ぼ う て き	ぜ つ ぼ う て き
け た た ま し い	け た た ま し い
こ く は つ し ゃ	こ く は つ し ゃ
う し ろ あ る き	う し ろ あ る き
そ っ ぽ を む く	そ っ ぽ を む く
と り ひ き じ ょ	と り ひ き じ ょ
に に ん ば お り	に に ん ば お り
と り あ つ か う	と り あ つ か う
て ん ぜ ん し ば	て ん ぜ ん し ば
た て が み い ぬ	た て が み い ぬ
あ わ た だ し い	あ わ た だ し い
す く い あ げ る	す く い あ げ る
お た が い さ ま	お た が い さ ま
か た を い れ る	か た を い れ る
か い ぞ く ば ん	か い ぞ く ば ん
ま ん じ と も え	ま ん じ と も え
さ ん ぱ く が ん	さ ん ぱ く が ん
が ま ん づ よ い	が ま ん づ よ い
は た め い わ く	は た め い わ く
じ つ ひ き す う	じ つ ひ き す う
は な か ん ら ん	は な か ん ら ん
ね ん に い ち ど	ね ん に い ち ど
ま ち あ い し つ	ま ち あ い し つ
ぼ う た か と び	ぼ う た か と び
じ つ ざ い ろ ん	じ つ ざ い ろ ん
せ い ぶ つ が く	せ い ぶ つ が く
じ っ け ん し つ	じ っ け ん し つ
せ ん て ん て き	せ ん て ん て き
い っ ぱ つ ど り	い っ ぱ つ ど り
し ゅ も く ざ め	し ゅ も く ざ め
う ら や ま し い	う ら や ま し い
く す ぐ っ た い	く す ぐ っ た い
い た く さ ん か	い た く さ ん か
も の も の し い	も の も の し い
ま ぼ ろ し と う	ま ぼ ろ し と う
げ ん だ い げ き	げ ん だ い げ き
は つ た い け ん	は つ た い け ん
お い て け ぼ り	お い て け ぼ り
か ん む り わ し	か ん む り わ し
せ き た ん さ ん	せ き た ん さ ん
や の あ さ っ て	や の あ さ っ て
お び た だ し い	お び た だ し い
ご え も ん ぶ ろ	ご え も ん ぶ ろ
き ん け ん せ い じ	き ん け ん せ い じ
し つ ど く し ょ う	し つ ど く し ょ う
し ん ぱ い て い し	し ん ぱ い て い し
で ん こ う せ っ か	で ん こ う せ っ か
か っ こ う わ る い	か っ こ う わ る い
お お う み が ら す	お お う み が ら す
げ ん ざ い じ せ い	げ ん ざ い じ せ い
さ い ほ く た ん	さ い ほ く た ん
す い も ん が く	す い も ん が く
が い こ く じ ん	が い こ く じ ん
ゆ う そ く よ み	ゆ う そ く よ み
う た っ て み た	う た っ て み た
こ べ つ し ど う	こ べ つ し ど う
な か が い に ん	な か が い に ん
い し か わ け ん	い し か わ け ん
に つ か わ し い	に つ か わ し い
か え す が え す	か え す が え す
そ り じ た お ん	そ り じ た お ん
き こ く し じ ょ	き こ く し じ ょ
な ん で や ね ん	な ん で や ね ん
わ け あ た え る	わ け あ た え る
か ん け つ せ ん	か ん け つ せ ん
ふ か か ち ぜ い	ふ か か ち ぜ い
あ い か わ ら ず	あ い か わ ら ず
む せ ん で ん わ	む せ ん で ん わ
か み ひ こ う き	か み ひ こ う き
お き な わ け ん	お き な わ け ん
お も ん ぱ か る	お も ん ぱ か る
あ け っ ぱ な し	あ け っ ぱ な し
し っ た ん も じ	し っ た ん も じ
り き が く け い	り き が く け い
い っ て き ま す	い っ て き ま す
つ め か ん む り	つ め か ん む り
な し と げ る	な し と げ る
わ り き れ る	わ り き れ る
み な ご ろ し	み な ご ろ し
ひ と ば し ら	ひ と ば し ら
ひ ざ ま ず く	ひ ざ ま ず く
か み こ ろ す	か み こ ろ す
と り つ け る	と り つ け る
ば け の か わ	ば け の か わ
な ぐ り が き	な ぐ り が き
も ぐ り こ む	も ぐ り こ む
し ら ぎ ご と	し ら ぎ ご と
て な が ざ る	て な が ざ る
ひ ま つ ぶ し	ひ ま つ ぶ し
ふ く じ て き	ふ く じ て き
や ま つ な み	や ま つ な み
ひ と も ど き	ひ と も ど き
め く ら ぐ も	め く ら ぐ も
と り も ど す	と り も ど す
ひ と と な り	ひ と と な り
は く り き こ	は く り き こ
さ く ら も ち	さ く ら も ち
ば か <<unk>> か ら	ば か <unk> か ら
も く し ろ く	も く し ろ く
こ こ ろ ざ し	こ こ ろ ざ し
み や こ じ ま	み や こ じ ま
や ぶ の な か	や ぶ の な か
み や つ こ ぎ	み や つ こ ぎ
は こ び こ む	は こ び こ む
は め た お す	は め た お す
く い さ が る	く い さ が る
こ が ね い ろ	こ が ね い ろ
や わ ら か い	や わ ら か い
め を つ け る	め を つ け る
に く た い び	に く た い び
け ん か ご し	け ん か ご し
と と の え る	と と の え る
さ る し ば い	さ る し ば い
の て ん ぶ ろ	の て ん ぶ ろ
あ た た め る	あ た た め る
で き あ が る	で き あ が る
お ひ と よ し	お ひ と よ し
か い こ ろ く	か い こ ろ く
ず ん だ も ち	ず ん だ も ち
だ か い さ く	だ か い さ く
く る い ざ き	く る い ざ き
い ま ひ と つ	い ま ひ と つ
と び お り る	と び お り る
お や ご こ ろ	お や ご こ ろ
あ て は め る	あ て は め る
せ き ば ら い	せ き ば ら い
つ か い み ち	つ か い み ち
に ほ ん こ く	に ほ ん こ く
に ほ ん ざ る	に ほ ん ざ る
あ け く れ る	あ け く れ る
つ き あ た り	つ き あ た り
う た つ ぐ み	う た つ ぐ み
こ ば ん ざ め	こ ば ん ざ め
と よ く こ ん	と よ く こ ん
つ か ま え る	つ か ま え る
さ わ が し い	さ わ が し い
ま ん ぞ く ど	ま ん ぞ く ど
も て あ そ ぶ	も て あ そ ぶ
お と こ の こ	お と こ の こ
み か く に ん	み か く に ん
し か た な い	し か た な い
ざ く ろ い し	ざ く ろ い し
よ み あ げ る	よ み あ げ る
い き ぐ す り	い き ぐ す り
う ら み ぶ し	う ら み ぶ し
そ め あ げ る	そ め あ げ る
あ わ よ く ば	あ わ よ く ば
や と い ぬ し	や と い ぬ し
あ け は な す	あ け は な す
て つ ば ん ど	て つ ば ん ど
く さ は え る	く さ は え る
う ち く だ く	う ち く だ く
た つ た あ げ	た つ た あ げ
み ず の あ わ	み ず の あ わ
ぬ い ぐ る み	ぬ い ぐ る み
は な だ い ろ	は な だ い ろ
こ じ ん て き	こ じ ん て き
む ず か し い	む ず か し い
か ぐ ら ぶ え	か ぐ ら ぶ え
か き お ろ す	か き お ろ す
だ ん ご む し	だ ん ご む し
あ り じ ご く	あ り じ ご く
も の す ご い	も の す ご い
め し つ か い	め し つ か い
ぶ っ た く り	ぶ っ た く り
ま っ ぴ る ま	ま っ ぴ る ま
か な つ ん ぼ	か な つ ん ぼ
あ ま の が わ	あ ま の が わ
や お よ ろ ず	や お よ ろ ず
ね こ め い し	ね こ め い し
か く か っ こ	か く か っ こ
ひ ら お よ ぎ	ひ ら お よ ぎ
し っ た つ り	し っ た つ り
ま で も な い	ま で も な い
じ さ つ て ん	じ さ つ て ん
な き う さ ぎ	な き う さ ぎ
す れ ち が う	す れ ち が う
さ く が ん き	さ く が ん き
い つ く し み	い つ く し み
さ だ め な い	さ だ め な い
う け つ け る	う け つ け る
ぼ っ ち め し	ぼ っ ち め し
か き な お す	か き な お す
ひ く い ど り	ひ く い ど り
わ き あ が る	わ き あ が る
も よ り え き	も よ り え き
た が い に そ	た が い に そ
と く い さ き	と く い さ き
か く れ ん ぼ	か く れ ん ぼ
き え は て る	き え は て る
し か け に ん	し か け に ん
い わ く つ き	い わ く つ き
む し の い き	む し の い き
ま え の め り	ま え の め り
い ろ じ か け	い ろ じ か け
い き じ び き	い き じ び き
あ ら け ず り	あ ら け ず り
な で お ろ す	な で お ろ す
て り か え す	て り か え す
お や ゆ ず り	お や ゆ ず り
し ぜ ん て き	し ぜ ん て き
う ち の め す	う ち の め す
ひ る ご は ん	ひ る ご は ん
す ば し こ い	す ば し こ い
な い が し ろ	な い が し ろ
お ち つ け る	お ち つ け る
あ ず ま ご と	あ ず ま ご と
こ け お ど し	こ け お ど し
ゆ め う つ つ	ゆ め う つ
し き ち な い	し き ち な い
や つ あ た り	や つ あ た り
あ ふ れ で る	あ ふ れ で る
こ ご え し ぬ	こ ご え し ぬ
ま る の う ち	ま る の う ち
た か い び き	た か い び き
い き の こ る	い き の こ る
ひ と そ ろ い	ひ と そ ろ い
ひ る が え す	ひ る が え す
う き す ど り	う き す ど り
も ち の ろ ん	も ち の ろ ん
に が わ ら い	に が わ ら い
ふ っ き れ る	ふ っ き れ る
う れ の こ り	う れ の こ り
い し だ た み	い し だ た み
こ い が た き	こ い が た き
し ん に ち は	し ん に ち は
て に は い る	て に は い る
て つ を ふ む	て つ を ふ む
う ぬ ぼ れ る	う ぬ ぼ れ る
ち り れ ん げ	ち り れ ん げ
ひ き お こ す	ひ き お こ す
う り き れ る	う り き れ る
だ い し ら ず	だ い し ら ず
あ か げ ざ る	あ か げ ざ る
お ど ろ か す	お ど ろ か す
ど ん ぶ ら こ	ど ん ぶ ら こ
あ ら わ れ る	あ ら わ れ る
お も て ざ た	お も て ざ た
も り あ げ る	も り あ げ る
で む か え る	で む か え る
の ど ち ん こ	の ど ち ん こ
も の ぐ る い	も の ぐ る い
さ ん ぶ つ げ	さ ん ぶ つ げ
か い ぎ し つ	か い ぎ し つ
と こ ろ て ん	と こ ろ て ん
さ し あ げ る	さ し あ げ る
よ み が え る	よ み が え る
す み れ い ろ	す み れ い ろ
い ち は や く	い ち は や く
と き あ か す	と き あ か す
い わ の ぼ り	い わ の ぼ り
や だ い ぼ ね	や だ い ぼ ね
う つ の み や	う つ の み や
ひ る が え る	ひ る が え る
ら く て ん か	ら く て ん か
と り い れ る	と り い れ る
だ い そ れ た	だ い そ れ た
き き か ん り	き き か ん り
み ず い ら ず	み ず い ら ず
つ つ い づ つ	つ つ い づ つ
ま た と な い	ま た と な い
は ば ひ ろ い	は ば ひ ろ い
た そ く る い	た そ く る い
か ん こ ど り	か ん こ ど り
く び っ た け	く び っ た け
う ま の ほ ね	う ま の ほ ね
ひ や や っ こ	ひ や や っ こ
さ ん か く ざ	さ ん か く ざ
に ら め っ こ	に ら め っ こ
あ ら た ま る	あ ら た ま る
げ ん し て き	げ ん し て き
ぼ ん や す み	ぼ ん や す み
も ち あ わ せ	も ち あ わ せ
つ み ぶ か い	つ み ぶ か い
う れ し な き	う れ し な き
す い ぼ く が	す い ぼ く が
か ぜ あ た り	か ぜ あ た り
か み し ば い	か み し ば い
い ち じ く か	い ち じ く か
や っ て く る	や っ て く る
つ き ま と う	つ き ま と う
う み へ び ざ	う み へ び ざ
く つ が え る	く つ が え る
ぶ っ か だ か	ぶ っ か だ か
が い こ く ご	が い こ く ご
し ら ん ぷ り	し ら ん ぷ り
も ち あ げ る	も ち あ げ る
う ら ば な し	う ら ば な し
あ わ だ て き	あ わ だ て き
く い こ ろ す	く い こ ろ す
む す い ぶ つ	む す い ぶ つ
か く し あ じ	か く し あ じ
と り あ た ま	と り あ た ま
ひ き あ げ る	ひ き あ げ る
は ん だ づ け	は ん だ づ け
ふ り か え る	ふ り か え る
ひ つ じ か い	ひ つ じ か い
や せ お と こ	や せ お と こ
び ん ざ さ ら	び ん ざ さ ら
あ り き た り	あ り き た り
つ き あ た る	つ き あ た る
な ま ぬ る い	な ま ぬ る い
わ か が え る	わ か が え る
た ち な お る	た ち な お る
ご げ ん て き	ご げ ん て き
い な く な る	い な く な る
ね り な お す	ね り な お す
い く ぐ す り	い く ぐ す り
お く り も の	お く り も の
か な づ か い	か な づ か い
り ん り が く	り ん り が く
は や が て ん	は や が て ん
い ず の く に	い ず の く に
た ち あ が る	た ち あ が る
は な し が い	は な し が い
あ め の し た	あ め の し た
こ く さ い か	こ く さ い か
あ ま て ら す	あ ま て ら す
う み と か げ	う み と か げ
こ だ い も う そ う	こ だ い も う そ う
じ こ ち ゅ う し ん	じ こ ち ゅ う し ん
に ほ ん り ょ う り	に ほ ん り ょ う り
か い し ゅ う り つ	か い し ゅ う り つ
ち ょ う げ ん じ つ	ち ょ う げ ん じ つ
ば と う か ん の ん	ば と う か ん の ん
へ い こ う し ん か	へ い こ う し ん か
き ょ し ゅ つ き ん	き ょ し ゅ つ き ん
ぶ ん め い か い か	ぶ ん め い か い か
せ ん し ゅ う ら く	せ ん し ゅ う ら く
か ん じ ょ う て き	か ん じ ょ う て き
あ ま っ ち ょ ろ い	あ ま っ ち ょ ろ い
こ う し ん き ょ く	こ う し ん き ょ く
ひ と ば ん じ ゅ う	ひ と ば ん じ ゅ う
よ う り ょ く た い	よ う り ょ く た い
じ ゅ う に ひ と え	じ ゅ う に ひ と え
げ ん そ う き ょ く	げ ん そ う き ょ く
い ん ぎ ん ぶ れ い	い ん ぎ ん ぶ れ い
じ ん こ う ち の う	じ ん こ う ち の う
お う ご ん じ だ い	お う ご ん じ だ い
も ん し ろ ち ょ う	も ん し ろ ち ょ う
し つ ぎ お う と う	し つ ぎ お う と う
さ ん み い っ た い	さ ん み い っ た い
こ う つ う き か ん	こ う つ う き か ん
ほ ん ば ん こ う い	ほ ん ば ん こ う い
ど う じ ん ざ っ し	ど う じ ん ざ っ し
お く び ょ う も の	お く び ょ う も の
て き だ ん へ い	て き だ ん へ い
な い て ん き ん	な い て ん き ん
な ん き ん ま め	な ん き ん ま め
あ ろ う こ と か	あ ろ う こ と か
し っ ぽ う や き	し っ ぽ う や き
あ お う な ば ら	あ お う な ば ら
よ ろ い ど う し	よ ろ い ど う し
お う か く ま く	お う か く ま く
か ん し つ け い	か ん し つ け い
あ つ く る し い	あ つ く る し い
ふ わ ら い ど う	ふ わ ら い ど う
せ ん す い か ん	せ ん す い か ん
な が じ ゅ ば ん	な が じ ゅ ば ん
ざ い ら い せ ん	ざ い ら い せ ん
す う ち ょ く せ ん	す う ち ょ く せ ん
い か が わ し い	い か が わ し い
き き い っ ぱ つ	き き い っ ぱ つ
か か あ で ん か	か か あ で ん か
つ っ ぱ り ぼ う	つ っ ぱ り ぼ う
ち ん ぷ ん か ん	ち ん ぷ ん か ん
み ず で っ ぽ う	み ず で っ ぽ う
け ん い ん や く	け ん い ん や く
な ん ば ん じ ん	な ん ば ん じ ん
ご め ん な さ い	ご め ん な さ い
こ て い で ん わ	こ て い で ん わ
し ょ う ひ き げ ん	し ょ う ひ き げ ん
ふ の か ん じ ょ う	ふ の か ん じ ょ う
れ ん し ゅ う き ょ く	れ ん し ゅ う き ょ く
け い き か ん じ ゅ う	け い き か ん じ ゅ う
う ち ゅ う ひ こ う し	う ち ゅ う ひ こ う し
こ う お つ へ い て い	こ う お つ へ い て い
だ ん し ょ う し ゅ ぎ	だ ん し ょ う し ゅ ぎ
き ょ う さ ん し ゅ ぎ	き ょ う さ ん し ゅ ぎ
じ ょ う よ う か ん じ	じ ょ う よ う か ん じ
お ん な ぶ げ い し ゃ	お ん な ぶ げ い し ゃ
ど う ぎ ょ う に に ん	ど う ぎ ょ う に に ん
じ し ゅ れ ん し ゅ う	じ し ゅ れ ん し ゅ う
い っ し ん ど う た い	い っ し ん ど う た い
は じ ゃ け ん し ょ う	は じ ゃ け ん し ょ う
じ ゅ じ ょ う と っ き	じ ゅ じ ょ う と っ き
い っ さ い が っ さ い	い っ さ い が っ さ い
き ゅ う し ん し ゅ ぎ	き ゅ う し ん し ゅ ぎ
い っ き ょ い ち ど う	い っ き ょ い ち ど う
と う ほ ん せ い そ う	と う ほ ん せ い そ う
て い お う せ っ か い	て い お う せ っ か い
じ ょ う よ う た い す う	じ ょ う よ う た い す う
せ い し ん り ょ う ほ う	せ い し ん り ょ う ほ う
じ ょ う し ゃ ひ っ す い	じ ょ う し ゃ ひ っ す い
た い し ょ り ょ う ほ う	た い し ょ り ょ う ほ う
ぼ う に ょ う ど う せ ん	ぼ う に ょ う ど う せ ん
ち ょ う ち ん あ ん こ う	ち ょ う ち ん あ ん こ う
し ゅ ん か し ゅ う と う	し ゅ ん か し ゅ う と う
に ょ う ど う き ゅ う せ ん	に ょ う ど う き ゅ う せ ん
き ょ う ご う じ ょ う た い	き ょ う ご う じ ょ う た い
し っ ぷ う ど と う	し っ ぷ う ど と う
に じ ゅ う み っ か	に じ ゅ う み っ か
き ょ う い く が く	き ょ う い く が く
や す げ っ き ゅ う	や す げ っ き ゅ う
ぶ ん お ん ふ ご う	ぶ ん お ん ふ ご う
ゆ う び ん き ょ く	ゆ う び ん き ょ く
じ て ん し ゃ ど う	じ て ん し ゃ ど う
し と ぎ ょ う で ん	し と ぎ ょ う で ん
て ん か つ き ゅ う	て ん か つ き ゅ う
ろ ん し ょ う き か	ろ ん し ょ う き か
は っ け つ び ょ う	は っ け つ び ょ う
お め い ば ん か い	お め い ば ん か い
あ く い ん あ っ か	あ く い ん あ っ か
し か ん し き	し か ん し き
に ん ぎ ょ う げ き	に ん ぎ ょ う げ き
じ ょ う わ ん こ つ	じ ょ う わ ん こ つ
じ ゅ な ん き ょ く	じ ゅ な ん き ょ く
が い こ う じ れ い	が い こ う じ れ い
ほ っ き ょ く せ い	ほ っ き ょ く せ い
む き ち ょ う え き	む き ち ょ う え き
い じ ん し ゅ か ん	い じ ん し ゅ か ん
と う ぶ が い し ょ う	と う ぶ が い し ょ う
い ん ぼ う ろ ん し ゃ	い ん ぼ う ろ ん し ゃ
ぐ う ぞ う す う は い	ぐ う ぞ う す う は い
へ ん り き ょ う せ い	へ ん り き ょ う せ い
い っ せ き に ち ょ う	い っ せ き に ち ょ う
こ く さ い ほ う	こ く さ い ほ う
く り か え し	く り か え し
ま っ ぷ た つ	ま っ ぷ た つ
く り か え す	く り か え す
な ぞ ら え る	な ぞ ら え る
な に げ な い	な に げ な い
ふ ま ん ぞ く	ふ ま ん ぞ く
の り あ げ る	の り あ げ る
ろ て ん ぶ ろ	ろ て ん ぶ ろ
は い き も の	は い き も の
し か く す い	し か く す い
よ い し れ る	よ い し れ る
ぎ ょ が ん せ き	ぎ ょ が ん せ き
で ん で ん む し	で ん で ん む し
と り あ げ る	と り あ げ る
し ゃ す い へ き	し ゃ す い へ き
し ょ っ き だ な	し ょ っ き だ な
た い い ん れ き	た い い ん れ き
か わ い ら し い	か わ い ら し い
さ い る い だ ん	さ い る い だ ん
な ん き ん む し	な ん き ん む し
む さ い し ょ く	む さ い し ょ く
び ゃ く だ ん ゆ	び ゃ く だ ん ゆ
か く せ い ざ い	か く せ い ざ い
は り ち り ょ う	は り ち り ょ う
せ い じ ん し き	せ い じ ん し き
は ん し ゃ て き	は ん し ゃ て き
み じ ん ぎ り	み じ ん ぎ り
や ま い だ れ	や ま い だ れ
ふ る く さ い	ふ る く さ い
ひ が ん ば な	ひ が ん ば な
す み ま せ ん	す み ま せ ん
こ く さ い ご	こ く さ い ご
ち く で ん き	ち く で ん き
ほ ろ に が い	ほ ろ に が い
く つ が え す	く つ が え す
さ ん か く す	さ ん か く す
ね ち が え る	ね ち が え る
あ こ が れ る	あ こ が れ る
し た が え る	し た が え る
じ ゅ ん か つ ゆ	じ ゅ ん か つ ゆ
お れ ま が る	お れ ま が る
じ だ い げ き	じ だ い げ き
お く ら せ る	お く ら せ る
め を み は る	め を み は る
は ち り は ん	は ち り は ん
ま め あ ぶ ら	ま め あ ぶ ら
う ま れ つ き	う ま れ つ き
い た に つ く	い た に つ く
お と な ぶ る	お と な ぶ る
あ ま や か す	あ ま や か す
い れ か わ る	い れ か わ る
お や し ら ず	お や し ら ず
あ お も り け ん	あ お も り け ん
に っ こ う よ く	に っ こ う よ く
に い が た け ん	に い が た け ん
ご き ょ く か ん	ご き ょ く か ん
た ん さ ん す い	た ん さ ん す い
す い そ う が く	す い そ う が く
か い よ う が く	か い よ う が く
お こ が ま し い	お こ が ま し い
せ い ぜ ん せ つ	せ い ぜ ん せ つ
も っ た い な い	も っ た い な い
や む を え な い	や む を え な い
ご し ん じ ゅ つ	ご し ん じ ゅ つ
わ せ い か ん ご	わ せ い か ん ご
ぞ う あ ざ ら し	ぞ う あ ざ ら し
こ ん し ん か い	こ ん し ん か い
み ら い じ せ い	み ら い じ せ い
こ ん や く し ゃ	こ ん や く し ゃ
わ す れ ん ぼ う	わ す れ ん ぼ う
て ん と う む し	て ん と う む し
け ん ぱ く し ょ	け ん ぱ く し ょ
は い で ん ば ん	は い で ん ば ん
き ん ぎ ょ ば ち	き ん ぎ ょ ば ち
か ん い っ ぱ つ	か ん い っ ぱ つ
り っ き ゃ く ち	り っ き ゃ く ち
ま ん よ う が な	ま ん よ う が な
か ん さ い じ ん	か ん さ い じ ん
な ん て ん も ん	な ん て ん も ん
か い が ん せ ん	か い が ん せ ん
こ う う つ や く	こ う う つ や く
ひ つ ぜ ん せ い	ひ つ ぜ ん せ い
う た が わ し い	う た が わ し い
あ ま の じ ゃ く	あ ま の じ ゃ く
さ い ば ん け ん	さ い ば ん け ん
き ょ た ん や く	き ょ た ん や く
こ う し き せ ん	こ う し き せ ん
か い た く し ゃ	か い た く し ゃ
か ん せ ん げ ん	か ん せ ん げ ん
た い け い て き	た い け い て き
だ い す う が く	だ い す う が く
と う ち り め ん	と う ち り め ん
ご き げ ん よ う	ご き げ ん よ う
く へ ん と う ゆ	く へ ん と う ゆ
い ち じ て い し	い ち じ て い し
ぼ ろ ぞ う き ん	ぼ ろ ぞ う き ん
お か ら こ う じ	お か ら こ う じ
て っ こ う か ぎ	て っ こ う か ぎ
な か お れ ぼ う	な か お れ ぼ う
ぎ ょ る い が く	ぎ ょ る い が く
じ も ん じ と う	じ も ん じ と う
べ ん と う ば こ	べ ん と う ば こ
ご ぞ う ろ っ ぷ	ご ぞ う ろ っ ぷ
し ゅ く が か い	し ゅ く が か い
ゆ う ぼ く み ん	ゆ う ぼ く み ん
し ゅ う ち ゅ う り ょ く	し ゅ う ち ゅ う り ょ く
じ ょ う し ょ う き り ゅ う	じ ょ う し ょ う き り ゅ う
き ょ う つ う し ゅ う ご う	き ょ う つ う し ゅ う ご う
じ ど う し ょ う じ ゅ う	じ ど う し ょ う じ ゅ う
お ん か か か び さ ん ま え い そ わ か	お ん か か か び さ ん ま え い そ わ か
た ん ぱ く し つ ぶ ん か い こ う そ	た ん ぱ く し つ ぶ ん か い こ
い し ば し を た た い て わ た る	い し ば し を た た い て わ た る
い し ば し を た た い て こ わ す	い し ば し を た た い て こ わ す
あ ま の む ら く も の つ る ぎ	あ ま の む ら く も の つ る ぎ
ひ と す じ な わ で は い か ぬ	ひ と す じ な わ で は い か ぬ
は や お き は さ ん も ん の と く	は や お き は さ ん も ん の と く
む し の い ど こ ろ が わ る い	む し の い ど こ ろ が わ る い
よ ろ し く お ね が い し ま す	よ ろ し く お ね が い し ま す
こ の は な の さ く や ひ め	こ の は な の さ く や ひ め
げ ん し か く ぶ つ り が く	げ ん し か く ぶ つ り が く
じ ど う げ ん き ん よ は ら い き	じ ど う げ ん き ん よ は ら い き
し ゅ ん み ん あ か つ き を お ぼ え ず	し ゅ ん み ん あ か つ き を ぼ え ず
ど う ぶ つ ゆ ら い か ん せ ん し ょ う	ど う ぶ つ ゆ ら い か ん し ょ う
じ ゅ う よ う ぎ ょ う せ き ひ ょ う か し ひ ょ う	じ ゅ う よ う ぎ ょ う せ き ひ ょ う か し ひ ょ
く さ に く さ は や す な	く さ に く さ は や す な
と し よ り の ひ や み ず	と し よ り の ひ や み ず
き ょ う ち ょ く せ い せ き つ い え ん	き ょ う ち ょ く せ い せ き つ い え ん
い っ ぱ ん そ う た い せ い り ろ ん	い っ ぱ ん そ う た い せ い り ろ ん
き り つ せ い て い け つ あ つ	き り つ せ い て い け つ あ つ
と り し ま り や く か い	と り し ま り や く か い
こ ろ ば ぬ さ き の つ え	こ ろ ば ぬ さ き の つ え
か が く は く ぶ つ か ん	か が く は く ぶ つ か ん
れ き し し ゅ う せ い し ゅ ぎ し ゃ	れ き し し ゅ う せ い し ゅ ぎ し ゃ
く さ な ぎ の つ る ぎ	く さ な ぎ の つ る ぎ
し ろ な が す く じ ら	し ろ な が す く じ ら
せ い ぶ つ ぶ つ り が く	せ い ぶ つ ぶ つ り が く
こ ど も べ や お じ さ ん	こ ど も べ や お じ さ ん
く ち は っ ち ょ う て は っ ち ょ う	く ち は っ ち ょ う て は っ ち ょ う
こ う き ょ う し ょ く ぎ ょ う あ ん て い じ ょ	こ う き ょ う し ょ く ぎ ょ う あ ん て い じ ょ
お う ご ん し ょ く し ょ く ぶ つ	お う ご ん し ょ く し ょ く ぶ つ
た ま っ た も ん じ ゃ な い	た ま っ た も ん じ ゃ な い
か み に だ ん か つ よ う	か み に だ ん か つ よ う
む な く そ が わ る い	む な く そ が わ る い
は や か れ お そ か れ	は や か れ お そ か れ
あ み め に し き へ び	あ み め に し き へ び
ぜ に が た あ ざ ら し	ぜ に が た あ ざ ら し
た て よ こ ち り め ん	た て よ こ ち り め ん
し ら た ま つ ば き	し ら た ま つ ば き
に も か か わ ら ず	に も か か わ ら ず
し た さ き さ ん ず ん	し た さ き さ ん ず ん
い ち に ち も は や い	い ち に ち も は や い
よ く あ る し つ も ん	よ く あ る し つ も ん
き た な い ば く だ ん	き た な い ば く だ ん
こ と な か れ し ゅ ぎ	こ と な か れ し ゅ ぎ
し ん お き な わ も じ	し ん お き な わ も じ
と に も か く に も	と に も か く に も
し る ひ と ぞ し る	し る ひ と ぞ し る
と ま れ か く ま れ	と ま れ か く ま れ
や ま と な で し こ	や ま と な で し こ
く さ び が た も じ	く さ び が た も じ
へ の へ の も へ じ	へ の へ の も へ じ
ふ れ あ い ど う ぶ つ え ん	ふ れ あ い ど う ぶ つ え ん
み な み か い き せ ん	み な み か い き せ ん
ち ゅ う と う き ょ う い く が っ こ う	ち ゅ う と う き ょ う い く が っ こ う
れ き し し ゅ う せ い し ゅ ぎ	れ き し し ゅ う せ い し ゅ ぎ
ご し ゅ う し ょ う さ ま で す	ご し ゅ う し ょ う さ ま で す
せ ん し ょ く け ん ろ う ど	せ ん し ょ く け ん ろ う ど
は っ せ い せ い ぶ つ が く	は っ せ い せ い ぶ つ が く
り ん し ょ う し ん り が く	り ん し ょ う し ん り が く
じ ょ う は ん し ん は だ か	じ ょ う は ん し ん は だ か
そ ん え き ぶ ん き て ん	そ ん え き ぶ ん き て ん
が い こ く じ ん け ん お	が い こ く じ ん け ん お
ぐ こ う や ま を う つ す	ぐ こ う や ま を う つ す
ず ん ぐ り む っ く り	ず ん ぐ り む っ く り
は だ か の つ き あ い	は だ か の つ き あ い
じ こ け ん じ よ く	じ こ け ん じ よ く
あ ぶ ら と り が み	あ ぶ ら と り が み
ひ げ ん じ つ て き	ひ げ ん じ つ て き
お や す み に な る	お や す み に な る
こ と あ ま つ か み	こ と あ ま つ か み
に た り よ っ た り	に た り よ っ た り
わ か れ を つ げ る	わ か れ を つ げ る
か た く ち い わ し	か た く ち い わ し
う み せ ん や ま せ ん	う み せ ん や ま せ ん
は つ が ん ぶ っ し つ	は つ が ん ぶ っ し つ
な な ほ し て ん と う	な な ほ し て ん と う
け い さ ん き か が く	け い さ ん き か が く
せ ん た く ば さ み	せ ん た く ば さ み
お さ な と も だ ち	お さ な と も だ ち
こ こ ろ が お れ る	こ こ ろ が お れ る
ま つ や に あ ぶ ら	ま つ や に あ ぶ ら
お と こ が す た る	お と こ が す た る
た つ の お と し ご	た つ の お と し ご
し に も の ぐ る い	し に も の ぐ る い
か な ま じ り ぶ ん	か な ま じ り ぶ ん
ふ き そ く ぎ ん が	ふ き そ く ぎ ん が
こ て ん り き が く	こ て ん り き が く
む な く そ わ る い	む な く そ わ る い
も と も こ も な い	も と も こ も な い
い っ さ く さ く じ つ	い っ さ く さ く じ つ
ふ く う じ ょ う じ ゅ に ょ ら い	ふ く う じ ょ う じ ゅ に ょ ら い
ひ ょ う じ ゅ ん し ゅ つ り ょ く	ひ ょ う じ ゅ ん し ゅ つ り ょ く
じ ゅ う に し ち ょ う か い よ う	じ ゅ う に し ち ょ う か い よ う
そ う き ょ く せ い し ょ う が い	そ う き ょ く せ い し ょ う が い
ひ ゃ っ ぱ つ ひ ゃ く ち ゅ う	ひ ゃ っ ぱ つ ひ ゃ く ち ゅ う
こ う が く け ん び き ょ う	こ う が く け ん び き ょ う
し ょ く ぶ つ じ ょ う た い	し ょ く ぶ つ じ ょ う た い
せ ん け い け い か く ほ う	せ ん け い け い か く ほ う
け い こ う ひ に ん や く	け い こ う ひ に ん や く
え ん ざ ん ぞ う ふ く き	え ん ざ ん ぞ う ふ く き
だ い の う せ い り が く	だ い の う せ い り が く
せ い さ ん か ご う ぶ つ	せ い さ ん か ご う ぶ つ
か ぶ し き が い し ゃ	か ぶ し き が い し ゃ
ま ん か ん ぜ ん せ き	ま ん か ん ぜ ん せ き
ほ っ き ょ く ぎ つ ね	ほ っ き ょ く ぎ つ ね
や く ぶ つ ら ん よ う	や く ぶ つ ら ん よ う
じ ち た い け い さ つ	じ ち た い け い さ つ
お し つ け が ま し い	お し つ け が ま し い
ぐ ん ば い が あ が る	ぐ ん ば い が あ が る
い っ て ま い り ま す	い っ て ま い り ま す
え び で た い を つ る	え び で た い を つ る
て ん こ う こ く し ょ く	て ん こ う こ く し ょ く
と ほ う に く れ る	と ほ う に く れ る
お と こ を み が く	お と こ を み が く
ひ っ く り か え る	ひ っ く り か え る
や ん ば る く い な	や ん ば る く い な
た い い く ず わ り	た い い く ず わ り
し ぜ ん せ ん た く	し ぜ ん せ ん た く
ぶ つ り が く し ゃ	ぶ つ り が く し ゃ
や ま と だ ま し い	や ま と だ ま し い
そ く ど く じ ゅ つ	そ く ど く じ ゅ つ
は い い ろ ぎ つ ね	は い い ろ ぎ つ ね
ひ み つ け い さ つ	ひ み つ け い さ つ
そ ろ ば ん だ か い	そ ろ ば ん だ か い
ひ ゃ く に ち ぜ き	ひ ゃ く に ち ぜ き
く う そ く ぜ し き	く う そ く ぜ し き
ど っ ち も ど っ ち	ど っ ち も ど っ ち
に さ ん か た ん そ	に さ ん か た ん そ
す い そ ば く だ ん	す い そ ば く だ ん
ゆ だ ん た い て き	ゆ だ ん た い て き
く う き り き が く	く う き り き が く
う す き み わ る い	う す き み わ る い
ぶ ん か つ ば ら い	ぶ ん か つ ば ら い
す く な く と も	す く な く と も
き を と り な お す	き を と り な お す
な か じ た ぼ い ん	な か じ た ぼ い ん
た す け に な る	た す け に な る
ひ か が く て き	ひ か が く て き
む す び の か み	む す び の か み
ぶ つ り か が く	ぶ つ り か が く
な か だ か が た	な か だ か が た
し も せ か や く	し も せ か や く
の る か そ る か	の る か そ る か
に り つ は い は ん	に り つ は い は ん
い っ た り き た り	い っ た り き た り
き か し ょ く ぶ つ	き か し ょ く ぶ つ
こ う ば こ ず わ り	こ う ば こ ず わ り
か ん ば ん む す め	か ん ば ん む す め
き が じ ゅ く す る	き が じ ゅ く す る
き た か い き せ ん	き た か い き せ ん
か つ お の え ぼ し	か つ お の え ぼ し
つ か い っ ぱ し り	つ か い っ ぱ し り
な ん さ い で す か	な ん さ い で す か
し ん せ か い ざ る	し ん せ か い ざ る
て る て る ぼ う ず	て る て る ぼ う ず
じ ゅ ず か け ば と	じ ゅ ず か け ば と
お や す み な さ い	お や す み な さ い
ひ ゃ く え ん き ん い つ	ひ ゃ く え ん き ん い つ
な ん ぼ く せ ん そ う	な ん ぼ く せ ん そ う
に じ ゅ う し ち に ち	に じ ゅ う し ち に ち
ご じ っ ぽ ひ ゃ っ ぽ	ご じ っ ぽ ひ ゃ っ ぽ
に じ ゅ う は ち に ち	に じ ゅ う は ち に ち
に じ ほ う て い し き	に じ ほ う て い し き
め い め い は く は く	め い め い は く は く
い ま き た さ ん ぎ ょ う	い ま き た さ ん ぎ ょ う
い ん き ょ く せ ん か ん	い ん き ょ く せ ん か ん
に ち じ ょ う せ い か つ	に ち じ ょ う せ い か つ
さ ん じ ゅ つ え ん ざ ん	さ ん じ ゅ つ え ん ざ ん
は っ た つ し ょ う が い	は っ た つ し ょ う が い
せ い れ ん け っ ぱ く	せ い れ ん け っ ぱ く
き ん じ ょ う て っ ぺ き	き ん じ ょ う て っ ぺ き
で ん し ょ う ぶ ん が く	で ん し ょ う ぶ ん が く
の り あ い じ ど う し ゃ	の り あ い じ ど う し ゃ
そ う た い せ い り ろ ん	そ う た い せ い り ろ ん
え ん す い き ょ く せ ん	え ん す い き ょ く せ ん
さ ん じ ゅ う い ち に ち	さ ん じ ゅ う い ち に ち
し ょ う り ん じ け ん ぽ う	し ょ う り ん じ け ん ぽ う
ふ ほ う に ゅ う こ く し ゃ	ふ ほ う に ゅ う こ く し ゃ
に ょ う ど う き ゅ う せ ん え き	に ょ う ど う き ゅ う せ ん え き
ね も の が た り	ね も の が た り
ど っ こ い ど っ こ い	ど っ こ い ど っ こ い
や ま た か ぼ う し	や ま た か ぼ う し
い だ て ん ば し り	い だ て ん ば し り
む き か ご う ぶ つ	む き か ご う ぶ つ
か さ ん か す い そ	か さ ん か す い そ
へ ん た い か ん ぶ ん	へ ん た い か ん ぶ ん
し ん こ て ん し ゅ ぎ	し ん こ て ん し ゅ ぎ
だ い に ち に ょ ら い	だ い に ち に ょ ら い
つ じ う ら せ ん べ い	つ じ う ら せ ん べ い
せ き し ょ く や け い	せ き し ょ く や け い
き み ょ う き て れ つ	き み ょ う き て れ つ
ほ う だ ん の え じ き	ほ う だ ん の え じ き
つ り ば し こ う か	つ り ば し こ う か
ひ し ゃ か い し ん ど	ひ し ゃ か い し ん ど
あ ん こ く ぶ っ し つ	あ ん こ く ぶ っ し つ
に じ ゅ う ろ く に ち	に じ ゅ う ろ く に ち
む げ ん れ ん さ こ う	む げ ん れ ん さ こ う
だ い こ ん や く し ゃ	だ い こ ん や く し ゃ
せ き ず い は ん し ゃ	せ き ず い は ん し ゃ
り ゅ う し か そ く き	り ゅ う し か そ く き
と っ か え ひ っ か え	と っ か え ひ っ か え
な ん し ん せ い さ く	な ん し ん せ い さ く
し ゃ し ゅ つ ざ せ き	し ゃ し ゅ つ ざ せ き
た か と び こ み	た か と び こ み
わ す れ な ぐ さ	わ す れ な ぐ さ
む や み や た ら	む や み や た ら
ひ と り ひ と り	ひ と り ひ と り
は ず か し め る	は ず か し め る
は し り ま わ る	は し り ま わ る
ひ き こ も ご も	ひ き こ も ご も
こ こ ろ づ も り	こ こ ろ づ も り
は じ め ま し て	は じ め ま し て
な み だ ぶ く ろ	な み だ ぶ く ろ
く ぐ り ぬ け る	く ぐ り ぬ け る
と ぎ れ と ぎ れ	と ぎ れ と ぎ れ
く り ひ ろ げ る	く り ひ ろ げ る
ひ と さ し ゆ び	ひ と さ し ゆ び
よ も つ し こ め	よ も つ し こ め
く る わ こ と ば	く る わ こ と ば
も し か し た ら	も し か し た ら
ふ ゆ き と ど き	ふ ゆ き と ど き
す め ば み や こ	す め ば み や こ
そ の ば か ぎ り	そ の ば か ぎ り
ま つ ば く ず し	ま つ ば く ず し
わ か と の ば ら	わ か と の ば ら
わ す れ が た み	わ す れ が た み
み み に の こ る	み み に の こ る
な す り つ け る	な す り つ け る
か ら く だ も の	か ら く だ も の
は た ら き も の	は た ら き も の
く ろ ご け ぐ も	く ろ ご け ぐ も
し か り つ け る	し か り つ け る
つ つ き ま わ す	つ つ き ま わ す
な が す く じ ら	な が す く じ ら
ぬ か よ ろ こ び	ぬ か よ ろ こ び
わ た く し す る	わ た く し す る
な み は ず れ る	な み は ず れ る
は な れ ば な れ	は な れ ば な れ
し の び の も の	し の び の も の
し た く ち び る	し た く ち び る
へ の へ の も へ	へ の へ の も へ
ら ぬ き こ と ば	ら ぬ き こ と ば
し ろ き く ら げ	し ろ き く ら げ
は や の み こ み	は や の み こ み
な か ま は ず れ	な か ま は ず れ
ま く ら こ と ば	ま く ら こ と ば
や つ め う な ぎ	や つ め う な ぎ
し た ご し ら え	し た ご し ら え
ど く せ ん よ く	ど く せ ん よ く
ひ っ く る め る	ひ っ く る め る
ぐ れ ん じ ご く	ぐ れ ん じ ご く
ぺ た ん す わ り	ぺ た ん す わ り
も の み だ か い	も の み だ か い
み す ぼ ら し い	み す ぼ ら し い
ゆ わ え つ け る	ゆ わ え つ け る
ま ぎ ら わ し い	ま ぎ ら わ し い
ぐ ち を こ ぼ す	ぐ ち を こ ぼ す
だ き か か え る	だ き か か え る
ふ く れ あ が る	ふ く れ あ が る
く ど き お と す	く ど き お と す
あ の か た が た	あ の か た が た
き た い は ず れ	き た い は ず れ
し つ な い が く	し つ な い が く
た た き お こ す	た た き お こ す
ば か ば か し い	ば か ば か し い
か い せ き が く	か い せ き が く
げ ん ご ろ う ぶ な	げ ん ご ろ う ぶ な
そ う た い し つ ど	そ う た い し つ ど
は な は だ し い	は な は だ し い
そ ぜ い か い ひ ち	そ ぜ い か い ひ ち
か ん せ つ わ ほ う	か ん せ つ わ ほ う
ざ こ つ し ん け い	ざ こ つ し ん け い
で ん で ん だ い こ	で ん で ん だ い こ
ら っ ぱ す い せ ん	ら っ ぱ す い せ ん
に そ く さ ん も ん	に そ く さ ん も ん
ご だ ん か つ よ う	ご だ ん か つ よ う
は か い か つ ど う	は か い か つ ど う
ず る が し こ い	ず る が し こ い
み れ ん が ま し い	み れ ん が ま し い
た ち い り き ん し	た ち い り き ん し
ど く し ん じ ゅ つ	ど く し ん じ ゅ つ
ひ ゃ く ぶ ん り つ	ひ ゃ く ぶ ん り つ
わ か わ か し い	わ か わ か し い
し き も の る い	し き も の る い
も ち あ わ せ る	も ち あ わ せ る
さ き お と と し	さ き お と と し
ら く て ん て き	ら く て ん て き
ぶ じ そ く さ い	ぶ じ そ く さ い
お り ひ め ぼ し	お り ひ め ぼ し
つ け く わ え る	つ け く わ え る
み く だ り は ん	み く だ り は ん
ろ く ぶ ん ぎ ざ	ろ く ぶ ん ぎ ざ
こ こ ろ ぼ そ い	こ こ ろ ぼ そ い
む い し き て き	む い し き て き
で ん し た ば こ	で ん し た ば こ
く わ ず ぎ ら い	く わ ず ぎ ら い
お め に か か る	お め に か か る
か み あ わ せ る	か み あ わ せ る
と て つ も な い	と て つ も な い
よ わ ね を は く	よ わ ね を は く
も の た り な い	も の た り な い
あ ず ま く だ り	あ ず ま く だ り
ね ず み い る か	ね ず み い る か
す い と り が み	す い と り が み
ま わ り く ど い	ま わ り く ど い
う し ろ す が た	う し ろ す が た
め を く ら ま す	め を く ら ま す
い わ し く じ ら	い わ し く じ ら
お ぼ ろ づ き よ	お ぼ ろ づ き よ
あ か つ め く さ	あ か つ め く さ
な か だ ち に ん	な か だ ち に ん
も く て き ろ ん	も く て き ろ ん
か た じ け な い	か た じ け な い
く ろ う た ど り	く ろ う た ど り
も ち こ た え る	も ち こ た え る
は ち ぶ ん ぎ ざ	は ち ぶ ん ぎ ざ
あ た ま じ ら み	あ た ま じ ら み
さ し ひ か え る	さ し ひ か え る
お と ぎ ば な し	お と ぎ ば な し
へ び く い わ し	へ び く い わ し
な が わ ず ら い	な が わ ず ら い
な が さ き け ん	な が さ き け ん
じ こ ま ん ぞ く	じ こ ま ん ぞ く
は だ か ま い り	は だ か ま い り
ま わ り あ わ せ	ま わ り あ わ せ
う ら ぎ り も の	う ら ぎ り も の
あ と の ま つ り	あ と の ま つ り
き ん し ん そ う か ん	き ん し ん そ う か ん
い っ ぷ た さ い せ い	い っ ぷ た さ い せ い
い っ た い ぜ ん た い	い っ た い ぜ ん た い
せ い ど う き じ だ い	せ い ど う き じ だ い
お じ さ ん こ う ぶ ん	お じ さ ん こ う ぶ ん
か ん け い ど う ぶ つ	か ん け い ど う ぶ つ
そ う た い お ん か ん	ぜ っ た い お ん か ん
ぜ っ た い お ん か ん	ぜ っ た い お ん か ん
し っ け い せ ん ば ん	し っ け い せ ん ば ん
げ ん せ い せ い ぶ つ	げ ん せ い せ い ぶ つ
し つ な い き ょ う ぎ	し つ な い き ょ う ぎ
て い し ゅ か ん ぱ く	て い し ゅ か ん ぱ く
じ ん ぞ う に ん げ ん	じ ん ぞ う に ん げ ん
き ょ う か す い げ つ	き ょ う か す い げ つ
じ ど う ぎ ゃ く た い	じ ど う ぎ ゃ く た い
い っ さ ん か た ん そ	い っ さ ん か た ん そ
だ い ぼ い ん す い い	だ い ぼ い ん す い い
ぶ ん か た よ う せ い	ぶ ん か た よ う せ い
つ う し ん は ん ば い	つ う し ん は ん ば い
ど う も あ り が と う	ど う も あ り が と う
じ ょ う ほ う け ん さ く	じ ょ う ほ う け ん さ く
ひ ょ う じ ゅ ん に ゅ う り ょ く	ひ ょ う じ ゅ に ゅ う り ょ く
と う ご う し っ ち ょ う し ょ う	と う ご う し っ ち ょ う し ょ う
ま っ し ょ う し ん け い け い	ま っ し ょ う し ん け い け い
き ょ う さ ん し ゅ ぎ し ゃ	き ょ う さ ん し ゅ ぎ し ゃ
み ぶ ん し ょ う め い し ょ	み ぶ ん し ょ う め い し ょ
じ ゅ ん ぷ う ま ん ぱ ん	じ ゅ ん ぷ う ま ん ぱ ん
あ ん ぜ ん こ う き て い	あ ん ぜ ん こ う き て い
か ん せ つ し ょ う め い	か ん せ つ し ょ う め い
し ゅ じ ん こ う ほ せ い	し ゅ じ ん こ う ほ せ い
ち ょ う し ん る こ つ	ち ょ う し ん る こ つ
ゆ う さ ん そ う ん ど う	ゆ う さ ん そ う ん ど う
ぜ っ た い り ょ う い き	ぜ っ た い り ょ う い き
き ょ う さ い く み あ い	き ょ う さ い く み あ い
し ん そ う が く し ゅ う	し ん そ う が く し ゅ う
こ く み ん と う ひ ょ う	こ く み ん と う ひ ょ う
け ん こ う し ん だ ん	け ん こ う し ん だ ん
き ゅ う せ か い ざ る	き ゅ う せ か い ざ る
し き か く い じ ょ う	し き か く い じ ょ う
あ く い あ く し ょ く	あ く い あ く し ょ く
も っ と も ら し い	も っ と も ら し い
し ゃ く り あ げ る	し ゃ く り あ げ る
は つ が げ ん ま い	は つ が げ ん ま い
せ ん た く こ う り	せ ん た く こ う り
い そ う き か が く	い そ う き か が く
こ だ い こ う こ く	こ だ い こ う こ く
さ い な ん じ け ん	さ い な ん じ け ん
し ゃ か い か が く	し ゃ か い か が く
と ば し け い た い	と ば し け い た い
あ い し ん か く ら	あ い し ん か く ら
う す ば か げ ろ う	う す ば か げ ろ う
き ょ く あ じ さ し	き ょ く あ じ さ し
ど く ぜ ん し ゅ ぎ	ど く ぜ ん し ゅ ぎ
う そ は っ け ん き	う そ は っ け ん き
す い ほ う に き す	す い ほ う に き す
ら く て ん し ゅ ぎ	ら く て ん し ゅ ぎ
か ん ぽ ど う ぶ つ	か ん ぽ ど う ぶ つ
い っ か つ ば ら い	い っ か つ ば ら い
げ ん じ つ と う ひ	げ ん じ つ と う ひ
ち し ま れ っ と う	ち し ま れ っ と う
ふ く ろ お お か み	ふ く ろ お お か み
あ く ぎ ゃ く ひ ど う	あ く ぎ ゃ く ひ ど う
さ い し ょ く し ゅ ぎ	さ い し ょ く し ゅ ぎ
そ つ ぎ ょ う し け ん	そ つ ぎ ょ う し け ん
し ん よ う は ん ば い	し ん よ う は ん ば い
か ん こ ん そ う さ い	か ん こ ん そ う さ い
し ゃ か い ち つ じ ょ	し ゃ か い ち つ じ ょ
だ い ぜ ん て い せ ん	だ い ぜ ん て い せ ん
し つ な い ゆ う ぎ	し つ な い ゆ う ぎ
お も い う か べ る	お も い う か べ る
い ち ま つ も よ う	い ち ま つ も よ う
あ っ と お ど ろ く	あ っ と お ど ろ く
あ っ と い わ せ る	あ っ と い わ せ る
や っ か い ば ら い	や っ か い ば ら い
あ つ り ょ く な べ	あ つ り ょ く な べ
か い ふ く た い い	か い ふ く た い い
め ん え き ふ ぜ ん	め ん え き ふ ぜ ん
ね む け が お そ う	ね む け が お そ う
ふ う せ ん か ず ら	ふ う せ ん か ず ら
き ん か ん が っ き	き ん か ん が っ き
じ ご く へ の み ち は ぜ ん い で ほ そ う さ れ て い る	じ ご く へ の み ち は ぜ ん い る
て ん は み ず か ら た す く る も の を た す く	て ん は み ず か ら た す く る も の
い の な か の か わ ず た い か い を し ら ず	い の な か の か わ ず た い を し ら ず
し ょ う ね ん お い や す く が く な り が た し	し ょ う ね ん お い や す く が た し
う り に つ め あ り つ め に つ め な し	う り に つ め あ り つ め な し
き ん い し ゅ く せ い そ く さ く こ う か し ょ う	き ん い し ゅ く せ い そ く さ く か し ょ う
べ い こ く で ん き で ん し が っ か い	べ い こ く で ん き で ん し が っ か い
そ う じ ょ う が ん ど う り ゅ う か て っ こ う こ う し ょ う	そ う じ ょ う が ん ど う り ゅ う か て っ こ う こ う し ょ う
