부 탁	부 탁
<<unk>> 다	<unk> 다
홍 차	홍 차
사 건	사 건
설 치	설 치
지 름	지 름
<<unk>> 다	<unk> 다
세 계	세 계
필 터	필 터
<<unk>> 자	<unk> 자
<<unk>> 세	<unk> 세
그 <<unk>>	그 <unk>
살 다	살 다
간 체	간 체
제 작	제 작
라 돈	라 돈
기 능	기 능
질 타	질 타
그 만	그 만
여 왕	여 왕
감 옥	감 옥
독 일	독 일
제 법	제 법
일 종	일 종
천 체	천 체
박 스	박 스
중 위	중 위
본 토	본 토
부 들	부 들
영 토	영 토
악 동	악 동
점 수	점 수
음 독	음 독
중 세	중 세
눈 앞	눈 앞
지 불	지 불
묵 가	묵 가
두 연	두 연
흡 사	흡 사
파 장	파 장
푸 젠	푸 젠
가 <<unk>>	가 <unk>
왕 조	왕 조
미 역	미 역
일 월	일 월
다 섯	다 섯
파 산	파 산
<<unk>> 지	<unk> 지
<<unk>> 시	<unk> 시
육 서	육 서
<<unk>> 다	<unk> 다
비 각	비 각
시 럽	실 업
앞 뒤	앞 뒤
농 부	농 부
저 것	저 것
<<unk>> 데	<unk> 데
성 하	성 하
소 풍	소 풍
세 척	세 척
비 중	비 중
찬 가	찬 가
양 파	양 파
무 죄	무 죄
신 사	신 사
풍 요	풍 요
음 식	음 식
매 점	매 점
<<unk>> 데	<unk> 데
무 선	무 선
시 <<unk>>	시 <unk>
부 <<unk>>	부 <unk>
서 <<unk>>	서 <unk>
요 즘	요 즘
일 국	일 국
지 금	지 금
성 씨	성 씨
<<unk>> 다	<unk> 다
일 왕	일 왕
지 폐	지 폐
난 자	난 자
<<unk>> 자	<unk> 자
군 도	군 도
치 료	치 료
누 계	누 계
과 외	과 외
수 간	수 간
비 늘	비 늘
사 탕	사 탕
교 리	교 리
종 일	종 일
서 술	서 술
조 합	조 합
비 밀	비 밀
조 롱	조 롱
둘 치	둘 치
신 자	신 자
중 부	중 부
<<unk>> 다	<unk> 다
하 늘	하 늘
수 출	수 출
나 중	나 중
<<unk>> 지	<unk> 지
미 남	미 남
수 석	수 석
음 양	음 양
열 도	열 도
반 응	반 응
요 청	요 청
둥 치	둥 치
위 훈	위 훈
실 업	실 업
제 약	제 약
추 락	추 락
잔 디	잔 디
여 당	여 당
성 가	성 가
가 만	가 만
염 주	염 주
언 덕	언 덕
북 위	북 위
구 원	구 원
가 문	가 문
가 축	가 축
찰 스	찰 스
미 학	미 학
되 다	되 다
수 준	수 준
모 <<unk>>	모 <unk>
모 금	모 금
<<unk>> 다	<unk> 다
벌 <<unk>>	벌 <unk>
멀 다	멀 다
죄 수	죄 수
서 양	서 양
셀 카	셀 카
언 간	언 간
<<unk>> 터	센 터
자 작	자 작
자 극	자 극
공 수	공 수
검 토	검 토
업 종	업 종
비 극	비 극
훈 제	훈 제
마 작	마 작
배 달	배 달
야 한	야 한
<<unk>> 기	<unk> 기
서 문	서 문
동 의	동 의
약 학	약 학
예 능	예 능
시 물	시 물
작 은	작 은
움 <<unk>>	움 <unk>
치 욕	치 욕
독 음	독 음
인 돌	인 돌
모 텔	모 텔
<<unk>> 인	<unk> 인
통 제	통 제
용 언	용 언
죄 악	죄 악
원 리	원 리
미 륵	미 륵
송 구	송 구
일 원	일 원
거 짓	거 짓
조 건	조 건
상 추	상 추
풍 부	풍 부
의 문	의 문
<<unk>> 업	<unk> 업
서 장	서 장
둥 지	둥 지
납 치	납 치
짓 다	짓 다
도 랑	도 랑
판 자	판 자
주 교	주 교
참 여	참 여
팔 다	팔 다
<<unk>> 은	<unk> 은
소 품	소 품
두 통	두 통
등 자	등 자
하 천	하 천
군 데	군 데
절 로	전 로
체 험	체 험
기 녀	기 녀
서 벌	서 벌
외 국	외 국
장 치	장 치
할 인	할 인
수 염	수 염
성 조	성 조
모 듬	모 듬
고 전	고 전
남 포	남 포
널 다	널 다
여 <<unk>>	여 <unk>
홍 시	홍 시
반 포	반 포
텐 구	텐 구
간 유	간 유
거 실	거 실
호 떡	호 떡
회 사	회 사
강 의	강 의
하 품	하 품
대 표	대 표
멀 리	멀 리
기 한	기 한
점 차	점 차
고 급	고 급
버 전	버 전
기 합	기 합
수 원	수 원
함 께	함 께
유 독	유 독
서 쪽	서 쪽
무 쇠	무 쇠
다 만	다 만
글 피	글 피
장 사	장 사
진 압	진 압
처 벌	처 벌
당 구	당 구
먹 다	먹 다
<<unk>> 다	<unk> 다
미 덕	미 덕
서 당	서 당
속 자	속 자
지 질	지 질
동 기	동 기
수 달	수 달
가 감	가 감
그 중	그 중
미 녀	미 녀
토 성	토 성
벌 다	벌 다
미 술	미 술
이 명	이 명
소 녀	소 녀
디 <<unk>>	디 <unk>
자 살	자 살
사 증	사 증
한 가	한 가
음 절	음 절
응 용	응 용
<<unk>> 스	<unk> 스
묘 미	묘 미
통 일	통 일
식 구	식 구
외 설	외 설
상 처	상 처
몽 고	몽 고
여 정	여 정
입 양	입 양
예 감	예 감
파 랑	파 랑
목 차	목 차
사 진	사 진
분 자	분 자
연 가	연 가
농 업	농 업
무 려	무 려
<<unk>> 기	<unk> 기
요 법	요 법
승 부	승 부
<<unk>> 다	<unk> 다
신 임	신 임
식 자	식 자
소 화	소 화
지 갑	지 갑
스 님	스 님
안 방	안 방
흔 히	흔 히
<<unk>> 시	<unk> 시
범 부	범 부
근 무	근 무
유 괴	유 괴
서 법	서 법
수 법	수 법
초 밥	초 밥
탐 사	탐 사
정 지	정 지
연 초	연 초
기 술	기 술
고 독	고 독
지 점	지 점
수 녀	수 녀
조 각	조 각
시 골	시 골
전 구	전 구
<<unk>> <<unk>>	<unk> <unk>
모 방	모 방
연 주	연 주
교 미	교 미
집 합	집 합
왕 후	왕 후
원 고	원 고
포 화	포 화
운 동	운 동
인 성	인 성
추 진	추 진
민 요	민 요
잡 다	잡 다
고 용	고 용
척 수	척 수
<<unk>> 다	<unk> 다
창 제	창 제
비 용	비 용
예 순	예 순
여 <<unk>>	여 <unk>
온 <<unk>>	온 <unk>
구 축	구 축
혹 시	혹 시
남 부	남 부
피 난	피 난
공 안	공 안
락 타	락 타
흑 로	흑 로
는 다	는 다
개 성	개 성
증 언	증 언
<<unk>> 저	<unk> 저
까 벨	까 벨
딱 지	딱 지
옥 <<unk>>	옥 <unk>
사 양	사 양
주 중	주 중
모 <<unk>>	모 <unk>
증 조	증 조
노 름	노 름
비 닐	비 닐
찌 창	찌 창
선 수	선 수
사 창	사 창
사 탄	사 탄
측 위	측 위
국 토	국 토
압 박	압 박
투 표	투 표
스 <<unk>>	스 <unk>
호 랑	호 랑
물 소	물 소
간 부	간 부
제 출	제 출
악 성	악 성
얼 <<unk>>	얼 <unk>
린 스	린 스
모 순	모 순
닌 자	닌 자
시 민	시 민
부 신	부 신
성 지	성 지
귀 리	귀 리
등 유	등 유
외 딸	외 딸
시 청	시 청
지 방	지 방
무 한	무 한
조 용	조 용
공 포	공 포
임 신	임 신
<<unk>> 다	<unk> 다
서 표	서 표
화 가	화 가
불 도	불 도
표 제	표 제
주 류	주 류
기 총	기 총
강 세	강 세
남 미	남 미
요 술	요 술
시 중	시 중
지 린	지 린
성 사	성 사
덕 트	덕 트
역 학	역 학
막 차	막 차
조 직	조 직
정 수	정 수
농 구	농 구
강 추	강 추
나 찰	나 찰
제 단	제 단
<<unk>> 시	<unk> 시
봉 투	봉 투
수 적	수 적
목 마	목 마
속 세	속 세
교 외	교 외
반 도	반 도
약 사	약 사
단 자	단 자
수 표	수 표
실 시	실 시
진 리	진 리
두 뇌	두 뇌
증 기	증 기
금 고	금 고
괴 수	괴 수
논 의	논 의
대 양	대 양
대 신	대 신
모 국	모 국
골 수	골 수
약 도	약 도
다 과	다 과
튀 다	튀 다
순 서	순 서
용 도	용 도
시 합	시 합
특 기	특 기
천 제	천 제
배 <<unk>>	배 <unk>
퇴 비	퇴 비
동 거	동 거
가 방	가 방
소 금	소 금
주 문	주 문
차 례	차 례
수 <<unk>>	수 <unk>
용 케	용 케
잠 두	잠 두
제 물	제 물
골 인	골 인
틀 다	틀 다
여 건	여 건
대 접	대 접
악 습	악 습
총 서	총 서
인 연	인 연
은 근	은 근
<<unk>> 자	<unk> 자
공 주	공 주
<<unk>> 차	<unk> 차
정 제	정 제
허 락	허 락
시 름	시 름
증 가	증 가
뿌 석	뿌 석
집 회	집 회
옥 상	옥 상
천 도	천 도
기 침	기 침
부 록	부 록
해 군	해 군
창 업	창 업
나 한	나 한
발 기	발 기
반 추	반 추
북 미	북 미
원 조	원 조
정 유	정 유
보 복	보 복
유 민	유 민
검 다	검 다
습 도	습 도
공 지	공 지
<<unk>> 다	<unk> 다
정 음	정 음
<<unk>> 로	<unk> 로
북 서	북 서
감 안	가 만
대 상	대 상
유 성	유 성
<<unk>> 리	<unk> 리
연 세	연 세
투 척	투 척
느 <<unk>>	느 <unk>
꼼 수	꼼 수
공 언	공 언
설 사	설 사
서 월	서 월
알 판	알 판
구 난	구 난
가 <<unk>>	가 <unk>
수 록	수 록
초 반	초 반
하 양	하 양
유 적	유 적
집 사	집 사
털 다	털 다
항 일	항 일
두 절	두 절
고 민	고 민
포 럼	포 럼
개 천	개 천
해 금	해 금
거 <<unk>>	거 <unk>
빨 리	빨 리
진 짜	진 짜
<<unk>> 운	<unk> 운
센 터	센 터
수 갑	수 갑
인 천	인 천
부 근	부 근
조 심	조 심
구 절	구 절
금 일	금 일
진 루	진 루
로 망	로 망
저 항	저 항
중 사	중 사
<<unk>> 모	<unk> 모
운 전	운 전
사 골	사 골
능 히	능 히
자 석	자 석
승 리	승 리
바 곤	바 곤
위 증	위 증
도 덕	도 덕
막 다	막 다
고 국	고 국
필 수	필 수
모 독	모 독
여 성	여 성
<<unk>> 다	<unk> 다
카 <<unk>>	카 <unk>
호 텔	호 텔
요 한	요 한
<<unk>> 비	<unk> 비
대 문	대 문
말 미	말 미
도 달	도 달
학 기	학 기
<<unk>> 다	<unk> 다
해 삼	해 삼
야 식	야 식
탁 구	탁 구
우 편	우 편
마 찰	마 찰
<<unk>> 다	<unk> 다
발 음	발 음
사 계	사 계
탄 압	탄 압
교 가	교 가
몸 소	몸 소
인 간	인 간
머 <<unk>>	머 <unk>
정 비	정 비
여 과	여 과
무 속	무 속
지 원	지 원
종 로	종 로
건 조	건 조
독 사	독 사
암 말	암 말
두 상	두 상
렌 즈	렌 즈
시 찰	시 찰
무 진	무 진
기 <<unk>>	기 <unk>
같 은	같 은
완 두	완 두
빈 부	빈 부
<<unk>> 다	<unk> 다
메 탄	메 탄
여 섯	여 섯
<<unk>> 다	<unk> 다
루 블	루 블
커 플	커 플
일 문	일 문
증 여	증 여
죽 지	죽 지
로 켓	로 켓
가 산	가 산
<<unk>> 씨	<unk> 씨
티 <<unk>>	티 <unk>
두 목	두 목
산 서	산 서
감 시	감 시
노 쇠	노 쇠
일 출	일 출
그 곳	그 곳
다 <<unk>>	다 <unk>
항 체	항 체
<<unk>> 다	<unk> 다
연 구	연 구
혼 수	혼 수
만 유	만 유
쿠 션	쿠 션
대 전	대 전
고 려	고 려
두 발	두 발
삼 수	삼 수
신 라	신 라
홍 보	홍 보
한 도	한 도
암 <<unk>>	암 <unk>
<<unk>> 침	<unk> 침
자 본	자 본
전 보	전 보
수 선	수 선
접 시	접 시
사 촌	사 촌
<<unk>> 다	<unk> 다
선 언	선 언
대 학	대 학
미 각	미 각
음 반	음 반
비 판	비 판
내 심	내 심
사 상	사 상
손 자	손 자
인 근	인 근
서 <<unk>>	서 <unk>
암 살	암 살
빙 고	빙 고
사 단	사 단
유 역	유 역
전 투	전 투
음 료	음 료
상 인	상 인
불 안	불 안
청 소	청 소
식 사	식 사
탁 자	탁 자
능 가	능 가
따 름	따 름
사 직	사 직
자 갈	자 갈
예 문	예 문
예 정	예 정
수 질	수 질
조 국	조 국
부 농	부 농
김 치	김 치
곡 조	곡 조
부 탄	부 탄
교 체	교 체
사 법	사 법
같 다	<unk> 다
교 도	교 도
계 수	계 수
고 정	고 정
신 도	신 도
육 체	육 체
공 인	공 인
알 콜	알 콜
도 료	도 료
정 서	정 서
위 탁	위 탁
노 천	노 천
빈 자	빈 자
난 소	난 소
공 세	공 세
연 안	연 안
온 몸	온 몸
가 봉	가 봉
음 성	음 성
조 작	조 작
노 망	노 망
세 뇌	세 뇌
앙 심	앙 심
설 마	설 마
입 성	입 성
혹 은	혹 은
산 시	산 시
뉴 스	뉴 스
지 난	지 난
고 통	고 통
영 <<unk>>	영 <unk>
본 사	본 사
<<unk>> 다	<unk> 다
괴 짜	괴 짜
응 답	응 답
교 수	교 수
샤 발	샤 발
학 구	학 구
구 멍	구 멍
구 강	구 강
<<unk>> 리	<unk> 리
취 미	취 미
노 동	노 동
호 전	호 전
정 구	정 구
수 영	수 영
<<unk>> 스	<unk> 스
동 부	동 부
상 의	상 의
장 모	장 모
<<unk>> 다	<unk> 다
의 복	의 복
누 들	누 들
양 초	양 초
진 주	진 주
<<unk>> 치	<unk> 치
육 수	육 수
악 취	악 취
모 전	모 전
울 산	울 산
따 <<unk>>	따 <unk>
선 지	선 지
탐 라	탐 라
하 남	하 남
낙 타	낙 타
치 한	치 한
양 유	양 유
남 루	남 루
<<unk>> 마	<unk> 마
미 성	미 성
무 술	무 술
숙 제	숙 제
<<unk>> 다	<unk> 다
노 선	노 선
여 <<unk>>	여 <unk>
내 장	내 장
국 가	국 가
특 유	특 유
도 <<unk>>	도 <unk>
<<unk>> 다	<unk> 다
석 의	석 의
까 닭	까 닭
손 주	손 주
골 프	골 프
걸 다	걸 다
암 <<unk>>	암 <unk>
센 트	센 트
더 빙	더 빙
소 속	소 속
질 소	질 소
말 레	말 레
금 지	금 지
감 마	감 마
원 시	원 시
서 점	서 점
인 식	인 식
강 요	강 요
여 론	여 론
수 칙	수 칙
서 <<unk>>	서 <unk>
예 방	예 방
멜 로	멜 로
군 인	군 인
가 식	가 식
<<unk>> 다	<unk> 다
표 고	표 고
주 정	주 정
충 고	충 고
그 것	그 것
헬 기	헬 기
미 분	미 분
골 무	골 무
강 가	강 가
입 법	입 법
가 끔	가 끔
다 발	다 발
자 산	자 산
기 약	기 약
그 <<unk>>	그 <unk>
케 <<unk>>	케 <unk>
방 언	방 언
인 출	인 출
낙 인	낙 인
단 지	단 지
기 역	기 역
흐 름	흐 름
분 투	분 투
고 발	고 발
중 지	중 지
기 원	기 원
박 제	박 제
마 침	마 침
수 송	수 송
옥 석	옥 석
빈 도	빈 도
알 <<unk>>	알 <unk>
메 밀	메 밀
저 곳	저 곳
줄 다	줄 다
푸 석	푸 석
자 만	자 만
답 다	답 다
<<unk>> 츠	<unk> 츠
품 다	품 다
남 체	남 체
입 <<unk>>	입 <unk>
집 안	집 안
대 국	대 국
기 름	기 름
혼 자	혼 자
언 문	언 문
투 항	투 항
도 금	도 금
엄 습	엄 습
노 랑	노 랑
검 도	검 도
세 금	세 금
망 치	망 치
조 회	조 회
그 날	그 날
복 수	복 수
졸 음	졸 음
소 득	소 득
어 형	어 형
떨 다	떨 다
조 절	조 절
야 <<unk>>	야 <unk>
왕 가	왕 가
창 조	창 조
그 림	그 림
고 집	고 집
각 기	각 기
드 립	드 립
<<unk>> 프	<unk> 프
기 록	기 록
<<unk>> 다	<unk> 다
초 딩	초 딩
<<unk>> 다	<unk> 다
세 상	세 상
복 사	복 사
찬 사	찬 사
크 기	크 기
회 음	회 음
독 주	독 주
민 서	민 서
마 켓	마 켓
<<unk>> 다	<unk> 다
옥 중	옥 중
범 주	범 주
계 모	계 모
녀 인	녀 인
체 육	체 육
북 부	북 부
안 심	안 심
과 로	과 로
<<unk>> 지	<unk> 지
문 제	문 제
파 탄	파 탄
도 망	도 망
초 혼	초 혼
얼 <<unk>>	얼 <unk>
바 늘	바 늘
피 망	피 망
참 다	참 다
초 순	초 순
처 럼	처 럼
약 자	약 자
질 투	질 투
진 보	진 보
발 인	발 인
<<unk>> <<unk>>	<unk> <unk>
또 는	또 는
산 호	산 호
구 출	구 출
체 질	체 질
<<unk>> 비	<unk> 비
제 탄	제 탄
워 낙	워 낙
도 둑	도 둑
자 칼	자 칼
참 사	참 사
송 도	송 도
종 자	종 자
호 남	호 남
전 업	전 업
구 혼	구 혼
보 상	보 상
거 절	거 절
구 약	구 약
성 부	성 부
주 막	주 막
지 진	지 진
날 다	날 다
의 혹	의 혹
교 거	교 거
리 원	리 원
열 다	열 다
산 보	산 보
전 부	전 부
유 진	유 진
각 시	각 시
남 초	남 초
다 락	다 락
주 석	주 석
<<unk>> 다	<unk> 다
노 크	노 크
외 교	외 교
배 당	배 당
구 성	구 성
의 료	의 료
친 구	친 구
탁 치	탁 치
화 차	화 차
<<unk>> 도	<unk> 도
보 통	보 통
그 물	그 물
부 품	부 품
<<unk>> 씨	<unk> 씨
내 용	내 용
녹 음	녹 음
찬 스	찬 스
일 꾼	일 꾼
외 과	외 과
트 림	트 림
사 설	사 설
절 차	절 차
달 비	달 비
녹 차	녹 차
출 구	출 구
연 옥	연 옥
해 녀	해 녀
폐 지	폐 지
하 녀	하 녀
도 적	도 적
유 탄	유 탄
추 석	추 석
의 식	의 식
조 류	조 류
장 비	장 비
시 험	시 험
정 보	정 보
법 학	법 학
바 <<unk>>	바 <unk>
억 류	억 류
카 란	카 란
구 취	구 취
콜 라	콜 라
야 당	야 당
부 름	부 름
입 술	입 술
간 사	간 사
사 뿐	사 뿐
게 장	게 장
서 남	서 남
알 곡	알 곡
비 난	비 난
수 화	수 화
코 <<unk>>	코 <unk>
찰 나	찰 나
전 하	전 하
가 득	가 득
<<unk>> 다	<unk> 다
겨 자	겨 자
불 다	불 다
지 붕	지 붕
내 전	내 전
충 수	충 수
예 절	예 절
비 법	비 법
괴 리	괴 리
암 흑	암 흑
빙 하	빙 하
저 쪽	저 쪽
거 역	거 역
통 로	통 로
유 통	유 통
구 상	구 상
다 른	다 른
죽 음	죽 음
마 달	마 달
유 학	유 학
하 필	하 필
구 분	구 분
수 심	수 심
말 리	말 리
비 율	비 율
일 군	일 꾼
마 법	마 법
콩 고	콩 고
요 절	요 절
고 문	고 문
흑 인	흑 인
마 취	마 취
신 다	신 다
의 회	의 회
낙 지	낙 지
응 당	응 당
도 박	도 박
지 출	지 출
정 부	정 부
대 퇴	대 퇴
<<unk>> 다	<unk> 다
심 지	심 지
여 진	여 진
학 자	학 자
안 쪽	안 쪽
케 <<unk>>	케 <unk>
배 송	배 송
선 로	선 로
적 외	적 외
서 민	서 민
<<unk>> 인	<unk> 인
처 신	처 신
박 사	박 사
봉 기	봉 기
기 물	기 물
부 화	부 화
악 단	악 단
소 송	소 송
구 십	구 십
요 괴	요 괴
정 주	정 주
요 람	요 람
물 체	물 체
옷 장	옷 장
버 선	버 선
씨 름	씨 름
<<unk>> 즈	<unk> 즈
비 골	비 골
차 장	차 장
드 럼	드 럼
천 지	천 지
난 수	난 수
다 짐	다 짐
니 <<unk>>	니 <unk>
부 족	부 족
브 금	브 금
중 도	중 도
커 <<unk>>	커 <unk>
독 자	독 자
이 별	이 별
<<unk>> 다	<unk> 다
물 레	물 레
매 출	매 출
정 은	정 은
자 료	자 료
간 주	간 주
독 소	독 소
벨 트	벨 트
<<unk>> 음	<unk> 음
치 는	치 는
학 사	학 사
수 말	수 말
염 기	염 기
시 선	시 선
온 실	온 실
단 일	단 일
서 강	서 강
제 공	제 공
신 비	신 비
부 분	부 분
게 시	게 시
증 오	증 오
기 후	기 후
어 뢰	어 뢰
후 추	후 추
무 마	무 마
불 어	불 어
수 로	수 로
다 시	다 시
노 사	노 사
부 처	부 처
너 머	너 머
기 치	기 치
구 타	구 타
직 후	직 후
무 리	무 리
투 수	투 수
급 우	급 우
포 치	포 치
주 사	주 사
리 그	리 그
리 얼	리 얼
수 바	수 바
인 도	인 도
소 위	소 위
까 치	까 치
스 타	스 타
나 포	나 포
보 다	보 다
주 도	주 도
은 인	은 인
하 트	하 트
멍 에	멍 에
송 어	송 어
마 더	마 더
외 지	외 지
<<unk>> 다	<unk> 다
수 입	수 입
마 유	마 유
가 게	가 게
거 지	거 지
마 루	마 루
<<unk>> 다	<unk> 다
두 음	두 음
제 주	제 주
시 루	시 루
따 로	따 로
제 의	제 의
고 모	고 모
악 수	악 수
치 즈	치 즈
<<unk>> 서	<unk> 서
이 점	이 점
나 사	나 사
마 주	마 주
우 산	우 산
기 체	기 체
서 구	서 구
급 히	급 히
바 쿠	바 쿠
도 기	도 기
임 무	임 무
암 시	암 시
거 즈	거 즈
기 업	기 업
이 름	이 름
전 우	전 우
여 와	여 와
따 위	따 위
고 <<unk>>	고 <unk>
도 예	도 예
에 탄	에 탄
<<unk>> 이	<unk> 이
고 시	고 시
악 한	악 한
종 이	종 이
어 근	어 근
자 체	자 체
카 드	카 드
이 듬	이 듬
<<unk>> 오	<unk> 오
스 모	스 모
놀 이	놀 이
세 일	세 일
너 <<unk>>	너 <unk>
가 히	가 히
매 주	매 주
노 예	노 예
제 비	제 비
아 론	아 론
대 다	대 다
자 네	자 네
저 거	저 거
<<unk>> 에	<unk> 에
대 위	대 위
요 일	요 일
피 다	피 다
소 리	소 리
고 온	고 온
이 발	이 발
이 과	이 과
겨 우	겨 우
세 요	세 요
이 물	이 물
코 피	코 피
<<unk>> 다	<unk> 다
도 시	도 시
서 로	서 로
비 트	비 트
기 자	기 자
타 일	타 일
다 소	다 소
비 다	비 다
개 요	개 요
오 <<unk>>	오 <unk>
하 도	하 도
버 마	버 마
제 거	제 거
티 슈	티 슈
위 치	위 치
예 일	예 일
마 트	마 트
노 트	노 트
소 음	소 음
마 다	마 다
<<unk>> 마	<unk> 마
저 <<unk>>	저 <unk>
외 모	외 모
세 트	세 트
부 수	부 수
어 원	어 원
체 스	체 스
투 기	투 기
노 인	노 인
축 하	축 하
운 수	운 수
모 드	모 드
타 자	타 자
노 안	노 안
코 트	코 트
제 로	제 로
거 세	거 세
처 가	처 가
메 기	메 기
아 동	아 동
안 부	안 부
미 라	미 라
오 직	오 직
울 다	울 다
암 호	암 호
자 리	자 리
버 미	버 미
파 다	파 다
고 니	곤 이
자 세	자 세
제 일	제 일
이 랑	이 랑
허 가	허 가
주 제	주 제
주 거	주 거
오 류	오 류
예 의	예 의
<<unk>> 다	<unk> 다
인 치	인 치
좌 우	좌 우
이 장	이 장
오 전	오 전
엄 지	엄 지
수 수	수 수
우 <<unk>>	우 <unk>
성 우	성 우
상 어	상 어
서 체	서 체
뜨 다	뜨 다
을 게	을 게
차 고	차 고
이 상	이 상
파 리	파 리
요 도	요 도
<<unk>> 다	<unk> 다
꼬 리	꼬 리
도 구	도 구
이 혼	이 혼
가 루	가 루
여 기	여 기
개 다	개 다
보 기	보 기
수 프	수 프
자 지	자 지
무 얼	무 얼
얼 <<unk>>	얼 <unk>
누 구	누 구
어 족	어 족
수 저	수 저
위 업	위 업
포 <<unk>>	포 <unk>
로 그	로 그
타 조	타 조
배 부	배 부
부 여	부 여
도 입	도 입
웃 다	웃 다
바 위	바 위
맞 이	맞 이
억 지	억 지
프 로	프 로
선 우	선 우
기 사	기 사
토 끼	토 끼
거 미	거 미
두 마	두 마
업 소	업 소
라 임	라 임
시 <<unk>>	시 <unk>
지 나	지 나
세 차	세 차
후 예	후 예
이 틀	이 틀
기 차	기 차
조 차	조 차
대 사	대 사
해 안	해 안
부 서	부 서
수 다	수 다
바 다	바 다
라 니	라 니
짜 다	짜 다
여 인	여 인
미 모	미 모
체 포	체 포
요 지	요 지
일 자	일 자
영 어	영 어
시 제	시 제
마 일	마 일
꼬 치	꼬 치
모 임	모 임
무 <<unk>>	무 <unk>
일 <<unk>>	일 <unk>
여 가	여 가
걸 어	걸 어
기 지	기 지
애 칭	애 칭
나 비	나 비
체 인	체 인
용 이	용 이
비 수	비 수
음 쓰	음 쓰
나 리	나 리
<<unk>> 다	<unk> 다
유 입	유 입
예 외	예 외
가 을	가 을
모 두	모 두
조 세	조 세
거 의	거 의
인 수	인 수
토 지	토 지
호 러	호 러
채 소	채 소
하 인	하 인
서 예	서 예
하 마	하 마
소 제	소 제
후 지	후 지
수 호	수 호
구 입	구 입
오 락	오 락
제 사	제 사
오 <<unk>>	오 <unk>
두 부	두 부
바 리	바 리
버 그	버 그
치 다	치 다
게 임	게 임
수 요	수 요
폐 어	폐 어
서 고	서 고
하 자	하 자
여 자	여 자
대 치	대 치
조 끼	조 끼
부 피	부 피
<<unk>> 다	<unk> 다
마 을	마 을
아 담	아 담
따 다	따 다
제 안	제 안
셔 터	셔 터
피 시	피 시
토 시	토 시
피 부	피 부
와 인	와 인
엄 마	엄 마
십 오	시 보
비 버	비 버
투 구	투 구
조 수	조 수
애 정	애 정
비 소	비 소
라 인	라 인
보 안	보 안
하 프	하 프
푸 다	푸 다
외 인	외 인
이 질	이 질
세 포	세 포
기 <<unk>>	기 <unk>
치 타	치 타
입 구	입 구
이 용	이 용
암 초	암 초
해 마	해 마
무 예	무 예
후 조	후 조
기 입	기 입
여 보	여 보
바 알	바 알
치 마	치 마
거 주	거 주
부 부	부 부
저 기	저 기
소 스	소 스
위 주	위 주
후 두	후 두
수 치	수 치
마 마	마 마
대 마	대 마
이 민	이 민
우 선	우 선
온 수	온 수
가 스	가 스
이 분	이 분
기 호	기 호
시 보	시 보
구 토	구 토
가 드	가 드
성 어	성 어
이 동	이 동
어 란	어 란
이 탈	이 탈
<<unk>> 이	<unk> 이
인 니	인 니
안 타	안 타
께 서	께 서
조 치	조 치
해 외	해 외
부 두	부 두
기 온	기 온
해 고	해 고
주 체	주 체
투 옥	투 옥
일 치	일 치
주 스	주 스
서 거	서 거
악 인	악 인
사 스	사 스
마 니	마 니
미 안	미 안
조 카	조 카
이 전	이 전
처 지	처 지
무 <<unk>>	무 <unk>
에 <<unk>>	에 <unk>
타 다	타 다
카 트	카 트
암 자	암 자
부 리	부 리
시 다	시 다
포 피	포 피
가 시	가 시
일 부	일 부
해 주	해 주
<<unk>> 도	<unk> 도
도 끼	도 끼
임 시	임 시
스 시	스 시
조 예	조 예
보 고	보 고
주 인	주 인
로 마	로 마
조 의	조 의
씨 <<unk>>	씨 <unk>
카 나	카 나
대 지	대 지
아 연	아 연
해 도	해 도
길 이	길 이
내 외	내 외
유 가	유 가
고 루	고 루
루 저	루 저
아 민	아 민
미 주	미 주
유 서	유 서
부 추	부 추
먹 이	먹 이
오 염	오 염
추 가	추 가
알 제	알 제
은 유	은 유
호 두	호 두
인 하	인 하
그 루	그 루
비 고	비 고
일 체	일 체
지 하	지 하
여 제	여 제
시 가	시 가
다 수	다 수
수 서	수 서
리 <<unk>>	리 <unk>
너 트	너 트
허 수	허 수
더 위	더 위
수 도	수 도
<<unk>> <<unk>>	<unk> <unk>
페 니	페 니
가 로	가 로
초 지	초 지
임 자	임 자
우 표	우 표
미 스	미 스
체 구	체 구
요 리	요 리
무 게	무 게
더 미	더 미
서 다	서 다
익 사	익 사
요 구	요 구
시 위	시 위
가 자	가 자
지 옥	지 옥
고 요	고 요
세 로	세 로
자 꾸	자 꾸
제 조	제 조
이 불	이 불
없 이	없 이
지 압	지 압
포 트	포 트
웃 음	웃 음
후 드	후 드
<<unk>> <<unk>>	<unk> <unk>
루 프	루 프
시 디	시 디
티 <<unk>>	티 <unk>
어 감	어 감
리 가	리 가
사 구	사 구
술 어	술 어
해 제	해 제
메 카	메 카
수 고	수 고
피 임	피 임
장 어	장 어
오 촌	오 촌
가 차	가 차
고 리	고 리
추 억	추 억
보 <<unk>>	보 <unk>
이 란	이 란
<<unk>> 다	<unk> 다
도 모	도 모
체 제	체 제
유 <<unk>>	유 <unk>
이 쪽	이 쪽
체 코	체 코
에 는	에 는
저 주	저 주
보 호	보 호
부 모	부 모
커 서	커 서
세 기	세 기
케 익	케 익
기 타	기 타
도 하	도 하
파 업	파 업
<<unk>> 다	<unk> 다
수 라	수 라
가 보	가 보
해 리	해 리
유 도	유 도
모 피	모 피
구 무	구 무
요 소	요 소
농 어	농 어
고 지	고 지
오 금	오 금
니 은	니 은
풀 이	풀 이
처 음	처 음
우 <<unk>>	우 <unk>
유 언	유 언
주 소	주 소
음 소	음 소
미 터	미 터
송 이	송 이
오 른	오 른
샤 워	샤 워
커 브	커 브
하 고	하 고
치 안	치 안
방 어	방 어
그 네	그 네
우 동	우 동
<<unk>> 다	<unk> 다
우 한	우 한
다 리	다 리
루 머	루 머
시 비	시 비
토 고	토 고
체 리	체 리
문 어	문 어
메 일	메 일
입 다	입 다
상 아	상 아
가 제	가 제
거 인	거 인
부 호	부 호
코 드	코 드
비 자	비 자
유 머	유 머
인 사	인 사
바 로	바 로
주 로	주 로
추 위	추 위
체 커	체 커
마 소	마 소
세 제	세 제
우 물	우 물
호 소	호 소
처 리	처 리
압 도	압 도
미 르	미 르
고 저	고 저
서 리	서 리
듯 이	듯 이
오 존	오 존
셔 츠	셔 츠
모 음	모 음
박 이	박 이
붕 어	붕 어
밀 어	밀 어
이 론	이 론
예 다	예 다
일 보	일 보
지 구	지 구
꼬 마	꼬 마
배 추	배 추
언 니	언 니
끼 니	끼 니
입 시	입 시
포 자	포 자
의 리	의 리
다 카	다 카
엄 니	엄 니
국 어	국 어
마 음	마 음
의 미	의 미
허 리	허 리
타 이 어	타 이 어
아 이 고	아 이 고
바 이 오	바 이 오
아 이 디	아 이 디
어 버 이	어 버 이
아 시 아	아 시 아
아 이 다	아 이 다
오 누 이	오 누 이
아 이 가	아 이 가
아 이 티	아 이 티
에 이 즈	에 이 즈
<<unk>> 다	<unk> 다
개 수	개 수
<<unk>> 다	<unk> 다
버 거	버 거
사 안	사 안
음 악	음 악
이 며	이 며
기 억	기 억
싸 리	싸 리
네 모	네 모
도 움	도 움
거 야	거 야
코 너	코 너
더 <<unk>>	더 <unk>
해 저	해 저
제 시	제 시
쓰 푸	쓰 푸
뇌 우	뇌 우
거 울	거 울
방 아	방 아
까 지	까 지
가 나	가 나
어 묵	어 묵
코 스	코 스
애 교	애 교
각 하	각 하
오 답	오 답
부 유	부 유
거 기	거 기
쓰 리	쓰 리
마 리	마 리
대 수	대 수
아 <<unk>>	아 <unk>
어 간	어 간
오 늘	오 늘
주 위	주 위
고 을	고 을
이 곳	이 곳
<<unk>> 데	<unk> 데
외 투	외 투
누 치	누 치
구 요	구 요
예 후	예 후
<<unk>> 이	맞 이
나 라	나 라
쓰 다	쓰 다
우 승	우 승
오 물	오 물
서 부	서 부
추 수	추 수
사 시	사 시
이 <<unk>>	이 <unk>
이 날	이 날
도 체	도 체
알 라	알 라
지 다	지 다
대 두	대 두
아 군	아 군
그 제	그 제
예 언	예 언
여 하	여 하
비 서	비 서
의 자	의 자
가 사	가 사
이 승	이 승
시 체	시 체
빠 리	빠 리
가 무	가 무
해 일	해 일
마 구	마 구
알 파	알 파
인 제	인 제
속 어	속 어
억 압	억 압
머 리	머 리
제 유	제 유
사 악	사 악
부 터	부 터
이 삼	이 삼
아 직	아 직
십 이	시 비
우 상	우 상
초 로	초 로
유 엔	유 엔
사 업	사 업
마 차	마 차
토 치	토 치
도 루	도 루
숭 어	숭 어
<<unk>> 부	<unk> 부
로 또	로 또
추 구	추 구
노 파	노 파
하 위	하 위
차 드	차 드
사 나	사 나
쇼 츠	쇼 츠
그 리	그 리
배 다	배 다
<<unk>> 다	<unk> 다
자 비	자 비
대 모	대 모
앞 서	앞 서
피 워	피 워
<<unk>> 이	<unk> 이
부 사	부 사
사 울	사 울
대 기	대 기
모 사	모 사
가 구	가 구
트 다	트 다
안 마	안 마
노 루	노 루
비 유	비 유
차 마	차 마
피 지	피 지
구 마	구 마
시 도	시 도
메 터	메 터
초 유	초 유
의 의	의 의
숙 어	숙 어
가 세	가 세
홍 어	홍 어
나 소	나 소
엉 엉	엉 엉
거 유	거 유
자 제	자 제
다 스	다 스
억 수	억 수
해 소	해 소
이 성	이 성
내 주	내 주
보 리	보 리
아 랍	아 랍
시 주	시 주
루 카	루 카
미 처	미 처
<<unk>> 다	<unk> 다
가 지	가 지
하 와	하 와
우 연	우 연
소 파	소 파
울 음	울 음
보 지	보 지
구 호	구 호
<<unk>> 기	<unk> 기
예 수	예 수
몽 어	몽 어
지 지	지 지
소 주	소 주
초 인	초 인
부 임	부 임
<<unk>> 다	<unk> 다
부 위	부 위
같 이	같 이
포 도	포 도
자 음	자 음
내 부	내 부
논 어	논 어
수 은	수 은
<<unk>> 다	<unk> 다
나 무	나 무
이 글	이 글
언 제	언 제
일 기	일 기
주 다	주 다
부 제	부 제
복 호	복 호
사 제	사 제
아 <<unk>>	아 <unk>
나 시	나 시
카 페	카 페
자 외	자 외
고 투	고 투
누 리	누 리
끼 다	끼 다
나 다	나 다
기 여	기 여
전 이	전 이
주 차	주 차
소 유	소 유
리 터	리 터
유 지	유 지
사 모	사 모
업 다	업 다
누 두	누 두
너 무	너 무
연 어	연 어
지 위	지 위
아 점	아 점
<<unk>> 어	<unk> 어
하 나	하 나
타 워	타 워
이 번	이 번
나 치	나 치
외 부	외 부
임 기	임 기
<<unk>> 여	<unk> 여
위 기	위 기
오 십	오 십
메 모	메 모
위 조	위 조
안 티	안 티
여 초	여 초
두 세	두 세
보 라	보 라
하 다	하 다
이 십	이 십
기 저	기 저
여 체	여 체
파 일	파 일
수 소	수 소
인 후	인 후
박 하	박 하
매 미	매 미
이 런	일 언
커 리	커 리
개 체	개 체
로 고	로 고
빠 다	빠 다
바 지	바 지
가 위	가 위
대 포	대 포
기 운	기 운
고 수	고 수
차 트	차 트
놓 다	놓 다
너 네	너 네
보 드	보 드
미 사	미 사
소 포	소 포
프 디	프 디
곤 이	곤 이
고 조	고 조
로 토	로 토
알 다	알 다
대 응	대 응
끼 리	끼 리
정 오	정 오
허 허	허 허
호 스	호 스
그 저	그 저
우 화	우 화
악 마	악 마
바 보	바 보
단 어	단 어
누 나	누 나
자 다	자 다
하 즈	하 즈
데 모	데 모
아 <<unk>>	아 <unk>
안 주	안 주
이 것	이 것
모 토	모 토
포 부	포 부
오 월	오 월
수 레	수 레
도 로	도 로
<<unk>> 이	<unk> 이
안 다	안 다
인 자	인 자
수 조	수 조
운 하	운 하
한 어	한 어
짜 리	짜 리
호 주	호 주
이 빨	이 빨
기 와	기 와
임 부	임 부
주 저	주 저
모 루	모 루
피 고	피 고
싸 다	싸 다
나 의	나 의
매 일	매 일
의 제	의 제
라 고	라 고
미 수	미 수
조 사	조 사
노 아	노 아
어 머	어 머
조 우	조 우
어 부	어 부
일 이	일 이
아 주	아 주
이 나	이 나
모 이	모 이
어 느	어 느
차 이	차 이
우 세	우 세
에 게	에 게
우 엉	우 엉
이 익	이 익
<<unk>> 이	<unk> 이
오 온	오 온
이 야	이 야
노 어	노 어
어 구	어 구
누 이	누 이
이 하	이 하
아 요	아 요
고 어	고 어
아 비	아 비
따 이	따 이
아 예	아 예
이 모	이 모
모 어	모 어
고 아	고 아
<<unk>> 어	<unk> 어
치 아	치 아
아 웃	아 웃
이 도	이 도
으 <<unk>>	으 <unk>
나 이	나 이
<<unk>> 어	<unk> 어
이 자	이 자
조 어	조 어
언 어	언 어
이 외	이 외
미 어	미 어
이 끼	이 끼
이 게	이 게
아 서	아 서
이 주	이 주
아 악	아 악
치 우	치 우
에 러	에 러
자 아	자 아
애 인	애 인
두 어	두 어
이 제	이 제
어 요	어 요
<<unk>> 아	<unk> 아
<<unk>> 지	<unk> 지
오 빠	오 빠
아 리	<unk> 이
아 유	아 유
아 무	아 무
오 <<unk>>	오 <unk>
로 어	로 어
토 우	토 우
악 어	악 어
유 아	유 아
아 마	아 마
이 리	일 이
코 이	코 이
어 제	어 제
타 이	타 이
아 기	아 기
에 터	에 터
우 마	우 마
파 이	파 이
오 타	오 타
어 치	어 치
이 마	이 마
어 디	어 디
모 에	모 에
이 엉	이 엉
미 아	미 아
인 어	인 어
오 후	오 후
<<unk>> 어	<unk> 어
오 다	오 다
아 야	아 야
이 거	이 거
아 라	아 라
누 에	누 에
우 유	우 유
어 서	어 서
부 아	부 아
에 <<unk>>	에 <unk>
구 이	구 이
이 체	이 체
오 디	오 디
대 우	대 우
은 어	은 어
이 다	이 다
으 로	으 로
주 어	주 어
이 미	이 미
아 자	아 자
이 웃	이 웃
아 니	아 니
아 이	아 이
어 이	어 이
오 이	오 이
이 어	이 어
우 아	우 아
좌 석	좌 석
볼 <<unk>>	볼 <unk>
반 반	반 반
승 려	승 려
반 말	반 말
소 형	소 형
<<unk>> 잠	<unk> 잠
간 <<unk>>	간 <unk>
한 <<unk>>	한 <unk>
문 화	문 화
용 돈	용 돈
명 의	명 의
만 성	만 성
호 평	호 평
공 중	공 중
감 전	감 전
약 실	약 실
국 립	국 립
원 폭	원 폭
실 <<unk>>	실 <unk>
슬 <<unk>>	슬 <unk>
삼 성	삼 성
대 량	대 량
멜 론	멜 론
질 녀	질 녀
눈 물	눈 물
달 성	달 성
단 락	단 락
눈 빛	눈 빛
약 칭	약 칭
문 학	문 학
눈 꽃	눈 꽃
훈 장	훈 장
독 살	독 살
영 혼	영 혼
발 목	발 목
깜 박	깜 박
개 량	개 량
근 원	근 원
신 발	신 발
국 왕	국 왕
봉 착	봉 착
원 장	원 장
한 양	한 양
규 율	규 율
정 원	정 원
발 간	발 간
계 승	계 승
턱 선	턱 선
양 말	양 말
<<unk>> 다	<unk> 다
분 묘	분 묘
종 양	종 양
연 간	연 간
분 류	분 류
배 경	배 경
민 국	민 국
가 령	가 령
동 전	동 전
갑 충	갑 충
진 출	진 출
순 교	순 교
수 명	수 명
창 원	창 원
닭 발	닭 발
<<unk>> 글	<unk> 글
공 작	공 작
방 출	방 출
안 경	안 경
빈 <<unk>>	빈 <unk>
삼 월	삼 월
솔 크	솔 크
학 과	학 과
천 당	천 당
실 례	실 례
통 금	통 금
절 반	절 반
방 금	방 금
노 면	노 면
세 력	세 력
발 란	발 란
전 한	전 한
연 극	연 극
수 련	수 련
불 법	불 법
폭 정	폭 정
멸 치	멸 치
조 <<unk>>	조 <unk>
<<unk>> 합	<unk> 합
망 상	망 상
예 명	예 명
물 질	물 질
목 란	목 란
낮 잠	낮 잠
용 접	용 접
흡 연	흡 연
통 증	통 증
탐 욕	탐 욕
<<unk>> 빈	<unk> 빈
만 날	만 날
운 명	운 명
리 <<unk>>	리 <unk>
성 실	성 실
콩 <<unk>>	콩 <unk>
외 환	외 환
명 소	명 소
전 율	전 율
번 역	번 역
다 <<unk>>	다 <unk>
망 간	망 간
영 양	영 양
명 부	명 부
권 위	권 위
음 향	음 향
통 풍	통 풍
<<unk>> 복	<unk> 복
년 도	년 도
목 청	목 청
실 습	실 습
궁 정	궁 정
출 근	출 근
영 성	영 성
청 진	청 진
공 간	공 간
삼 십	삼 십
병 사	병 사
설 화	설 화
열 <<unk>>	열 <unk>
장 군	장 군
산 문	산 문
축 복	축 복
민 <<unk>>	민 <unk>
졸 혼	졸 혼
김 장	김 장
닭 살	닭 살
폭 발	폭 발
특 성	특 성
점 원	점 원
종 류	종 류
착 석	착 석
홍 콩	홍 콩
<<unk>> 지	<unk> 지
순 박	순 박
근 접	근 접
노 력	노 력
퇴 진	퇴 진
증 상	증 상
녹 말	녹 말
전 역	전 역
심 정	심 정
건 반	건 반
술 집	술 집
화 신	화 신
교 복	교 복
만 족	만 족
중 립	중 립
탄 성	탄 성
신 종	신 종
성 상	성 상
침 <<unk>>	침 <unk>
곳 곳	곳 곳
낙 엽	낙 엽
전 복	전 복
상 표	상 표
개 <<unk>>	개 <unk>
절 망	절 망
계 절	계 절
광 업	광 업
연 <<unk>>	연 <unk>
침 목	침 목
광 부	광 부
한 글	한 글
구 녕	구 녕
녀 신	녀 신
장 난	장 난
손 질	손 질
용 역	용 역
시 력	시 력
<<unk>> 일	<unk> 일
발 정	발 정
상 점	상 점
<<unk>> 털	<unk> 털
전 설	전 설
<<unk>> <<unk>>	<unk> <unk>
금 전	금 전
과 금	과 금
한 참	한 참
화 단	화 단
고 관	고 관
접 근	접 근
볼 일	볼 일
상 식	상 식
교 원	교 원
삼 한	삼 한
출 전	출 전
연 장	연 장
동 작	동 작
곡 물	곡 물
<<unk>> 쪽	<unk> 쪽
학 식	학 식
광 초	광 초
불 만	불 만
망 막	망 막
찬 장	찬 장
총 통	총 통
산 천	산 천
과 물	과 물
과 팅	과 팅
연 못	연 못
계 란	계 란
문 턱	문 턱
꿈 틀	꿈 틀
칼 <<unk>>	칼 <unk>
편 의	편 의
전 류	전 류
분 단	분 단
<<unk>> 침	<unk> 침
저 력	저 력
식 탁	식 탁
과 학	과 학
철 폐	철 폐
잡 종	잡 종
턱 <<unk>>	턱 <unk>
순 흥	순 흥
공 연	공 연
동 화	동 화
감 금	감 금
선 박	선 박
귀 족	귀 족
흥 정	흥 정
통 합	통 합
한 영	하 녕
감 각	감 각
<<unk>> 마	<unk> 마
요 령	요 령
직 감	직 감
작 품	작 품
내 <<unk>>	내 <unk>
만 물	만 물
등 장	등 장
설 폰	설 폰
유 량	유 량
교 란	교 란
엄 격	엄 격
정 답	정 답
계 정	계 정
<<unk>> 장	<unk> 장
<<unk>> <<unk>>	<unk> <unk>
창 문	창 문
화 석	화 석
명 일	명 일
단 계	단 계
식 품	식 품
적 분	적 분
여 관	여 관
밀 림	밀 림
귀 국	귀 국
강 물	강 물
화 학	화 학
출 산	출 산
약 탈	약 탈
표 절	표 절
친 절	친 절
중 간	중 간
영 역	영 역
천 둥	천 둥
취 직	취 직
공 갈	공 갈
발 <<unk>>	발 <unk>
학 습	학 습
화 폐	화 폐
경 치	경 치
수 평	수 평
외 면	외 면
빙 점	빙 점
영 적	영 적
문 진	문 진
발 표	발 표
도 벽	도 벽
전 갈	전 갈
강 판	강 판
진 한	진 한
평 야	평 야
본 능	본 능
정 규	정 규
벼 슬	벼 슬
양 봉	양 봉
체 결	체 결
요 격	요 격
국 민	국 민
근 육	근 육
염 장	염 장
두 견	두 견
죄 송	죄 송
반 품	반 품
독 립	독 립
<<unk>> 집	<unk> 집
공 방	공 방
글 꼴	글 꼴
완 성	완 성
농 민	농 민
콘 <<unk>>	콘 <unk>
교 장	교 장
순 천	순 천
회 상	회 상
십 삼	십 삼
총 장	총 장
서 클	서 클
<<unk>> 날	<unk> 날
각 본	각 본
중 공	중 공
선 물	선 물
천 국	천 국
한 잔	한 잔
번 영	번 영
방 송	방 송
함 흥	함 흥
담 요	담 요
달 빛	달 빛
통 화	통 화
시 편	시 편
복 잡	복 잡
접 <<unk>>	접 <unk>
질 문	질 문
<<unk>> 장	<unk> 장
염 복	염 복
동 성	동 성
해 결	해 결
철 퇴	철 퇴
손 상	손 상
별 세	별 세
매 년	매 년
간 극	간 극
방 식	방 식
<<unk>> <<unk>>	<unk> <unk>
송 림	송 림
<<unk>> 날	<unk> 날
규 범	규 범
남 쪽	남 쪽
뉴 런	뉴 런
불 복	불 복
삼 국	삼 국
악 력	악 력
문 과	문 과
산 양	사 냥
요 녕	요 녕
선 상	선 상
익 명	익 명
유 <<unk>>	유 <unk>
성 욕	성 욕
상 성	상 성
종 료	종 료
복 날	복 날
청 각	청 각
실 험	실 험
교 전	교 전
밥 집	밥 집
계 좌	계 좌
친 족	친 족
<<unk>> 렛	<unk> 렛
칭 찬	칭 찬
독 방	독 방
곰 틀	곰 틀
정 장	정 장
가 격	가 격
몽 정	몽 정
돌 <<unk>>	돌 <unk>
원 통	원 통
교 류	교 류
공 항	공 항
증 설	증 설
악 평	악 평
잔 혹	잔 혹
<<unk>> 정	<unk> 정
소 련	소 련
영 문	영 문
설 교	설 교
실 록	실 록
경 고	경 고
항 성	항 성
침 묵	침 묵
착 공	착 공
상 원	상 원
합 창	합 창
화 분	화 분
칠 판	칠 판
집 중	집 중
궁 중	궁 중
똑 똑	똑 똑
문 법	문 법
<<unk>> 난	<unk> 난
눈 길	눈 길
신 속	신 속
소 환	소 환
설 정	설 정
구 현	구 현
실 망	실 망
굴 절	굴 절
경 제	경 제
접 선	접 선
창 설	창 설
꽃 집	꽃 집
계 산	계 산
별 일	별 일
야 경	야 경
동 갑	동 갑
변 수	변 수
육 군	육 군
일 광	일 광
곱 <<unk>>	곱 <unk>
<<unk>> 눈	<unk> 눈
해 병	해 병
안 녕	안 녕
꿈 적	꿈 적
풍 선	풍 선
공 군	공 군
흑 흑	흑 흑
음 경	음 경
작 용	작 용
<<unk>> 말	<unk> 말
밥 상	밥 상
남 장	남 장
민 속	민 속
침 술	침 술
갈 증	갈 증
출 연	출 연
혼 례	혼 례
성 문	성 문
계 단	계 단
전 진	전 진
탐 정	탐 정
위 협	위 협
극 동	극 동
평 일	평 일
선 창	선 창
학 번	학 번
민 화	민 화
전 등	전 등
<<unk>> <<unk>>	<unk> <unk>
<<unk>> 볼	<unk> 볼
몽 골	몽 골
신 화	신 화
종 족	종 족
쌀 쌀	쌀 쌀
되 <<unk>>	되 <unk>
집 필	집 필
잠 열	잠 열
물 범	물 범
추 격	추 격
명 주	명 주
버 클	버 클
산 장	산 장
집 계	집 계
혼 란	혼 란
지 혈	지 혈
선 장	선 장
당 류	당 류
정 전	정 전
민 중	민 중
<<unk>> 음	<unk> 음
독 감	독 감
경 주	경 주
감 상	감 상
맞 <<unk>>	맞 <unk>
골 목	골 목
분 점	분 점
실 천	실 천
권 투	권 투
창 작	창 작
화 물	화 물
공 급	공 급
접 속	접 속
원 <<unk>>	원 <unk>
팔 각	팔 각
전 공	전 공
정 식	정 식
연 합	연 합
염 통	염 통
속 담	속 담
공 민	공 민
궁 전	궁 전
의 향	의 향
북 방	북 방
걸 <<unk>>	걸 <unk>
수 량	수 량
방 학	방 학
<<unk>> 팅	<unk> 팅
괴 뢰	괴 뢰
약 속	약 속
권 리	권 리
관 리	관 리
신 학	신 학
급 료	급 료
원 천	원 천
전 골	전 골
혹 성	혹 성
방 귀	방 귀
열 흘	열 흘
<<unk>> 통	<unk> 통
<<unk>> <<unk>>	<unk> <unk>
벌 떡	벌 떡
식 전	식 전
탄 화	탄 화
부 활	부 활
공 공	공 공
민 망	민 망
양 곤	양 곤
면 서	면 서
점 막	점 막
규 약	규 약
연 금	연 금
학 살	학 살
영 묘	영 묘
중 성	중 성
변 소	변 소
꽃 <<unk>>	꽃 <unk>
몰 골	몰 골
참 전	참 전
별 거	별 거
<<unk>> 납	<unk> 납
염 료	염 료
열 방	열 방
열 정	열 정
철 갑	철 갑
세 <<unk>>	세 <unk>
반 짝	반 짝
체 력	체 력
황 로	황 로
근 본	근 본
본 문	본 문
동 정	동 정
간 판	간 판
착 각	착 각
꼴 꼴	꼴 꼴
<<unk>> 형	<unk> 형
집 들	집 들
만 능	만 능
발 탁	발 탁
교 양	교 양
석 순	석 순
<<unk>> 권	<unk> 권
북 송	북 송
무 력	무 력
소 변	소 변
벤 젠	벤 젠
격 언	격 언
몸 통	몸 통
먹 물	먹 물
강 림	강 림
평 수	평 수
깜 작	깜 작
반 복	반 복
<<unk>> 콘	<unk> 콘
왕 실	왕 실
방 점	방 점
줄 <<unk>>	줄 <unk>
석 방	석 방
단 천	단 천
<<unk>> 통	<unk> 통
<<unk>> 각	<unk> 각
통 신	통 신
원 칙	원 칙
덕 분	덕 분
홍 합	홍 합
음 력	음 력
끔 쩍	끔 쩍
단 골	단 골
신 곡	신 곡
득 남	득 남
간 식	간 식
강 설	강 설
<<unk>> 닭	<unk> 닭
퇴 폐	퇴 폐
간 접	간 접
일 년	일 년
남 극	남 극
약 품	약 품
정 직	정 직
대 <<unk>>	대 <unk>
알 력	알 력
각 종	각 종
<<unk>> 장	<unk> 장
장 물	장 물
학 설	학 설
군 단	군 단
금 성	금 성
종 종	종 종
탐 험	탐 험
계 곡	계 곡
겹 다	겹 다
광 시	광 시
방 문	방 문
블 럭	블 럭
상 당	상 당
대 령	대 령
빙 빙	빙 빙
목 표	목 표
기 병	기 병
잠 <<unk>>	잠 <unk>
날 것	날 것
촌 락	촌 락
지 경	지 경
잔 류	잔 류
눈 곱	눈 곱
방 영	방 영
반 죽	반 죽
침 실	침 실
위 력	위 력
신 뢰	신 뢰
산 동	산 동
도 <<unk>>	도 <unk>
장 승	장 승
<<unk>> 날	<unk> 날
양 심	양 심
동 공	동 공
염 증	염 증
감 방	감 방
동 글	동 글
극 장	극 장
전 신	전 신
징 계	징 계
무 <<unk>>	무 <unk>
진 <<unk>>	진 <unk>
바 륨	바 륨
죽 순	죽 순
손 <<unk>>	손 <unk>
최 선	최 선
진 실	진 실
총 총	총 총
선 실	선 실
직 원	직 원
품 목	품 목
곰 국	곰 국
금 속	금 속
최 강	최 강
성 공	성 공
과 장	과 장
왕 복	왕 복
괴 한	괴 한
사 면	사 면
암 향	암 향
전 술	전 술
영 국	영 국
기 관	기 관
필 승	필 승
상 속	상 속
만 약	만 약
성 심	성 심
원 반	원 반
<<unk>> 빵	<unk> 빵
합 계	합 계
불 상	불 상
알 약	알 약
진 화	진 화
고 환	고 환
<<unk>> <<unk>>	<unk> <unk>
료 법	료 법
모 <<unk>>	모 <unk>
감 동	감 동
직 전	직 전
신 용	신 용
득 녀	득 녀
약 국	약 국
영 본	영 본
<<unk>> 적	<unk> 적
삼 족	삼 족
쌀 밥	쌀 밥
절 약	절 약
방 법	방 법
강 국	강 국
물 통	물 통
대 변	대 변
과 연	과 연
필 통	필 통
복 선	복 선
관 음	관 음
성 교	성 교
간 질	간 질
종 교	종 교
차 량	차 량
만 화	만 화
<<unk>> 말	<unk> 말
벼 랑	벼 랑
충 돌	충 돌
밀 월	밀 월
작 곡	작 곡
성 립	성 립
담 당	담 당
풍 금	풍 금
곰 실	곰 실
답 습	답 습
경 구	경 구
전 학	전 학
밀 크	밀 크
득 점	득 점
한 둘	한 둘
한 국	한 국
돌 연	돌 연
친 밀	친 밀
신 문	신 문
북 측	북 측
존 중	존 중
약 점	약 점
체 면	체 면
만 남	만 남
식 욕	식 욕
교 탁	교 탁
라 면	라 면
마 력	마 력
특 례	특 례
상 <<unk>>	상 <unk>
확 인	확 인
해 면	해 면
검 술	검 술
<<unk>> 션	<unk> 션
식 빵	식 빵
진 동	진 동
교 육	교 육
전 례	전 례
청 춘	청 춘
간 성	간 성
<<unk>> 다	<unk> 다
방 역	방 역
<<unk>> 꽃	<unk> 꽃
삼 춘	삼 춘
활 자	활 자
공 정	공 정
목 장	목 장
욕 실	욕 실
간 통	간 통
각 설	각 설
젠 장	젠 장
한 중	한 중
사 형	사 형
<<unk>> <<unk>>	<unk> <unk>
학 교	학 교
반 찬	반 찬
익 <<unk>>	익 <unk>
중 증	중 증
강 당	강 당
의 견	의 견
남 작	남 작
당 질	당 질
방 탄	방 탄
침 공	침 공
물 증	물 증
회 원	회 원
답 장	답 장
풍 습	풍 습
촌 극	촌 극
필 름	필 름
정 말	정 말
계 속	계 속
문 란	문 란
<<unk>> 낮	<unk> 낮
논 문	논 문
존 <<unk>>	존 <unk>
멀 <<unk>>	멀 <unk>
팅 팅	팅 팅
한 약	한 약
승 화	승 화
항 상	항 상
준 말	준 말
승 계	승 계
난 방	난 방
열 둘	열 둘
양 쪽	양 쪽
코 <<unk>>	코 <unk>
통 계	통 계
반 역	반 역
전 날	전 날
격 리	격 리
빙 산	빙 산
각 막	각 막
완 전	완 전
학 벌	학 벌
과 정	과 정
<<unk>> 물	<unk> 물
숙 답	숙 답
몸 짓	몸 짓
충 충	충 충
강 철	강 철
직 접	직 접
암 벽	암 벽
라 <<unk>>	라 <unk>
체 념	체 념
명 사	명 사
청 순	청 순
황 하	황 하
점 검	점 검
항 복	항 복
당 연	당 연
정 성	정 성
지 면	지 면
양 상	양 상
퇴 학	퇴 학
<<unk>> 하	<unk> 하
천 장	천 장
보 병	보 병
곤 충	곤 충
경 로	격 로
<<unk>> 뻑	<unk> 뻑
노 환	노 환
합 법	합 법
밀 랍	밀 랍
교 각	교 각
건 축	건 축
<<unk>> 금	<unk> 금
성 취	성 취
갈 등	갈 등
검 정	검 정
석 탄	석 탄
인 명	인 명
학 급	학 급
팔 뚝	팔 뚝
화 약	화 약
칠 월	칠 월
삼 촌	삼 촌
<<unk>> 철	<unk> 철
함 성	함 성
흥 분	흥 분
화 살	화 살
강 간	강 간
남 용	남 용
겨 <<unk>>	겨 <unk>
북 쪽	북 쪽
계 약	계 약
음 량	음 량
칼 집	칼 집
장 정	장 정
최 근	최 근
떡 국	떡 국
저 편	저 편
불 과	불 과
훈 독	훈 독
상 담	상 담
말 <<unk>>	말 <unk>
차 별	차 별
월 식	월 식
간 절	간 절
구 경	구 경
방 심	방 심
친 선	친 선
각 국	각 국
총 각	총 각
천 성	천 성
참 말	참 말
본 성	본 성
약 식	약 식
연 속	연 속
선 화	선 화
통 과	통 과
검 역	검 역
범 죄	범 죄
단 풍	단 풍
선 교	선 교
연 꽃	연 꽃
계 열	계 열
목 석	목 석
<<unk>> 떡	<unk> 떡
담 임	담 임
악 곡	악 곡
추 방	추 방
축 사	축 사
사 월	사 월
밀 도	밀 도
조 짐	조 짐
날 짜	날 짜
수 성	수 성
국 악	국 악
철 도	철 도
화 보	화 보
치 통	치 통
젖 다	젖 다
미 팅	미 팅
초 원	초 원
겨 레	겨 레
차 질	차 질
사 천	사 천
안 과	안 과
주 민	주 민
나 방	나 방
인 증	인 증
지 만	지 만
혹 여	혹 여
모 험	모 험
전 자	전 자
국 화	국 화
유 럽	유 럽
전 주	전 주
법 안	법 안
소 용	소 용
길 가	길 가
냉 수	냉 수
칠 리	칠 리
상 자	상 자
판 지	판 지
침 입	침 입
필 자	필 자
보 험	보 험
조 <<unk>>	조 <unk>
난 치	난 치
범 위	범 위
꺼 풀	꺼 풀
동 네	동 네
봉 사	봉 사
스 <<unk>>	스 <unk>
누 님	누 님
서 랍	서 랍
흥 미	흥 미
초 판	초 판
미 상	미 상
원 자	원 자
잠 시	잠 시
모 란	모 란
멀 미	멀 미
<<unk>> 인	<unk> 인
무 역	무 역
<<unk>> 운	<unk> 운
베 닌	베 닌
<<unk>> 리	<unk> 리
신 호	신 호
라 선	라 선
당 시	당 시
천 사	천 사
제 한	제 한
모 <<unk>>	모 <unk>
법 가	법 가
<<unk>> 다	<unk> 다
공 로	공 로
나 랑	나 랑
전 체	전 체
물 기	물 기
공 모	공 모
자 율	자 율
위 반	위 반
달 리	달 리
수 술	수 술
수 산	수 산
<<unk>> 다	막 다
후 작	후 작
사 물	사 물
나 흘	나 흘
시 상	시 상
지 류	지 류
무 탈	무 탈
포 삭	포 삭
매 월	매 월
각 자	각 자
<<unk>> 이	<unk> 이
복 제	복 제
인 류	인 류
호 박	호 박
발 레	발 레
선 거	선 거
난 초	난 초
<<unk>> 다	<unk> 다
주 <<unk>>	주 <unk>
풍 수	풍 수
입 장	입 장
분 사	분 사
입 금	입 금
두 건	두 건
누 설	누 설
차 <<unk>>	차 <unk>
머 핀	머 핀
굴 비	굴 비
인 중	인 중
자 연	자 연
위 험	위 험
마 약	마 약
배 심	배 심
주 식	주 식
궁 수	궁 수
지 역	지 역
자 신	자 신
글 씨	글 씨
사 <<unk>>	사 <unk>
코 란	코 란
자 진	자 진
<<unk>> 다	<unk> 다
분 리	분 리
증 거	증 거
구 름	구 름
신 체	신 체
주 장	주 장
유 혹	유 혹
작 다	작 다
걸 레	걸 레
설 비	설 비
무 당	무 당
수 괴	수 괴
메 달	메 달
척 추	척 추
한 테	한 테
일 천	일 천
조 식	조 식
잡 초	잡 초
스 승	스 승
따 님	따 님
장 미	장 미
몰 카	몰 카
의 심	의 심
최 초	최 초
거 품	거 품
성 의	성 의
방 구	방 구
제 육	제 육
<<unk>> 다	<unk> 다
용 모	용 모
집 게	집 게
도 장	도 장
라 며	라 며
찾 다	찾 다
암 실	암 실
근 처	근 처
낮 다	낮 다
동 무	동 무
난 로	난 로
토 <<unk>>	토 <unk>
분 노	분 노
실 제	실 제
죄 인	죄 인
반 구	반 구
의 논	의 논
닝 샤	닝 샤
추 측	추 측
저 분	저 분
빙 수	빙 수
신 기	신 기
조 금	조 금
육 지	육 지
버 섯	버 섯
딸 기	딸 기
터 빈	터 빈
걸 음	걸 음
매 장	매 장
바 탕	바 탕
시 계	시 계
완 비	완 비
사 립	사 립
마 술	마 술
탄 소	탄 소
절 다	절 다
비 방	비 방
농 사	농 사
서 원	서 원
정 조	정 조
약 혼	약 혼
망 토	망 토
사 실	사 실
장 <<unk>>	장 <unk>
다 들	다 들
역 시	역 시
귀 주	귀 주
직 기	직 기
거 <<unk>>	거 <unk>
국 자	국 자
간 지	간 지
<<unk>> 다	<unk> 다
볼 트	볼 트
중 앙	중 앙
다 <<unk>>	다 <unk>
몰 라	몰 라
<<unk>> 다	<unk> 다
나 물	나 물
<<unk>> 도	<unk> 도
예 <<unk>>	예 <unk>
묘 지	묘 지
판 도	판 도
고 산	고 산
시 절	시 절
수 필	수 필
엄 청	엄 청
후 식	후 식
실 체	실 체
방 주	방 주
<<unk>> 다	<unk> 다
지 국	지 국
<<unk>> 다	<unk> 다
여 <<unk>>	여 <unk>
타 원	타 원
문 구	문 구
노 <<unk>>	노 <unk>
무 능	무 능
<<unk>> 다	<unk> 다
예 물	예 물
욕 조	욕 조
유 물	유 물
소 식	소 식
독 도	독 도
경 어	경 어
파 괴	파 괴
판 다	판 다
취 소	취 소
<<unk>> 다	<unk> 다
토 란	토 란
지 식	지 식
성 운	성 운
증 인	증 인
자 몽	자 몽
양 주	양 주
마 귀	마 귀
계 시	계 시
<<unk>> 다	<unk> 다
모 양	모 양
<<unk>> 입	<unk> 입
들 다	들 다
무 례	무 례
급 여	급 여
<<unk>> 다	<unk> 다
내 한	내 한
기 준	기 준
교 토	교 토
여 신	여 신
<<unk>> 음	<unk> 음
쇼 크	쇼 크
과 업	과 업
음 문	음 문
예 식	예 식
망 고	망 고
단 수	단 수
담 다	담 다
난 시	난 시
괴 기	괴 기
로 국	로 국
기 간	기 간
상 응	상 응
<<unk>> 다	집 다
부 장	부 장
의 장	의 장
일 단	일 단
한 두	한 두
악 당	악 당
물 음	물 음
강 수	강 수
영 하	영 하
국 회	국 회
저 장	저 장
중 요	중 요
습 기	습 기
심 사	심 사
역 사	역 사
도 표	도 표
다 엽	다 엽
신 부	신 부
주 연	주 연
원 앙	원 앙
옷 감	옷 감
라 <<unk>>	라 <unk>
자 랑	자 랑
인 삼	인 삼
음 표	음 표
조 림	조 림
처 방	처 방
잠 바	잠 바
조 상	조 상
전 기	전 기
<<unk>> 다	<unk> 다
말 기	말 기
해 달	해 달
조 성	조 성
자 뻑	자 뻑
물 가	물 가
석 유	석 유
부 검	부 검
방 지	방 지
단 위	단 위
도 <<unk>>	도 <unk>
티 켓	티 켓
처 녀	처 녀
<<unk>> 다	<unk> 다
비 료	비 료
부 산	부 산
되 게	되 게
달 인	달 인
폴 로	폴 로
그 람	그 람
졸 다	졸 다
개 판	개 판
페 놀	페 놀
는 지	는 지
이 념	이 념
보 물	보 물
마 흔	마 흔
<<unk>> 다	<unk> 다
적 자	적 자
추 출	추 출
허 용	허 용
양 즈	양 즈
과 일	과 일
피 롤	피 롤
일 동	일 동
유 월	유 월
<<unk>> 푸	<unk> 푸
법 인	법 인
대 장	대 장
박 차	박 차
유 감	유 감
글 자	글 자
<<unk>> 다	<unk> 다
기 계	기 계
전 후	전 후
부 적	부 적
감 소	감 소
포 탈	포 탈
필 요	필 요
거 성	거 성
수 습	수 습
괴 다	괴 다
일 정	일 정
그 늘	그 늘
식 초	식 초
모 교	모 교
자 식	자 식
통 가	통 가
대 충	대 충
가 계	가 계
<<unk>> 다	<unk> 다
분 모	분 모
벤 치	벤 치
기 각	기 각
수 박	수 박
목 수	목 수
유 출	유 출
피 란	피 란
초 점	초 점
주 방	주 방
과 자	과 자
나 름	나 름
<<unk>> 전	<unk> 전
자 막	자 막
직 위	직 위
슬 기	슬 기
과 두	과 두
점 주	점 주
여 름	여 름
천 하	천 하
잡 지	잡 지
칠 레	칠 레
폭 파	폭 파
셔 <<unk>>	셔 <unk>
텐 트	텐 트
상 호	상 호
비 취	비 취
범 인	범 인
삼 다	<unk> 다
자 취	자 취
영 지	영 지
도 청	도 청
온 천	온 천
모 욕	모 욕
파 동	파 동
사 신	사 신
고 난	고 난
학 회	학 회
지 뢰	지 뢰
<<unk>> 수	<unk> 수
저 급	저 급
민 주	민 주
적 도	적 도
사 항	사 항
<<unk>> 다	<unk> 다
처 남	처 남
시 방	시 방
논 리	논 리
각 도	각 도
합 체	합 체
영 사	영 사
의 상	의 상
<<unk>> 다	<unk> 다
가 동	가 동
은 <<unk>>	은 <unk>
열 차	열 차
미 국	미 국
보 증	보 증
악 몽	악 몽
공 업	공 업
정 리	정 리
기 근	기 근
알 <<unk>>	알 <unk>
방 조	방 조
대 회	대 회
<<unk>> 다	<unk> 다
사 망	사 망
제 품	제 품
아 이 <<unk>>	아 이 <unk>
에 테 르	에 테 르
<<unk>> 지 어	<unk> 지 어
오 타 쿠	오 타 쿠
오 페 라	오 페 라
이 모 부	이 모 부
라 우 터	라 우 터
아 파 트	아 파 트
웨 이 터	웨 이 터
카 우 치	카 우 치
앞 에 서	앞 에 서
노 서 아	노 서 아
알 타 이	알 타 이
비 데 오	비 데 오
게 이 샤	게 이 샤
사 우 나	사 우 나
도 우 미	도 우 미
타 이 가	타 이 가
메 이 스	메 이 스
허 베 이	허 베 이
지 우 다	지 우 다
우 체 부	우 체 부
오 적 어	오 적 어
리 어 카	리 어 카
요 오 드	요 오 드
오 징 어	오 징 어
나 오 다	나 오 다
우 익 수	우 익 수
<<unk>> 히 다	<unk> 히 다
두 바 이	두 바 이
이 <<unk>> 고	이 <unk> 고
오 타 와	오 타 와
이 메 일	이 메 일
아 이 돌	아 이 돌
아 마 도	아 마 도
라 디 오	라 디 오
에 스 터	에 스 터
<<unk>> 우 지	<unk> 우 지
이 따 가	이 따 가
아 테 네	아 테 네
아 프 다	아 프 다
아 이 들	아 이 들
마 우 스	마 우 스
라 오 스	라 오 스
앞 으 로	앞 으 로
아 흐 레	아 흐 레
마 피 아	마 피 아
조 이 다	조 이 다
오 소 리	오 소 리
아 수 라	아 수 라
놓 이 다	놓 이 다
메 시 아	메 시 아
아 바 나	아 바 나
나 이 트	나 이 트
줄 기	줄 기
널 리	널 리
사 막	사 막
복 도	복 도
<<unk>> 다	<unk> 다
대 박	대 박
영 업	영 업
배 교	배 교
수 십	수 십
죄 다	죄 다
바 둑	바 둑
기 절	기 절
항 의	항 의
도 작	도 작
탄 로	탄 로
갈 비	갈 비
비 듬	비 듬
회 비	회 비
마 녀	마 녀
적 의	적 의
검 사	검 사
<<unk>> 다	<unk> 다
동 시	동 시
티 탄	티 탄
감 초	감 초
분 야	분 야
호 밀	호 밀
몰 다	몰 다
아 리 수	아 리 수
아 이 콘	아 이 콘
세 우 다	세 우 다
에 너 지	에 너 지
여 우 비	여 우 비
아 지 트	아 지 트
아 이 폰	아 이 폰
부 엉 이	부 엉 이
그 럼	그 럼
바 람	바 람
갈 고	갈 고
바 <<unk>>	바 <unk>
이 루 다	이 루 다
<<unk>> 후	<unk> 후
거 만	거 만
공 구	공 구
<<unk>> 다	<unk> 다
사 본	사 본
<<unk>> 다	<unk> 다
기 법	기 법
사 학	사 학
무 <<unk>>	무 <unk>
교 인	교 인
수 전	수 전
안 휘	안 휘
어 <<unk>> 게	어 <unk> 게
아 랍 어	아 랍 어
바 오 즈	바 오 즈
가 이 드	가 이 드
배 우 자	배 우 자
리 비 아	리 비 아
사 모 아	사 모 아
아 메 바	아 메 바
모 으 다	모 으 다
조 지 아	조 지 아
나 이 프	나 이 프
티 브 이	티 브 이
데 이 터	데 이 터
앙 이 다	앙 이 다
아 가 미	아 가 미
부 이 온	부 이 온
비 사 우	비 사 우
나 우 루	나 우 루
테 이 프	테 이 프
레 이 스	레 이 스
시 누 이	시 누 이
바 오 로	바 오 로
파 이 프	파 이 프
코 리 아	코 리 아
이 러 다	일 어 다
이 사 야	이 사 야
어 즈 버	어 즈 버
어 리 다	어 리 다
아 오 자 이	아 오 자 이
아 궁 이	아 궁 이
우 렁 이	우 렁 이
어 차 피	어 차 피
스 카 이	스 카 이
입 빠 이	입 빠 이
차 이 다	차 이 다
이 렇 다	이 렇 다
모 오 케	모 오 케
아 니 다	아 니 다
쓰 이 다	쓰 이 다
바 이 트	바 이 트
소 피 아	소 피 아
오 로 지	오 로 지
비 우 다	비 우 다
페 이 지	페 이 지
사 나 이	사 나 이
스 파 이	스 파 이
제 우 스	제 우 스
사 이 즈	사 이 즈
아 부 자	아 부 자
우 수 리	우 수 리
카 이 로	카 이 로
오 사 카	오 사 카
하 이 퍼	하 이 퍼
모 이 다	모 이 다
피 에 로	피 에 로
이 란 어	이 란 어
사 이 비	사 이 비
와 이 프	와 이 프
유 의 어	유 의 어
레 이 저	레 이 저
싸 우 다	싸 우 다
아 가 씨	아 가 씨
어 머 나	어 머 나
기 꺼 이	기 꺼 이
따 오 기	따 오 기
비 디 오	비 디 오
트 이 다	트 이 다
아 빠 트	아 빠 트
이 기 다	이 기 다
더 <<unk>> 이	더 <unk> 이
스 스 이	스 스 이
파 라 오	파 라 오
후 베 이	후 베 이
아 니 야	아 니 야
이 야 기	이 야 기
피 우 다	피 우 다
이 르 다	이 르 다
지 은 이	지 은 이
이 화 우	이 화 우
사 이 다	사 이 다
이 미 지	이 미 지
기 마 이	기 마 이
게 이 트	게 이 트
어 <<unk>> 다	어 <unk> 다
데 이 트	데 이 트
안 후 이	안 후 이
어 머 니	어 머 니
오 데 사	오 데 사
에 어 컨	에 어 컨
어 <<unk>> 다	어 <unk> 다
라 이 터	라 이 터
아 니 메	아 니 메
어 린 이	어 린 이
온 통	온 통
끼 우 다	끼 우 다
오 르 다	오 르 다
이 어 폰	이 어 폰
애 쓰 다	애 쓰 다
<<unk>> 우 다	<unk> 우 다
아 저 씨	아 저 씨
타 이 머	타 이 머
요 사 이	요 사 이
미 디 어	미 디 어
사 이 트	사 이 트
도 리 어	도 리 어
아 무 리	아 무 리
실 로	실 로
소 문	소 문
레 몬	레 몬
번 호	번 호
다 양	다 양
모 습	모 습
인 질	인 질
함 수	함 수
풍 미	풍 미
영 예	영 예
타 율	타 율
여 장	여 장
칼 라	칼 라
사 원	사 원
경 우	경 우
모 과	모 과
속 옷	속 옷
세 탁	세 탁
봉 지	봉 지
해 장	해 장
제 복	제 복
자 원	자 원
코 린	코 린
정 가	정 가
<<unk>> 다	<unk> 다
암 만	암 만
도 난	도 난
<<unk>> 치	<unk> 치
만 주	만 주
순 수	순 수
누 적	누 적
바 질	바 질
대 출	대 출
체 중	체 중
동 안	동 안
진 지	진 지
표 지	표 지
전 지	전 지
지 각	지 각
<<unk>> 시	<unk> 시
신 앙	신 앙
교 포	교 포
페 달	페 달
세 종	세 종
서 방	서 방
외 식	외 식
엔 진	엔 진
구 속	구 속
유 교	유 교
감 기	감 기
마 늘	마 늘
육 회	육 회
포 크	포 크
화 기	화 기
수 상	수 상
앙 숙	앙 숙
구 슬	구 슬
유 죄	유 죄
보 건	보 건
포 함	포 함
차 단	차 단
목 사	목 사
뛰 다	뛰 다
<<unk>> 다	<unk> 다
조 반	조 반
십 자	십 자
굴 다	굴 다
붕 소	붕 소
커 닝	커 닝
동 포	동 포
공 짜	공 짜
보 름	보 름
<<unk>> 다	<unk> 다
몰 타	몰 타
난 리	난 리
메 뉴	메 뉴
건 의	건 의
축 제	축 제
세 례	세 례
기 공	기 공
신 수	신 수
하 강	하 강
는 데	는 데
임 질	임 질
사 방	사 방
냉 기	냉 기
삼 바	삼 바
반 사	반 사
보 석	보 석
기 린	기 린
속 도	속 도
가 <<unk>>	가 <unk>
묘 사	묘 사
부 류	부 류
보 <<unk>>	보 <unk>
간 음	간 음
수 축	수 축
제 왕	제 왕
자 동	자 동
받 다	받 다
토 론	토 론
답 사	답 사
파 벌	파 벌
유 충	유 충
대 답	대 답
정 기	정 기
왕 자	왕 자
아 련	아 련
너 <<unk>>	너 <unk>
해 열	해 열
내 과	내 과
마 중	마 중
황 어	황 어
바 <<unk>>	바 <unk>
종 파	종 파
수 능	수 능
얼 른	얼 른
안 전	안 전
탐 구	탐 구
작 가	작 가
화 음	화 음
<<unk>> 다	<unk> 다
후 뇌	후 뇌
길 다	길 다
푸 <<unk>>	푸 <unk>
걸 인	걸 인
신 주	신 주
흑 체	흑 체
배 신	배 신
축 소	축 소
박 수	박 수
자 손	자 손
파 문	파 문
용 지	용 지
라 벨	라 벨
영 구	영 구
크 다	크 다
제 발	제 발
만 일	만 일
하 원	하 원
해 물	해 물
질 서	질 서
참 고	참 고
<<unk>> 리	<unk> 리
퇴 위	퇴 위
사 철	사 철
굴 레	굴 레
파 삭	파 삭
월 세	월 세
규 제	규 제
심 다	심 다
전 차	전 차
카 불	카 불
주 말	주 말
염 소	염 소
<<unk>> 다	<unk> 다
홍 수	홍 수
준 비	준 비
갈 기	갈 기
아 편	아 편
무 척	무 척
교 조	교 조
<<unk>> 다	<unk> 다
장 소	장 소
창 자	창 자
음 훈	음 훈
서 른	서 른
동 지	동 지
일 반	일 반
근 시	근 시
자 판	자 판
약 주	약 주
저 축	저 축
그 <<unk>>	그 <unk>
차 림	차 림
보 살	보 살
규 모	규 모
보 람	보 람
기 본	기 본
연 고	연 고
불 타	불 타
돌 드	돌 드
지 <<unk>>	지 <unk>
예 산	예 산
그 런	그 런
인 종	인 종
시 <<unk>>	시 <unk>
화 지	화 지
<<unk>> 다	<unk> 다
강 제	강 제
지 <<unk>>	지 <unk>
일 흔	일 흔
도 교	도 교
집 다	집 다
치 열	치 열
온 돌	온 돌
신 미	신 미
무 료	무 료
무 <<unk>>	무 <unk>
독 서	독 서
토 착	토 착
대 중	대 중
여 돌	여 돌
응 원	응 원
원 인	원 인
참 외	참 외
도 전	도 전
리 듬	리 듬
쇼 <<unk>>	쇼 <unk>
사 랑	사 랑
실 수	실 수
사 흘	사 흘
주 먹	주 먹
병 법	병 법
명 절	명 절
취 향	취 향
문 명	문 명
편 성	편 성
광 장	광 장
전 환	전 환
평 판	평 판
망 령	망 령
평 양	평 양
황 동	황 동
공 <<unk>>	공 <unk>
풍 경	풍 경
능 <<unk>>	능 <unk>
평 성	평 성
격 려	격 려
불 경	불 경
잡 년	잡 년
뇌 관	뇌 관
불 변	불 변
광 물	광 물
정 년	정 년
<<unk>> <<unk>>	<unk> <unk>
편 중	편 중
반 경	반 경
특 권	특 권
선 <<unk>>	선 <unk>
편 복	편 복
양 면	양 면
질 병	질 병
<<unk>> <<unk>>	<unk> <unk>
폐 <<unk>>	폐 <unk>
함 량	함 량
반 년	반 년
명 칭	명 칭
련 습	련 습
달 력	달 력
황 금	황 금
관 절	관 절
열 량	열 량
총 명	총 명
민 병	민 병
복 력	복 력
방 향	방 향
관 심	관 심
경 험	경 험
<<unk>> 밥	<unk> 밥
전 력	전 력
환 전	환 전
광 동	광 동
분 량	분 량
절 벽	절 벽
관 성	관 성
당 면	당 면
<<unk>> 불	<unk> 불
된 장	된 장
횡 적	횡 적
편 종	편 종
성 냥	성 냥
경 청	경 청
근 면	근 면
별 실	별 실
창 <<unk>>	창 <unk>
법 령	법 령
군 관	군 관
불 량	불 량
<<unk>> 별	<unk> 별
약 력	양 력
<<unk>> 른	<unk> 른
연 령	연 령
결 론	결 론
척 결	척 결
통 념	통 념
불 멸	불 멸
장 면	장 면
양 념	양 념
<<unk>> <<unk>>	<unk> <unk>
별 빛	별 빛
경 계	경 계
들 <<unk>>	들 <unk>
양 력	양 력
경 축	경 축
결 <<unk>>	결 <unk>
명 곡	명 곡
학 명	학 명
발 견	발 견
황 혼	황 혼
상 념	상 념
큰 일	큰 일
<<unk>> 진	<unk> 진
회 관	회 관
숙 명	숙 명
판 권	판 권
역 경	역 경
직 관	직 관
천 황	천 황
술 병	술 병
성 병	성 병
영 향	영 향
변 화	변 화
숭 <<unk>>	숭 <unk>
복 병	복 병
관 문	관 문
교 환	교 환
관 복	관 복
광 원	광 원
존 경	존 경
결 정	결 정
강 경	강 경
달 <<unk>>	달 <unk>
함 경	함 경
학 력	학 력
편 람	편 람
변 동	변 동
혼 혈	혼 혈
한 편	한 편
작 <<unk>>	작 <unk>
석 관	석 관
종 횡	종 횡
징 병	징 병
탈 환	탈 환
결 혼	결 혼
평 상	평 상
변 한	변 한
별 표	별 표
단 념	단 념
표 면	표 면
정 황	정 황
평 정	평 정
판 결	판 결
확 립	확 립
클 립	클 립
련 합	련 합
감 명	감 명
<<unk>> 결	<unk> 결
면 전	면 전
병 역	병 역
귀 환	귀 환
갈 륨	갈 륨
환 상	환 상
<<unk>> <<unk>>	<unk> <unk>
멸 망	멸 망
중 년	중 년
결 심	결 심
<<unk>> 살	<unk> 살
면 발	면 발
불 편	불 편
법 <<unk>>	법 <unk>
헬 륨	헬 륨
활 성	활 성
공 격	공 격
신 념	신 념
관 할	관 할
속 견	속 견
출 혈	출 혈
교 황	교 황
강 변	강 변
실 력	실 력
련 락	련 락
방 편	방 편
문 <<unk>>	문 <unk>
광 선	광 선
멸 종	멸 종
불 평	불 평
평 민	평 민
작 별	작 별
병 신	병 신
검 열	검 열
활 발	활 발
확 신	확 신
견 본	견 본
횡 단	횡 단
왕 관	왕 관
혼 령	혼 령
꽃 병	꽃 병
청 결	청 결
폭 력	폭 력
월 경	월 경
정 녕	정 녕
공 병	공 병
방 면	방 면
면 적	면 적
불 <<unk>>	불 <unk>
면 접	면 접
정 량	정 량
<<unk>> 돌	<unk> 돌
광 학	광 학
증 명	증 명
명 단	명 단
금 <<unk>>	금 <unk>
<<unk>> <<unk>>	<unk> <unk>
만 년	만 년
학 년	학 년
분 권	분 권
환 승	환 승
반 면	반 면
순 결	순 결
<<unk>> 면	<unk> 면
클 <<unk>>	클 <unk>
실 현	실 현
경 영	경 영
성 격	성 격
병 원	병 원
분 명	분 명
명 중	명 중
성 명	성 명
실 명	실 명
급 격	급 격
권 당	권 당
복 권	복 권
농 경	농 경
북 경	북 경
명 함	명 함
칼 륨	칼 륨
정 면	정 면
질 량	질 량
목 련	목 련
강 력	강 력
확 장	확 장
<<unk>> 출	<unk> 출
완 벽	완 벽
<<unk>> 변	<unk> 변
동 력	동 력
큰 물	큰 물
공 경	공 경
폐 경	폐 경
청 년	청 년
성 경	성 경
정 권	정 권
려 관	려 관
광 둥	광 둥
품 격	품 격
중 량	중 량
표 현	표 현
신 형	신 형
<<unk>> 손	<unk> 손
법 <<unk>>	법 <unk>
<<unk>> 병	<unk> 병
병 풍	병 풍
편 집	편 집
광 산	광 산
관 계	관 계
편 린	편 린
국 면	국 면
<<unk>> 면	<unk> 면
광 검	광 검
결 합	결 합
상 황	상 황
당 황	당 황
침 <<unk>>	침 <unk>
작 년	작 년
코 발 트	코 발 트
합 격	합 격
연 결	연 결
<<unk>> 영	<unk> 영
식 량	식 량
충 격	충 격
동 경	동 경
필 <<unk>>	필 <unk>
성 <<unk>>	성 <unk>
경 성	경 성
법 관	법 관
경 찰	경 찰
장 관	장 관
방 광	방 광
광 석	광 석
용 병	용 병
커 피 <<unk>>	커 피 <unk>
실 제 로	실 제 로
번 데 기	번 데 기
콜 호 스	콜 호 스
끄 집 다	끄 집 다
항 암 제	항 암 제
<<unk>> 바 인	<unk> 바 인
세 네 갈	세 네 갈
일 반 인	일 반 인
스 <<unk>> 지	스 <unk> 지
습 니 다	습 니 다
잠 그 다	잠 그 다
증 오 심	증 오 심
피 임 약	피 임 약
쇠 고 기	쇠 고 기
창 세 기	창 세 기
<<unk>> <<unk>> 이	<unk> <unk> 이
여 남 은	여 남 은
순 두 부	순 두 부
더 듬 다	더 듬 다
꽃 가 루	꽃 가 루
<<unk>> 보 다	<unk> 보 다
잠 자 코	잠 자 코
눈 웃 음	눈 웃 음
게 릴 라	게 릴 라
아 <<unk>> 다	아 <unk> 다
그 림 자	그 림 자
외 롭 다	외 롭 다
<<unk>> 시 터	<unk> 시 터
참 수 리	참 수 리
<<unk>> 테 인	<unk> 테 인
머 리 털	머 리 털
날 고 기	날 고 기
반 시 <<unk>>	반 시 <unk>
운 전 자	운 전 자
두 서 <<unk>>	두 서 <unk>
한 마 디	한 마 디
그 토 록	그 토 록
따 르 <<unk>>	따 르 <unk>
화 이 팅	화 이 팅
바 티 <<unk>>	바 티 <unk>
리 무 진	리 무 진
청 바 지	청 바 지
몽 타 주	몽 타 주
<<unk>> 하 다	<unk> 하 다
투 표 자	투 표 자
움 직 임	움 직 임
온 종 일	온 종 일
미 소 녀	미 소 녀
스 <<unk>> 시	스 <unk> 시
연 하 다	연 하 다
취 하 다	취 하 다
날 리 다	날 리 다
마 술 사	마 술 사
장 보 다	장 보 다
파 라 솔	파 라 솔
연 구 소	연 구 소
수 학 자	수 학 자
조 종 사	조 종 사
판 도 라	판 도 라
말 라 위	말 라 위
더 럽 다	더 럽 다
파 출 소	파 출 소
요 크 셔	요 크 셔
<<unk>> 네 임	<unk> 네 임
<<unk>> 거 웃	<unk> 거 웃
<<unk>> 페 인	<unk> 페 인
되 풀 이	되 풀 이
방 망 이	방 망 이
예 수 회	예 수 회
걸 치 다	걸 치 다
콜 라 보	콜 라 보
차 갑 다	차 갑 다
대 서 양	대 서 양
모 스 크	모 스 크
표 하 다	표 하 다
유 난 히	유 난 히
늘 리 다	늘 리 다
수 <<unk>> 다	수 <unk> 다
눈 송 이	눈 송 이
납 지 리	납 지 리
박 치 기	박 치 기
원 피 스	원 피 스
주 전 자	주 전 자
마 나 과	마 나 과
트 롤 리	트 롤 리
가 가 린	가 가 린
홍 어 회	홍 어 회
부 럽 다	부 럽 다
반 도 체	반 도 체
<<unk>> 나 무	<unk> 나 무
귀 하 다	귀 하 다
음 모 론	음 모 론
존 엄 사	존 엄 사
중 고 기	중 고 기
슬 리 퍼	슬 리 퍼
부 <<unk>> 디	부 <unk> 디
<<unk>> 없 다	<unk> 없 다
칼 리 파	칼 리 파
안 락 사	안 락 사
노 파 심	노 파 심
묵 은 지	묵 은 지
서 양 인	서 양 인
노 동 자	노 동 자
<<unk>> 자 리	<unk> 자 리
거 문 고	거 문 고
적 응 도	적 응 도
나 일 론	나 일 론
나 치 즘	나 치 즘
헤 드 폰	헤 드 폰
만 지 다	만 지 다
동 사 리	동 사 리
모 르 핀	모 르 핀
후 계 자	후 계 자
네 모 꼴	네 모 꼴
일 각 수	일 각 수
참 붕 어	참 붕 어
국 경	국 경
치 료 제	치 료 제
불 사 조	불 사 조
사 진 사	사 진 사
노 른 자	노 른 자
스 럽 다	스 럽 다
<<unk>> 네 일	<unk> 네 일
소 방 차	소 방 차
철 부 지	철 부 지
뿌 서 석	뿌 서 석
튀 기 다	튀 기 다
<<unk>> 추 다	<unk> 추 다
밀 치 다	밀 치 다
서 럽 다	서 럽 다
밥 벌 이	밥 벌 이
<<unk>> 자 루	<unk> 자 루
납 세 자	납 세 자
칼 로 리	칼 로 리
유 제 품	유 제 품
다 정 히	다 정 히
음 역 자	음 역 자
달 리 다	달 리 다
의 문 사	의 문 사
부 티 크	부 티 크
복 음 서	복 음 서
<<unk>> 머 리	<unk> 머 리
가 시 화	가 시 화
발 명	발 명
계 <<unk>>	계 <unk>
확 산	확 산
남 편	남 편
교 량	교 량
연 <<unk>>	연 <unk>
대 부 분	대 부 분
신 기 루	신 기 루
지 난 주	지 난 주
마 구 간	마 구 간
애 국 심	애 국 심
떡 <<unk>> 이	떡 <unk> 이
채 소 <<unk>>	채 소 <unk>
잠 자 다	잠 자 다
증 조 부	증 조 부
성 별	성 별
머 물 다	머 물 다
고 릴 라	고 릴 라
발 코 니	발 코 니
페 닐 기	페 닐 기
접 미 사	접 미 사
흘 리 다	흘 리 다
가 르 침	가 르 침
뒷 간	뒷 간
집 결	집 결
평 화	평 화
답 변	답 변
돌 격	돌 격
회 령	회 령
손 <<unk>>	손 <unk>
관 찰	관 찰
습 격	습 격
영 광	영 광
활 용	활 용
명 동	명 동
결 함	결 함
만 <<unk>>	만 <unk>
활 동	활 동
논 평	논 평
콜 카 타	콜 카 타
소 독 제	소 독 제
결 장	결 장
능 력	능 력
벽 장	벽 장
중 경	중 경
클 럽	클 럽
불 황	불 황
환 불	환 불
<<unk>> <<unk>>	<unk> <unk>
평 창	평 창
<<unk>> 립	<unk> 립
탈 륨	탈 륨
송 편	송 편
명 성	명 성
공 황	공 황
병 합	병 합
허 물 다	허 물 다
뒤 지 다	뒤 지 다
<<unk>> 놀 이	<unk> 놀 이
타 나 크	타 나 크
선 지 자	선 지 자
지 원 자	지 원 자
주 인 공	주 인 공
꼬 르 륵	꼬 르 륵
전 도 서	전 도 서
친 일 파	친 일 파
내 밀 다	내 밀 다
흔 하 다	흔 하 다
<<unk>> 도 그	<unk> 도 그
무 언 증	무 언 증
제 기 <<unk>>	제 기 <unk>
일 본 주	일 본 주
곰 <<unk>> 이	곰 <unk> 이
안 되 다	안 되 다
호 르 몬	호 르 몬
건 지 다	건 지 다
플 루 트	플 루 트
니 트 릴	니 트 릴
간 간 이	간 간 이
겨 누 다	겨 누 다
<<unk>> 장 어	<unk> 장 어
머 리 칼	머 리 칼
대 보 름	대 보 름
제 주 말	제 주 말
<<unk>> 추 다	<unk> 추 다
대 규 모	대 규 모
수 화 기	수 화 기
노 선 도	노 선 도
지 하 철	지 하 철
연 구 자	연 구 자
계 시 다	계 시 다
수 도 원	수 도 원
남 서 부	남 서 부
놀 이 감	놀 이 감
체 온 계	체 온 계
양 다 리	양 다 리
말 하 다	말 하 다
호 <<unk>> 가	호 <unk> 가
흡 수 지	흡 수 지
<<unk>> 꼬 리	<unk> 꼬 리
꾸 르 륵	꾸 르 륵
<<unk>> 바 로	<unk> 바 로
함 부 로	함 부 로
<<unk>> 기 다	<unk> 기 다
갑 자 기	갑 자 기
서 귀 포	서 귀 포
울 버 린	울 버 린
대 단 히	대 단 히
강 하 다	강 하 다
스 케 줄	스 케 줄
쪽 발 이	쪽 발 이
대 여 섯	대 여 섯
수 사 학	수 사 학
영 도 자	영 도 자
틀 리 다	틀 리 다
좌 익 수	좌 익 수
전 라 도	전 라 도
귀 걸 이	귀 걸 이
걸 리 다	걸 리 다
만 나 기	만 나 기
붕 어 빵	붕 어 빵
다 듬 다	다 듬 다
소 비 자	소 비 자
고 구 마	고 구 마
바 수 다	바 수 다
게 임 기	게 임 기
라 이 플	라 이 플
대 자 보	대 자 보
저 고 리	저 고 리
오 트 밀	오 트 밀
구 기 자	구 기 자
카 세 트	카 세 트
제 주 도	제 주 도
우 주 선	우 주 선
벨 기 에	벨 기 에
다 니 다	다 니 다
고 사 리	고 사 리
기 울 다	기 울 다
메 토 끼	메 토 끼
니 제 르	니 제 르
제 주 시	제 주 시
트 로 피	트 로 피
마 나 마	마 나 마
소 나 타	소 나 타
파 스 타	파 스 타
위 안 부	위 안 부
너 무 나	너 무 나
느 리 다	느 리 다
고 마 워	고 마 워
여 <<unk>> 다	여 <unk> 다
그 르 다	그 르 다
초 음 파	초 음 파
세 미 나	세 미 나
울 리 다	울 리 다
못 하 다	못 하 다
야 자 수	야 자 수
사 업 차	사 업 차
토 스 트	토 스 트
제 스 처	제 스 처
사 업 주	사 업 주
케 이 블	케 이 블
라 고 스	라 고 스
카 지 노	카 지 노
부 조 리	부 조 리
아 <<unk>> 싸	아 <unk> 싸
이 라 크	이 라 크
치 르 다	치 르 다
소 고 기	소 고 기
바 레 인	바 레 인
신 시 아	신 시 아
바 구 니	바 구 니
해 파 리	해 파 리
수 도 사	수 도 사
하 이 난	하 이 난
꾸 리 다	꾸 리 다
주 꾸 미	주 꾸 미
저 수 지	저 수 지
가 숭 어	가 숭 어
버 버 리	버 버 리
베 이 징	베 이 징
수 식 어	수 식 어
스 카 프	스 카 프
수 요 일	수 요 일
업 동 이	업 동 이
어 <<unk>> 다	어 <unk> 다
보 다 도	보 다 도
주 사 기	주 사 기
라 바 트	라 바 트
로 씨 야	로 씨 야
소 유 자	소 유 자
스 피 커	스 피 커
지 렁 이	지 렁 이
코 요 테	코 요 테
무 디 다	무 디 다
무 쿠 리	무 쿠 리
화 이 자	화 이 자
다 르 다	다 르 다
사 투 리	사 투 리
더 듬 이	더 듬 이
앙 카 라	앙 카 라
우 연 히	우 연 히
모 조 리	모 조 리
부 르 다	부 르 다
표 제 어	표 제 어
토 요 일	토 요 일
카 운 터	카 운 터
지 도 자	지 도 자
제 노 바	제 노 바
사 무 소	사 무 소
시 부 모	시 부 모
메 서 드	메 서 드
아 야 <<unk>>	아 야 <unk>
케 이 크	케 이 크
우 리 집	우 리 집
외 치 다	외 치 다
가 두 리	가 두 리
까 히 라	까 히 라
모 서 리	모 서 리
이 사 회	이 사 회
노 리 다	놀 이 다
우 체 국	우 체 국
메 가 나	메 가 나
테 레 비	테 레 비
두 루 미	두 루 미
비 로 소	비 로 소
가 라 데	가 라 데
언 어 학	언 어 학
가 <<unk>> 다	가 <unk> 다
구 렁 이	구 렁 이
언 제 나	언 제 나
은 하 수	은 하 수
도 자 기	도 자 기
예 언 자	예 언 자
지 구 의	지 구 의
<<unk>> 어 미	<unk> 어 미
한 자 어	한 자 어
마 이 크	마 이 크
파 트 너	파 트 너
아 <<unk>> 움	아 <unk> 움
미 스 터	미 스 터
기 업 인	기 업 인
놀 이 터	놀 이 터
바 이 <<unk>>	바 이 <unk>
나 <<unk>> 다	나 <unk> 다
도 가 니	도 가 니
서 커 스	서 커 스
커 지 다	커 지 다
자 시 다	자 시 다
흐 르 다	흐 르 다
와 타 시	와 타 시
사 하 라	사 하 라
가 시 나	가 시 나
반 의 어	반 의 어
무 기 고	무 기 고
다 투 다	다 투 다
파 고 다	파 고 다
마 이 웨 이	마 이 웨 이
절 이 다	절 이 다
와 이 파 이	와 이 파 이
러 시 아 어	러 시 아 어
이 디 시 어	이 디 시 어
다 이 오 드	다 이 오 드
어 린 아 이	어 린 아 이
카 우 보 이	카 우 보 이
아 즈 바 이	아 즈 바 이
조 지 아 어	조 지 아 어
우 아 하 다	우 아 하 다
아 마 추 어	아 마 추 어
하 이 에 나	하 이 에 나
여 자 아 이	여 자 아 이
그 렇 지	그 렇 지
오 아 시 스	오 아 시 스
이 어 지 다	이 어 지 다
디 엔 에 이	디 엔 에 이
다 이 어 트	다 이 어 트
아 라 비 아	아 라 비 아
오 토 바 이	오 토 바 이
타 이 페 이	타 이 페 이
타 이 베 이	타 이 베 이
외 계 어	외 계 어
내 주 다	내 주 다
보 드 카	보 드 카
비 추 다	비 추 다
아 체 쥐	아 체 쥐
자 세 히	자 세 히
올 리 브	올 리 브
조 롱 이	조 롱 이
도 도 마	도 도 마
게 다 가	게 다 가
두 꺼 비	두 꺼 비
헤 르 츠	헤 르 츠
마 무 리	마 무 리
우 울 증	우 울 증
카 라 치	카 라 치
고 라 니	고 라 니
기 모 노	기 모 노
자 라 다	자 라 다
신 조 어	신 조 어
모 나 코	모 나 코
<<unk>> 히 다	<unk> 히 다
의 성 어	의 성 어
가 지 다	가 지 다
보 고 서	보 고 서
소 나 무	소 나 무
외 국 어	외 국 어
제 조 업	제 조 업
우 리 말	우 리 말
파 자 마	파 자 마
거 뜨 다	거 뜨 다
그 리 움	그 리 움
스 페 인	스 페 인
허 리 <<unk>>	허 리 <unk>
어 딘 가	어 딘 가
카 메 라	카 메 라
수 시 로	수 시 로
머 구 리	머 구 리
마 스 다	마 스 다
스 도 쿠	스 도 쿠
바 르 다	바 르 다
무 인 도	무 인 도
라 운 지	라 운 지
나 머 지	나 머 지
하 시 다	하 시 다
봉 우 리	봉 우 리
이 기 적	이 기 적
노 네 인	노 네 인
브 러 시	브 러 시
마 음 씨	마 음 씨
예 니 레	예 니 레
카 르 마	카 르 마
여 드 레	여 드 레
토 바 고	토 바 고
마 르 스	마 르 스
그 러 나	그 러 나
이 교 도	이 교 도
티 베 트	티 베 트
거 세 다	거 세 다
청 동	청 동
망 둑	망 둑
활 기	활 기
회 장	회 장
노 년	노 년
실 장	실 장
손 녀	손 녀
명 예	명 예
짐 승	짐 승
반 절	반 절
풀 발	풀 발
산 전	산 전
<<unk>> 박	<unk> 박
<<unk>> 물	<unk> 물
괴 담	괴 담
살 롱	살 롱
원 족	원 족
<<unk>> 호	<unk> 호
동 창	동 창
박 쥐	박 쥐
평 소	평 소
연 필	연 필
철 판	철 판
사 냥	사 냥
폭 동	폭 동
특 정	특 정
성 질	성 질
등 불	등 불
뇌 물	뇌 물
<<unk>> 짝	<unk> 짝
관 세	관 세
반 장	반 장
학 원	학 원
산 골	산 골
교 통	교 통
인 형	인 형
험 담	험 담
신 규	신 규
원 망	원 망
당 근	당 근
황 제	황 제
회 귀	회 귀
법 정	법 정
<<unk>> 션	<unk> 션
<<unk>> 벌	<unk> 벌
튀 김	튀 김
등 등	등 등
원 본	원 본
특 징	특 징
철 <<unk>>	철 <unk>
귀 양	귀 양
연 근	연 근
농 장	농 장
폐 단	폐 단
칼 날	칼 날
밥 <<unk>>	밥 <unk>
며 칠	며 칠
보 관	보 관
박 동	박 동
복 습	복 습
절 감	절 감
원 료	원 료
남 방	남 방
종 합	종 합
속 속	속 속
학 술	학 술
회 담	회 담
소 령	소 령
등 심	등 심
헬 <<unk>>	헬 <unk>
별 도	별 도
교 정	교 정
감 염	감 염
중 계	중 계
계 <<unk>>	계 <unk>
본 질	본 질
장 석	장 석
혼 합	혼 합
뉴 욕	뉴 욕
잔 돈	잔 돈
끔 벅	끔 벅
<<unk>> 금	<unk> 금
딩 딩	딩 딩
젖 통	젖 통
왕 국	왕 국
원 산	원 산
회 교	회 교
점 심	점 심
해 변	해 변
규 칙	규 칙
받 침	받 침
수 력	수 력
남 측	남 측
설 산	설 산
유 형	유 형
신 랑	신 랑
변 비	변 비
민 간	민 간
말 뚝	말 뚝
목 발	목 발
성 분	성 분
독 신	독 신
목 욕	목 욕
설 문	설 문
설 설	설 설
최 종	최 종
일 견	일 견
반 발	반 발
열 등	열 등
불 빛	불 빛
용 과	용 과
간 혹	간 혹
<<unk>> 짝	<unk> 짝
장 작	장 작
전 <<unk>>	전 <unk>
갈 망	갈 망
찰 <<unk>>	찰 <unk>
과 욕	과 욕
동 산	동 산
빈 곤	빈 곤
수 병	수 병
냉 전	냉 전
동 물	동 물
압 력	압 력
횡 파	횡 파
철 학	철 학
황 후	황 후
편 도	편 도
공 학	공 학
홍 역	홍 역
불 꽃	불 꽃
<<unk>> 꾼	<unk> 꾼
통 근	통 근
살 살	살 살
경 악	경 악
국 적	국 적
계 통	계 통
동 양	동 양
원 석	원 석
탈 린	탈 린
알 현	알 현
흔 적	흔 적
결 코	결 코
종 식	종 식
당 국	당 국
팔 딱	팔 딱
괴 물	괴 물
폭 탄	폭 탄
걸 신	걸 신
청 탁	청 탁
교 실	교 실
그 냥	그 냥
면 세	면 세
선 원	선 원
수 <<unk>>	수 <unk>
성 당	성 당
한 물	한 물
타 협	타 협
링 크	링 크
성 찬	성 찬
한 성	한 성
<<unk>> 법	<unk> 법
폐 급	폐 급
식 물	식 물
<<unk>> 게	<unk> 게
유 명	유 명
경 외	경 외
꿈 쩍	꿈 쩍
목 적	목 적
몸 살	몸 살
공 동	공 동
농 촌	농 촌
연 습	연 습
설 탕	설 탕
친 척	친 척
연 방	연 방
벌 <<unk>>	벌 <unk>
국 산	국 산
류 월	류 월
연 말	연 말
천 만	천 만
콜 론	콜 론
신 선	신 선
단 순	단 순
산 불	산 불
전 통	전 통
무 명	무 명
<<unk>> 갈	<unk> 갈
노 병	노 병
목 젖	목 젖
평 온	평 온
감 탄	감 탄
중 화	중 화
작 전	작 전
금 방	금 방
쇠 풀	쇠 풀
<<unk>> 잘	<unk> 잘
성 과	성 과
산 술	산 술
말 벌	말 벌
중 문	중 문
분 필	분 필
전 장	전 장
봉 급	봉 급
건 답	건 답
충 칭	충 칭
월 남	월 남
강 정	강 정
설 날	설 날
연 설	연 설
불 닭	불 닭
회 전	회 전
석 류	석 류
유 령	유 령
충 성	충 성
근 교	근 교
<<unk>> 계	<unk> 계
성 함	성 함
<<unk>> 덕	<unk> 덕
양 국	양 국
폭 풍	폭 풍
정 월	정 월
권 세	권 세
합 금	합 금
축 척	축 척
앞 면	앞 면
중 심	중 심
촌 <<unk>>	촌 <unk>
가 명	가 명
봉 건	봉 건
손 님	손 님
접 골	접 골
양 식	양 식
빈 <<unk>>	빈 <unk>
몬 순	몬 순
순 례	순 례
장 교	장 교
입 력	입 력
소 년	소 년
국 영	국 영
혼 돈	혼 돈
총 화	총 화
<<unk>> 떡	<unk> 떡
로 <<unk>>	로 <unk>
자 격	자 격
풍 속	풍 속
불 쌍	불 쌍
난 민	난 민
견 유	견 유
감 정	감 정
<<unk>> 집	<unk> 집
연 감	연 감
임 명	임 명
권 고	권 고
발 <<unk>>	발 <unk>
중 독	중 독
집 쥐	집 쥐
분 말	분 말
문 방	문 방
귀 신	귀 신
사 향	사 향
명 인	명 인
벼 락	벼 락
소 멸	소 멸
양 반	양 반
팔 목	팔 목
민 감	민 감
신 분	신 분
출 금	출 금
열 쇠	열 쇠
가 면	가 면
반 려	반 려
복 싱	복 싱
반 박	반 박
독 물	독 물
녀 석	녀 석
접 전	접 전
갑 판	갑 판
한 복	한 복
공 식	공 식
정 신	정 신
실 정	실 정
좌 표	좌 표
등 산	등 산
순 간	순 간
목 전	목 전
습 득	습 득
크 <<unk>>	크 <unk>
짐 작	짐 작
적 용	적 용
적 극	적 극
불 화	불 화
깜 짝	깜 짝
궁 <<unk>>	궁 <unk>
공 원	공 원
취 급	취 급
냉 동	냉 동
신 청	신 청
벨 <<unk>>	벨 <unk>
<<unk>> 질	<unk> 질
관 사	관 사
지 협	지 협
중 죄	중 죄
군 복	군 복
경 시	경 시
점 점	점 점
교 역	교 역
참 회	참 회
삼 림	삼 림
출 신	출 신
등 급	등 급
굴 뚝	굴 뚝
깜 <<unk>>	깜 <unk>
모 형	모 형
독 점	독 점
급 습	급 습
연 적	연 적
계 급	계 급
콜 록	콜 록
법 원	법 원
문 <<unk>>	문 <unk>
피 <<unk>>	피 <unk>
전 문	전 문
핀 <<unk>>	핀 <unk>
신 성	신 성
빈 <<unk>>	빈 <unk>
벽 자	벽 자
진 단	진 단
적 군	적 군
제 명	제 명
침 범	침 범
서 명	서 명
남 녀	남 녀
편 자	편 자
학 문	학 문
남 성	남 성
난 간	난 간
<<unk>> 신	<unk> 신
심 성	심 성
발 열	발 열
감 당	감 당
회 랑	회 랑
합 작	합 작
동 료	동 료
탈 락	탈 락
유 년	유 년
남 벌	남 벌
전 함	전 함
계 간	계 간
국 물	국 물
인 격	인 격
건 설	건 설
정 글	정 글
돌 <<unk>>	돌 <unk>
대 <<unk>>	대 <unk>
왕 성	왕 성
과 립	과 립
빨 강	빨 강
발 <<unk>>	발 <unk>
양 복	양 복
곡 식	곡 식
선 율	선 율
상 상	상 상
변 기	변 기
볼 링	볼 링
마 련	마 련
출 석	출 석
건 강	건 강
금 연	금 연
여 권	여 권
꼼 짝	꼼 짝
대 <<unk>>	대 <unk>
곤 란	곤 란
편 지	편 지
포 인 트	포 인 트
아 무 런	아 무 런
카 이 만	카 이 만
올 리 고	올 리 고
그 리 다	그 리 다
라 파 스	라 파 스
<<unk>> 지 다	<unk> 지 다
구 라 파	구 라 파
고 르 다	고 르 다
마 푸 토	마 푸 토
쓰 레 기	쓰 레 기
그 다 지	그 다 지
아 마 존	아 마 존
코 로 나	코 로 나
오 사 존	오 사 존
기 러 기	기 러 기
아 버 님	아 버 님
조 가 비	조 가 비
하 <<unk>> 다	하 <unk> 다
포 스 터	포 스 터
서 비 스	서 비 스
요 즈 음	요 즈 음
메 <<unk>> 기	메 <unk> 기
야 하 다	야 하 다
미 루 다	미 루 다
메 모 리	메 모 리
가 제 따	가 제 따
루 사 카	루 사 카
아 라 한	아 라 한
파 나 마	파 나 마
타 밀 어	타 밀 어
느 끼 다	느 끼 다
애 국 자	애 국 자
사 쿠 라	사 쿠 라
스 커 트	스 커 트
지 치 다	지 치 다
파 파 야	파 파 야
세 상 에	세 상 에
음 악 가	음 악 가
먹 이 다	먹 이 다
고 모 부	고 모 부
몰 타 어	몰 타 어
부 러 움	부 러 움
어 름 치	어 름 치
약 하 다	약 하 다
야 쿠 자	야 쿠 자
대 리 인	대 리 인
구 치 소	구 치 소
덩 어 리	덩 어 리
다 치 다	다 치 다
스 르 르	스 르 르
시 치 미	시 치 미
서 서 히	서 서 히
게 으 름	게 으 름
구 더 기	구 더 기
일 하 다	일 하 다
리 야 드	리 야 드
무 서 움	무 서 움
비 하 다	비 하 다
도 입 부	도 입 부
테 이 블	테 이 블
이 집 트	이 집 트
노 <<unk>> 다	노 <unk> 다
찌 르 다	찌 르 다
디 자 인	디 자 인
티 오 <<unk>>	티 오 <unk>
옥 수 수	옥 수 수
바 이 블	바 이 블
동 아 리	동 아 리
<<unk>> 덩 이	<unk> 덩 이
알 리 고	알 리 고
지 니 다	지 니 다
북 한 어	북 한 어
아 몬 드	아 몬 드
개 나 리	개 나 리
두 더 지	두 더 지
착 하 다	착 하 다
네 거 리	네 거 리
사 하 다	사 하 다
마 흐 디	마 흐 디
너 머 로	너 머 로
강 아 지	강 아 지
들 이 다	들 이 다
디 스 코	디 스 코
비 엔 나	비 엔 나
미 치 다	미 치 다
일 <<unk>> 이	일 <unk> 이
외 아 들	외 아 들
지 하 드	지 하 드
가 리 다	가 리 다
두 서 너	두 서 너
<<unk>> 하 다	<unk> 하 다
미 카 엘	미 카 엘
고 스 트	고 스 트
앞 서 다	앞 서 다
호 랑 이	호 랑 이
프 라 하	프 라 하
뿌 <<unk>> 다	뿌 <unk> 다
하 수 도	하 수 도
로 그 인	로 그 인
브 로 치	브 로 치
유 아 원	유 아 원
티 아 졸	티 아 졸
꾸 러 미	꾸 러 미
코 카 인	코 카 인
앞 다 리	앞 다 리
칭 하 이	칭 하 이
무 언 가	무 언 가
음 악 학	음 악 학
<<unk>> 이 다	<unk> 이 다
그 리 고	그 리 고
어 휘 소	어 휘 소
보 고 타	보 고 타
코 소 보	코 소 보
어 금 니	어 금 니
레 소 토	레 소 토
속 이 다	속 이 다
코 브 라	코 브 라
유 리 기	유 리 기
알 제 리	알 제 리
시 스 터	시 스 터
어 머 님	어 머 님
엘 리 트	엘 리 트
코 미 디	코 미 디
나 가 다	나 가 다
푸 르 다	푸 르 다
시 드 니	시 드 니
고 양 이	고 양 이
보 너 스	보 너 스
수 포 자	수 포 자
가 운 데	가 운 데
수 의 사	수 의 사
사 거 리	사 거 리
오 렌 지	오 렌 지
스 트 로	스 트 로
<<unk>> 아 비	<unk> 아 비
도 저 히	도 저 히
스 스 로	스 스 로
가 리 비	가 리 비
어 려 움	어 려 움
모 로 코	모 로 코
가 로 다	가 로 다
헤 로 인	헤 로 인
에 티 켓	에 티 켓
마 사 지	마 사 지
초 하 루	초 하 루
마 누 라	마 누 라
끼 치 다	끼 치 다
리 포 트	리 포 트
일 주 일	일 주 일
까 <<unk>> 다	까 <unk> 다
바 라 다	바 라 다
<<unk>> 이 다	<unk> 이 다
미 나 리	미 나 리
거 시 기	거 시 기
치 와 와	치 와 와
잠 비 아	잠 비 아
상 하 이	상 하 이
이 <<unk>> 다	이 <unk> 다
세 입 자	세 입 자
다 다 미	다 다 미
얼 리 다	얼 리 다
베 드 로	베 드 로
바 하 마	바 하 마
고 등 어	고 등 어
그 다 음	그 다 음
고 아 원	고 아 원
더 하 기	더 하 기
스 타 일	스 타 일
지 하 도	지 하 도
라 <<unk>> 이	라 <unk> 이
지 <<unk>> 이	지 <unk> 이
고 사 포	고 사 포
코 끼 리	코 끼 리
파 인 더	파 인 더
일 본 어	일 본 어
소 시 지	소 시 지
그 저 께	그 저 께
브 라 더	브 라 더
뿌 리 다	뿌 리 다
노 르 마	노 르 마
온 라 인	온 라 인
기 <<unk>> 다	기 <unk> 다
탁 아 소	탁 아 소
고 사 기	고 사 기
브 로 커	브 로 커
비 기 다	비 기 다
거 머 리	거 머 리
스 웨 터	스 웨 터
로 보 트	로 보 트
피 하 다	피 하 다
베 <<unk>> 이	베 <unk> 이
그 라 프	그 라 프
꺼 리 다	꺼 리 다
나 누 다	나 누 다
스 포 츠	스 포 츠
이 용 자	이 용 자
티 라 나	티 라 나
이 발 사	이 발 사
지 나 다	지 나 다
마 시 다	마 시 다
코 알 라	코 알 라
팔 라 우	팔 라 우
케 바 케	케 바 케
사 이 렌	사 이 렌
도 메 인	도 메 인
와 사 비	와 사 비
일 부 러	일 부 러
타 이 틀	타 이 틀
디 저 트	디 저 트
일 요 일	일 요 일
버 리 다	버 리 다
구 미 호	구 미 호
조 부 모	조 부 모
테 스 트	테 스 트
지 게 미	지 게 미
우 리 들	우 리 들
독 일 어	독 일 어
머 시 마	머 시 마
바 이 <<unk>>	바 이 <unk>
보 따 리	보 따 리
파 운 드	파 운 드
또 다 시	또 다 시
인 하 다	인 하 다
그 렇 게	그 렇 게
나 서 다	나 서 다
개 고 기	개 고 기
앙 케 트	앙 케 트
아 리 랑	아 리 랑
우 롱 차	우 롱 차
네 피 도	네 피 도
요 하 다	요 하 다
기 수 사	기 수 사
트 로 트	트 로 트
평 가	평 가
알 리 다	알 리 다
<<unk>> 도 우	<unk> 도 우
다 <<unk>> 다	다 <unk> 다
따 라 서	따 라 서
베 이 컨	베 이 컨
회 합	회 합
승 진	승 진
창 턱	창 턱
빌 딩	빌 딩
<<unk>> 뒤	<unk> 뒤
물 건	물 건
적 어 도	적 어 도
동 쪽	동 쪽
정 욕	정 욕
혼 약	혼 약
골 반	골 반
<<unk>> 발	<unk> 발
반 영	반 영
열 반	열 반
술 독	술 독
황 도	황 도
남 한	남 한
잘 못	잘 못
머 리 <<unk>>	머 리 <unk>
<<unk>> 리 다	<unk> 리 다
비 구 니	비 구 니
알 거 지	알 거 지
스 모 그	스 모 그
스 위 치	스 위 치
그 치 다	그 치 다
짜 하 다	짜 하 다
버 러 지	버 러 지
구 입 처	구 입 처
바 마 코	바 마 코
소 나 기	소 나 기
포 도 주	포 도 주
외 야 수	외 야 수
조 선 어	조 선 어
아 스 <<unk>>	아 스 <unk>
대 체 로	대 체 로
오 히 려	오 히 려
이 웃 집	이 웃 집
미 사 일	미 사 일
옥 테 인	옥 테 인
이 벤 트	이 벤 트
무 치 다	무 치 다
주 머 니	주 머 니
보 일 러	보 일 러
대 기 업	대 기 업
안 도 라	안 도 라
거 북 이	거 북 이
여 기 다	여 기 다
저 렇 게	저 렇 게
티 셔 츠	티 셔 츠
이 발 소	이 발 소
<<unk>> 가 리	<unk> 가 리
우 습 다	우 습 다
<<unk>> 바 이	<unk> 바 이
<<unk>> 타 이	<unk> 타 이
허 브 티	허 브 티
유 르 트	유 르 트
동 의 어	동 의 어
차 라 리	차 라 리
모 시 다	모 시 다
그 러 다	그 러 다
토 스 터	토 스 터
스 티 커	스 티 커
두 르 다	두 르 다
사 파 리	사 파 리
가 지 고	가 지 고
기 르 다	기 르 다
다 지 다	다 지 다
제 트 기	제 트 기
모 <<unk>> 이	모 <unk> 이
바 <<unk>> 다	바 <unk> 다
따 르 다	따 르 다
우 간 다	우 간 다
호 주 인	호 주 인
도 다 리	도 다 리
줄 이 다	줄 이 다
누 르 다	누 르 다
아 크 라	아 크 라
웃 기 다	웃 기 다
시 리 다	시 리 다
가 시 다	가 시 다
네 바 다	네 바 다
메 소 드	메 소 드
고 프 다	고 프 다
주 유 소	주 유 소
스 위 스	스 위 스
노 여 움	노 여 움
스 쿠 터	스 쿠 터
울 리 짜	울 리 짜
구 덩 이	구 덩 이
찌 꺼 기	찌 꺼 기
기 업 가	기 업 가
더 하 다	더 하 다
디 디 다	디 디 다
따 지 다	따 지 다
<<unk>> 이 다	<unk> 이 다
<<unk>> 운 아	<unk> 운 아
버 티 다	버 티 다
마 르 코	마 르 코
올 리 다	올 리 다
거 리 다	거 리 다
카 타 르	카 타 르
베 니 스	베 니 스
급 하 다	급 하 다
이 롭 다	이 롭 다
쿠 데 타	쿠 데 타
<<unk>> 어 리	<unk> 어 리
사 르 르	사 르 르
무 르 다	무 르 다
미 지 수	미 지 수
다 리 미	다 리 미
스 토 브	스 토 브
옷 걸 이	옷 걸 이
사 업 가	사 업 가
미 주 알	미 주 알
<<unk>> 그 제	<unk> 그 제
알 까 기	알 까 기
다 루 다	다 루 다
야 마 토	야 마 토
부 리 다	부 리 다
시 카 고	시 카 고
<<unk>> 시 다	<unk> 시 다
내 야 수	내 야 수
라 이 벌	라 이 벌
규 정	규 정
바 게 트	바 게 트
꺼 지 다	꺼 지 다
나 나 니	나 나 니
사 다 리	사 다 리
항 아 리	항 아 리
<<unk>> 이 다	<unk> 이 다
후 보 자	후 보 자
더 불 어	더 불 어
페 스 트	페 스 트
얼 마 나	얼 마 나
통 역 사	통 역 사
다 문 화	다 문 화
니 호 늄	니 호 늄
참 모 장	참 모 장
북 <<unk>> 다	북 <unk> 다
장 모 님	장 모 님
불 야 성	불 야 성
풍 자 문	풍 자 문
자 존 감	자 존 감
턱 수 염	턱 수 염
말 다 <<unk>>	말 다 <unk>
트 렁 크	트 렁 크
광 동 어	광 동 어
사 할 린	사 할 린
한 라 산	한 라 산
칼 바 람	칼 바 람
쌀 국 수	쌀 국 수
쌍 꺼 풀	쌍 꺼 풀
당 중 앙	당 중 앙
휘 파 람	휘 파 람
사 립 문	사 립 문
신 호 등	신 호 등
발 가 락	발 가 락
굴 곡 위	굴 곡 위
경 보 기	경 보 기
사 진 술	사 진 술
<<unk>> 리 학	<unk> 리 학
구 성 원	구 성 원
천 자 문	천 자 문
정 상 치	정 상 치
완 전 히	완 전 히
작 곡 가	작 곡 가
대 합 실	대 합 실
조 금 <<unk>>	조 금 <unk>
추 밀 원	추 밀 원
해 왕 성	해 왕 성
<<unk>> 리 컨	<unk> 리 컨
멜 버 른	멜 버 른
맞 흥 정	맞 흥 정
의 형 제	의 형 제
젖 <<unk>> 지	젖 <unk> 지
열 심 히	열 심 히
<<unk>> 얼 굴	<unk> 얼 굴
기 념 일	기 념 일
호 지 명	호 지 명
외 삼 촌	외 삼 촌
콩 자 반	콩 자 반
같 <<unk>> 다	같 <unk> 다
화 장 지	화 장 지
<<unk>> 바 람	<unk> 바 람
참 되 다	참 되 다
가 끔 <<unk>>	가 끔 <unk>
대 동 강	대 동 강
빌 뉴 스	빌 뉴 스
자 동 화	자 동 화
<<unk>> 입 곡	<unk> 입 곡
독 서 실	독 서 실
대 학 원	대 학 원
유 목 민	유 목 민
김 치 전	김 치 전
고 순 쥐	고 순 쥐
상 속 인	상 속 인
한 겨 레	한 겨 레
큰 아 들	큰 아 들
의 존 증	의 존 증
연 락 처	연 락 처
자 물 쇠	자 물 쇠
인 식 표	인 식 표
총 체 적	총 체 적
방 사 선	방 사 선
두 <<unk>> 다	두 <unk> 다
조 랑 말	조 랑 말
구 결 자	구 결 자
고 혈 압	고 혈 압
북 마 크	북 마 크
해 산 물	해 산 물
철 자 법	철 자 법
양 조 장	양 조 장
방 <<unk>> 간	방 <unk> 간
<<unk>> <<unk>> 터	<unk> <unk> 터
큰 고 니	큰 고 니
비 평 가	비 평 가
사 령 부	사 령 부
투 표 함	투 표 함
배 수 관	배 수 관
무 신 론	무 신 론
승 무 원	승 무 원
종 업 원	종 업 원
대 성 당	대 성 당
널 뛰 기	널 뛰 기
동 글 다	동 글 다
수 문 학	수 문 학
물 시 계	물 시 계
설 교 자	설 교 자
손 수 건	손 수 건
흡 연 자	흡 연 자
귀 엽 다	귀 엽 다
전 화 기	전 화 기
워 싱 <<unk>>	워 싱 <unk>
양 귀 비	양 귀 비
<<unk>> <<unk>> 다	<unk> <unk> 다
놀 랍 다	놀 랍 다
졸 업 식	졸 업 식
차 림 표	차 림 표
증 후 군	증 후 군
관 계 어	관 계 어
고 려 말	고 려 말
만 들 다	만 들 다
흔 들 다	흔 들 다
동 반 자	동 반 자
인 문 학	인 문 학
한 사 군	한 사 군
<<unk>> 가 락	<unk> 가 락
신 호 총	신 호 총
불 구 속	불 구 속
보 온 병	보 온 병
우 편 함	우 편 함
운 동 화	운 동 화
간 지 럼	간 지 럼
물 망 초	물 망 초
녹 음 실	녹 음 실
베 <<unk>> 린	베 <unk> 린
목 사 님	목 사 님
문 바 람	문 바 람
위 원 장	위 원 장
길 냥 이	길 냥 이
나 팔 꽃	나 팔 꽃
정 거 장	정 거 장
발 꿈 치	발 꿈 치
항 공 사	항 공 사
사 마 륨	사 마 륨
방 위 각	방 위 각
한 시 름	한 시 름
통 조 림	통 조 림
뉴 <<unk>> 리	뉴 <unk> 리
비 망 록	비 망 록
국 제 화	국 제 화
갈 비 탕	갈 비 탕
상 록 수	상 록 수
바 <<unk>> 쪽	바 <unk> 쪽
피 크 <<unk>>	피 크 <unk>
화 학 자	화 학 자
올 여 름	올 여 름
가 공 품	가 공 품
망 시 민	망 시 민
검 은 금	검 은 금
크 세 논	크 세 논
할 미 꽃	할 미 꽃
답 정 너	답 정 너
물 들 다	물 들 다
필 수 적	필 수 적
수 도 권	수 도 권
<<unk>> 글 씨	<unk> 글 씨
크 로 켓	크 로 켓
특 급 시	특 급 시
천 주 교	천 주 교
신 교 도	신 교 도
가 정 법	가 정 법
수 납 장	수 납 장
회 계 사	회 계 사
미 역 국	미 역 국
장 로 교	장 로 교
시 궁 쥐	시 궁 쥐
영 원 히	영 원 히
언 론 학	언 론 학
보 신 탕	보 신 탕
영 양 제	영 양 제
처 방 전	처 방 전
공 보 원	공 보 원
대 표 적	대 표 적
충 분 히	충 분 히
콘 <<unk>> 트	콘 <unk> 트
함 구 증	함 구 증
교 과 서	교 과 서
처 녀 막	처 녀 막
속 쓰 림	속 쓰 림
탐 험 가	탐 험 가
감 리 교	감 리 교
스 크 린	스 크 린
식 민 지	식 민 지
남 프 <<unk>>	남 프 <unk>
고 전 적	고 전 적
유 기 견	유 기 견
난 센 스	난 센 스
<<unk>> 사 탕	<unk> 사 탕
꽃 다 발	꽃 다 발
방 과 후	방 과 후
미 용 실	미 용 실
탈 의 실	탈 의 실
팔 꿈 치	팔 꿈 치
말 <<unk>> 씨	말 <unk> 씨
콩 나 물	콩 나 물
만 주 국	만 주 국
외 손 녀	외 손 녀
냉 장 고	냉 장 고
손 가 방	손 가 방
분 석 자	분 석 자
무 진 장	무 진 장
연 구 실	연 구 실
<<unk>> <<unk>> 터	<unk> <unk> 터
뒷 다 리	뒷 다 리
독 신 자	독 신 자
다 락 방	다 락 방
눈 사 람	눈 사 람
폐 기 종	폐 기 종
기 계 공	기 계 공
지 름 길	지 름 길
문 제 점	문 제 점
잠 들 다	잠 들 다
금 자 <<unk>>	금 자 <unk>
운 동 장	운 동 장
들 <<unk>> 다	들 <unk> 다
<<unk>> 기 름	<unk> 기 름
적 외 선	적 외 선
감 미 료	감 미 료
대 명 사	대 명 사
충 전 기	충 전 기
그 러 면	그 러 면
루 테 늄	루 테 늄
<<unk>> 마 크	<unk> 마 크
정 치 학	정 치 학
부 회 장	부 회 장
중 요 성	중 요 성
까 막 눈	까 막 눈
건 강 히	건 강 히
중 성 자	중 성 자
음 식 점	음 식 점
지 속 적	지 속 적
운 동 복	운 동 복
군 만 두	군 만 두
대 폭 적	대 폭 적
합 법 화	합 법 화
콜 <<unk>> 션	콜 <unk> 션
진 료 소	진 료 소
심 리 학	심 리 학
반 지 름	반 지 름
지 난 번	지 난 번
대 사 관	대 사 관
더 블 린	더 블 린
대 검 집	대 검 집
신 세 계	신 세 계
과 일 물	과 일 물
로 렌 <<unk>>	로 렌 <unk>
강 화 도	강 화 도
변 압 기	변 압 기
필 리 핀	필 리 핀
범 죄 자	범 죄 자
자 폐 증	자 폐 증
경 기 도	경 기 도
원 기 둥	원 기 둥
발 바 <<unk>>	발 바 <unk>
북 반 구	북 반 구
계 산 기	계 산 기
변 호 사	변 호 사
근 일 점	근 일 점
동 호 회	동 호 회
무 국 적	무 국 적
괴 롭 다	괴 롭 다
짝 사 랑	짝 사 랑
정 답 다	정 답 다
나 침 반	나 침 반
작 업 실	작 업 실
금 메 달	금 메 달
음 식 <<unk>>	음 식 <unk>
그 <<unk>> 날	그 <unk> 날
십 일 월	십 일 월
위 굴 말	위 굴 말
나 트 륨	나 트 륨
<<unk>> 시 꾼	<unk> 시 꾼
솔 까 말	솔 까 말
참 기 름	참 기 름
작 업 복	작 업 복
당 연 히	당 연 히
공 무 원	공 무 원
눈 꺼 풀	눈 꺼 풀
뒤 <<unk>> 다	뒤 <unk> 다
폴 란 드	폴 란 드
초 콜 릿	초 콜 릿
영 성 체	영 성 체
천 조 국	천 조 국
비 판 적	비 판 적
개 정 판	개 정 판
환 하 다	환 하 다
회 사 원	회 사 원
가 는 쥐	가 는 쥐
비 단 길	비 단 길
설 치 류	설 치 류
단 순 히	단 순 히
계 산 서	계 산 서
슬 로 건	슬 로 건
미 적 분	미 적 분
기 본 적	기 본 적
벤 질 기	벤 질 기
선 교 사	선 교 사
교 육 학	교 육 학
벨 모 판	벨 모 판
병 기 고	병 기 고
조 각 상	조 각 상
선 인 장	선 인 장
레 슬 링	레 슬 링
승 냥 이	승 냥 이
조 계 종	조 계 종
과 학 자	과 학 자
위 원 회	위 원 회
살 며 시	살 며 시
카 드 <<unk>>	카 드 <unk>
수 정 란	수 정 란
정 치 판	정 치 판
물 만 두	물 만 두
다 림 질	다 림 질
세 계 적	세 계 적
거 북 선	거 북 선
부 작 용	부 작 용
대 표 단	대 표 단
최 소 한	최 소 한
번 역 가	번 역 가
기 독 교	기 독 교
견 디 다	견 디 다
남 조 선	남 조 선
작 곡 자	작 곡 자
견 주 다	견 주 다
양 성 자	양 성 자
립 스 <<unk>>	립 스 <unk>
<<unk>> <<unk>> 션	<unk> <unk> 션
뒤 집 다	뒤 집 다
브 <<unk>> 셀	브 <unk> 셀
트 럼 <<unk>>	트 럼 <unk>
속 삭 임	속 삭 임
가 독 성	가 독 성
공 동 체	공 동 체
목 구 멍	목 구 멍
수 류 탄	수 류 탄
레 퍼 토 리	레 퍼 토 리
두 드 리 다	두 드 리 다
피 라 미 드	피 라 미 드
떠 다 니 다	떠 다 니 다
유 사 하 다	유 사 하 다
호 흡 하 다	호 흡 하 다
얼 어 <<unk>> 다	얼 어 <unk> 다
바 그 르 르	바 그 르 르
시 도 하 다	시 도 하 다
모 터 보 트	모 터 보 트
걸 어 가 다	걸 어 가 다
가 득 하 다	가 득 하 다
아 티 초 크	아 티 초 크
스 노 보 드	스 노 보 드
파 시 스 트	파 시 스 트
그 러 <<unk>> 로	그 러 <unk> 로
지 <<unk>> 하 다	지 <unk> 하 다
다 운 로 드	다 운 로 드
대 비 하 다	대 비 하 다
호 루 라 기	호 루 라 기
아 미 노 산	아 미 노 산
불 가 리 아	불 가 리 아
에 스 파 <<unk>>	에 스 파 <unk>
받 아 쓰 기	받 아 쓰 기
멀 어 지 다	멀 어 지 다
제 작 하 다	제 작 하 다
조 지 타 운	조 지 타 운
설 레 이 다	설 레 이 다
허 락 하 다	허 락 하 다
낮 아 지 다	낮 아 지 다
산 티 아 고	산 티 아 고
소 비 하 다	소 비 하 다
가 파 르 다	가 파 르 다
수 집 하 다	수 집 하 다
저 지 하 다	저 지 하 다
미 국 오 리	미 국 오 리
간 악 하 다	간 악 하 다
요 약 하 다	요 약 하 다
후 레 이 크	후 레 이 크
흐 릿 하 다	흐 릿 하 다
오 랑 우 탄	오 랑 우 탄
아 미 타 불	아 미 타 불
바 그 다 드	바 그 다 드
부 유 하 다	부 유 하 다
헤 엄 치 다	헤 엄 치 다
알 데 히 드	알 데 히 드
부 르 트 다	부 르 트 다
미 꾸 라 지	미 꾸 라 지
사 자 고 추	사 자 고 추
바 다 사 자	바 다 사 자
인 구 조 사	인 구 조 사
무 모 하 다	무 모 하 다
스 포 일 러	스 포 일 러
요 리 하 다	요 리 하 다
솔 로 몬	솔 로 몬
<<unk>> 하 늘	<unk> 하 늘
위 화 감	위 화 감
줄 공 치	줄 공 치
두 반 장	두 반 장
홍 당 무	홍 당 무
당 나 귀	당 나 귀
갈 수 록	갈 수 록
물 방 울	물 방 울
올 바 르 다	올 바 르 다
아 제 티 딘	아 제 티 딘
세 수 하 다	세 수 하 다
찾 아 보 다	찾 아 보 다
벌 어 지 다	벌 어 지 다
파 트 타 임	파 트 타 임
이 미 다 졸	이 미 다 졸
울 음 소 리	울 음 소 리
마 무 르 다	마 무 르 다
주 무 르 다	주 무 르 다
늘 어 나 다	늘 어 나 다
어 드 벤 처	어 드 벤 처
부 서 지 다	부 서 지 다
보 호 하 다	보 호 하 다
죽 마 고 우	죽 마 고 우
짜 릿 하 다	짜 릿 하 다
이 글 이 글	이 글 이 글
여 보 세 요	여 보 세 요
프 로 세 서	프 로 세 서
수 수 께 끼	수 수 께 끼
따 <<unk>> 하 다	따 <unk> 하 다
페 샤 와 르	페 샤 와 르
수 음 하 다	수 음 하 다
지 시 하 다	지 시 하 다
소 말 리 아	소 말 리 아
볼 리 비 아	볼 리 비 아
베 스 푸 치	베 스 푸 치
무 시 하 다	무 시 하 다
부 리 나 케	부 리 나 케
보 그 르 르	보 그 르 르
모 리 셔 스	모 리 셔 스
후 쿠 시 마	후 쿠 시 마
<<unk>> 아 지 다	<unk> 아 지 다
오 물 오 물	오 물 오 물
없 어 지 다	없 어 지 다
글 라 이 더	글 라 이 더
누 악 쇼 트	누 악 쇼 트
의 식 하 다	의 식 하 다
자 그 레 브	자 그 레 브
지 적 하 다	지 적 하 다
<<unk>> 딱 하 다	<unk> 딱 하 다
그 레 나 다	그 레 나 다
스 무 니 다	스 무 니 다
블 라 우 스	블 라 우 스
임 마 누 엘	임 마 누 엘
버 무 리 다	버 무 리 다
오 글 오 글	오 글 오 글
해 고 하 다	해 고 하 다
어 린 이 집	어 린 이 집
도 모 하 다	도 모 하 다
따 라 가 다	따 라 가 다
집 어 <<unk>> 다	집 어 <unk> 다
제 <<unk>> 놓 다	제 <unk> 놓 다
사 라 지 다	사 라 지 다
억 울 하 다	억 울 하 다
카 라 카 스	카 라 카 스
제 거 하 다	제 거 하 다
찾 아 가 다	찾 아 가 다
누 구 세 요	누 구 세 요
추 적 하 다	추 적 하 다
그 러 니 까	그 러 니 까
익 숙 하 다	익 숙 하 다
빠 듯 하 다	빠 듯 하 다
지 루 하 다	지 루 하 다
기 도 하 다	기 도 하 다
보 츠 와 나	보 츠 와 나
시 작 하 다	시 작 하 다
<<unk>> 어 지 다	<unk> 어 지 다
지 나 치 다	지 나 치 다
다 마 네 기	다 마 네 기
우 물 우 물	우 물 우 물
지 <<unk>> 이 다	지 <unk> 이 다
스 <<unk>> 디 오	스 <unk> 디 오
엄 습 하 다	엄 습 하 다
커 다 <<unk>> 다	커 다 <unk> 다
와 그 르 르	와 그 르 르
다 부 지 다	다 부 지 다
자 세 하 다	자 세 하 다
해 석 하 다	해 석 하 다
바 라 보 다	바 라 보 다
어 <<unk>> 나 다	어 <unk> 나 다
두 드 러 기	두 드 러 기
커 <<unk>> 아 웃	커 <unk> 아 웃
하 루 살 이	하 루 살 이
뿌 셔 뿌 셔	뿌 셔 뿌 셔
노 고 지 리	노 고 지 리
무 스 카 트	무 스 카 트
고 집 하 다	고 집 하 다
부 족 하 다	부 족 하 다
방 어 하 다	방 어 하 다
머 무 르 다	머 무 르 다
주 무 시 다	주 무 시 다
부 여 하 다	부 여 하 다
하 숙 집	하 숙 집
뛰 어 가 다	뛰 어 가 다
이 상 하 다	이 상 하 다
가 <<unk>> 가 다	가 <unk> 가 다
아 스 타 <<unk>>	아 스 타 <unk>
아 브 라 함	아 브 라 함
스 트 레 스	스 트 레 스
가 브 리 엘	가 브 리 엘
라 이 선 스	라 이 선 스
모 자 라 다	모 자 라 다
심 부 름	심 부 름
제 과 점	제 과 점
육 분 의	육 분 의
허 영 심	허 영 심
코 헬 렛	코 헬 렛
탄 약 고	탄 약 고
비 교 적	비 교 적
조 선 말	조 선 말
두 만 강	두 만 강
편 하 다	편 하 다
복 엽 기	복 엽 기
강 준 치	강 준 치
앙 상 블	앙 상 블
강 점 기	강 점 기
클 로 버	클 로 버
표 지 판	표 지 판
겨 울 철	겨 울 철
령 도 자	령 도 자
한 국 학	한 국 학
모 란 봉	모 란 봉
불 포 화	불 포 화
노 동 법	노 동 법
굴 착 기	굴 착 기
손 가 락	손 가 락
크 레 용	크 레 용
한 국 인	한 국 인
갑 분 싸	갑 분 싸
창 조 적	창 조 적
무 궁 화	무 궁 화
글 루 텐	글 루 텐
셀 로 판	셀 로 판
하 극 상	하 극 상
방 사 능	방 사 능
잠 수 함	잠 수 함
할 <<unk>> 다	할 <unk> 다
기 억 력	기 억 력
바 <<unk>> 물	바 <unk> 물
올 림 <<unk>>	올 림 <unk>
<<unk>> 익 다	<unk> 익 다
<<unk>> 걸 음	<unk> 걸 음
유 권 자	유 권 자
일 반 적	일 반 적
<<unk>> <<unk>> 다	<unk> <unk> 다
강 원 도	강 원 도
나 환 자	나 환 자
수 출 품	수 출 품
쥐 창 시	쥐 창 시
안 녕 히	안 녕 히
<<unk>> <<unk>> 이	<unk> <unk> 이
지 정 학	지 정 학
신 청 자	신 청 자
중 국 인	중 국 인
발 리 볼	발 리 볼
면 도 기	면 도 기
슈 크 림	슈 크 림
출 판 사	출 판 사
된 비 <<unk>>	된 비 <unk>
초 특 급	초 특 급
연 설 자	연 설 자
탈 출 기	탈 출 기
<<unk>> 팔 라	<unk> 팔 라
한 반 도	한 반 도
짝 짓 기	짝 짓 기
수 면 제	수 면 제
블 루 길	블 루 길
쌍 디 <<unk>>	쌍 디 <unk>
물 리 학	물 리 학
연 월 일	연 월 일
<<unk>> 지 꿈	<unk> 지 꿈
무 화 과	무 화 과
저 금 통	저 금 통
<<unk>> 처 럼	<unk> 처 럼
필 요 성	필 요 성
소 중 화	소 중 화
남 반 구	남 반 구
거 짓 말	거 짓 말
크 리 켓	크 리 켓
복 수 전	복 수 전
반 올 림	반 올 림
들 기 름	들 기 름
<<unk>> 치 다	<unk> 치 다
국 유 화	국 유 화
예 닐 곱	예 닐 곱
슬 며 시	슬 며 시
탈 북 자	탈 북 자
설 문 지	설 문 지
자 존 심	자 존 심
멜 라 닌	멜 라 닌
수 영 장	수 영 장
뇌 피 <<unk>>	뇌 피 <unk>
각 다 귀	각 다 귀
초 록 빛	초 록 빛
핀 란 드	핀 란 드
양 귀 자	양 귀 자
<<unk>> 만 두	<unk> 만 두
손 바 <<unk>>	손 바 <unk>
정 비 공	정 비 공
국 한 문	국 한 문
대 역 죄	대 역 죄
진 동 수	진 동 수
갈 비 <<unk>>	갈 비 <unk>
한 동 안	한 동 안
위 글 말	위 글 말
발 자 국	발 자 국
귀 <<unk>> 다	귀 <unk> 다
그 녀 들	그 녀 들
부 분 적	부 분 적
실 로 폰	실 로 폰
참 을 성	참 을 성
인 식 론	인 식 론
가 능 성	가 능 성
초 콜 렛	초 콜 렛
화 강 암	화 강 암
북 한 말	북 한 말
<<unk>> 라 잔	<unk> 라 잔
대 학 교	대 학 교
인 력 거	인 력 거
비 교 급	비 교 급
취 나 물	취 나 물
각 선 미	각 선 미
<<unk>> 빙 수	<unk> 빙 수
입 장 료	입 장 료
링 귀 네	링 귀 네
할 로 <<unk>>	할 로 <unk>
주 방 장	주 방 장
천 천 히	천 천 히
리 <<unk>> 션	리 <unk> 션
뒤 <<unk>> 다	뒤 <unk> 다
전 리 품	전 리 품
열 다 섯	열 다 섯
천 안 문	천 안 문
루 테 <<unk>>	루 테 <unk>
배 심 원	배 심 원
천 부 적	천 부 적
된 디 <<unk>>	된 디 <unk>
간 단 히	간 단 히
종 유 석	종 유 석
출 원 자	출 원 자
쌀 쌀 히	쌀 쌀 히
사 회 학	사 회 학
지 방 산	지 방 산
할 머 님	할 머 님
정 말 로	정 말 로
명 하 다	명 하 다
영 국 인	영 국 인
올 림 말	올 림 말
다 람 쥐	다 람 쥐
선 거 통	선 거 통
승 강 기	승 강 기
반 창 고	반 창 고
되 찾 다	되 찾 다
고 량 주	고 량 주
얼 <<unk>> 말	얼 <unk> 말
부 동 산	부 동 산
집 사 람	집 사 람
유 격 수	유 격 수
잔 디 <<unk>>	잔 디 <unk>
관 리 인	관 리 인
신 장 위	신 장 위
기 원 전	기 원 전
스 <<unk>> 크	스 <unk> 크
똑 같 다	똑 같 다
영 수 증	영 수 증
항 공 기	항 공 기
후 견 인	후 견 인
지 겹 다	지 겹 다
경 력	격 력
별 명	별 명
광 경	광 경
별 별	별 별
명 관	명 관
변 형	변 형
광 명	광 명
평 형	평 형
편 경	편 경
뒷 면	뒷 면
황 량	황 량
<<unk>> <<unk>>	<unk> <unk>
경 향	경 향
신 부 님	신 부 님
평 <<unk>>	평 <unk>
권 력	권 력
관 념	관 념
관 광	관 광
변 환	변 환
경 관	경 관
<<unk>> 형	<unk> 형
환 경	환 경
<<unk>> <<unk>>	<unk> <unk>
편 견	편 견
환 관	환 관
평 면	평 면
환 멸	환 멸
<<unk>> <<unk>>	<unk> <unk>
추 출 물	추 출 물
두 벌 식	두 벌 식
탈 영 자	탈 영 자
순 교 자	순 교 자
가 <<unk>> <<unk>>	가 <unk> <unk>
폭 <<unk>> 다	폭 <unk> 다
중 국 화	중 국 화
전 문 가	전 문 가
초 승 달	초 승 달
시 간 표	시 간 표
수 영 복	수 영 복
<<unk>> 스 텐	<unk> 스 텐
극 작 가	극 작 가
광 년	광 년
확 <<unk>>	확 <unk>
관 련	관 련
사 회 적	사 회 적
건 축 가	건 축 가
보 름 날	보 름 날
냉 동 고	냉 동 고
일 본 학	일 본 학
기 관 차	기 관 차
중 국 학	중 국 학
꿈 꾸 다	꿈 꾸 다
테 헤 란	테 헤 란
골 짜 기	골 짜 기
대 리 석	대 리 석
<<unk>> 파 리	<unk> 파 리
인 도 양	인 도 양
도 시 락	도 시 락
프 리 즘	프 리 즘
거 칠 다	거 칠 다
까 치 복	까 치 복
나 폴 리	나 폴 리
프 랑 스	프 랑 스
시 금 치	시 금 치
근 로 자	근 로 자
<<unk>> 지 다	<unk> 지 다
대 리 점	대 리 점
참 가 자	참 가 자
습 니 까	습 니 까
<<unk>> 지 다	<unk> 지 다
보 건 소	보 건 소
브 리 <<unk>>	브 리 <unk>
노 트 북	노 트 북
<<unk>> 뿌 라	<unk> 뿌 라
<<unk>> 스 카	<unk> 스 카
토 욕 혼	토 욕 혼
반 듯 이	반 드 시
부 상 자	부 상 자
차 마 당	차 마 당
이 슬 람	이 슬 람
<<unk>> 가 리	<unk> 가 리
용 의 자	용 의 자
가 만 히	가 만 히
돌 고 기	돌 고 기
유 전 자	유 전 자
<<unk>> 주 다	<unk> 주 다
저 항 기	저 항 기
동 거 인	동 거 인
자 꾸 만	자 꾸 만
해 부 학	해 부 학
합 성 어	합 성 어
들 러 리	들 러 리
<<unk>> 스 트	<unk> 스 트
무 <<unk>> 다	무 <unk> 다
군 소 리	군 소 리
블 로 그	블 로 그
시 심 마	시 심 마
게 시 판	게 시 판
비 구 름	비 구 름
건 너 다	건 너 다
삼 루 수	삼 루 수
오 락 실	오 락 실
실 마 리	실 마 리
몰 도 바	몰 도 바
하 지 만	하 지 만
발 라 드	발 라 드
과 메 기	과 메 기
파 슬 리	파 슬 리
어 휘 장	어 휘 장
쇼 트 닝	쇼 트 닝
까 불 다	까 불 다
놀 라 움	놀 라 움
몽 따 <<unk>>	몽 따 <unk>
까 마 귀	까 마 귀
유 인 원	유 인 원
피 시 방	피 시 방
저 절 로	저 절 로
공 식 어	공 식 어
교 차 로	교 차 로
비 둘 기	비 둘 기
중 국 어	중 국 어
<<unk>> <<unk>> 다	<unk> <unk> 다
드 르 렁	드 르 렁
독 수 리	독 수 리
드 물 다	드 물 다
<<unk>> 가 을	<unk> 가 을
벼 리 다	벼 리 다
소 음 순	소 음 순
이 력 서	이 력 서
글 라 스	글 라 스
대 기 실	대 기 실
무 <<unk>> 다	무 <unk> 다
운 전 사	운 전 사
거 미 줄	거 미 줄
<<unk>> <<unk>> 다	<unk> <unk> 다
사 용 자	사 용 자
가 물 치	가 물 치
떠 돌 다	떠 돌 다
논 하 다	논 하 다
고 고 학	고 고 학
추 리 닝	추 리 닝
옷 고 름	옷 고 름
지 리 산	지 리 산
도 청 기	도 청 기
<<unk>> 거 움	<unk> 거 움
대 원 수	대 원 수
법 무 부	법 무 부
글 쓰 기	글 쓰 기
천 리 안	천 리 안
릴 리 스	릴 리 스
케 더 링	케 더 링
정 치 인	정 치 인
<<unk>> <<unk>> 에	<unk> <unk> 에
<<unk>> 기 다	<unk> 기 다
가 야 금	가 야 금
복 소 수	복 소 수
미 국 인	미 국 인
프 런 트	프 런 트
간 호 사	간 호 사
매 표 구	매 표 구
신 의 주	신 의 주
밀 리 다	밀 리 다
달 마 다	달 마 다
살 리 다	살 리 다
시 청 자	시 청 자
비 스 켓	비 스 켓
일 본 인	일 본 인
야 구 장	야 구 장
적 나 라	적 나 라
천 지 인	천 지 인
터 미 널	터 미 널
만 나 다	만 나 다
인 화 지	인 화 지
공 수 도	공 수 도
사 막 화	사 막 화
나 라 님	나 라 님
마 케 팅	마 케 팅
흐 느 적	흐 느 적
논 다 니	논 다 니
창 조 자	창 조 자
트 럼 프	트 럼 프
내 몽 고	내 몽 고
코 <<unk>> 소	코 <unk> 소
골 드 바	골 드 바
외 국 인	외 국 인
겨 루 다	겨 루 다
송 사 리	송 사 리
디 지 털	디 지 털
슬 프 다	슬 프 다
피 난 처	피 난 처
제 작 자	제 작 자
오 <<unk>> 렛	오 <unk> 렛
밀 가 루	밀 가 루
제 설 차	제 설 차
천 리 마	천 리 마
불 도 저	불 도 저
일 인 칭	일 인 칭
수 리 남	수 리 남
바 지 락	바 지 락
팔 걸 이	팔 걸 이
구 체 적	구 체 적
칼 자 루	칼 자 루
건 조 기	건 조 기
게 르 만	게 르 만
불 고 기	불 고 기
이 진 법	이 진 법
할 머 니	할 머 니
불 바 다	불 바 다
사 기 꾼	사 기 꾼
무 승 부	무 승 부
빨 <<unk>> 다	빨 <unk> 다
며 느 리	며 느 리
반 시 옷	반 시 옷
잔 나 비	잔 나 비
소 지 품	소 지 품
자 전 거	자 전 거
인 절 미	인 절 미
기 숙 사	기 숙 사
열 아 <<unk>>	열 아 <unk>
취 리 히	취 리 히
조 선 인	조 선 인
기 술 자	기 술 자
문 둥 이	문 둥 이
기 라 성	기 라 성
돌 리 다	돌 리 다
금 요 일	금 요 일
주 차 장	주 차 장
수 호 신	수 호 신
부 <<unk>> 다	부 <unk> 다
그 동 안	그 동 안
수 정 체	수 정 체
퍼 센 트	퍼 센 트
집 토 끼	집 토 끼
텔 루 르	텔 루 르
파 친 코	파 친 코
손 아 귀	손 아 귀
반 드 시	반 드 시
분 위 기	분 위 기
조 미 료	조 미 료
어 <<unk>> 다	어 <unk> 다
무 제 한	무 제 한
튀 니 지	튀 니 지
소 낙 비	소 낙 비
은 근 히	은 근 히
<<unk>> 가 지	<unk> 가 지
어 <<unk>> 면	어 <unk> 면
지 하 실	지 하 실
도 파 민	도 파 민
바 <<unk>> 다	바 <unk> 다
젖 먹 이	젖 먹 이
구 호 금	구 호 금
두 려 움	두 려 움
떨 치 다	떨 치 다
레 바 논	레 바 논
지 식 인	지 식 인
유 <<unk>> 브	유 <unk> 브
<<unk>> 은 이	<unk> 은 이
몽 둥 이	몽 둥 이
시 토 회	시 토 회
개 인 적	개 인 적
맞 벌 이	맞 벌 이
<<unk>> <<unk>> 다	<unk> <unk> 다
팔 다 리	팔 다 리
괴 로 움	괴 로 움
이 신 론	이 신 론
만 하 다	만 하 다
<<unk>> 치 다	<unk> 치 다
풀 네 임	풀 네 임
머 그 잔	머 그 잔
스 웨 <<unk>>	스 웨 <unk>
카 르 텔	카 르 텔
양 피 지	양 피 지
파 스 텔	파 스 텔
복 숭 아	복 숭 아
더 불 다	더 불 다
거 드 름	거 드 름
설 치 다	설 치 다
파 사 삭	파 사 삭
질 리 다	질 리 다
프 로 판	프 로 판
시 스 <<unk>>	시 스 <unk>
병 아 리	병 아 리
단 고 기	단 고 기
마 닐 라	마 닐 라
가 을 철	가 을 철
문 화 어	문 화 어
니 코 <<unk>>	니 코 <unk>
합 기 도	합 기 도
자 판 기	자 판 기
가 랑 비	가 랑 비
반 치 음	반 치 음
걸 음 마	걸 음 마
심 마 니	심 마 니
피 리 딘	피 리 딘
살 피 다	살 피 다
여 러 분	여 러 분
리 <<unk>> 스	리 <unk> 스
외 손 자	외 손 자
<<unk>> 기 다	<unk> 기 다
죽 부 인	죽 부 인
올 겨 울	올 겨 울
내 국 인	내 국 인
은 하 단	은 하 단
텔 레 비	텔 레 비
아 니 면	아 니 면
없 <<unk>> 다	없 <unk> 다
빛 나 다	빛 나 다
삼 나 무	삼 나 무
도 회 인	도 회 인
가 로 등	가 로 등
산 호 초	산 호 초
포 플 러	포 플 러
매 춘 부	매 춘 부
떠 들 다	떠 들 다
후 유 증	후 유 증
능 하 다	능 하 다
살 인 자	살 인 자
포 유 류	포 유 류
초 고 속	초 고 속
세 모 꼴	세 모 꼴
<<unk>> 테 일	<unk> 테 일
가 늘 다	가 늘 다
가 <<unk>> 다	가 <unk> 다
돌 팔 이	돌 팔 이
달 구 다	달 구 다
사 랑 니	사 랑 니
여 과 기	여 과 기
세 포 학	세 포 학
물 수 리	물 수 리
난 추 니	난 추 니
목 요 일	목 요 일
하 여 간	하 여 간
파 드 <<unk>>	파 드 <unk>
<<unk>> 기 다	<unk> 기 다
칼 파 스	칼 파 스
인 터 <<unk>>	인 터 <unk>
정 치 가	정 치 가
돌 <<unk>> 이	돌 <unk> 이
커 미 션	커 미 션
<<unk>> 소 리	<unk> 소 리
세 탁 기	세 탁 기
사 리 원	사 리 원
공 용 어	공 용 어
사 춘 기	사 춘 기
전 하 다	전 하 다
아 들 딸	아 들 딸
유 니 <<unk>>	유 니 <unk>
군 주 제	군 주 제
크 레 인	크 레 인
선 거 인	선 거 인
<<unk>> 리 다	<unk> 리 다
말 라 보	말 라 보
기 승 위	기 승 위
매 국 노	매 국 노
하 느 님	하 느 님
구 분 자	구 분 자
자 강 도	자 강 도
리 스 본	리 스 본
파 슈 토 어	파 슈 토 어
세 르 비 아	세 르 비 아
로 사 리 오	로 사 리 오
브 라 우 저	브 라 우 저
유 익 하 다	유 익 하 다
사 이 보 그	사 이 보 그
기 울 이 다	기 울 이 다
나 이 로 비	나 이 로 비
유 언 비 어	유 언 비 어
아 코 디 언	아 코 디 언
시 베 리 아	시 베 리 아
기 억 하 다	기 억 하 다
아 카 데 미	아 카 데 미
페 르 샤 어	페 르 샤 어
부 아 소 리	부 아 소 리
와 이 셔 츠	와 이 셔 츠
혹 여 나	혹 여 나
예 술 가	예 술 가
나 라 말	나 라 말
구 급 차	구 급 차
알 바 니 아	알 바 니 아
스 페 인 어	스 페 인 어
아 메 리 카	아 메 리 카
알 아 보 다	알 아 보 다
아 주 머 니	아 주 머 니
너 비 아 니	너 비 아 니
오 <<unk>> 하 다	오 <unk> 하 다
그 <<unk>> 하 다	그 <unk> 하 다
디 바 이 스	디 바 이 스
어 떡 하 다	어 떡 하 다
<<unk>> 두 기	<unk> 두 기
에 피 소 드	에 피 소 드
추 악 하 다	추 악 하 다
러 시 아 인	러 시 아 인
아 나 운 서	아 나 운 서
프 리 지 어	프 리 지 어
게 으 르 다	게 으 르 다
우 그 르 르	우 그 르 르
안 드 레 아	안 드 레 아
동 업 자	동 업 자
고 <<unk>> 다	고 <unk> 다
<<unk>> 아 들	<unk> 아 들
어 <<unk>> <<unk>>	어 <unk> <unk>
<<unk>> 보 기	<unk> 보 기
<<unk>> 티 드	<unk> 티 드
접 수 처	접 수 처
과 로 사	과 로 사
폭 풍 우	폭 풍 우
양 동 이	양 동 이
카 메 <<unk>>	카 메 <unk>
앙 골 라	앙 골 라
무 속 인	무 속 인
보 사 삭	보 사 삭
디 스 크	디 스 크
열 리 다	열 리 다
굼 <<unk>> 이	굼 <unk> 이
알 칼 리	알 칼 리
코 크 스	코 크 스
가 지 <<unk>>	가 지 <unk>
위 선 자	위 선 자
양 수 사	양 수 사
누 군 가	누 군 가
달 맞 이	달 맞 이
유 도 탄	유 도 탄
<<unk>> 무 니	<unk> 무 니
바 텐 더	바 텐 더
월 요 일	월 요 일
조 산 부	조 산 부
미 어 지 다	미 어 지 다
몰 디 브	몰 디 브
떨 리 다	떨 리 다
마 라 <<unk>>	마 라 <unk>
이 <<unk>> 날	이 <unk> 날
누 리 꾼	누 리 꾼
아 줄 렌	아 줄 렌
표 준 어	표 준 어
공 업 화	공 업 화
스 케 이 트	스 케 이 트
이 스 마 엘	이 스 마 엘
나 미 비 아	나 미 비 아
베 이 루 트	베 이 루 트
토 네 이 도	토 네 이 도
마 이 너 스	마 이 너 스
시 어 머 니	시 어 머 니
사 마 리 아	사 마 리 아
유 라 시 아	유 라 시 아
일 어 서 다	일 어 서 다
그 리 스 어	그 리 스 어
라 트 비 아	라 트 비 아
페 르 시 아	페 르 시 아
다 가 오 다	다 가 오 다
헤 어 지 다	헤 어 지 다
바 이 러 스	바 이 러 스
오 리 나 무	오 리 나 무
어 여 머 리	어 여 머 리
위 구 르 어	위 구 르 어
사 악 하 다	사 악 하 다
에 티 오 피 아	에 티 오 피 아
아 프 리 카	아 프 리 카
이 스 라 엘	이 스 라 엘
브 라 이 언	브 라 이 언
남 자 아 이	남 자 아 이
치 어 리 더	치 어 리 더
말 레 이 어	말 레 이 어
소 비 에 트	소 비 에 트
버 지 니 아	버 지 니 아
떠 오 르 다	떠 오 르 다
<<unk>> 아 하 다	<unk> 아 하 다
가 라 오 케	가 라 오 케
이 기 주 의	이 기 주 의
<<unk>> 어 쓰 기	<unk> 어 쓰 기
우 울 하 다	우 울 하 다
차 이 니 스	차 이 니 스
오 페 레 타	오 페 레 타
가 마 우 지	가 마 우 지
어 울 리 다	어 울 리 다
아 시 타 비	아 시 타 비
에 미 리 트	에 미 리 트
아 틀 리 에	아 틀 리 에
바 누 아 투	바 누 아 투
꼬 치 구 이	꼬 치 구 이
카 나 리 아	카 나 리 아
아 스 타 나	아 스 타 나
헤 아 리 다	헤 아 리 다
우 루 과 이	우 루 과 이
일 어 나 다	일 어 나 다
아 보 카 도	아 보 카 도
사 무 라 이	사 무 라 이
네 오 나 치	네 오 나 치
아 부 다 비	아 부 다 비
<<unk>> 아 지 다	<unk> 아 지 다
에 네 르 기	에 네 르 기
아 이 쇼 <<unk>>	아 이 쇼 <unk>
트 레 이 너	트 레 이 너
노 르 웨 이	노 르 웨 이
돌 아 오 다	돌 아 오 다
타 이 르 다	타 이 르 다
우 리 나 라	우 리 나 라
시 아 버 지	시 아 버 지
나 아 가 다	나 아 가 다
우 두 커 니	우 두 커 니
루 마 니 아	루 마 니 아
보 스 니 아	보 스 니 아
쇼 케 이 스	쇼 케 이 스
반 바 지	반 바 지
자 메 이 카	자 메 이 카
찾 아 오 다	찾 아 오 다
살 아 오 다	살 아 오 다
로 <<unk>> 니 아	로 <unk> 니 아
브 루 나 이	브 루 나 이
가 <<unk>> 오 다	가 <unk> 오 다
부 르 <<unk>> 아	부 르 <unk> 아
노 이 로 제	노 이 로 제
칼 상 어	칼 상 어
예 레 반	예 레 반
글 <<unk>> 요	글 <unk> 요
판 소 리	판 소 리
비 밀 리	비 밀 리
해 상 도	해 상 도
축 음 기	축 음 기
등 받 이	등 받 이
지 리 학	지 리 학
조 용 히	조 용 히
노 인 학	노 인 학
언 젠 가	언 젠 가
낮 추 다	낮 추 다
요 르 단	요 르 단
십 자 가	십 자 가
리 <<unk>> 스	리 <unk> 스
코 코 <<unk>>	코 코 <unk>
꽃 <<unk>> 이	꽃 <unk> 이
네 티 <<unk>>	네 티 <unk>
버 팔 로	버 팔 로
나 <<unk>> 카	나 <unk> 카
플 러 스	플 러 스
마 천 루	마 천 루
슬 라 브	슬 라 브
소 모 전	소 모 전
똑 바 로	똑 바 로
급 기 야	급 기 야
닭 고 기	닭 고 기
노 숙 자	노 숙 자
호 기 심	호 기 심
돌 상 어	돌 상 어
음 운 론	음 운 론
과 포 자	과 포 자
들 르 다	들 르 다
바 자 회	바 자 회
돌 보 다	돌 보 다
<<unk>> 아 <<unk>>	<unk> 아 <unk>
자 <<unk>> 괴	자 <unk> 괴
<<unk>> 사 삭	<unk> 사 삭
복 사 기	복 사 기
베 풀 다	베 풀 다
마 지 막	마 지 막
소 방 수	소 방 수
지 휘 자	지 휘 자
그 런 데	그 런 데
맞 추 다	맞 추 다
사 기 죄	사 기 죄
꾸 <<unk>> 다	꾸 <unk> 다
건 네 다	건 네 다
눈 보 라	눈 보 라
사 마 귀	사 마 귀
흥 하 다	흥 하 다
<<unk>> 페 지	<unk> 페 지
디 스 켓	디 스 켓
리 모 컨	리 모 컨
정 수 리	정 수 리
꼬 리 표	꼬 리 표
기 중 기	기 중 기
마 스 크	마 스 크
리 왕 조	리 왕 조
그 네 들	그 네 들
날 마 다	날 마 다
콘 서 트	콘 서 트
대 주 교	대 주 교
나 란 히	나 란 히
노 처 녀	노 처 녀
방 숭 이	방 숭 이
길 거 리	길 거 리
네 다 섯	네 다 섯
몸 조 리	몸 조 리
<<unk>> 치 다	<unk> 치 다
고 가 교	고 가 교
곡 예 사	곡 예 사
파 시 즘	파 시 즘
무 <<unk>> 다	무 <unk> 다
미 혼 모	미 혼 모
베 트 남	베 트 남
부 서 석	부 서 석
건 더 기	건 더 기
누 리 집	누 리 집
낙 하 산	낙 하 산
고 구 려	고 구 려
벨 리 즈	벨 리 즈
쇠 <<unk>> 이	쇠 <unk> 이
벅 차 다	벅 차 다
마 법 사	마 법 사
<<unk>> 스 크	<unk> 스 크
노 엽 다	노 엽 다
망 치 다	망 치 다
자 장 가	자 장 가
자 동 차	자 동 차
그 립 다	그 립 다
아 련 히	아 련 히
연 기 자	연 기 자
간 드 리	간 드 리
부 처 님	부 처 님
홍 송 어	홍 송 어
플 러 그	플 러 그
테 러 범	테 러 범
르 완 다	르 완 다
막 바 지	막 바 지
무 조 건	무 조 건
대 작 자	대 작 자
프 린 터	프 린 터
고 추 장	고 추 장
한 가 위	한 가 위
모 처 럼	모 처 럼
통 하 다	통 하 다
혹 시 나	혹 시 나
미 <<unk>> 마	미 <unk> 마
가 마 <<unk>>	가 마 <unk>
돌 잡 이	돌 잡 이
범 아 귀	범 아 귀
사 치 품	사 치 품
<<unk>> 체 어	<unk> 체 어
그 치 만	그 치 만
마 음 속	마 음 속
부 모 님	부 모 님
고 조 선	고 조 선
마 름 모	마 름 모
산 토 끼	산 토 끼
고 무 신	고 무 신
철 저 히	철 저 히
쌍 둥 이	쌍 둥 이
검 둥 이	검 둥 이
알 맞 다	알 맞 다
잔 소 리	잔 소 리
말 고 기	말 고 기
화 요 일	화 요 일
비 타 민	비 타 민
역 사 가	역 사 가
<<unk>> 하 다	<unk> 하 다
소 화 기	소 화 기
임 신 부	임 신 부
의 인 화	의 인 화
하 나 님	하 나 님
녹 음 기	녹 음 기
머 리 통	머 리 통
소 방 서	소 방 서
피 폭 자	피 폭 자
스 시 국	스 시 국
반 지 하	반 지 하
가 부 좌	가 부 좌
바 <<unk>> 가	바 <unk> 가
자 유 적	자 유 적
방 아 쇠	방 아 쇠
가 <<unk>> 다	가 <unk> 다
일 시 적	일 시 적
서 <<unk>> 다	서 <unk> 다
실 업 가	실 업 가
하 느 작	하 느 작
똑 같 이	똑 같 이
뜨 <<unk>> 다	뜨 <unk> 다
진 실 하 다	진 실 하 다
강 력 하 다	강 력 하 다
헬 리 <<unk>> 터	헬 리 <unk> 터
사 용 되 다	사 용 되 다
돌 하 르 방	돌 하 르 방
춘 하 추 동	춘 하 추 동
원 망 하 다	원 망 하 다
원 조 교 제	원 조 교 제
<<unk>> 지 럽 다	<unk> 지 럽 다
날 카 롭 다	날 카 롭 다
건 강 하 다	건 강 하 다
친 근 하 다	친 근 하 다
벌 거 <<unk>> 다	벌 거 <unk> 다
프 탈 라 진	프 탈 라 진
담 당 하 다	담 당 하 다
<<unk>> <<unk>> 지 다	<unk> <unk> 지 다
발 전 하 다	발 전 하 다
어 장 관 리	어 장 관 리
급 격 하 다	급 격 하 다
자 <<unk>> 하 면	자 <unk> 하 면
반 항 하 다	반 항 하 다
육 자 진 언	육 자 진 언
틀 림 없 이	틀 림 없 이
엉 <<unk>> 하 다	엉 <unk> 하 다
보 글 보 글	보 글 보 글
꾸 물 꾸 물	꾸 물 꾸 물
글 리 세 린	글 리 세 린
신 선 하 다	신 선 하 다
유 릿 조 각	유 릿 조 각
등 줄 숭 어	등 줄 숭 어
완 성 하 다	완 성 하 다
당 당 하 다	당 당 하 다
<<unk>> 가 <<unk>> 부	<unk> 가 <unk> 부
건 전 하 다	건 전 하 다
심 마 니 말	심 마 니 말
관 자 놀 이	관 자 놀 이
죄 송 하 다	죄 송 하 다
투 명 하 다	투 명 하 다
스 <<unk>> <<unk>> 지	스 <unk> <unk> 지
편 안 하 다	편 안 하 다
지 르 코 늄	지 르 코 늄
꼬 물 꼬 물	꼬 물 꼬 물
숙 주 나 물	숙 주 나 물
출 발 하 다	출 발 하 다
오 버 클 럭	오 버 클 럭
상 당 하 다	상 당 하 다
잔 잔 하 다	잔 잔 하 다
프 로 필 렌	프 로 필 렌
정 크 푸 드	정 크 푸 드
흔 들 리 다	흔 들 리 다
부 <<unk>> 부 <<unk>>	부 <unk> 부 <unk>
성 교 하 다	성 교 하 다
<<unk>> 두 각 시	<unk> 두 각 시
<<unk>> <<unk>> 하 다	<unk> <unk> 하 다
의 심 쩍 다	의 심 쩍 다
이 슬 람 교	이 슬 람 교
가 물 가 물	가 물 가 물
게 르 마 늄	게 르 마 늄
교 통 사 고	교 통 사 고
갑 작 스 레	갑 작 스 레
코 린 치 쥐	코 린 치 쥐
물 놀 이 장	물 놀 이 장
검 독 수 리	검 독 수 리
빨 리 빨 리	빨 리 빨 리
상 담 하 다	상 담 하 다
스 며 들 다	스 며 들 다
말 살 하 다	말 살 하 다
면 도 하 다	면 도 하 다
신 중 하 다	신 중 하 다
별 세 하 다	별 세 하 다
<<unk>> <<unk>> 하 다	<unk> <unk> 하 다
언 론 학 자	언 론 학 자
흥 분 하 다	흥 분 하 다
살 <<unk>> 보 다	살 <unk> 보 다
시 작 되 다	시 작 되 다
통 근 하 다	통 근 하 다
터 <<unk>> 터 <<unk>>	터 <unk> 터 <unk>
적 절 하 다	적 절 하 다
콘 크 리 트	콘 크 리 트
모 스 코 <<unk>>	모 스 코 <unk>
존 중 하 다	존 중 하 다
된 장 풀	된 장 풀
활 동 적	활 동 적
건 <<unk>> 편	건 <unk> 편
당 <<unk>> 병	당 <unk> 병
활 성 탄	활 성 탄
잠 망 경	잠 망 경
법 <<unk>> 학	법 <unk> 학
과 학 관	과 학 관
조 현 병	조 현 병
<<unk>> 크 병	<unk> 크 병
교 향 곡	교 향 곡
영 화 관	영 화 관
대 관 령	대 관 령
불 현 듯	불 현 듯
삼 겹 살	삼 겹 살
<<unk>> 약 근	<unk> 약 근
만 년 필	만 년 필
<<unk>> 약 <<unk>>	<unk> 약 <unk>
된 장 녀	된 장 녀
송 년 회	송 년 회
통 찰 력	통 찰 력
전 염 병	전 염 병
관 절 염	관 절 염
상 상 력	상 상 력
빙 상 관	빙 상 관
남 빙 양	남 빙 양
결 정 론	결 정 론
탈 영 병	탈 영 병
관 박 쥐	관 박 쥐
집 권 당	집 권 당
화 염 병	화 염 병
관 풍 금	관 풍 금
영 춘 권	영 춘 권
<<unk>> 승 권	<unk> 승 권
명 왕 성	명 왕 성
박 물 관	박 물 관
기 념 관	기 념 관
불 면 증	불 면 증
환 상 적	환 상 적
관 형 사	관 형 사
팔 극 권	팔 극 권
알 루 미 늄	알 루 미 늄
<<unk>> <<unk>> 하 다	<unk> <unk> 하 다
비 밀 번 호	비 밀 번 호
팔 팔 하 다	팔 팔 하 다
출 근 하 다	출 근 하 다
사 이 클 링	사 이 클 링
워 석 버 석	워 석 버 석
크 리 스 천	크 리 스 천
급 진 주 의	급 진 주 의
연 구 되 다	연 구 되 다
건 설 하 다	건 설 하 다
연 필 <<unk>> 이	연 필 <unk> 이
멀 찌 감 치	멀 찌 감 치
부 전 자 전	부 전 자 전
강 간 하 다	강 간 하 다
고 정 되 다	고 정 되 다
성 스 럽 다	성 스 럽 다
물 리 학 자	물 리 학 자
구 경 하 다	구 경 하 다
특 정 하 다	특 정 하 다
호 놀 <<unk>> 루	호 놀 <unk> 루
광 화 문	광 화 문
살 결 물	살 결 물
<<unk>> 은 창 자	<unk> 은 창 자
마 련 하 다	마 련 하 다
보 디 빌 딩	보 디 빌 딩
전 진 하 다	전 진 하 다
심 심 하 다	심 심 하 다
<<unk>> 살 같 이	<unk> 살 같 이
그 린 란 드	그 린 란 드
부 러 뜨 리 다	부 러 뜨 리 다
조 피 볼 락	조 피 볼 락
가 만 가 만	가 만 가 만
파 동 함 수	파 동 함 수
비 <<unk>> 되 다	비 <unk> 되 다
충 실 하 다	충 실 하 다
전 율 하 다	전 율 하 다
두 음 법 칙	두 음 법 칙
정 치 학 자	정 치 학 자
담 담 하 다	담 담 하 다
검 은 딸 기	검 은 딸 기
편 리 하 다	편 리 하 다
엉 <<unk>> 결 에	엉 <unk> 결 에
세 미 콜 론	세 미 콜 론
칭 찬 하 다	칭 찬 하 다
글 리 세 롤	글 리 세 롤
경 이 롭 다	경 이 롭 다
부 슬 부 슬	부 슬 부 슬
이 심 전 심	이 심 전 심
발 휘 하 다	발 휘 하 다
용 감 하 다	용 감 하 다
단 단 하 다	단 단 하 다
훈 주 음 종	훈 주 음 종
극 단 주 의	극 단 주 의
기 독 교 도	기 독 교 도
군 국 주 의	군 국 주 의
걸 프 렌 드	걸 프 렌 드
외 복 사 근	외 복 사 근
관 리 하 다	관 리 하 다
<<unk>> 겨 지 다	<unk> 겨 지 다
경 고 하 다	경 고 하 다
반 <<unk>> 불 이	반 <unk> 불 이
확 인 하 다	확 인 하 다
선 글 라 스	선 글 라 스
보 슬 보 슬	보 슬 보 슬
포 슬 포 슬	포 슬 포 슬
적 당 하 다	적 당 하 다
접 근 하 다	접 근 하 다
참 중 고 기	참 중 고 기
달 <<unk>> 하 다	달 <unk> 하 다
복 스 럽 다	복 스 럽 다
대 영 제 국	대 영 제 국
거 스 름 돈	거 스 름 돈
선 동 하 다	선 동 하 다
속 속 들 이	속 속 들 이
팔 미 트 산	팔 미 트 산
남 녀 노 소	남 녀 노 소
질 풍 노 도	질 풍 노 도
바 다 표 범	바 다 표 범
감 당 하 다	감 당 하 다
증 진 하 다	증 진 하 다
몬 테 비 데 오	몬 테 비 데 오
가 위 바 위 보	가 위 바 위 보
뛰 어 다 니 다	뛰 어 다 니 다
바 다 코 끼 리	바 다 코 끼 리
스 테 이 플 러	스 테 이 플 러
두 드 러 지 다	두 드 러 지 다
테 러 리 스 트	테 러 리 스 트
받 아 들 이 다	받 아 들 이 다
돌 아 가 시 다	돌 아 가 시 다
마 이 크 로 파	마 이 크 로 파
카 보 베 르 데	카 보 베 르 데
아 이 슬 란 드	아 이 슬 란 드
남 아 메 리 카	남 아 메 리 카
하 이 드 라 진	하 이 드 라 진
수 수 미 꾸 리	수 수 미 꾸 리
작 은 아 버 지	작 은 아 버 지
오 르 되 브 르	오 르 되 브 르
그 리 워 하 다	그 리 워 하 다
동 남 아 시 아	동 남 아 시 아
간 선 도 로	간 선 도 로
쌀 쌀 하 다	쌀 쌀 하 다
프 랑 스 빵	프 랑 스 빵
납 품 하 다	납 품 하 다
인 공 지 능	인 공 지 능
궁 금 하 다	궁 금 하 다
지 역 사 회	지 역 사 회
적 용 하 다	적 용 하 다
증 설 하 다	증 설 하 다
투 탕 카 <<unk>>	투 탕 카 <unk>
초 자 연 적	초 자 연 적
폴 란 드 인	폴 란 드 인
브 라 질 리 아	브 라 질 리 아
슬 로 베 니 아	슬 로 베 니 아
베 네 수 엘 라	베 네 수 엘 라
부 다 페 스 트	부 다 페 스 트
에 멜 무 지 로	에 멜 무 지 로
더 러 워 지 다	더 러 워 지 다
거 릿 모 테 이	거 릿 모 테 이
가 운 데 소 리	가 운 데 소 리
<<unk>> 비 <<unk>> 하 다	<unk> 비 <unk> 하 다
코 <<unk>> 하 <<unk>>	코 <unk> 하 <unk>
설 포 닐 기	설 포 닐 기
흥 미 롭 다	흥 미 롭 다
할 라 페 <<unk>>	할 라 페 <unk>
심 사 숙 고	심 사 숙 고
플 라 스 <<unk>>	플 라 스 <unk>
심 란 하 다	심 란 하 다
과 <<unk>> 말 라	과 <unk> 말 라
사 뿐 사 뿐	사 뿐 사 뿐
애 완 동 물	애 완 동 물
표 고 버 섯	표 고 버 섯
정 확 하 다	정 확 하 다
갈 망 하 다	갈 망 하 다
당 연 하 다	당 연 하 다
판 판 하 다	판 판 하 다
팔 방 미 인	팔 방 미 인
달 려 가 다	달 려 가 다
바 글 바 글	바 글 바 글
전 라 남 도	전 라 남 도
발 기 부 전	발 기 부 전
지 하 철 역	지 하 철 역
과 들 루 <<unk>>	과 들 루 <unk>
안 절 부 절	안 절 부 절
벼 락 부 자	벼 락 부 자
군 데 군 데	군 데 군 데
유 명 하 다	유 명 하 다
출 출 하 다	출 출 하 다
수 소 폭 탄	수 소 폭 탄
파 삭 파 삭	파 삭 파 삭
전 자 우 편	전 자 우 편
<<unk>> 손 잡 이	<unk> 손 잡 이
불 쌍 하 다	불 쌍 하 다
멀 <<unk>> 하 다	멀 <unk> 하 다
출 판 하 다	출 판 하 다
스 <<unk>> 트 럼	스 <unk> 트 럼
틀 림 없 다	틀 림 없 다
질 문 하 다	질 문 하 다
통 과 하 다	통 과 하 다
모 잠 비 크	모 잠 비 크
우 편 번 호	우 편 번 호
공 정 하 다	공 정 하 다
서 뿐 서 뿐	서 뿐 서 뿐
화 창 하 다	화 창 하 다
충 분 하 다	충 분 하 다
멍 <<unk>> 구 리	멍 <unk> 구 리
별 다 르 다	별 다 르 다
무 빙 워 크	무 빙 워 크
와 글 와 글	와 글 와 글
민 족 주 의	민 족 주 의
<<unk>> 끔 하 다	<unk> 끔 하 다
과 테 말 라	과 테 말 라
손 상 하 다	손 상 하 다
대 한 제 국	대 한 제 국
탄 화 수 소	탄 화 수 소
착 용 하 다	착 용 하 다
불 과 하 다	불 과 하 다
리 버 모 륨	리 버 모 륨
불 꽃 놀 이	불 꽃 놀 이
텔 레 비 전	텔 레 비 전
곤 란 하 다	곤 란 하 다
과 들 루 프	과 들 루 프
민 감 하 다	민 감 하 다
비 <<unk>> 방 울	비 <unk> 방 울
야 민 정 음	야 민 정 음
<<unk>> 적 다 리	<unk> 적 다 리
실 망 하 다	실 망 하 다
황 조 롱 이	황 조 롱 이
두 근 두 근	두 근 두 근
실 존 주 의	실 존 주 의
빈 트 후 크	빈 트 후 크
단 순 하 다	단 순 하 다
논 병 아 리	논 병 아 리
그 <<unk>> 되 다	그 <unk> 되 다
소 수 민 족	소 수 민 족
큰 기 러 기	큰 기 러 기
남 자 답 다	남 자 답 다
가 득 가 득	가 득 가 득
공 산 주 의	공 산 주 의
성 장 하 다	성 장 하 다
불 철 주 야	불 철 주 야
스 리 랑 카	스 리 랑 카
플 라 스 마	플 라 스 마
자 기 절 로	자 기 절 로
나 <<unk>> 가 지	나 <unk> 가 지
강 요 하 다	강 요 하 다
간 질 이 다	간 질 이 다
수 상 하 다	수 상 하 다
그 야 말 로	그 야 말 로
신 기 하 다	신 기 하 다
둘 러 싸 다	둘 러 싸 다
그 렇 지 만	그 렇 지 만
다 정 하 다	다 정 하 다
카 놀 라 유	카 놀 라 유
영 리 하 다	영 리 하 다
슈 퍼 마 켓	슈 퍼 마 켓
침 묵 하 다	침 묵 하 다
답 답 하 다	답 답 하 다
증 가 하 다	증 가 하 다
<<unk>> 어 보 다	<unk> 어 보 다
타 슈 <<unk>> 트	타 슈 <unk> 트
둘 러 보 다	둘 러 보 다
자 진 하 다	자 진 하 다
공 부 하 다	공 부 하 다
응 징 하 다	응 징 하 다
화 사 하 다	화 사 하 다
지 <<unk>> 하 다	지 <unk> 하 다
분 주 하 다	분 주 하 다
노 려 보 다	노 려 보 다
변 이 하 다	변 이 하 다
주 식 회 사	주 식 회 사
불 안 하 다	불 안 하 다
수 염 수 리	수 염 수 리
꽃 봉 오 리	꽃 봉 오 리
옥 시 토 신	옥 시 토 신
비 잔 티 움	비 잔 티 움
발 음 하 다	발 음 하 다
바 <<unk>> 어 른	바 <unk> 어 른
막 다 르 다	막 다 르 다
창 조 하 다	창 조 하 다
살 그 머 니	살 그 머 니
잡 수 시 다	잡 수 시 다
수 도 <<unk>> 지	수 도 <unk> 지
제 공 하 다	제 공 하 다
불 구 하 다	불 구 하 다
의 심 하 다	의 심 하 다
산 마 리 노	산 마 리 노
자 가 용 차	자 가 용 차
철 저 하 다	철 저 하 다
중 요 하 다	중 요 하 다
모 음 조 화	모 음 조 화
순 박 하 다	순 박 하 다
대 단 하 다	대 단 하 다
부 럼 없 다	부 럼 없 다
망 설 이 다	망 설 이 다
염 세 주 의	염 세 주 의
추 진 하 다	추 진 하 다
부 르 <<unk>> 다	부 르 <unk> 다
<<unk>> 셔 너 리	<unk> 셔 너 리
불 가 사 리	불 가 사 리
목 마 르 다	목 마 르 다
시 상 하 부	시 상 하 부
묘 사 하 다	묘 사 하 다
오 염 되 다	오 염 되 다
제 출 하 다	제 출 하 다
사 로 잡 다	사 로 잡 다
<<unk>> <<unk>> <<unk>> 순	<unk> <unk> <unk> 순
물 들 이 다	물 들 이 다
타 이 타 늄	타 이 타 늄
반 듯 하 다	반 듯 하 다
귀 <<unk>> 라 미	귀 <unk> 라 미
안 심 하 다	안 심 하 다
고 민 하 다	고 민 하 다
딱 딱 하 다	딱 딱 하 다
일 사 천 리	일 사 천 리
<<unk>> 가 노 쥐	<unk> 가 노 쥐
체 르 노 빌	체 르 노 빌
흘 러 가 다	흘 러 가 다
어 <<unk>> <<unk>> 다	어 <unk> <unk> 다
눈 다 랑 어	눈 다 랑 어
주 장 하 다	주 장 하 다
분 석 하 다	분 석 하 다
운 동 하 다	운 동 하 다
그 늘 지 다	그 늘 지 다
감 사 하 다	감 사 하 다
심 각 하 다	심 각 하 다
엉 <<unk>> 하 다	엉 <unk> 하 다
엄 격 하 다	엄 격 하 다
산 봉 우 리	산 봉 우 리
추 천 하 다	추 천 하 다
타 협 하 다	타 협 하 다
부 드 럽 다	부 드 럽 다
구 성 하 다	구 성 하 다
음 소 문 자	음 소 문 자
<<unk>> 푸 르 다	<unk> 푸 르 다
큰 아 버 지	큰 아 버 지
여 전 하 다	여 전 하 다
커 <<unk>> 니 티	커 <unk> 니 티
물 고 기 알	물 고 기 알
비 트 박 스	비 트 박 스
센 티 미 터	센 티 미 터
솔 직 하 다	솔 직 하 다
여 성 주 의	여 성 주 의
보 상 하 다	보 상 하 다
까 딸 로 그	까 딸 로 그
끔 <<unk>> 하 다	끔 <unk> 하 다
주 고 받 다	주 고 받 다
승 하 하 다	승 하 하 다
연 습 하 다	연 습 하 다
분 포 하 다	분 포 하 다
못 지 <<unk>> 다	못 지 <unk> 다
푸 짐 하 다	푸 짐 하 다
인 도 차 이 나	인 도 차 이 나
프 리 토 리 아	프 리 토 리 아
바 베 이 도 스	바 베 이 도 스
이 야 기 하 다	이 야 기 하 다
베 오 그 라 드	베 오 그 라 드
케 이 프 타 운	케 이 프 타 운
필 요 하 다	필 요 하 다
쌀 미 꾸 리	쌀 미 꾸 리
후 <<unk>> 가 루	후 <unk> 가 루
가 난 하 다	가 난 하 다
마 팔 디 네	마 팔 디 네
비 슈 케 크	비 슈 케 크
클 라 우 드	클 라 우 드
말 레 이 시 아	말 레 이 시 아
고 달 피 다	고 달 피 다
<<unk>> 스 하 다	<unk> 스 하 다
연 주 하 다	연 주 하 다
참 석 하 다	참 석 하 다
더 위 팔 기	더 위 팔 기
주 체 사 상	주 체 사 상
거 만 하 다	거 만 하 다
일 고 여 <<unk>>	일 고 여 <unk>
이 스 탄 불	이 스 탄 불
진 부 하 다	진 부 하 다
줄 어 들 다	줄 어 들 다
의 존 하 다	의 존 하 다
동 일 하 다	동 일 하 다
안 드 로 이 드	안 드 로 이 드
독 특 하 다	독 특 하 다
에 스 토 니 아 어	에 스 토 니 아 어
아 르 메 니 아 어	아 르 메 니 아 어
차 이 나 타 운	차 이 나 타 운
다 이 아 몬 드	다 이 아 몬 드
스 트 레 이 트	스 트 레 이 트
크 로 아 티 아	크 로 아 티 아
시 에 라 리 온	시 에 라 리 온
포 트 루 이 스	포 트 루 이 스
오 케 스 트 라	오 케 스 트 라
마 케 도 니 아	마 케 도 니 아
이 데 올 로 기	이 데 올 로 기
어 그 러 지 다	어 그 러 지 다
서 양 자 두	서 양 자 두
날 아 오 르 다	날 아 오 르 다
인 도 네 시 아	인 도 네 시 아
가 시 아 버 지	가 시 아 버 지
피 아 니 스 트	피 아 니 스 트
가 무 이 야 기	가 무 이 야 기
인 터 페 이 스	인 터 페 이 스
아 프 로 디 테	아 프 로 디 테
빠 <<unk>> 나 오 다	빠 <unk> 나 오 다
업 그 레 이 드	업 그 레 이 드
엘 리 베 이 터	엘 리 베 이 터
카 페 테 리 아	카 페 테 리 아
<<unk>> 어 버 리 다	<unk> 어 버 리 다
피 스 타 치 오	피 스 타 치 오
<<unk>> 임 없 이	<unk> 임 없 이
르 네 상 스	르 네 상 스
검 소 하 다	검 소 하 다
채 식 주 의	채 식 주 의
어 <<unk>> <<unk>> 다	어 <unk> <unk> 다
카 트 만 두	카 트 만 두
올 려 놓 다	올 려 놓 다
준 비 하 다	준 비 하 다
미 끄 럽 다	미 끄 럽 다
신 임 하 다	신 임 하 다
겨 드 랑 이	겨 드 랑 이
반 복 하 다	반 복 하 다
어 <<unk>> <<unk>> 이	어 <unk> <unk> 이
흑 두 루 미	흑 두 루 미
<<unk>> 가 리 다	<unk> 가 리 다
귀 국 하 다	귀 국 하 다
가 만 두 다	가 만 두 다
자 본 주 의	자 본 주 의
피 페 리 딘	피 페 리 딘
얼 음 과 자	얼 음 과 자
브 로 콜 리	브 로 콜 리
눈 <<unk>> 가 시	눈 <unk> 가 시
청 둥 오 리	청 둥 오 리
근 무 하 다	근 무 하 다
거 슬 리 다	거 슬 리 다
자 타 공 인	자 타 공 인
노 른 자 위	노 른 자 위
일 정 하 다	일 정 하 다
청 초 하 다	청 초 하 다
크 레 파 스	크 레 파 스
엄 청 나 다	엄 청 나 다
비 판 하 다	비 판 하 다
프 로 파 길	프 로 파 길
안 전 제 일	안 전 제 일
트 빌 리 시	트 빌 리 시
자 업 자 득	자 업 자 득
채 용 하 다	채 용 하 다
감 수 하 다	감 수 하 다
지 칭 하 다	지 칭 하 다
완 곡 하 다	완 곡 하 다
물 어 <<unk>> 다	물 어 <unk> 다
인 용 하 다	인 용 하 다
감 시 하 다	감 시 하 다
회 복 하 다	회 복 하 다
머 리 카 락	머 리 카 락
다 양 하 다	다 양 하 다
페 미 니 즘	페 미 니 즘
니 카 라 과	니 카 라 과
복 수 하 다	복 수 하 다
하 루 빨 리	하 루 빨 리
<<unk>> 어 지 다	<unk> 어 지 다
간 사 하 다	간 사 하 다
구 굴 무 치	구 굴 무 치
여 겨 지 다	여 겨 지 다
곰 비 임 비	곰 비 임 비
장 난 감	장 난 감
가 면 극	가 면 극
칠 면 조	칠 면 조
신 <<unk>> 센	신 <unk> 센
곤 충 학	곤 충 학
식 료 품	식 료 품
운 명 론	운 명 론
<<unk>> 플 렛	<unk> 플 렛
공 통 점	공 통 점
성 차 별	성 차 별
홍 길 동	홍 길 동
경 제 적	경 제 적
연 속 극	연 속 극
한 식 집	한 식 집
북 <<unk>> 쥐	북 <unk> 쥐
혼 례 식	혼 례 식
집 박 쥐	집 박 쥐
열 화 학	열 화 학
공 수 병	공 수 병
<<unk>> 장 <<unk>>	<unk> 장 <unk>
정 육 점	정 육 점
청 국 장	청 국 장
전 문 화	전 문 화
셀 레 늄	셀 레 늄
불 장 난	불 장 난
함 묵 증	함 묵 증
병 들 다	병 들 다
잔 <<unk>> 집	잔 <unk> 집
<<unk>> 질 방	<unk> 질 방
부 통 령	부 통 령
퇴 직 금	퇴 직 금
규 칙 적	규 칙 적
중 징 계	중 징 계
정 치 권	정 치 권
편 집 자	편 집 자
공 산 당	공 산 당
통 계 학	통 계 학
계 산 원	계 산 원
한 여 름	한 여 름
독 립 성	독 립 성
장 려 금	장 려 금
전 국 적	전 국 적
클 리 닝	클 리 닝
한 글 날	한 글 날
전 람 회	전 람 회
분 광 기	분 광 기
영 사 관	영 사 관
고 질 병	고 질 병
중 견 수	중 견 수
친 삼 촌	친 삼 촌
주 교 관	주 교 관
열 여 <<unk>>	열 여 <unk>
경 비 원	경 비 원
건 널 목	건 널 목
선 진 국	선 진 국
구 경 꾼	구 경 꾼
철 밥 통	철 밥 통
갈 림 길	갈 림 길
손 전 화	손 전 화
정 관 사	정 관 사
불 곰 국	불 곰 국
판 공 실	판 공 실
그 만 <<unk>>	그 만 <unk>
문 화 적	문 화 적
농 산 물	농 산 물
경 영 자	경 영 자
한 민 족	한 민 족
화 살 표	화 살 표
정 류 장	정 류 장
상 사 병	상 사 병
속 눈 <<unk>>	속 눈 <unk>
북 극 곰	북 극 곰
식 물 학	식 물 학
선 착 장	선 착 장
반 <<unk>> 불	반 <unk> 불
계 절 적	계 절 적
불 가 결	불 가 결
감 각 적	감 각 적
화 합 물	화 합 물
목 욕 탕	목 욕 탕
평 의 회	평 의 회
계 란 <<unk>>	계 란 <unk>
역 겹 다	역 겹 다
경 고 창	경 고 창
폐 회 식	폐 회 식
관 람 차	관 람 차
동 물 학	동 물 학
복 건 성	복 건 성
보 편 적	보 편 적
면 도 칼	면 도 칼
<<unk>> 장 히	<unk> 장 히
최 상 급	최 상 급
출 산 율	출 산 율
방 정 식	방 정 식
뒷 마 당	뒷 마 당
뒷 모 습	뒷 모 습
수 평 선	수 평 선
미 술 관	미 술 관
방 송 국	방 송 국
영 미 권	영 미 권
확 성 기	확 성 기
간 <<unk>> 천	간 <unk> 천
열 등 감	열 등 감
건 너 편	건 너 편
환 절 기	환 절 기
골 상 학	골 상 학
흡 혈 귀	흡 혈 귀
전 반 적	전 반 적
<<unk>> 작 년	<unk> 작 년
불 만 족	불 만 족
성 적 표	성 적 표
목 슈 권	목 슈 권
선 술 집	선 술 집
특 별 히	특 별 히
전 <<unk>> 가	전 <unk> 가
저 작 권	저 작 권
단 풍 국	단 풍 국
<<unk>> <<unk>> 이	<unk> <unk> 이
폭 격 기	폭 격 기
정 겹 다	정 겹 다
몰 상 식	몰 상 식
팔 라 <<unk>>	팔 라 <unk>
열 역 학	열 역 학
광 우 병	광 우 병
체 육 관	체 육 관
소 방 관	소 방 관
짜 장 면	짜 장 면
관 계 자	관 계 자
흑 설 탕	흑 설 탕
근 <<unk>> <<unk>>	근 <unk> <unk>
직 접 적	직 접 적
<<unk>> 투 늄	<unk> 투 늄
병 리 학	병 리 학
나 선 형	나 선 형
한 국 말	한 국 말
건 축 물	건 축 물
<<unk>> 방 귀	<unk> 방 귀
면 역 학	면 역 학
방 송 원	방 송 원
<<unk>> <<unk>> <<unk>>	<unk> <unk> <unk>
과 거 형	과 거 형
청 남 방	청 남 방
기 관 총	기 관 총
근 본 적	근 본 적
관 용 구	관 용 구
궁 극 적	궁 극 적
합 창 단	합 창 단
잘 잘 못	잘 잘 못
장 군 석	장 군 석
기 념 품	기 념 품
편 의 점	편 의 점
격 납 고	격 납 고
정 적 분	정 적 분
<<unk>> 정 적	<unk> 정 적
석 탄 산	석 탄 산
악 영 향	악 영 향
장 학 금	장 학 금
송 과 선	송 과 선
방 광 암	방 광 암
진 열 장	진 열 장
정 교 회	정 교 회
무 중 력	무 중 력
청 <<unk>> 장	청 <unk> 장
자 명 종	자 명 종
수 족 관	수 족 관
방 법 론	방 법 론
크 로 <<unk>>	크 로 <unk>
불 친 절	불 친 절
공 성 계	공 성 계
손 전 등	손 전 등
식 중 독	식 중 독
천 왕 성	천 왕 성
낙 동 강	낙 동 강
자 장 면	자 장 면
사 철 나 무	사 철 나 무
박 람 회	박 람 회
경 기 장	경 기 장
불 치 병	불 치 병
독 극 물	독 극 물
사 냥 꾼	사 냥 꾼
초 능 력	초 능 력
기 념 물	기 념 물
자 명 금	자 명 금
중 학 교	중 학 교
식 용 유	식 용 유
소 용 돌 이	소 용 돌 이
시 끄 럽 다	시 끄 럽 다
사 용 하 다	사 용 하 다
미 치 광 이	미 치 광 이
코 카 콜 라	코 카 콜 라
진 지 하 다	진 지 하 다
짐 바 브 웨	짐 바 브 웨
프 로 <<unk>> 러	프 로 <unk> 러
시 원 하 다	시 원 하 다
테 니 스 장	테 니 스 장
건 조 하 다	건 조 하 다
우 렁 각 시	우 렁 각 시
싱 가 포 르	싱 가 포 르
마 르 멜 로	마 르 멜 로
버 들 가 지	버 들 가 지
천 만 에 요	천 만 에 요
노 력 하 다	노 력 하 다
운 전 기 사	운 전 기 사
보 살 피 다	보 살 피 다
강 아 지 풀	강 아 지 풀
건 너 가 다	건 너 가 다
소 프 트 볼	소 프 트 볼
사 과 하 다	사 과 하 다
허 술 하 다	허 술 하 다
마 <<unk>> 하 다	마 <unk> 하 다
곱 사 연 어	곱 사 연 어
네 트 워 크	네 트 워 크
은 퇴 하 다	은 퇴 하 다
바 로 잡 다	바 로 잡 다
기 만 하 다	기 만 하 다
밀 리 미 터	밀 리 미 터
서 술 하 다	서 술 하 다
뛰 어 들 다	뛰 어 들 다
시 험 하 다	시 험 하 다
스 마 트 폰	스 마 트 폰
마 찬 가 지	마 찬 가 지
가 능 하 다	가 능 하 다
강 조 하 다	강 조 하 다
고 속 버 스	고 속 버 스
<<unk>> 마 크 어	<unk> 마 크 어
사 회 주 의	사 회 주 의
접 수 하 다	접 수 하 다
초 고 추 장	초 고 추 장
빨 아 먹 다	빨 아 먹 다
함 께 하 다	함 께 하 다
<<unk>> 수 수 치	<unk> 수 수 치
북 <<unk>> 우 다	북 <unk> 우 다
봉 착 하 다	봉 착 하 다
<<unk>> 들 리 에	<unk> 들 리 에
바 람 둥 이	바 람 둥 이
교 체 하 다	교 체 하 다
제 국 주 의	제 국 주 의
배 신 하 다	배 신 하 다
논 의 하 다	논 의 하 다
종 아 리 <<unk>>	종 아 리 <unk>
동 그 라 미	동 그 라 미
분 리 주 의	분 리 주 의
참 조 하 다	참 조 하 다
상 세 하 다	상 세 하 다
보 충 하 다	보 충 하 다
쇠 기 러 기	쇠 기 러 기
가 <<unk>> 하 다	가 <unk> 하 다
가 장 자 리	가 장 자 리
알 고 리 즘	알 고 리 즘
장 식 하 다	장 식 하 다
배 반 하 다	배 반 하 다
순 수 하 다	순 수 하 다
풍 부 하 다	풍 부 하 다
물 러 나 다	물 러 나 다
호 랑 나 비	호 랑 나 비
설 립 하 다	설 립 하 다
그 만 하 다	그 만 하 다
안 락 의 자	안 락 의 자
여 자 친 구	여 자 친 구
국 수 주 의	국 수 주 의
적 포 도 주	적 포 도 주
비 난 하 다	비 난 하 다
조 용 하 다	조 용 하 다
스 타 벅 스	스 타 벅 스
시 가 전 차	시 가 전 차
프 로 <<unk>> 트	프 로 <unk> 트
화 산 학	화 산 학
고 <<unk>> 가 루	고 <unk> 가 루
기 수 열 외	기 수 열 외
<<unk>> <<unk>> 하 다	<unk> <unk> 하 다
모 스 크 바	모 스 크 바
미 소 짓 다	미 소 짓 다
카 멜 레 온	카 멜 레 온
도 망 치 다	도 망 치 다
대 중 음 악	대 중 음 악
심 포 지 엄	심 포 지 엄
하 늘 나 라	하 늘 나 라
편 <<unk>> 다	편 <unk> 다
팔 랑 귀	팔 랑 귀
흡 인 력	흡 인 력
경 찰 서	경 찰 서
설 렁 탕	설 렁 탕
활 동 가	활 동 가
량 강 도	량 강 도
담 벼 락	담 벼 락
과 학 적	과 학 적
목 격 자	목 격 자
법 랑 질	법 랑 질
청 소 년	청 소 년
경 상 도	경 상 도
광 역 시	광 역 시
분 수 령	분 수 령
쌍 안 경	쌍 안 경
<<unk>> 트 <<unk>>	<unk> 트 <unk>
응 집 력	응 집 력
한 림 원	한 림 원
외 교 관	외 교 관
폴 로 늄	폴 로 늄
세 계 관	세 계 관
집 단 화	집 단 화
검 둥 오 리	검 둥 오 리
순 양 함	순 양 함
요 구 되 다	요 구 되 다
분 홍 빛	분 홍 빛
합 중 국	합 중 국
열 여 섯	열 여 섯
정 신 적	정 신 적
귀 <<unk>> 귀	귀 <unk> 귀
석 류 석	석 류 석
면 허 증	면 허 증
표 준 화	표 준 화
삼 계 탕	삼 계 탕
교 회 론	교 회 론
비 교 하 다	비 교 하 다
복 불 복	복 불 복
목 청 <<unk>>	목 청 <unk>
열 일 곱	열 일 곱
증 권 사	증 권 사
화 장 장	화 장 장
딸 <<unk>> 질	딸 <unk> 질
의 협 심	의 협 심
방 석 집	방 석 집
회 계 학	회 계 학
판 문 점	판 문 점
<<unk>> <<unk>> 하 다	<unk> <unk> 하 다
부 담 하 다	부 담 하 다
저 승 사 자	저 승 사 자
플 러 그 인	플 러 그 인
이 용 되 다	이 용 되 다
몬 트 리 올	몬 트 리 올
버 들 붕 어	버 들 붕 어
공 언 하 다	공 언 하 다
<<unk>> 르 <<unk>> 갈	<unk> 르 <unk> 갈
레 스 토 랑	레 스 토 랑
무 장 하 다	무 장 하 다
납 작 하 다	납 작 하 다
알 려 지 다	알 려 지 다
계 속 하 다	계 속 하 다
아 름 답 다	아 름 답 다
도 달 하 다	도 달 하 다
무 인 점 포	무 인 점 포
<<unk>> 족 하 다	<unk> 족 하 다
구 레 나 <<unk>>	구 레 나 <unk>
벨 라 루 스	벨 라 루 스
유 용 하 다	유 용 하 다
아 크 리 딘	아 크 리 딘
정 직 하 다	정 직 하 다
사 탕 수 수	사 탕 수 수
데 릴 사 위	데 릴 사 위
공 리 주 의	공 리 주 의
한 꺼 번 에	한 꺼 번 에
너 그 럽 다	너 그 럽 다
고 지 리 학	고 지 리 학
유 능 하 다	유 능 하 다
구 름 다 리	구 름 다 리
쓰 다 듬 다	쓰 다 듬 다
전 체 주 의	전 체 주 의
매 달 리 다	매 달 리 다
민 주 주 의	민 주 주 의
물 러 서 다	물 러 서 다
모 니 터 링	모 니 터 링
<<unk>> 스 주 의	<unk> 스 주 의
플 루 오 렌	플 루 오 렌
외 할 머 니	외 할 머 니
석 가 모 니	석 가 모 니
반 짝 이 다	반 짝 이 다
용 서 하 다	용 서 하 다
개 나 리 꽃	개 나 리 꽃
공 허 하 다	공 허 하 다
같 이 하 다	같 이 하 다
<<unk>> 어 하 다	<unk> 어 하 다
따 라 하 다	따 라 하 다
사 무 치 다	사 무 치 다
마 카 로 니	마 카 로 니
제 안 하 다	제 안 하 다
조 사 하 다	조 사 하 다
인 티 파 다	인 티 파 다
요 구 하 다	요 구 하 다
<<unk>> 카 이 도	<unk> 카 이 도
세 탁 하 다	세 탁 하 다
가 르 치 다	가 르 치 다
<<unk>> 보 디 아	<unk> 보 디 아
오 르 가 <<unk>>	오 르 가 <unk>
고 독 하 다	고 독 하 다
거 부 하 다	거 부 하 다
대 기 하 다	대 기 하 다
스 파 게 티	스 파 게 티
<<unk>> 페 이 지	<unk> 페 이 지
미 니 버 스	미 니 버 스
고 방 오 리	고 방 오 리
인 터 네 트	인 터 네 트
떨 어 지 다	떨 어 지 다
그 리 스 도	그 리 스 도
프 로 세 스	프 로 세 스
거 주 하 다	거 주 하 다
털 어 놓 다	털 어 놓 다
일 치 하 다	일 치 하 다
예 약 하 다	예 약 하 다
알 레 르 기	알 레 르 기
트 러 스 트	트 러 스 트
스 라 소 니	스 라 소 니
전 무 이 사	전 무 이 사
비 약 하 다	비 약 하 다
서 두 르 다	서 두 르 다
박 테 리 아	박 테 리 아
미 리 보 기	미 리 보 기
나 이 오 <<unk>>	나 이 오 <unk>
바 르 샤 바	바 르 샤 바
할 아 버 지	할 아 버 지
아 순 시 온	아 순 시 온
갈 리 시 아	갈 리 시 아
에 <<unk>> 도 르	에 <unk> 도 르
나 타 나 다	나 타 나 다
헤 르 메 스	헤 르 메 스
추 구 하 다	추 구 하 다
아 롱 아 롱	아 롱 아 롱
압 또 부 스	압 또 부 스
기 억 나 다	기 억 나 다
오 라 버 님	오 라 버 님
제 기 차 기	제 기 차 기
<<unk>> 죽 이 다	<unk> 죽 이 다
그 루 지 야	그 루 지 야
차 지 하 다	차 지 하 다
바 스 라 기	바 스 라 기
그 러 하 다	그 러 하 다
부 스 러 기	부 스 러 기
호 주 머 니	호 주 머 니
지 푸 라 기	지 푸 라 기
기 <<unk>> 하 다	기 <unk> 하 다
애 국 주 의	애 국 주 의
구 부 리 다	구 부 리 다
프 랑 스 어	프 랑 스 어
레 즈 비 언	레 즈 비 언
기 니 피 그	기 니 피 그
버 그 르 르	버 그 르 르
<<unk>> 타 이 드	<unk> 타 이 드
의 거 하 다	의 거 하 다
네 이 멍 구	네 이 멍 구
<<unk>> 어 지 다	<unk> 어 지 다
노 워 스 티	노 워 스 티
포 <<unk>> 하 다	포 <unk> 하 다
비 트 코 인	비 트 코 인
상 이 하 다	상 이 하 다
자 가 사 리	자 가 사 리
레 위 니 <<unk>>	레 위 니 <unk>
워 그 르 르	워 그 르 르
<<unk>> 지 이 응	<unk> 지 이 응
파 라 과 이	파 라 과 이
게 시 하 다	게 시 하 다
스 웨 리 예	스 웨 리 예
무 지 하 다	무 지 하 다
쓰 러 지 다	쓰 러 지 다
올 라 가 다	올 라 가 다
흐 지 부 지	흐 지 부 지
<<unk>> 사 이 트	<unk> 사 이 트
비 파 나 무	비 파 나 무
허 리 케 인	허 리 케 인
마 을 버 스	마 을 버 스
자 두 나 무	자 두 나 무
스 테 아 린	스 테 아 린
유 로 비 트	유 로 비 트
그 끄 저 께	그 끄 저 께
움 직 이 다	움 직 이 다
일 러 두 기	일 러 두 기
<<unk>> 토 리 아	<unk> 토 리 아
보 수 주 의	보 수 주 의
부 인 하 다	부 인 하 다
고 사 성 어	고 사 성 어
<<unk>> 어 안 다	<unk> 어 안 다
뛰 어 나 다	뛰 어 나 다
어 지 럽 다	어 지 럽 다
달 아 나 다	달 아 나 다
송 이 송 이	송 이 송 이
가 시 나 무	가 시 나 무
이 목 구 비	이 목 구 비
오 리 무 중	오 리 무 중
무 너 지 다	무 너 지 다
기 록 하 다	기 록 하 다
라 이 베 리 아	라 이 베 리 아
허 무 주 의	허 무 주 의
알 바 니 아 어	알 바 니 아 어
라 트 비 아 어	라 트 비 아 어
에 리 트 레 아	에 리 트 레 아
아 르 메 니 아	아 르 메 니 아
아 르 바 이 트	아 르 바 이 트
오 <<unk>> 라 이 스	오 <unk> 라 이 스
라 디 에 이 터	라 디 에 이 터
루 마 니 아 어	루 마 니 아 어
노 르 웨 이 어	노 르 웨 이 어
시 나 브 로	시 나 브 로
나 이 지 리 아	나 이 지 리 아
에 스 토 니 아	에 스 토 니 아
스 파 이 웨 어	스 파 이 웨 어
리 투 아 니 아	리 투 아 니 아
웨 브 페 지	웨 브 페 지
어 리 석 다	어 리 석 다
돌 아 가 다	돌 아 가 다
부 임 하 다	부 임 하 다
자 유 주 의	자 유 주 의
프 러 포 즈	프 러 포 즈
몬 로 비 아	몰 로 비 아
여 기 저 기	여 기 저 기
코 스 모 스	코 스 모 스
가 따 까 나	가 따 까 나
마 드 리 드	마 드 리 드
도 미 니 카	도 미 니 카
바 이 올 린	바 이 올 린
사 라 예 보	사 라 예 보
사 타 구 니	사 타 구 니
뉴 트 리 아	뉴 트 리 아
보 고 하 다	보 고 하 다
스 테 이 크	스 테 이 크
무 찌 르 다	무 찌 르 다
낙 하 하 다	낙 하 하 다
기 여 하 다	기 여 하 다
너 나 들 이	너 나 들 이
파 리 하 다	파 리 하 다
시 꺼 <<unk>> 다	시 꺼 <unk> 다
용 이 하 다	용 이 하 다
베 트 남 어	베 트 남 어
부 탁 하 다	부 탁 하 다
야 자 나 무	야 자 나 무
소 유 하 다	소 유 하 다
부 끄 러 움	부 끄 러 움
가 시 고 기	가 시 고 기
주 요 하 다	주 요 하 다
모 호 하 다	모 호 하 다
토 의 하 다	토 의 하 다
부 끄 리 다	부 끄 리 다
들 어 가 다	들 어 가 다
파 파 라 치	파 파 라 치
대 접 하 다	대 접 하 다
이 용 하 다	이 용 하 다
거 스 러 미	거 스 러 미
저 지 르 다	저 지 르 다
물 어 보 다	물 어 보 다
세 워 지 다	세 워 지 다
들 어 서 다	들 어 서 다
유 지 하 다	유 지 하 다
갈 아 타 다	갈 아 타 다
무 리 하 다	무 리 하 다
스 타 디 움	스 타 디 움
모 가 디 슈	모 가 디 슈
케 이 터 링	케 이 터 링
신 형 코 로 나 비 루 스 감 염 증	신 형 코 로 나 비 루 스 감 염 증
조 선 민 주 주 의 인 민 공 화 국	조 선 민 주 주 의 인 민 공 화 국
대 학 수 학 능 력 시 험	대 학 수 학 능 력 시 험
신 경 전 달 물 질	신 경 전 달 물 질
젖 당 못 견 <<unk>> 증	젖 당 못 견 <unk> 증
체 스 꼬 슬 로 벤 스 꼬	체 스 꼬 슬 로 벤 스 꼬
검 은 머 리 <<unk>> 죽 지	검 은 머 리 <unk> 죽 지
원 자 력 발 전 소	원 자 력 발 전 소
작 은 관 코 박 쥐	작 은 관 코 박 쥐
근 질 근 질 하 다	근 질 근 질 하 다
계 량 경 제 학	계 량 경 제 학
꼼 지 락 꼼 지 락	꼼 지 락 꼼 지 락
꿈 지 럭 꿈 지 럭	꿈 지 럭 꿈 지 럭
북 방 <<unk>> <<unk>> 오 리	북 방 <unk> <unk> 오 리
꼼 트 락 꼼 트 락	꼼 트 락 꼼 트 락
안 절 부 절 못 하 다	안 절 부 절 못 하 다
블 라 디 보 스 토 크	블 라 디 보 스 토 크
예 카 테 린 부 르 크	예 카 테 린 부 르 크
두 만 강 자 그 사 니	두 만 강 자 그 사 니
블 라 지 보 스 또 크	블 라 지 보 스 또 크
정 신 분 열 증	정 신 분 열 증
열 동 갈 문 절	열 동 갈 문 절
전 상 장 골 극	전 상 장 골 극
합 성 록 음 하 다	합 성 록 음 하 다
폴 리 프 로 필 렌	폴 리 프 로 필 렌
들 <<unk>> 날 <<unk>> 하 다	들 <unk> 날 <unk> 하 다
노 보 시 비 르 스 크	노 보 시 비 르 스 크
고 바 야 시 박 쥐	고 바 야 시 박 쥐
<<unk>> 굴 <<unk>> 굴	<unk> 굴 <unk> 굴
광 명 성 절	광 명 성 절
청 천 벽 력	청 천 벽 력
영 광 스 럽 다	영 광 스 럽 다
식 품 보 존 료	식 품 보 존 료
가 <<unk>> <<unk>> 교 회	가 <unk> <unk> 교 회
<<unk>> 명 스 럽 다	<unk> 명 스 럽 다
순 회 심 판 소	순 회 심 판 소
검 둥 오 리 사 촌	검 둥 오 리 사 촌
바 스 락 바 스 락	바 스 락 바 스 락
콘 스 탄 티 누 스	콘 스 탄 티 누 스
크 로 스 드 레 싱	크 로 스 드 레 싱
마 이 크 로 소 프 트	마 이 크 로 소 프 트
크 리 스 마 스 이 브	크 리 스 마 스 이 브
꼬 르 륵 꼬 르 륵	꼬 르 륵 꼬 르 륵
부 스 럭 부 스 럭	부 스 럭 부 스 럭
프 로 트 악 티 늄	프 로 트 악 티 늄
칼 리 닌 그 라 드	칼 리 닌 그 라 드
미 적 지 근 하 다	미 적 지 근 하 다
푸 서 석 푸 서 석	푸 서 석 푸 서 석
<<unk>> 꼬 리 꼬 마 쥐	<unk> 꼬 리 꼬 마 쥐
리 히 텐 슈 타 인	리 히 텐 슈 타 인
브 라 티 슬 라 바	브 라 티 슬 라 바
출 퇴 근 하 다	출 퇴 근 하 다
남 방 동 사 리	남 방 동 사 리
눈 꼴 사 납 다	눈 꼴 사 납 다
불 친 절 하 다	불 친 절 하 다
<<unk>> <<unk>> 부 르 크	<unk> <unk> 부 르 크
<<unk>> 논 병 아 리	<unk> 논 병 아 리
합 법 화 되 다	합 법 화 되 다
하 퇴 삼 두 근	하 퇴 삼 두 근
스 프 링 클 러	스 프 링 클 러
스 몰 렌 스 크	스 몰 렌 스 크
관 현 악 단	관 현 악 단
자 연 환 경	자 연 환 경
진 공 청 소 기	진 공 청 소 기
쿠 알 라 <<unk>> 푸 르	쿠 알 라 <unk> 푸 르
부 에 노 스 아 이 레 스	부 에 노 스 아 이 레 스
티 라 노 사 우 루 스	티 라 노 사 우 루 스
그 레 이 프 프 루 트	그 레 이 프 프 루 트
알 <<unk>> 산 드 리 아	알 <unk> 산 드 리 아
자 유 지 상 주 의	자 유 지 상 주 의
포 름 알 데 히 드	포 름 알 데 히 드
<<unk>> 소 리 어 울 림	<unk> 소 리 어 울 림
마 르 크 스 주 의	마 르 크 스 주 의
푸 르 스 름 하 다	푸 르 스 름 하 다
커 <<unk>> 니 케 이 션	커 <unk> 니 케 이 션
인 텔 리 <<unk>> 치 아	인 텔 리 <unk> 치 아
프 레 젠 테 이 션	프 레 젠 테 이 션
트 리 케 라 <<unk>> 스	트 리 케 라 <unk> 스
거 치 적 거 리 다	거 치 적 거 리 다
모 세 혈 관	모 세 혈 관
깜 박 깜 박	깜 박 깜 박
환 경 오 염	환 경 오 염
꼼 작 꼼 작	꼼 작 꼼 작
세 계 평 화	세 계 평 화
함 경 북 도	함 경 북 도
결 정 되 다	결 정 되 다
끔 뻑 끔 뻑	끔 뻑 끔 뻑
경 상 남 도	경 상 남 도
검 정 망 둑	검 정 망 둑
총 영 사 관	총 영 사 관
살 금 살 금	살 금 살 금
공 중 전 화	공 중 전 화
지 복 직 관	지 복 직 관
헬 스 클 럽	헬 스 클 럽
중 화 민 국	중 화 민 국
명 령 하 다	명 령 하 다
연 결 되 다	연 결 되 다
황 량 하 다	황 량 하 다
꿈 쩍 꿈 쩍	꿈 쩍 꿈 쩍
<<unk>> 법 소 년	<unk> 법 소 년
콜 록 콜 록	콜 록 콜 록
정 상 회 담	정 상 회 담
활 동 사 진	활 동 사 진
슬 쩍 슬 쩍	슬 쩍 슬 쩍
굼 실 굼 실	굼 실 굼 실
결 정 짓 다	결 정 짓 다
방 송 간 <<unk>>	방 송 간 <unk>
플 립 플 롭	플 립 플 롭
깜 <<unk>> 깜 <<unk>>	깜 <unk> 깜 <unk>
슬 금 슬 금	슬 금 슬 금
발 견 되 다	발 견 되 다
내 측 광 근	내 측 광 근
출 신 성 분	출 신 성 분
결 합 되 다	결 합 되 다
식 료 품 점	식 료 품 점
정 신 병 자	정 신 병 자
명 말 청 초	명 말 청 초
싱 글 싱 글	싱 글 싱 글
관 코 박 쥐	관 코 박 쥐
<<unk>> 쩍 <<unk>> 쩍	<unk> 쩍 <unk> 쩍
<<unk>> 뻑 <<unk>> 뻑	<unk> 뻑 <unk> 뻑
점 줄 망 둑	점 줄 망 둑
상 환 되 다	상 환 되 다
소 년 궁 전	소 년 궁 전
블 링 블 링	블 링 블 링
구 약 성 경	구 약 성 경
굼 적 굼 적	굼 적 굼 적
풍 덩 풍 덩	풍 덩 풍 덩
흥 청 망 청	흥 청 망 청
청 량 음 료	청 량 음 료
살 짝 살 짝	살 짝 살 짝
반 짝 반 짝	반 짝 반 짝
삼 십 육 계	삼 십 육 계
<<unk>> 벅 <<unk>> 벅	<unk> 벅 <unk> 벅
부 끄 러 워 하 다	부 끄 러 워 하 다
<<unk>> 실 트 리 다	<unk> 실 트 리 다
사 랑 스 럽 다	사 랑 스 럽 다
맞 부 <<unk>> 치 다	맞 부 <unk> 치 다
콜 레 스 테 롤	콜 레 스 테 롤
카 르 복 실 기	카 르 복 실 기
방 글 라 데 시	방 글 라 데 시
파 <<unk>> 치 하 다	파 <unk> 치 하 다
하 플 로 그 <<unk>>	하 플 로 그 <unk>
불 가 능 하 다	불 가 능 하 다
비 치 발 리 볼	비 치 발 리 볼
식 기 세 척 기	식 기 세 척 기
꼬 리 지 느 러 미	꼬 리 지 느 러 미
이 슬 라 마 바 드	이 슬 라 마 바 드
합 스 부 르 크	합 스 부 르 크
나 일 <<unk>> 라 피 아	나 일 <unk> 라 피 아
미 주 알 고 주 알	미 주 알 고 주 알
안 타 나 나 리 보	안 타 나 나 나 리 보
유 고 슬 라 비 아	유 고 슬 라 비 아
마 다 가 스 카 르	마 다 가 스 카 르
중 앙 아 메 리 카	중 앙 아 메 리 카
아 프 가 니 스 탄	아 프 가 니 스 탄
마 스 터 베 이 션	마 스 터 베 이 션
코 로 나 비 루 스	코 로 나 비 루 스
북 마 케 도 니 아	북 마 케 도 니 아
리 우 데 자 네 이 루	리 우 데 자 네 이 루
아 파 르 트 헤 이 트	아 파 르 트 헤 이 트
편 <<unk>> 으 시 다	편 <unk> 으 시 다
끔 적 끔 적	끔 적 끔 적
함 경 남 도	함 경 남 도
변 변 하 다	변 변 하 다
방 위 산 업 체	방 위 산 업 체
엄 지 손 가 락	엄 지 손 가 락
자 연 스 럽 다	자 연 스 럽 다
품 <<unk>> 음 하 다	품 <unk> 음 하 다
보 잘 것 없 다	보 잘 것 없 다
임 실 납 자 루	임 실 납 자 루
자 랑 스 럽 다	자 랑 스 럽 다
고 집 스 럽 다	고 집 스 럽 다
이 슬 람 국 가	이 슬 람 국 가
간 질 거 리 다	간 질 거 리 다
풍 력 단 지	풍 력 단 지
비 밀 스 럽 다	비 밀 스 럽 다
이 산 화 탄 소	이 산 화 탄 소
슬 로 벤 스 꼬	슬 로 벤 스 꼬
헤 모 글 로 빈	헤 모 글 로 빈
트 롱 프 뢰 유	트 롱 프 뢰 유
공 산 주 의 자	공 산 주 의 자
불 필 요 하 다	불 필 요 하 다
말 <<unk>> 꾸 러 기	말 <unk> 꾸 러 기
고 통 스 럽 다	고 통 스 럽 다
큰 바 다 사 자	큰 바 다 사 자
스 트 리 크 닌	스 트 리 크 닌
고 <<unk>> 습 니 다	고 <unk> 습 니 다
번 쩍 번 쩍	번 쩍 번 쩍
<<unk>> 럭 <<unk>> 럭	<unk> 럭 <unk> 럭
꼼 실 꼼 실	꼼 실 꼼 실
관 광 버 스	관 광 버 스
끔 벅 끔 벅	끔 벅 끔 벅
광 견 병	광 견 병
북 두 칠 성	북 두 칠 성
부 정 적 분	부 정 적 분
운 동 공 원	운 동 공 원
감 자 튀 김	감 자 튀 김
해 결 되 다	해 결 되 다
고 등 학 교	고 등 학 교
횡 단 보 도	횡 단 보 도
발 뒤 꿈 치	발 뒤 꿈 치
반 신 반 인	반 신 반 인
대 중 교 통	대 중 교 통
대 한 민 국	대 한 민 국
대 중 문 화	대 중 문 화
적 반 하 장	적 반 하 장
연 결 하 다	연 결 하 다
부 정 관 사	부 정 관 사
돌 연 변 이	돌 연 변 이
활 발 하 다	활 발 하 다
카 복 실 산	카 복 실 산
크 림 반 도	크 림 반 도
충 청 북 도	충 청 북 도
간 편 하 다	간 편 하 다
강 <<unk>> 하 다	강 <unk> 하 다
엉 망 진 창	엉 망 진 창
안 면 승 마	안 면 승 마
물 결 길 이	물 결 길 이
확 실 하 다	확 실 하 다
관 계 없 이	관 계 없 이
특 별 하 다	특 별 하 다
인 종 차 별	인 종 차 별
활 동 하 다	활 동 하 다
평 안 남 도	평 안 남 도
녀 성 중 음	녀 성 중 음
경 영 하 다	경 영 하 다
훈 민 정 음	훈 민 정 음
전 신 케 블	전 신 케 블
<<unk>> 가 락 질	<unk> 가 락 질
다 크 서 클	다 크 서 클
한 정 되 다	한 정 되 다
작 은 <<unk>> 쥐	작 은 <unk> 쥐
플 루 토 늄	플 루 토 늄
적 용 되 다	적 용 되 다
표 현 하 다	표 현 하 다
평 범 하 다	평 범 하 다
노 동 계 급	노 동 계 급
<<unk>> 손 하 다	<unk> 손 하 다
미 합 중 국	미 합 중 국
테 크 네 <<unk>>	테 크 네 <unk>
김 일 성 화	김 일 성 화
불 편 하 다	불 편 하 다
잘 못 되 다	잘 못 되 다
노 면 전 차	노 면 전 차
영 양 실 조	영 양 실 조
분 명 하 다	분 명 하 다
유 가 증 권	유 가 증 권
설 명 하 다	설 명 하 다
관 련 성	관 련 성
경 멸 적	경 멸 적
관 광 학	관 광 학
방 광 염	방 광 염
영 향 력	영 향 력
기 린 영 양	기 린 영 양
집 중 되 다	집 중 되 다
트 로 필 륨	트 로 필 륨
만 유 인 력	만 유 인 력
작 심 삼 일	작 심 삼 일
스 트 론 <<unk>>	스 트 론 <unk>
클 라 리 <<unk>>	클 라 리 <unk>
젖 가 공 품	젖 가 공 품
증 명 하 다	증 명 하 다
손 가 락 질	손 가 락 질
신 탁 통 치	신 탁 통 치
올 통 볼 통	올 통 볼 통
물 리 화 학	물 리 화 학
<<unk>> 나 졸 린	<unk> 나 졸 린
발 견 하 다	발 견 하 다
<<unk>> 플 <<unk>> 스	<unk> 플 <unk> 스
전 화 번 호	전 화 번 호
등 장 인 물	등 장 인 물
관 찰 하 다	관 찰 하 다
울 란 바 토 르	울 란 바 토 르
미 성 숙 하 다	미 성 숙 하 다
시 장 하 시 다	시 장 하 시 다
채 식 주 의 자	채 식 주 의 자
야 무 수 크 로	야 무 수 크 로
설 거 지 하 다	설 거 지 하 다
무 뚝 뚝 하 다	무 뚝 뚝 하 다
바 람 직 하 다	바 람 직 하 다
쓰 딸 로 바 야	쓰 딸 로 바 야
저 널 리 스 트	저 널 리 스 트
두 근 거 리 다	두 근 거 리 다
물 푸 레 나 무	물 푸 레 나 무
베 스 트 셀 러	베 스 트 셀 러
오 드 콜 로 뉴	오 드 콜 로 뉴
되 풀 이 하 다	되 풀 이 하 다
엘 살 바 도 르	엘 살 바 도 르
멜 로 드 라 마	멜 로 드 라 마
기 회 주 의 자	기 회 주 의 자
불 가 피 하 다	불 가 피 하 다
카 르 빌 아 민	카 르 빌 아 민
파 이 프 오 르 간	파 이 프 오 르 간
사 우 디 아 라 비 아	사 우 디 아 라 비 아
에 어 컨 디 셔 너	에 어 컨 디 셔 너
에 스 <<unk>> 레 이 터	에 스 <unk> 레 이 터
헤 파 이 스 토 스	헤 파 이 스 토 스
코 트 디 부 아 르	코 트 디 부 아 르
스 케 이 트 보 드	스 케 이 트 보 드
드 라 이 브 하 다	드 라 이 브 하 다
아 스 파 라 거 스	아 스 파 라 거 스
아 제 르 바 이 잔	아 제 르 바 이 잔
김 정 일 화	김 정 일 화
게 스 트 하 우 스	게 스 트 하 우 스
아 랍 에 미 리 트	아 랍 에 미 리 트
슬 로 베 니 아 어	슬 로 베 니 아 어
<<unk>> 웃 거 리 다	<unk> 웃 거 리 다
인 플 루 엔 자	인 플 루 엔 자
용 비 어 천 가	용 비 어 천 가
스 푸 트 니 크	스 푸 트 니 크
무 정 부 주 의	무 정 부 주 의
암 스 테 르 담	암 스 테 르 담
고 기 겹 빵	고 기 겹 빵
탄 수 화 물	탄 수 화 물
경 험 하 다	경 험 하 다
출 근 시 간	출 근 시 간
전 문 일 군	전 문 일 군
회 전 목 마	회 전 목 마
결 정 하 다	결 정 하 다
단 념 하 다	단 념 하 다
척 추 동 물	척 추 동 물
만 리 장 성	만 리 장 성
그 리 스 도 교	그 리 스 도 교
인 플 레 이 션	인 플 레 이 션
점 입 가 경	점 입 가 경
불 <<unk>> 하 다	불 <unk> 하 다
무 선 전 화	무 선 전 화
동 문 서 답	동 문 서 답
교 활 하 다	교 활 하 다
교 통 요 금	교 통 요 금
두 줄 망 둑	두 줄 망 둑
일 취 월 장	일 취 월 장
장 로 교 회	장 로 교 회
오 른 손 잡 이	오 른 손 잡 이
설 더 구 하 다	설 더 구 하 다
유 스 호 스 텔	유 스 호 스 텔
롤 러 코 스 터	롤 러 코 스 터
떠 들 <<unk>> 하 다	떠 들 <unk> 하 다
지 저 분 하 다	지 저 분 하 다
콘 도 미 니 엄	콘 도 미 니 엄
머 <<unk>> 거 리 다	머 <unk> 거 리 다
마 르 티 니 크	마 르 티 니 크
팔 레 스 타 인	팔 레 스 타 인
카 자 흐 스 탄	카 자 흐 스 탄
몬 테 네 그 로	몬 테 네 그 로
<<unk>> 시 코 시 티	<unk> 시 코 시 티
초 등 학 교	초 등 학 교
<<unk>> <<unk>> 하 <<unk>>	<unk> <unk> 하 <unk>
솔 선 수 범	솔 선 수 범
과 일 단 물	과 일 단 물
마 트 료 시 카	마 트 료 시 카
신 시 사 이 저	신 시 사 이 저
알 칼 로 이 드	알 칼 로 이 드
다 마 스 쿠 스	다 마 스 쿠 스
북 아 메 리 카	북 아 메 리 카
떨 어 뜨 리 다	떨 어 뜨 리 다
스 <<unk>> 어 디 스	스 <unk> 어 디 스
남 아 프 리 카	남 아 프 리 카
포 르 투 갈 어	포 르 투 갈 어
고 지 식 하 다	고 지 식 하 다
쇠 가 마 우 지	쇠 가 마 우 지
부 쿠 레 슈 티	부 쿠 레 슈 티
일 그 러 지 다	일 그 러 지 다
디 스 플 레 이	디 스 플 레 이
코 스 타 리 카	코 스 타 리 카
외 할 아 버 지	외 할 아 버 지
홍 머 리 오 리	홍 머 리 오 리
미 니 스 커 트	미 니 스 커 트
우 크 라 이 나 어	우 크 라 이 나 어
아 우 구 스 투 스	아 우 구 스 투 스
인 도 네 시 아 어	인 도 네 시 아 어
아 디 스 아 바 바	아 디 스 아 바 바 바
비 디 오 테 이 프	비 디 오 테 이 프
데 이 터 베 이 스	데 이 터 베 이 스
파 운 데 이 션	파 운 데 이 션
