աագխ	ɑ ɑ ɡ ə χ ə
աաի	ɑ ɑ i
աած	ɑ ɑ t͡s ə
աակ	ɑ ɑ k ə
աահ	ɑ ɑ h ə
աապ	ɑ ɑ p ə
աապվ	ɑ ɑ p ə v ə
աբա	ɑ b ɑ
աբական	ɑ b ɑ k ɑ n
աբաջյան	ɑ b ɑ d͡ʒ j ɑ n
աբաս	ɑ b ɑ s
աբբա	ɑ bː ɑ
աբբայուհի	ɑ bː ɑ j u h i
աբել	ɑ b ɛ l
աբեղա	ɑ b ɛ ʁ ɑ
աբեղայական	ɑ b ɛ ʁ ɑ j ɑ k ɑ n
աբեղուկ	ɑ b ɛ ʁ u k
աբիսողոմ	ɑ b i s ɔ ʁ ɔ m
աբխազ	ɑ pʰ χ ɑ z
աբխազական	ɑ pʰ χ ɑ z ɑ k ɑ n
աբխազերեն	ɑ pʰ χ ɑ z ɛ ɾ ɛ n
աբխազիա	ɑ pʰ χ ɑ z j ɑ
աբո	ɑ b ɔ
աբոնեմենտ	ɑ b ɔ n ɛ m ɛ n t
աբովյան	ɑ b ɔ v j ɑ n
աբորտ	ɑ b ɔ ɾ t
աբսոլյուտ	ɑ pʰ s ɔ l j u t
աբսուրդ	ɑ pʰ s u ɾ d
աբստրակտ	ɑ pʰ s t ɾ ɑ k t
աբստրակցիա	ɑ pʰ s t ɾ ɑ k t͡sʰ j ɑ
աբստրահվել	ɑ pʰ s t ɾ ɑ h v ɛ l
աբրա	ɑ b ɾ ɑ
աբրահամյան	ɑ b ɾ ɑ h ɑ m j ɑ n
աբրամ	ɑ b ɾ ɑ m
ագա	ɑ ɡ ɑ
ագաթ	ɑ ɡ ɑ tʰ
ագահաբար	ɑ ɡ ɑ h ɑ b ɑ ɾ
ագահորեն	ɑ ɡ ɑ h ɔ ɾ ɛ n
ագահություն	ɑ ɡ ɑ h u tʰ j u n
ագարակ	ɑ ɡ ɑ ɾ ɑ k
ագարակացնել	ɑ ɡ ɑ ɾ ɑ k ɑ t͡sʰ n ɛ l
ագարտալա	ɑ ɡ ɑ ɾ t ɑ l ɑ
ագն	ɑ ɡ ə n ə
ագնոստիկ	ɑ ɡ n ɔ s t i k
ագնոստիցիզմ	ɑ ɡ n ɔ s t i t͡sʰ i z m
ագուցահանել	ɑ ɡ u t͡sʰ ɑ h ɑ n ɛ l
ագուցանել	ɑ ɡ u t͡sʰ ɑ n ɛ l
ագուցել	ɑ ɡ u t͡sʰ ɛ l
ագուցվել	ɑ ɡ u t͡sʰ v ɛ l
ագռավ	ɑ ɡ r ɑ v
ագռավանալ	ɑ ɡ r ɑ v ɑ n ɑ l
ագրեսիա	ɑ ɡ ɾ ɛ s j ɑ
ագրիպպաս	ɑ ɡ ɾ i pː ɑ s
ադամ	ɑ d ɑ m
ադամաթուզ	ɑ d ɑ m ɑ tʰ u z
ադամանդ	ɑ d ɑ m ɑ n d
ադամանդագործ	ɑ d ɑ m ɑ n d ɑ ɡ ɔ ɾ t͡s
ադամանդագործական	ɑ d ɑ m ɑ n d ɑ ɡ ɔ ɾ t͡s ɑ k ɑ n
ադամանդվել	ɑ d ɑ m ɑ n d v ɛ l
ադանա	ɑ d ɑ n ɑ
ադլեր	ɑ d l ɛ ɾ
ադոնց	ɑ d ɔ n t͡sʰ
ադրբեջանական	ɑ d ə ɾ b ɛ d͡ʒ ɑ n ɑ k ɑ n
ադրբեջաներեն	ɑ d ə ɾ b ɛ d͡ʒ ɑ n ɛ ɾ ɛ n
ադրբեջանցի	ɑ d ə ɾ b ɛ d͡ʒ ɑ n t͡sʰ i
ադրիանապոլիս	ɑ d ɾ i j ɑ n ɑ p ɔ l i s
ադրիանոս	ɑ d ɾ i j ɑ n ɔ s
ազազանալ	ɑ z ɑ z ɑ n ɑ l
ազատ	ɑ z ɑ t
ազատագրվել	ɑ z ɑ t ɑ ɡ ə ɾ v ɛ l
ազատազրկել	ɑ z ɑ t ɑ z ə ɾ k ɛ l
ազատականացնել	ɑ z ɑ t ɑ k ɑ n ɑ t͡sʰ n ɛ l
ազատել	ɑ z ɑ t ɛ l
ազատություն	ɑ z ɑ t u tʰ j u n
ազգագրական	ɑ z ɡ ɑ ɡ ə ɾ ɑ k ɑ n
ազգայնականություն	ɑ z ɡ ɑ j n ɑ k ɑ n u tʰ j u n
ազգասեր	ɑ z ɡ ɑ s ɛ ɾ
ազգերի	ɑ z ɡ ɛ ɾ i
ազգություն	ɑ z ɡ u tʰ j u n
ազդակ	ɑ z d ɑ k
ազդանշան	ɑ z d ɑ n ə ʃ ɑ n
ազդարար	ɑ z d ɑ ɾ ɑ ɾ
ազդարարել	ɑ z d ɑ ɾ ɑ ɾ ɛ l
ազդեցություն	ɑ z d ɛ t͡sʰ u tʰ j u n
ազդվել	ɑ z d v ɛ l
ազդր	ɑ z d ə ɾ
ազերի	ɑ z ɛ ɾ i
ազնավուր	ɑ z n ɑ v u ɾ
ազնիվ	ɑ z n i v
ազնվական	ɑ z n ə v ɑ k ɑ n
ազոտ	ɑ z ɔ t
աթեիզմ	ɑ tʰ ɛ j i z m
աթեիստ	ɑ tʰ ɛ i s t
աթենք	ɑ tʰ ɛ ŋ kʰ
աթլաս	ɑ tʰ l ɑ s
աթլետիկա	ɑ tʰ l ɛ t i k ɑ
աթոռ	ɑ tʰ ɔ r
աթոռակ	ɑ tʰ ɔ r ɑ k
աթս	ɑ tʰ ə s ə
աժ	ɑ ʒ ə
աժան	ɑ ʒ ɑ n
աժդահա	ɑ ʒ d ɑ h ɑ
աժդահակ	ɑ ʒ d ɑ h ɑ k
ալ	ɑ l
ալադին	ɑ l ɑ d i n
ալազան	ɑ l ɑ z ɑ n
ալաժահրի	ɑ l ɑ ʒ ɑ h ɾ i
ալան	ɑ l ɑ n
ալանի	ɑ l ɑ n i
ալավերդի	ɑ l ɑ v ɛ ɾ d i
ալբաներեն	ɑ l b ɑ n ɛ ɾ ɛ n
ալբանիա	ɑ l b ɑ n j ɑ
ալբերտ	ɑ l b ɛ ɾ t
ալբոմ	ɑ l b ɔ m
ալեկոծ	ɑ l ɛ k ɔ t͡s
ալեմաներեն	ɑ l ɛ m ɑ n ɛ ɾ ɛ n
ալեւոր	ɑ l ɛ v ɔ ɾ
ալեքսանդրիա	ɑ l ɛ kʰ s ɑ n d ɾ j ɑ
ալի	ɑ l i
ալիբի	ɑ l i b i
ալիգատոր	ɑ l i ɡ ɑ t ɔ ɾ
ալիեւ	ɑ l i j ɛ v
ալինա	ɑ l i n ɑ
ալիք	ɑ l i kʰ
ալկաշ	ɑ l k ɑ ʃ
ալկոհոլ	ɑ l k ɔ h ɔ l
ալմաթի	ɑ l m ɑ tʰ i
ալմանախ	ɑ l m ɑ n ɑ χ
ալմաստ	ɑ l m ɑ s t
ալյանս	ɑ l j ɑ n s
ալյուր	ɑ l j u ɾ
ալոե	ɑ l ɔ ɛ
ալոճ	ɑ l ɔ t͡ʃ
ալուցք	ɑ l u t͡sʰ kʰ
ալպագա	ɑ l p ɑ ɡ ɑ
ալպեր	ɑ l p ɛ ɾ
ալպինիզմ	ɑ l p i n i z m
ալտ	ɑ l t
ալքիմիկոս	ɑ l kʰ i m i k ɔ s
ախալցխա	ɑ χ ɑ l t͡sʰ ə χ ɑ
ախալքալաք	ɑ χ ɑ l kʰ ɑ l ɑ kʰ
ախոռ	ɑ χ ɔ r
ախորժակ	ɑ χ ɔ ɾ ʒ ɑ k
ախուրյան	ɑ χ u ɾ j ɑ n
ախպար	ɑ χ p ɑ ɾ
ախպեր	ɑ χ p ɛ ɾ
ախտ	ɑ χ t
ախտաբան	ɑ χ t ɑ b ɑ n
ախտարար	ɑ χ t ɑ ɾ ɑ ɾ
ախտորոշել	ɑ χ t ɔ ɾ ɔ ʃ ɛ l
ախտորոշում	ɑ χ t ɔ ɾ ɔ ʃ u m
ած	ɑ t͡s
ածանցել	ɑ t͡s ɑ n t͡sʰ ɛ l
ածանցյալ	ɑ t͡s ɑ n t͡sʰ j ɑ l
ածել	ɑ t͡s ɛ l
ածելի	ɑ t͡s ɛ l i
ածեր	ɑ t͡s ɛ ɾ
ածու	ɑ t͡s u
ածուխ	ɑ t͡s u χ
ակ	ɑ k
ակադեմիա	ɑ k ɑ d ɛ m j ɑ
ական	ɑ k ɑ n
ականավոր	ɑ k ɑ n ɑ v ɔ ɾ
ականատես	ɑ k ɑ n ɑ t ɛ s
ականի	ɑ k ɑ n i
ականջ	ɑ k ɑ n d͡ʒ
ականջօղ	ɑ k ɑ n d͡ʒ ɔ ʁ
ակն	ɑ k ə n
ակնախնձոր	ɑ k n ɑ χ ə n d͡z ɔ ɾ
ակնածալից	ɑ k n ɑ t͡s ɑ l i t͡sʰ
ակնածանք	ɑ k n ɑ t͡s ɑ ŋ kʰ
ակնածել	ɑ k n ɑ t͡s ɛ l
ակնաղբյուր	ɑ k n ɑ χ p j u ɾ
ակնային	ɑ k n ɑ j i n
ակնարկ	ɑ k n ɑ ɾ k
ակներեւ	ɑ k n ɛ ɾ ɛ v
ակներեւաբար	ɑ k n ɛ ɾ ɛ v ɑ b ɑ ɾ
ակներեւապես	ɑ k n ɛ ɾ ɛ v ɑ p ɛ s
ակնթարթ	ɑ k ə n tʰ ɑ ɾ tʰ
ակնկալիք	ɑ k ə ŋ k ɑ l i kʰ
ակնհայտ	ɑ k ə n h ɑ j t
ակնոց	ɑ k n ɔ t͡sʰ
ակոս	ɑ k ɔ s
ակորդեոն	ɑ k ɔ ɾ d ɛ ɔ n
ակութ	ɑ k u tʰ
ակունք	ɑ k u ŋ kʰ
ակտիվ	ɑ k t i v
ակտիվորեն	ɑ k t i v ɔ ɾ ɛ n
ահ	ɑ h
ահաբեկում	ɑ h ɑ b ɛ k u m
ահաբեկչական	ɑ h ɑ b ɛ k t͡ʃʰ ɑ k ɑ n
ահաբեկչություն	ɑ h ɑ b ɛ k t͡ʃʰ u tʰ j u n
ահագին	ɑ h ɑ ɡ i n
ահագնանալ	ɑ h ɑ ɡ n ɑ n ɑ l
ահազանգում	ɑ h ɑ z ɑ ŋ ɡ u m
ահազդու	ɑ h ɑ z d u
ահարոն	ɑ h ɑ ɾ ɔ n
ահեղ	ɑ h ɛ ʁ
աղ	ɑ ʁ
աղա	ɑ ʁ ɑ
աղաթոն	ɑ ʁ ɑ tʰ ɔ n
աղալ	ɑ ʁ ɑ l
աղախին	ɑ ʁ ɑ χ i n
աղաղակ	ɑ ʁ ɑ ʁ ɑ k
աղաղակել	ɑ ʁ ɑ ʁ ɑ k ɛ l
աղանդավոր	ɑ ʁ ɑ n d ɑ v ɔ ɾ
աղանդավորական	ɑ ʁ ɑ n d ɑ v ɔ ɾ ɑ k ɑ n
աղանդավորություն	ɑ ʁ ɑ n d ɑ v ɔ ɾ u tʰ j u n
աղաչել	ɑ ʁ ɑ t͡ʃʰ ɛ l
աղասի	ɑ ʁ ɑ s i
աղավաղել	ɑ ʁ ɑ v ɑ ʁ ɛ l
աղավնի	ɑ ʁ ɑ v n i
աղբ	ɑ χ p
աղբաման	ɑ ʁ b ɑ m ɑ n
աղբանոց	ɑ χ p ɑ n ɔ t͡sʰ
աղբերակ	ɑ χ p ɛ ɾ ɑ k
աղբյուր	ɑ χ p j u ɾ
աղդամ	ɑ ʁ d ɑ m
աղեկ	ɑ ʁ ɛ k
աղեղ	ɑ ʁ ɛ ʁ
աղերս	ɑ ʁ ɛ ɾ s
աղերսել	ɑ ʁ ɛ ɾ s ɛ l
աղի	ɑ ʁ i
աղիճ	ɑ ʁ i t͡ʃ
աղիողորմ	ɑ ʁ i ɔ ʁ ɔ ɾ m
աղիք	ɑ ʁ i kʰ
աղխ	ɑ χː
աղճատել	ɑ χ t͡ʃ ɑ t ɛ l
աղմկել	ɑ ʁ m ə k ɛ l
աղմուկ	ɑ ʁ m u k
աղյուս	ɑ ʁ j u s
աղյուսակ	ɑ ʁ j u s ɑ k
աղյուսե	ɑ ʁ j u s ɛ
աղոթք	ɑ ʁ ɔ tʰ kʰ
աղու	ɑ ʁ u
աղունիկ	ɑ ʁ u n i k
աղջամուղջ	ɑ ʁ d͡ʒ ɑ m u ʁ d͡ʒ
աղջիկ	ɑ χ t͡ʃʰ i k
աղվանք	ɑ ʁ v ɑ ŋ kʰ
աղվես	ɑ ʁ v ɛ s
աղվեսենի	ɑ ʁ v ɛ s ɛ n i
աղվոր	ɑ ʁ v ɔ ɾ
աղտ	ɑ χ t
աղտոտել	ɑ χ t ɔ t ɛ l
աղցան	ɑ χ t͡sʰ ɑ n
աղքատ	ɑ χ kʰ ɑ t
աղքատները	ɑ χ kʰ ɑ t n ɛ ɾ ə
աղքատություն	ɑ χ kʰ ɑ t u tʰ j u n
աճառյան	ɑ t͡ʃ ɑ r j ɑ n
աճեմյան	ɑ t͡ʃ ɛ m j ɑ n
աճեցնել	ɑ t͡ʃ ɛ t͡sʰ n ɛ l
աճյուն	ɑ t͡ʃ j u n
աճուրդ	ɑ t͡ʃ u ɾ tʰ
աճպարարություն	ɑ t͡ʃ p ɑ ɾ ɑ ɾ u tʰ j u n
ամ	ɑ m
ամայի	ɑ m ɑ j i
աման	ɑ m ɑ n
ամանոր	ɑ m ɑ n ɔ ɾ
ամանորյա	ɑ m ɑ n ɔ ɾ j ɑ
ամաչել	ɑ m ɑ t͡ʃʰ ɛ l
ամաչկոտ	ɑ m ɑ t͡ʃʰ k ɔ t
ամառ	ɑ m ɑ r
ամառային	ɑ m ɑ r ɑ j i n
ամառանոց	ɑ m ɑ r ɑ n ɔ t͡sʰ
ամբակում	ɑ m b ɑ k u m
ամբաստանյալ	ɑ m b ɑ s t ɑ n j ɑ l
ամբաստանք	ɑ m b ɑ s t ɑ ŋ kʰ
ամբար	ɑ m b ɑ ɾ
ամբարիշտ	ɑ m b ɑ ɾ i ʃ t
ամբարտակ	ɑ m b ɑ ɾ t ɑ k
ամբարտավանություն	ɑ m b ɑ ɾ t ɑ v ɑ n u tʰ j u n
ամբոխ	ɑ m b ɔ χ
ամբողջ	ɑ m b ɔ χ t͡ʃʰ
ամբողջություն	ɑ m b ɔ χ t͡ʃʰ u tʰ j u n
ամեն	ɑ m ɛ n
ամենագետ	ɑ m ɛ n ɑ ɡ ɛ t
ամենազոր	ɑ m ɛ n ɑ z ɔ ɾ
ամենալավ	ɑ m ɛ n ɑ l ɑ v
ամենակալ	ɑ m ɛ n ɑ k ɑ l
ամենամեծ	ɑ m ɛ n ɑ m ɛ t͡s
ամենայն	ɑ m ɛ n ɑ j n
ամենուր	ɑ m ɛ n u ɾ
ամերիկա	ɑ m ɛ ɾ i k ɑ
ամերիկական	ɑ m ɛ ɾ i k ɑ k ɑ n
ամերիկայի	ɑ m ɛ ɾ i k ɑ j i
ամերիկացի	ɑ m ɛ ɾ i k ɑ t͡sʰ i
ամերիկյան	ɑ m ɛ ɾ i k j ɑ n
ամերիկուհի	ɑ m ɛ ɾ i k u h i
ամիս	ɑ m i s
ամիրա	ɑ m i ɾ ɑ
ամիրյան	ɑ m i ɾ j ɑ n
ամիրսպասալար	ɑ m i ɾ s p ɑ s ɑ l ɑ ɾ
ամն	ɑ m ə n ə
ամնիստիա	ɑ m n i s t j ɑ
ամոթ	ɑ m ɔ tʰ
ամորձիք	ɑ m ɔ ɾ d͡z i kʰ
ամուլ	ɑ m u l
ամուսին	ɑ m u s i n
ամուսնալուծություն	ɑ m u s n ɑ l u t͡s u tʰ j u n
ամուսնացած	ɑ m u s n ɑ t͡sʰ ɑ t͡s
ամուսնություն	ɑ m u s n u tʰ j u n
ամուր	ɑ m u ɾ
ամուրի	ɑ m u ɾ i
ամսագիր	ɑ m s ɑ ɡ i ɾ
ամսական	ɑ m s ɑ k ɑ n
ամսեկան	ɑ m s ɛ k ɑ n
ամստերդամ	ɑ m s t ɛ ɾ d ɑ m
ամրակ	ɑ m ɾ ɑ k
ամրակազմ	ɑ m ɾ ɑ k ɑ z m
ամրապնդում	ɑ m ɾ ɑ p ə n d u m
ամրոց	ɑ m ɾ ɔ t͡sʰ
ամփոփել	ɑ m pʰ ɔ pʰ ɛ l
այբ	ɑ j b
այբբենարան	ɑ j bː ɛ n ɑ ɾ ɑ n
այբուբեն	ɑ j b u b ɛ n
այգաբաց	ɑ j ɡ ɑ b ɑ t͡sʰ
այգեպան	ɑ j ɡ ɛ p ɑ n
այգեստան	ɑ j ɡ ɛ s t ɑ n
այգի	ɑ j ɡ i
այդուհանդերձ	ɑ j d u h ɑ n d ɛ ɾ t͡sʰ
այդտեղ	ɑ j d t ɛ ʁ
այժմ	ɑ j ʒ ə m
այժմու	ɑ j ʒ ə m u
այլ	ɑ j l
այլանդակություն	ɑ j l ɑ n d ɑ k u tʰ j u n
այլեւայլ	ɑ j l ɛ v ɑ j l
այլեւայլություն	ɑ j l ɛ v ɑ j l u tʰ j u n
այլեւս	ɑ j l ɛ v ə s
այլընտրանք	ɑ j l ə n t ɾ ɑ ŋ kʰ
այլընտրանքային	ɑ j l ə n t ɾ ɑ ŋ kʰ ɑ j i n
այծ	ɑ j t͡s
այծենի	ɑ j t͡s ɛ n i
այծյամ	ɑ j t͡s j ɑ m
այնուամենայնիվ	ɑ j n u ɑ m ɛ n ɑ j n i v
այնուհետեւ	ɑ j n u h ɛ t ɛ v
այնպես	ɑ j n p ɛ s
այնտեղ	ɑ j n t ɛ ʁ
այուբյան	ɑ j u b j ɑ n
այսինքն	ɑ j s i ŋ kʰ ə n
այսու	ɑ j s u
այսուամենայնիվ	ɑ j s u ɑ m ɛ n ɑ j n i v
այսուհանդերձ	ɑ j s u h ɑ n d ɛ ɾ t͡sʰ
այսուհետ	ɑ j s u h ɛ t
այսուհետեւ	ɑ j s u h ɛ t ɛ v
այստեղ	ɑ j s t ɛ ʁ
այստեղացի	ɑ j s t ɛ ʁ ɑ t͡sʰ i
այսրկովկասյան	ɑ j s ə ɾ k ɔ f k ɑ s j ɑ n
այսօր	ɑ j s ɔ ɾ
այվազյան	ɑ j v ɑ z j ɑ n
այտուց	ɑ j t u t͡sʰ
այրել	ɑ j ɾ ɛ l
այրի	ɑ j ɾ i
այրուկ	ɑ j ɾ u k
այց	ɑ j t͡sʰ
այցելել	ɑ j t͡sʰ ɛ l ɛ l
այցելություն	ɑ j t͡sʰ ɛ l u tʰ j u n
ան	ɑ n
անագորույն	ɑ n ɑ ɡ ɔ ɾ u j n
անազնիվ	ɑ n ɑ z n i v
անալի	ɑ n ɑ l i
անախորժ	ɑ n ɑ χ ɔ ɾ ʒ
անակ	ɑ n ɑ k
անակնկալ	ɑ n ɑ k ə ŋ k ɑ l
անահիտ	ɑ n ɑ h i t
անաղարտ	ɑ n ɑ ʁ ɑ ɾ t
անամոք	ɑ n ɑ m ɔ kʰ
անապատ	ɑ n ɑ p ɑ t
անասնաբույժ	ɑ n ɑ s n ɑ b u j ʒ
անաստաս	ɑ n ɑ s t ɑ s
անատոլիա	ɑ n ɑ t ɔ l j ɑ
անատոլիական	ɑ n ɑ t ɔ l j ɑ k ɑ n
անատոմիա	ɑ n ɑ t ɔ m j ɑ
անարատ	ɑ n ɑ ɾ ɑ t
անարդարություն	ɑ n ɑ ɾ tʰ ɑ ɾ u tʰ j u n
անարի	ɑ n ɑ ɾ i
անաքսիմանդրոս	ɑ n ɑ kʰ s i m ɑ n d ɾ ɔ s
անբարյացկամ	ɑ n b ɑ ɾ j ɑ t͡sʰ k ɑ m
անբիծ	ɑ n b i t͡s
անբնակ	ɑ n b ə n ɑ k
անբովանդակ	ɑ n b ɔ v ɑ n d ɑ k
անգ	ɑ ŋ ɡ
անգամ	ɑ ŋ kʰ ɑ m
անգեղ	ɑ ŋ ɡ ɛ ʁ
անգինա	ɑ ŋ ɡ i n ɑ
անգիր	ɑ ŋ ɡ i ɾ
անգլերեն	ɑ ŋ ɡ l ɛ ɾ ɛ n
անգլիա	ɑ ŋ ɡ l j ɑ
անգլիացի	ɑ ŋ ɡ l j ɑ t͡sʰ i
անգլուհի	ɑ ŋ ɡ l u h i
անգղ	ɑ ŋ ɡ ə ʁ
անգնահատելի	ɑ ŋ ɡ ə n ɑ h ɑ t ɛ l i
անգործ	ɑ ŋ ɡ ɔ ɾ t͡s
անդ	ɑ n d
անդադար	ɑ n d ɑ tʰ ɑ ɾ
անդամ	ɑ n tʰ ɑ m
անդամալուծություն	ɑ n tʰ ɑ m ɑ l u t͡s u tʰ j u n
անդամակից	ɑ n tʰ ɑ m ɑ k i t͡sʰ
անդաստան	ɑ n d ɑ s t ɑ n
անդեր	ɑ n d ɛ ɾ
անդորր	ɑ n d ɔ ɾː
անդորրագիր	ɑ n d ɔ ɾː ɑ ɡ i ɾ
անդունդ	ɑ n d u n d
անդրադառնալ	ɑ n d ɾ ɑ d ɑ r n ɑ l
անդրանիկ	ɑ n d ɾ ɑ n i k
անդրավարտիք	ɑ n d ɾ ɑ v ɑ ɾ t i kʰ
անդրի	ɑ n d ɾ i
անդրկովկաս	ɑ n d ə ɾ k ɔ f k ɑ s
անդրկովկասյան	ɑ n d ə ɾ k ɔ f k ɑ s j ɑ n
անդրշիրիմյան	ɑ n d ə ɾ ʃ i ɾ i m j ɑ n
անդրջրհեղեղյան	ɑ n d ə ɾ d͡ʒ ə ɾ h ɛ ʁ ɛ ʁ j ɑ n
անեզական	ɑ n ɛ z ɑ k ɑ n
անել	ɑ n ɛ l
անելիք	ɑ n ɛ l i kʰ
անեծք	ɑ n ɛ t͡s kʰ
անեկդոտ	ɑ n ɛ k d ɔ t
աներ	ɑ n ɛ ɾ
աներկյուղ	ɑ n ɛ ɾ k j u ʁ
աներձագ	ɑ n ɛ ɾ d͡z ɑ kʰ
անզոր	ɑ n z ɔ ɾ
անթառամ	ɑ n tʰ ɑ r ɑ m
անթարշամ	ɑ n tʰ ɑ ɾ ʃ ɑ m
անթերի	ɑ n tʰ ɛ ɾ i
անժելա	ɑ n ʒ ɛ l ɑ
անիծել	ɑ n i t͡s ɛ l
անիծյալ	ɑ n i t͡s j ɑ l
անիմաստ	ɑ n i m ɑ s t
անիրավ	ɑ n i ɾ ɑ v
անխելք	ɑ n χ ɛ l kʰ
անխնա	ɑ n χ ə n ɑ
անծանոթ	ɑ n t͡s ɑ n ɔ tʰ
անկախ	ɑ ŋ k ɑ χ
անկանոն	ɑ ŋ k ɑ n ɔ n
անկաշկանդ	ɑ ŋ k ɑ ʃ k ɑ n d
անկասկած	ɑ ŋ k ɑ s k ɑ t͡s
անկարա	ɑ ŋ k ɑ ɾ ɑ
անկարելի	ɑ ŋ k ɑ ɾ ɛ l i
անկեղծություն	ɑ ŋ k ɛ χ t͡s u tʰ j u n
անկյալ	ɑ ŋ k j ɑ l
անկյուն	ɑ ŋ k j u n
անկում	ɑ ŋ k u m
անկուշտ	ɑ ŋ k u ʃ t
անհաղթ	ɑ n h ɑ χ tʰ
անհաղթելի	ɑ n h ɑ χ tʰ ɛ l i
անհամ	ɑ n h ɑ m
անհամբեր	ɑ n h ɑ m pʰ ɛ ɾ
անհամեստ	ɑ n h ɑ m ɛ s t
անհամեստորեն	ɑ n h ɑ m ɛ s t ɔ ɾ ɛ n
անհամեստություն	ɑ n h ɑ m ɛ s t u tʰ j u n
անհայտ	ɑ n h ɑ j t
անհանգիստ	ɑ n h ɑ ŋ ɡ i s t
անհանգստանալ	ɑ n h ɑ ŋ ɡ ə s t ɑ n ɑ l
անհապաղ	ɑ n h ɑ p ɑ ʁ
անհաջողություն	ɑ n h ɑ d͡ʒ ɔ ʁ u tʰ j u n
անհասանելի	ɑ n h ɑ s ɑ n ɛ l i
անհավանական	ɑ n h ɑ v ɑ n ɑ k ɑ n
անհատ	ɑ n h ɑ t
անհատակ	ɑ n h ɑ t ɑ k
անհատականություն	ɑ n h ɑ t ɑ k ɑ n u tʰ j u n
անհեթեթություն	ɑ n h ɛ tʰ ɛ tʰ u tʰ j u n
անհեռանկարային	ɑ n h ɛ r ɑ n ə k ɑ ɾ ɑ j i n
անհետ	ɑ n h ɛ t
անհետանալ	ɑ n h ɛ t ɑ n ɑ l
անհերքելի	ɑ n h ɛ ɾ kʰ ɛ l i
անհիմն	ɑ n h i m ə n
անհնար	ɑ n h ə n ɑ ɾ
անհուն	ɑ n h u n
անձ	ɑ n d͡z
անձամբ	ɑ n d͡z ɑ m pʰ
անձավ	ɑ n d͡z ɑ v
անձեռոց	ɑ n d͡z ɛ r ɔ t͡sʰ
անձինք	ɑ n d͡z i ŋ kʰ
անձիք	ɑ n d͡z i kʰ
անձնագիր	ɑ n d͡z n ɑ ɡ i ɾ
անձնական	ɑ n d͡z n ɑ k ɑ n
անձնանուն	ɑ n d͡z n ɑ n u n
անձնյա	ɑ n d͡z n j ɑ
անձրեւ	ɑ n d͡z ɾ ɛ v
անձրեւանոց	ɑ n d͡z ɾ ɛ v ɑ n ɔ t͡sʰ
անձրեւել	ɑ n d͡z ɾ ɛ v ɛ l
անճար	ɑ n t͡ʃ ɑ ɾ
անմահ	ɑ n m ɑ h
անմահություն	ɑ n m ɑ h u tʰ j u n
անմեղ	ɑ n m ɛ ʁ
անմեղություն	ɑ n m ɛ ʁ u tʰ j u n
անմեռ	ɑ n m ɛ r
անմիջաբար	ɑ n m i t͡ʃʰ ɑ b ɑ ɾ
անմիջական	ɑ n m i t͡ʃʰ ɑ k ɑ n
անմիջականորեն	ɑ n m i t͡ʃʰ ɑ k ɑ n ɔ ɾ ɛ n
անմիտ	ɑ n m i t
անմոռուկ	ɑ n m ɔ r u k
աննա	ɑ nː ɑ
աննամուս	ɑ nː ɑ m u s
աննկուն	ɑ nː ə k u n
աննման	ɑ nː ə m ɑ n
աննպաստ	ɑ nː ə p ɑ s t
աննվաճ	ɑ nː ə v ɑ t͡ʃ
անշարժ	ɑ n ʃ ɑ ɾ ʒ
անշեն	ɑ n ʃ ɛ n
անշշուկ	ɑ n ʃ ə ʃ u k
անշուշտ	ɑ n ʃ u ʃ t
անշուք	ɑ n ʃ u kʰ
անշրջելի	ɑ n ʃ ə ɾ d͡ʒ ɛ l i
անոթ	ɑ n ɔ tʰ
անոնք	ɑ n ɔ ŋ kʰ
անորոշ	ɑ n ɔ ɾ ɔ ʃ
անորոշելի	ɑ n ɔ ɾ ɔ ʃ ɛ l i
անորոշություն	ɑ n ɔ ɾ ɔ ʃ u tʰ j u n
անութ	ɑ n u tʰ
անուշահոտություն	ɑ n u ʃ ɑ h ɔ t u tʰ j u n
անուշավան	ɑ n u ʃ ɑ v ɑ n
անուրջ	ɑ n u ɾ d͡ʒ
անպայման	ɑ n p ɑ j m ɑ n
անպատեհ	ɑ n p ɑ t ɛ h
անպատրաստ	ɑ n p ɑ t ɾ ɑ s t
անպիտան	ɑ n p i t ɑ n
անջատ	ɑ n d͡ʒ ɑ t
անջատել	ɑ n d͡ʒ ɑ t ɛ l
անջրդի	ɑ n d͡ʒ ə ɾ tʰ i
անջրպետ	ɑ n d͡ʒ ə ɾ p ɛ t
անսասան	ɑ n s ɑ s ɑ n
անսպառ	ɑ n s p ɑ r
անվադող	ɑ n v ɑ d ɔ ʁ
անվախ	ɑ n v ɑ χ
անվայել	ɑ n v ɑ j ɛ l
անվանել	ɑ n v ɑ n ɛ l
անվանի	ɑ n v ɑ n i
անվասայլակ	ɑ n v ɑ s ɑ j l ɑ k
անվճռական	ɑ n v ə t͡ʃ r ɑ k ɑ n
անվճռականություն	ɑ n v ə t͡ʃ r ɑ k ɑ n u tʰ j u n
անվտանգության	ɑ n v ə t ɑ ŋ ɡ u tʰ j ɑ n
անվտանգություն	ɑ n v ə t ɑ ŋ ɡ u tʰ j u n
անտանանարիվու	ɑ n t ɑ n ɑ n ɑ ɾ i v u
անտառ	ɑ n t ɑ r
անտարբերություն	ɑ n t ɑ ɾ b ɛ ɾ u tʰ j u n
անտեր	ɑ n t ɛ ɾ
անտերունչ	ɑ n t ɛ ɾ u n t͡ʃʰ
անտի	ɑ n t i
անտիկ	ɑ n t i k
անտիոք	ɑ n t i ɔ kʰ
անտիոքացի	ɑ n t i ɔ kʰ ɑ t͡sʰ i
անտիոքոս	ɑ n t i ɔ kʰ ɔ s
անտիտավրոս	ɑ n t i t ɑ v ɾ ɔ s
անտիցիկլոն	ɑ n t i t͡sʰ i k l ɔ n
անտոնի	ɑ n t ɔ n i
անտոնիոս	ɑ n t ɔ n j ɔ s
անտուն	ɑ n t u n
անրադառնալ	ɑ n ɾ ɑ d ɑ r n ɑ l
անց	ɑ n t͡sʰ
անցած	ɑ n t͡sʰ ɑ t͡s
անցկացնել	ɑ n t͡sʰ k ɑ t͡sʰ n ɛ l
անցյալ	ɑ n t͡sʰ j ɑ l
անցնել	ɑ n t͡sʰ n ɛ l
անցողական	ɑ n t͡sʰ ɔ ʁ ɑ k ɑ n
անցում	ɑ n t͡sʰ u m
անցք	ɑ n t͡sʰ kʰ
անփույթ	ɑ n pʰ u j tʰ
անօգ	ɑ n ɔ kʰ
անօգուտ	ɑ n ɔ kʰ u t
անօդաչու	ɑ n ɔ tʰ ɑ t͡ʃʰ u
անօթեւան	ɑ n ɔ tʰ ɛ v ɑ n
աշակերտ	ɑ ʃ ɑ k ɛ ɾ t
աշակերտուհի	ɑ ʃ ɑ k ɛ ɾ t u h i
աշխաբադ	ɑ ʃ χ ɑ b ɑ d
աշխատակազմ	ɑ ʃ χ ɑ t ɑ k ɑ z m
աշխատակից	ɑ ʃ χ ɑ t ɑ k i t͡sʰ
աշխատանք	ɑ ʃ χ ɑ t ɑ ŋ kʰ
աշխատասեր	ɑ ʃ χ ɑ t ɑ s ɛ ɾ
աշխատավարձ	ɑ ʃ χ ɑ t ɑ v ɑ ɾ t͡sʰ
աշխատել	ɑ ʃ χ ɑ t ɛ l
աշխատող	ɑ ʃ χ ɑ t ɔ ʁ
աշխարհաբար	ɑ ʃ χ ɑ ɾ ɑ b ɑ ɾ
աշխարհագրական	ɑ ʃ χ ɑ ɾ ɑ ɡ ɾ ɑ k ɑ n
աշխարհագրություն	ɑ ʃ χ ɑ ɾ ɑ ɡ ɾ u tʰ j u n
աշխարհակալ	ɑ ʃ χ ɑ ɾ ɑ k ɑ l
աշխարհահայացք	ɑ ʃ χ ɑ ɾ ɑ h ɑ j ɑ t͡sʰ kʰ
աշխարհամաս	ɑ ʃ χ ɑ ɾ ɑ m ɑ s
աշխարհայացք	ɑ ʃ χ ɑ ɾ h ɑ j ɑ t͡sʰ kʰ
աշխարհային	ɑ ʃ χ ɑ ɾ ɑ j i n
աշխարհաքաղաքական	ɑ ʃ χ ɑ ɾ ɑ kʰ ɑ ʁ ɑ kʰ ɑ k ɑ n
աշխեն	ɑ ʃ χ ɛ n
աշխույժ	ɑ ʃ χ u j ʒ
աշկարա	ɑ ʃ k ɑ ɾ ɑ
աշոտ	ɑ ʃ ɔ t
աշոտյան	ɑ ʃ ɔ t j ɑ n
աշորա	ɑ ʃ ɔ ɾ ɑ
աշուղ	ɑ ʃ u ʁ
աշտարակ	ɑ ʃ t ɑ ɾ ɑ k
աուդիտոր	ɑ u d i t ɔ ɾ
աուլիս	ɑ u l i s
աչալուրջ	ɑ t͡ʃʰ ɑ l u ɾ d͡ʒ
աչք	ɑ t͡ʃʰ kʰ
ապա	ɑ p ɑ
ապաթարց	ɑ p ɑ tʰ ɑ ɾ t͡sʰ
ապակառուցողական	ɑ p ɑ k ɑ r u t͡sʰ ɔ ʁ ɑ k ɑ n
ապակատար	ɑ p ɑ k ɑ t ɑ ɾ
ապահարզան	ɑ p ɑ h ɑ ɾ z ɑ n
ապահով	ɑ p ɑ h ɔ v
ապահովանալ	ɑ p ɑ h ɔ v ɑ n ɑ l
ապահովել	ɑ p ɑ h ɔ v ɛ l
ապահովում	ɑ p ɑ h ɔ v u m
ապահովվել	ɑ p ɑ h ɔ vː ɛ l
ապաշրջափակել	ɑ p ɑ ʃ ə ɾ d͡ʒ ɑ pʰ ɑ k ɛ l
ապառաժ	ɑ p ɑ r ɑ ʒ
ապառնի	ɑ p ɑ r n i
ապավեն	ɑ p ɑ v ɛ n
ապավինել	ɑ p ɑ v i n ɛ l
ապատ	ɑ p ɑ t
ապարան	ɑ p ɑ ɾ ɑ n
ապարանջան	ɑ p ɑ ɾ ɑ n d͡ʒ ɑ n
ապարանք	ɑ p ɑ ɾ ɑ ŋ kʰ
ապարատ	ɑ p ɑ ɾ ɑ t
ապացույց	ɑ p ɑ t͡sʰ u j t͡sʰ
ապացուցանել	ɑ p ɑ t͡sʰ u t͡sʰ ɑ n ɛ l
ապացուցել	ɑ p ɑ t͡sʰ u t͡sʰ ɛ l
ապացուցում	ɑ p ɑ t͡sʰ u t͡sʰ u m
ապացուցվել	ɑ p ɑ t͡sʰ u t͡sʰ v ɛ l
ապենինյան	ɑ p ɛ n i n j ɑ n
ապեր	ɑ p ɛ ɾ
ապերջանիկ	ɑ p ɛ ɾ d͡ʒ ɑ n i k
ապիկար	ɑ p i k ɑ ɾ
ապիրատ	ɑ p i ɾ ɑ t
ապհ	ɑ p ə h ə
ապշել	ɑ p ʃ ɛ l
ապոլոնիա	ɑ p ɔ l ɔ n j ɑ
ապուլիա	ɑ p u l j ɑ
ապուխտ	ɑ p u χ t
ապուշ	ɑ p u ʃ
ապուր	ɑ p u ɾ
ապսպրել	ɑ p ə s p ɾ ɛ l
ապստամբել	ɑ p ə s t ɑ m b ɛ l
ապստամբություն	ɑ p ə s t ɑ m b u tʰ j u n
ապտակ	ɑ p t ɑ k
ապտակել	ɑ p t ɑ k ɛ l
ապրանք	ɑ p ɾ ɑ ŋ kʰ
ապրանքագիր	ɑ p ɾ ɑ ŋ kʰ ɑ ɡ i ɾ
ապրել	ɑ p ɾ ɛ l
ապրեսյան	ɑ p ɾ ɛ s j ɑ n
ապրիլ	ɑ p ɾ i l
ապրիլյան	ɑ p ɾ i l j ɑ n
ապրուստ	ɑ p ɾ u s t
ապօրինի	ɑ p ɔ ɾ i n i
աջ	ɑ t͡ʃʰ
աջակցել	ɑ t͡ʃʰ ɑ k t͡sʰ ɛ l
աջարիա	ɑ d͡ʒ ɑ ɾ j ɑ
առ	ɑ r
առած	ɑ r ɑ t͡s
առակ	ɑ r ɑ k
առայժմ	ɑ r ɑ j ʒ ə m
առանձին	ɑ r ɑ n d͡z i n
առանձնյակ	ɑ r ɑ n d͡z n j ɑ k
առանց	ɑ r ɑ n t͡sʰ
առանցք	ɑ r ɑ n t͡sʰ kʰ
առանցքային	ɑ r ɑ n t͡sʰ kʰ ɑ j i n
առապար	ɑ r ɑ p ɑ ɾ
առաջ	ɑ r ɑ t͡ʃʰ
առաջադեմ	ɑ r ɑ t͡ʃʰ ɑ d ɛ m
առաջադիմական	ɑ r ɑ t͡ʃʰ ɑ d i m ɑ k ɑ n
առաջադիմել	ɑ r ɑ t͡ʃʰ ɑ d i m ɛ l
առաջադիմություն	ɑ r ɑ t͡ʃʰ ɑ d i m u tʰ j u n
առաջավոր	ɑ r ɑ t͡ʃʰ ɑ v ɔ ɾ
առաջավորասիական	ɑ r ɑ t͡ʃʰ ɑ v ɔ ɾ ɑ s j ɑ k ɑ n
առաջարկ	ɑ r ɑ t͡ʃʰ ɑ ɾ k
առաջարկել	ɑ r ɑ t͡ʃʰ ɑ ɾ k ɛ l
առաջարկություն	ɑ r ɑ t͡ʃʰ ɑ ɾ k u tʰ j u n
առաջացում	ɑ r ɑ t͡ʃʰ ɑ t͡sʰ u m
առաջընթաց	ɑ r ɑ t͡ʃʰ ə n tʰ ɑ t͡sʰ
առաջիկա	ɑ r ɑ t͡ʃʰ i k ɑ
առաջնային	ɑ r ɑ t͡ʃʰ n ɑ j i n
առաջնորդ	ɑ r ɑ t͡ʃʰ n ɔ ɾ tʰ
առաջնորդել	ɑ r ɑ t͡ʃʰ n ɔ ɾ tʰ ɛ l
առաջնություն	ɑ r ɑ t͡ʃʰ n u tʰ j u n
առաստաղ	ɑ r ɑ s t ɑ ʁ
առավել	ɑ r ɑ v ɛ l
առավելագույն	ɑ r ɑ v ɛ l ɑ ɡ u j n
առավոտ	ɑ r ɑ v ɔ t
առավոտականչ	ɑ r ɑ v ɔ t ɑ k ɑ n t͡ʃʰ
առավոտյան	ɑ r ɑ v ɔ t j ɑ n
առատ	ɑ r ɑ t
առատության	ɑ r ɑ t u tʰ j ɑ n
առատություն	ɑ r ɑ t u tʰ j u n
առարկա	ɑ r ɑ ɾ k ɑ
առաքել	ɑ r ɑ kʰ ɛ l
առաքելյան	ɑ r ɑ kʰ ɛ l j ɑ n
առաքելություն	ɑ r ɑ kʰ ɛ l u tʰ j u n
առաքինի	ɑ r ɑ kʰ i n i
առաքյալ	ɑ r ɑ kʰ j ɑ l
առաքում	ɑ r ɑ kʰ u m
առերես	ɑ r ɛ ɾ ɛ s
առերեսում	ɑ r ɛ ɾ ɛ s u m
առերեսվել	ɑ r ɛ ɾ ɛ s v ɛ l
առեւանգել	ɑ r ɛ v ɑ ŋ ɡ ɛ l
առեւանգում	ɑ r ɛ v ɑ ŋ ɡ u m
առեւտուր	ɑ r ɛ f t u ɾ
առեւտրային	ɑ r ɛ f t ɾ ɑ j i n
առթիվ	ɑ r tʰ i v
առիթ	ɑ r i tʰ
առինջ	ɑ r i n d͡ʒ
առիք	ɑ r i kʰ
առկախ	ɑ r k ɑ χ
առկախել	ɑ r k ɑ χ ɛ l
առկայծ	ɑ r k ɑ j t͡s
առկայծել	ɑ r k ɑ j t͡s ɛ l
առկայծում	ɑ r k ɑ j t͡s u m
առկայծվել	ɑ r k ɑ j t͡s v ɛ l
առկայություն	ɑ r k ɑ j u tʰ j u n
առհավատչյա	ɑ r h ɑ v ɑ t t͡ʃʰ j ɑ
առձեռն	ɑ r d͡z ɛ r ə n
առյուծ	ɑ r j u t͡s
առն	ɑ r ə n
առնանդամ	ɑ r n ɑ n tʰ ɑ m
առնել	ɑ r n ɛ l
առնետ	ɑ r n ɛ t
առնետավազք	ɑ r n ɛ t ɑ v ɑ s kʰ
առնո	ɑ r n ɔ
առնվազն	ɑ r n ə v ɑ z n
առողջ	ɑ r ɔ χ t͡ʃʰ
առողջանալ	ɑ r ɔ χ t͡ʃʰ ɑ n ɑ l
առողջարան	ɑ r ɔ χ t͡ʃʰ ɑ ɾ ɑ n
առողջարար	ɑ r ɔ χ t͡ʃʰ ɑ ɾ ɑ ɾ
առողջացնել	ɑ r ɔ χ t͡ʃʰ ɑ t͡sʰ n ɛ l
առողջություն	ɑ r ɔ χ t͡ʃʰ u tʰ j u n
առու	ɑ r u
առույգ	ɑ r u j ɡ
առուշանյան	ɑ r u ʃ ɑ n j ɑ n
առջեւ	ɑ r t͡ʃʰ ɛ v
առտու	ɑ r t u
ասած	ɑ s ɑ t͡s
ասատրյան	ɑ s ɑ t ə ɾ j ɑ n
ասացվածք	ɑ s ɑ t͡sʰ v ɑ t͡s kʰ
ասել	ɑ s ɛ l
ասեղ	ɑ s ɛ ʁ
ասիա	ɑ s j ɑ
ասիական	ɑ s j ɑ k ɑ n
ասլանյան	ɑ s l ɑ n j ɑ n
ասկետիզմ	ɑ s k ɛ t i z m
ասորեստան	ɑ s ɔ ɾ ɛ s t ɑ n
ասորերեն	ɑ s ɔ ɾ ɛ ɾ ɛ n
ասորի	ɑ s ɔ ɾ i
ասորիք	ɑ s ɔ ɾ i kʰ
ասոցացնել	ɑ s ɔ t͡sʰ ɑ t͡sʰ n ɛ l
ասոցիացիա	ɑ s ɔ t͡sʰ j ɑ t͡sʰ j ɑ
ասուլիս	ɑ s u l i s
ասպաստան	ɑ s p ɑ s t ɑ n
ասպետ	ɑ s p ɛ t
ասպետական	ɑ s p ɛ t ɑ k ɑ n
ասպիրանտ	ɑ s p i ɾ ɑ n t
ասպնջական	ɑ s p ə n d͡ʒ ɑ k ɑ n
ասվի	ɑ s v i
աստանա	ɑ s t ɑ n ɑ
աստղ	ɑ s t ə ʁ
աստղաբան	ɑ s t ʁ ɑ b ɑ n
աստղագիտություն	ɑ s t ʁ ɑ ɡ i t u tʰ j u n
աստղադիտակ	ɑ s t ʁ ɑ d i t ɑ k
աստղադիտարան	ɑ s t ʁ ɑ d i t ɑ ɾ ɑ n
աստղակերպ	ɑ s t ʁ ɑ k ɛ ɾ p
աստղիկ	ɑ s t ʁ i k
աստված	ɑ s t v ɑ t͡s
աստվածաբան	ɑ s t v ɑ t͡s ɑ b ɑ n
աստվածաբանական	ɑ s t v ɑ t͡s ɑ b ɑ n ɑ k ɑ n
աստվածաբանություն	ɑ s t v ɑ t͡s ɑ b ɑ n u tʰ j u n
աստվածածանոթություն	ɑ s t v ɑ t͡s ɑ t͡s ɑ n ɔ tʰ u tʰ j u n
աստվածաշունչ	ɑ s t v ɑ t͡s ɑ ʃ u n t͡ʃʰ
աստվածատուր	ɑ s t v ɑ t͡s ɑ t u ɾ
աստվածեղեն	ɑ s t v ɑ t͡s ɛ ʁ ɛ n
աստվածուհի	ɑ s t v ɑ t͡s u h i
աստրոլաբ	ɑ s t ɾ ɔ l ɑ b
ասք	ɑ s kʰ
ասֆալտ	ɑ s f ɑ l t
ավագյան	ɑ v ɑ kʰ j ɑ n
ավազակ	ɑ v ɑ z ɑ k
ավազան	ɑ v ɑ z ɑ n
ավազաքար	ɑ v ɑ z ɑ kʰ ɑ ɾ
ավան	ɑ v ɑ n
ավանդ	ɑ v ɑ n d
ավանդական	ɑ v ɑ n d ɑ k ɑ n
ավանդել	ɑ v ɑ n d ɛ l
ավանդություն	ɑ v ɑ n d u tʰ j u n
ավատ	ɑ v ɑ t
ավար	ɑ v ɑ ɾ
ավարտ	ɑ v ɑ ɾ t
ավարտել	ɑ v ɑ ɾ t ɛ l
ավարտում	ɑ v ɑ ɾ t u m
ավարտուն	ɑ v ɑ ɾ t u n
ավարտված	ɑ v ɑ ɾ t v ɑ t͡s
ավարտվել	ɑ v ɑ ɾ t v ɛ l
ավգիաս	ɑ v ɡ i j ɑ s
ավգուստ	ɑ v ɡ u s t
ավել	ɑ v ɛ l
ավելացնել	ɑ v ɛ l ɑ t͡sʰ n ɛ l
ավելի	ɑ v ɛ l i
ավելնորդ	ɑ v ɛ l n ɔ ɾ tʰ
ավելորդ	ɑ v ɛ l ɔ ɾ tʰ
ավեստերեն	ɑ v ɛ s t ɛ ɾ ɛ n
ավետ	ɑ v ɛ t
ավետարան	ɑ v ɛ t ɑ ɾ ɑ n
ավետիս	ɑ v ɛ t i s
ավետիսյան	ɑ v ɛ t i s j ɑ n
ավետիք	ɑ v ɛ t i kʰ
ավետչեք	ɑ v ɛ t t͡ʃʰ ɛ kʰ
ավերակ	ɑ v ɛ ɾ ɑ k
ավերել	ɑ v ɛ ɾ ɛ l
ավիաընկերություն	ɑ v j ɑ ə ŋ k ɛ ɾ u tʰ j u n
ավիացիա	ɑ v j ɑ t͡sʰ j ɑ
ավիշ	ɑ v i ʃ
ավիրել	ɑ v i ɾ ɛ l
ավիցեննա	ɑ v i t͡sʰ ɛ nː ɑ
ավյուն	ɑ v j u n
ավստրալիա	ɑ f s t ɾ ɑ l j ɑ
ավստրալիական	ɑ f s t ɾ ɑ l j ɑ k ɑ n
ավստրալիացի	ɑ f s t ɾ ɑ l j ɑ t͡sʰ i
ավստրիա	ɑ f s t ɾ j ɑ
ավտո	ɑ f t ɔ
ավտոբուս	ɑ f t ɔ b u s
ավտոմեքենա	ɑ f t ɔ m ɛ kʰ ɛ n ɑ
ավտոպարկ	ɑ f t ɔ p ɑ ɾ k
ավտովարորդ	ɑ f t ɔ v ɑ ɾ ɔ ɾ tʰ
ավտոտնակ	ɑ f t ɔ t ə n ɑ k
ատաղձ	ɑ t ɑ ʁ d͡z
ատաղձագործ	ɑ t ɑ ʁ d͡z ɑ ɡ ɔ ɾ t͡s
ատամ	ɑ t ɑ m
ատաման	ɑ t ɑ m ɑ n
ատամնաբույժ	ɑ t ɑ m n ɑ b u j ʒ
ատամնային	ɑ t ɑ m n ɑ j i n
ատամները	ɑ t ɑ m n ɛ ɾ ə
ատել	ɑ t ɛ l
ատելություն	ɑ t ɛ l u tʰ j u n
ատեն	ɑ t ɛ n
ատենախոսություն	ɑ t ɛ n ɑ χ ɔ s u tʰ j u n
ատեստատ	ɑ t ɛ s t ɑ t
ատկատ	ɑ t k ɑ t
ատյան	ɑ t j ɑ n
ատրագույն	ɑ t ɾ ɑ ɡ u j n
ատրճան	ɑ t ə ɾ t͡ʃ ɑ n
ատրճանակ	ɑ t ə ɾ t͡ʃ ɑ n ɑ k
ատրպատական	ɑ t ə ɾ p ɑ t ɑ k ɑ n
ար	ɑ ɾ
արա	ɑ ɾ ɑ
արագ	ɑ ɾ ɑ ɡ
արագածոտն	ɑ ɾ ɑ ɡ ɑ t͡s ɔ t ə n
արագաշարժ	ɑ ɾ ɑ ɡ ɑ ʃ ɑ ɾ ʒ
արագացում	ɑ ɾ ɑ ɡ ɑ t͡sʰ u m
արագիլ	ɑ ɾ ɑ ɡ i l
արագություն	ɑ ɾ ɑ ɡ u tʰ j u n
արած	ɑ ɾ ɑ t͡s
արաղ	ɑ ɾ ɑ ʁ
արամ	ɑ ɾ ɑ m
արամազդ	ɑ ɾ ɑ m ɑ z d
արամանյակ	ɑ ɾ ɑ m ɑ n j ɑ k
արամեացի	ɑ ɾ ɑ m ɛ ɑ t͡sʰ i
արամեերեն	ɑ ɾ ɑ m ɛː ɾ ɛ n
արամերեն	ɑ ɾ ɑ m ɛ ɾ ɛ n
արամյան	ɑ ɾ ɑ m j ɑ n
արատ	ɑ ɾ ɑ t
արար	ɑ ɾ ɑ ɾ
արարած	ɑ ɾ ɑ ɾ ɑ t͡s
արարել	ɑ ɾ ɑ ɾ ɛ l
արարիչ	ɑ ɾ ɑ ɾ i t͡ʃʰ
արարողություն	ɑ ɾ ɑ ɾ ɔ ʁ u tʰ j u n
արարք	ɑ ɾ ɑ ɾ kʰ
արաց	ɑ ɾ ɑ t͡sʰ
արբանյակ	ɑ ɾ b ɑ n j ɑ k
արբուն	ɑ ɾ pʰ u n
արգանակ	ɑ ɾ ɡ ɑ n ɑ k
արգանդ	ɑ ɾ ɡ ɑ n d
արգանդային	ɑ ɾ ɡ ɑ n d ɑ j i n
արգանդափող	ɑ ɾ ɡ ɑ n d ɑ pʰ ɔ ʁ
արգել	ɑ ɾ kʰ ɛ l
արգելակ	ɑ ɾ kʰ ɛ l ɑ k
արգելել	ɑ ɾ kʰ ɛ l ɛ l
արգելոց	ɑ ɾ kʰ ɛ l ɔ t͡sʰ
արգելք	ɑ ɾ kʰ ɛ l kʰ
արգիշտի	ɑ ɾ ɡ i ʃ t i
արգոլիս	ɑ ɾ ɡ ɔ l i s
արգոն	ɑ ɾ ɡ ɔ n
արդար	ɑ ɾ tʰ ɑ ɾ
արդարադատություն	ɑ ɾ tʰ ɑ ɾ ɑ d ɑ t u tʰ j u n
արդարացի	ɑ ɾ tʰ ɑ ɾ ɑ t͡sʰ i
արդարացնել	ɑ ɾ tʰ ɑ ɾ ɑ t͡sʰ n ɛ l
արդեն	ɑ ɾ tʰ ɛ n
արդիականացում	ɑ ɾ d i j ɑ k ɑ n ɑ t͡sʰ u m
արդյունաբերական	ɑ ɾ tʰ j u n ɑ b ɛ ɾ ɑ k ɑ n
արդյունաբերություն	ɑ ɾ tʰ j u n ɑ b ɛ ɾ u tʰ j u n
արդյոք	ɑ ɾ tʰ j ɔ kʰ
արդուկ	ɑ ɾ d u k
արդուկել	ɑ ɾ tʰ u k ɛ l
արե	ɑ ɾ ɛ
արեգակնային	ɑ ɾ ɛ ɡ ɑ k n ɑ j i n
արեւածագ	ɑ ɾ ɛ v ɑ t͡s ɑ kʰ
արեւածաղիկ	ɑ ɾ ɛ v ɑ t͡s ɑ ʁ i k
արեւային	ɑ ɾ ɛ v ɑ j i n
արեւելագետ	ɑ ɾ ɛ v ɛ l ɑ ɡ ɛ t
արեւելագիտական	ɑ ɾ ɛ v ɛ l ɑ ɡ i t ɑ k ɑ n
արեւելահայ	ɑ ɾ ɛ v ɛ l ɑ h ɑ j
արեւելահայերեն	ɑ ɾ ɛ v ɛ l ɑ h ɑ j ɛ ɾ ɛ n
արեւելյան	ɑ ɾ ɛ v ɛ l j ɑ n
արեւելք	ɑ ɾ ɛ v ɛ l kʰ
արեւմուտք	ɑ ɾ ɛ v m u t kʰ
արթնանալ	ɑ ɾ tʰ n ɑ n ɑ l
արթնացնել	ɑ ɾ tʰ n ɑ t͡sʰ n ɛ l
արթուր	ɑ ɾ tʰ u ɾ
արժանապատվություն	ɑ ɾ ʒ ɑ n ɑ p ɑ t v u tʰ j u n
արժանի	ɑ ɾ ʒ ɑ n i
արժենալ	ɑ ɾ ʒ ɛ n ɑ l
արժույթ	ɑ ɾ ʒ u j tʰ
արի	ɑ ɾ i
արիական	ɑ ɾ j ɑ k ɑ n
արիություն	ɑ ɾ i j u tʰ j u n
արիստակես	ɑ ɾ i s t ɑ k ɛ s
արիստոտել	ɑ ɾ i s t ɔ t ɛ l
արիստոփանես	ɑ ɾ i s t ɔ pʰ ɑ n ɛ s
արխային	ɑ ɾ χ ɑ j i n
արծաթ	ɑ ɾ t͡s ɑ tʰ
արծաթի	ɑ ɾ t͡s ɑ tʰ i
արծիվ	ɑ ɾ t͡s i v
արծվաբույն	ɑ ɾ t͡s v ɑ b u j n
արծվի	ɑ ɾ t͡s v i
արծրուն	ɑ ɾ t͡s ɾ u n
արծրունյաց	ɑ ɾ t͡s ɾ u n j ɑ t͡sʰ
արկ	ɑ ɾ k
արկադի	ɑ ɾ k ɑ d i
արկադիոս	ɑ ɾ k ɑ d i j ɔ s
արկղ	ɑ ɾ k ə ʁ
արհեստական	ɑ ɾ h ɛ s t ɑ k ɑ n
արհեստանոց	ɑ ɾ h ɛ s t ɑ n ɔ t͡sʰ
արհեստավոր	ɑ ɾ h ɛ s t ɑ v ɔ ɾ
արձագանք	ɑ ɾ d͡z ɑ ɡ ɑ ŋ kʰ
արձագանքել	ɑ ɾ d͡z ɑ ɡ ɑ ŋ kʰ ɛ l
արձակ	ɑ ɾ t͡sʰ ɑ k
արձակել	ɑ ɾ t͡sʰ ɑ k ɛ l
արձակուրդ	ɑ ɾ t͡sʰ ɑ k u ɾ tʰ
արձան	ɑ ɾ d͡z ɑ n
արձանագրել	ɑ ɾ d͡z ɑ n ɑ ɡ ɾ ɛ l
արմ	ɑ ɾ m
արմավ	ɑ ɾ m ɑ v
արմավիր	ɑ ɾ m ɑ v i ɾ
արմատ	ɑ ɾ m ɑ t
արմեն	ɑ ɾ m ɛ n
արմենակ	ɑ ɾ m ɛ n ɑ k
արմին	ɑ ɾ m i n
արմինե	ɑ ɾ m i n ɛ
արյունաբանություն	ɑ ɾ j u n ɑ b ɑ n u tʰ j u n
արյունահոսել	ɑ ɾ j u n ɑ h ɔ s ɛ l
արյունահոսություն	ɑ ɾ j u n ɑ h ɔ s u tʰ j u n
արյունաքամ	ɑ ɾ j u n ɑ kʰ ɑ m
արյունոտ	ɑ ɾ j u n ɔ t
արշալույս	ɑ ɾ ʃ ɑ l u j s
արշակ	ɑ ɾ ʃ ɑ k
արշակունյաց	ɑ ɾ ʃ ɑ k u n j ɑ t͡sʰ
արշավ	ɑ ɾ ʃ ɑ v
արշավանք	ɑ ɾ ʃ ɑ v ɑ ŋ kʰ
արշիպելագ	ɑ ɾ ʃ i p ɛ l ɑ ɡ
արոնյան	ɑ ɾ ɔ n j ɑ n
արոտ	ɑ ɾ ɔ t
արոտավայր	ɑ ɾ ɔ t ɑ v ɑ j ɾ
արու	ɑ ɾ u
արույր	ɑ ɾ u j ɾ
արուսյակ	ɑ ɾ u s j ɑ k
արսեն	ɑ ɾ s ɛ n
արսենի	ɑ ɾ s ɛ n i
արվարձան	ɑ ɾ v ɑ ɾ d͡z ɑ n
արվեստ	ɑ ɾ v ɛ s t
արվեստագետ	ɑ ɾ v ɛ s t ɑ ɡ ɛ t
արտ	ɑ ɾ t
արտադրանք	ɑ ɾ t ɑ d ɾ ɑ ŋ kʰ
արտադրել	ɑ ɾ t ɑ d ɾ ɛ l
արտադրող	ɑ ɾ t ɑ d ɾ ɔ ʁ
արտադրություն	ɑ ɾ t ɑ d ɾ u tʰ j u n
արտակարգ	ɑ ɾ t ɑ k ɑ ɾ kʰ
արտահայտություն	ɑ ɾ t ɑ h ɑ j t u tʰ j u n
արտահանձնում	ɑ ɾ t ɑ h ɑ n d͡z n u m
արտահանում	ɑ ɾ t ɑ h ɑ n u m
արտահերթ	ɑ ɾ t ɑ h ɛ ɾ tʰ
արտաշատ	ɑ ɾ t ɑ ʃ ɑ t
արտաշես	ɑ ɾ t ɑ ʃ ɛ s
արտասահման	ɑ ɾ t ɑ s ɑ h m ɑ n
արտասահմանցի	ɑ ɾ t ɑ s ɑ h m ɑ n t͡sʰ i
արտասովոր	ɑ ɾ t ɑ s ɔ v ɔ ɾ
արտասունք	ɑ ɾ t ɑ s u ŋ kʰ
արտասուք	ɑ ɾ t ɑ s u kʰ
արտասվել	ɑ ɾ t ɑ s v ɛ l
արտավան	ɑ ɾ t ɑ v ɑ n
արտացոլում	ɑ ɾ t ɑ t͡sʰ ɔ l u m
արտաքին	ɑ ɾ t ɑ kʰ i n
արտաքո	ɑ ɾ t ɑ kʰ ɔ
արտաքուստ	ɑ ɾ t ɑ kʰ u s t
արտաքսել	ɑ ɾ t ɑ kʰ s ɛ l
արտոնագիր	ɑ ɾ t ɔ n ɑ ɡ i ɾ
արտորայք	ɑ ɾ t ɔ ɾ ɑ j kʰ
արցախ	ɑ ɾ t͡sʰ ɑ χ
արցախյան	ɑ ɾ t͡sʰ ɑ χ j ɑ n
արցունք	ɑ ɾ t͡sʰ u ŋ kʰ
արփենի	ɑ ɾ pʰ ɛ n i
արփի	ɑ ɾ pʰ i
արքա	ɑ ɾ kʰ ɑ
արքայադուստր	ɑ ɾ kʰ ɑ j ɑ d u s t ə ɾ
արքայական	ɑ ɾ kʰ ɑ j ɑ k ɑ n
արքայություն	ɑ ɾ kʰ ɑ j u tʰ j u n
արքունի	ɑ ɾ kʰ u n i
արքունիք	ɑ ɾ kʰ u n i kʰ
ափ	ɑ pʰ
ափափա	ɑ pʰ ɑ pʰ ɑ
ափի	ɑ pʰ i
ափսե	ɑ pʰ s ɛ
ափսոս	ɑ pʰ s ɔ s
աք	ɑ kʰ
աքաղաղ	ɑ kʰ ɑ ʁ ɑ ʁ
աքիլլեսյան	ɑ kʰ i lː ɛ s j ɑ n
աքլոր	ɑ kʰ l ɔ ɾ
աքսիոմ	ɑ kʰ s i j ɔ m
աքսոր	ɑ kʰ s ɔ ɾ
աքսորաբնակություն	ɑ kʰ s ɔ ɾ ɑ b ə n ɑ k u tʰ j u n
աքսորական	ɑ kʰ s ɔ ɾ ɑ k ɑ n
աքսորել	ɑ kʰ s ɔ ɾ ɛ l
աքսորյալ	ɑ kʰ s ɔ ɾ j ɑ l
աքսորում	ɑ kʰ s ɔ ɾ u m
աքսորվել	ɑ kʰ s ɔ ɾ v ɛ l
աֆարերեն	ɑ f ɑ ɾ ɛ ɾ ɛ n
աֆղան	ɑ f ʁ ɑ n
աֆղաներեն	ɑ f ʁ ɑ n ɛ ɾ ɛ n
աֆղանստան	ɑ f ʁ ɑ n ə s t ɑ n
աֆրիկա	ɑ f ɾ i k ɑ
աֆրիկական	ɑ f ɾ i k ɑ k ɑ n
աֆրիկացի	ɑ f ɾ i k ɑ t͡sʰ i
աֆրիկյան	ɑ f ɾ i k j ɑ n
բաբայան	b ɑ b ɑ j ɑ n
բաբաջանյան	b ɑ b ɑ d͡ʒ ɑ n j ɑ n
բաբելոն	b ɑ b ɛ l ɔ n
բաբլոյան	b ɑ b l ɔ j ɑ n
բագրատ	b ɑ ɡ ɾ ɑ t
բագրատունի	b ɑ ɡ ɾ ɑ t u n i
բագրատունյաց	b ɑ ɡ ɾ ɑ t u n j ɑ t͡sʰ
բադ	b ɑ d
բադարա	b ɑ d ɑ ɾ ɑ
բադմինտոն	b ɑ d m i n t ɔ n
բազա	b ɑ z ɑ
բազազ	b ɑ z ɑ z
բազալտ	b ɑ z ɑ l t
բազարդյուզյու	b ɑ z ɑ ɾ d j u z j u
բազե	b ɑ z ɛ
բազկաթոռ	b ɑ z k ɑ tʰ ɔ r
բազմագիտակարգային	b ɑ z m ɑ ɡ i t ɑ k ɑ ɾ kʰ ɑ j i n
բազմագույն	b ɑ z m ɑ ɡ u j n
բազմազան	b ɑ z m ɑ z ɑ n
բազմազանություն	b ɑ z m ɑ z ɑ n u tʰ j u n
բազմածաղիկ	b ɑ z m ɑ t͡s ɑ ʁ i k
բազմակնություն	b ɑ z m ɑ k ə n u tʰ j u n
բազմամարդ	b ɑ z m ɑ m ɑ ɾ tʰ
բազմանալ	b ɑ z m ɑ n ɑ l
բազմապատկիչ	b ɑ z m ɑ p ɑ t k i t͡ʃʰ
բազմապատկում	b ɑ z m ɑ p ɑ t k u m
բազմել	b ɑ z m ɛ l
բազմերանգ	b ɑ z m ɛ ɾ ɑ ŋ ɡ
բազմիցս	b ɑ z m i t͡sʰ ə s
բազմոց	b ɑ z m ɔ t͡sʰ
բազմություն	b ɑ z m u tʰ j u n
բազում	b ɑ z u m
բաթում	b ɑ tʰ u m
բաթումի	b ɑ tʰ u m i
բաժ	b ɑ ʒ
բաժակ	b ɑ ʒ ɑ k
բաժանել	b ɑ ʒ ɑ n ɛ l
բաժանորդ	b ɑ ʒ ɑ n ɔ ɾ tʰ
բաժանում	b ɑ ʒ ɑ n u m
բաժանվել	b ɑ ʒ ɑ n v ɛ l
բաժին	b ɑ ʒ i n
բալ	b ɑ l
բալալայկա	b ɑ l ɑ l ɑ j k ɑ
բալայան	b ɑ l ɑ j ɑ n
բալետ	b ɑ l ɛ t
բալթիկ	b ɑ l tʰ i k
բալիկ	b ɑ l i k
բալօղի	b ɑ l ɔ ʁ i
բախ	b ɑ χ
բախել	b ɑ χ ɛ l
բախյուն	b ɑ χ j u n
բախում	b ɑ χ u m
բախտ	b ɑ χ t
բակ	b ɑ k
բակո	b ɑ k ɔ
բակտերիա	b ɑ k t ɛ ɾ j ɑ
բահ	b ɑ h
բահամյան	b ɑ h ɑ m j ɑ n
բահրեյն	b ɑ h ɾ ɛ j n
բաղադրիչ	b ɑ ʁ ɑ d ɾ i t͡ʃʰ
բաղաձայն	b ɑ ʁ ɑ d͡z ɑ j n
բաղդադ	b ɑ ʁ d ɑ d
բաղդասարյան	b ɑ ʁ d ɑ s ɑ ɾ j ɑ n
բաղնիք	b ɑ ʁ n i kʰ
բաղչա	b ɑ χ t͡ʃʰ ɑ
բաճկոն	b ɑ t͡ʃ k ɔ n
բամբակ	b ɑ m b ɑ k
բամբասանք	b ɑ m b ɑ s ɑ ŋ kʰ
բայ	b ɑ j
բայդեն	b ɑ j d ɛ n
բայղուշ	b ɑ j ʁ u ʃ
բայոց	b ɑ j ɔ t͡sʰ
բայց	b ɑ j t͡sʰ
բան	b ɑ n
բանալ	b ɑ n ɑ l
բանակ	b ɑ n ɑ k
բանական	b ɑ n ɑ k ɑ n
բանականություն	b ɑ n ɑ k ɑ n u tʰ j u n
բանակցություն	b ɑ n ɑ k t͡sʰ u tʰ j u n
բանաձեւ	b ɑ n ɑ d͡z ɛ v
բանան	b ɑ n ɑ n
բանաստեղծ	b ɑ n ɑ s t ɛ χ t͡s
բանաստեղծուհի	b ɑ n ɑ s t ɛ χ t͡s u h i
բանավեճ	b ɑ n ɑ v ɛ t͡ʃ
բանավոր	b ɑ n ɑ v ɔ ɾ
բանբեր	b ɑ n b ɛ ɾ
բանգլադեշ	b ɑ ŋ ɡ l ɑ d ɛ ʃ
բանել	b ɑ n ɛ l
բանկ	b ɑ ŋ k
բաննա	b ɑ nː ɑ
բանջար	b ɑ n d͡ʒ ɑ ɾ
բանջարեղեն	b ɑ n d͡ʒ ɑ ɾ ɛ ʁ ɛ n
բանջուլ	b ɑ n d͡ʒ u l
բանսարկու	b ɑ n s ɑ ɾ k u
բանվոր	b ɑ n v ɔ ɾ
բանտ	b ɑ n t
բանտարկել	b ɑ n t ɑ ɾ k ɛ l
բանտարկյալ	b ɑ n t ɑ ɾ k j ɑ l
բանտարկություն	b ɑ n t ɑ ɾ k u tʰ j u n
բաշիբոզուկ	b ɑ ʃ i b ɔ z u k
բաշխել	b ɑ ʃ χ ɛ l
բաջանաղ	b ɑ d͡ʒ ɑ n ɑ ʁ
բաջի	b ɑ d͡ʒ i
բառ	b ɑ r
բառագիրք	b ɑ r ɑ ɡ i ɾ kʰ
բառադի	b ɑ r ɑ d i
բառախաղ	b ɑ r ɑ χ ɑ ʁ
բառակապակցություն	b ɑ r ɑ k ɑ p ɑ k t͡sʰ u tʰ j u n
բառապաշար	b ɑ r ɑ p ɑ ʃ ɑ ɾ
բառարան	b ɑ r ɑ ɾ ɑ n
բառացանկ	b ɑ r ɑ t͡sʰ ɑ ŋ k
բառգիրք	b ɑ r ɡ i ɾ kʰ
բառնալ	b ɑ r n ɑ l
բառույթ	b ɑ r u j tʰ
բասկետբոլ	b ɑ s k ɛ t b ɔ l
բավ	b ɑ v
բավական	b ɑ v ɑ k ɑ n
բավարար	b ɑ v ɑ ɾ ɑ ɾ
բավարարել	b ɑ v ɑ ɾ ɑ ɾ ɛ l
բավարացի	b ɑ v ɑ ɾ ɑ t͡sʰ i
բավարիա	b ɑ v ɑ ɾ j ɑ
բար	b ɑ ɾ
բարակ	b ɑ ɾ ɑ k
բարաք	b ɑ ɾ ɑ kʰ
բարբանջել	b ɑ ɾ b ɑ n d͡ʒ ɛ l
բարբաջանք	b ɑ ɾ b ɑ d͡ʒ ɑ ŋ kʰ
բարբառ	b ɑ ɾ b ɑ r
բարբառային	b ɑ ɾ b ɑ r ɑ j i n
բարբառել	b ɑ ɾ b ɑ r ɛ l
բարգավաճ	b ɑ ɾ ɡ ɑ v ɑ t͡ʃ
բարդի	b ɑ ɾ d i
բարդություն	b ɑ ɾ tʰ u tʰ j u n
բարդույթ	b ɑ ɾ tʰ u j tʰ
բարեգործական	b ɑ ɾ ɛ ɡ ɔ ɾ t͡s ɑ k ɑ n
բարելավել	b ɑ ɾ ɛ l ɑ v ɛ l
բարեկամ	b ɑ ɾ ɛ k ɑ m
բարեկամական	b ɑ ɾ ɛ k ɑ m ɑ k ɑ n
բարեկամություն	b ɑ ɾ ɛ k ɑ m u tʰ j u n
բարեկենդան	b ɑ ɾ ɛ k ɛ n tʰ ɑ n
բարեպաշտ	b ɑ ɾ ɛ p ɑ ʃ t
բարեպաշտություն	b ɑ ɾ ɛ p ɑ ʃ t u tʰ j u n
բարեւ	b ɑ ɾ ɛ v
բարեւել	b ɑ ɾ ɛ v ɛ l
բարեփոխում	b ɑ ɾ ɛ pʰ ɔ χ u m
բարի	b ɑ ɾ i
բարիկադ	b ɑ ɾ i k ɑ d
բարիշել	b ɑ ɾ i ʃ ɛ l
բարիք	b ɑ ɾ i kʰ
բարխուդարյան	b ɑ ɾ χ u d ɑ ɾ j ɑ n
բարկ	b ɑ ɾ k
բարկանալ	b ɑ ɾ k ɑ n ɑ l
բարկացած	b ɑ ɾ k ɑ t͡sʰ ɑ t͡s
բարկություն	b ɑ ɾ k u tʰ j u n
բարձ	b ɑ ɾ t͡sʰ
բարձիթողի	b ɑ ɾ t͡sʰ i tʰ ɔ ʁ i
բարձունք	b ɑ ɾ t͡sʰ u ŋ kʰ
բարձունքներ	b ɑ ɾ t͡sʰ u ŋ kʰ n ɛ ɾ
բարձր	b ɑ ɾ t͡sʰ ə ɾ
բարձրագույն	b ɑ ɾ t͡sʰ ɾ ɑ ɡ u j n
բարձրահասակ	b ɑ ɾ t͡sʰ ɾ ɑ h ɑ s ɑ k
բարձրաձայն	b ɑ ɾ t͡sʰ ɾ ɑ d͡z ɑ j n
բարձրաձայնել	b ɑ ɾ t͡sʰ ɾ ɑ d͡z ɑ j n ɛ l
բարձրավանդակ	b ɑ ɾ t͡sʰ ɾ ɑ v ɑ n d ɑ k
բարձրացնել	b ɑ ɾ t͡sʰ ɾ ɑ t͡sʰ n ɛ l
բարձրորակ	b ɑ ɾ t͡sʰ ɾ ɔ ɾ ɑ k
բարձրություն	b ɑ ɾ t͡sʰ ɾ u tʰ j u n
բարմեն	b ɑ ɾ m ɛ n
բարոյական	b ɑ ɾ ɔ j ɑ k ɑ n
բարոյականություն	b ɑ ɾ ɔ j ɑ k ɑ n u tʰ j u n
բարոն	b ɑ ɾ ɔ n
բարով	b ɑ ɾ ɔ v
բարսեղ	b ɑ ɾ s ɛ ʁ
բարսեղյան	b ɑ ɾ s ɛ ʁ j ɑ n
բարվոք	b ɑ ɾ v ɔ kʰ
բացականչական	b ɑ t͡sʰ ɑ k ɑ n t͡ʃʰ ɑ k ɑ n
բացականչել	b ɑ t͡sʰ ɑ k ɑ n t͡ʃʰ ɛ l
բացականչում	b ɑ t͡sʰ ɑ k ɑ n t͡ʃʰ u m
բացառապես	b ɑ t͡sʰ ɑ r ɑ p ɛ s
բացառել	b ɑ t͡sʰ ɑ r ɛ l
բացառիկ	b ɑ t͡sʰ ɑ r i k
բացառություն	b ɑ t͡sʰ ɑ r u tʰ j u n
բացառվել	b ɑ t͡sʰ ɑ r v ɛ l
բացատ	b ɑ t͡sʰ ɑ t
բացատրական	b ɑ t͡sʰ ɑ t ɾ ɑ k ɑ n
բացատրել	b ɑ t͡sʰ ɑ t ɾ ɛ l
բացարձակ	b ɑ t͡sʰ ɑ ɾ t͡sʰ ɑ k
բացել	b ɑ t͡sʰ ɛ l
բացի	b ɑ t͡sʰ i
բացորոշակի	b ɑ t͡sʰ ɔ ɾ ɔ ʃ ɑ k i
բացում	b ɑ t͡sʰ u m
բացօթյա	b ɑ t͡sʰ ɔ tʰ j ɑ
բաքու	b ɑ kʰ u
բեթհովեն	b ɛ tʰ h ɔ v ɛ n
բեթղեհեմ	b ɛ tʰ χ ɛ h ɛ m
բելառուս	b ɛ l ɑ r u s
բելառուսական	b ɛ l ɑ r u s ɑ k ɑ n
բելառուսերեն	b ɛ l ɑ r u s ɛ ɾ ɛ n
բելգիա	b ɛ l ɡ j ɑ
բելիսարիոս	b ɛ l i s ɑ ɾ i ɔ s
բեխաբար	b ɛ χ ɑ b ɑ ɾ
բեկել	b ɛ k ɛ l
բեկոր	b ɛ k ɔ ɾ
բեղ	b ɛ ʁ
բեղեր	b ɛ ʁ ɛ ɾ
բեղուն	b ɛ ʁ u n
բեմ	b ɛ m
բեյրութ	b ɛ j ɾ u tʰ
բենգալերեն	b ɛ ŋ ɡ ɑ l ɛ ɾ ɛ n
բենգալի	b ɛ ŋ ɡ ɑ l i
բենզալցակայան	b ɛ n z ɑ l ə t͡sʰ ɑ k ɑ j ɑ n
բենզասղոց	b ɛ n z ɑ s ə ʁ ɔ t͡sʰ
բենզին	b ɛ n z i n
բեովտիա	b ɛ ɔ f t j ɑ
բեռ	b ɛ r
բեռլին	b ɛ r l i n
բեռն	b ɛ r n
բեռնատար	b ɛ r n ɑ t ɑ ɾ
բեսեդկա	b i s ɛ d k ɑ
բեսթսելեր	b ɛ s tʰ s ɛ l ɛ ɾ
բեսիրաթ	b ɛ s i ɾ ɑ tʰ
բերանային	b ɛ ɾ ɑ n ɑ j i n
բերանացի	b ɛ ɾ ɑ n ɑ t͡sʰ i
բերդ	b ɛ ɾ tʰ
բերել	b ɛ ɾ ɛ l
բերման	b ɛ ɾ m ɑ n
բերում	b ɛ ɾ u m
բերրի	b ɛ ɾː i
բերք	b ɛ ɾ kʰ
բեւեռ	b ɛ v ɛ r
բեւեռային	b ɛ v ɛ r ɑ j i n
բժիշկ	b ə ʒ i ʃ k
բժշկել	b ə ʒ ə ʃ k ɛ l
բժշկություն	b ə ʒ ə ʃ k u tʰ j u n
բիբար	b i b ɑ ɾ
բիբլոս	b i b l ɔ s
բիզնեսմեն	b i z n ɛ s m ɛ n
բիթ	b i tʰ
բիլ	b i l
բիլակ	b i l ɑ k
բիծ	b i t͡s
բիհար	b i h ɑ ɾ
բիհարի	b i h ɑ ɾ i
բինտ	b i n t
բիսլամա	b i s l ɑ m ɑ
բիրմինգհեմ	b i ɾ m i ŋ ɡ h ɛ m
բիրտ	b i ɾ t
բիֆշտեքս	b i f ʃ t ɛ kʰ s
բլագովեշչենսկ	b l ɑ ɡ ɔ v ɛ ʃ t͡ʃʰ ɛ n s k
բլբուլ	b ə l b u l
բլիթ	b ə l i tʰ
բլնգազ	b ə l ə ŋ ɡ ɑ z
բլոգ	b l ɔ ɡ
բլոգեր	b ə l ɔ ɡ ɛ ɾ
բլոկ	b ə l ɔ k
բլուր	b ə l u ɾ
բղավել	b ə ʁ ɑ v ɛ l
բյուզանդացի	b j u z ɑ n d ɑ t͡sʰ i
բյուջե	b j u d͡ʒ ɛ
բյուջետային	b j u d͡ʒ ɛ t ɑ j i n
բյուր	b j u ɾ
բնագիր	b ə n ɑ ɡ i ɾ
բնազդ	b ə n ɑ z d
բնակարան	b ə n ɑ k ɑ ɾ ɑ n
բնակիչ	b ə n ɑ k i t͡ʃʰ
բնակչություն	b ə n ɑ k t͡ʃʰ u tʰ j u n
բնակվել	b ə n ɑ k v ɛ l
բնապատկեր	b ə n ɑ p ɑ t k ɛ ɾ
բնավորություն	b ə n ɑ v ɔ ɾ u tʰ j u n
բնորոշ	b ə n ɔ ɾ ɔ ʃ
բնորոշել	b ə n ɔ ɾ ɔ ʃ ɛ l
բնութագրել	b ə n u tʰ ɑ ɡ ə ɾ ɛ l
բնություն	b ə n u tʰ j u n
բոբիկ	b ɔ b i k
բոզավագ	b ɔ z ɑ v ɑ kʰ
բոթսվանա	b ɔ tʰ ə s v ɑ n ɑ
բոժոժ	b ɔ ʒ ɔ ʒ
բոլիվիա	b ɔ l i v j ɑ
բոլոնիա	b ɔ l ɔ n j ɑ
բոլոր	b ɔ l ɔ ɾ
բոլորակ	b ɔ l ɔ ɾ ɑ k
բոլորը	b ɔ l ɔ ɾ ə
բոխատերեւ	b ɔ χ ɑ t ɛ ɾ ɛ v
բոկոտն	b ɔ k ɔ t ə n
բող	b ɔ ʁ
բողբոջ	b ɔ ʁ b ɔ d͡ʒ
բողբոջել	b ɔ ʁ b ɔ d͡ʒ ɛ l
բողկ	b ɔ χ k
բողոքարկել	b ɔ ʁ ɔ kʰ ɑ ɾ k ɛ l
բողոքարկում	b ɔ ʁ ɔ kʰ ɑ ɾ k u m
բոյաջյան	b ɔ j ɑ d͡ʒ j ɑ n
բոյկոտ	b ɔ j k ɔ t
բոնուս	b ɔ n u s
բոշա	b ɔ ʃ ɑ
բոպլիկ	b ɔ p l i k
բոռ	b ɔ r
բոստան	b ɔ s t ɑ n
բովանդակային	b ɔ v ɑ n d ɑ k ɑ j i n
բովանդակություն	b ɔ v ɑ n d ɑ k u tʰ j u n
բովել	b ɔ v ɛ l
բոտոշան	b ɔ t ɔ ʃ ɑ n
բորան	b ɔ ɾ ɑ n
բորբոս	b ɔ ɾ b ɔ s
բորբոք	b ɔ ɾ b ɔ kʰ
բորբոքել	b ɔ ɾ b ɔ kʰ ɛ l
բորբոքում	b ɔ ɾ b ɔ kʰ u m
բորենի	b ɔ ɾ ɛ n i
բորժոմի	b ɔ ɾ ʒ ɔ m i
բորոտ	b ɔ ɾ ɔ t
բոց	b ɔ t͡sʰ
բոցեղեն	b ɔ t͡sʰ ɛ ʁ ɛ n
բու	b u
բուգ	b u ɡ
բուդ	b u d
բուդապեշտ	b u d ɑ p ɛ ʃ t
բուդդայականություն	b u dː ɑ j ɑ k ɑ n u tʰ j u n
բութ	b u tʰ
բուժել	b u ʒ ɛ l
բուժում	b u ʒ u m
բուժքույր	b u ʒ kʰ u j ɾ
բուլկի	b u l k i
բուլղարերեն	b u l ʁ ɑ ɾ ɛ ɾ ɛ n
բուլղարիա	b u l ʁ ɑ ɾ j ɑ
բուխ	b u χ
բուխարեստ	b u χ ɑ ɾ ɛ s t
բուխարիկ	b u χ ɑ ɾ i k
բուկովինա	b u k ɔ v i n ɑ
բուհ	b u h
բույլ	b u j l
բույն	b u j n
բույս	b u j s
բույր	b u j ɾ
բուն	b u n
բունոց	b u n ɔ t͡sʰ
բուռ	b u r
բուսաբանություն	b u s ɑ b ɑ n u tʰ j u n
բուսակեր	b u s ɑ k ɛ ɾ
բուսակերություն	b u s ɑ k ɛ ɾ u tʰ j u n
բուրաստան	b u ɾ ɑ s t ɑ n
բուրբոն	b u ɾ b ɔ n
բուրգ	b u ɾ ɡ
բուրգեր	b u ɾ ɡ ɛ ɾ
բուրդ	b u ɾ tʰ
բուրմունք	b u ɾ m u ŋ kʰ
բուրում	b u ɾ u m
բուրունդի	b u ɾ u n d i
բուք	b u kʰ
բոքս	b ɔ kʰ s
բջիջ	b ə d͡ʒ i d͡ʒ
բջջաբանական	b ə d͡ʒ ə d͡ʒ ɑ b ɑ n ɑ k ɑ n
բջջային	b ə d͡ʒ ə d͡ʒ ɑ j i n
բռի	b ə r i
բռնաբար	b ə r n ɑ b ɑ ɾ
բռնաբարել	b ə r n ɑ b ɑ ɾ ɛ l
բռնաբարություն	b ə r n ɑ b ɑ ɾ u tʰ j u n
բռնազավթում	b ə r n ɑ z ɑ f tʰ u m
բռնակալ	b ə r n ɑ k ɑ l
բռնապետ	b ə r n ɑ p ɛ t
բռնել	b ə r n ɛ l
բռնություն	b ə r n u tʰ j u n
բռունցք	b ə r u n t͡sʰ kʰ
բտել	b ə t ɛ l
բրազիլիա	b ɾ ɑ z i l j ɑ
բրդյա	b ə ɾ tʰ j ɑ
բրետ	b ə ɾ ɛ t
բրինձ	b ə ɾ i n d͡z
բրիտանական	b ɾ i t ɑ n ɑ k ɑ n
բրիտանիա	b ɾ i t ɑ n j ɑ
բրյուսել	b ɾ j u s ɛ l
բրոմ	b ɾ ɔ m
բրոնզ	b ə ɾ ɔ n z
բրոունյան	b ɾ ɔ u n j ɑ n
բրունեյ	b ɾ u n ɛ j
բրուցելոզ	b ɾ u t͡sʰ ɛ l ɔ z
գաբրիել	ɡ ɑ pʰ ɾ i j ɛ l
գագաթ	ɡ ɑ ɡ ɑ tʰ
գագաթնաժողով	ɡ ɑ ɡ ɑ tʰ n ɑ ʒ ɔ ʁ ɔ v
գագիկ	ɡ ɑ ɡ i k
գագրա	ɡ ɑ ɡ ɾ ɑ
գազ	ɡ ɑ z
գազա	ɡ ɑ z ɑ
գազայի	ɡ ɑ z ɑ j i
գազան	ɡ ɑ z ɑ n
գազանանոց	ɡ ɑ z ɑ n ɑ n ɔ t͡sʰ
գազանություն	ɡ ɑ z ɑ n u tʰ j u n
գազոն	ɡ ɑ z ɔ n
գալ	ɡ ɑ l
գալակտիկական	ɡ ɑ l ɑ k t i k ɑ k ɑ n
գալարվել	ɡ ɑ l ɑ ɾ v ɛ l
գալիլեա	ɡ ɑ l i l ɛ j ɑ
գալիլիա	ɡ ɑ l i l j ɑ
գալիում	ɡ ɑ l i j u m
գալիս	ɡ ɑ l i s
գալուստ	ɡ ɑ l u s t
գալստյան	ɡ ɑ l ə s t j ɑ n
գալստուկ	ɡ ɑ l s t u k
գահ	ɡ ɑ h
գահակալել	ɡ ɑ h ɑ k ɑ l ɛ l
գաղափար	ɡ ɑ ʁ ɑ pʰ ɑ ɾ
գաղափարագիր	ɡ ɑ ʁ ɑ pʰ ɑ ɾ ɑ ɡ i ɾ
գաղափարախոս	ɡ ɑ ʁ ɑ pʰ ɑ ɾ ɑ χ ɔ s
գաղափարախոսական	ɡ ɑ ʁ ɑ pʰ ɑ ɾ ɑ χ ɔ s ɑ k ɑ n
գաղափարախոսություն	ɡ ɑ ʁ ɑ pʰ ɑ ɾ ɑ χ ɔ s u tʰ j u n
գաղթ	ɡ ɑ χ tʰ
գաղթել	ɡ ɑ χ tʰ ɛ l
գաղութ	ɡ ɑ ʁ u tʰ
գաղտնաբառ	ɡ ɑ χ t n ɑ b ɑ r
գաղտնի	ɡ ɑ χ t n i
գաղտնիք	ɡ ɑ χ t n i kʰ
գամ	ɡ ɑ m
գամակ	ɡ ɑ m ɑ k
գամիրք	ɡ ɑ m i ɾ kʰ
գամփռ	ɡ ɑ m pʰ ə r
գայանա	ɡ ɑ j ɑ n ɑ
գայթակղել	ɡ ɑ j tʰ ɑ k ə ʁ ɛ l
գայթակղություն	ɡ ɑ j tʰ ɑ k ə ʁ u tʰ j u n
գայլ	ɡ ɑ j l
գայլաձուկ	ɡ ɑ j l ɑ d͡z u k
գայլաշուն	ɡ ɑ j l ɑ ʃ u n
գան	ɡ ɑ n
գանա	ɡ ɑ n ɑ
գանգ	ɡ ɑ ŋ ɡ
գանգատ	ɡ ɑ ŋ ɡ ɑ t
գանգես	ɡ ɑ ŋ ɡ ɛ s
գանգուր	ɡ ɑ ŋ ɡ u ɾ
գանգրահեր	ɡ ɑ ŋ ɡ ɾ ɑ h ɛ ɾ
գանգրաշուք	ɡ ɑ ŋ ɡ ɾ ɑ ʃ u kʰ
գանգրավարս	ɡ ɑ ŋ ɡ ɾ ɑ v ɑ ɾ s
գանգրացնել	ɡ ɑ ŋ ɡ ɾ ɑ t͡sʰ n ɛ l
գանգրացում	ɡ ɑ ŋ ɡ ɾ ɑ t͡sʰ u m
գանգրենա	ɡ ɑ ŋ ɡ ɾ ɛ n ɑ
գանգրոց	ɡ ɑ ŋ ɡ ɾ ɔ t͡sʰ
գանձ	ɡ ɑ n d͡z
գանձավոր	ɡ ɑ n d͡z ɑ v ɔ ɾ
գանձարան	ɡ ɑ n d͡z ɑ ɾ ɑ n
գաջ	ɡ ɑ d͡ʒ
գառ	ɡ ɑ r
գառնարած	ɡ ɑ r n ɑ ɾ ɑ t͡s
գառնենի	ɡ ɑ r n ɛ n i
գառնիկ	ɡ ɑ r n i k
գասկոնցի	ɡ ɑ s k ɔ n t͡sʰ i
գասպարյան	ɡ ɑ s p ɑ ɾ j ɑ n
գավազան	ɡ ɑ v ɑ z ɑ n
գավաթ	ɡ ɑ v ɑ tʰ
գավառ	ɡ ɑ v ɑ r
գավառական	ɡ ɑ v ɑ r ɑ k ɑ n
գավիթ	ɡ ɑ v i tʰ
գավոտ	ɡ ɑ v ɔ t
գավրիլ	ɡ ɑ v ɾ i l
գարեգին	ɡ ɑ ɾ ɛ ɡ i n
գարեջուր	ɡ ɑ ɾ ɛ d͡ʒ u ɾ
գարի	ɡ ɑ ɾ i
գարիկ	ɡ ɑ ɾ i k
գարնային	ɡ ɑ ɾ n ɑ j i n
գարնանային	ɡ ɑ ɾ n ɑ n ɑ j i n
գարշ	ɡ ɑ ɾ ʃ
գարշել	ɡ ɑ ɾ ʃ ɛ l
գարուն	ɡ ɑ ɾ u n
գգվանք	ɡ ə kʰ v ɑ ŋ kʰ
գգվել	ɡ ə kʰ v ɛ l
գդալ	ɡ ə tʰ ɑ l
գդակ	ɡ ə d ɑ k
գելարան	ɡ ɛ l ɑ ɾ ɑ n
գեղ	ɡ ɛ ʁ
գեղագանգուր	ɡ ɛ ʁ ɑ ɡ ɑ ŋ ɡ u ɾ
գեղագետ	ɡ ɛ ʁ ɑ ɡ ɛ t
գեղագիտություն	ɡ ɛ ʁ ɑ ɡ i t u tʰ j u n
գեղամ	ɡ ɛ ʁ ɑ m
գեղամյան	ɡ ɛ ʁ ɑ m j ɑ n
գեղանի	ɡ ɛ ʁ ɑ n i
գեղարքունի	ɡ ɛ ʁ ɑ ɾ kʰ u n i
գեղարքունիք	ɡ ɛ ʁ ɑ ɾ kʰ u n i kʰ
գեղեցիկ	ɡ ɛ ʁ ɛ t͡sʰ i k
գեղեցկուհի	ɡ ɛ ʁ ɛ t͡sʰ k u h i
գեղձ	ɡ ɛ ʁ d͡z
գեղձի	ɡ ɛ ʁ d͡z i
գեղմ	ɡ ɛ ʁ m
գեղոն	ɡ ɛ ʁ ɔ n
գեղջուկ	ɡ ɛ ʁ d͡ʒ u k
գեղցի	ɡ ɛ χ t͡sʰ i
գեյզեր	ɡ ɛ j z ɛ ɾ
գեն	ɡ ɛ n
գեներալ	ɡ ɛ n ɛ ɾ ɑ l
գեջ	ɡ ɛ d͡ʒ
գետաբերան	ɡ ɛ t ɑ b ɛ ɾ ɑ n
գետակ	ɡ ɛ t ɑ k
գետառ	ɡ ɛ t ɑ r
գետափ	ɡ ɛ t ɑ pʰ
գետնախնձոր	ɡ ɛ t n ɑ χ ə n d͡z ɔ ɾ
գետնից	ɡ ɛ t n i t͡sʰ
գեր	ɡ ɛ ɾ
գերագնահատել	ɡ ɛ ɾ ɑ ɡ ə n ɑ h ɑ t ɛ l
գերազանց	ɡ ɛ ɾ ɑ z ɑ n t͡sʰ
գերազանցություն	ɡ ɛ ɾ ɑ z ɑ n t͡sʰ u tʰ j u n
գերատեսչություն	ɡ ɛ ɾ ɑ t ɛ s t͡ʃʰ u tʰ j u n
գերդաստան	ɡ ɛ ɾ d ɑ s t ɑ n
գերեզման	ɡ ɛ ɾ ɛ z m ɑ n
գերել	ɡ ɛ ɾ ɛ l
գերեվարում	ɡ ɛ ɾ ɛ v ɑ ɾ u m
գերճշտում	ɡ ɛ ɾ t͡ʃ ə ʃ t u m
գերմակ	ɡ ɛ ɾ m ɑ k
գերմանական	ɡ ɛ ɾ m ɑ n ɑ k ɑ n
գերմանացի	ɡ ɛ ɾ m ɑ n ɑ t͡sʰ i
գերմաներեն	ɡ ɛ ɾ m ɑ n ɛ ɾ ɛ n
գերմանիա	ɡ ɛ ɾ m ɑ n j ɑ
գերմանիայի	ɡ ɛ ɾ m ɑ n j ɑ j i
գերմանուհի	ɡ ɛ ɾ m ɑ n u h i
գերշուկա	ɡ ɛ ɾ ʃ u k ɑ
գեւորգ	ɡ ɛ v ɔ ɾ kʰ
գեւորգյան	ɡ ɛ v ɔ ɾ kʰ j ɑ n
գթություն	ɡ ə tʰ u tʰ j u n
գժանոց	ɡ ə ʒ ɑ n ɔ t͡sʰ
գի	ɡ i
գիլյոտին	ɡ i l j ɔ t i n
գիլոյան	ɡ i l ɔ j ɑ n
գին	ɡ i n
գինարբու	ɡ i n ɑ ɾ b u
գինարբուք	ɡ i n ɑ ɾ b u kʰ
գինդ	ɡ i n d
գինեմոլ	ɡ i n ɛ m ɔ l
գինետուն	ɡ i n ɛ t u n
գինի	ɡ i n i
գինձ	ɡ i n d͡z
գիշերային	ɡ i ʃ ɛ ɾ ɑ j i n
գիշերօթիկ	ɡ i ʃ ɛ ɾ ɔ tʰ i k
գիսակ	ɡ i s ɑ k
գիսաստղ	ɡ i s ɑ s t ə ʁ
գիտական	ɡ i t ɑ k ɑ n
գիտակից	ɡ i t ɑ k i t͡sʰ
գիտակցաբար	ɡ i t ɑ k t͡sʰ ɑ b ɑ ɾ
գիտակցական	ɡ i t ɑ k t͡sʰ ɑ k ɑ n
գիտակցել	ɡ i t ɑ k t͡sʰ ɛ l
գիտակցորեն	ɡ i t ɑ k t͡sʰ ɔ ɾ ɛ n
գիտակցություն	ɡ i t ɑ k t͡sʰ u tʰ j u n
գիտակցում	ɡ i t ɑ k t͡sʰ u m
գիտակցվել	ɡ i t ɑ k t͡sʰ v ɛ l
գիտելիք	ɡ i t ɛ l i kʰ
գիտենալ	ɡ i t ɛ n ɑ l
գիտնական	ɡ i t n ɑ k ɑ n
գիտունիկ	ɡ i t u n i k
գիր	ɡ i ɾ
գիրկ	ɡ i ɾ k
գիրուկ	ɡ i ɾ u k
գիրք	ɡ i ɾ kʰ
գիրքը	ɡ i ɾ kʰ ə
գիրքն	ɡ i ɾ kʰ n
գլան	ɡ ə l ɑ n
գլասնոստ	ɡ l ɑ s n ɔ s t
գլաքար	ɡ ə l ɑ kʰ ɑ ɾ
գլխաշոր	ɡ ə l χ ɑ ʃ ɔ ɾ
գլխապտույտ	ɡ ə l χ ɑ p ə t u j t
գլխավոր	ɡ ə l χ ɑ v ɔ ɾ
գլխատել	ɡ ə l χ ɑ t ɛ l
գլխարկ	ɡ ə l χ ɑ ɾ k
գլխացավ	ɡ ə l χ ɑ t͡sʰ ɑ v
գլխուղեղ	ɡ ə l χ u ʁ ɛ ʁ
գլուխկոտրուկ	ɡ ə l u χ k ɔ t ɾ u k
գծիկ	ɡ ə t͡s i k
գյադա	ɡ j ɑ d ɑ
գյանջա	ɡ j ɑ n d͡ʒ ɑ
գյավուր	ɡ j ɑ v u ɾ
գյոզ	ɡ j ɔ z
գյոզալ	ɡ j ɔ z ɑ l
գյոլ	ɡ j ɔ l
գյոռ	ɡ j ɔ r
գյուղ	ɡ j u ʁ
գյուղատնտես	ɡ j u ʁ ɑ t ə n t ɛ s
գյուղատնտեսական	ɡ j u ʁ ɑ t ə n t ɛ s ɑ k ɑ n
գյուղատնտեսություն	ɡ j u ʁ ɑ t ə n t ɛ s u tʰ j u n
գյուղացի	ɡ j u ʁ ɑ t͡sʰ i
գյուտ	ɡ j u t
գյուտարար	ɡ j u t ɑ ɾ ɑ ɾ
գյուրզա	ɡ j u ɾ z ɑ
գյուրջինյան	ɡ j u ɾ d͡ʒ i n j ɑ n
գնահատել	ɡ ə n ɑ h ɑ t ɛ l
գնահատելի	ɡ ə n ɑ h ɑ t ɛ l i
գնաճ	ɡ ə n ɑ t͡ʃ
գնացուցակ	ɡ ə n ɑ t͡sʰ u t͡sʰ ɑ k
գնացք	ɡ ə n ɑ t͡sʰ kʰ
գնդակ	ɡ ə n d ɑ k
գնդակահարություն	ɡ ə n d ɑ k ɑ h ɑ ɾ u tʰ j u n
գնդաձեւ	ɡ ə n d ɑ d͡z ɛ v
գնդապետ	ɡ ə n d ɑ p ɛ t
գնդացիր	ɡ ə n d ɑ t͡sʰ i ɾ
գնդիկ	ɡ ə n d i k
գնդոլորտ	ɡ ə n d ɔ l ɔ ɾ t
գնել	ɡ ə n ɛ l
գնհատել	ɡ ə n h ɑ t ɛ l
գնոստիկական	ɡ ə n ɔ s t i k ɑ k ɑ n
գնում	ɡ ə n u m
գնչու	ɡ ə n t͡ʃʰ u
գոգ	ɡ ɔ kʰ
գոլ	ɡ ɔ l
գոլորշի	ɡ ɔ l ɔ ɾ ʃ i
գոհ	ɡ ɔ h
գոհանալ	ɡ ɔ h ɑ n ɑ l
գոհար	ɡ ɔ h ɑ ɾ
գոհացնել	ɡ ɔ h ɑ t͡sʰ n ɛ l
գող	ɡ ɔ ʁ
գողանալ	ɡ ɔ ʁ ɑ n ɑ l
գողգոթա	ɡ ɔ ʁ ɡ ɔ tʰ ɑ
գողունի	ɡ ɔ ʁ u n i
գողտր	ɡ ɔ χ t ə ɾ
գոմ	ɡ ɔ m
գոմաղբ	ɡ ɔ m ɑ χ p
գոմեշ	ɡ ɔ m ɛ ʃ
գոյ	ɡ ɔ j
գոյական	ɡ ɔ j ɑ k ɑ n
գոյակցություն	ɡ ɔ j ɑ k t͡sʰ u tʰ j u n
գոյանալ	ɡ ɔ j ɑ n ɑ l
գոյություն	ɡ ɔ j u tʰ j u n
գոնե	ɡ ɔ n ɛ
գոչել	ɡ ɔ t͡ʃʰ ɛ l
գոռ	ɡ ɔ r
գոռալ	ɡ ɔ r ɑ l
գոռոզ	ɡ ɔ r ɔ z
գոռոզություն	ɡ ɔ r ɔ z u tʰ j u n
գոս	ɡ ɔ s
գովազդ	ɡ ɔ v ɑ z d
գովալ	ɡ ɔ v ɑ l
գովել	ɡ ɔ v ɛ l
գովեստ	ɡ ɔ v ɛ s t
գովք	ɡ ɔ f kʰ
գոտի	ɡ ɔ t i
գորբաչով	ɡ ɔ ɾ b ɑ t͡ʃʰ ɔ v
գորգ	ɡ ɔ ɾ ɡ
գորիս	ɡ ɔ ɾ i s
գործ	ɡ ɔ ɾ t͡s
գործադուլ	ɡ ɔ ɾ t͡s ɑ d u l
գործազուրկ	ɡ ɔ ɾ t͡s ɑ z u ɾ k
գործազրկություն	ɡ ɔ ɾ t͡s ɑ z ə ɾ k u tʰ j u n
գործածել	ɡ ɔ ɾ t͡s ɑ t͡s ɛ l
գործակցություն	ɡ ɔ ɾ t͡s ɑ k t͡sʰ u tʰ j u n
գործառնական	ɡ ɔ ɾ t͡s ɑ r n ɑ k ɑ n
գործառնություն	ɡ ɔ ɾ t͡s ɑ r n u tʰ j u n
գործառույթը	ɡ ɔ ɾ t͡s ɑ r u j tʰ ə
գործարան	ɡ ɔ ɾ t͡s ɑ ɾ ɑ n
գործարար	ɡ ɔ ɾ t͡s ɑ ɾ ɑ ɾ
գործարկել	ɡ ɔ ɾ t͡s ɑ ɾ k ɛ l
գործարք	ɡ ɔ ɾ t͡s ɑ ɾ kʰ
գործել	ɡ ɔ ɾ t͡s ɛ l
գործելաոճ	ɡ ɔ ɾ t͡s ɛ l ɑ v ɔ t͡ʃ
գործընթաց	ɡ ɔ ɾ t͡s ə n tʰ ɑ t͡sʰ
գործընկեր	ɡ ɔ ɾ t͡s ə ŋ k ɛ ɾ
գործի	ɡ ɔ ɾ t͡s i
գործիչ	ɡ ɔ ɾ t͡s i t͡ʃʰ
գործնական	ɡ ɔ ɾ t͡s n ɑ k ɑ n
գործող	ɡ ɔ ɾ t͡s ɔ ʁ
գործողություն	ɡ ɔ ɾ t͡s ɔ ʁ u tʰ j u n
գործոն	ɡ ɔ ɾ t͡s ɔ n
գործում	ɡ ɔ ɾ t͡s u m
գործուն	ɡ ɔ ɾ t͡s u n
գործվածք	ɡ ɔ ɾ t͡s v ɑ t͡s kʰ
գորկի	ɡ ɔ ɾ k i
գորշ	ɡ ɔ ɾ ʃ
գորշավուն	ɡ ɔ ɾ ʃ ɑ v u n
գորովել	ɡ ɔ ɾ ɔ v ɛ l
գորտ	ɡ ɔ ɾ t
գուգարք	ɡ u ɡ ɑ ɾ kʰ
գուգլ	ɡ u ɡ ə l
գուդաութա	ɡ u d ɑ u tʰ ɑ
գութան	ɡ u tʰ ɑ n
գուժում	ɡ u ʒ u m
գումար	ɡ u m ɑ ɾ
գումարել	ɡ u m ɑ ɾ ɛ l
գումարում	ɡ u m ɑ ɾ u m
գույժ	ɡ u j ʒ
գույն	ɡ u j n
գուն	ɡ u n
գունդ	ɡ u n d
գուշակ	ɡ u ʃ ɑ k
գուշակել	ɡ u ʃ ɑ k ɛ l
գուշակողական	ɡ u ʃ ɑ k ɔ ʁ ɑ k ɑ n
գուշակում	ɡ u ʃ ɑ k u m
գուշպ	ɡ u ʃ p
գուպար	ɡ u p ɑ ɾ
գուսան	ɡ u s ɑ n
գուրգեն	ɡ u ɾ ɡ ɛ n
գուրգուրալ	ɡ u ɾ ɡ u ɾ ɑ l
գուրզ	ɡ u ɾ z
գռեհիկ	ɡ ə r ɛ h i k
գվինեա	ɡ v i n ɛ ɑ
գտածո	ɡ ə t ɑ t͡s ɔ
գտնել	ɡ ə t n ɛ l
գտնվել	ɡ ə t n ə v ɛ l
գրաբար	ɡ ə ɾ ɑ pʰ ɑ ɾ
գրադարան	ɡ ə ɾ ɑ d ɑ ɾ ɑ n
գրադարձել	ɡ ə ɾ ɑ d ɑ ɾ t͡sʰ ɛ l
գրազ	ɡ ə ɾ ɑ z
գրախանութ	ɡ ə ɾ ɑ χ ɑ n u tʰ
գրախոսություն	ɡ ə ɾ ɑ χ ɔ s u tʰ j u n
գրական	ɡ ə ɾ ɑ k ɑ n
գրականագետ	ɡ ə ɾ ɑ k ɑ n ɑ ɡ ɛ t
գրականագիտություն	ɡ ə ɾ ɑ k ɑ n ɑ ɡ i t u tʰ j u n
գրականություն	ɡ ə ɾ ɑ k ɑ n u tʰ j u n
գրամ	ɡ ə ɾ ɑ m
գրամեքենա	ɡ ə ɾ ɑ m ɛ kʰ ɛ n ɑ
գրանիտ	ɡ ɾ ɑ n i t
գրանտակեր	ɡ ə ɾ ɑ n t ɑ k ɛ ɾ
գրանցել	ɡ ə ɾ ɑ n t͡sʰ ɛ l
գրանցում	ɡ ə ɾ ɑ n t͡sʰ u m
գրանցվել	ɡ ə ɾ ɑ n t͡sʰ v ɛ l
գրառել	ɡ ə ɾ ɑ r ɛ l
գրասեղան	ɡ ə ɾ ɑ s ɛ ʁ ɑ n
գրասենյակ	ɡ ə ɾ ɑ s ɛ n j ɑ k
գրավիտոն	ɡ ɾ ɑ v i t ɔ n
գրատախտակ	ɡ ə ɾ ɑ t ɑ χ t ɑ k
գրգիռ	ɡ ə ɾ ɡ i r
գրգռված	ɡ ə ɾ ɡ ə r v ɑ t͡s
գրենա	ɡ ɾ ɛ n ɑ
գրենլանդիա	ɡ ɾ ɛ n l ɑ n d j ɑ
գրիգոր	ɡ ɾ i kʰ ɔ ɾ
գրիգորի	ɡ ɾ i ɡ ɔ ɾ i
գրիգորյան	ɡ ɾ i kʰ ɔ ɾ j ɑ n
գրիժա	ɡ ɾ i ʒ ɑ
գրիչ	ɡ ə ɾ i t͡ʃʰ
գրիպ	ɡ ə ɾ i p
գրկել	ɡ ə ɾ k ɛ l
գրկում	ɡ ə ɾ k u m
գրոզնի	ɡ ɾ ɔ z n i
գրոհ	ɡ ə ɾ ɔ h
գրոհային	ɡ ə ɾ ɔ h ɑ j i n
գրոհել	ɡ ə ɾ ɔ h ɛ l
գրող	ɡ ə ɾ ɔ ʁ
գրպան	ɡ ə ɾ p ɑ n
գրպանահատ	ɡ ə ɾ p ɑ n ɑ h ɑ t
գրպանի	ɡ ə ɾ p ɑ n i
դա	d ɑ
դաբաղ	d ɑ b ɑ ʁ
դաբրո	d ɑ b ɾ ɔ
դադար	d ɑ tʰ ɑ ɾ
դադարած	d ɑ tʰ ɑ ɾ ɑ t͡s
դադարգյուն	d ɑ d ɑ ɾ ɡ j u n
դադարել	d ɑ tʰ ɑ ɾ ɛ l
դադարեցնել	d ɑ tʰ ɑ ɾ ɛ t͡sʰ n ɛ l
դադարեցում	d ɑ tʰ ɑ ɾ ɛ t͡sʰ u m
դադարեցվել	d ɑ tʰ ɑ ɾ ɛ t͡sʰ v ɛ l
դաժան	d ɑ ʒ ɑ n
դաժե	d ɑ ʒ ɛ
դալկադեմ	d ɑ l k ɑ d ɛ m
դահիճ	d ɑ h i t͡ʃ
դահիրա	d ɑ h i ɾ ɑ
դահլիճ	d ɑ h l i t͡ʃ
դահճապետ	d ɑ h t͡ʃ ɑ p ɛ t
դաղալ	d ɑ ʁ ɑ l
դամասկոս	d ɑ m ɑ s k ɔ s
դամբարան	d ɑ m b ɑ ɾ ɑ n
դամբուլ	d ɑ m b u l
դամոն	d ɑ m ɔ n
դայակ	d ɑ j ɑ k
դայլայլ	d ɑ j l ɑ j l
դանակ	d ɑ n ɑ k
դանդալոշ	d ɑ n d ɑ l ɔ ʃ
դանդաղ	d ɑ n d ɑ ʁ
դանիա	d ɑ n j ɑ
դանիական	d ɑ n j ɑ k ɑ n
դանիացի	d ɑ n j ɑ t͡sʰ i
դանիշմենդյան	d ɑ n i ʃ m ɛ n d j ɑ n
դաշինք	d ɑ ʃ i ŋ kʰ
դաշն	d ɑ ʃ ə n
դաշնագիր	d ɑ ʃ n ɑ ɡ i ɾ
դաշնակ	d ɑ ʃ n ɑ k
դաշնակցական	d ɑ ʃ n ɑ k t͡sʰ ɑ k ɑ n
դաշնային	d ɑ ʃ n ɑ j i n
դաշնություն	d ɑ ʃ n u tʰ j u n
դաշույն	d ɑ ʃ u j n
դաշտ	d ɑ ʃ t
դաշտային	d ɑ ʃ t ɑ j i n
դաշտան	d ɑ ʃ t ɑ n
դաշտավայր	d ɑ ʃ t ɑ v ɑ j ɾ
դաշտեր	d ɑ ʃ t ɛ ɾ
դաշտերը	d ɑ ʃ t ɛ ɾ ə
դաշտերի	d ɑ ʃ t ɛ ɾ i
դաշտերին	d ɑ ʃ t ɛ ɾ i n
դաշտերից	d ɑ ʃ t ɛ ɾ i t͡sʰ
դաշտերն	d ɑ ʃ t ɛ ɾ n
դաշտերում	d ɑ ʃ t ɛ ɾ u m
դաշտի	d ɑ ʃ t i
դաշտին	d ɑ ʃ t i n
դաշտից	d ɑ ʃ t i t͡sʰ
դաշտն	d ɑ ʃ t ə n
դաշտում	d ɑ ʃ t u m
դաչա	d ɑ t͡ʃʰ ɑ
դաջել	d ɑ d͡ʒ ɛ l
դաջվածք	d ɑ d͡ʒ v ɑ t͡s kʰ
դառն	d ɑ r ə n
դառնալ	d ɑ r n ɑ l
դաս	d ɑ s
դասագիրք	d ɑ s ɑ ɡ i ɾ kʰ
դասադուլ	d ɑ s ɑ d u l
դասալիք	d ɑ s ɑ l i kʰ
դասալքություն	d ɑ s ɑ l ə kʰ u tʰ j u n
դասախոս	d ɑ s ɑ χ ɔ s
դասախոսություն	d ɑ s ɑ χ ɔ s u tʰ j u n
դասական	d ɑ s ɑ k ɑ n
դասավորել	d ɑ s ɑ v ɔ ɾ ɛ l
դասատու	d ɑ s ɑ t u
դաստակ	d ɑ s t ɑ k
դավադրության	d ɑ v ɑ d ɾ u tʰ j ɑ n
դավադրություն	d ɑ v ɑ d ɾ u tʰ j u n
դավաճան	d ɑ v ɑ t͡ʃ ɑ n
դավաճանել	d ɑ v ɑ t͡ʃ ɑ n ɛ l
դավաճանություն	d ɑ v ɑ t͡ʃ ɑ n u tʰ j u n
դավաճանում	d ɑ v ɑ t͡ʃ ɑ n u m
դավթյան	d ɑ f tʰ j ɑ n
դատ	d ɑ t
դատախազ	d ɑ t ɑ χ ɑ z
դատական	d ɑ t ɑ k ɑ n
դատապարտել	d ɑ t ɑ p ɑ ɾ t ɛ l
դատապարտյալ	d ɑ t ɑ p ɑ ɾ t j ɑ l
դատավոր	d ɑ t ɑ v ɔ ɾ
դատարկ	d ɑ t ɑ ɾ k
դատարկագլուխ	d ɑ t ɑ ɾ k ɑ ɡ ə l u χ
դատարկաձեռն	d ɑ t ɑ ɾ k ɑ d͡z ɛ r ə n
դատարկամիտ	d ɑ t ɑ ɾ k ɑ m i t
դատարկել	d ɑ t ɑ ɾ k ɛ l
դատարկուն	d ɑ t ɑ ɾ k u n
դատողություն	d ɑ t ɔ ʁ u tʰ j u n
դար	d ɑ ɾ
դարակ	d ɑ ɾ ɑ k
դարան	d ɑ ɾ ɑ n
դարանակալել	d ɑ ɾ ɑ n ɑ k ɑ l ɛ l
դարաշրջան	d ɑ ɾ ɑ ʃ ə ɾ d͡ʒ ɑ n
դարբին	d ɑ ɾ pʰ i n
դարեհ	d ɑ ɾ ɛ h
դարեր	d ɑ ɾ ɛ ɾ
դարձ	d ɑ ɾ t͡sʰ
դարձյալ	d ɑ ɾ t͡sʰ j ɑ l
դարձվածք	d ɑ ɾ t͡sʰ v ɑ t͡s kʰ
դարձվոր	d ɑ ɾ t͡sʰ v ɔ ɾ
դարման	d ɑ ɾ m ɑ n
դարչին	d ɑ ɾ t͡ʃʰ i n
դարպաս	d ɑ ɾ p ɑ s
դարվինիզմ	d ɑ ɾ v i n i z m
դափնեկիր	d ɑ pʰ n ɛ k i ɾ
դափնի	d ɑ pʰ n i
դդում	d ə tʰ u m
դե	d ɛ
դեբիլ	d ɛ b i l
դեգերում	d ɛ ɡ ɛ ɾ u m
դեդլայն	d ɛ d l ɑ j n
դեզ	d ɛ z
դելփին	d ɛ l pʰ i n
դելֆին	d ɛ l f i n
դեկտեմբեր	d ɛ k t ɛ m b ɛ ɾ
դեկտեմբերյան	d ɛ k t ɛ m b ɛ ɾ j ɑ n
դեղ	d ɛ ʁ
դեղահատ	d ɛ ʁ ɑ h ɑ t
դեղատոմս	d ɛ ʁ ɑ t ɔ m s
դեղատուն	d ɛ ʁ ɑ t u n
դեղին	d ɛ ʁ i n
դեղձ	d ɛ χ t͡sʰ
դեղնավուն	d ɛ ʁ n ɑ v u n
դեղնուց	d ɛ ʁ n u t͡sʰ
դեմ	d ɛ m
դեմիրճյան	d ɛ m i ɾ t͡ʃ j ɑ n
դեմոկրատ	d ɛ m ɔ k ɾ ɑ t
դեմոկրատիա	d ɛ m ɔ k ɾ ɑ t j ɑ
դեմք	d ɛ m kʰ
դեյրա	d ɛ j ɾ ɑ
դեպի	d ɛ p i
դեպք	d ɛ p kʰ
դեռ	d ɛ r
դեռեւս	d ɛ r ɛ v ə s
դեսպան	d ɛ s p ɑ n
դեսպանատուն	d ɛ s p ɑ n ɑ t u n
դեստրուկտիվ	d ɛ s t ɾ u k t i v
դետրոյտ	d ɛ t ɾ ɔ j t
դեր	d ɛ ɾ
դերանուն	d ɛ ɾ ɑ n u n
դերասան	d ɛ ɾ ɑ s ɑ n
դերասանուհի	d ɛ ɾ ɑ s ɑ n u h i
դերբայ	d ɛ ɾ b ɑ j
դերկոմս	d ɛ ɾ k ɔ m s
դերձակ	d ɛ ɾ t͡sʰ ɑ k
դեցիմետր	d ɛ t͡sʰ i m ɛ t ə ɾ
դեւ	d ɛ v
դեւանագարի	d ɛ v ɑ n ɑ ɡ ɑ ɾ i
դժար	d ə ʒ ɑ ɾ
դժբախտություն	d ə ʒ b ɑ χ t u tʰ j u n
դժգոհություն	d ə ʒ ɡ ɔ h u tʰ j u n
դժգույն	d ə ʒ ɡ u j n
դժոխք	d ə ʒ ɔ χ kʰ
դժվար	d ə ʒ v ɑ ɾ
դի	d i
դիաբետ	d i j ɑ b ɛ t
դիակ	d i j ɑ k
դիարան	d i j ɑ ɾ ɑ n
դիարբեքիր	d i j ɑ ɾ b ɛ kʰ i ɾ
դիետա	d i j ɛ t ɑ
դիեցիկ	d i j ɛ t͡sʰ i k
դիզայներ	d i z ɑ j n ɛ ɾ
դիլիջան	d i l i d͡ʒ ɑ n
դիմադրություն	d i m ɑ d ɾ u tʰ j u n
դիմախաղ	d i m ɑ χ ɑ ʁ
դիմակ	d i m ɑ k
դիմանալ	d i m ɑ n ɑ l
դիմանկար	d i m ɑ n ə k ɑ ɾ
դիմավորել	d i m ɑ v ɔ ɾ ɛ l
դիմացկուն	d i m ɑ t͡sʰ k u n
դիմորդ	d i m ɔ ɾ tʰ
դինաստիա	d i n ɑ s t j ɑ
դինար	d i n ɑ ɾ
դիոգենես	d i j ɔ ɡ ɛ n ɛ s
դիպակ	d i p ɑ k
դիպլոմ	d i p l ɔ m
դիպուկ	d i p u k
դիպչել	d i p t͡ʃʰ ɛ l
դիպված	d i p v ɑ t͡s
դիսերտացիա	d i s ɛ ɾ t ɑ t͡sʰ j ɑ
դիսկոտեկ	d i s k ɔ t ɛ k
դիսկուրս	d i s k u ɾ s
դիսպաշեր	d i s p ɑ ʃ ɛ ɾ
դիվանագետ	d i v ɑ n ɑ ɡ ɛ t
դիվանագիտություն	d i v ɑ n ɑ ɡ i t u tʰ j u n
դիվերսիոն	d i v ɛ ɾ s j ɔ n
դիվիդենտ	d i v i d ɛ n t
դիտակ	d i t ɑ k
դիտել	d i t ɛ l
դիտողություն	d i t ɔ ʁ u tʰ j u n
դիտորդական	d i t ɔ ɾ tʰ ɑ k ɑ n
դիտվել	d i t v ɛ l
դիրագ	d i ɾ ɑ ɡ
դիրք	d i ɾ kʰ
դիրքորոշում	d i ɾ kʰ ɔ ɾ ɔ ʃ u m
դիցուք	d i t͡sʰ u kʰ
դիք	d i kʰ
դհոլ	d ə h ɔ l
դղյակ	d ə ʁ j ɑ k
դյուժին	d j u ʒ i n
դյույմ	d j u j m
դյուր	d j u ɾ
դյուրաթեք	d j u ɾ ɑ tʰ ɛ kʰ
դյուրաշարժ	d j u ɾ ɑ ʃ ɑ ɾ ʒ
դյուցազուն	d j u t͡sʰ ɑ z u n
դնեստր	d n ɛ s t ə ɾ
դնթ	d ə n ə tʰ ə
դնչիկ	d ə n t͡ʃʰ i k
դոգմա	d ɔ ɡ m ɑ
դոդոշ	d ɔ d ɔ ʃ
դոլար	d ɔ l ɑ ɾ
դոլմա	d ɔ l m ɑ
դոխտուր	d ɔ χ t u ɾ
դոհա	d ɔ h ɑ
դող	d ɔ ʁ
դողալ	d ɔ ʁ ɑ l
դոմփել	d ɔ m pʰ ɛ l
դոնեցկ	d ɔ n ɛ t͡sʰ k
դոնի	d ɔ n i
դոշակ	d ɔ ʃ ɑ k
դոցենտ	d ɔ t͡sʰ ɛ n t
դու	d u
դուբայ	d u b ɑ j
դուբլին	d u b l i n
դուբնիում	d u b n i j u m
դուբոսար	d u b ɔ s ɑ ɾ
դուդուկ	d u d u k
դուխ	d u χ
դուխի	d u χ i
դուխով	d u χ ɔ v
դույզն	d u j z ə n
դույլ	d u j l
դուն	d u n
դունչ	d u n t͡ʃʰ
դուշանբե	d u ʃ ɑ n b ɛ
դուշման	d u ʃ m ɑ n
դուռ	d u r
դուստր	d u s t ə ɾ
դուր	d u ɾ
դուրգար	d u ɾ ɡ ɑ ɾ
դուրգարյան	d u ɾ ɡ ɑ ɾ j ɑ n
դուրս	d u ɾ s
դուք	d u kʰ
դուքան	d u kʰ ɑ n
դուքս	d u kʰ s
դպիր	d ə p i ɾ
դպրոց	d ə p ɾ ɔ t͡sʰ
դպրոցական	d ə p ɾ ɔ t͡sʰ ɑ k ɑ n
դռնապան	d ə r n ɑ p ɑ n
դռնփակ	d ə r ə n pʰ ɑ k
դրախտ	d ə ɾ ɑ χ t
դրական	d ə ɾ ɑ k ɑ n
դրամաշորթ	d ɾ ɑ m ɑ ʃ ɔ ɾ tʰ
դրամապանակ	d ɾ ɑ m ɑ p ɑ n ɑ k
դրամատուրգ	d ɾ ɑ m ɑ t u ɾ ɡ
դրամատուրգիական	d ɾ ɑ m ɑ t u ɾ ɡ j ɑ k ɑ n
դրամարկղ	d ə ɾ ɑ m ɑ ɾ k ə ʁ
դրանիկ	d ə ɾ ɑ n i k
դրացի	d ə ɾ ɑ t͡sʰ i
դրացիական	d ə ɾ ɑ t͡sʰ i j ɑ k ɑ n
դրափոխություն	d ə ɾ ɑ pʰ ɔ χ u tʰ j u n
դրժել	d ə ɾ ʒ ɛ l
դրոշմ	d ə ɾ ɔ ʃ m
դրություն	d ə ɾ u tʰ j u n
դրսեւորել	d ə ɾ s ɛ v ɔ ɾ ɛ l
եահկ	j ɛ ɑ h ə k ə
եատմ	j ɛ ɑ t ə m ə
եբրայերեն	j ɛ b ɾ ɑ j ɛ ɾ ɛ n
եբրայեցի	j ɛ b ɾ ɑ j ɛ t͡sʰ i
եգիպտացորեն	j ɛ ɡ i p t ɑ t͡sʰ ɔ ɾ ɛ n
եգիպտոս	j ɛ ɡ i p t ɔ s
եդեսացի	j ɛ d ɛ s ɑ t͡sʰ i
եդեսիա	j ɛ d ɛ s j ɑ
եզ	j ɛ z
եզնիկ	j ɛ z n i k
եզրակացություն	j ɛ z ɾ ɑ k ɑ t͡sʰ u tʰ j u n
եզրափակել	j ɛ z ɾ ɑ pʰ ɑ k ɛ l
եզրափակիչ	j ɛ z ɾ ɑ pʰ ɑ k i t͡ʃʰ
եթե	j ɛ tʰ ɛ
եթեր	j ɛ tʰ ɛ ɾ
եթովպիա	j ɛ tʰ ɔ f p j ɑ
ելակ	j ɛ l ɑ k
ելենա	j ɛ l ɛ n ɑ
ելիզավետա	j ɛ l i z ɑ v ɛ t ɑ
ելնել	j ɛ l n ɛ l
ելույթ	j ɛ l u j tʰ
ելունդ	j ɛ l u n d
ելուստ	j ɛ l u s t
ելցին	j ɛ l t͡sʰ i n
եխ	j ɛ χ ə
եկատերինբուրգ	j ɛ k ɑ t ɛ ɾ i n b u ɾ ɡ
եկբատան	j ɛ k b ɑ t ɑ n
եկեղեցի	j ɛ k ɛ ʁ ɛ t͡sʰ i
եկող	j ɛ k ɔ ʁ
եկվոր	j ɛ k v ɔ ɾ
եղած	j ɛ ʁ ɑ t͡s
եղանակ	j ɛ ʁ ɑ n ɑ k
եղբայր	j ɛ χ p ɑ j ɾ
եղբայրական	j ɛ χ p ɑ j ɾ ɑ k ɑ n
եղբորորդի	j ɛ χ p ɔ ɾ ɔ ɾ tʰ i
եղեգ	j ɛ ʁ ɛ ɡ
եղեգնաձոր	j ɛ ʁ ɛ ɡ n ɑ d͡z ɔ ɾ
եղեգնյա	j ɛ ʁ ɛ ɡ n j ɑ
եղեռն	j ɛ ʁ ɛ r n
եղերական	j ɛ ʁ ɛ ɾ ɑ k ɑ n
եղերդ	j ɛ ʁ ɛ ɾ d
եղեւնի	j ɛ ʁ ɛ v n i
եղեք	j ɛ ʁ ɛ kʰ
եղիա	j ɛ ʁ j ɑ
եղիշե	j ɛ ʁ i ʃ ɛ
եղիսաբեթ	j ɛ ʁ i s ɑ b ɛ tʰ
եղիր	j ɛ ʁ i ɾ
եղյամ	j ɛ ʁ j ɑ m
եղն	j ɛ ʁ ə n
եղնիկ	j ɛ ʁ n i k
եղունգ	j ɛ ʁ u ŋ ɡ
եղջյուր	j ɛ ʁ d͡ʒ j u ɾ
եմեն	j ɛ m ɛ n
եմիշ	j ɛ m i ʃ
են	ɛ n
ենթադրել	j ɛ n tʰ ɑ d ɾ ɛ l
ենթադրելի	j ɛ n tʰ ɑ d ɾ ɛ l i
ենթադրյալ	j ɛ n tʰ ɑ d ə ɾ j ɑ l
ենթակայական	j ɛ n tʰ ɑ k ɑ j ɑ k ɑ n
ենթակայան	j ɛ n tʰ ɑ k ɑ j ɑ n
ենթակայություն	j ɛ n tʰ ɑ k ɑ j u tʰ j u n
ենթակառույց	j ɛ n tʰ ɑ k ɑ r u j t͡sʰ
ենթարկել	j ɛ n tʰ ɑ ɾ k ɛ l
ենթարկվել	j ɛ n tʰ ɑ ɾ k v ɛ l
ենիչերի	j ɛ n i t͡ʃʰ ɛ ɾ i
ենիսեյ	j ɛ n i s ɛ j
եպիսկոպոս	j ɛ p i s k ɔ p ɔ s
եպհ	j ɛ p ə h ə
եռաբարբառ	j ɛ r ɑ b ɑ ɾ b ɑ r
եռալ	j ɛ r ɑ l
եռամսյակ	j ɛ r ɑ m s j ɑ k
եռանդ	j ɛ r ɑ n d
եռանդագին	j ɛ r ɑ n d ɑ ɡ i n
եռանդուն	j ɛ r ɑ n d u n
եռանկյուն	j ɛ r ɑ ŋ k j u n
եռացում	j ɛ r ɑ t͡sʰ u m
եսայի	j ɛ s ɑ j i
եսասիրական	j ɛ s ɑ s i ɾ ɑ k ɑ n
եվգենի	j ɛ v ɡ ɛ n i
եվսեբիոս	j ɛ f s ɛ b j ɔ s
եվրախորհրդարան	j ɛ v ɾ ɑ χ ɔ ɾ ə ɾ tʰ ɑ ɾ ɑ n
եվրահանձնաժողով	j ɛ v ɾ ɑ h ɑ n d͡z n ɑ ʒ ɔ ʁ ɔ v
եվրամիություն	j ɛ v ɾ ɑ m i u tʰ j u n
եվրասիական	j ɛ v ɾ ɑ s j ɑ k ɑ n
եվրատեսիլ	j ɛ v ɾ ɑ t ɛ s i l
եվրո	j ɛ v ɾ ɔ
եվրոպա	j ɛ v ɾ ɔ p ɑ
եվրոպական	j ɛ v ɾ ɔ p ɑ k ɑ n
եվրոպայի	j ɛ v ɾ ɔ p ɑ j i
եվրոպայում	j ɛ v ɾ ɔ p ɑ j u m
եվրոպացի	j ɛ v ɾ ɔ p ɑ t͡sʰ i
ետ	j ɛ t
ետեւ	j ɛ t ɛ v
ետին	j ɛ t i n
ետմ	j ɛ t ə m ə
երազ	j ɛ ɾ ɑ z
երազանք	j ɛ ɾ ɑ z ɑ ŋ kʰ
երազգավորս	j ɛ ɾ ɑ z ɡ ɑ v ɔ ɾ s
երազել	j ɛ ɾ ɑ z ɛ l
երաժիշտ	j ɛ ɾ ɑ ʒ i ʃ t
երախայրիք	j ɛ ɾ ɑ χ ɑ j ɾ i kʰ
երախտագիտություն	j ɛ ɾ ɑ χ t ɑ ɡ i t u tʰ j u n
երախտամոռ	j ɛ ɾ ɑ χ t ɑ m ɔ r
երախտիք	j ɛ ɾ ɑ χ t i kʰ
երակ	j ɛ ɾ ɑ k
երանգ	j ɛ ɾ ɑ ŋ ɡ
երանի	j ɛ ɾ ɑ n i
երաշխավորել	j ɛ ɾ ɑ ʃ χ ɑ v ɔ ɾ ɛ l
երաշխավորում	j ɛ ɾ ɑ ʃ χ ɑ v ɔ ɾ u m
երաշխիք	j ɛ ɾ ɑ ʃ χ i kʰ
երաշտ	j ɛ ɾ ɑ ʃ t
երբ	j ɛ ɾ pʰ
երբեմն	j ɛ ɾ pʰ ɛ m ə n
երբեմնի	j ɛ ɾ pʰ ɛ m n i
երգ	j ɛ ɾ kʰ
երգահան	j ɛ ɾ kʰ ɑ h ɑ n
երգել	j ɛ ɾ kʰ ɛ l
երգեցիկ	j ɛ ɾ kʰ ɛ t͡sʰ i k
երգեցողություն	j ɛ ɾ kʰ ɛ t͡sʰ ɔ ʁ u tʰ j u n
երգի	j ɛ ɾ kʰ i
երգիծաբան	j ɛ ɾ kʰ i t͡s ɑ b ɑ n
երգիծել	j ɛ ɾ kʰ i t͡s ɛ l
երգիչ	j ɛ ɾ kʰ i t͡ʃʰ
երգչուհի	j ɛ ɾ kʰ t͡ʃʰ u h i
երդում	j ɛ ɾ tʰ u m
երդվել	j ɛ ɾ tʰ v ɛ l
երդվյալ	j ɛ ɾ tʰ v j ɑ l
երեկ	j ɛ ɾ ɛ k
երեկո	j ɛ ɾ ɛ k ɔ
երեկոյան	j ɛ ɾ ɛ k ɔ j ɑ n
երեկույթ	j ɛ ɾ ɛ k u j tʰ
երեմիա	j ɛ ɾ ɛ m j ɑ
երեսնամյա	j ɛ ɾ ɛ s n ɑ m j ɑ
երերալ	j ɛ ɾ ɛ ɾ ɑ l
երեց	j ɛ ɾ ɛ t͡sʰ
երեւալ	j ɛ ɾ ɛ v ɑ l
երեւակայածին	j ɛ ɾ ɛ v ɑ k ɑ j ɑ t͡s i n
երեւակայական	j ɛ ɾ ɛ v ɑ k ɑ j ɑ k ɑ n
երեւակայել	j ɛ ɾ ɛ v ɑ k ɑ j ɛ l
երեւակայելի	j ɛ ɾ ɛ v ɑ k ɑ j ɛ l i
երեւակայություն	j ɛ ɾ ɛ v ɑ k ɑ j u tʰ j u n
երեւակայվել	j ɛ ɾ ɛ v ɑ k ɑ j v ɛ l
երեւան	j ɛ ɾ ɛ v ɑ n
երեւելի	j ɛ ɾ ɛ v ɛ l i
երեւույթ	j ɛ ɾ ɛ v u j tʰ
երեք	j ɛ ɾ ɛ kʰ
երեքկին	j ɛ ɾ ɛ kʰ k i n
երեքնուկ	j ɛ ɾ ɛ kʰ n u k
երթեւեկել	j ɛ ɾ tʰ ɛ v ɛ k ɛ l
երթեւեկություն	j ɛ ɾ tʰ ɛ v ɛ k u tʰ j u n
երթեւեկում	j ɛ ɾ tʰ ɛ v ɛ k u m
երթուղային	j ɛ ɾ tʰ u ʁ ɑ j i n
երթուղի	j ɛ ɾ tʰ u ʁ i
երիվար	j ɛ ɾ i v ɑ ɾ
երիտասարդ	j ɛ ɾ i t ɑ s ɑ ɾ tʰ
երիտասարդություն	j ɛ ɾ i t ɑ s ɑ ɾ d u tʰ j u n
երիքով	j ɛ ɾ i kʰ ɔ v
երկ	j ɛ ɾ k
երկաթ	j ɛ ɾ k ɑ tʰ
երկաթե	j ɛ ɾ k ɑ tʰ ɛ
երկաթեղեն	j ɛ ɾ k ɑ tʰ ɛ ʁ ɛ n
երկաթյա	j ɛ ɾ k ɑ tʰ j ɑ
երկաթուղային	j ɛ ɾ k ɑ tʰ u ʁ ɑ j i n
երկաթուղի	j ɛ ɾ k ɑ tʰ u ʁ i
երկայն	j ɛ ɾ k ɑ j n
երկար	j ɛ ɾ k ɑ ɾ
երկարաժամկետ	j ɛ ɾ k ɑ ɾ ɑ ʒ ɑ m k ɛ t
երկարամյա	j ɛ ɾ k ɑ ɾ ɑ m j ɑ
երկարավուն	j ɛ ɾ k ɑ ɾ ɑ v u n
երկարացնել	j ɛ ɾ k ɑ ɾ ɑ t͡sʰ n ɛ l
երկարություն	j ɛ ɾ k ɑ ɾ u tʰ j u n
երկբայելի	j ɛ ɾ k b ɑ j ɛ l i
երկբայորեն	j ɛ ɾ k b ɑ j ɔ ɾ ɛ n
երկընտրանք	j ɛ ɾ k ə n t ɾ ɑ ŋ kʰ
երկինք	j ɛ ɾ k i ŋ kʰ
երկիր	j ɛ ɾ k i ɾ
երկմտանք	j ɛ ɾ k m ə t ɑ ŋ kʰ
երկյուղ	j ɛ ɾ k j u ʁ
երկյուղալի	j ɛ ɾ k j u ʁ ɑ l i
երկյուղալիր	j ɛ ɾ k j u ʁ ɑ l i ɾ
երկյուղածություն	j ɛ ɾ k j u ʁ ɑ t͡s u tʰ j u n
երկնագույն	j ɛ ɾ k n ɑ ɡ u j n
երկնաքար	j ɛ ɾ k n ɑ kʰ ɑ ɾ
երկնաքեր	j ɛ ɾ k n ɑ kʰ ɛ ɾ
երկու	j ɛ ɾ k u
երկունք	j ɛ ɾ k u ŋ kʰ
երկուշաբթի	j ɛ ɾ k u ʃ ɑ pʰ tʰ i
երկուս	j ɛ ɾ k u s
երկչոտ	j ɛ ɾ k t͡ʃʰ ɔ t
երկսայրի	j ɛ ɾ k s ɑ j ɾ i
երկվորյակ	j ɛ ɾ k v ɔ ɾ j ɑ k
երկվորյակներ	j ɛ ɾ k v ɔ ɾ j ɑ k n ɛ ɾ
երկրաբան	j ɛ ɾ k ɾ ɑ b ɑ n
երկրագունդ	j ɛ ɾ k ɾ ɑ ɡ u n d
երկրաշարժ	j ɛ ɾ k ɾ ɑ ʃ ɑ ɾ ʒ
երկրաչափական	j ɛ ɾ k ɾ ɑ t͡ʃʰ ɑ pʰ ɑ k ɑ n
երկրաչափություն	j ɛ ɾ k ɾ ɑ t͡ʃʰ ɑ pʰ u tʰ j u n
երկրպագու	j ɛ ɾ k ə ɾ p ɑ ɡ u
երնեկ	j ɛ ɾ n ɛ k
երշիկ	j ɛ ɾ ʃ i k
երուսաղեմ	j ɛ ɾ u s ɑ ʁ ɛ m
երջանկություն	j ɛ ɾ d͡ʒ ɑ ŋ k u tʰ j u n
երվազ	j ɛ ɾ v ɑ z
երվանդ	j ɛ ɾ v ɑ n d
երվինյան	j ɛ ɾ v i n j ɑ n
եւս	j ɛ v ə s
եփեսոս	j ɛ pʰ ɛ s ɔ s
եփրատ	j ɛ pʰ ɾ ɑ t
եփրեմ	j ɛ pʰ ɾ ɛ m
եք	ɛ kʰ
զագրեբ	z ɑ ɡ ɾ ɛ b
զալցբուրգ	z ɑ l t͡sʰ b u ɾ ɡ
զամբիա	z ɑ m b j ɑ
զամբյուղ	z ɑ m b j u ʁ
զայրույթ	z ɑ j ɾ u j tʰ
զայրուց	z ɑ j ɾ u t͡sʰ
զանազան	z ɑ n ɑ z ɑ n
զանգ	z ɑ ŋ ɡ
զանգակ	z ɑ ŋ ɡ ɑ k
զանգակատուն	z ɑ ŋ ɡ ɑ k ɑ t u n
զանգել	z ɑ ŋ ɡ ɛ l
զանգի	z ɑ ŋ ɡ i
զանգված	z ɑ ŋ ɡ v ɑ t͡s
զանգվածային	z ɑ ŋ ɡ v ɑ t͡s ɑ j i n
զառ	z ɑ r
զառանցել	z ɑ r ɑ n t͡sʰ ɛ l
զավակ	z ɑ v ɑ k
զավեն	z ɑ v ɛ n
զավեշտ	z ɑ v ɛ ʃ t
զավեշտական	z ɑ v ɛ ʃ t ɑ k ɑ n
զավթել	z ɑ f tʰ ɛ l
զավտրիկ	z ɑ f t ɾ i k
զատ	z ɑ t
զատել	z ɑ t ɛ l
զարգանալ	z ɑ ɾ ɡ ɑ n ɑ l
զարգացում	z ɑ ɾ ɡ ɑ t͡sʰ u m
զարդ	z ɑ ɾ tʰ
զարդարանք	z ɑ ɾ tʰ ɑ ɾ ɑ ŋ kʰ
զարդարել	z ɑ ɾ tʰ ɑ ɾ ɛ l
զարդարուն	z ɑ ɾ tʰ ɑ ɾ u n
զարեհ	z ɑ ɾ ɛ h
զարկ	z ɑ ɾ k
զարկերակ	z ɑ ɾ k ɛ ɾ ɑ k
զարհուր	z ɑ ɾ h u ɾ
զարհուրանք	z ɑ ɾ h u ɾ ɑ ŋ kʰ
զարհուրատեսք	z ɑ ɾ h u ɾ ɑ t ɛ s kʰ
զարհուրելի	z ɑ ɾ h u ɾ ɛ l i
զարհուրում	z ɑ ɾ h u ɾ u m
զարմ	z ɑ ɾ m
զարմանալ	z ɑ ɾ m ɑ n ɑ l
զարմանք	z ɑ ɾ m ɑ ŋ kʰ
զարմացած	z ɑ ɾ m ɑ t͡sʰ ɑ t͡s
զարմացնել	z ɑ ɾ m ɑ t͡sʰ n ɛ l
զարմիկ	z ɑ ɾ m i k
զարմուհի	z ɑ ɾ m u h i
զարուհի	z ɑ ɾ u h i
զաքարիա	z ɑ kʰ ɑ ɾ j ɑ
զաքարյան	z ɑ kʰ ɑ ɾ j ɑ n
զբաղեցնել	ə z b ɑ ʁ ɛ t͡sʰ n ɛ l
զբաղվել	ə z b ɑ ʁ v ɛ l
զբոսանավ	ə z b ɔ s ɑ n ɑ v
զբոսանք	ə z b ɔ s ɑ ŋ kʰ
զբոսաշրջիկ	ə z b ɔ s ɑ ʃ ə ɾ d͡ʒ i k
զբոսաշրջություն	ə z b ɔ s ɑ ʃ ə ɾ d͡ʒ u tʰ j u n
զբոսնել	ə z b ɔ s n ɛ l
զգալ	ə z ɡ ɑ l
զգայարան	ə z ɡ ɑ j ɑ ɾ ɑ n
զգայռում	ə z ɡ ɑ j r u m
զգաստ	ə z ɡ ɑ s t
զգաստություն	ə z ɡ ɑ s t u tʰ j u n
զգացմունք	ə z ɡ ɑ t͡sʰ m u ŋ kʰ
զգեստ	ə z ɡ ɛ s t
զգեստապահարան	ə z ɡ ɛ s t ɑ p ɑ h ɑ ɾ ɑ n
զգոն	ə z ɡ ɔ n
զգոնություն	ə z ɡ ɔ n u tʰ j u n
զգույշ	ə z ɡ u j ʃ
զեխ	z ɛ χ
զեկույց	z ɛ k u j t͡sʰ
զեղչ	z ɛ χ t͡ʃʰ
զեղչել	z ɛ χ t͡ʃʰ ɛ l
զեյթուն	z ɛ j tʰ u n
զենոն	z ɛ n ɔ n
զենք	z ɛ ŋ kʰ
զեռուն	z ɛ r u n
զետեղել	z ɛ t ɛ ʁ ɛ l
զերծ	z ɛ ɾ t͡s
զեւս	z ɛ f s
զզվանք	z ə z v ɑ ŋ kʰ
զզվելի	z ə z v ɛ l i
զիբիլ	z i b i l
զիբիլանոց	z i b i l ɑ n ɔ t͡sʰ
զիբիլի	z i b i l i
զիգզագ	z i ɡ z ɑ ɡ
զինադադար	z i n ɑ d ɑ tʰ ɑ ɾ
զինամթերք	z i n ɑ m ə tʰ ɛ ɾ kʰ
զինանշան	z i n ɑ n ə ʃ ɑ n
զինել	z i n ɛ l
զինծառայող	z i n t͡s ɑ r ɑ j ɔ ʁ
զինված	z i n v ɑ t͡s
զինվել	z i n v ɛ l
զինվոր	z i n v ɔ ɾ
զինվորական	z i n v ɔ ɾ ɑ k ɑ n
զինվորականություն	z i n v ɔ ɾ ɑ k ɑ n u tʰ j u n
զիջում	z i t͡ʃʰ u m
զմռնիտ	z ə m ə r n i t
զմրուխտ	z ə m ɾ u χ t
զնդան	z ə n d ɑ n
զնջիլ	z ə n d͡ʒ i l
զոդ	z ɔ d
զոդել	z ɔ d ɛ l
զոհ	z ɔ h
զոհասեղան	z ɔ h ɑ s ɛ ʁ ɑ n
զոհվել	z ɔ h v ɛ l
զոյա	z ɔ j ɑ
զոոխորիա	z ɔ ɔ χ ɔ ɾ j ɑ
զոռ	z ɔ r
զոռով	z ɔ r ɔ v
զով	z ɔ v
զոր	z ɔ ɾ
զորախումբ	z ɔ ɾ ɑ χ u m b
զորահավաք	z ɔ ɾ ɑ h ɑ v ɑ kʰ
զորավար	z ɔ ɾ ɑ v ɑ ɾ
զորավարժություն	z ɔ ɾ ɑ v ɑ ɾ ʒ u tʰ j u n
զորավոր	z ɔ ɾ ɑ v ɔ ɾ
զորեղ	z ɔ ɾ ɛ ʁ
զորիկ	z ɔ ɾ i k
զորություն	z ɔ ɾ u tʰ j u n
զորք	z ɔ ɾ kʰ
զուգադիպություն	z u ɡ ɑ d i p u tʰ j u n
զուգարան	z u kʰ ɑ ɾ ɑ n
զուգել	z u kʰ ɛ l
զույգ	z u j kʰ
զուսպ	z u s p
զուտ	z u t
զուր	z u ɾ
զոքանչ	z ɔ kʰ ɑ n t͡ʃʰ
զսպաշապիկ	z ə s p ɑ ʃ ɑ p i k
զսպել	z ə s p ɛ l
զվարթ	z ə v ɑ ɾ tʰ
զվարճախոսել	z ə v ɑ ɾ t͡ʃ ɑ χ ɔ s ɛ l
զվարճանալ	z ə v ɑ ɾ t͡ʃ ɑ n ɑ l
զվարճանք	z ə v ɑ ɾ t͡ʃ ɑ ŋ kʰ
զտել	z ə t ɛ l
զրադաշտ	z ə ɾ ɑ d ɑ ʃ t
զրահ	z ə ɾ ɑ h
զրահակիր	z ə ɾ ɑ h ɑ k i ɾ
զրկել	z ə ɾ k ɛ l
զրո	z ə ɾ ɔ
զրույց	z ə ɾ u j t͡sʰ
զրուցարան	z ə ɾ u t͡sʰ ɑ ɾ ɑ n
զրուցել	z ə ɾ u t͡sʰ ɛ l
էակ	ɛ j ɑ k
էական	ɛ j ɑ k ɑ n
էգ	ɛ kʰ
էգուց	ɛ kʰ u t͡sʰ
էդ	ɛ d
էդգար	ɛ d ɡ ɑ ɾ
էդո	ɛ d ɔ
էթալ	ɛ tʰ ɑ l
էթիկա	ɛ tʰ i k ɑ
էլբակյան	ɛ l b ɑ k j ɑ n
էլեկտրական	ɛ l ɛ k t ɾ ɑ k ɑ n
էլեկտրականություն	ɛ l ɛ k t ɾ ɑ k ɑ n u tʰ j u n
էլեկտրոլիզ	ɛ l ɛ k t ɾ ɔ l i z
էլեկտրոն	ɛ l ɛ k t ɾ ɔ n
էլեկտրոնային	ɛ l ɛ k t ɾ ɔ n ɑ j i n
էլեմենտ	ɛ l ɛ m ɛ n t
էլեմենտար	ɛ l ɛ m ɛ n t ɑ ɾ
էլեն	ɛ l ɛ n
էլչիբեյ	ɛ l t͡ʃʰ i b ɛ j
էկոլոգիա	ɛ k ɔ l ɔ ɡ j ɑ
էկոնոմիկա	ɛ k ɔ n ɔ m i k ɑ
էկվադոր	ɛ k v ɑ d ɔ ɾ
էկրան	ɛ k ɾ ɑ n
էմիգրանտ	ɛ m i ɡ ɾ ɑ n t
էմին	ɛ m i n
էմիր	ɛ m i ɾ
էմոցիա	ɛ m ɔ t͡sʰ j ɑ
էմպեդոկլես	ɛ m p ɛ d ɔ k l ɛ s
էն	ɛ n
էներգիա	ɛ n ɛ ɾ ɡ j ɑ
էնֆիաջյան	ɛ n f i j ɑ d͡ʒ j ɑ n
էշ	ɛ ʃ
էպիկենտրոն	ɛ p i k ɛ n t ɾ ɔ n
էպիրոս	ɛ p i ɾ ɔ s
էջ	ɛ d͡ʒ
էջմիածին	ɛ t͡ʃʰ m j ɑ t͡s i n
էս	ɛ s
էսկալացիա	ɛ s k ɑ l ɑ t͡sʰ j ɑ
էսսե	ɛ sː ɛ
էստոնական	ɛ s t ɔ n ɑ k ɑ n
էստոնացի	ɛ s t ɔ n ɑ t͡sʰ i
էսօր	ɛ s ɔ ɾ
էվթանազիա	ɛ f tʰ ɑ n ɑ z j ɑ
էվոլյուցիա	ɛ v ɔ l j u t͡sʰ j ɑ
էվոլյուցիոն	ɛ v ɔ l j u t͡sʰ j ɔ n
էտ	ɛ t
էրե	ɛ ɾ ɛ
էրեբունի	ɛ ɾ ɛ b u n i
էրեխա	ɛ ɾ ɛ χ ɑ
էրես	ɛ ɾ ɛ s
էրզրում	ɛ ɾ z ə ɾ u m
էրիկ	ɛ ɾ i k
էրկու	ɛ ɾ k u
էրունջէկ	ɛ ɾ u n d͡ʒ ɛ k
էքսպերիմենտալ	ɛ kʰ s p ɛ ɾ i m ɛ n t ɑ l
էքսպերտ	ɛ kʰ s p ɛ ɾ t
էֆենդի	ɛ f ɛ n d i
ըղձական	ə ʁ d͡z ɑ k ɑ n
ըմբշամարտ	ə m b ʃ ɑ m ɑ ɾ t
ըմպել	ə m p ɛ l
ըմպելիք	ə m p ɛ l i kʰ
ընդամենը	ə n tʰ ɑ m ɛ n ə
ընդավոր	ə n d ɑ v ɔ ɾ
ընդարձակ	ə n tʰ ɑ ɾ t͡sʰ ɑ k
ընդարմանալ	ə n tʰ ɑ ɾ m ɑ n ɑ l
ընդդիմություն	ə n dː i m u tʰ j u n
ընդեղեն	ə n d ɛ ʁ ɛ n
ընդերք	ə n d ɛ ɾ kʰ
ընդլայնել	ə n d l ɑ j n ɛ l
ընդհանրական	ə n tʰ h ɑ n ɾ ɑ k ɑ n
ընդմիշտ	ə n d m i ʃ t
ընդունակ	ə n tʰ u n ɑ k
ընդունակություն	ə n tʰ u n ɑ k u tʰ j u n
ընդունել	ə n tʰ u n ɛ l
ընդունելի	ə n tʰ u n ɛ l i
ընդունում	ə n tʰ u n u m
ընդունված	ə n tʰ u n v ɑ t͡s
ընդվզում	ə n d v ə z u m
ընել	ə n ɛ l
ընթածիր	ə n tʰ ɑ t͡s i ɾ
ընթանալ	ə n tʰ ɑ n ɑ l
ընթաց	ə n tʰ ɑ t͡sʰ
ընթացակարգ	ə n tʰ ɑ t͡sʰ ɑ k ɑ ɾ kʰ
ընթացք	ə n tʰ ɑ t͡sʰ kʰ
ընթացքում	ə n tʰ ɑ t͡sʰ kʰ u m
ընթերցանություն	ə n tʰ ɛ ɾ t͡sʰ ɑ n u tʰ j u n
ընթերցող	ə n tʰ ɛ ɾ t͡sʰ ɔ ʁ
ընթերցում	ə n tʰ ɛ ɾ t͡sʰ u m
ընթրիք	ə n tʰ ɾ i kʰ
ընծա	ə n t͡s ɑ
ընկերություն	ə ŋ k ɛ ɾ u tʰ j u n
ընկերուհի	ə ŋ k ɛ ɾ u h i
ընկեցիկ	ə ŋ k ɛ t͡sʰ i k
ընկղմել	ə ŋ k ʁ m ɛ l
ընկճել	ə ŋ k ə t͡ʃ ɛ l
ընկճվել	ə ŋ k ə t͡ʃ v ɛ l
ընկնել	ə ŋ k n ɛ l
ընկուզենի	ə ŋ k u z ɛ n i
ընկույզ	ə ŋ k u j z
ընձառյուծ	ə n d͡z ɑ r j u t͡s
ընտանեական	ə n t ɑ n j ɑ k ɑ n
ընտանեկան	ə n t ɑ n ɛ k ɑ n
ընտանի	ə n t ɑ n i
ընտիր	ə n t i ɾ
ընտրական	ə n t ɾ ɑ k ɑ n
ընտրակաշառք	ə n t ɾ ɑ k ɑ ʃ ɑ r kʰ
ընտրակեղծարար	ə n t ɾ ɑ k ɛ χ t͡s ɑ ɾ ɑ ɾ
ընտրյալ	ə n t ɾ j ɑ l
ընտրող	ə n t ɾ ɔ ʁ
ընտրություն	ə n t ɾ u tʰ j u n
ընտրվել	ə n t ə ɾ v ɛ l
թագ	tʰ ɑ ɡ
թագավարակ	tʰ ɑ ɡ ɑ v ɑ ɾ ɑ k
թագավոր	tʰ ɑ kʰ ɑ v ɔ ɾ
թագավորություն	tʰ ɑ ɡ ɑ v ɔ ɾ u tʰ j u n
թագուհի	tʰ ɑ kʰ u h i
թադեւոսյան	tʰ ɑ tʰ ɛ v ɔ s j ɑ n
թաթար	tʰ ɑ tʰ ɑ ɾ
թաթարերեն	tʰ ɑ tʰ ɑ ɾ ɛ ɾ ɛ n
թաթերական	tʰ ɑ tʰ ɛ ɾ ɑ k ɑ n
թաթուլ	tʰ ɑ tʰ u l
թաի	tʰ ɑ i
թաիլանդ	tʰ ɑ j l ɑ n d
թալան	tʰ ɑ l ɑ n
թալանչի	tʰ ɑ l ɑ n t͡ʃʰ i
թալիբ	tʰ ɑ l i b
թալիբան	tʰ ɑ l i b ɑ n
թալիշ	tʰ ɑ l i ʃ
թալիշերեն	tʰ ɑ l i ʃ ɛ ɾ ɛ n
թալմուդ	tʰ ɑ l m u d
թախանձել	tʰ ɑ χ ɑ n d͡z ɛ l
թակարդ	tʰ ɑ k ɑ ɾ d
թակոց	tʰ ɑ k ɔ t͡sʰ
թահաթ	tʰ ɑ h ɑ tʰ
թաղ	tʰ ɑ ʁ
թաղանթ	tʰ ɑ ʁ ɑ n tʰ
թաղապետ	tʰ ɑ ʁ ɑ p ɛ t
թաղել	tʰ ɑ ʁ ɛ l
թաղում	tʰ ɑ ʁ u m
թամադա	tʰ ɑ m ɑ d ɑ
թամաշա	tʰ ɑ m ɑ ʃ ɑ
թամիլերեն	tʰ ɑ m i l ɛ ɾ ɛ n
թամիլնադ	tʰ ɑ m i l n ɑ d
թայբեյ	tʰ ɑ j b ɛ j
թայվան	tʰ ɑ j v ɑ n
թայֆա	tʰ ɑ j f ɑ
թայֆուն	tʰ ɑ j f u n
թանաքաձուկ	tʰ ɑ n ɑ kʰ ɑ d͡z u k
թանաքաման	tʰ ɑ n ɑ kʰ ɑ m ɑ n
թանգարան	tʰ ɑ ŋ ɡ ɑ ɾ ɑ n
թանկ	tʰ ɑ ŋ k
թանկարժեք	tʰ ɑ ŋ k ɑ ɾ ʒ ɛ kʰ
թանձր	tʰ ɑ n d͡z ə ɾ
թառ	tʰ ɑ r
թառամ	tʰ ɑ r ɑ m
թառել	tʰ ɑ r ɛ l
թաս	tʰ ɑ s
թավա	tʰ ɑ v ɑ
թավալ	tʰ ɑ v ɑ l
թավուտ	tʰ ɑ v u t
թավջութակ	tʰ ɑ v d͡ʒ u tʰ ɑ k
թավրիզ	tʰ ɑ v ɾ i z
թատերական	tʰ ɑ t ɛ ɾ ɑ k ɑ n
թատրոն	tʰ ɑ t ɾ ɔ n
թարգման	tʰ ɑ ɾ kʰ m ɑ n
թարգմանել	tʰ ɑ ɾ kʰ m ɑ n ɛ l
թարգմանիչ	tʰ ɑ ɾ kʰ m ɑ n i t͡ʃʰ
թարթել	tʰ ɑ ɾ tʰ ɛ l
թարխան	tʰ ɑ ɾ χ ɑ n
թարխանյան	tʰ ɑ ɾ χ ɑ n j ɑ n
թարխուն	tʰ ɑ ɾ χ u n
թարմ	tʰ ɑ ɾ m
թարմանալ	tʰ ɑ ɾ m ɑ n ɑ l
թարմացնել	tʰ ɑ ɾ m ɑ t͡sʰ n ɛ l
թաց	tʰ ɑ t͡sʰ
թացություն	tʰ ɑ t͡sʰ u tʰ j u n
թափել	tʰ ɑ pʰ ɛ l
թափոր	tʰ ɑ pʰ ɔ ɾ
թափուր	tʰ ɑ pʰ u ɾ
թաք	tʰ ɑ kʰ
թաքթաքուր	tʰ ɑ kʰ tʰ ɑ kʰ u ɾ
թաքուստ	tʰ ɑ kʰ u s t
թաքցնել	tʰ ɑ kʰ t͡sʰ ə n ɛ l
թբիլիսի	tʰ ə b i l i s i
թե	tʰ ɛ
թեբե	tʰ ɛ b ɛ
թեեւ	tʰ ɛ j ɛ v
թեզ	tʰ ɛ z
թեզան	tʰ ɛ z ɑ n
թեթեւ	tʰ ɛ tʰ ɛ v
թեթեւաշարժ	tʰ ɛ tʰ ɛ v ɑ ʃ ɑ ɾ ʒ
թեժ	tʰ ɛ ʒ
թել	tʰ ɛ l
թելադրիչ	tʰ ɛ l ɑ d ɾ i t͡ʃʰ
թելավ	tʰ ɛ l ɑ v
թեկնածու	tʰ ɛ k n ɑ t͡s u
թեկուզ	tʰ ɛ k u z
թեհրան	tʰ ɛ h ɾ ɑ n
թեղի	tʰ ɛ ʁ i
թեմա	tʰ ɛ m ɑ
թեյ	tʰ ɛ j
թեյնիկ	tʰ ɛ j n i k
թենիս	tʰ ɛ n i s
թենիսիստ	tʰ ɛ n i s i s t
թենիսիստուհի	tʰ ɛ n i s i s t u h i
թեոդոսիա	tʰ ɛ ɔ d ɔ s j ɑ
թեորեմ	tʰ ɛ ɔ ɾ ɛ m
թեպետ	tʰ ɛ p ɛ t
թեր	tʰ ɛ ɾ
թերագնահատում	tʰ ɛ ɾ ɑ ɡ ə n ɑ h ɑ t u m
թերակղզի	tʰ ɛ ɾ ɑ k ə ʁ z i
թերահավատ	tʰ ɛ ɾ ɑ h ɑ v ɑ t
թերասնում	tʰ ɛ ɾ ɑ s ə n u m
թերթ	tʰ ɛ ɾ tʰ
թերթիկ	tʰ ɛ ɾ tʰ i k
թերթոն	tʰ ɛ ɾ tʰ ɔ n
թերի	tʰ ɛ ɾ i
թերություն	tʰ ɛ ɾ u tʰ j u n
թեւ	tʰ ɛ v
թեւքաճարմանդ	tʰ ɛ f kʰ ɑ t͡ʃ ɑ ɾ m ɑ n d
թեփ	tʰ ɛ pʰ
թեփուկ	tʰ ɛ pʰ u k
թեք	tʰ ɛ kʰ
թեքել	tʰ ɛ kʰ ɛ l
թեքում	tʰ ɛ kʰ u m
թեքվել	tʰ ɛ kʰ v ɛ l
թզենի	tʰ ə z ɛ n i
թզուկ	tʰ ə z u k
թթենի	tʰ ə tʰ ɛ n i
թթի	tʰ ə tʰ i
թթխմոր	tʰ ə tʰ χ ə m ɔ ɾ
թթուջուր	tʰ ə tʰ u d͡ʒ u ɾ
թթված	tʰ ə tʰ v ɑ t͡s
թթվածին	tʰ ə tʰ v ɑ t͡s i n
թթվասեր	tʰ ə tʰ v ɑ s ɛ ɾ
թի	tʰ i
թիզ	tʰ i z
թիթեռ	tʰ i tʰ ɛ r
թիկնապահ	tʰ i k n ɑ p ɑ h
թիկունք	tʰ i k u ŋ kʰ
թիմ	tʰ i m
թիվ	tʰ i v
թիրախ	tʰ i ɾ ɑ χ
թիրախային	tʰ i ɾ ɑ χ ɑ j i n
թիքա	tʰ i kʰ ɑ
թիֆլիս	tʰ i f l i s
թլվատել	tʰ ə l v ɑ t ɛ l
թխկի	tʰ ə χ k i
թխվածք	tʰ ə χ v ɑ t͡s kʰ
թհիմփհու	tʰ h i m pʰ h u
թղթապանակ	tʰ ə χ tʰ ɑ p ɑ n ɑ k
թմբլիկ	tʰ ə m b ə l i k
թմբկահար	tʰ ə m b k ɑ h ɑ ɾ
թմբուկ	tʰ ə m b u k
թմրամիջոց	tʰ ə m ɾ ɑ m i t͡ʃʰ ɔ t͡sʰ
թմրամոլություն	tʰ ə m ɾ ɑ m ɔ l u tʰ j u n
թմփլիկ	tʰ ə m pʰ ə l i k
թյուրիմացություն	tʰ j u ɾ i m ɑ t͡sʰ u tʰ j u n
թյուրինգիա	tʰ j u ɾ i ŋ ɡ j ɑ
թնդանոթ	tʰ ə n d ɑ n ɔ tʰ
թշնամի	tʰ ə ʃ n ɑ m i
թշնամություն	tʰ ə ʃ n ɑ m u tʰ j u n
թշվառ	tʰ ə ʃ v ɑ r
թո	tʰ ɔ
թոզ	tʰ ɔ z
թոթովել	tʰ ɔ tʰ ɔ v ɛ l
թող	tʰ ɔ ʁ
թողարկել	tʰ ɔ ʁ ɑ ɾ k ɛ l
թողել	tʰ ɔ ʁ ɛ l
թողություն	tʰ ɔ ʁ u tʰ j u n
թոմաս	tʰ ɔ m ɑ s
թոնիր	tʰ ɔ n i ɾ
թոշակ	tʰ ɔ ʃ ɑ k
թոշակառու	tʰ ɔ ʃ ɑ k ɑ r u
թոռ	tʰ ɔ r
թոռնիկ	tʰ ɔ r n i k
թովմասյան	tʰ ɔ v m ɑ s j ɑ n
թովչանք	tʰ ɔ f t͡ʃʰ ɑ ŋ kʰ
թորգոմ	tʰ ɔ ɾ ɡ ɔ m
թորիծ	tʰ ɔ ɾ i t͡s
թորշոմ	tʰ ɔ ɾ ʃ ɔ m
թորոս	tʰ ɔ ɾ ɔ s
թուզ	tʰ u z
թութ	tʰ u tʰ
թութակ	tʰ u tʰ ɑ k
թութուն	tʰ u tʰ u n
թութք	tʰ u tʰ kʰ
թուլ	tʰ u l
թուլա	tʰ u l ɑ
թուլաբերանություն	tʰ u l ɑ b ɛ ɾ ɑ n u tʰ j u n
թուլաբնություն	tʰ u l ɑ b ə n u tʰ j u n
թուլանալ	tʰ u l ɑ n ɑ l
թուխ	tʰ u χ
թուխս	tʰ u χ s
թուղթ	tʰ u χ tʰ
թույլ	tʰ u j l
թույլատրել	tʰ u j l ɑ t ɾ ɛ l
թույլտվություն	tʰ u j l t v u tʰ j u n
թույն	tʰ u j n
թունավորել	tʰ u n ɑ v ɔ ɾ ɛ l
թունդ	tʰ u n d
թունել	tʰ u n ɛ l
թունելային	tʰ u n ɛ l ɑ j i n
թուր	tʰ u ɾ
թուրինջ	tʰ u ɾ i n d͡ʒ
թուրծ	tʰ u ɾ t͡s
թուրմ	tʰ u ɾ m
թուրք	tʰ u ɾ kʰ
թուրքերեն	tʰ u ɾ kʰ ɛ ɾ ɛ n
թուրքիա	tʰ u ɾ kʰ j ɑ
թուրքմենական	tʰ u ɾ kʰ m ɛ n ɑ k ɑ n
թուրքմեներեն	tʰ u ɾ kʰ m ɛ n ɛ ɾ ɛ n
թուրքմենստան	tʰ u ɾ kʰ m ɛ n s t ɑ n
թուք	tʰ u kʰ
թոք	tʰ ɔ kʰ
թոքաբորբ	tʰ ɔ kʰ ɑ b ɔ ɾ b
թռիչք	tʰ ə r i t͡ʃʰ kʰ
թռնել	tʰ ə r n ɛ l
թռչող	tʰ ə r t͡ʃʰ ɔ ʁ
թռչուն	tʰ ə r t͡ʃʰ u n
թվաբանական	tʰ ə v ɑ b ɑ n ɑ k ɑ n
թվաբանություն	tʰ ə v ɑ b ɑ n u tʰ j u n
թվանշան	tʰ ə v ɑ n ə ʃ ɑ n
թվարկել	tʰ ə v ɑ ɾ k ɛ l
թվի	tʰ ə v i
թվիթեր	tʰ v i tʰ ɛ ɾ
թրամփ	tʰ ə ɾ ɑ m pʰ
թրաշ	tʰ ə ɾ ɑ ʃ
թրեւ	tʰ ə ɾ ɛ v
թրթնջուկ	tʰ ə ɾ tʰ ə n d͡ʒ u k
թրթուր	tʰ ə ɾ tʰ u ɾ
թրիք	tʰ ə ɾ i kʰ
թրծել	tʰ ə ɾ t͡s ɛ l
թրմել	tʰ ə ɾ m ɛ l
թրջել	tʰ ə ɾ t͡ʃʰ ɛ l
թրքուհի	tʰ ə ɾ kʰ u h i
թքել	tʰ ə kʰ ɛ l
ժամ	ʒ ɑ m
ժաման	ʒ ɑ m ɑ n
ժամանակ	ʒ ɑ m ɑ n ɑ k
ժամանակագիր	ʒ ɑ m ɑ n ɑ k ɑ ɡ i ɾ
ժամանակագրություն	ʒ ɑ m ɑ n ɑ k ɑ ɡ ɾ u tʰ j u n
ժամանակաշրջան	ʒ ɑ m ɑ n ɑ k ɑ ʃ ə ɾ d͡ʒ ɑ n
ժամանակի	ʒ ɑ m ɑ n ɑ k i
ժամանել	ʒ ɑ m ɑ n ɛ l
ժամանում	ʒ ɑ m ɑ n u m
ժամացույց	ʒ ɑ m ɑ t͡sʰ u j t͡sʰ
ժամկոչյան	ʒ ɑ m k ɔ t͡ʃʰ j ɑ n
ժայթքում	ʒ ɑ j tʰ kʰ u m
ժանգ	ʒ ɑ ŋ ɡ
ժանի	ʒ ɑ n i
ժանիք	ʒ ɑ n i kʰ
ժանյակ	ʒ ɑ n j ɑ k
ժանտ	ʒ ɑ n t
ժանտախտ	ʒ ɑ n t ɑ χ t
ժանտափուշ	ʒ ɑ n t ɑ pʰ u ʃ
ժապավեն	ʒ ɑ p ɑ v ɛ n
ժառանգ	ʒ ɑ r ɑ ŋ ɡ
ժառանգել	ʒ ɑ r ɑ ŋ ɡ ɛ l
ժառանգորդ	ʒ ɑ r ɑ ŋ ɡ ɔ ɾ tʰ
ժառանգություն	ʒ ɑ r ɑ ŋ ɡ u tʰ j u n
ժընեւ	ʒ ə n ɛ v
ժիր	ʒ i ɾ
ժիրայր	ʒ i ɾ ɑ j ɾ
ժլատ	ʒ ə l ɑ t
ժխտական	ʒ ə χ t ɑ k ɑ n
ժխտել	ʒ ə χ t ɛ l
ժողով	ʒ ɔ ʁ ɔ v
ժողովուրդ	ʒ ɔ ʁ ɔ v u ɾ tʰ
ժողովրդական	ʒ ɔ ʁ ɔ v ə ɾ tʰ ɑ k ɑ n
ժողովրդավարական	ʒ ɔ ʁ ɔ v ə ɾ tʰ ɑ v ɑ ɾ ɑ k ɑ n
ժուժկալ	ʒ u ʒ k ɑ l
ժուռնալ	ʒ u r n ɑ l
ժուռնալիստ	ʒ u r n ɑ l i s t
իբո	i b ɔ
իգական	i kʰ ɑ k ɑ n
իգնատիոս	i ɡ n ɑ t i ɔ s
իզաֆետ	i z ɑ f ɛ t
իզմիր	i z m i ɾ
իժ	i ʒ
իիհ	i i h ə
իլ	i l
իլենի	i l ɛ n i
իլիկ	i l i k
իլլիրիական	i lː i ɾ j ɑ k ɑ n
իլհամ	i l h ɑ m
իհարկե	i h ɑ ɾ k ɛ
իմ	i m
իմա	i m ɑ
իմանալ	i m ɑ n ɑ l
իմաստության	i m ɑ s t u tʰ j ɑ n
իմաստություն	i m ɑ s t u tʰ j u n
իմաստուն	i m ɑ s t u n
իմիջ	i m i d͡ʒ
իմունիզացիա	i m u n i z ɑ t͡sʰ j ɑ
իմպերիալիստ	i m p ɛ ɾ j ɑ l i s t
ինադու	i n ɑ d u
ինգա	i ŋ ɡ ɑ
ինգուշ	i ŋ ɡ u ʃ
ինդիում	i n d i j u m
ինդոնեզերեն	i n d ɔ n ɛ z ɛ ɾ ɛ n
ինդոնեզիա	i n d ɔ n ɛ z j ɑ
իներտ	i n ɛ ɾ t
ինը	i n ə
ինժեներ	i n ʒ ɛ n ɛ ɾ
ինժեներական	i n ʒ ɛ n ɛ ɾ ɑ k ɑ n
ինի	i n i
ինձ	i n d͡z
ինձանից	i n d͡z ɑ n i t͡sʰ
ինձանով	i n d͡z ɑ n ɔ v
ինձանում	i n d͡z ɑ n u m
ինձնից	i n d͡z n i t͡sʰ
ինձնով	i n d͡z n ɔ v
իններորդ	i nː ɛ ɾ ɔ ɾ tʰ
իննսուն	i nː ə s u n
ինչ	i n t͡ʃʰ
ինչի	i n t͡ʃʰ i
ինչու	i n t͡ʃʰ u
ինչպես	i n t͡ʃʰ p ɛ s
ինչք	i n t͡ʃʰ kʰ
ինստիտուտ	i n s t i t u t
ինտեգրալ	i n t ɛ ɡ ɾ ɑ l
ինտերլինգվա	i n t ɛ ɾ l i ŋ ɡ v ɑ
ինտերնետ	i n t ɛ ɾ n ɛ t
ինտերնետային	i n t ɛ ɾ n ɛ t ɑ j i n
ինքն	i ŋ kʰ ə n
ինքնագիր	i ŋ kʰ n ɑ ɡ i ɾ
ինքնաթափ	i ŋ kʰ n ɑ tʰ ɑ pʰ
ինքնաթիռ	i ŋ kʰ n ɑ tʰ i r
ինքնահավատք	i ŋ kʰ n ɑ h ɑ v ɑ t kʰ
ինքնաշարժ	i ŋ kʰ n ɑ ʃ ɑ ɾ ʒ
ինքնասպան	i ŋ kʰ n ɑ s p ɑ n
ինքնասպանություն	i ŋ kʰ n ɑ s p ɑ n u tʰ j u n
ինքնավարություն	i ŋ kʰ n ɑ v ɑ ɾ u tʰ j u n
ինքնին	i ŋ kʰ n i n
ինքնիշխանություն	i ŋ kʰ n i ʃ χ ɑ n u tʰ j u n
ինքնություն	i ŋ kʰ n u tʰ j u n
ինքնուրույն	i ŋ kʰ n u ɾ u j n
ինֆոգրաֆիկա	i n f ɔ ɡ ɾ ɑ f i k ɑ
իշխան	i ʃ χ ɑ n
իշխանափոխություն	i ʃ χ ɑ n ɑ pʰ ɔ χ u tʰ j u n
իշխանյան	i ʃ χ ɑ n j ɑ n
իշխանություն	i ʃ χ ɑ n u tʰ j u n
իշխանուհի	i ʃ χ ɑ n u h i
իջեւան	i d͡ʒ ɛ v ɑ n
իջեւանային	i d͡ʒ ɛ v ɑ n ɑ j i n
իջեւանատեղի	i d͡ʒ ɛ v ɑ n ɑ t ɛ ʁ i
իջեւանատեր	i d͡ʒ ɛ v ɑ n ɑ t ɛ ɾ
իջեւանել	i d͡ʒ ɛ v ɑ n ɛ l
իջեւանում	i d͡ʒ ɛ v ɑ n u m
իռացիոնալ	i r ɑ t͡sʰ i ɔ n ɑ l
իռլանդացի	i r l ɑ n d ɑ t͡sʰ i
իսահակ	i s ɑ h ɑ k
իսլամացնել	i s l ɑ m ɑ t͡sʰ n ɛ l
իսլամացում	i s l ɑ m ɑ t͡sʰ u m
իսլանդիա	i s l ɑ n d j ɑ
իսկական	i s k ɑ k ɑ n
իսկապես	i s k ɑ p ɛ s
իսմայիլի	i s m ɑ j i l i
իսպանական	i s p ɑ n ɑ k ɑ n
իսպանացի	i s p ɑ n ɑ t͡sʰ i
իսպանիա	i s p ɑ n j ɑ
իսպանուհի	i s p ɑ n u h i
իսպառ	i s p ɑ r
իստակ	i s t ɑ k
իվան	i v ɑ n
իվանովո	i v ɑ n ɔ v ɔ
իտալական	i t ɑ l ɑ k ɑ n
իտալացի	i t ɑ l ɑ t͡sʰ i
իտալիա	i t ɑ l j ɑ
իտալուհի	i t ɑ l u h i
իր	i ɾ
իրադարձային	i ɾ ɑ d ɑ ɾ t͡sʰ ɑ j i n
իրադարձություն	i ɾ ɑ d ɑ ɾ t͡sʰ u tʰ j u n
իրազեկ	i ɾ ɑ z ɛ k
իրական	i ɾ ɑ k ɑ n
իրականացնել	i ɾ ɑ k ɑ n ɑ t͡sʰ n ɛ l
իրականություն	i ɾ ɑ k ɑ n u tʰ j u n
իրականում	i ɾ ɑ k ɑ n u m
իրան	i ɾ ɑ n
իրանական	i ɾ ɑ n ɑ k ɑ n
իրանյան	i ɾ ɑ n j ɑ n
իրավաբան	i ɾ ɑ v ɑ b ɑ n
իրավազուրկ	i ɾ ɑ v ɑ z u ɾ k
իրավիճակ	i ɾ ɑ v i t͡ʃ ɑ k
իրավմամբ	i ɾ ɑ v m ɑ m pʰ
իրավունք	i ɾ ɑ v u ŋ kʰ
իրատեսություն	i ɾ ɑ t ɛ s u tʰ j u n
իրար	i ɾ ɑ ɾ
իրարանցում	i ɾ ɑ ɾ ɑ n t͡sʰ u m
իրաք	i ɾ ɑ kʰ
իրենք	i ɾ ɛ ŋ kʰ
իրեք	i ɾ ɛ kʰ
իրիկուն	i ɾ i k u n
իրողություն	i ɾ ɔ ʁ u tʰ j u n
լաբիրինթոս	l ɑ b i ɾ i n tʰ ɔ s
լազերային	l ɑ z ɛ ɾ ɑ j i n
լաթաքիա	l ɑ tʰ ɑ kʰ j ɑ
լախտ	l ɑ χ t
լակոտ	l ɑ k ɔ t
լամպ	l ɑ m p
լամպուշկա	l ɑ m p u ʃ k ɑ
լայն	l ɑ j n
լայնատարած	l ɑ j n ɑ t ɑ ɾ ɑ t͡s
լայնատերեւ	l ɑ j n ɑ t ɛ ɾ ɛ v
լայպցիգ	l ɑ j p t͡sʰ i ɡ
լանչ	l ɑ n t͡ʃʰ
լանջ	l ɑ n d͡ʒ
լանջապանակ	l ɑ n d͡ʒ ɑ p ɑ n ɑ k
լաչառ	l ɑ t͡ʃʰ ɑ r
լաջվարդ	l ɑ d͡ʒ v ɑ ɾ tʰ
լաստանավ	l ɑ s t ɑ n ɑ v
լավ	l ɑ v
լավա	l ɑ v ɑ
լավագույն	l ɑ v ɑ ɡ u j n
լավանալ	l ɑ v ɑ n ɑ l
լավաշ	l ɑ v ɑ ʃ
լատիշերեն	l ɑ t i ʃ ɛ ɾ ɛ n
լատվիա	l ɑ t v j ɑ
լատվիական	l ɑ t v j ɑ k ɑ n
լար	l ɑ ɾ
լարել	l ɑ ɾ ɛ l
լարի	l ɑ ɾ i
լարում	l ɑ ɾ u m
լաց	l ɑ t͡sʰ
լափել	l ɑ pʰ ɛ l
լաքա	l ɑ kʰ ɑ
լեգիտիմ	l ɛ ɡ i t i m
լեզվաբան	l ɛ z v ɑ b ɑ n
լեզվաբանություն	l ɛ z v ɑ b ɑ n u tʰ j u n
լեզվական	l ɛ z v ɑ k ɑ n
լեկ	l ɛ k
լեհ	l ɛ h
լեհաստան	l ɛ h ɑ s t ɑ n
լեհերեն	l ɛ h ɛ ɾ ɛ n
լեմուր	l ɛ m u ɾ
լեյտենանտ	l ɛ j t ɛ n ɑ n t
լեն	l ɛ n
լենին	l ɛ n i n
լեպ	l ɛ p
լեռ	l ɛ r
լեռնագնաց	l ɛ r n ɑ ɡ ə n ɑ t͡sʰ
լեռնային	l ɛ r n ɑ j i n
լեռնաշխարհ	l ɛ r n ɑ ʃ χ ɑ ɾ
լեստեր	l ɛ s t ɛ ɾ
լերդախոտ	l ɛ ɾ tʰ ɑ χ ɔ t
լերկ	l ɛ ɾ k
լեցնել	l ɛ t͡sʰ n ɛ l
լեցուն	l ɛ t͡sʰ u n
լեւանտ	l ɛ v ɑ n t
լեւոն	l ɛ v ɔ n
լի	l i
լիազոր	l j ɑ z ɔ ɾ
լիազորագիր	l j ɑ z ɔ ɾ ɑ ɡ i ɾ
լիազորված	l j ɑ z ɔ ɾ v ɑ t͡s
լիազորվել	l j ɑ z ɔ ɾ v ɛ l
լիանա	l j ɑ n ɑ
լիարժեք	l j ɑ ɾ ʒ ɛ kʰ
լիբանան	l i b ɑ n ɑ n
լիբերալիզմ	l i b ɛ ɾ ɑ l i z m
լիբերիա	l i b ɛ ɾ j ɑ
լիբիա	l i b j ɑ
լիբրացիա	l i b ɾ ɑ t͡sʰ j ɑ
լիբրետո	l i b ɾ ɛ t ɔ
լիլիթ	l i l i tʰ
լիխտենշտեյն	l i χ t ɛ n ʃ t ɛ j n
լիճ	l i t͡ʃ
լիմա	l i m ɑ
լիմասոլ	l i m ɑ s ɔ l
լիմբուրգերեն	l i m b u ɾ ɡ ɛ ɾ ɛ n
լիմոն	l i m ɔ n
լիմոնադ	l i m ɔ n ɑ d
լիմուզին	l i m u z i n
լինդ	l i n d
լինել	l i n ɛ l
լինց	l i n t͡sʰ
լիոն	l i ɔ n
լիովին	l i ɔ v i n
լիուլի	l i u l i
լիպեցկ	l i p ɛ t͡sʰ k
լիսաբոն	l i s ɑ b ɔ n
լիսեռ	l i s ɛ r
լիտվա	l i t v ɑ
լիտվական	l i t v ɑ k ɑ n
լիտր	l i t ə ɾ
լիք	l i kʰ
լիքը	l i kʰ ə
լիքն	l i kʰ ə n
լլկանք	l ə l k ɑ ŋ kʰ
լխպոր	l ə χ p ɔ ɾ
լծել	l ə t͡s ɛ l
լծորդ	l ə t͡s ɔ ɾ tʰ
լկստվել	l ə k ə s t v ɛ l
լկտի	l ə k t i
լղիմ	l ə ʁ i m
լղհ	l ə ʁ ə h ə
լյուդովիկոս	l j u d ɔ v i k ɔ s
լյուդվիգ	l j u d v i ɡ
լյուն	l j u n
լյուքսեմբուրգ	l j u kʰ s ɛ m b u ɾ ɡ
լնդախտ	l ə n d ɑ χ t
լոբի	l ɔ b i
լոգանալ	l ɔ ɡ ɑ n ɑ l
լոգանք	l ɔ ɡ ɑ ŋ kʰ
լոգարան	l ɔ ɡ ɑ ɾ ɑ n
լոգիկա	l ɔ ɡ i k ɑ
լոգին	l ɔ ɡ i n
լոզան	l ɔ z ɑ n
լոթարինգացի	l ɔ tʰ ɑ ɾ i ŋ ɡ ɑ t͡sʰ i
լոթարինգիա	l ɔ tʰ ɑ ɾ i ŋ ɡ j ɑ
լոժբան	l ɔ ʒ b ɑ n
լոլիկ	l ɔ l i k
լոխ	l ɔ χ
լոխում	l ɔ χ u m
լոկ	l ɔ k
լոկոմոտիվ	l ɔ k ɔ m ɔ t i v
լոձ	l ɔ d͡z
լող	l ɔ ʁ
լողալ	l ɔ ʁ ɑ l
լողակ	l ɔ ʁ ɑ k
լողանալ	l ɔ ʁ ɑ n ɑ l
լողափ	l ɔ ʁ ɑ pʰ
լոնդոն	l ɔ n d ɔ n
լոշ	l ɔ ʃ
լոռի	l ɔ r i
լոս	l ɔ s
լոտո	l ɔ t ɔ
լորենի	l ɔ ɾ ɛ n i
լորիկ	l ɔ ɾ i k
լորձ	l ɔ ɾ d͡z
լորտու	l ɔ ɾ t u
լու	l u
լութեր	l u tʰ ɛ ɾ
լուծ	l u t͡s
լուծարել	l u t͡s ɑ ɾ ɛ l
լուծել	l u t͡s ɛ l
լուծիչ	l u t͡s i t͡ʃʰ
լուծում	l u t͡s u m
լումա	l u m ɑ
լույծ	l u j t͡s
լույս	l u j s
լուռ	l u r
լուսամուտ	l u s ɑ m u t
լուսան	l u s ɑ n
լուսանկարել	l u s ɑ n ə k ɑ ɾ ɛ l
լուսավոր	l u s ɑ v ɔ ɾ
լուսաֆոր	l u s ɑ f ɔ ɾ
լուսինե	l u s i n ɛ
լուսնկա	l u s ə ŋ k ɑ
լուսնոտ	l u s n ɔ t
լուսո	l u s ɔ
լուտանք	l u t ɑ ŋ kʰ
լուր	l u ɾ
լուրեր	l u ɾ ɛ ɾ
լուրթ	l u ɾ tʰ
լուրջ	l u ɾ d͡ʒ
լուցկի	l u t͡sʰ k i
լոք	l ɔ kʰ
լռելյայն	l ə r ɛ l j ɑ j n
լռություն	l ə r u tʰ j u n
լսել	l ə s ɛ l
լվալ	l ə v ɑ l
լվածաղիկ	l ə v ɑ t͡s ɑ ʁ i k
լվանալ	l ə v ɑ n ɑ l
լվացվել	l ə v ɑ t͡sʰ v ɛ l
լվացք	l ə v ɑ t͡sʰ kʰ
լվացքատուն	l ə v ɑ t͡sʰ kʰ ɑ t u n
լվացքի	l ə v ɑ t͡sʰ kʰ i
լվով	l v ɔ v
լրագրող	l ə ɾ ɑ ɡ ə ɾ ɔ ʁ
լրագրություն	l ə ɾ ɑ ɡ ɾ u tʰ j u n
լրահոս	l ə ɾ ɑ h ɔ s
լրատու	l ə ɾ ɑ t u
լրացնել	l ə ɾ ɑ t͡sʰ n ɛ l
լրացում	l ə ɾ ɑ t͡sʰ u m
լրացուցիչ	l ə ɾ ɑ t͡sʰ u t͡sʰ i t͡ʃʰ
լրջմիտ	l ə ɾ d͡ʒ m i t
լրտես	l ə ɾ t ɛ s
լրտեսել	l ə ɾ t ɛ s ɛ l
լրտեսություն	l ə ɾ t ɛ s u tʰ j u n
լցվել	l ə t͡sʰ v ɛ l
լքավեր	l ə kʰ ɑ v ɛ ɾ
լքել	l ə kʰ ɛ l
լքյալ	l ə kʰ j ɑ l
խաբարովսկ	χ ɑ b ɑ ɾ ɔ f s k
խաբել	χ ɑ pʰ ɛ l
խաբեպատիր	χ ɑ pʰ ɛ p ɑ t i ɾ
խաբնվել	χ ɑ pʰ n ə v ɛ l
խադ	χ ɑ d
խազ	χ ɑ z
խազել	χ ɑ z ɛ l
խաթաբալա	χ ɑ tʰ ɑ b ɑ l ɑ
խաթեր	χ ɑ tʰ ɛ ɾ
խաթր	χ ɑ tʰ ə ɾ
խաժ	χ ɑ ʒ
խալ	χ ɑ l
խալի	χ ɑ l i
խալիֆ	χ ɑ l i f
խալիֆայություն	χ ɑ l i f ɑ j u tʰ j u n
խախտել	χ ɑ χ t ɛ l
խածանել	χ ɑ t͡s ɑ n ɛ l
խածնել	χ ɑ t͡s n ɛ l
խակ	χ ɑ k
խաղ	χ ɑ ʁ
խաղաթուղթ	χ ɑ ʁ ɑ tʰ u χ tʰ
խաղալ	χ ɑ ʁ ɑ l
խաղալիք	χ ɑ ʁ ɑ l i kʰ
խաղաղություն	χ ɑ ʁ ɑ ʁ u tʰ j u n
խաղամոլ	χ ɑ ʁ ɑ m ɔ l
խաղասրահ	χ ɑ ʁ ɑ s ə ɾ ɑ h
խաղացող	χ ɑ ʁ ɑ t͡sʰ ɔ ʁ
խաղաքարտ	χ ɑ ʁ ɑ kʰ ɑ ɾ t
խաղխաղ	χ ɑ ʁ χ ɑ ʁ
խաղող	χ ɑ ʁ ɔ ʁ
խայթել	χ ɑ j tʰ ɛ l
խայթոց	χ ɑ j tʰ ɔ t͡sʰ
խայտառակ	χ ɑ j t ɑ r ɑ k
խայտառակություն	χ ɑ j t ɑ r ɑ k u tʰ j u n
խայրի	χ ɑ j ɾ i
խան	χ ɑ n
խանդ	χ ɑ n d
խանդակ	χ ɑ n d ɑ k
խանդել	χ ɑ n d ɛ l
խանդոտ	χ ɑ n d ɔ t
խանձել	χ ɑ n d͡z ɛ l
խանութ	χ ɑ n u tʰ
խանություն	χ ɑ n u tʰ j u n
խաշ	χ ɑ ʃ
խաշել	χ ɑ ʃ ɛ l
խաչ	χ ɑ t͡ʃʰ
խաչակիր	χ ɑ t͡ʃʰ ɑ k i ɾ
խաչատուր	χ ɑ t͡ʃʰ ɑ t u ɾ
խաչիկ	χ ɑ t͡ʃʰ i k
խաչմերուկ	χ ɑ t͡ʃʰ m ɛ ɾ u k
խաչո	χ ɑ t͡ʃʰ ɔ
խառան	χ ɑ r ɑ n
խառատահաստոց	χ ɑ r ɑ t ɑ h ɑ s t ɔ t͡sʰ
խառատյան	χ ɑ r ɑ t j ɑ n
խառը	χ ɑ r ə
խառն	χ ɑ r ə n
խառնել	χ ɑ r n ɛ l
խառնիչ	χ ɑ r n i t͡ʃʰ
խառնուրդ	χ ɑ r n u ɾ tʰ
խառնվածք	χ ɑ r n ə v ɑ t͡s kʰ
խավար	χ ɑ v ɑ ɾ
խավարասեր	χ ɑ v ɑ ɾ ɑ s ɛ ɾ
խավիար	χ ɑ v j ɑ ɾ
խատուտիկ	χ ɑ t u t i k
խարակիրի	χ ɑ ɾ ɑ k i ɾ i
խարբերդ	χ ɑ ɾ b ɛ ɾ tʰ
խարդախ	χ ɑ ɾ d ɑ χ
խարիսխ	χ ɑ ɾ i s χ
խարխլել	χ ɑ ɾ χ ə l ɛ l
խարկով	χ ɑ ɾ k ɔ v
խարույկ	χ ɑ ɾ u j k
խարտոց	χ ɑ ɾ t ɔ t͡sʰ
խափան	χ ɑ pʰ ɑ n
խափանել	χ ɑ pʰ ɑ n ɛ l
խեթ	χ ɛ tʰ
խեթական	χ ɛ tʰ ɑ k ɑ n
խեթել	χ ɛ tʰ ɛ l
խեթերեն	χ ɛ tʰ ɛ ɾ ɛ n
խեժ	χ ɛ ʒ
խելախոս	χ ɛ l ɑ χ ɔ s
խելամիտ	χ ɛ l ɑ m i t
խելացի	χ ɛ l ɑ t͡sʰ i
խելոք	χ ɛ l ɔ kʰ
խելք	χ ɛ l kʰ
խեղանդամ	χ ɛ ʁ ɑ n tʰ ɑ m
խեղդել	χ ɛ χ t ɛ l
խենթ	χ ɛ n tʰ
խեցգետին	χ ɛ t͡sʰ ɡ ɛ t i n
խզել	χ ə z ɛ l
խթան	χ ə tʰ ɑ n
խթանել	χ ə tʰ ɑ n ɛ l
խի	χ i
խիզախ	χ i z ɑ χ
խիթ	χ i tʰ
խիթալ	χ i tʰ ɑ l
խիղճ	χ i χ t͡ʃ
խինդ	χ i n d
խիտ	χ i t
խլություն	χ ə l u tʰ j u n
խլուրդ	χ ə l u ɾ d
խխունջ	χ ə χ u n d͡ʒ
խղճալ	χ ə χ t͡ʃ ɑ l
խճանկար	χ ə t͡ʃ ɑ ŋ k ɑ ɾ
խճուղի	χ ə t͡ʃ u ʁ i
խմած	χ ə m ɑ t͡s
խմբագրել	χ ə m b ɑ ɡ ɾ ɛ l
խմբակցություն	χ ə m b ɑ k t͡sʰ u tʰ j u n
խմել	χ ə m ɛ l
խմոր	χ ə m ɔ ɾ
խմորիչ	χ ə m ɔ ɾ i t͡ʃʰ
խնամ	χ ə n ɑ m
խնամել	χ ə n ɑ m ɛ l
խնամի	χ ə n ɑ m i
խնամք	χ ə n ɑ m kʰ
խնդիր	χ ə n tʰ i ɾ
խնդրել	χ ə n tʰ ɾ ɛ l
խնդրեմ	χ ə n tʰ ɾ ɛ m
խնկել	χ ə ŋ k ɛ l
խնձոր	χ ə n d͡z ɔ ɾ
խնոցի	χ ə n ɔ t͡sʰ i
խնջլոզ	χ ə n d͡ʒ ə l ɔ z
խնջույք	χ ə n d͡ʒ u j kʰ
խշտիկ	χ ə ʃ t i k
խոզ	χ ɔ z
խոզանուկ	χ ɔ z ɑ n u k
խոզուկ	χ ɔ z u k
խոթել	χ ɔ tʰ ɛ l
խոհ	χ ɔ h
խոհական	χ ɔ h ɑ k ɑ n
խոհանոց	χ ɔ h ɑ n ɔ t͡sʰ
խոհարար	χ ɔ h ɑ ɾ ɑ ɾ
խոհարարական	χ ɔ h ɑ ɾ ɑ ɾ ɑ k ɑ n
խոհեմ	χ ɔ h ɛ m
խողովակ	χ ɔ ʁ ɔ v ɑ k
խոճկոր	χ ɔ t͡ʃ k ɔ ɾ
խոյ	χ ɔ j
խոյանալ	χ ɔ j ɑ n ɑ l
խոնավ	χ ɔ n ɑ v
խոնարհ	χ ɔ n ɑ ɾ
խոնարհում	χ ɔ n ɑ ɾ u m
խոշոր	χ ɔ ʃ ɔ ɾ
խոշորացույց	χ ɔ ʃ ɔ ɾ ɑ t͡sʰ u j t͡sʰ
խոշտանգում	χ ɔ ʃ t ɑ ŋ ɡ u m
խոչ	χ ɔ t͡ʃʰ
խոչընդոտել	χ ɔ t͡ʃʰ ə n d ɔ t ɛ l
խոպան	χ ɔ p ɑ n
խոռոչ	χ ɔ r ɔ t͡ʃʰ
խոսալ	χ ɔ s ɑ l
խոսակցական	χ ɔ s ɑ k t͡sʰ ɑ k ɑ n
խոսել	χ ɔ s ɛ l
խոսնակ	χ ɔ s n ɑ k
խոսուն	χ ɔ s u n
խոստանալ	χ ɔ s t ɑ n ɑ l
խոստովանություն	χ ɔ s t ɔ v ɑ n u tʰ j u n
խոստում	χ ɔ s t u m
խոսրով	χ ɔ s ɾ ɔ v
խոսք	χ ɔ s kʰ
խոտ	χ ɔ t
խոտակեր	χ ɔ t ɑ k ɛ ɾ
խորաթափանց	χ ɔ ɾ ɑ tʰ ɑ pʰ ɑ n t͡sʰ
խորակ	χ ɔ ɾ ɑ k
խորամանկ	χ ɔ ɾ ɑ m ɑ ŋ k
խորան	χ ɔ ɾ ɑ n
խորանարդ	χ ɔ ɾ ɑ n ɑ ɾ tʰ
խորեզմերեն	χ ɔ ɾ ɛ z m ɛ ɾ ɛ n
խորեն	χ ɔ ɾ ɛ n
խորենացի	χ ɔ ɾ ɛ n ɑ t͡sʰ i
խորթ	χ ɔ ɾ tʰ
խորհել	χ ɔ ɾ h ɛ l
խորհրդաժողով	χ ɔ ɾ ə ɾ tʰ ɑ ʒ ɔ ʁ ɔ v
խորհրդական	χ ɔ ɾ ə ɾ tʰ ɑ k ɑ n
խորհրդակցություն	χ ɔ ɾ ə ɾ tʰ ɑ k t͡sʰ u tʰ j u n
խորհրդանիշ	χ ɔ ɾ ə ɾ tʰ ɑ n i ʃ
խորհրդանշական	χ ɔ ɾ ə ɾ tʰ ɑ n ə ʃ ɑ k ɑ n
խորհրդանշել	χ ɔ ɾ ə ɾ tʰ ɑ n ə ʃ ɛ l
խորհրդավոր	χ ɔ ɾ ə ɾ tʰ ɑ v ɔ ɾ
խորհրդատու	χ ɔ ɾ ə ɾ tʰ ɑ t u
խորհրդատվություն	χ ɔ ɾ ə ɾ tʰ ɑ t v u tʰ j u n
խորհրդարան	χ ɔ ɾ ə ɾ tʰ ɑ ɾ ɑ n
խորհրդարանական	χ ɔ ɾ ə ɾ tʰ ɑ ɾ ɑ n ɑ k ɑ n
խորշ	χ ɔ ɾ ʃ
խորություն	χ ɔ ɾ u tʰ j u n
խորվաթ	χ ɔ ɾ v ɑ tʰ
խորվաթերեն	χ ɔ ɾ v ɑ tʰ ɛ ɾ ɛ n
խորվաթիա	χ ɔ ɾ v ɑ tʰ j ɑ
խորտակվել	χ ɔ ɾ t ɑ k v ɛ l
խոց	χ ɔ t͡sʰ
խոցոտել	χ ɔ t͡sʰ ɔ t ɛ l
խուզարկու	χ u z ɑ ɾ k u
խուզարկություն	χ u z ɑ ɾ k u tʰ j u n
խուզել	χ u z ɛ l
խութ	χ u tʰ
խուլիգան	χ u l i ɡ ɑ n
խուճապ	χ u t͡ʃ ɑ p
խուճուճ	χ u t͡ʃ u t͡ʃ
խումբ	χ u m b
խումհար	χ u m h ɑ ɾ
խունկ	χ u ŋ k
խունտա	χ u n t ɑ
խուսափել	χ u s ɑ pʰ ɛ l
խուտուտ	χ u t u t
խուրձ	χ u ɾ t͡sʰ
խուրմա	χ u ɾ m ɑ
խուփ	χ u pʰ
խչո	χ ə t͡ʃʰ ɔ
խպիպ	χ ə p i p
խռով	χ ə r ɔ v
խռովություն	χ ə r ɔ v u tʰ j u n
խստիվ	χ ə s t i v
խտիղ	χ ə t i ʁ
խտություն	χ ə t u tʰ j u n
խտրականություն	χ ə t ɾ ɑ k ɑ n u tʰ j u n
խրախուսանք	χ ə ɾ ɑ χ u s ɑ ŋ kʰ
խրախուսել	χ ə ɾ ɑ χ u s ɛ l
խրամ	χ ə ɾ ɑ m
խրամատ	χ ə ɾ ɑ m ɑ t
խրթին	χ ə ɾ tʰ i n
խրոխտ	χ ə ɾ ɔ χ t
խրոխտաբար	χ ə ɾ ɔ χ t ɑ b ɑ ɾ
խրոխտագին	χ ə ɾ ɔ χ t ɑ ɡ i n
խրոխտություն	χ ə ɾ ɔ χ t u tʰ j u n
խրուշչով	χ ɾ u ʃ t͡ʃʰ ɔ v
խրտնել	χ ə ɾ t n ɛ l
խցան	χ ə t͡sʰ ɑ n
խցիկ	χ ə t͡sʰ i k
խփել	χ ə pʰ ɛ l
ծա	t͡s ɑ
ծագ	t͡s ɑ kʰ
ծագել	t͡s ɑ kʰ ɛ l
ծագում	t͡s ɑ kʰ u m
ծալել	t͡s ɑ l ɛ l
ծալծալ	t͡s ɑ l t͡s ɑ l
ծախ	t͡s ɑ χ
ծախել	t͡s ɑ χ ɛ l
ծախծխոտվել	t͡s ɑ χ t͡s ə χ ɔ t v ɛ l
ծախծխորվել	t͡s ɑ χ t͡s ə χ ɔ ɾ v ɛ l
ծախոտում	t͡s ɑ χ ɔ t u m
ծախու	t͡s ɑ χ u
ծախում	t͡s ɑ χ u m
ծախս	t͡s ɑ χ s
ծախսել	t͡s ɑ χ s ɛ l
ծախսում	t͡s ɑ χ s u m
ծախսվել	t͡s ɑ χ s v ɛ l
ծախված	t͡s ɑ χ v ɑ t͡s
ծածանել	t͡s ɑ t͡s ɑ n ɛ l
ծածկել	t͡s ɑ t͡s k ɛ l
ծածկույթ	t͡s ɑ t͡s k u j tʰ
ծակ	t͡s ɑ k
ծակոտ	t͡s ɑ k ɔ t
ծակոտկեն	t͡s ɑ k ɔ t k ɛ n
ծաղիկ	t͡s ɑ ʁ i k
ծաղկազարդ	t͡s ɑ χ k ɑ z ɑ ɾ tʰ
ծաղկակաղամբ	t͡s ɑ χ k ɑ k ɑ ʁ ɑ m b
ծաղկեփունջ	t͡s ɑ χ k ɛ pʰ u n d͡ʒ
ծաղկյա	t͡s ɑ χ k j ɑ
ծաղկոտն	t͡s ɑ χ k ɔ t ə n
ծաղկունք	t͡s ɑ χ k u ŋ kʰ
ծաղր	t͡s ɑ ʁ ə ɾ
ծաղրածու	t͡s ɑ ʁ ɾ ɑ t͡s u
ծաղրել	t͡s ɑ ʁ ɾ ɛ l
ծամել	t͡s ɑ m ɛ l
ծամոն	t͡s ɑ m ɔ n
ծայր	t͡s ɑ j ɾ
ծայրահեղ	t͡s ɑ j ɾ ɑ h ɛ ʁ
ծայրահեղական	t͡s ɑ j ɾ ɑ h ɛ ʁ ɑ k ɑ n
ծայրաքաղաք	t͡s ɑ j ɾ ɑ kʰ ɑ ʁ ɑ kʰ
ծանակ	t͡s ɑ n ɑ k
ծանծաղ	t͡s ɑ n t͡s ɑ ʁ
ծանծաղուտ	t͡s ɑ n t͡s ɑ ʁ u t
ծանոթ	t͡s ɑ n ɔ tʰ
ծանոթացնել	t͡s ɑ n ɔ tʰ ɑ t͡sʰ n ɛ l
ծանոթություն	t͡s ɑ n ɔ tʰ u tʰ j u n
ծանուցել	t͡s ɑ n u t͡sʰ ɛ l
ծանուցում	t͡s ɑ n u t͡sʰ u m
ծանրաբեռ	t͡s ɑ n ɾ ɑ b ɛ r
ծանրաձող	t͡s ɑ n ɾ ɑ d͡z ɔ ʁ
ծանրորդ	t͡s ɑ n ɾ ɔ ɾ tʰ
ծանրոց	t͡s ɑ n ɾ ɔ t͡sʰ
ծանրություն	t͡s ɑ n ɾ u tʰ j u n
ծառ	t͡s ɑ r
ծառայել	t͡s ɑ r ɑ j ɛ l
ծառայող	t͡s ɑ r ɑ j ɔ ʁ
ծառայողական	t͡s ɑ r ɑ j ɔ ʁ ɑ k ɑ n
ծառայություն	t͡s ɑ r ɑ j u tʰ j u n
ծավալ	t͡s ɑ v ɑ l
ծավալել	t͡s ɑ v ɑ l ɛ l
ծարավ	t͡s ɑ ɾ ɑ v
ծարավի	t͡s ɑ ɾ ɑ v i
ծափահարել	t͡s ɑ pʰ ɑ h ɑ ɾ ɛ l
ծափահարում	t͡s ɑ pʰ ɑ h ɑ ɾ u m
ծափահարվել	t͡s ɑ pʰ ɑ h ɑ ɾ v ɛ l
ծեծ	t͡s ɛ t͡s
ծեծել	t͡s ɛ t͡s ɛ l
ծես	t͡s ɛ s
ծեր	t͡s ɛ ɾ
ծերանալ	t͡s ɛ ɾ ɑ n ɑ l
ծերուկ	t͡s ɛ ɾ u k
ծերույթ	t͡s ɛ ɾ u j tʰ
ծեփամածիկ	t͡s ɛ pʰ ɑ m ɑ t͡s i k
ծեփել	t͡s ɛ pʰ ɛ l
ծիածան	t͡s i j ɑ t͡s ɑ n
ծիծ	t͡s i t͡s
ծիծաղ	t͡s i t͡s ɑ ʁ
ծիծաղալ	t͡s i t͡s ɑ ʁ ɑ l
ծիծաղաշարժ	t͡s i t͡s ɑ ʁ ɑ ʃ ɑ ɾ ʒ
ծիծեռ	t͡s i t͡s ɛ r
ծիծեռնակ	t͡s i t͡s ɛ r n ɑ k
ծին	t͡s i n
ծիտ	t͡s i t
ծիր	t͡s i ɾ
ծիրան	t͡s i ɾ ɑ n
ծիրանի	t͡s i ɾ ɑ n i
ծլարձակել	t͡s ə l ɑ ɾ t͡sʰ ɑ k ɛ l
ծլել	t͡s ə l ɛ l
ծլիկ	t͡s ə l i k
ծլիկային	t͡s ə l i k ɑ j i n
ծխախոտ	t͡s ə χ ɑ χ ɔ t
ծխած	t͡s ə χ ɑ t͡s
ծխածածկույթ	t͡s ə χ ɑ t͡s ɑ t͡s k u j tʰ
ծխնելույզ	t͡s ə χ n ɛ l u j z
ծխող	t͡s ə χ ɔ ʁ
ծծակ	t͡s ə t͡s ɑ k
ծծել	t͡s ə t͡s ɛ l
ծղոտ	t͡s ə ʁ ɔ t
ծղուկ	t͡s ə ʁ u k
ծնել	t͡s ə n ɛ l
ծնոտ	t͡s ə n ɔ t
ծնված	t͡s ə n v ɑ t͡s
ծնվել	t͡s ə n v ɛ l
ծոռ	t͡s ɔ r
ծով	t͡s ɔ v
ծովախեցգետին	t͡s ɔ v ɑ χ ɛ t͡sʰ ɡ ɛ t i n
ծովածոց	t͡s ɔ v ɑ t͡s ɔ t͡sʰ
ծովակալ	t͡s ɔ v ɑ k ɑ l
ծովահեն	t͡s ɔ v ɑ h ɛ n
ծովափ	t͡s ɔ v ɑ pʰ
ծոր	t͡s ɔ ɾ
ծորակ	t͡s ɔ ɾ ɑ k
ծոց	t͡s ɔ t͡sʰ
ծուլանալ	t͡s u l ɑ n ɑ l
ծուլություն	t͡s u l u tʰ j u n
ծուխ	t͡s u χ
ծուղակ	t͡s u ʁ ɑ k
ծույլ	t͡s u j l
ծունկ	t͡s u ŋ k
ծուռ	t͡s u r
ծպտյալ	t͡s ə p t j ɑ l
ծրագիր	t͡s ə ɾ ɑ ɡ i ɾ
ծրագրաշար	t͡s ə ɾ ɑ ɡ ə ɾ ɑ ʃ ɑ ɾ
ծրագրավորել	t͡s ə ɾ ɑ ɡ ɾ ɑ v ɔ ɾ ɛ l
ծրագրավորող	t͡s ə ɾ ɑ ɡ ɾ ɑ v ɔ ɾ ɔ ʁ
ծրագրավորում	t͡s ə ɾ ɑ ɡ ɾ ɑ v ɔ ɾ u m
ծրագրել	t͡s ə ɾ ɑ ɡ ɾ ɛ l
ծրար	t͡s ə ɾ ɑ ɾ
կա	k ɑ
կադիս	k ɑ d i s
կադմիում	k ɑ d m i j u m
կադրային	k ɑ d ɾ ɑ j i n
կազակ	k ɑ z ɑ k
կազան	k ɑ z ɑ n
կազդուրվել	k ɑ z d u ɾ v ɛ l
կազինո	k ɑ z i n ɔ
կազմ	k ɑ z m
կազմախոսություն	k ɑ z m ɑ χ ɔ s u tʰ j u n
կազմակերպել	k ɑ z m ɑ k ɛ ɾ p ɛ l
կազմակերպիչ	k ɑ z m ɑ k ɛ ɾ p i t͡ʃʰ
կազմակերպություն	k ɑ z m ɑ k ɛ ɾ p u tʰ j u n
կազմակերպում	k ɑ z m ɑ k ɛ ɾ p u m
կազմավորում	k ɑ z m ɑ v ɔ ɾ u m
կազմել	k ɑ z m ɛ l
կաթ	k ɑ tʰ
կաթիլ	k ɑ tʰ i l
կաթնաշոռ	k ɑ tʰ n ɑ ʃ ɔ r
կաթնով	k ɑ tʰ n ɔ v
կաթսա	k ɑ tʰ s ɑ
կալ	k ɑ l
կալանավորել	k ɑ l ɑ n ɑ v ɔ ɾ ɛ l
կալանք	k ɑ l ɑ ŋ kʰ
կալինին	k ɑ l i n i n
կալիում	k ɑ l i j u m
կալկաթա	k ɑ l k ɑ tʰ ɑ
կալուգա	k ɑ l u ɡ ɑ
կալվածք	k ɑ l v ɑ t͡s kʰ
կախ	k ɑ χ
կախակապ	k ɑ χ ɑ k ɑ p
կախաղան	k ɑ χ ɑ ʁ ɑ n
կախարդ	k ɑ χ ɑ ɾ d
կախարդաբար	k ɑ χ ɑ ɾ d ɑ b ɑ ɾ
կախարդական	k ɑ χ ɑ ɾ d ɑ k ɑ n
կախարդել	k ɑ χ ɑ ɾ d ɛ l
կախարդություն	k ɑ χ ɑ ɾ d u tʰ j u n
կախել	k ɑ χ ɛ l
կախվածություն	k ɑ χ v ɑ t͡s u tʰ j u n
կախվել	k ɑ χ v ɛ l
կակաչ	k ɑ k ɑ t͡ʃʰ
կահիրե	k ɑ h i ɾ ɛ
կահույք	k ɑ h u j kʰ
կաղ	k ɑ ʁ
կաղաղ	k ɑ ʁ ɑ ʁ
կաղամբ	k ɑ ʁ ɑ m b
կաղապար	k ɑ ʁ ɑ p ɑ ɾ
կաղապարը	k ɑ ʁ ɑ p ɑ ɾ ə
կաղին	k ɑ ʁ i n
կաղկանձ	k ɑ χ k ɑ n d͡z
կաղնի	k ɑ ʁ n i
կաճառ	k ɑ t͡ʃ ɑ r
կամա	k ɑ m ɑ
կամակոր	k ɑ m ɑ k ɔ ɾ
կամավոր	k ɑ m ɑ v ɔ ɾ
կամավորական	k ɑ m ɑ v ɔ ɾ ɑ k ɑ n
կամար	k ɑ m ɑ ɾ
կամաց	k ɑ m ɑ t͡sʰ
կամերուն	k ɑ m ɛ ɾ u n
կամընտիր	k ɑ m ə n t i ɾ
կամուրջ	k ɑ m u ɾ d͡ʒ
կամչատկա	k ɑ m t͡ʃʰ ɑ t k ɑ
կամրջից	k ɑ m ə ɾ d͡ʒ i t͡sʰ
կայան	k ɑ j ɑ n
կայանալ	k ɑ j ɑ n ɑ l
կայանում	k ɑ j ɑ n u m
կայարան	k ɑ j ɑ ɾ ɑ n
կայացած	k ɑ j ɑ t͡sʰ ɑ t͡s
կայի	k ɑ j i
կային	k ɑ j i n
կայինք	k ɑ j i ŋ kʰ
կայծ	k ɑ j t͡s
կայծակ	k ɑ j t͡s ɑ k
կայծառ	k ɑ j t͡s ɑ r
կայուն	k ɑ j u n
կայսերապաշտ	k ɑ j s ɛ ɾ ɑ p ɑ ʃ t
կայսերապաշտական	k ɑ j s ɛ ɾ ɑ p ɑ ʃ t ɑ k ɑ n
կայսր	k ɑ j s ə ɾ
կայսրուհի	k ɑ j s ɾ u h i
կայտառ	k ɑ j t ɑ r
կան	k ɑ n
կանադա	k ɑ n ɑ d ɑ
կանադական	k ɑ n ɑ d ɑ k ɑ n
կանաչ	k ɑ n ɑ t͡ʃʰ
կանաչազարդ	k ɑ n ɑ t͡ʃʰ ɑ z ɑ ɾ tʰ
կանաչապատ	k ɑ n ɑ t͡ʃʰ ɑ p ɑ t
կանացի	k ɑ n ɑ t͡sʰ i
կանգառ	k ɑ ŋ ɡ ɑ r
կանգնել	k ɑ ŋ ɡ n ɛ l
կանգնեցնել	k ɑ ŋ ɡ n ɛ t͡sʰ n ɛ l
կանթեղ	k ɑ n tʰ ɛ ʁ
կանխարգելիչ	k ɑ n χ ɑ ɾ kʰ ɛ l i t͡ʃʰ
կանխիկ	k ɑ n χ i k
կանն	k ɑ nː
կաննադա	k ɑ nː ɑ d ɑ
կանոն	k ɑ n ɔ n
կանոնավոր	k ɑ n ɔ n ɑ v ɔ ɾ
կանուխ	k ɑ n u χ
կանչ	k ɑ n t͡ʃʰ
կանչել	k ɑ n t͡ʃʰ ɛ l
կանտրոլ	k ɑ n t ɾ ɔ l
կանք	k ɑ ŋ kʰ
կաշառակերություն	k ɑ ʃ ɑ r ɑ k ɛ ɾ u tʰ j u n
կաշառել	k ɑ ʃ ɑ r ɛ l
կաշառվել	k ɑ ʃ ɑ r v ɛ l
կաշի	k ɑ ʃ i
կաշկանդ	k ɑ ʃ k ɑ n d
կաշկանդել	k ɑ ʃ k ɑ n d ɛ l
կաշկանդյալ	k ɑ ʃ k ɑ n d j ɑ l
կաշկանդվածություն	k ɑ ʃ k ɑ n d v ɑ t͡s u tʰ j u n
կապադովկիա	k ɑ p ɑ d ɔ f k j ɑ
կապակցել	k ɑ p ɑ k t͡sʰ ɛ l
կապակցություն	k ɑ p ɑ k t͡sʰ u tʰ j u n
կապան	k ɑ p ɑ n
կապանք	k ɑ p ɑ ŋ kʰ
կապար	k ɑ p ɑ ɾ
կապարճ	k ɑ p ɑ ɾ t͡ʃ
կապիկ	k ɑ p i k
կապիճ	k ɑ p i t͡ʃ
կապիտալիզմ	k ɑ p i t ɑ l i z m
կապիտալիստական	k ɑ p i t ɑ l i s t ɑ k ɑ n
կապիտան	k ɑ p i t ɑ n
կապիտոլիում	k ɑ p i t ɔ l i j u m
կապոց	k ɑ p ɔ t͡sʰ
կապույտ	k ɑ p u j t
կապուտ	k ɑ p u t
կապուտակ	k ɑ p u t ɑ k
կապված	k ɑ p v ɑ t͡s
կապվածություն	k ɑ p v ɑ t͡s u tʰ j u n
կապտավուն	k ɑ p t ɑ v u n
կապտուկ	k ɑ p t u k
կառավարել	k ɑ r ɑ v ɑ ɾ ɛ l
կառավարիչ	k ɑ r ɑ v ɑ ɾ i t͡ʃʰ
կառավարություն	k ɑ r ɑ v ɑ ɾ u tʰ j u n
կառավարում	k ɑ r ɑ v ɑ ɾ u m
կառե	k ɑ r ɛ
կառույց	k ɑ r u j t͡sʰ
կառուցանել	k ɑ r u t͡sʰ ɑ n ɛ l
կառուցողական	k ɑ r u t͡sʰ ɔ ʁ ɑ k ɑ n
կառուցում	k ɑ r u t͡sʰ u m
կառուցվածք	k ɑ r u t͡sʰ v ɑ t͡s kʰ
կաս	k ɑ s
կասեցնել	k ɑ s ɛ t͡sʰ n ɛ l
կասկածել	k ɑ s k ɑ t͡s ɛ l
կասկածելի	k ɑ s k ɑ t͡s ɛ l i
կասկածյալ	k ɑ s k ɑ t͡s j ɑ l
կասկարա	k ɑ s k ɑ ɾ ɑ
կաստայական	k ɑ s t ɑ j ɑ k ɑ n
կավ	k ɑ v
կավիճ	k ɑ v i t͡ʃ
կատալիզատոր	k ɑ t ɑ l i z ɑ t ɔ ɾ
կատալոնիա	k ɑ t ɑ l ɔ n j ɑ
կատակագուսան	k ɑ t ɑ k ɑ ɡ u s ɑ n
կատակել	k ɑ t ɑ k ɛ l
կատաղել	k ɑ t ɑ ʁ ɛ l
կատաղի	k ɑ t ɑ ʁ i
կատաղություն	k ɑ t ɑ ʁ u tʰ j u n
կատաստրոֆա	k ɑ t ɑ s t ɾ ɔ f ɑ
կատար	k ɑ t ɑ ɾ
կատարել	k ɑ t ɑ ɾ ɛ l
կատարյալ	k ɑ t ɑ ɾ j ɑ l
կատեգորիա	k ɑ t ɛ ɡ ɔ ɾ j ɑ
կատմանդու	k ɑ t m ɑ n d u
կատու	k ɑ t u
կար	k ɑ ɾ
կարագ	k ɑ ɾ ɑ kʰ
կարամ	k ɑ ɾ ɑ m
կարամել	k ɑ ɾ ɑ m ɛ l
կարայան	k ɑ ɾ ɑ j ɑ n
կարանտին	k ɑ ɾ ɑ n t i n
կարաոկե	k ɑ ɾ ɑ ɔ k ɛ
կարապետ	k ɑ ɾ ɑ p ɛ t
կարապետյան	k ɑ ɾ ɑ p ɛ t j ɑ n
կարաս	k ɑ ɾ ɑ s
կարատե	k ɑ ɾ ɑ t ɛ
կարգ	k ɑ ɾ kʰ
կարգաբանական	k ɑ ɾ kʰ ɑ b ɑ n ɑ k ɑ n
կարգադրել	k ɑ ɾ kʰ ɑ d ɾ ɛ l
կարգախոս	k ɑ ɾ kʰ ɑ χ ɔ s
կարգապահ	k ɑ ɾ kʰ ɑ p ɑ h
կարգապահական	k ɑ ɾ kʰ ɑ p ɑ h ɑ k ɑ n
կարգավարական	k ɑ ɾ kʰ ɑ v ɑ ɾ ɑ k ɑ n
կարգավիճակ	k ɑ ɾ kʰ ɑ v i t͡ʃ ɑ k
կարգիչ	k ɑ ɾ kʰ i t͡ʃʰ
կարդալ	k ɑ ɾ tʰ ɑ l
կարել	k ɑ ɾ ɛ l
կարելերեն	k ɑ ɾ ɛ l ɛ ɾ ɛ n
կարելի	k ɑ ɾ ɛ l i
կարելիա	k ɑ ɾ ɛ l j ɑ
կարեկցաբար	k ɑ ɾ ɛ k t͡sʰ ɑ b ɑ ɾ
կարեկցաբեր	k ɑ ɾ ɛ k t͡sʰ ɑ b ɛ ɾ
կարեկցական	k ɑ ɾ ɛ k t͡sʰ ɑ k ɑ n
կարեկցանք	k ɑ ɾ ɛ k t͡sʰ ɑ ŋ kʰ
կարեկցաշարժ	k ɑ ɾ ɛ k t͡sʰ ɑ ʃ ɑ ɾ ʒ
կարեկցել	k ɑ ɾ ɛ k t͡sʰ ɛ l
կարեկցելի	k ɑ ɾ ɛ k t͡sʰ ɛ l i
կարեկցություն	k ɑ ɾ ɛ k t͡sʰ u tʰ j u n
կարեկցում	k ɑ ɾ ɛ k t͡sʰ u m
կարեն	k ɑ ɾ ɛ n
կարենալ	k ɑ ɾ ɛ n ɑ l
կարեւոր	k ɑ ɾ ɛ v ɔ ɾ
կարթ	k ɑ ɾ tʰ
կարթագեն	k ɑ ɾ tʰ ɑ ɡ ɛ n
կարիբյան	k ɑ ɾ i b j ɑ n
կարիճ	k ɑ ɾ i t͡ʃ
կարին	k ɑ ɾ i n
կարիք	k ɑ ɾ i kʰ
կարծել	k ɑ ɾ t͡s ɛ l
կարծիք	k ɑ ɾ t͡s i kʰ
կարծր	k ɑ ɾ t͡s ə ɾ
կարծրախտ	k ɑ ɾ t͡s ɾ ɑ χ t
կարծրատիպ	k ɑ ɾ t͡s ɾ ɑ t i p
կարկեհան	k ɑ ɾ k ɛ h ɑ n
կարկին	k ɑ ɾ k i n
կարկուտ	k ɑ ɾ k u t
կարճաժամկետ	k ɑ ɾ t͡ʃ ɑ ʒ ɑ m k ɛ t
կարճամետրաժ	k ɑ ɾ t͡ʃ ɑ m ɛ t ɾ ɑ ʒ
կարճառոտաբար	k ɑ ɾ t͡ʃ ɑ r ɔ t ɑ b ɑ ɾ
կարճատեսություն	k ɑ ɾ t͡ʃ ɑ t ɛ s u tʰ j u n
կարմիր	k ɑ ɾ m i ɾ
կարմրախայտ	k ɑ ɾ m ɾ ɑ χ ɑ j t
կարմրախտ	k ɑ ɾ m ɾ ɑ χ t
կարմրանալ	k ɑ ɾ m ɾ ɑ n ɑ l
կարմրավուն	k ɑ ɾ m ɾ ɑ v u n
կարմրել	k ɑ ɾ m ɾ ɛ l
կարմրուկ	k ɑ ɾ m ɾ u k
կարո	k ɑ ɾ ɔ
կարող	k ɑ ɾ ɔ ʁ
կարողանալ	k ɑ ɾ ɔ ʁ ɑ n ɑ l
կարոս	k ɑ ɾ ɔ s
կարոտել	k ɑ ɾ ɔ t ɛ l
կարուսել	k ɑ ɾ u s ɛ l
կարպիս	k ɑ ɾ p i s
կարս	k ɑ ɾ s
կարտ	k ɑ ɾ t
կարտոշկա	k ɑ ɾ t ɔ ʃ k ɑ
կարտոֆիլ	k ɑ ɾ t ɔ f i l
կացարան	k ɑ t͡sʰ ɑ ɾ ɑ n
կափարիչ	k ɑ pʰ ɑ ɾ i t͡ʃʰ
կափույր	k ɑ pʰ u j ɾ
կաֆե	k ɑ f ɛ
կգան	k ə ɡ ɑ n
կելտական	k ɛ l t ɑ k ɑ n
կեղակարծ	k ɛ ʁ ɑ k ɑ ɾ t͡s
կեղեւ	k ɛ ʁ ɛ v
կեղեքել	k ɛ ʁ ɛ kʰ ɛ l
կեղծ	k ɛ χ t͡s
կեղծամ	k ɛ χ t͡s ɑ m
կեղծիք	k ɛ χ t͡s i kʰ
կեղտ	k ɛ χ t
կեղտոտել	k ɛ χ t ɔ t ɛ l
կեն	k ɛ n
կենալ	k ɛ n ɑ l
կենգուրու	k ɛ ŋ ɡ u ɾ u
կենդանաբան	k ɛ n tʰ ɑ n ɑ b ɑ n
կենդանանալ	k ɛ n tʰ ɑ n ɑ n ɑ l
կենդանավետ	k ɛ n tʰ ɑ n ɑ v ɛ t
կենսաբազմազանություն	k ɛ n s ɑ b ɑ z m ɑ z ɑ n u tʰ j u n
կենսաբան	k ɛ n s ɑ b ɑ n
կենսաբանություն	k ɛ n s ɑ b ɑ n u tʰ j u n
կենսալից	k ɛ n s ɑ l i t͡sʰ
կենսախինդ	k ɛ n s ɑ χ i n d
կենսունակ	k ɛ n s u n ɑ k
կենտ	k ɛ n t
կենտկոմ	k ɛ n t k ɔ m
կենտրոն	k ɛ n t ɾ ɔ n
կենտրոնական	k ɛ n t ɾ ɔ n ɑ k ɑ n
կենտրոնաձիգ	k ɛ n t ɾ ɔ n ɑ d͡z i kʰ
կենտրոնանալ	k ɛ n t ɾ ɔ n ɑ n ɑ l
կենցաղ	k ɛ n t͡sʰ ɑ ʁ
կեռաս	k ɛ r ɑ s
կես	k ɛ s
կեսարիա	k ɛ s ɑ ɾ j ɑ
կեսրայր	k ɛ s ɾ ɑ j ɾ
կեսօր	k ɛ s ɔ ɾ
կետադրություն	k ɛ t ɑ d ɾ u tʰ j u n
կետչուպ	k ɛ t t͡ʃʰ u p
կերալա	k ɛ ɾ ɑ l ɑ
կերակուր	k ɛ ɾ ɑ k u ɾ
կերակրափող	k ɛ ɾ ɑ k ɾ ɑ pʰ ɔ ʁ
կերոսին	k ɛ ɾ ɔ s i n
կերպ	k ɛ ɾ p
կերպար	k ɛ ɾ p ɑ ɾ
կեցցես	k ɛ t͡sʰː ɛ s
կզակ	k ə z ɑ k
կզաքիս	k ə z ɑ kʰ i s
կըհ	k ə ə h ə
կթել	k ə tʰ ɛ l
կթոտ	k ə tʰ ɔ t
կիբեռնետիկա	k i b ɛ r n ɛ t i k ɑ
կիեւ	k i j ɛ v
կիզել	k i z ɛ l
կիզիչ	k i z i t͡ʃʰ
կիթ	k i tʰ
կիթառ	k i tʰ ɑ r
կիլիկիա	k i l i k j ɑ
կիլիկիացի	k i l i k j ɑ t͡sʰ i
կիլիկյան	k i l i k j ɑ n
կիլո	k i l ɔ
կիլոգրամ	k i l ɔ ɡ ɾ ɑ m
կիլոմետր	k i l ɔ m ɛ t ə ɾ
կին	k i n
կինաբար	k i n ɑ b ɑ ɾ
կինամոմոն	k i n ɑ m ɔ m ɔ n
կինո	k i n ɔ
կիպ	k i p
կիպրոս	k i p ɾ ɔ s
կիսաշփական	k i s ɑ ʃ ə pʰ ɑ k ɑ n
կիսատաբատ	k i s ɑ t ɑ b ɑ t
կիսաֆաբրիկատ	k i s ɑ f ɑ b ɾ i k ɑ t
կիսել	k i s ɛ l
կիվի	k i v i
կիտել	k i t ɛ l
կիտո	k i t ɔ
կիր	k i ɾ
կիրակնօրյա	k i ɾ ɑ k n ɔ ɾ j ɑ
կիրակոսյան	k i ɾ ɑ k ɔ s j ɑ n
կիրառվել	k i ɾ ɑ r v ɛ l
կիրթ	k i ɾ tʰ
կիրճ	k i ɾ t͡ʃ
կիրով	k i ɾ ɔ v
կիրք	k i ɾ kʰ
կից	k i t͡sʰ
կլանել	k ə l ɑ n ɛ l
կլարա	k l ɑ ɾ ɑ
կլափ	k ə l ɑ pʰ
կլերմոն	k l ɛ ɾ m ɔ n
կլիմա	k l i m ɑ
կլոուն	k ə l ɔ u n
կլոր	k ə l ɔ ɾ
կլորավուն	k ə l ɔ ɾ ɑ v u n
կծոխուր	k ə t͡s ɔ χ u ɾ
կծու	k ə t͡s u
կղերական	k ə ʁ ɛ ɾ ɑ k ɑ n
կղզի	k ə ʁ z i
կղզիներ	k ə ʁ z i n ɛ ɾ
կղկղանք	k ə χ k ə ʁ ɑ ŋ kʰ
կճատ	k ə t͡ʃ ɑ t
կմախք	k ə m ɑ χ kʰ
կյանք	k j ɑ ŋ kʰ
կյուսյու	k j u s j u
կյուրեղյան	k j u ɾ ɛ ʁ j ɑ n
կյուրոս	k j u ɾ ɔ s
կնդրուկ	k ə n d ɾ u k
կնիկ	k ə n i k
կնիք	k ə n i kʰ
կնճիռ	k ə n t͡ʃ i r
կնունք	k ə n u ŋ kʰ
կնքահայր	k ə ŋ kʰ ɑ h ɑ j ɾ
կնքել	k ə ŋ kʰ ɛ l
կշռել	k ə ʃ r ɛ l
կոալիցիա	k ɔ ɑ l i t͡sʰ j ɑ
կոբալտ	k ɔ b ɑ l t
կոգի	k ɔ ɡ i
կոդոմանոս	k ɔ d ɔ m ɑ n ɔ s
կոլաժ	k ɔ l ɑ ʒ
կոլեգա	k ɔ l ɛ ɡ ɑ
կոլեգիա	k ɔ l ɛ ɡ j ɑ
կոխել	k ɔ χ ɛ l
կոծոծ	k ɔ t͡s ɔ t͡s
կոկաին	k ɔ k ɑ j i n
կոկովանք	k ɔ k ɔ v ɑ ŋ kʰ
կոկորդ	k ɔ k ɔ ɾ tʰ
կոկտեյլ	k ɔ k t ɛ j l
կող	k ɔ ʁ
կողակ	k ɔ ʁ ɑ k
կողակից	k ɔ ʁ ɑ k i t͡sʰ
կողբացի	k ɔ ʁ b ɑ t͡sʰ i
կողմ	k ɔ ʁ m
կողմից	k ɔ ʁ m i t͡sʰ
կողմնակի	k ɔ ʁ m n ɑ k i
կողմնացույց	k ɔ ʁ m n ɑ t͡sʰ u j t͡sʰ
կողոպտել	k ɔ ʁ ɔ p t ɛ l
կողպել	k ɔ χ p ɛ l
կողպեք	k ɔ χ p ɛ kʰ
կողք	k ɔ χ kʰ
կողքիս	k ɔ χ kʰ i s
կոճապղպեղ	k ɔ t͡ʃ ɑ p ə χ p ɛ ʁ
կոմբայն	k ɔ m b ɑ j n
կոմիտե	k ɔ m i t ɛ
կոմնենոս	k ɔ m n ɛ n ɔ s
կոմունիզմ	k ɔ m u n i z m
կոմպետենտ	k ɔ m p ɛ t ɛ n t
կոմպոզիտոր	k ɔ m p ɔ z i t ɔ ɾ
կոմպոնենտ	k ɔ m p ɔ n ɛ n t
կոմսություն	k ɔ m s u tʰ j u n
կոյամպուտուր	k ɔ j ɑ m p u t u ɾ
կոնական	k ɔ n ɑ k ɑ n
կոնյակ	k ɔ n j ɑ k
կոնսոլիդացիա	k ɔ n s ɔ l i d ɑ t͡sʰ j ɑ
կոնստրուկտիվ	k ɔ n s t ɾ u k t i v
կոնտեյներ	k ɔ n t ɛ j n ɛ ɾ
կոնտեքստ	k ɔ n t ɛ kʰ s t
կոնտրոլ	k ɔ n t ɾ ɔ l
կոնրադ	k ɔ n ɾ ɑ d
կոնք	k ɔ ŋ kʰ
կոնֆետ	k ɔ n f ɛ t
կոնֆերանս	k ɔ n f ɛ ɾ ɑ n s
կոնֆերանսը	k ɔ n f ɛ ɾ ɑ n s ə
կոշիկ	k ɔ ʃ i k
կոշկակար	k ɔ ʃ k ɑ k ɑ ɾ
կոշկեղեն	k ɔ ʃ k ɛ ʁ ɛ n
կոչ	k ɔ t͡ʃʰ
կոչել	k ɔ t͡ʃʰ ɛ l
կոչեցյալ	k ɔ t͡ʃʰ ɛ t͡sʰ j ɑ l
կոչում	k ɔ t͡ʃʰ u m
կոպեկ	k ɔ p ɛ k
կոպիտ	k ɔ p i t
կոռներեն	k ɔ r n ɛ ɾ ɛ n
կոռուպցիա	k ɔ r u p t͡sʰ j ɑ
կոռուպցիոն	k ɔ r u p t͡sʰ i ɔ n
կոսմոպոլիտական	k ɔ s m ɔ p ɔ l i t ɑ k ɑ n
կոսմոպոլիտություն	k ɔ s m ɔ p ɔ l i t u tʰ j u n
կոսմոս	k ɔ s m ɔ s
կոսովո	k ɔ s ɔ v ɔ
կոստանդնուպոլիս	k ɔ s t ɑ n d n u p ɔ l i s
կոստրոմա	k ɔ s t ɾ ɔ m ɑ
կով	k ɔ v
կովբոյ	k ɔ v b ɔ j
կովլակ	k ɔ v l ɑ k
կովկասյան	k ɔ f k ɑ s j ɑ n
կովկասցի	k ɔ f k ɑ s t͡sʰ i
կոտակ	k ɔ t ɑ k
կոտայք	k ɔ t ɑ j kʰ
կոտլետ	k ɔ t l ɛ t
կոտոշ	k ɔ t ɔ ʃ
կոտոր	k ɔ t ɔ ɾ
կոտրել	k ɔ t ɾ ɛ l
կորեա	k ɔ ɾ ɛ ɑ
կորիզ	k ɔ ɾ i z
կործան	k ɔ ɾ t͡s ɑ n
կործանել	k ɔ ɾ t͡s ɑ n ɛ l
կործանիչ	k ɔ ɾ t͡s ɑ n i t͡ʃʰ
կործանում	k ɔ ɾ t͡s ɑ n u m
կործել	k ɔ ɾ t͡s ɛ l
կորյուն	k ɔ ɾ j u n
կորնթոս	k ɔ ɾ ə n tʰ ɔ s
կորնչել	k ɔ ɾ ə n t͡ʃʰ ɛ l
կորոնավիրուս	k ɔ ɾ ɔ n ɑ v i ɾ u s
կորուսյալ	k ɔ ɾ u s j ɑ l
կորուստ	k ɔ ɾ u s t
կորչել	k ɔ ɾ t͡ʃʰ ɛ l
կորպուս	k ɔ ɾ p u s
կորպուսը	k ɔ ɾ p u s ə
կորտ	k ɔ ɾ t
կորցնել	k ɔ ɾ t͡sʰ n ɛ l
կուզ	k u z
կուզիկ	k u z i k
կութ	k u tʰ
կուլ	k u l
կուլտուրա	k u l t u ɾ ɑ
կուլտուրական	k u l t u ɾ ɑ k ɑ n
կուխնի	k u χ n i
կույս	k u j s
կույտ	k u j t
կույր	k u j ɾ
կուշտ	k u ʃ t
կուպր	k u p ə ɾ
կուռ	k u r
կուռք	k u r kʰ
կուսակցություն	k u s ɑ k t͡sʰ u tʰ j u n
կուտ	k u t
կուտիկ	k u t i k
կուր	k u ɾ
կուրծք	k u ɾ t͡s kʰ
կուրսկ	k u ɾ s k
կուց	k u t͡sʰ
կպնել	k ə p n ɛ l
կպչուն	k ə p t͡ʃʰ u n
կռահել	k ə r ɑ h ɛ l
կռատուկ	k ə r ɑ t u k
կռիս	k r i s
կռիվ	k ə r i v
կռկռալ	k ə r k ə r ɑ l
կռճիկ	k ə r t͡ʃ i k
կռնակ	k ə r n ɑ k
կռնատ	k ə r n ɑ t
կռունկ	k ə r u ŋ k
կռվել	k ə r v ɛ l
կռտած	k ə r t ɑ t͡s
կսկիծ	k ə s k i t͡s
կտակ	k ə t ɑ k
կտակարան	k ə t ɑ k ɑ ɾ ɑ n
կտոր	k ə t ɔ ɾ
կտուր	k ə t u ɾ
կտուց	k ə t u t͡sʰ
կտրական	k ə t ɾ ɑ k ɑ n
կտրականապես	k ə t ɾ ɑ k ɑ n ɑ p ɛ s
կտրել	k ə t ɾ ɛ l
կտրիճ	k ə t ɾ i t͡ʃ
կտրոն	k ə t ɾ ɔ n
կտցել	k ə t t͡sʰ ɛ l
կրավորական	k ə ɾ ɑ v ɔ ɾ ɑ k ɑ n
կրաքար	k ə ɾ ɑ kʰ ɑ ɾ
կրեատիվ	k ɾ ɛ ɑ t i v
կրել	k ə ɾ ɛ l
կրեմլ	k ə ɾ ɛ m ə l
կրետե	k ə ɾ ɛ t ɛ
կրթել	k ə ɾ tʰ ɛ l
կրթություն	k ə ɾ tʰ u tʰ j u n
կրիա	k ə ɾ j ɑ
կրիկետ	k ɾ i k ɛ t
կրիշնա	k ɾ i ʃ n ɑ
կրծել	k ə ɾ t͡s ɛ l
կրծկալ	k ə ɾ t͡s k ɑ l
կրծող	k ə ɾ t͡s ɔ ʁ
կրծքանշան	k ə ɾ t͡s kʰ ɑ n ə ʃ ɑ n
կրծքավանդակ	k ə ɾ t͡s kʰ ɑ v ɑ n d ɑ k
կրկես	k ə ɾ k ɛ s
կրկին	k ə ɾ k i n
կրկնություն	k ə ɾ k n u tʰ j u n
կրճատում	k ə ɾ t͡ʃ ɑ t u m
կրոնագետ	k ə ɾ ɔ n ɑ ɡ ɛ t
կրուասան	k ɾ u ɑ s ɑ n
կրունկ	k ə ɾ u ŋ k
կրպակ	k ə ɾ p ɑ k
կրտսեր	k ə ɾ t s ɛ ɾ
կցել	k ə t͡sʰ ɛ l
կցորդ	k ə t͡sʰ ɔ ɾ tʰ
կքել	k ə kʰ ɛ l
հա	h ɑ
հաագա	h ɑ ɑ ɡ ɑ
հաբ	h ɑ b
հագել	h ɑ ɡ ɛ l
հագենալ	h ɑ ɡ ɛ n ɑ l
հագեցնել	h ɑ ɡ ɛ t͡sʰ n ɛ l
հագնել	h ɑ kʰ n ɛ l
հագնի	h ɑ kʰ n i
հագնվել	h ɑ ɡ n ə v ɛ l
հագուստ	h ɑ kʰ u s t
հագցնել	h ɑ kʰ t͡sʰ ə n ɛ l
հադես	h ɑ d ɛ s
հադրոն	h ɑ d ɾ ɔ n
հազ	h ɑ z
հազարամյակ	h ɑ z ɑ ɾ ɑ m j ɑ k
հազարապետ	h ɑ z ɑ ɾ ɑ p ɛ t
հազարերորդ	h ɑ z ɑ ɾ ɛ ɾ ɔ ɾ tʰ
հազիվ	h ɑ z i v
հազվադեպ	h ɑ z v ɑ d ɛ p
հաթ	h ɑ tʰ
հաթաթա	h ɑ tʰ ɑ tʰ ɑ
հալածանք	h ɑ l ɑ t͡s ɑ ŋ kʰ
հալածել	h ɑ l ɑ t͡s ɛ l
հալեպ	h ɑ l ɛ p
հալոգեն	h ɑ l ɔ ɡ ɛ n
հալումաշ	h ɑ l u m ɑ ʃ
հալվա	h ɑ l v ɑ
հալվե	h ɑ l v ɛ
հակ	h ɑ k
հակագրոհ	h ɑ k ɑ ɡ ə ɾ ɔ h
հակազդել	h ɑ k ɑ z d ɛ l
հակահեղափոխական	h ɑ k ɑ h ɛ ʁ ɑ pʰ ɔ χ ɑ k ɑ n
հակահեղափոխություն	h ɑ k ɑ h ɛ ʁ ɑ pʰ ɔ χ u tʰ j u n
հականեխիչ	h ɑ k ɑ n ɛ χ i t͡ʃʰ
հակառակ	h ɑ k ɑ r ɑ k
հակաօդային	h ɑ k ɑ ɔ tʰ ɑ j i n
հակինթ	h ɑ k i n tʰ
հակիրճ	h ɑ k i ɾ t͡ʃ
հակոբ	h ɑ k ɔ pʰ
հակոբյան	h ɑ k ɔ pʰ j ɑ n
հահ	h ɑ h
հաղագս	h ɑ ʁ ɑ ɡ ə s
հաղարջ	h ɑ ʁ ɑ ɾ d͡ʒ
հաղբ	h ɑ ʁ b
հաղթ	h ɑ χ tʰ
հաղթաթուղթ	h ɑ χ tʰ ɑ tʰ u χ tʰ
հաղթական	h ɑ χ tʰ ɑ k ɑ n
հաղթանակ	h ɑ χ tʰ ɑ n ɑ k
հաղթել	h ɑ χ tʰ ɛ l
հաղթու	h ɑ χ tʰ u
հաղորդագրություն	h ɑ ʁ ɔ ɾ tʰ ɑ ɡ ɾ u tʰ j u n
հաղորդակցություն	h ɑ ʁ ɔ ɾ tʰ ɑ k t͡sʰ u tʰ j u n
հաղորդավար	h ɑ ʁ ɔ ɾ tʰ ɑ v ɑ ɾ
հաղորդել	h ɑ ʁ ɔ ɾ tʰ ɛ l
հաճ	h ɑ t͡ʃ
հաճախորդ	h ɑ t͡ʃ ɑ χ ɔ ɾ tʰ
հաճախություն	h ɑ t͡ʃ ɑ χ u tʰ j u n
հաճախում	h ɑ t͡ʃ ɑ χ u m
հաճարենի	h ɑ t͡ʃ ɑ ɾ ɛ n i
հաճարի	h ɑ t͡ʃ ɑ ɾ i
հաճել	h ɑ t͡ʃ ɛ l
հաճելի	h ɑ t͡ʃ ɛ l i
հաճո	h ɑ t͡ʃ ɔ
հաճություն	h ɑ t͡ʃ u tʰ j u n
հաճույք	h ɑ t͡ʃ u j kʰ
համ	h ɑ m
համա	h ɑ m ɑ
համագործակցել	h ɑ m ɑ ɡ ɔ ɾ t͡s ɑ k t͡sʰ ɛ l
համագործակցության	h ɑ m ɑ ɡ ɔ ɾ t͡s ɑ k t͡sʰ u tʰ j ɑ n
համագործակցություն	h ɑ m ɑ ɡ ɔ ɾ t͡s ɑ k t͡sʰ u tʰ j u n
համագործել	h ɑ m ɑ ɡ ɔ ɾ t͡s ɛ l
համագումար	h ɑ m ɑ ɡ u m ɑ ɾ
համադան	h ɑ m ɑ d ɑ n
համադրություն	h ɑ m ɑ d ə ɾ u tʰ j u n
համազասպ	h ɑ m ɑ z ɑ s p
համաժամանակյա	h ɑ m ɑ ʒ ɑ m ɑ n ɑ k j ɑ
համալիր	h ɑ m ɑ l i ɾ
համալսարան	h ɑ m ɑ l s ɑ ɾ ɑ n
համախոհ	h ɑ m ɑ χ ɔ h
համակարգ	h ɑ m ɑ k ɑ ɾ kʰ
համակարգային	h ɑ m ɑ k ɑ ɾ kʰ ɑ j i n
համակարգել	h ɑ m ɑ k ɑ ɾ kʰ ɛ l
համակարգող	h ɑ m ɑ k ɑ ɾ kʰ ɔ ʁ
համակարգչային	h ɑ m ɑ k ɑ ɾ kʰ t͡ʃʰ ɑ j i n
համակրանք	h ɑ m ɑ k ɾ ɑ ŋ kʰ
համակրել	h ɑ m ɑ k ɾ ɛ l
համակրելի	h ɑ m ɑ k ɾ ɛ l i
համաձայն	h ɑ m ɑ d͡z ɑ j n
համաձայնել	h ɑ m ɑ d͡z ɑ j n ɛ l
համաձուլվածք	h ɑ m ɑ d͡z u l v ɑ t͡s kʰ
համամարդկային	h ɑ m ɑ m ɑ ɾ tʰ k ɑ j i n
համանախագահ	h ɑ m ɑ n ɑ χ ɑ ɡ ɑ h
համաներում	h ɑ m ɑ n ɛ ɾ u m
համանուն	h ɑ m ɑ n u n
համաշխարհային	h ɑ m ɑ ʃ χ ɑ ɾ ɑ j i n
համաշխարհաքաղաքացի	h ɑ m ɑ ʃ χ ɑ ɾ ɑ kʰ ɑ ʁ ɑ kʰ ɑ t͡sʰ i
համաչափ	h ɑ m ɑ t͡ʃʰ ɑ pʰ
համապատասխան	h ɑ m ɑ p ɑ t ɑ s χ ɑ n
համասեռամոլություն	h ɑ m ɑ s ɛ r ɑ m ɔ l u tʰ j u n
համաստեղություն	h ɑ m ɑ s t ɛ ʁ u tʰ j u n
համատարած	h ɑ m ɑ t ɑ ɾ ɑ t͡s
համատեղ	h ɑ m ɑ t ɛ ʁ
համատիրություն	h ɑ m ɑ t i ɾ u tʰ j u n
համար	h ɑ m ɑ ɾ
համարել	h ɑ m ɑ ɾ ɛ l
համարժեք	h ɑ m ɑ ɾ ʒ ɛ kʰ
համարիչ	h ɑ m ɑ ɾ i t͡ʃʰ
համարյա	h ɑ m ɑ ɾ j ɑ
համացանց	h ɑ m ɑ t͡sʰ ɑ n t͡sʰ
համացանցային	h ɑ m ɑ t͡sʰ ɑ n t͡sʰ ɑ j i n
համաքաղաքացի	h ɑ m ɑ kʰ ɑ ʁ ɑ kʰ ɑ t͡sʰ i
համբալ	h ɑ m b ɑ l
համբավավոր	h ɑ m b ɑ v ɑ v ɔ ɾ
համբար	h ɑ m b ɑ ɾ
համբարձում	h ɑ m b ɑ ɾ t͡sʰ u m
համբարձումյան	h ɑ m b ɑ ɾ t͡sʰ u m j ɑ n
համբերատար	h ɑ m pʰ ɛ ɾ ɑ t ɑ ɾ
համբերել	h ɑ m pʰ ɛ ɾ ɛ l
համբերություն	h ɑ m pʰ ɛ ɾ u tʰ j u n
համբյուր	h ɑ m pʰ j u ɾ
համբույր	h ɑ m pʰ u j ɾ
համբուրգ	h ɑ m b u ɾ ɡ
համբուրել	h ɑ m pʰ u ɾ ɛ l
համել	h ɑ m ɛ l
համեղ	h ɑ m ɛ ʁ
համեմատություն	h ɑ m ɛ m ɑ t u tʰ j u n
համեմունք	h ɑ m ɛ m u ŋ kʰ
համեստաբար	h ɑ m ɛ s t ɑ b ɑ ɾ
համեստորեն	h ɑ m ɛ s t ɔ ɾ ɛ n
համեստություն	h ɑ m ɛ s t u tʰ j u n
համերաշխ	h ɑ m ɛ ɾ ɑ ʃ χ
համերաշխություն	h ɑ m ɛ ɾ ɑ ʃ χ u tʰ j u n
համերգ	h ɑ m ɛ ɾ ɡ
համերգասրահ	h ɑ m ɛ ɾ ɡ ɑ s ə ɾ ɑ h
համընկնել	h ɑ m ə ŋ k n ɛ l
համշենցի	h ɑ m ʃ ɛ n t͡sʰ i
համշենցիներ	h ɑ m ʃ ɛ n t͡sʰ i n ɛ ɾ
համոզել	h ɑ m ɔ z ɛ l
համոզկեր	h ɑ m ɔ z k ɛ ɾ
համոզմունք	h ɑ m ɔ z m u ŋ kʰ
համով	h ɑ m ɔ v
համր	h ɑ m ə ɾ
հայաբնակ	h ɑ j ɑ b ə n ɑ k
հայագիտական	h ɑ j ɑ ɡ i t ɑ k ɑ n
հայագիտություն	h ɑ j ɑ ɡ i t u tʰ j u n
հայասա	h ɑ j ɑ s ɑ
հայաստան	h ɑ j ɑ s t ɑ n
հայաստանի	h ɑ j ɑ s t ɑ n i
հայացի	h ɑ j ɑ t͡sʰ i
հայացք	h ɑ j ɑ t͡sʰ kʰ
հայդարաբադ	h ɑ j d ɑ ɾ ɑ b ɑ d
հայելի	h ɑ j ɛ l i
հայերեն	h ɑ j ɛ ɾ ɛ n
հայեցակարգ	h ɑ j ɛ t͡sʰ ɑ k ɑ ɾ kʰ
հայեցի	h ɑ j ɛ t͡sʰ i
հայթայթել	h ɑ j tʰ ɑ j tʰ ɛ l
հայլի	h ɑ j l i
հայկ	h ɑ j k
հայկազն	h ɑ j k ɑ z ə n
հայկազուն	h ɑ j k ɑ z u n
հայկական	h ɑ j k ɑ k ɑ n
հայկականություն	h ɑ j k ɑ k ɑ n u tʰ j u n
հայկյան	h ɑ j k j ɑ n
հայհոյանք	h ɑ j h ɔ j ɑ ŋ kʰ
հայհոյել	h ɑ j h ɔ j ɛ l
հայոց	h ɑ j ɔ t͡sʰ
հայուհի	h ɑ j u h i
հայտ	h ɑ j t
հայտանիշ	h ɑ j t ɑ n i ʃ
հայտարար	h ɑ j t ɑ ɾ ɑ ɾ
հայտարարել	h ɑ j t ɑ ɾ ɑ ɾ ɛ l
հայտարարություն	h ɑ j t ɑ ɾ ɑ ɾ u tʰ j u n
հայտարարում	h ɑ j t ɑ ɾ ɑ ɾ u m
հայտարարվել	h ɑ j t ɑ ɾ ɑ ɾ v ɛ l
հայտնաբերել	h ɑ j t n ɑ b ɛ ɾ ɛ l
հայտնագործություն	h ɑ j t n ɑ ɡ ɔ ɾ t͡s u tʰ j u n
հայտնապես	h ɑ j t n ɑ p ɛ s
հայտնել	h ɑ j t n ɛ l
հայտնի	h ɑ j t n i
հայր	h ɑ j ɾ
հայրական	h ɑ j ɾ ɑ k ɑ n
հայրանուն	h ɑ j ɾ ɑ n u n
հայրատ	h ɑ j ɾ ɑ t
հայրենակից	h ɑ j ɾ ɛ n ɑ k i t͡sʰ
հայրենասիրական	h ɑ j ɾ ɛ n ɑ s i ɾ ɑ k ɑ n
հայրենիք	h ɑ j ɾ ɛ n i kʰ
հայրենյաց	h ɑ j ɾ ɛ n j ɑ t͡sʰ
հայց	h ɑ j t͡sʰ
հայցական	h ɑ j t͡sʰ ɑ k ɑ n
հայցել	h ɑ j t͡sʰ ɛ l
հայք	h ɑ j kʰ
հանապազ	h ɑ n ɑ p ɑ z
հանգ	h ɑ ŋ ɡ
հանգամանք	h ɑ ŋ ɡ ɑ m ɑ ŋ kʰ
հանգել	h ɑ ŋ ɡ ɛ l
հանգիստ	h ɑ ŋ ɡ i s t
հանգույց	h ɑ ŋ ɡ u j t͡sʰ
հանգստանալ	h ɑ ŋ ɡ ə s t ɑ n ɑ l
հանգրվան	h ɑ ŋ ɡ ə ɾ v ɑ n
հանդ	h ɑ n d
հանդարտ	h ɑ n d ɑ ɾ t
հանդբոլ	h ɑ n d b ɔ l
հանդեպ	h ɑ n d ɛ p
հանդես	h ɑ n d ɛ s
հանդերձ	h ɑ n d ɛ ɾ t͡sʰ
հանդիմանել	h ɑ n d i m ɑ n ɛ l
հանդիպել	h ɑ n d i p ɛ l
հանդիպում	h ɑ n d i p u m
հանդիսական	h ɑ n d i s ɑ k ɑ n
հանդիսավոր	h ɑ n d i s ɑ v ɔ ɾ
հանդիսավորապես	h ɑ n d i s ɑ v ɔ ɾ ɑ p ɛ s
հանդուգն	h ɑ n d u ɡ ə n
հանդուրժել	h ɑ n d u ɾ ʒ ɛ l
հանդուրժող	h ɑ n d u ɾ ʒ ɔ ʁ
հանդուրժողական	h ɑ n d u ɾ ʒ ɔ ʁ ɑ k ɑ n
հանել	h ɑ n ɛ l
հանելուկ	h ɑ n ɛ l u k
հանի	h ɑ n i
հանկարծ	h ɑ ŋ k ɑ ɾ t͡s
հանձին	h ɑ n d͡z i n
հանձինս	h ɑ n d͡z i n ə s
հանձնախումբ	h ɑ n d͡z n ɑ χ u m b
հանձնարարել	h ɑ n d͡z n ɑ ɾ ɑ ɾ ɛ l
հանձնել	h ɑ n d͡z n ɛ l
հանում	h ɑ n u m
հանուն	h ɑ n u n
հանպատրաստից	h ɑ n p ɑ t ɾ ɑ s t i t͡sʰ
հանվել	h ɑ n v ɛ l
հանրագիտարան	h ɑ n ɾ ɑ ɡ i t ɑ ɾ ɑ n
հանրախանութ	h ɑ n ɾ ɑ χ ɑ n u tʰ
հանրակացարան	h ɑ n ɾ ɑ k ɑ t͡sʰ ɑ ɾ ɑ n
հանրահավաք	h ɑ n ɾ ɑ h ɑ v ɑ kʰ
հանրապետական	h ɑ n ɾ ɑ p ɛ t ɑ k ɑ n
հանրապետություն	h ɑ n ɾ ɑ p ɛ t u tʰ j u n
հանրաքվե	h ɑ n ɾ ɑ kʰ ə v ɛ
հանցագործ	h ɑ n t͡sʰ ɑ ɡ ɔ ɾ t͡s
հանցանք	h ɑ n t͡sʰ ɑ ŋ kʰ
հանցավորություն	h ɑ n t͡sʰ ɑ v ɔ ɾ u tʰ j u n
հանքաքար	h ɑ ŋ kʰ ɑ kʰ ɑ ɾ
հաշիվ	h ɑ ʃ i v
հաշմանդամություն	h ɑ ʃ m ɑ n d ɑ m u tʰ j u n
հաշվապահություն	h ɑ ʃ v ɑ p ɑ h u tʰ j u n
հաշվառում	h ɑ ʃ v ɑ r u m
հաշվետախտակ	h ɑ ʃ v ɛ t ɑ χ t ɑ k
հաշվեքննիչ	h ɑ ʃ v ɛ kʰ ə nː i t͡ʃʰ
հաշվիչ	h ɑ ʃ v i t͡ʃʰ
հաշվում	h ɑ ʃ v u m
հաշտ	h ɑ ʃ t
հաշտեցում	h ɑ ʃ t ɛ t͡sʰ u m
հաուրան	h ɑ u ɾ ɑ n
հաչաղ	h ɑ t͡ʃʰ ɑ ʁ
հաչել	h ɑ t͡ʃʰ ɛ l
հապալաս	h ɑ p ɑ l ɑ s
հապաղ	h ɑ p ɑ ʁ
հապաղել	h ɑ p ɑ ʁ ɛ l
հապաղում	h ɑ p ɑ ʁ u m
հապավում	h ɑ p ɑ v u m
հապկ	h ɑ p k
հաջող	h ɑ d͡ʒ ɔ ʁ
հաջողություն	h ɑ d͡ʒ ɔ ʁ u tʰ j u n
հառաչ	h ɑ r ɑ t͡ʃʰ
հառաչալի	h ɑ r ɑ t͡ʃʰ ɑ l i
հառաչալիր	h ɑ r ɑ t͡ʃʰ ɑ l i ɾ
հառաչակից	h ɑ r ɑ t͡ʃʰ ɑ k i t͡sʰ
հառաչել	h ɑ r ɑ t͡ʃʰ ɛ l
հառաջացում	h ɑ r ɑ t͡ʃʰ ɑ t͡sʰ u m
հառել	h ɑ r ɛ l
հաս	h ɑ s
հասանելի	h ɑ s ɑ n ɛ l i
հասարակ	h ɑ s ɑ ɾ ɑ k
հասարակած	h ɑ s ɑ ɾ ɑ k ɑ t͡s
հասարակական	h ɑ s ɑ ɾ ɑ k ɑ k ɑ n
հասարակություն	h ɑ s ɑ ɾ ɑ k u tʰ j u n
հասկ	h ɑ s k
հասկանալ	h ɑ s k ɑ n ɑ l
հասկանալի	h ɑ s k ɑ n ɑ l i
հասկանում	h ɑ s k ɑ n u m
հասնել	h ɑ s n ɛ l
հասու	h ɑ s u
հաստ	h ɑ s t
հաստատ	h ɑ s t ɑ t
հաստատակամ	h ɑ s t ɑ t ɑ k ɑ m
հաստատել	h ɑ s t ɑ t ɛ l
հաստատուն	h ɑ s t ɑ t u n
հաստիչ	h ɑ s t i t͡ʃʰ
հաստոց	h ɑ s t ɔ t͡sʰ
հաստություն	h ɑ s t u tʰ j u n
հասցե	h ɑ s t͡sʰ ɛ
հասցեատեր	h ɑ s t͡sʰ ɛ ɑ t ɛ ɾ
հավ	h ɑ v
հավա	h ɑ v ɑ
հավանա	h ɑ v ɑ n ɑ
հավանաբար	h ɑ v ɑ n ɑ b ɑ ɾ
հավանական	h ɑ v ɑ n ɑ k ɑ n
հավանականություն	h ɑ v ɑ n ɑ k ɑ n u tʰ j u n
հավասարակողմ	h ɑ v ɑ s ɑ ɾ ɑ k ɔ ʁ m
հավասարասրուն	h ɑ v ɑ s ɑ ɾ ɑ s ɾ u n
հավասարություն	h ɑ v ɑ s ɑ ɾ u tʰ j u n
հավասարում	h ɑ v ɑ s ɑ ɾ u m
հավաստի	h ɑ v ɑ s t i
հավատալ	h ɑ v ɑ t ɑ l
հավատարիմ	h ɑ v ɑ t ɑ ɾ i m
հավատարմաբար	h ɑ v ɑ t ɑ ɾ m ɑ b ɑ ɾ
հավատարմագրել	h ɑ v ɑ t ɑ ɾ m ɑ ɡ ɾ ɛ l
հավատարմորեն	h ɑ v ɑ t ɑ ɾ m ɔ ɾ ɛ n
հավատարմություն	h ɑ v ɑ t ɑ ɾ m u tʰ j u n
հավատք	h ɑ v ɑ t kʰ
հավաք	h ɑ v ɑ kʰ
հավաքածու	h ɑ v ɑ kʰ ɑ t͡s u
հավաքական	h ɑ v ɑ kʰ ɑ k ɑ n
հավաքույթ	h ɑ v ɑ kʰ u j tʰ
հավելել	h ɑ v ɛ l ɛ l
հավելված	h ɑ v ɛ l v ɑ t͡s
հավես	h ɑ v ɛ s
հավետ	h ɑ v ɛ t
հավերժ	h ɑ v ɛ ɾ ʒ
հավիտյան	h ɑ v i t j ɑ n
հավր	h ɑ v ə ɾ
հավք	h ɑ f kʰ
հատ	h ɑ t
հատակ	h ɑ t ɑ k
հատապտուղ	h ɑ t ɑ p ə t u ʁ
հատել	h ɑ t ɛ l
հատիկ	h ɑ t i k
հատկություն	h ɑ t k u tʰ j u n
հատոր	h ɑ t ɔ ɾ
հատու	h ɑ t u
հատուկ	h ɑ t u k
հատում	h ɑ t u m
հատուցել	h ɑ t u t͡sʰ ɛ l
հատուցում	h ɑ t u t͡sʰ u m
հատված	h ɑ t v ɑ t͡s
հարազատ	h ɑ ɾ ɑ z ɑ t
հարակատար	h ɑ ɾ ɑ k ɑ t ɑ ɾ
հարամի	h ɑ ɾ ɑ m i
հարավային	h ɑ ɾ ɑ f ɑ j i n
հարբած	h ɑ ɾ pʰ ɑ t͡s
հարբել	h ɑ ɾ pʰ ɛ l
հարբուխ	h ɑ ɾ b u χ
հարգել	h ɑ ɾ ɡ ɛ l
հարդ	h ɑ ɾ d
հարել	h ɑ ɾ ɛ l
հարեւան	h ɑ ɾ ɛ v ɑ n
հարթ	h ɑ ɾ tʰ
հարթաքանդակ	h ɑ ɾ tʰ ɑ kʰ ɑ n d ɑ k
հարթություն	h ɑ ɾ tʰ u tʰ j u n
հարիսա	h ɑ ɾ i s ɑ
հարկ	h ɑ ɾ k
հարկահավաք	h ɑ ɾ k ɑ h ɑ v ɑ kʰ
հարկային	h ɑ ɾ k ɑ j i n
հարկավ	h ɑ ɾ k ɑ v
հարձակում	h ɑ ɾ t͡sʰ ɑ k u m
հարյուր	h ɑ ɾ j u ɾ
հարյուրամյակ	h ɑ ɾ j u ɾ ɑ m j ɑ k
հարյուրերորդ	h ɑ ɾ j u ɾ ɛ ɾ ɔ ɾ tʰ
հարոյան	h ɑ ɾ ɔ j ɑ n
հարություն	h ɑ ɾ u tʰ j u n
հարությունյան	h ɑ ɾ u tʰ j u n j ɑ n
հարուստ	h ɑ ɾ u s t
հարս	h ɑ ɾ s
հարսանեկան	h ɑ ɾ s ɑ n ɛ k ɑ n
հարսանիթ	h ɑ ɾ s ɑ n i tʰ
հարսանիք	h ɑ ɾ s ɑ n i kʰ
հարսանյաց	h ɑ ɾ s ɑ n j ɑ t͡sʰ
հարսնանալ	h ɑ ɾ s n ɑ n ɑ l
հարսնացնել	h ɑ ɾ s n ɑ t͡sʰ n ɛ l
հարսնացու	h ɑ ɾ s n ɑ t͡sʰ u
հարստություն	h ɑ ɾ ə s t u tʰ j u n
հարված	h ɑ ɾ v ɑ t͡s
հարվածել	h ɑ ɾ v ɑ t͡s ɛ l
հարց	h ɑ ɾ t͡sʰ
հարցազրույց	h ɑ ɾ t͡sʰ ɑ z ɾ u j t͡sʰ
հարցաքննություն	h ɑ ɾ t͡sʰ ɑ kʰ ə nː u tʰ j u n
հարցաքննում	h ɑ ɾ t͡sʰ ɑ kʰ ə nː u m
հարցնել	h ɑ ɾ t͡sʰ n ɛ l
հարցում	h ɑ ɾ t͡sʰ u m
հաց	h ɑ t͡sʰ
հացաբույս	h ɑ t͡sʰ ɑ b u j s
հացագործ	h ɑ t͡sʰ ɑ ɡ ɔ ɾ t͡s
հացադուլ	h ɑ t͡sʰ ɑ d u l
հացահատիկ	h ɑ t͡sʰ ɑ h ɑ t i k
հացենի	h ɑ t͡sʰ ɛ n i
հացի	h ɑ t͡sʰ i
հացհամեմ	h ɑ t͡sʰ h ɑ m ɛ m
հացուտ	h ɑ t͡sʰ u t
հափափել	h ɑ pʰ ɑ pʰ ɛ l
հափշտակում	h ɑ pʰ ʃ t ɑ k u m
հաքեր	h ɑ kʰ ɛ ɾ
հեգ	h ɛ ɡ
հեգել	h ɛ ɡ ɛ l
հեգնական	h ɛ ɡ n ɑ k ɑ n
հեթանոս	h ɛ tʰ ɑ n ɔ s
հեթում	h ɛ tʰ u m
հելլադա	h ɛ lː ɑ d ɑ
հելլեն	h ɛ lː ɛ n
հելլեսպոնտոս	h ɛ lː ɛ s p ɔ n t ɔ s
հելսինկի	h ɛ l s i ŋ k i
հեծան	h ɛ t͡s ɑ n
հեծանիվ	h ɛ t͡s ɑ n i v
հեծել	h ɛ t͡s ɛ l
հեծելազոր	h ɛ t͡s ɛ l ɑ z ɔ ɾ
հեծյալ	h ɛ t͡s j ɑ l
հեղաշրջում	h ɛ ʁ ɑ ʃ ə ɾ d͡ʒ u m
հեղել	h ɛ ʁ ɛ l
հեղեղ	h ɛ ʁ ɛ ʁ
հեղեղել	h ɛ ʁ ɛ ʁ ɛ l
հեղեղում	h ɛ ʁ ɛ ʁ u m
հեղինակ	h ɛ ʁ i n ɑ k
հեղինակություն	h ɛ ʁ i n ɑ k u tʰ j u n
հեղինե	h ɛ ʁ i n ɛ
հեղուկ	h ɛ ʁ u k
հեղված	h ɛ ʁ v ɑ t͡s
հեղվել	h ɛ ʁ v ɛ l
հենան	h ɛ n ɑ n
հենվել	h ɛ n v ɛ l
հենրիկ	h ɛ n ɾ i k
հեշթեգ	h ɛ ʃ tʰ ɛ ɡ
հեշտ	h ɛ ʃ t
հեշտոցային	h ɛ ʃ t ɔ t͡sʰ ɑ j i n
հեռագիր	h ɛ r ɑ ɡ i ɾ
հեռադիտակ	h ɛ r ɑ d i t ɑ k
հեռախոս	h ɛ r ɑ χ ɔ s
հեռակառավարման	h ɛ r ɑ k ɑ r ɑ v ɑ ɾ m ɑ n
հեռաձայն	h ɛ r ɑ d͡z ɑ j n
հեռաձայնել	h ɛ r ɑ d͡z ɑ j n ɛ l
հեռանկար	h ɛ r ɑ n ə k ɑ ɾ
հեռավոր	h ɛ r ɑ v ɔ ɾ
հեռացնել	h ɛ r ɑ t͡sʰ n ɛ l
հեռացում	h ɛ r ɑ t͡sʰ u m
հեռու	h ɛ r u
հեռուստաընկերություն	h ɛ r u s t ɑ ə ŋ k ɛ ɾ u tʰ j u n
հեռուստատեսություն	h ɛ r u s t ɑ t ɛ s u tʰ j u n
հեռուստացմփորիկ	h ɛ r u s t ɑ t͡sʰ ə m pʰ ɔ ɾ i k
հեսան	h ɛ s ɑ n
հեստ	h ɛ s t
հետազոտող	h ɛ t ɑ z ɔ t ɔ ʁ
հետազոտություն	h ɛ t ɑ z ɔ t u tʰ j u n
հետախուզական	h ɛ t ɑ χ u z ɑ k ɑ n
հետաձգել	h ɛ t ɑ d͡z ə kʰ ɛ l
հետանցք	h ɛ t ɑ n t͡sʰ kʰ
հետաքրքիր	h ɛ t ɑ kʰ ə ɾ kʰ i ɾ
հետաքրքրասեր	h ɛ t ɑ kʰ ə ɾ kʰ ɾ ɑ s ɛ ɾ
հետաքրքրություն	h ɛ t ɑ kʰ ə ɾ kʰ ɾ u tʰ j u n
հետեւ	h ɛ t ɛ v
հետեւաբար	h ɛ t ɛ v ɑ b ɑ ɾ
հետեւակային	h ɛ t ɛ v ɑ k ɑ j i n
հետեւանք	h ɛ t ɛ v ɑ ŋ kʰ
հետեւել	h ɛ t ɛ v ɛ l
հետին	h ɛ t i n
հետխորհրդային	h ɛ t χ ɔ ɾ ə ɾ tʰ ɑ j i n
հետմահու	h ɛ t m ɑ h u
հետնորդ	h ɛ t n ɔ ɾ tʰ
հետո	h ɛ t ɔ
հետույք	h ɛ t u j kʰ
հետք	h ɛ t kʰ
հեր	h ɛ ɾ
հերակլիտ	h ɛ ɾ ɑ k l i t
հերերո	h ɛ ɾ ɛ ɾ ɔ
հերթ	h ɛ ɾ tʰ
հերիք	h ɛ ɾ i kʰ
հերձում	h ɛ ɾ d͡z u m
հերոին	h ɛ ɾ ɔ i n
հերոս	h ɛ ɾ ɔ s
հերոսական	h ɛ ɾ ɔ s ɑ k ɑ n
հերոսություն	h ɛ ɾ ɔ s u tʰ j u n
հերոսուհի	h ɛ ɾ ɔ s u h i
հերովդես	h ɛ ɾ ɔ v d ɛ s
հերցեգովինա	h ɛ ɾ t͡sʰ ɛ ɡ ɔ v i n ɑ
հերք	h ɛ ɾ kʰ
հերքել	h ɛ ɾ kʰ ɛ l
հերքում	h ɛ ɾ kʰ u m
հերքվել	h ɛ ɾ kʰ v ɛ l
հեքիաթ	h ɛ kʰ j ɑ tʰ
հեքիմ	h ɛ kʰ i m
հզոր	h ə z ɔ ɾ
հի	h i
հիանալ	h i j ɑ n ɑ l
հիանալի	h i j ɑ n ɑ l i
հիասթափություն	h i j ɑ s tʰ ɑ pʰ u tʰ j u n
հիասթափում	h i j ɑ s tʰ ɑ pʰ u m
հիասթափված	h i j ɑ s tʰ ɑ pʰ v ɑ t͡s
հիասթափվել	h i j ɑ s tʰ ɑ pʰ v ɛ l
հիասքանչ	h i j ɑ s kʰ ɑ n t͡ʃʰ
հիգիենա	h i ɡ j ɛ n ɑ
հիմա	h i m ɑ
հիման	h i m ɑ n
հիմն	h i m ə n
հիմնադիր	h i m n ɑ d i ɾ
հիմնադրական	h i m n ɑ d ɾ ɑ k ɑ n
հիմնադրամ	h i m n ɑ d ɾ ɑ m
հիմնադրել	h i m n ɑ d ɾ ɛ l
հիմնադրում	h i m n ɑ d ɾ u m
հիմնադրվել	h i m n ɑ d ə ɾ v ɛ l
հիմնախնդիր	h i m n ɑ χ ə n tʰ i ɾ
հիմնական	h i m n ɑ k ɑ n
հիմնականորեն	h i m n ɑ k ɑ n ɔ ɾ ɛ n
հիմնահարց	h i m n ɑ h ɑ ɾ t͡sʰ
հիմնավորել	h i m n ɑ v ɔ ɾ ɛ l
հիմք	h i m kʰ
հին	h i n
հինգ	h i ŋ ɡ
հինգերորդ	h i ŋ ɡ ɛ ɾ ɔ ɾ tʰ
հինդի	h i n d i
հինդուկուշ	h i n d u k u ʃ
հիշել	h i ʃ ɛ l
հիշեցնել	h i ʃ ɛ t͡sʰ n ɛ l
հիշողություն	h i ʃ ɔ ʁ u tʰ j u n
հիպերմարկետ	h i p ɛ ɾ m ɑ ɾ k ɛ t
հիջազ	h i d͡ʒ ɑ z
հիսուս	h i s u s
հիվանդ	h i v ɑ n d
հիվանդագին	h i v ɑ n d ɑ ɡ i n
հիվանդախնամ	h i v ɑ n d ɑ χ ə n ɑ m
հիվանդանալ	h i v ɑ n d ɑ n ɑ l
հիվանդանոց	h i v ɑ n d ɑ n ɔ t͡sʰ
հիվանդություն	h i v ɑ n d u tʰ j u n
հիրավի	h i ɾ ɑ v i
հլու	h ə l u
հհ	h ə h ə
հհկ	h ə h ə k ə
հղանալ	h ə ʁ ɑ n ɑ l
հղիանալ	h ə ʁ i j ɑ n ɑ l
հղիություն	h ə ʁ i j u tʰ j u n
հղություն	h ə ʁ u tʰ j u n
հղում	h ə ʁ u m
հմայք	h ə m ɑ j kʰ
հմուտ	h ə m u t
հյութ	h j u tʰ
հյութեղ	h j u tʰ ɛ ʁ
հյուլե	h j u l ɛ
հյուպատոս	h j u p ɑ t ɔ s
հյուպատոսություն	h j u p ɑ t ɔ s u tʰ j u n
հյուսել	h j u s ɛ l
հյուսիսային	h j u s i s ɑ j i n
հյուսկեն	h j u s k ɛ n
հյուսն	h j u s ə n
հյուր	h j u ɾ
հյուրանոց	h j u ɾ ɑ n ɔ t͡sʰ
հյուրասրահ	h j u ɾ ɑ s ə ɾ ɑ h
հյուրեր	h j u ɾ ɛ ɾ
հյուրերը	h j u ɾ ɛ ɾ ə
հյուրերի	h j u ɾ ɛ ɾ i
հյուրերիդ	h j u ɾ ɛ ɾ i d
հյուրերին	h j u ɾ ɛ ɾ i n
հյուրերիս	h j u ɾ ɛ ɾ i s
հյուրերից	h j u ɾ ɛ ɾ i t͡sʰ
հյուրերն	h j u ɾ ɛ ɾ ə n
հյուրերով	h j u ɾ ɛ ɾ ɔ v
հյուրը	h j u ɾ ə
հյուրի	h j u ɾ i
հյուրին	h j u ɾ i n
հյուրիս	h j u ɾ i s
հյուրից	h j u ɾ i t͡sʰ
հյուրն	h j u ɾ n
հյուրս	h j u ɾ ə s
հնագետ	h ə n ɑ ɡ ɛ t
հնագույն	h ə n ɑ ɡ u j n
հնազանդ	h ə n ɑ z ɑ n d
հնազանդություն	h ə n ɑ z ɑ n d u tʰ j u n
հնազանդվել	h ə n ɑ z ɑ n d v ɛ l
հնամյա	h ə n ɑ m j ɑ
հնար	h ə n ɑ ɾ
հնարամիտ	h ə n ɑ ɾ ɑ m i t
հնարամտություն	h ə n ɑ ɾ ɑ m ə t u tʰ j u n
հնարավորություն	h ə n ɑ ɾ ɑ v ɔ ɾ u tʰ j u n
հնարել	h ə n ɑ ɾ ɛ l
հնացած	h ə n ɑ t͡sʰ ɑ t͡s
հնդեվրոպական	h ə n d ɛ v ɾ ɔ p ɑ k ɑ n
հնդիկ	h ə n d i k
հնդկական	h ə n d k ɑ k ɑ n
հնդկաչին	h ə n d k ɑ t͡ʃʰ i n
հնդկաստան	h ə n d k ɑ s t ɑ n
հնդկացի	h ə n d k ɑ t͡sʰ i
հնդկընկույզ	h ə n d k ə ŋ k u j z
հնձան	h ə n d͡z ɑ n
հնոտի	h ə n ɔ t i
հնոտիք	h ə n ɔ t i kʰ
հնչել	h ə n t͡ʃʰ ɛ l
հնչյուն	h ə n t͡ʃʰ j u n
հնչյունական	h ə n t͡ʃʰ j u n ɑ k ɑ n
հնչյունային	h ə n t͡ʃʰ j u n ɑ j i n
հնչույթ	h ə n t͡ʃʰ u j tʰ
հո	h ɔ
հոբելյան	h ɔ b ɛ l j ɑ n
հոբելյանական	h ɔ b ɛ l j ɑ n ɑ k ɑ n
հոբելյար	h ɔ b ɛ l j ɑ ɾ
հոգ	h ɔ kʰ
հոգալ	h ɔ kʰ ɑ l
հոգատար	h ɔ kʰ ɑ t ɑ ɾ
հոգեբան	h ɔ kʰ ɛ b ɑ n
հոգեբանական	h ɔ kʰ ɛ b ɑ n ɑ k ɑ n
հոգեբանություն	h ɔ kʰ ɛ b ɑ n u tʰ j u n
հոգեղեն	h ɔ kʰ ɛ ʁ ɛ n
հոգի	h ɔ kʰ i
հոգնա	h ɔ kʰ n ɑ
հոգնած	h ɔ kʰ n ɑ t͡s
հոգնածություն	h ɔ kʰ n ɑ t͡s u tʰ j u n
հոգնակի	h ɔ kʰ n ɑ k i
հոգնել	h ɔ kʰ n ɛ l
հոգոց	h ɔ kʰ ɔ t͡sʰ
հոգս	h ɔ kʰ s
հոդ	h ɔ d
հոլ	h ɔ l
հոլանդական	h ɔ l ɑ n d ɑ k ɑ n
հոլանդացի	h ɔ l ɑ n d ɑ t͡sʰ i
հոլանդերեն	h ɔ l ɑ n d ɛ ɾ ɛ n
հոլանի	h ɔ l ɑ n i
հոլով	h ɔ l ɔ v
հոլովակ	h ɔ l ɔ v ɑ k
հոլովում	h ɔ l ɔ v u m
հոլոքոստ	h ɔ l ɔ kʰ ɔ s t
հոխորտալ	h ɔ χ ɔ ɾ t ɑ l
հոխորտանք	h ɔ χ ɔ ɾ t ɑ ŋ kʰ
հոկեյ	h ɔ k ɛ j
հոկտեմբեր	h ɔ k t ɛ m b ɛ ɾ
հոկտեմբերյան	h ɔ k t ɛ m b ɛ ɾ j ɑ n
հողակոշտ	h ɔ ʁ ɑ k ɔ ʃ t
հողդողդ	h ɔ ʁ d ɔ ʁ d
հողդողդել	h ɔ ʁ d ɔ ʁ d ɛ l
հողեղեն	h ɔ ʁ ɛ ʁ ɛ n
հոմանիշ	h ɔ m ɑ n i ʃ
հոմս	h ɔ m s
հոյակապ	h ɔ j ɑ k ɑ p
հոյակերտ	h ɔ j ɑ k ɛ ɾ t
հոյաշեն	h ɔ j ɑ ʃ ɛ n
հոն	h ɔ n
հոնդուրաս	h ɔ n d u ɾ ɑ s
հոնկոնգ	h ɔ ŋ k ɔ ŋ ɡ
հոնսյու	h ɔ n s j u
հոշոտել	h ɔ ʃ ɔ t ɛ l
հոպար	h ɔ p ɑ ɾ
հոռի	h ɔ r i
հոս	h ɔ s
հոսանք	h ɔ s ɑ ŋ kʰ
հոսք	h ɔ s kʰ
հով	h ɔ v
հովանի	h ɔ v ɑ n i
հովիտ	h ɔ v i t
հովո	h ɔ v ɔ
հովսեփ	h ɔ f s ɛ pʰ
հոտ	h ɔ t
հոտաղ	h ɔ t ɑ ʁ
հոր	h ɔ ɾ
հորդ	h ɔ ɾ d
հորդել	h ɔ ɾ d ɛ l
հորդորել	h ɔ ɾ d ɔ ɾ ɛ l
հորեղբայր	h ɔ ɾ ɛ χ p ɑ j ɾ
հորեղբոր	h ɔ ɾ ɛ χ p ɔ ɾ
հորթ	h ɔ ɾ tʰ
հորթուկ	h ɔ ɾ tʰ u k
հորովել	h ɔ ɾ ɔ v ɛ l
հորու	h ɔ ɾ u
հորս	h ɔ ɾ s
հու	h u
հուբեյ	h u b ɛ j
հուդա	h u d ɑ
հուդզոն	h u d z ɔ n
հուզել	h u z ɛ l
հուզիչ	h u z i t͡ʃʰ
հուզող	h u z ɔ ʁ
հուլիսյան	h u l i s j ɑ n
հում	h u m
հումանիստ	h u m ɑ n i s t
հումանիտար	h u m ɑ n i t ɑ ɾ
հումոր	h u m ɔ ɾ
հումուս	h u m u s
հումք	h u m kʰ
հույզ	h u j z
հույլ	h u j l
հույն	h u j n
հույս	h u j s
հունական	h u n ɑ k ɑ n
հունաստան	h u n ɑ s t ɑ n
հունարեն	h u n ɑ ɾ ɛ n
հունգարիա	h u ŋ ɡ ɑ ɾ j ɑ
հունիսյան	h u n i s j ɑ n
հունձ	h u n d͡z
հունվար	h u n v ɑ ɾ
հուշ	h u ʃ
հուշանվեր	h u ʃ ɑ n ə v ɛ ɾ
հուշարձան	h u ʃ ɑ ɾ d͡z ɑ n
հուշեր	h u ʃ ɛ ɾ
հուռ	h u r
հուռութք	h u r u tʰ kʰ
հուսադրել	h u s ɑ d ɾ ɛ l
հուսալքված	h u s ɑ l ə kʰ v ɑ t͡s
հուսակտուր	h u s ɑ k ə t u ɾ
հուսահատ	h u s ɑ h ɑ t
հուսահատեցնել	h u s ɑ h ɑ t ɛ t͡sʰ n ɛ l
հուսահատեցնող	h u s ɑ h ɑ t ɛ t͡sʰ n ɔ ʁ
հուսահատություն	h u s ɑ h ɑ t u tʰ j u n
հուսիկ	h u s i k
հուր	h u ɾ
հպարտանալ	h ə p ɑ ɾ t ɑ n ɑ l
հպարտություն	h ə p ɑ ɾ t u tʰ j u n
հռետոր	h r ɛ t ɔ ɾ
հռոդոս	h r ɔ d ɔ s
հռչակ	h ə r t͡ʃʰ ɑ k
հռչակավոր	h ə r t͡ʃʰ ɑ k ɑ v ɔ ɾ
հսկա	h ə s k ɑ
հսկայական	h ə s k ɑ j ɑ k ɑ n
հսկել	h ə s k ɛ l
հստակ	h ə s t ɑ k
հտհ	h ə t ə h ə
հրաբուխ	h ə ɾ ɑ b u χ
հրադադար	h ə ɾ ɑ d ɑ tʰ ɑ ɾ
հրազդան	h ə ɾ ɑ z d ɑ n
հրաժարական	h ə ɾ ɑ ʒ ɑ ɾ ɑ k ɑ n
հրաժեշտ	h ə ɾ ɑ ʒ ɛ ʃ t
հրաժեշտախնջույք	h ə ɾ ɑ ʒ ɛ ʃ t ɑ χ ə n d͡ʒ u j kʰ
հրահրել	h ə ɾ ɑ h ə ɾ ɛ l
հրաձգարան	h ə ɾ ɑ d͡z ə kʰ ɑ ɾ ɑ n
հրամայական	h ə ɾ ɑ m ɑ j ɑ k ɑ n
հրամանատար	h ə ɾ ɑ m ɑ n ɑ t ɑ ɾ
հրայր	h ə ɾ ɑ j ɾ
հրանտ	h ə ɾ ɑ n t
հրաշք	h ə ɾ ɑ ʃ kʰ
հրաչ	h ə ɾ ɑ t͡ʃʰ
հրապարակայնություն	h ə ɾ ɑ p ɑ ɾ ɑ k ɑ j n u tʰ j u n
հրապարակավ	h ɾ ɑ p ɑ ɾ ɑ k ɑ v
հրապարակել	h ə ɾ ɑ p ɑ ɾ ɑ k ɛ l
հրապուրել	h ə ɾ ɑ p u ɾ ɛ l
հրասայլ	h ə ɾ ɑ s ɑ j l
հրավառություն	h ə ɾ ɑ v ɑ r u tʰ j u n
հրավերք	h ə ɾ ɑ v ɛ ɾ kʰ
հրատ	h ə ɾ ɑ t
հրատարակել	h ə ɾ ɑ t ɑ ɾ ɑ k ɛ l
հրատարակչություն	h ə ɾ ɑ t ɑ ɾ ɑ k t͡ʃʰ u tʰ j u n
հրեական	h ə ɾ j ɑ k ɑ n
հրել	h ə ɾ ɛ l
հրեշտակ	h ə ɾ ɛ ʃ t ɑ k
հրես	h ə ɾ ɛ s
հրետանի	h ə ɾ ɛ t ɑ n i
հրկիզել	h ə ɾ k i z ɛ l
հրճվանք	h ə ɾ t͡ʃ v ɑ ŋ kʰ
հրճվել	h ə ɾ t͡ʃ v ɛ l
հրշեջ	h ə ɾ ʃ ɛ d͡ʒ
հրուշակագործ	h ə ɾ u ʃ ɑ k ɑ ɡ ɔ ɾ t͡s
հրուշակեղեն	h ə ɾ u ʃ ɑ k ɛ ʁ ɛ n
հրվանդան	h ə ɾ v ɑ n d ɑ n
հօգուտ	h ɔ kʰ u t
հօպ	h ɔ p
ձագ	d͡z ɑ kʰ
ձագար	d͡z ɑ ɡ ɑ ɾ
ձախ	d͡z ɑ χ
ձախլիկ	d͡z ɑ χ l i k
ձախողակ	d͡z ɑ χ ɔ ʁ ɑ k
ձաղել	d͡z ɑ ʁ ɛ l
ձաղկել	d͡z ɑ χ k ɛ l
ձաղտել	d͡z ɑ χ t ɛ l
ձայն	d͡z ɑ j n
ձայնավոր	d͡z ɑ j n ɑ v ɔ ɾ
ձայնեղ	d͡z ɑ j n ɛ ʁ
ձանձրալի	d͡z ɑ n d͡z ɾ ɑ l i
ձանձրույթ	d͡z ɑ n d͡z ɾ u j tʰ
ձաուջիկաու	d͡z ɑ u d͡ʒ i k ɑ u
ձառ	d͡z ɑ r
ձավար	d͡z ɑ v ɑ ɾ
ձար	d͡z ɑ ɾ
ձգել	d͡z ə kʰ ɛ l
ձգտել	d͡z ə kʰ t ɛ l
ձգտում	d͡z ə kʰ t u m
ձեթ	d͡z ɛ tʰ
ձեղնահարկ	d͡z ɛ ʁ n ɑ h ɑ ɾ k
ձեն	d͡z ɛ n
ձեռ	d͡z ɛ r
ձեռային	d͡z ɛ r ɑ j i n
ձեռնագնդակ	d͡z ɛ r n ɑ ɡ ə n d ɑ k
ձեռնածու	d͡z ɛ r n ɑ t͡s u
ձեռնարկ	d͡z ɛ r n ɑ ɾ k
ձեռնարկություն	d͡z ɛ r n ɑ ɾ k u tʰ j u n
ձեռներեց	d͡z ɛ r n ɛ ɾ ɛ t͡sʰ
ձեռնոց	d͡z ɛ r n ɔ t͡sʰ
ձեռնպահ	d͡z ɛ r ə n p ɑ h
ձեռք	d͡z ɛ r kʰ
ձեռքի	d͡z ɛ r kʰ i
ձերբակալել	d͡z ɛ ɾ pʰ ɑ k ɑ l ɛ l
ձերբակալություն	d͡z ɛ ɾ pʰ ɑ k ɑ l u tʰ j u n
ձեւ	d͡z ɛ v
ձեւանմուշ	d͡z ɛ v ɑ n ə m u ʃ
ձեւաչափ	d͡z ɛ v ɑ t͡ʃʰ ɑ pʰ
ձեւավորել	d͡z ɛ v ɑ v ɔ ɾ ɛ l
ձի	d͡z i
ձիաբոռ	d͡z i j ɑ b ɔ r
ձիահ	d͡z i ɑ h
ձիաուժ	d͡z i j ɑ u ʒ
ձիգ	d͡z i kʰ
ձիթայուղ	d͡z i tʰ ɑ j u ʁ
ձիթապտուղ	d͡z i tʰ ɑ p ə t u ʁ
ձիր	d͡z i ɾ
ձիրք	d͡z i ɾ kʰ
ձկնորս	d͡z ə k n ɔ ɾ s
ձկնորսական	d͡z ə k n ɔ ɾ s ɑ k ɑ n
ձկնորսություն	d͡z ə k n ɔ ɾ s u tʰ j u n
ձմեռ	d͡z ə m ɛ r
ձմեռային	d͡z ə m ɛ r ɑ j i n
ձմեռանոց	d͡z ə m ɛ r ɑ n ɔ t͡sʰ
ձմռանը	d͡z ə m r ɑ n ə
ձյուն	d͡z j u n
ձնագնդիկ	d͡z ə n ɑ ɡ ə n d i k
ձնե	d͡z ə n ɛ
ձնեմարդ	d͡z ə n ɛ m ɑ ɾ tʰ
ձնծաղիկ	d͡z ə n t͡s ɑ ʁ i k
ձող	d͡z ɔ ʁ
ձողիկ	d͡z ɔ ʁ i k
ձու	d͡z u
ձուլածո	d͡z u l ɑ t͡s ɔ
ձուլել	d͡z u l ɛ l
ձուկ	d͡z u k
ձուն	d͡z u n
ձվաբջիջ	d͡z ə v ɑ b ə d͡ʒ i d͡ʒ
ձվածեղ	d͡z ə v ɑ t͡s ɛ ʁ
ձվաձեւ	d͡z ə v ɑ d͡z ɛ v
ձվարան	d͡z ə v ɑ ɾ ɑ n
ձրի	d͡z ə ɾ i
ղազախերեն	ʁ ɑ z ɑ χ ɛ ɾ ɛ n
ղազար	ʁ ɑ z ɑ ɾ
ղազարյան	ʁ ɑ z ɑ ɾ j ɑ n
ղազարոս	ʁ ɑ z ɑ ɾ ɔ s
ղալաթ	ʁ ɑ l ɑ tʰ
ղալմաղալ	ʁ ɑ l m ɑ ʁ ɑ l
ղայիշ	ʁ ɑ j i ʃ
ղաշանգ	ʁ ɑ ʃ ɑ ŋ ɡ
ղատ	ʁ ɑ t
ղարաբաղ	ʁ ɑ ɾ ɑ b ɑ ʁ
ղարաբաղյան	ʁ ɑ ɾ ɑ b ɑ ʁ j ɑ n
ղարաբաղցի	ʁ ɑ ɾ ɑ b ɑ χ t͡sʰ i
ղարավաշ	ʁ ɑ ɾ ɑ v ɑ ʃ
ղարս	ʁ ɑ ɾ s
ղափան	ʁ ɑ pʰ ɑ n
ղափլան	ʁ ɑ pʰ l ɑ n
ղեկ	ʁ ɛ k
ղեկավար	ʁ ɛ k ɑ v ɑ ɾ
ղեկավարել	ʁ ɛ k ɑ v ɑ ɾ ɛ l
ղեկավարություն	ʁ ɛ k ɑ v ɑ ɾ u tʰ j u n
ղոնաղ	ʁ ɔ n ɑ ʁ
ղուկաս	ʁ u k ɑ s
ղում	ʁ u m
ղուշ	ʁ u ʃ
ղուրան	ʁ u ɾ ɑ n
ղպտի	ʁ ə p t i
ղպտիական	ʁ ə p t i j ɑ k ɑ n
ղսմաթ	ʁ ə s m ɑ tʰ
ղրիմ	ʁ ə ɾ i m
ղրղզական	ʁ ə ɾ ʁ ə z ɑ k ɑ n
ղրղզստան	ʁ ə ɾ ʁ ə z s t ɑ n
ճագար	t͡ʃ ɑ ɡ ɑ ɾ
ճախարակ	t͡ʃ ɑ χ ɑ ɾ ɑ k
ճախրել	t͡ʃ ɑ χ ɾ ɛ l
ճակատ	t͡ʃ ɑ k ɑ t
ճակատագիր	t͡ʃ ɑ k ɑ t ɑ ɡ i ɾ
ճակատամարտ	t͡ʃ ɑ k ɑ t ɑ m ɑ ɾ t
ճակատային	t͡ʃ ɑ k ɑ t ɑ j i n
ճահիճ	t͡ʃ ɑ h i t͡ʃ
ճահուկ	t͡ʃ ɑ h u k
ճաղատ	t͡ʃ ɑ ʁ ɑ t
ճամբար	t͡ʃ ɑ m b ɑ ɾ
ճամփա	t͡ʃ ɑ m pʰ ɑ
ճամփել	t͡ʃ ɑ m pʰ ɛ l
ճայ	t͡ʃ ɑ j
ճան	t͡ʃ ɑ n
ճանաչել	t͡ʃ ɑ n ɑ t͡ʃʰ ɛ l
ճանաչում	t͡ʃ ɑ n ɑ t͡ʃʰ u m
ճանապարհ	t͡ʃ ɑ n ɑ p ɑ ɾ
ճանապարհային	t͡ʃ ɑ n ɑ p ɑ ɾ ɑ j i n
ճանապարհել	t͡ʃ ɑ n ɑ p ɑ ɾ ɛ l
ճանապարհորդ	t͡ʃ ɑ n ɑ p ɑ ɾ ɔ ɾ tʰ
ճանապարհորդել	t͡ʃ ɑ n ɑ p ɑ ɾ ɔ ɾ tʰ ɛ l
ճանապարհորդություն	t͡ʃ ɑ n ɑ p ɑ ɾ ɔ ɾ tʰ u tʰ j u n
ճանդան	t͡ʃ ɑ n d ɑ n
ճանճ	t͡ʃ ɑ n t͡ʃ
ճաշ	t͡ʃ ɑ ʃ
ճաշաման	t͡ʃ ɑ ʃ ɑ m ɑ n
ճաշասրահ	t͡ʃ ɑ ʃ ɑ s ə ɾ ɑ h
ճաշարան	t͡ʃ ɑ ʃ ɑ ɾ ɑ n
ճաշել	t͡ʃ ɑ ʃ ɛ l
ճաշկերույթ	t͡ʃ ɑ ʃ k ɛ ɾ u j tʰ
ճապոնական	t͡ʃ ɑ p ɔ n ɑ k ɑ n
ճապոներեն	t͡ʃ ɑ p ɔ n ɛ ɾ ɛ n
ճապոնիա	t͡ʃ ɑ p ɔ n j ɑ
ճապուկ	t͡ʃ ɑ p u k
ճառագայթ	t͡ʃ ɑ r ɑ ɡ ɑ j tʰ
ճարակ	t͡ʃ ɑ ɾ ɑ k
ճարահատ	t͡ʃ ɑ ɾ ɑ h ɑ t
ճարահատյալ	t͡ʃ ɑ ɾ ɑ h ɑ t j ɑ l
ճարպ	t͡ʃ ɑ ɾ p
ճարպիկ	t͡ʃ ɑ ɾ p i k
ճարտարագիտական	t͡ʃ ɑ ɾ t ɑ ɾ ɑ ɡ i t ɑ k ɑ n
ճարտարապետ	t͡ʃ ɑ ɾ t ɑ ɾ ɑ p ɛ t
ճարտարապետություն	t͡ʃ ɑ ɾ t ɑ ɾ ɑ p ɛ t u tʰ j u n
ճաք	t͡ʃ ɑ kʰ
ճգնաժամ	t͡ʃ ə kʰ n ɑ ʒ ɑ m
ճգնավոր	t͡ʃ ə kʰ n ɑ v ɔ ɾ
ճեղք	t͡ʃ ɛ χ kʰ
ճեղքում	t͡ʃ ɛ χ kʰ u m
ճեղքվածք	t͡ʃ ɛ χ kʰ v ɑ t͡s kʰ
ճենովական	t͡ʃ ɛ n ɔ v ɑ k ɑ n
ճենովացի	t͡ʃ ɛ n ɔ v ɑ t͡sʰ i
ճեպազրույց	t͡ʃ ɛ p ɑ z ə ɾ u j t͡sʰ
ճերմակ	t͡ʃ ɛ ɾ m ɑ k
ճերմակություն	t͡ʃ ɛ ɾ m ɑ k u tʰ j u n
ճիգ	t͡ʃ i kʰ
ճիզվիտ	t͡ʃ i z v i t
ճիճու	t͡ʃ i t͡ʃ u
ճիշտ	t͡ʃ i ʃ t
ճիվ	t͡ʃ i v
ճկել	t͡ʃ ə k ɛ l
ճկուն	t͡ʃ ə k u n
ճկունություն	t͡ʃ ə k u n u tʰ j u n
ճյուղ	t͡ʃ j u ʁ
ճնճղուկ	t͡ʃ ə n t͡ʃ ə ʁ u k
ճնշում	t͡ʃ ə n ʃ u m
ճշգրտել	t͡ʃ ə ʃ ɡ ə ɾ t ɛ l
ճշմարիտ	t͡ʃ ə ʃ m ɑ ɾ i t
ճշմարտություն	t͡ʃ ə ʃ m ɑ ɾ t u tʰ j u n
ճո	t͡ʃ ə ɔ
ճոխ	t͡ʃ ɔ χ
ճողոպրել	t͡ʃ ɔ ʁ ɔ p ɾ ɛ l
ճոճաթոռ	t͡ʃ ɔ t͡ʃ ɑ tʰ ɔ r
ճոճանակ	t͡ʃ ɔ t͡ʃ ɑ n ɑ k
ճոճել	t͡ʃ ɔ t͡ʃ ɛ l
ճոն	t͡ʃ ɔ n
ճոռոմ	t͡ʃ ɔ r ɔ m
ճոռոմախոս	t͡ʃ ɔ r ɔ m ɑ χ ɔ s
ճորոխ	t͡ʃ ɔ ɾ ɔ χ
ճորտ	t͡ʃ ɔ ɾ t
ճչալ	t͡ʃ ə t͡ʃʰ ɑ l
ճռճռալ	t͡ʃ ə r t͡ʃ ə r ɑ l
ճտվտալ	t͡ʃ ə t v ə t ɑ l
ճրագ	t͡ʃ ə ɾ ɑ kʰ
ճրագալույց	t͡ʃ ə ɾ ɑ kʰ ɑ l u j t͡sʰ
մա	m ɑ
մագադան	m ɑ ɡ ɑ d ɑ n
մագնիս	m ɑ ɡ n i s
մադագասկար	m ɑ d ɑ ɡ ɑ s k ɑ ɾ
մադադյան	m ɑ d ɑ d j ɑ n
մադաթ	m ɑ d ɑ tʰ
մադիան	m ɑ d j ɑ n
մադրիդյան	m ɑ d ɾ i d j ɑ n
մազ	m ɑ z
մաթեմատիկա	m ɑ tʰ ɛ m ɑ t i k ɑ
մաթեմատիկոս	m ɑ tʰ ɛ m ɑ t i k ɔ s
մաթեւոս	m ɑ tʰ ɛ v ɔ s
մաթեւոսյան	m ɑ tʰ ɛ v ɔ s j ɑ n
մալադեց	m ɑ l ɑ d ɛ t͡sʰ
մալարիա	m ɑ l ɑ ɾ j ɑ
մալթա	m ɑ l tʰ ɑ
մալթայերեն	m ɑ l tʰ ɑ j ɛ ɾ ɛ n
մալի	m ɑ l i
մալուխ	m ɑ l u χ
մախր	m ɑ χ ə ɾ
մածուկ	m ɑ t͡s u k
մածուն	m ɑ t͡s u n
մակ	m ɑ k
մակարոն	m ɑ k ɑ ɾ ɔ n
մակբայական	m ɑ k b ɑ j ɑ k ɑ n
մակդիր	m ɑ k d i ɾ
մակեդոնական	m ɑ k ɛ d ɔ n ɑ k ɑ n
մակեդոնացի	m ɑ k ɛ d ɔ n ɑ t͡sʰ i
մակեդոներեն	m ɑ k ɛ d ɔ n ɛ ɾ ɛ n
մակերես	m ɑ k ɛ ɾ ɛ s
մակույկ	m ɑ k u j k
մակրոտնտեսական	m ɑ k ɾ ɔ t ə n t ɛ s ɑ k ɑ n
մահ	m ɑ h
մահաբեր	m ɑ h ɑ b ɛ ɾ
մահակ	m ɑ h ɑ k
մահանա	m ɑ h ɑ n ɑ
մահանալ	m ɑ h ɑ n ɑ l
մահապարտ	m ɑ h ɑ p ɑ ɾ t
մահարաշտրա	m ɑ h ɑ ɾ ɑ ʃ t ɾ ɑ
մահացու	m ɑ h ɑ t͡sʰ u
մահափորձ	m ɑ h ɑ pʰ ɔ ɾ t͡sʰ
մահաքաղաք	m ɑ h ɑ kʰ ɑ ʁ ɑ kʰ
մահիճ	m ɑ h i t͡ʃ
մահճակալ	m ɑ h t͡ʃ ɑ k ɑ l
մահմեդական	m ɑ h m ɛ d ɑ k ɑ n
մահմեդականություն	m ɑ h m ɛ d ɑ k ɑ n u tʰ j u n
մաղ	m ɑ ʁ
մաղադանոս	m ɑ ʁ ɑ d ɑ n ɔ s
մաղթանք	m ɑ χ tʰ ɑ ŋ kʰ
մաճառ	m ɑ t͡ʃ ɑ r
մաճար	m ɑ t͡ʃ ɑ ɾ
մամ	m ɑ m
մամա	m ɑ m ɑ
մամբո	m ɑ m b ɔ
մամիկ	m ɑ m i k
մամլյուք	m ɑ m l j u kʰ
մամուլ	m ɑ m u l
մամուլի	m ɑ m u l i
մայել	m ɑ j ɛ l
մայիս	m ɑ j i s
մայիսյան	m ɑ j i s j ɑ n
մայլա	m ɑ j l ɑ
մայկա	m ɑ j k ɑ
մայկոպ	m ɑ j k ɔ p
մայոնեզ	m ɑ j ɔ n ɛ z
մայր	m ɑ j ɾ
մայրական	m ɑ j ɾ ɑ k ɑ n
մայրամուտ	m ɑ j ɾ ɑ m u t
մայրապետ	m ɑ j ɾ ɑ p ɛ t
մայրապետյան	m ɑ j ɾ ɑ p ɛ t j ɑ n
մայրասպան	m ɑ j ɾ ɑ s p ɑ n
մայրենի	m ɑ j ɾ ɛ n i
մայրի	m ɑ j ɾ i
մայրիկ	m ɑ j ɾ i k
մայրուղի	m ɑ j ɾ u ʁ i
մանագուա	m ɑ n ɑ ɡ u ɑ
մանաթ	m ɑ n ɑ tʰ
մանանա	m ɑ n ɑ n ɑ
մանանդյան	m ɑ n ɑ n d j ɑ n
մանանեխ	m ɑ n ɑ n ɛ χ
մանգաղ	m ɑ ŋ ɡ ɑ ʁ
մանգո	m ɑ ŋ ɡ ɔ
մանդակունի	m ɑ n d ɑ k u n i
մանե	m ɑ n ɛ
մանեթ	m ɑ n ɛ tʰ
մանթապուր	m ɑ n tʰ ɑ p u ɾ
մանիպուր	m ɑ n i p u ɾ
մանկապարտեզ	m ɑ ŋ k ɑ p ɑ ɾ t ɛ z
մանկապիղծ	m ɑ ŋ k ɑ p i χ t͡s
մանկասայլակ	m ɑ ŋ k ɑ s ɑ j l ɑ k
մանկասար	m ɑ ŋ k ɑ s ɑ ɾ
մանկություն	m ɑ ŋ k u tʰ j u n
մանկտի	m ɑ ŋ k t i
մանյակ	m ɑ n j ɑ k
մանուկյան	m ɑ n u k j ɑ n
մանուշակագույն	m ɑ n u ʃ ɑ k ɑ ɡ u j n
մանչեստր	m ɑ n t͡ʃʰ ɛ s t ə ɾ
մանջուրիա	m ɑ n d͡ʒ u ɾ j ɑ
մանսարդ	m ɑ n s ɑ ɾ d
մանվածապատ	m ɑ n v ɑ t͡s ɑ p ɑ t
մանվածապատություն	m ɑ n v ɑ t͡s ɑ p ɑ t u tʰ j u n
մանվածք	m ɑ n v ɑ t͡s kʰ
մանվածքային	m ɑ n v ɑ t͡s kʰ ɑ j i n
մանվել	m ɑ n v ɛ l
մանր	m ɑ n ə ɾ
մանրագոր	m ɑ n ɾ ɑ ɡ ɔ ɾ
մանրամասն	m ɑ n ɾ ɑ m ɑ s ə n
մանրէ	m ɑ n ɾ ɛ
մանրէաբան	m ɑ n ɾ ɛ j ɑ b ɑ n
մաշիկ	m ɑ ʃ i k
մաշկ	m ɑ ʃ k
մառախուղ	m ɑ r ɑ χ u ʁ
մառան	m ɑ r ɑ n
մաս	m ɑ s
մասերու	m ɑ s ɛ ɾ u
մասիս	m ɑ s i s
մասնագիտություն	m ɑ s n ɑ ɡ i t u tʰ j u n
մասնակից	m ɑ s n ɑ k i t͡sʰ
մասնակցել	m ɑ s n ɑ k t͡sʰ ɛ l
մասնաճյուղ	m ɑ s n ɑ t͡ʃ j u ʁ
մասնաշենք	m ɑ s n ɑ ʃ ɛ ŋ kʰ
մասնավոր	m ɑ s n ɑ v ɔ ɾ
մասնավորեցում	m ɑ s n ɑ v ɔ ɾ ɛ t͡sʰ u m
մասնիկ	m ɑ s n i k
մասոն	m ɑ s ɔ n
մասուր	m ɑ s u ɾ
մաստակ	m ɑ s t ɑ k
մավի	m ɑ v i
մատ	m ɑ t
մատակ	m ɑ t ɑ k
մատակարար	m ɑ t ɑ k ɑ ɾ ɑ ɾ
մատաղ	m ɑ t ɑ ʁ
մատանի	m ɑ t ɑ n i
մատենագիտություն	m ɑ t ɛ n ɑ ɡ i t u tʰ j u n
մատենագիր	m ɑ t ɛ n ɑ ɡ i ɾ
մատթեոս	m ɑ tʰː ɛ ɔ s
մատիտ	m ɑ t i t
մատղաշ	m ɑ t ʁ ɑ ʃ
մատյան	m ɑ t j ɑ n
մատնահետք	m ɑ t n ɑ h ɛ t kʰ
մատնանշել	m ɑ t n ɑ n ə ʃ ɛ l
մատնել	m ɑ t n ɛ l
մատնություն	m ɑ t n u tʰ j u n
մատուռ	m ɑ t u r
մատուցել	m ɑ t u t͡sʰ ɛ l
մատուցող	m ɑ t u t͡sʰ ɔ ʁ
մատուցողուհի	m ɑ t u t͡sʰ ɔ ʁ u h i
մար	m ɑ ɾ
մարաթոն	m ɑ ɾ ɑ tʰ ɔ n
մարախ	m ɑ ɾ ɑ χ
մարաստան	m ɑ ɾ ɑ s t ɑ n
մարատ	m ɑ ɾ ɑ t
մարգագետին	m ɑ ɾ ɡ ɑ ɡ ɛ t i n
մարգար	m ɑ ɾ kʰ ɑ ɾ
մարգարե	m ɑ ɾ kʰ ɑ ɾ ɛ
մարգարեություն	m ɑ ɾ kʰ ɑ ɾ ɛ j u tʰ j u n
մարգարին	m ɑ ɾ ɡ ɑ ɾ i n
մարգարիտ	m ɑ ɾ kʰ ɑ ɾ i t
մարգարյան	m ɑ ɾ kʰ ɑ ɾ j ɑ n
մարգարյանց	m ɑ ɾ kʰ ɑ ɾ j ɑ n t͡sʰ
մարդ	m ɑ ɾ tʰ
մարդաբան	m ɑ ɾ tʰ ɑ b ɑ n
մարդաբանություն	m ɑ ɾ tʰ ɑ b ɑ n u tʰ j u n
մարդահամար	m ɑ ɾ tʰ ɑ h ɑ m ɑ ɾ
մարդաշատ	m ɑ ɾ tʰ ɑ ʃ ɑ t
մարդասիրական	m ɑ ɾ tʰ ɑ s i ɾ ɑ k ɑ n
մարդասպան	m ɑ ɾ d ɑ s p ɑ n
մարդասպաններ	m ɑ ɾ tʰ ɑ s p ɑ nː ɛ ɾ
մարդիկ	m ɑ ɾ tʰ i k
մարդկություն	m ɑ ɾ tʰ k u tʰ j u n
մարզ	m ɑ ɾ z
մարզադաշտ	m ɑ ɾ z ɑ d ɑ ʃ t
մարզասարք	m ɑ ɾ z ɑ s ɑ ɾ kʰ
մարզասրահ	m ɑ ɾ z ɑ s ə ɾ ɑ h
մարզիկ	m ɑ ɾ z i k
մարզիչ	m ɑ ɾ z i t͡ʃʰ
մարի	m ɑ ɾ i
մարիամ	m ɑ ɾ j ɑ m
մարկ	m ɑ ɾ k
մարկիզ	m ɑ ɾ k i z
մարմար	m ɑ ɾ m ɑ ɾ
մարմին	m ɑ ɾ m i n
մարմնական	m ɑ ɾ m n ɑ k ɑ n
մարշրուտնի	m ɑ ɾ ʃ ɾ u t n i
մարոկկո	m ɑ ɾ ɔ kː ɔ
մարուքյան	m ɑ ɾ u kʰ j ɑ n
մարջան	m ɑ ɾ d͡ʒ ɑ n
մարս	m ɑ ɾ s
մարտ	m ɑ ɾ t
մարտական	m ɑ ɾ t ɑ k ɑ n
մարտակոչ	m ɑ ɾ t ɑ k ɔ t͡ʃʰ
մարտահրավեր	m ɑ ɾ t ɑ h ə ɾ ɑ v ɛ ɾ
մարտավարություն	m ɑ ɾ t ɑ v ɑ ɾ u tʰ j u n
մարտիկ	m ɑ ɾ t i k
մարտին	m ɑ ɾ t i n
մարտիրոս	m ɑ ɾ t i ɾ ɔ s
մարտիրոսյան	m ɑ ɾ t i ɾ ɔ s j ɑ n
մարտյան	m ɑ ɾ t j ɑ n
մարտնչել	m ɑ ɾ t ə n t͡ʃʰ ɛ l
մարքիզ	m ɑ ɾ kʰ i z
մարքս	m ɑ ɾ kʰ s
մաքառել	m ɑ kʰ ɑ r ɛ l
մաքառում	m ɑ kʰ ɑ r u m
մաքի	m ɑ kʰ i
մաքուր	m ɑ kʰ u ɾ
մաքոք	m ɑ kʰ ɔ kʰ
մաքս	m ɑ kʰ s
մաքսատուն	m ɑ kʰ s ɑ t u n
մաքսատուրք	m ɑ kʰ s ɑ t u ɾ kʰ
մաքրել	m ɑ kʰ ɾ ɛ l
մաքրում	m ɑ kʰ ɾ u m
մգեցում	m ə kʰ ɛ t͡sʰ u m
մգլահոտ	m ə ɡ l ɑ h ɔ t
մեգ	m ɛ ɡ
մեդալ	m ɛ d ɑ l
մեզ	m ɛ z
մեզար	m ɛ z ɑ ɾ
մեթոդ	m ɛ tʰ ɔ d
մելիտենե	m ɛ l i t ɛ n ɛ
մելիք	m ɛ l i kʰ
մելիքյան	m ɛ l i kʰ j ɑ n
մեխ	m ɛ χ
մեխանիզմ	m ɛ χ ɑ n i z m
մեխիկո	m ɛ χ i k ɔ
մեծ	m ɛ t͡s
մեծաբան	m ɛ t͡s ɑ b ɑ n
մեծաբանել	m ɛ t͡s ɑ b ɑ n ɛ l
մեծագույն	m ɛ t͡s ɑ ɡ u j n
մեծահանդես	m ɛ t͡s ɑ h ɑ n d ɛ s
մեծահասակ	m ɛ t͡s ɑ h ɑ s ɑ k
մեծամոր	m ɛ t͡s ɑ m ɔ ɾ
մեծամտություն	m ɛ t͡s ɑ m ə t u tʰ j u n
մեծանալ	m ɛ t͡s ɑ n ɑ l
մեծանուն	m ɛ t͡s ɑ n u n
մեծաշեն	m ɛ t͡s ɑ ʃ ɛ n
մեծաշուք	m ɛ t͡s ɑ ʃ u kʰ
մեծապես	m ɛ t͡s ɑ p ɛ s
մեծավոր	m ɛ t͡s ɑ v ɔ ɾ
մեծատուն	m ɛ t͡s ɑ t u n
մեծարանք	m ɛ t͡s ɑ ɾ ɑ ŋ kʰ
մեծարգո	m ɛ t͡s ɑ ɾ ɡ ɔ
մեծարել	m ɛ t͡s ɑ ɾ ɛ l
մեծություն	m ɛ t͡s u tʰ j u n
մեկ	m ɛ k
մեկին	m ɛ k i n
մեկնարկել	m ɛ k n ɑ ɾ k ɛ l
մեղանչել	m ɛ ʁ ɑ n t͡ʃʰ ɛ l
մեղավոր	m ɛ ʁ ɑ v ɔ ɾ
մեղավորություն	m ɛ ʁ ɑ v ɔ ɾ u tʰ j u n
մեղեդի	m ɛ ʁ ɛ d i
մեղեխ	m ɛ ʁ ɛ χ
մեղկ	m ɛ χ k
մեղմ	m ɛ ʁ m
մեղմեխ	m ɛ ʁ m ɛ χ
մեղու	m ɛ ʁ u
մեղր	m ɛ ʁ ə ɾ
մեղրագինի	m ɛ ʁ ɾ ɑ ɡ i n i
մեղրամոմ	m ɛ ʁ ɾ ɑ m ɔ m
մեղք	m ɛ χ kʰ
մեղքեր	m ɛ χ kʰ ɛ ɾ
մեմնոն	m ɛ m n ɔ n
մեյդան	m ɛ j d ɑ n
մեյմուն	m ɛ j m u n
մեն	m ɛ n
մենակ	m ɛ n ɑ k
մենակատար	m ɛ n ɑ k ɑ t ɑ ɾ
մենաշնորհ	m ɛ n ɑ ʃ ə n ɔ ɾ
մենուա	m ɛ n u ɑ
մենք	m ɛ ŋ kʰ
մեշոկ	m ɛ ʃ ɔ k
մեջ	m ɛ t͡ʃʰ
մեջտեղ	m ɛ t͡ʃʰ t ɛ ʁ
մեռած	m ɛ r ɑ t͡s
մեռել	m ɛ r ɛ l
մեռյալ	m ɛ r j ɑ l
մեռնել	m ɛ r n ɛ l
մեսրոպ	m ɛ s ɾ ɔ p
մետաղ	m ɛ t ɑ ʁ
մետաքս	m ɛ t ɑ kʰ s
մետաքսե	m ɛ t ɑ kʰ s ɛ
մետաքսյա	m ɛ t ɑ kʰ s j ɑ
մետր	m ɛ t ə ɾ
մետրո	m ɛ t ɾ ɔ
մետրոպոլիտեն	m ɛ t ɾ ɔ p ɔ l i t ɛ n
մեր	m ɛ ɾ
մերժել	m ɛ ɾ ʒ ɛ l
մերժում	m ɛ ɾ ʒ u m
մերի	m ɛ ɾ i
մերկ	m ɛ ɾ k
մերկանալ	m ɛ ɾ k ɑ n ɑ l
մերկապար	m ɛ ɾ k ɑ p ɑ ɾ
մերկասառույց	m ɛ ɾ k ɑ s ɑ r u j t͡sʰ
մերկություն	m ɛ ɾ k u tʰ j u n
մերկուրի	m ɛ ɾ k u ɾ i
մերձ	m ɛ ɾ d͡z
մերձավոր	m ɛ ɾ d͡z ɑ v ɔ ɾ
մերձենալ	m ɛ ɾ d͡z ɛ n ɑ l
մերուժան	m ɛ ɾ u ʒ ɑ n
մերսել	m ɛ ɾ s ɛ l
մերսի	m ɛ ɾ s i
մերսում	m ɛ ɾ s u m
մերվ	m ɛ ɾ v
մերօրյա	m ɛ ɾ ɔ ɾ j ɑ
մեքենա	m ɛ kʰ ɛ n ɑ
մեքսիկա	m ɛ kʰ s i k ɑ
մեքսիկացի	m ɛ kʰ s i k ɑ t͡sʰ i
մեքքա	m ɛ kʰː ɑ
մզկիթ	m ə z k i tʰ
մը	m ə
մթամ	m ə tʰ ɑ m
մթար	m ə tʰ ɑ ɾ
մթերք	m ə tʰ ɛ ɾ kʰ
մթնշաղ	m ə tʰ ə n ʃ ɑ ʁ
մթնոլորտ	m ə tʰ n ɔ l ɔ ɾ t
մթոմ	m ə tʰ ɔ m
մի	m i
միաժամանակ	m i j ɑ ʒ ɑ m ɑ n ɑ k
միակ	m i j ɑ k
միամիտ	m i j ɑ m i t
միամտություն	m i j ɑ m ə t u tʰ j u n
միայն	m i j ɑ j n
միայնակ	m i j ɑ j n ɑ k
միանալ	m i j ɑ n ɑ l
միանձնուհի	m i j ɑ n d͡z n u h i
միասեռական	m i j ɑ s ɛ r ɑ k ɑ n
միասին	m j ɑ s i n
միասնաբար	m j ɑ s n ɑ b ɑ ɾ
միասնականություն	m j ɑ s n ɑ k ɑ n u tʰ j u n
միավորված	m i j ɑ v ɔ ɾ v ɑ t͡s
միավորվել	m i j ɑ v ɔ ɾ v ɛ l
միատեղ	m i j ɑ t ɛ ʁ
միատոն	m i j ɑ t ɔ n
միացյալ	m i j ɑ t͡sʰ j ɑ l
միացում	m i j ɑ t͡sʰ u m
միգուցե	m i ɡ u t͡sʰ ɛ
միզապարկ	m i z ɑ p ɑ ɾ k
միզորամ	m i z ɔ ɾ ɑ m
միթամ	m i tʰ ɑ m
միթե	m i tʰ ɛ
միլան	m i l ɑ n
միլանցի	m i l ɑ n t͡sʰ i
միլիառ	m i l j ɑ r
միլիարդ	m i l j ɑ ɾ d
միլիարդատեր	m i l j ɑ ɾ tʰ ɑ t ɛ ɾ
միլիոն	m i l j ɔ n
միլիոնատեր	m i l j ɔ n ɑ t ɛ ɾ
միլիցա	m i l i t͡sʰ ɑ
միլիցիա	m i l i t͡sʰ j ɑ
միլիցիոներ	m i l i t͡sʰ j ɔ n ɛ ɾ
միկոյան	m i k ɔ j ɑ n
միկրոալիքային	m i k ɾ ɔ ɑ l i kʰ ɑ j i n
միկրոբ	m i k ɾ ɔ b
միկրոօրգանիզմ	m i k ɾ ɔ ɔ ɾ ɡ ɑ n i z m
միկրոֆոն	m i k ɾ ɔ f ɔ n
միհրան	m i h ɾ ɑ n
միհրանյան	m i h ɾ ɑ n j ɑ n
միմյանց	m i m j ɑ n t͡sʰ
միմներմոս	m i m n ɛ ɾ m ɔ s
մինասյան	m i n ɑ s j ɑ n
մինետ	m i n ɛ t
մինչդեռ	m i n t͡ʃʰ d ɛ r
մինսկ	m i n s k
միշտ	m i ʃ t
միության	m i u tʰ j ɑ n
միություն	m i u tʰ j u n
միջագետք	m i t͡ʃʰ ɑ ɡ ɛ t kʰ
միջադիր	m i t͡ʃʰ ɑ d i ɾ
միջազգային	m i t͡ʃʰ ɑ z ɡ ɑ j i n
միջակետ	m i t͡ʃʰ ɑ k ɛ t
միջամտել	m i t͡ʃʰ ɑ m ə t ɛ l
միջանցք	m i t͡ʃʰ ɑ n t͡sʰ kʰ
միջատ	m i t͡ʃʰ ɑ t
միջատաբանական	m i t͡ʃʰ ɑ t ɑ b ɑ n ɑ k ɑ n
միջատասպան	m i t͡ʃʰ ɑ t ɑ s p ɑ n
միջերկրական	m i t͡ʃʰ ɛ ɾ k ɾ ɑ k ɑ n
միջեւ	m i t͡ʃʰ ɛ v
միջինասիական	m i t͡ʃʰ i n ɑ s j ɑ k ɑ n
միջնաբերդ	m i t͡ʃʰ n ɑ b ɛ ɾ tʰ
միջնադար	m i t͡ʃʰ n ɑ d ɑ ɾ
միջնադարագետ	m i t͡ʃʰ n ɑ d ɑ ɾ ɑ ɡ ɛ t
միջնադարյան	m i t͡ʃʰ n ɑ d ɑ ɾ j ɑ n
միջով	m i t͡ʃʰ ɔ v
միջոց	m i t͡ʃʰ ɔ t͡sʰ
միջոցառում	m i t͡ʃʰ ɔ t͡sʰ ɑ r u m
միջուկ	m i t͡ʃʰ u k
միս	m i s
միստերիա	m i s t ɛ ɾ j ɑ
միտ	m i t
միտաննի	m i t ɑ nː i
միտում	m i t u m
միտք	m i t kʰ
միտքը	m i t kʰ ə
միրգ	m i ɾ kʰ
միրուք	m i ɾ u kʰ
միքայել	m i kʰ ɑ j ɛ l
մխիթար	m ə χ i tʰ ɑ ɾ
մխիթարել	m ə χ i tʰ ɑ ɾ ɛ l
մխիթարյան	m ə χ i tʰ ɑ ɾ j ɑ n
մխոց	m ə χ ɔ t͡sʰ
մխրճում	m ə χ ə ɾ t͡ʃ u m
մկան	m ə k ɑ n
մկնիկ	m ə k n i k
մկրտել	m ə k ə ɾ t ɛ l
մկրտիչ	m ə k ə ɾ t i t͡ʃʰ
մկրտություն	m ə k ə ɾ t u tʰ j u n
մկրտում	m ə k ə ɾ t u m
մկրտումյան	m ə k ə ɾ t u m j ɑ n
մհա	m ə h ə ɑ
մհեր	m ə h ɛ ɾ
մղել	m ə ʁ ɛ l
մղեղ	m ə ʁ ɛ ʁ
մղձավանջ	m ə ʁ d͡z ɑ v ɑ n d͡ʒ
մղմուղ	m ə ʁ m u ʁ
մղոն	m ə ʁ ɔ n
մյունխեն	m j u n χ ɛ n
մյուս	m j u s
մյուսլի	m j u s l i
մնալ	m ə n ɑ l
մնացական	m ə n ɑ t͡sʰ ɑ k ɑ n
մնացյալ	m ə n ɑ t͡sʰ j ɑ l
մնացորդ	m ə n ɑ t͡sʰ ɔ ɾ tʰ
մնաք	m ə n ɑ kʰ
մնջկատակ	m ə n d͡ʒ k ɑ t ɑ k
մշակ	m ə ʃ ɑ k
մշակել	m ə ʃ ɑ k ɛ l
մշակութային	m ə ʃ ɑ k u tʰ ɑ j i n
մշակույթ	m ə ʃ ɑ k u j tʰ
մշուշ	m ə ʃ u ʃ
մշուշապատ	m ə ʃ u ʃ ɑ p ɑ t
մշտապես	m ə ʃ t ɑ p ɛ s
մոգ	m ɔ ɡ
մոգոնել	m ɔ ɡ ɔ n ɛ l
մոգություն	m ɔ ɡ u tʰ j u n
մոդա	m ɔ d ɑ
մոդել	m ɔ d ɛ l
մոդեմ	m ɔ d ɛ m
մոդուլ	m ɔ d u l
մոզ	m ɔ z
մոլախաղ	m ɔ l ɑ χ ɑ ʁ
մոլդավական	m ɔ l d ɑ v ɑ k ɑ n
մոլդովա	m ɔ l d ɔ v ɑ
մոլդովական	m ɔ l d ɔ v ɑ k ɑ n
մոլեգնել	m ɔ l ɛ ɡ n ɛ l
մոլեկուլ	m ɔ l ɛ k u l
մոլեկուլային	m ɔ l ɛ k u l ɑ j i n
մոլիբդեն	m ɔ l i b d ɛ n
մոլորակ	m ɔ l ɔ ɾ ɑ k
մոլորել	m ɔ l ɔ ɾ ɛ l
մոլորեցնել	m ɔ l ɔ ɾ ɛ t͡sʰ n ɛ l
մոլորվել	m ɔ l ɔ ɾ v ɛ l
մոլուցք	m ɔ l u t͡sʰ kʰ
մոխրագույն	m ɔ χ ɾ ɑ ɡ u j n
մոնակո	m ɔ n ɑ k ɔ
մոնիտոր	m ɔ n i t ɔ ɾ
մոնղոլ	m ɔ n ʁ ɔ l
մոնղոլիա	m ɔ n ʁ ɔ l j ɑ
մոնպելիե	m ɔ n p ɛ l j ɛ
մոնտենեգրո	m ɔ n t ɛ n ɛ ɡ ɾ ɔ
մոշ	m ɔ ʃ
մոշենի	m ɔ ʃ ɛ n i
մոշի	m ɔ ʃ i
մոռ	m ɔ r
մոռանալ	m ɔ r ɑ n ɑ l
մոսուլ	m ɔ s u l
մովսես	m ɔ f s ɛ s
մովսեսյան	m ɔ f s ɛ s j ɑ n
մովսիսյան	m ɔ f s i s j ɑ n
մոտ	m ɔ t
մոտալուտ	m ɔ t ɑ l u t
մոտակա	m ɔ t ɑ k ɑ
մոտակայք	m ɔ t ɑ k ɑ j kʰ
մոտավոր	m ɔ t ɑ v ɔ ɾ
մոտավորություն	m ɔ t ɑ v ɔ ɾ u tʰ j u n
մոտենալ	m ɔ t ɛ n ɑ l
մոտեցնել	m ɔ t ɛ t͡sʰ n ɛ l
մոտիկ	m ɔ t i k
մոտիկություն	m ɔ t i k u tʰ j u n
մոտիվ	m ɔ t i v
մոտիվացիա	m ɔ t i v ɑ t͡sʰ j ɑ
մոտոցիկլ	m ɔ t ɔ t͡sʰ i k ə l
մոտոցիկլետ	m ɔ t ɔ t͡sʰ i k l ɛ t
մոր	m ɔ ɾ
մորաքույր	m ɔ ɾ ɑ kʰ u j ɾ
մորենի	m ɔ ɾ ɛ n i
մորթ	m ɔ ɾ tʰ
մորթել	m ɔ ɾ tʰ ɛ l
մորթի	m ɔ ɾ tʰ i
մորի	m ɔ ɾ i
մորմոք	m ɔ ɾ m ɔ kʰ
մորու	m ɔ ɾ u
մորուք	m ɔ ɾ u kʰ
մորքուր	m ɔ ɾ kʰ u ɾ
մուգ	m u kʰ
մուղամ	m u ʁ ɑ m
մուղտ	m u χ t
մումբայ	m u m b ɑ j
մուն	m u n
մունդառ	m u n d ɑ r
մունջ	m u n d͡ʒ
մուշեղ	m u ʃ ɛ ʁ
մուշտակ	m u ʃ t ɑ k
մուսուլման	m u s u l m ɑ n
մուտք	m u t kʰ
մուր	m u ɾ
մուրադ	m u ɾ ɑ d
մուրադյան	m u ɾ ɑ d j ɑ n
մուրալ	m u ɾ ɑ l
մուրացիկ	m u ɾ ɑ t͡sʰ i k
մուրացկան	m u ɾ ɑ t͡sʰ k ɑ n
մուրհակ	m u ɾ h ɑ k
մուրճ	m u ɾ t͡ʃ
մուրուք	m u ɾ u kʰ
մուրց	m u ɾ t͡sʰ
մռայլ	m ə r ɑ j l
մսագործ	m ə s ɑ ɡ ɔ ɾ t͡s
մսալի	m ə s ɑ l i
մսակեր	m ə s ɑ k ɛ ɾ
մսեղեն	m ə s ɛ ʁ ɛ n
մսոտ	m ə s ɔ t
մտաբերել	m ə t ɑ b ɛ ɾ ɛ l
մտադիր	m ə t ɑ d i ɾ
մտադրություն	m ə t ɑ d ɾ u tʰ j u n
մտադրվել	m ə t ɑ d ə ɾ v ɛ l
մտածել	m ə t ɑ t͡s ɛ l
մտածելակերպ	m ə t ɑ t͡s ɛ l ɑ k ɛ ɾ p
մտահաղացում	m ə t ɑ h ɑ ʁ ɑ t͡sʰ u m
մտահղացում	m ə t ɑ h ʁ ɑ t͡sʰ u m
մտահոգ	m ə t ɑ h ɔ ɡ
մտահոգել	m ə t ɑ h ɔ kʰ ɛ l
մտահոգիչ	m ə t ɑ h ɔ kʰ i t͡ʃʰ
մտահոգություն	m ə t ɑ h ɔ kʰ u tʰ j u n
մտահոգվածություն	m ə t ɑ h ɔ kʰ v ɑ t͡s u tʰ j u n
մտահոգվել	m ə t ɑ h ɔ kʰ v ɛ l
մտառու	m ə t ɑ r u
մտավոր	m ə t ɑ v ɔ ɾ
մտավորականություն	m ə t ɑ v ɔ ɾ ɑ k ɑ n u tʰ j u n
մտիկ	m ə t i k
մտնել	m ə t n ɛ l
մտովի	m ə t ɔ v i
մտորել	m ə t ɔ ɾ ɛ l
մտրակ	m ə t ɾ ɑ k
մտցնել	m ə t t͡sʰ n ɛ l
մրմնջալ	m ɾ m ə n d͡ʒ ɑ l
մրմունջ	m ə ɾ m u n d͡ʒ
մրջյուն	m ə ɾ t͡ʃʰ j u n
մրսածություն	m ə ɾ s ɑ t͡s u tʰ j u n
մրրիկ	m ə ɾː i k
մրրկել	m ə ɾː k ɛ l
մրցակցություն	m ə ɾ t͡sʰ ɑ k t͡sʰ u tʰ j u n
մրցավազք	m ə ɾ t͡sʰ ɑ v ɑ s kʰ
մրցավար	m ə ɾ t͡sʰ ɑ v ɑ ɾ
մրցել	m ə ɾ t͡sʰ ɛ l
մրցորդ	m ə ɾ t͡sʰ ɔ ɾ tʰ
մրցում	m ə ɾ t͡sʰ u m
մցխեթա	m ə t͡sʰ χ ɛ tʰ ɑ
յալթա	j ɑ l tʰ ɑ
յաղութ	j ɑ ʁ u tʰ
յաշ	j ɑ ʃ
յասախ	j ɑ s ɑ χ
յասաման	j ɑ s ɑ m ɑ n
յեն	j ɛ n
յոգ	j ɔ ɡ
յոգա	j ɔ ɡ ɑ
յոդ	j ɔ d
յոթ	j ɔ tʰ
յոթանասուն	j ɔ tʰ ɑ n ɑ s u n
յոթներյակ	j ɔ tʰ n ɛ ɾ j ɑ k
յոթներորդ	j ɔ tʰ n ɛ ɾ ɔ ɾ tʰ
յորուբա	j ɔ ɾ u b ɑ
յուան	j u ɑ n
յուլյա	j u l j ɑ
յուղ	j u ʁ
յուպիտեր	j u p i t ɛ ɾ
յուր	j u ɾ
յուրահատուկ	j u ɾ ɑ h ɑ t u k
յուրային	j u ɾ ɑ j i n
յուրաքանչյուր	j u ɾ ɑ kʰ ɑ n t͡ʃʰ j u ɾ
յուրովի	j u ɾ ɔ v i
յուրովսանն	j u ɾ ɔ f s ɑ nː
յուրօրինակ	j u ɾ ɔ ɾ i n ɑ k
նա	n ɑ
նաբուքոդոնոսոր	n ɑ b u kʰ ɔ d ɔ n ɔ s ɔ ɾ
նադիր	n ɑ d i ɾ
նաեւ	n ɑ j ɛ v
նազանի	n ɑ z ɑ n i
նազար	n ɑ z ɑ ɾ
նազարեթ	n ɑ z ɑ ɾ ɛ tʰ
նազարյան	n ɑ z ɑ ɾ j ɑ n
նալբանդ	n ɑ l b ɑ n d
նախ	n ɑ χ
նախագա	n ɑ χ ɑ ɡ ɑ
նախագահական	n ɑ χ ɑ ɡ ɑ h ɑ k ɑ n
նախագահություն	n ɑ χ ɑ ɡ ɑ h u tʰ j u n
նախագծել	n ɑ χ ɑ ɡ ə t͡s ɛ l
նախագծող	n ɑ χ ɑ ɡ ə t͡s ɔ ʁ
նախադասություն	n ɑ χ ɑ d ɑ s u tʰ j u n
նախազգուշացում	n ɑ χ ɑ z ɡ u ʃ ɑ t͡sʰ u m
նախախնամություն	n ɑ χ ɑ χ ə n ɑ m u tʰ j u n
նախահայր	n ɑ χ ɑ h ɑ j ɾ
նախաճաշ	n ɑ χ ɑ t͡ʃ ɑ ʃ
նախաճաշել	n ɑ χ ɑ t͡ʃ ɑ ʃ ɛ l
նախանձել	n ɑ χ ɑ n d͡z ɛ l
նախանձկոտ	n ɑ χ ɑ n d͡z k ɔ t
նախանձոտ	n ɑ χ ɑ n d͡z ɔ t
նախապայման	n ɑ χ ɑ p ɑ j m ɑ n
նախապես	n ɑ χ ɑ p ɛ s
նախատանք	n ɑ χ ɑ t ɑ ŋ kʰ
նախատել	n ɑ χ ɑ t ɛ l
նախատեսել	n ɑ χ ɑ t ɛ s ɛ l
նախատեսում	n ɑ χ ɑ t ɛ s u m
նախատեսվել	n ɑ χ ɑ t ɛ s v ɛ l
նախատինք	n ɑ χ ɑ t i ŋ kʰ
նախարար	n ɑ χ ɑ ɾ ɑ ɾ
նախարարություն	n ɑ χ ɑ ɾ ɑ ɾ u tʰ j u n
նախընտրել	n ɑ χ ə n t ɾ ɛ l
նախիջեւան	n ɑ χ i t͡ʃʰ ɛ v ɑ n
նախկին	n ɑ χ k i n
նախճիր	n ɑ χ t͡ʃ i ɾ
նախնի	n ɑ χ n i
նախորդ	n ɑ χ ɔ ɾ tʰ
նախուտեստ	n ɑ χ u t ɛ s t
նահանգ	n ɑ h ɑ ŋ ɡ
նահանգապետ	n ɑ h ɑ ŋ ɡ ɑ p ɛ t
նահապետ	n ɑ h ɑ p ɛ t
նահապետյան	n ɑ h ɑ p ɛ t j ɑ n
նահատակ	n ɑ h ɑ t ɑ k
նամ	n ɑ m
նամակ	n ɑ m ɑ k
նամականի	n ɑ m ɑ k ɑ n i
նամականիշ	n ɑ m ɑ k ɑ n i ʃ
նամանավանդ	n ɑ m ɑ n ɑ v ɑ n d
նամուս	n ɑ m u s
նայած	n ɑ j ɑ t͡s
նայել	n ɑ j ɛ l
նայվածք	n ɑ j v ɑ t͡s kʰ
նան	n ɑ n
նանա	n ɑ n ɑ
նանի	n ɑ n i
նաուրու	n ɑ u ɾ u
նապաստակ	n ɑ p ɑ s t ɑ k
նաջարյան	n ɑ d͡ʒ ɑ ɾ j ɑ n
նավազ	n ɑ v ɑ z
նավակ	n ɑ v ɑ k
նավակատիք	n ɑ v ɑ k ɑ t i kʰ
նավահանգիստ	n ɑ v ɑ h ɑ ŋ ɡ i s t
նավապետ	n ɑ v ɑ p ɛ t
նավաստի	n ɑ v ɑ s t i
նավատորմիղ	n ɑ v ɑ t ɔ ɾ m i ʁ
նավթ	n ɑ f tʰ
նատօ	n ɑ t ɔ
նարգիզ	n ɑ ɾ ɡ i z
նարդի	n ɑ ɾ d i
նարե	n ɑ ɾ ɛ
նարինջ	n ɑ ɾ i n d͡ʒ
նարնջագույն	n ɑ ɾ ə n d͡ʒ ɑ ɡ u j n
նարտ	n ɑ ɾ t
նացիստ	n ɑ t͡sʰ i s t
նացիստական	n ɑ t͡sʰ i s t ɑ k ɑ n
նեգատիվ	n ɛ ɡ ɑ t i v
նեգր	n ɛ ɡ ə ɾ
նեգրի	n ɛ ɡ ɾ i
նեխած	n ɛ χ ɑ t͡s
նեխել	n ɛ χ ɛ l
նեղանալ	n ɛ ʁ ɑ n ɑ l
նեղոս	n ɛ ʁ ɔ s
նեղություն	n ɛ ʁ u tʰ j u n
նեյտրալ	n ɛ j t ɾ ɑ l
նեյտրոնային	n ɛ j t ɾ ɔ n ɑ j i n
նենգաբար	n ɛ ŋ ɡ ɑ b ɑ ɾ
նենգավոր	n ɛ ŋ ɡ ɑ v ɔ ɾ
նեոդիմ	n ɛ ɔ d i m
նեպալի	n ɛ p ɑ l i
նեպտուն	n ɛ p t u n
նեստորական	n ɛ s t ɔ ɾ ɑ k ɑ n
նետ	n ɛ t
նետաձիգ	n ɛ t ɑ d͡z i kʰ
նետել	n ɛ t ɛ l
ներ	n ɛ ɾ
ներարկիչ	n ɛ ɾ ɑ ɾ k i t͡ʃʰ
ներբան	n ɛ ɾ b ɑ n
ներբեռնել	n ɛ ɾ b ɛ r n ɛ l
ներբեռնում	n ɛ ɾ b ɛ r n u m
ներբող	n ɛ ɾ pʰ ɔ ʁ
ներգաղթ	n ɛ ɾ ɡ ɑ χ tʰ
ներգաղթել	n ɛ ɾ ɡ ɑ χ tʰ ɛ l
ներգաղթյալ	n ɛ ɾ ɡ ɑ χ tʰ j ɑ l
ներգործական	n ɛ ɾ ɡ ɔ ɾ t͡s ɑ k ɑ n
ներդաշնակ	n ɛ ɾ d ɑ ʃ n ɑ k
ներդաշնակություն	n ɛ ɾ d ɑ ʃ n ɑ k u tʰ j u n
ներդնել	n ɛ ɾ d ə n ɛ l
ներդրում	n ɛ ɾ d ə ɾ u m
ներել	n ɛ ɾ ɛ l
ներեղություն	n ɛ ɾ ɛ ʁ u tʰ j u n
ներխուժել	n ɛ ɾ χ u ʒ ɛ l
ներխուժում	n ɛ ɾ χ u ʒ u m
ներկա	n ɛ ɾ k ɑ
ներկայացնել	n ɛ ɾ k ɑ j ɑ t͡sʰ n ɛ l
ներկայացում	n ɛ ɾ k ɑ j ɑ t͡sʰ u m
ներկայացուցիչ	n ɛ ɾ k ɑ j ɑ t͡sʰ u t͡sʰ i t͡ʃʰ
ներկայացուցչություն	n ɛ ɾ k ɑ j ɑ t͡sʰ u t͡sʰ t͡ʃʰ u tʰ j u n
ներկապնակ	n ɛ ɾ k ɑ p ə n ɑ k
ներկել	n ɛ ɾ k ɛ l
ներողություն	n ɛ ɾ ɔ ʁ u tʰ j u n
ներում	n ɛ ɾ u m
ներս	n ɛ ɾ s
ներսես	n ɛ ɾ s ɛ s
ներսիսյան	n ɛ ɾ s i s j ɑ n
ներվ	n ɛ ɾ v
ներքեւ	n ɛ ɾ kʰ ɛ v
ներքին	n ɛ ɾ kʰ i n
ներքինացնել	n ɛ ɾ kʰ i n ɑ t͡sʰ n ɛ l
ներքինի	n ɛ ɾ kʰ i n i
ներքնազգեստ	n ɛ ɾ kʰ n ɑ z ɡ ɛ s t
ներքնակ	n ɛ ɾ kʰ n ɑ k
ներքո	n ɛ ɾ kʰ ɔ
ներքուստ	n ɛ ɾ kʰ u s t
նեցուկ	n ɛ t͡sʰ u k
նզովք	n ə z ɔ f kʰ
նժույգ	n ə ʒ u j kʰ
նիգերիա	n i ɡ ɛ ɾ j ɑ
նիդեռլանդներ	n i d ɛ r l ɑ n d n ɛ ɾ
նիդերլանդացի	n i d ɛ ɾ l ɑ n d ɑ t͡sʰ i
նիդերլանդներ	n i d ɛ ɾ l ɑ n d n ɛ ɾ
նիկել	n i k ɛ l
նիկիա	n i k j ɑ
նիկոլ	n i k ɔ l
նիկոլաեւ	n i k ɔ l ɑ j ɛ v
նիկողայոս	n i k ɔ ʁ ɑ j ɔ s
նիկոսիա	n i k ɔ s i ɑ
նիհար	n i h ɑ ɾ
նինջա	n i n d͡ʒ ɑ
նինվե	n i n v ɛ
նիշ	n i ʃ
նիստ	n i s t
նիստուկաց	n i s t u k ɑ t͡sʰ
նիրհ	n i ɾ h
նիցցա	n i t͡sʰː ɑ
նկատմամբ	n ə k ɑ t m ɑ m b
նկարագրություն	n ə k ɑ ɾ ɑ ɡ ɾ u tʰ j u n
նկարահանել	n ə k ɑ ɾ ɑ h ɑ n ɛ l
նկարահանում	n ə k ɑ ɾ ɑ h ɑ n u m
նկարահանվել	n ə k ɑ ɾ ɑ h ɑ n v ɛ l
նկարել	n ə k ɑ ɾ ɛ l
նկարեն	n ə k ɑ ɾ ɛ n
նկարիչ	n ə k ɑ ɾ i t͡ʃʰ
նկուղ	n ə k u ʁ
նկուղային	n ə k u ʁ ɑ j i n
նկուն	n ə k u n
նհանգ	n ə h ɑ ŋ ɡ
նման	n ə m ɑ n
նմանատիպ	n ə m ɑ n ɑ t i p
նմուշ	n ə m u ʃ
նյութափոխանակություն	n j u tʰ ɑ pʰ ɔ χ ɑ n ɑ k u tʰ j u n
նշան	n ə ʃ ɑ n
նշանաբան	n ə ʃ ɑ n ɑ b ɑ n
նշանագետ	n ə ʃ ɑ n ɑ ɡ ɛ t
նշանակ	n ʃ ɑ n ɑ k
նշանակալից	n ə ʃ ɑ n ɑ k ɑ l i t͡sʰ
նշանավոր	n ə ʃ ɑ n ɑ v ɔ ɾ
նշանյան	n ə ʃ ɑ n j ɑ n
նշանված	n ə ʃ ɑ n v ɑ t͡s
նշանվել	n ə ʃ ɑ n v ɛ l
նշել	n ə ʃ ɛ l
նշմարել	n ə ʃ m ɑ ɾ ɛ l
նշույլ	n ə ʃ u j l
նոխազ	n ɔ χ ɑ z
նոճի	n ɔ t͡ʃ i
նոյ	n ɔ j
նոյեմբեր	n ɔ j ɛ m b ɛ ɾ
նոյեմբերյան	n ɔ j ɛ m b ɛ ɾ j ɑ n
նովոռոսիյսկ	n ɔ v ɔ r ɔ s i j s k
նովոսիբիրսկ	n ɔ v ɔ s i b i ɾ s k
նոտար	n ɔ t ɑ ɾ
նոր	n ɔ ɾ
նորաբնակ	n ɔ ɾ ɑ b ə n ɑ k
նորածին	n ɔ ɾ ɑ t͡s i n
նորապսակ	n ɔ ɾ ɑ p ə s ɑ k
նորեկ	n ɔ ɾ ɛ k
նորընտիր	n ɔ ɾ ə n t i ɾ
նորման	n ɔ ɾ m ɑ n
նորմատիվ	n ɔ ɾ m ɑ t i v
նորոգ	n ɔ ɾ ɔ kʰ
նորոգել	n ɔ ɾ ɔ kʰ ɛ l
նորություն	n ɔ ɾ u tʰ j u n
նորություններ	n ɔ ɾ u tʰ j u nː ɛ ɾ
նորվեգական	n ɔ ɾ v ɛ ɡ ɑ k ɑ n
նորվեգիա	n ɔ ɾ v ɛ ɡ j ɑ
նու	n u
նուբար	n u b ɑ ɾ
նուկլոն	n u k l ɔ n
նույն	n u j n
նույնիսկ	n u j n i s k
նույնպես	n u j n p ɛ s
նույնքան	n u j ŋ kʰ ɑ n
նուշ	n u ʃ
նուրբ	n u ɾ pʰ
նպաստավոր	n ə p ɑ s t ɑ v ɔ ɾ
նպաստել	n ə p ɑ s t ɛ l
նպատակ	n ə p ɑ t ɑ k
նռնակ	n ə r n ɑ k
նռնականետ	n ə r n ɑ k ɑ n ɛ t
նվագ	n ə v ɑ ɡ
նվագել	n ə v ɑ ɡ ɛ l
նվազ	n ə v ɑ z
նվաճել	n ə v ɑ t͡ʃ ɛ l
նվաճում	n ə v ɑ t͡ʃ u m
նվարդ	n ə v ɑ ɾ tʰ
նվեր	n ə v ɛ ɾ
նվիրակ	n ə v i ɾ ɑ k
նվիրում	n ə v i ɾ u m
նրա	n ə ɾ ɑ
նրան	n ə ɾ ɑ n
նրանում	n ə ɾ ɑ n u m
նրանց	n ə ɾ ɑ n t͡sʰ
նրանք	n ə ɾ ɑ ŋ kʰ
նրբանցք	n ə ɾ pʰ ɑ n t͡sʰ kʰ
նրբերշիկ	n ə ɾ pʰ ɛ ɾ ʃ i k
շա	ʃ ɑ
շաբաշ	ʃ ɑ b ɑ ʃ
շագանակ	ʃ ɑ ɡ ɑ n ɑ k
շագանակագույն	ʃ ɑ ɡ ɑ n ɑ k ɑ ɡ u j n
շալ	ʃ ɑ l
շալակ	ʃ ɑ l ɑ k
շախ	ʃ ɑ χ
շախմատ	ʃ ɑ χ m ɑ t
շախմատի	ʃ ɑ χ m ɑ t i
շախմատիստ	ʃ ɑ χ m ɑ t i s t
շախմատիստուհի	ʃ ɑ χ m ɑ t i s t u h i
շահ	ʃ ɑ h
շահաբաժին	ʃ ɑ h ɑ b ɑ ʒ i n
շահագործել	ʃ ɑ h ɑ ɡ ɔ ɾ t͡s ɛ l
շահագործում	ʃ ɑ h ɑ ɡ ɔ ɾ t͡s u m
շահավետ	ʃ ɑ h ɑ v ɛ t
շահել	ʃ ɑ h ɛ l
շահեկան	ʃ ɑ h ɛ k ɑ n
շահեն	ʃ ɑ h ɛ n
շաղ	ʃ ɑ ʁ
շաղգամ	ʃ ɑ χ k ɑ m
շամամ	ʃ ɑ m ɑ m
շամբ	ʃ ɑ m b
շամիրամ	ʃ ɑ m i ɾ ɑ m
շամպայն	ʃ ɑ m p ɑ j n
շամպուն	ʃ ɑ m p u n
շայբա	ʃ ɑ j b ɑ
շանթ	ʃ ɑ n tʰ
շանհայ	ʃ ɑ n h ɑ j
շանսոնյե	ʃ ɑ n s ɔ n j ɛ
շանտաժ	ʃ ɑ n t ɑ ʒ
շաշ	ʃ ɑ ʃ
շաուրմա	ʃ ɑ u ɾ m ɑ
շապիկ	ʃ ɑ p i k
շապուհ	ʃ ɑ p u h
շավիղ	ʃ ɑ v i ʁ
շատ	ʃ ɑ t
շատակերիկ	ʃ ɑ t ɑ k ɛ ɾ i k
շատրվան	ʃ ɑ t ə ɾ v ɑ n
շարահյուսություն	ʃ ɑ ɾ ɑ h j u s u tʰ j u n
շարել	ʃ ɑ ɾ ɛ l
շարժական	ʃ ɑ ɾ ʒ ɑ k ɑ n
շարժանկար	ʃ ɑ ɾ ʒ ɑ n ə k ɑ ɾ
շարժապատկեր	ʃ ɑ ɾ ʒ ɑ p ɑ t k ɛ ɾ
շարժել	ʃ ɑ ɾ ʒ ɛ l
շարժիչ	ʃ ɑ ɾ ʒ i t͡ʃʰ
շարժում	ʃ ɑ ɾ ʒ u m
շարժուն	ʃ ɑ ɾ ʒ u n
շարք	ʃ ɑ ɾ kʰ
շարքային	ʃ ɑ ɾ kʰ ɑ j i n
շափյուղա	ʃ ɑ pʰ j u ʁ ɑ
շաքար	ʃ ɑ kʰ ɑ ɾ
շաքարախտ	ʃ ɑ kʰ ɑ ɾ ɑ χ t
շաքարավազ	ʃ ɑ kʰ ɑ ɾ ɑ v ɑ z
շաքարաքլոր	ʃ ɑ kʰ ɑ ɾ ɑ kʰ l ɔ ɾ
շաքարյան	ʃ ɑ kʰ ɑ ɾ j ɑ n
շեկ	ʃ ɛ k
շեղ	ʃ ɛ ʁ
շեղանկյուն	ʃ ɛ ʁ ɑ ŋ k j u n
շեղբ	ʃ ɛ ʁ b
շեղել	ʃ ɛ ʁ ɛ l
շեղջ	ʃ ɛ ʁ d͡ʒ
շեմ	ʃ ɛ m
շեյեն	ʃ ɛ j ɛ n
շեն	ʃ ɛ n
շեշտ	ʃ ɛ ʃ t
շեշտել	ʃ ɛ ʃ t ɛ l
շերեփ	ʃ ɛ ɾ ɛ pʰ
շերտ	ʃ ɛ ɾ t
շեփոր	ʃ ɛ pʰ ɔ ɾ
շեֆ	ʃ ɛ f
շթաքար	ʃ ə tʰ ɑ kʰ ɑ ɾ
շիզոֆրենիա	ʃ i z ɔ f ɾ ɛ n j ɑ
շիթ	ʃ i tʰ
շիճուկ	ʃ i t͡ʃ u k
շիմպանզե	ʃ i m p ɑ n z ɛ
շինական	ʃ i n ɑ k ɑ n
շինել	ʃ i n ɛ l
շինծու	ʃ i n t͡s u
շինվածք	ʃ i n v ɑ t͡s kʰ
շիշ	ʃ i ʃ
շիվ	ʃ i v
շիվա	ʃ i v ɑ
շիտակ	ʃ i t ɑ k
շիրակ	ʃ i ɾ ɑ k
շիրինյան	ʃ i ɾ i n j ɑ n
շղթա	ʃ ə χ tʰ ɑ
շնագայլ	ʃ ə n ɑ ɡ ɑ j l
շնդեղ	ʃ ə n d ɛ ʁ
շներ	ʃ ə n ɛ ɾ
շնորհ	ʃ ə n ɔ ɾ
շնորհակալ	ʃ ə n ɔ ɾ ɑ k ɑ l
շնորհակալություն	ʃ ə n ɔ ɾ ɑ k ɑ l u tʰ j u n
շնորհավոր	ʃ ə n ɔ ɾ ɑ v ɔ ɾ
շնորհավորանք	ʃ n ɔ ɾ ɑ v ɔ ɾ ɑ ŋ kʰ
շնորհավորել	ʃ n ɔ ɾ ɑ v ɔ ɾ ɛ l
շնորհավորում	ʃ n ɔ ɾ ɑ v ɔ ɾ u m
շնորհել	ʃ ə n ɔ ɾ ɛ l
շնորհիվ	ʃ ə n ɔ ɾ i v
շնորհք	ʃ ə n ɔ ɾ kʰ
շնչառություն	ʃ ə n t͡ʃʰ ɑ r u tʰ j u n
շնչել	ʃ ə n t͡ʃʰ ɛ l
շշնջալ	ʃ ə ʃ ə n d͡ʒ ɑ l
շոգ	ʃ ɔ kʰ
շոգենավ	ʃ ɔ kʰ ɛ n ɑ v
շոգի	ʃ ɔ kʰ i
շոկոլադ	ʃ ɔ k ɔ l ɑ d
շող	ʃ ɔ ʁ
շողոտ	ʃ ɔ ʁ ɔ t
շոշափել	ʃ ɔ ʃ ɑ pʰ ɛ l
շոր	ʃ ɔ ɾ
շորթել	ʃ ɔ ɾ tʰ ɛ l
շորթում	ʃ ɔ ɾ tʰ u m
շորժա	ʃ ɔ ɾ ʒ ɑ
շուկա	ʃ u k ɑ
շուն	ʃ u n
շունչ	ʃ u n t͡ʃʰ
շուշա	ʃ u ʃ ɑ
շուշան	ʃ u ʃ ɑ n
շուշի	ʃ u ʃ i
շուշմա	ʃ u ʃ m ɑ
շուտ	ʃ u t
շուտափույթ	ʃ u t ɑ pʰ u j tʰ
շուտով	ʃ u t ɔ v
շուրթ	ʃ u ɾ tʰ
շուրջպար	ʃ u ɾ d͡ʒ p ɑ ɾ
շուք	ʃ u kʰ
շոֆեռ	ʃ ɔ f ɛ r
շոֆեր	ʃ ɔ f ɛ ɾ
շպիլկա	ə ʃ p i l k ɑ
շպրտել	ʃ ə p ə ɾ t ɛ l
շռայլ	ʃ ə r ɑ j l
շռել	ʃ ə r ɛ l
շվեդ	ʃ ə v ɛ d
շվեդերեն	ʃ v ɛ d ɛ ɾ ɛ n
շվեդիա	ʃ v ɛ d j ɑ
շվի	ʃ ə v i
շտաբ	ə ʃ t ɑ b
շտապ	ə ʃ t ɑ p
շտապել	ə ʃ t ɑ p ɛ l
շտապօգնություն	ə ʃ t ɑ p ɔ kʰ n u tʰ j u n
շտեմարան	ə ʃ t ɛ m ɑ ɾ ɑ n
շտկել	ʃ ə t k ɛ l
շրթներկ	ʃ ə ɾ tʰ n ɛ ɾ k
շրջազգեստ	ʃ ə ɾ d͡ʒ ɑ z ɡ ɛ s t
շրջակայք	ʃ ə ɾ d͡ʒ ɑ k ɑ j kʰ
շրջահայաց	ʃ ə ɾ d͡ʒ ɑ h ɑ j ɑ t͡sʰ
շրջան	ʃ ə ɾ d͡ʒ ɑ n
շրջանագիծ	ʃ ə ɾ d͡ʒ ɑ n ɑ ɡ i t͡s
շրջանակ	ʃ ə ɾ d͡ʒ ɑ n ɑ k
շրջանակում	ʃ ə ɾ d͡ʒ ɑ n ɑ k u m
շրջանառություն	ʃ ə ɾ d͡ʒ ɑ n ɑ r u tʰ j u n
շրջափակել	ʃ ə ɾ d͡ʒ ɑ pʰ ɑ k ɛ l
շրջում	ʃ ə ɾ d͡ʒ u m
շրջվել	ʃ ə ɾ d͡ʒ v ɛ l
շփել	ʃ ə pʰ ɛ l
շփոթել	ʃ ə pʰ ɔ tʰ ɛ l
շփոթեցնել	ʃ ə pʰ ɔ tʰ ɛ t͡sʰ n ɛ l
շփոթմունք	ʃ ə pʰ ɔ tʰ m u ŋ kʰ
շփոթվել	ʃ ə pʰ ɔ tʰ v ɛ l
շփում	ʃ ə pʰ u m
շփվել	ʃ ə pʰ v ɛ l
շքախումբ	ʃ ə kʰ ɑ χ u m b
շքահանդես	ʃ ə kʰ ɑ h ɑ n d ɛ s
շքամուտք	ʃ ə kʰ ɑ m u t kʰ
շքեղ	ʃ ə kʰ ɛ ʁ
շքերթ	ʃ ə kʰ ɛ ɾ tʰ
ոգեշնչել	v ɔ kʰ ɛ ʃ ə n t͡ʃʰ ɛ l
ոգեշնչում	v ɔ kʰ ɛ ʃ ə n t͡ʃʰ u m
ոգեւորել	v ɔ kʰ ɛ v ɔ ɾ ɛ l
ոգեւորություն	v ɔ kʰ ɛ v ɔ ɾ u tʰ j u n
ոգեւորվել	v ɔ kʰ ɛ v ɔ ɾ v ɛ l
ոգի	v ɔ kʰ i
ոգորել	v ɔ ɡ ɔ ɾ ɛ l
ոզնախոտ	v ɔ z n ɑ χ ɔ t
ոզնի	v ɔ z n i
ոլոռ	v ɔ l ɔ r
ոլորապտույտ	v ɔ l ɔ ɾ ɑ p ə t u j t
ոլորուն	v ɔ l ɔ ɾ u n
ոլորտ	v ɔ l ɔ ɾ t
ոխ	v ɔ χ
ոխերիմ	v ɔ χ ɛ ɾ i m
ոհմակ	v ɔ h m ɑ k
ող	v ɔ ʁ
ողբ	v ɔ χ p
ողբերգություն	v ɔ χ p ɛ ɾ ɡ u tʰ j u n
ողկույզ	v ɔ χ k u j z
ողնաշար	v ɔ ʁ n ɑ ʃ ɑ ɾ
ողնաշարավոր	v ɔ ʁ n ɑ ʃ ɑ ɾ ɑ v ɔ ɾ
ողողել	v ɔ ʁ ɔ ʁ ɛ l
ողողվել	v ɔ ʁ ɔ ʁ v ɛ l
ողորկ	v ɔ ʁ ɔ ɾ k
ողորկություն	v ɔ ʁ ɔ ɾ k u tʰ j u n
ողորմածիկ	v ɔ ʁ ɔ ɾ m ɑ t͡s i k
ողորմություն	v ɔ ʁ ɔ ɾ m u tʰ j u n
ողջ	v ɔ χ t͡ʃʰ
ողջագուրել	v ɔ χ t͡ʃʰ ɑ ɡ u ɾ ɛ l
ողջակիզում	v ɔ χ t͡ʃʰ ɑ k i z u m
ողջամիտ	v ɔ χ t͡ʃʰ ɑ m i t
ողջույն	v ɔ χ t͡ʃʰ u j n
ողջունել	v ɔ χ t͡ʃʰ u n ɛ l
ոճ	v ɔ t͡ʃ
ոմն	v ɔ m ə n
ոնց	v ɔ n t͡sʰ
ոչ	v ɔ t͡ʃʰ
ոչինչ	v ɔ t͡ʃʰ i n t͡ʃʰ
ոչխար	v ɔ t͡ʃʰ χ ɑ ɾ
ոչնչացում	v ɔ t͡ʃʰ ə n t͡ʃʰ ɑ t͡sʰ u m
ոռնալ	v ɔ r n ɑ l
ոսկանյան	v ɔ s k ɑ n j ɑ n
ոսկե	v ɔ s k ɛ
ոսկեդրամ	v ɔ s k ɛ d ɾ ɑ m
ոսկեզօծ	v ɔ s k ɛ z ɔ t͡s
ոսկերիչ	v ɔ s k ɛ ɾ i t͡ʃʰ
ոսկերչություն	v ɔ s k ɛ ɾ t͡ʃʰ u tʰ j u n
ոսկի	v ɔ s k i
ոսկյա	v ɔ s k j ɑ
ոսկոր	v ɔ s k ɔ ɾ
ոսկու	v ɔ s k u
ոսկր	v ɔ s k ə ɾ
ոսոխ	v ɔ s ɔ χ
ոսպ	v ɔ s p
ոսպապուր	v ɔ s p ɑ p u ɾ
ոստ	v ɔ s t
ոստան	v ɔ s t ɑ n
ոստիկանապետ	v ɔ s t i k ɑ n ɑ p ɛ t
ոստիկանություն	v ɔ s t i k ɑ n u tʰ j u n
ոստրե	v ɔ s t ɾ ɛ
ոտ	v ɔ t
ոտանավոր	v ɔ t ɑ n ɑ v ɔ ɾ
ոտնաձայն	v ɔ t n ɑ d͡z ɑ j n
ոտնաչափ	v ɔ t n ɑ t͡ʃʰ ɑ pʰ
ոտք	v ɔ t kʰ
որ	v ɔ ɾ
որակ	v ɔ ɾ ɑ k
որակական	v ɔ ɾ ɑ k ɑ k ɑ n
որակյալ	v ɔ ɾ ɑ k j ɑ l
որբ	v ɔ ɾ pʰ
որդ	v ɔ ɾ tʰ
որդեգրում	v ɔ ɾ tʰ ɛ ɡ ə ɾ u m
որդեսեր	v ɔ ɾ tʰ ɛ s ɛ ɾ
որդյակ	v ɔ ɾ tʰ j ɑ k
որթ	v ɔ ɾ tʰ
որի	v ɔ ɾ i
որձ	v ɔ ɾ t͡sʰ
որմնադիր	v ɔ ɾ m n ɑ d i ɾ
որոգայթ	v ɔ ɾ ɔ ɡ ɑ j tʰ
որոմ	v ɔ ɾ ɔ m
որոնել	v ɔ ɾ ɔ n ɛ l
որոնք	v ɔ ɾ ɔ ŋ kʰ
որոշակի	v ɔ ɾ ɔ ʃ ɑ k i
որոշել	v ɔ ɾ ɔ ʃ ɛ l
որոշում	v ɔ ɾ ɔ ʃ u m
որովայն	v ɔ ɾ ɔ v ɑ j n
որոտ	v ɔ ɾ ɔ t
որոտան	v ɔ ɾ ɔ t ɑ n
որպեսզի	v ɔ ɾ p ɛ s z i
որջ	v ɔ ɾ t͡ʃʰ
որս	v ɔ ɾ s
որսալ	v ɔ ɾ s ɑ l
որսորդ	v ɔ ɾ s ɔ ɾ tʰ
որտեղ	v ɔ ɾ t ɛ ʁ
որտեւ	v ɔ ɾ t ɛ v
որքան	v ɔ ɾ kʰ ɑ n
ուագադուգու	u ɑ ɡ ɑ d u ɡ u
ուդմուրտ	u d m u ɾ t
ուդոն	u d ɔ n
ուզբեկ	u z b ɛ k
ուզբեկերեն	u z b ɛ k ɛ ɾ ɛ n
ուզբեկստան	u z b ɛ k s t ɑ n
ուզել	u z ɛ l
ութ	u tʰ
ուժ	u ʒ
ուժգին	u ʒ ɡ i n
ուժեղ	u ʒ ɛ ʁ
ուլունք	u l u ŋ kʰ
ուխտ	u χ t
ուխտագնացություն	u χ t ɑ ɡ ə n ɑ t͡sʰ u tʰ j u n
ուկրաինական	u k ɾ ɑ i n ɑ k ɑ n
ուկրաինացի	u k ɾ ɑ i n ɑ t͡sʰ i
ուկրաիներեն	u k ɾ ɑ i n ɛ ɾ ɛ n
ուղարկել	u ʁ ɑ ɾ k ɛ l
ուղեբեռ	u ʁ ɛ b ɛ r
ուղեկից	u ʁ ɛ k i t͡sʰ
ուղեկցել	u ʁ ɛ k t͡sʰ ɛ l
ուղեղ	u ʁ ɛ ʁ
ուղեղային	u ʁ ɛ ʁ ɑ j i n
ուղերձ	u ʁ ɛ ɾ t͡sʰ
ուղի	u ʁ i
ուղղագրություն	u ʁː ɑ ɡ ɾ u tʰ j u n
ուղղական	u ʁː ɑ k ɑ n
ուղղակի	u ʁː ɑ k i
ուղղափառ	u ʁː ɑ pʰ ɑ r
ուղղափառություն	u ʁː ɑ pʰ ɑ r u tʰ j u n
ուղղել	u ʁː ɛ l
ուղղություն	u ʁː u tʰ j u n
ուղտ	u χ t
ումպ	u m p
ունաբ	u n ɑ b
ունակ	u n ɑ k
ունակություն	u n ɑ k u tʰ j u n
ունայնություն	u n ɑ j n u tʰ j u n
ունդ	u n d
ունեմ	u n ɛ m
ունենալ	u n ɛ n ɑ l
ունիվերմագ	u n i v ɛ ɾ m ɑ ɡ
ունկնդիր	u ŋ k ə n d i ɾ
ունկնդրել	u ŋ k ə n d ɾ ɛ l
ուշ	u ʃ
ուշադիր	u ʃ ɑ d i ɾ
ուշանալ	u ʃ ɑ n ɑ l
ուշիմ	u ʃ i m
ուշունց	u ʃ u n t͡sʰ
ուշք	u ʃ kʰ
ուռել	u r ɛ l
ուռենի	u r ɛ n i
ուռի	u r i
ուռհա	u r h ɑ
ուռուցք	u r u t͡sʰ kʰ
ուռուցքաբան	u r u t͡sʰ kʰ ɑ b ɑ n
ուս	u s
ուսանել	u s ɑ n ɛ l
ուսանող	u s ɑ n ɔ ʁ
ուսապարկ	u s ɑ p ɑ ɾ k
ուսնոց	u s n ɔ t͡sʰ
ուսում	u s u m
ուսումնասիրություն	u s u m n ɑ s i ɾ u tʰ j u n
ուսուցանել	u s u t͡sʰ ɑ n ɛ l
ուսուցիչ	u s u t͡sʰ i t͡ʃʰ
ուսուցչուհի	u s u t͡sʰ t͡ʃʰ u h i
ուստի	u s t i
ուստիեւ	u s t i j ɛ v
ուստր	u s t ə ɾ
ուտել	u t ɛ l
ուտելիք	u t ɛ l i kʰ
ուտեստ	u t ɛ s t
ուտի	u t i
ուր	u ɾ
ուրալ	u ɾ ɑ l
ուրախ	u ɾ ɑ χ
ուրախակից	u ɾ ɑ χ ɑ k i t͡sʰ
ուրախացնել	u ɾ ɑ χ ɑ t͡sʰ n ɛ l
ուրախություն	u ɾ ɑ χ u tʰ j u n
ուրան	u ɾ ɑ n
ուրանալ	u ɾ ɑ n ɑ l
ուրարտական	u ɾ ɑ ɾ t ɑ k ɑ n
ուրարտերեն	u ɾ ɑ ɾ t ɛ ɾ ɛ n
ուրբաթ	u ɾ pʰ ɑ tʰ
ուրբանոս	u ɾ b ɑ n ɔ s
ուրեմն	u ɾ ɛ m ə n
ուրիշ	u ɾ i ʃ
ուրհա	u ɾ h ɑ
ուրմիա	u ɾ m i j ɑ
ուրու	u ɾ u
ուրվական	u ɾ v ɑ k ɑ n
ուրց	u ɾ t͡sʰ
ուրֆա	u ɾ f ɑ
ուֆա	u f ɑ
չա	t͡ʃʰ ɑ
չաղ	t͡ʃʰ ɑ ʁ
չաման	t͡ʃʰ ɑ m ɑ n
չայ	t͡ʃʰ ɑ j
չան	t͡ʃʰ ɑ n
չար	t͡ʃʰ ɑ ɾ
չարախոս	t͡ʃʰ ɑ ɾ ɑ χ ɔ s
չարամիտ	t͡ʃʰ ɑ ɾ ɑ m i t
չարանալ	t͡ʃʰ ɑ ɾ ɑ n ɑ l
չարաշահել	t͡ʃʰ ɑ ɾ ɑ ʃ ɑ h ɛ l
չարաչք	t͡ʃʰ ɑ ɾ ɑ t͡ʃʰ kʰ
չարբախ	t͡ʃʰ ɑ ɾ b ɑ χ
չարչարանք	t͡ʃʰ ɑ ɾ t͡ʃʰ ɑ ɾ ɑ ŋ kʰ
չարչարվել	t͡ʃʰ ɑ ɾ t͡ʃʰ ɑ ɾ v ɛ l
չափ	t͡ʃʰ ɑ pʰ
չափագիտություն	t͡ʃʰ ɑ pʰ ɑ ɡ i t u tʰ j u n
չափածո	t͡ʃʰ ɑ pʰ ɑ t͡s ɔ
չափահաս	t͡ʃʰ ɑ pʰ ɑ h ɑ s
չափանիշ	t͡ʃʰ ɑ pʰ ɑ n i ʃ
չափել	t͡ʃʰ ɑ pʰ ɛ l
չափորոշիչ	t͡ʃʰ ɑ pʰ ɔ ɾ ɔ ʃ i t͡ʃʰ
չբեր	t͡ʃʰ ə b ɛ ɾ
չգիտեմ	t͡ʃʰ ə ɡ i t ɛ m
չեզոք	t͡ʃʰ ɛ z ɔ kʰ
չեխ	t͡ʃʰ ɛ χ
չեխական	t͡ʃʰ ɛ χ ɑ k ɑ n
չեխերեն	t͡ʃʰ ɛ χ ɛ ɾ ɛ n
չեխիա	t͡ʃʰ ɛ χ j ɑ
չեխոլ	t͡ʃʰ ɛ χ ɔ l
չեխոսլովակիա	t͡ʃʰ ɛ χ ɔ s l ɔ v ɑ k j ɑ
չեղարկել	t͡ʃʰ ɛ ʁ ɑ ɾ k ɛ l
չեմպիոն	t͡ʃʰ ɛ m p j ɔ n
չեննայ	t͡ʃʰ ɛ nː ɑ j
չեչեն	t͡ʃʰ ɛ t͡ʃʰ ɛ n
չեչնիա	t͡ʃʰ ɛ t͡ʃʰ n j ɑ
չեռնոգորիա	t͡ʃʰ ɛ r n ɔ ɡ ɔ ɾ j ɑ
չէ	t͡ʃʰ ɛ
չիդար	t͡ʃʰ i d ɑ ɾ
չիթ	t͡ʃʰ i tʰ
չիլի	t͡ʃʰ i l i
չիլիացի	t͡ʃʰ i l i j ɑ t͡sʰ i
չիլինգարյան	t͡ʃʰ i l i ŋ ɡ ɑ ɾ j ɑ n
չիկագո	t͡ʃʰ i k ɑ ɡ ɔ
չիղջ	t͡ʃʰ i ʁ d͡ʒ
չինական	t͡ʃʰ i n ɑ k ɑ n
չինաստան	t͡ʃʰ i n ɑ s t ɑ n
չինարեն	t͡ʃʰ i n ɑ ɾ ɛ n
չինարի	t͡ʃʰ i n ɑ ɾ i
չինացի	t͡ʃʰ i n ɑ t͡sʰ i
չինգաչունգ	t͡ʃʰ i ŋ ɡ ɑ t͡ʃʰ u ŋ ɡ
չիներեն	t͡ʃʰ i n ɛ ɾ ɛ n
չիպ	t͡ʃʰ i p
չիր	t͡ʃʰ i ɾ
չիք	t͡ʃʰ i kʰ
չկայացած	t͡ʃʰ ə k ɑ j ɑ t͡sʰ ɑ t͡s
չղջիկ	t͡ʃʰ ə χ t͡ʃʰ i k
չնայած	t͡ʃʰ ə n ɑ j ɑ t͡s
չոբան	t͡ʃʰ ɔ b ɑ n
չոր	t͡ʃʰ ɔ ɾ
չորաթան	t͡ʃʰ ɔ ɾ ɑ tʰ ɑ n
չորավուն	t͡ʃʰ ɔ ɾ ɑ v u n
չորթան	t͡ʃʰ ɔ ɾ tʰ ɑ n
չորս	t͡ʃʰ ɔ ɾ s
չորքոտանի	t͡ʃʰ ɔ ɾ kʰ ɔ t ɑ n i
չու	t͡ʃʰ u
չոփ	t͡ʃʰ ɔ pʰ
չոփիկ	t͡ʃʰ ɔ pʰ i k
չոքել	t͡ʃʰ ɔ kʰ ɛ l
չսիրած	t͡ʃʰ ə s i ɾ ɑ t͡s
չվել	t͡ʃʰ ə v ɛ l
չվերթ	t͡ʃʰ ə v ɛ ɾ tʰ
չքանալ	t͡ʃʰ ə kʰ ɑ n ɑ l
չքավոր	t͡ʃʰ ə kʰ ɑ v ɔ ɾ
չքնաղ	t͡ʃʰ ə kʰ n ɑ ʁ
չքսեինք	t͡ʃʰ ə kʰ ə s ɛ j i ŋ kʰ
պագ	p ɑ kʰ
պագնել	p ɑ kʰ n ɛ l
պալատ	p ɑ l ɑ t
պալատական	p ɑ l ɑ t ɑ k ɑ n
պալար	p ɑ l ɑ ɾ
պակ	p ɑ k
պակաս	p ɑ k ɑ s
պակասել	p ɑ k ɑ s ɛ l
պակասեցնել	p ɑ k ɑ s ɛ t͡sʰ n ɛ l
պակասուրդ	p ɑ k ɑ s u ɾ tʰ
պակիստան	p ɑ k i s t ɑ n
պահածո	p ɑ h ɑ t͡s ɔ
պահանջ	p ɑ h ɑ n d͡ʒ
պահանջարկ	p ɑ h ɑ n d͡ʒ ɑ ɾ k
պահանջել	p ɑ h ɑ n d͡ʒ ɛ l
պահապան	p ɑ h ɑ p ɑ n
պահարան	p ɑ h ɑ ɾ ɑ n
պահել	p ɑ h ɛ l
պահեստ	p ɑ h ɛ s t
պահլավերեն	p ɑ h l ɑ v ɛ ɾ ɛ n
պահպանակ	p ɑ h p ɑ n ɑ k
պաղեստին	p ɑ ʁ ɛ s t i n
պաղպաղակ	p ɑ χ p ɑ ʁ ɑ k
պաճուճ	p ɑ t͡ʃ u t͡ʃ
պամիրյան	p ɑ m i ɾ j ɑ n
պայթյուն	p ɑ j tʰ j u n
պայծառ	p ɑ j t͡s ɑ r
պայմանագիր	p ɑ j m ɑ n ɑ ɡ i ɾ
պայմանական	p ɑ j m ɑ n ɑ k ɑ n
պայմանավոր	p ɑ j m ɑ n ɑ v ɔ ɾ
պայմանավորել	p ɑ j m ɑ n ɑ v ɔ ɾ ɛ l
պայմանավորվել	p ɑ j m ɑ n ɑ v ɔ ɾ v ɛ l
պայքար	p ɑ j kʰ ɑ ɾ
պան	p ɑ n
պանամա	p ɑ n ɑ m ɑ
պանդոկ	p ɑ n d ɔ k
պանիր	p ɑ n i ɾ
պաշար	p ɑ ʃ ɑ ɾ
պաշտամունք	p ɑ ʃ t ɑ m u ŋ kʰ
պաշտել	p ɑ ʃ t ɛ l
պաշտոն	p ɑ ʃ t ɔ n
պաշտոնական	p ɑ ʃ t ɔ n ɑ k ɑ n
պաշտոնակից	p ɑ ʃ t ɔ n ɑ k i t͡sʰ
պաշտոնավոր	p ɑ ʃ t ɔ n ɑ v ɔ ɾ
պաչ	p ɑ t͡ʃʰ
պաչել	p ɑ t͡ʃʰ ɛ l
պաչիկ	p ɑ t͡ʃʰ i k
պապ	p ɑ p
պապա	p ɑ p ɑ
պապական	p ɑ p ɑ k ɑ n
պապայա	p ɑ p ɑ j ɑ
պապանձվել	p ɑ p ɑ n d͡z v ɛ l
պապի	p ɑ p i
պապկա	p ɑ p k ɑ
պառավ	p ɑ r ɑ v
պառլամենտ	p ɑ r l ɑ m ɛ n t
պառկել	p ɑ r k ɛ l
պաս	p ɑ s
պաստառ	p ɑ s t ɑ r
պատ	p ɑ t
պատահար	p ɑ t ɑ h ɑ ɾ
պատահել	p ɑ t ɑ h ɛ l
պատանդ	p ɑ t ɑ n d
պատանեկություն	p ɑ t ɑ n ɛ k u tʰ j u n
պատանի	p ɑ t ɑ n i
պատանյակ	p ɑ t ɑ n j ɑ k
պատառ	p ɑ t ɑ r
պատառաքաղ	p ɑ t ɑ r ɑ kʰ ɑ ʁ
պատասխան	p ɑ t ɑ s χ ɑ n
պատասխանատվությամբ	p ɑ t ɑ s χ ɑ n ɑ t v u tʰ j ɑ m b
պատասխանատվություն	p ɑ t ɑ s χ ɑ n ɑ t v u tʰ j u n
պատասխանել	p ɑ t ɑ s χ ɑ n ɛ l
պատարագ	p ɑ t ɑ ɾ ɑ kʰ
պատգամավորացու	p ɑ t ɡ ɑ m ɑ v ɔ ɾ ɑ t͡sʰ u
պատգարակ	p ɑ t ɡ ɑ ɾ ɑ k
պատել	p ɑ t ɛ l
պատերազմ	p ɑ t ɛ ɾ ɑ z m
պատժամիջոց	p ɑ t ʒ ɑ m i t͡ʃʰ ɔ t͡sʰ
պատժել	p ɑ t ʒ ɛ l
պատժում	p ɑ t ʒ u m
պատժվել	p ɑ t ə ʒ v ɛ l
պատիժ	p ɑ t i ʒ
պատիկ	p ɑ t i k
պատիվ	p ɑ t i v
պատկանել	p ɑ t k ɑ n ɛ l
պատկառանք	p ɑ t k ɑ r ɑ ŋ kʰ
պատկառելի	p ɑ t k ɑ r ɛ l i
պատկերահան	p ɑ t k ɛ ɾ ɑ h ɑ n
պատկերասրահ	p ɑ t k ɛ ɾ ɑ s ə ɾ ɑ h
պատկերացնել	p ɑ t k ɛ ɾ ɑ t͡sʰ n ɛ l
պատկերացում	p ɑ t k ɛ ɾ ɑ t͡sʰ u m
պատճառ	p ɑ t t͡ʃ ɑ r
պատճեն	p ɑ t t͡ʃ ɛ n
պատճենահան	p ɑ t t͡ʃ ɛ n ɑ h ɑ n
պատմագիտություն	p ɑ t m ɑ ɡ i t u tʰ j u n
պատմական	p ɑ t m ɑ k ɑ n
պատմել	p ɑ t m ɛ l
պատմություն	p ɑ t m u tʰ j u n
պատմուճան	p ɑ t m u t͡ʃ ɑ n
պատյան	p ɑ t j ɑ n
պատնեշ	p ɑ t n ɛ ʃ
պատշաճ	p ɑ t ʃ ɑ t͡ʃ
պատշգամբ	p ɑ t ə ʃ ɡ ɑ m b
պատուհան	p ɑ t u h ɑ n
պատուհաս	p ɑ t u h ɑ s
պատռել	p ɑ t r ɛ l
պատվաստանյութ	p ɑ t v ɑ s t ɑ n j u tʰ
պատվաստել	p ɑ t v ɑ s t ɛ l
պատվաստում	p ɑ t v ɑ s t u m
պատվար	p ɑ t v ɑ ɾ
պատվարժան	p ɑ t v ɑ ɾ ʒ ɑ n
պատվեր	p ɑ t v ɛ ɾ
պատվիրակություն	p ɑ t v i ɾ ɑ k u tʰ j u n
պատվիրան	p ɑ t v i ɾ ɑ n
պատվիրել	p ɑ t v i ɾ ɛ l
պատվոգիր	p ɑ t v ɔ ɡ i ɾ
պատրանք	p ɑ t ɾ ɑ ŋ kʰ
պատրաստ	p ɑ t ɾ ɑ s t
պատրաստակամ	p ɑ t ɾ ɑ s t ɑ k ɑ m
պատրաստել	p ɑ t ɾ ɑ s t ɛ l
պատրաստվել	p ɑ t ɾ ɑ s t v ɛ l
պատրվակ	p ɑ t ə ɾ v ɑ k
պար	p ɑ ɾ
պարագա	p ɑ ɾ ɑ ɡ ɑ
պարագվայ	p ɑ ɾ ɑ ɡ v ɑ j
պարադոքս	p ɑ ɾ ɑ d ɔ kʰ s
պարան	p ɑ ɾ ɑ n
պարաշյուտ	p ɑ ɾ ɑ ʃ j u t
պարապ	p ɑ ɾ ɑ p
պարապել	p ɑ ɾ ɑ p ɛ l
պարարտ	p ɑ ɾ ɑ ɾ t
պարարտանյութ	p ɑ ɾ ɑ ɾ t ɑ n j u tʰ
պարգեւ	p ɑ ɾ kʰ ɛ v
պարգեւավճար	p ɑ ɾ kʰ ɛ v ɑ v ə t͡ʃ ɑ ɾ
պարգեւել	p ɑ ɾ kʰ ɛ v ɛ l
պարեգոտ	p ɑ ɾ ɛ ɡ ɔ t
պարել	p ɑ ɾ ɛ l
պարեն	p ɑ ɾ ɛ n
պարետ	p ɑ ɾ ɛ t
պարզ	p ɑ ɾ z
պարզապես	p ɑ ɾ z ɑ p ɛ s
պարզորոշ	p ɑ ɾ z ɔ ɾ ɔ ʃ
պարզունակ	p ɑ ɾ z u n ɑ k
պարթեւ	p ɑ ɾ tʰ ɛ v
պարթեւստան	p ɑ ɾ tʰ ɛ f s t ɑ n
պարիկ	p ɑ ɾ i k
պարծանք	p ɑ ɾ t͡s ɑ ŋ kʰ
պարծենալ	p ɑ ɾ t͡s ɛ n ɑ l
պարկ	p ɑ ɾ k
պարկավոր	p ɑ ɾ k ɑ v ɔ ɾ
պարմեզան	p ɑ ɾ m ɛ z ɑ n
պարող	p ɑ ɾ ɔ ʁ
պարոն	p ɑ ɾ ɔ n
պարուհի	p ɑ ɾ u h i
պարույր	p ɑ ɾ u j ɾ
պարս	p ɑ ɾ s
պարսատիկ	p ɑ ɾ s ɑ t i k
պարսիկ	p ɑ ɾ s i k
պարսկական	p ɑ ɾ s k ɑ k ɑ n
պարսկահայ	p ɑ ɾ s k ɑ h ɑ j
պարսկաստան	p ɑ ɾ s k ɑ s t ɑ n
պարսկերեն	p ɑ ɾ s k ɛ ɾ ɛ n
պարտ	p ɑ ɾ t
պարտականություն	p ɑ ɾ t ɑ k ɑ n u tʰ j u n
պարտավ	p ɑ ɾ t ɑ v
պարտավորություն	p ɑ ɾ t ɑ v ɔ ɾ u tʰ j u n
պարտատոմս	p ɑ ɾ t ɑ t ɔ m s
պարտեզ	p ɑ ɾ t ɛ z
պարտիա	p ɑ ɾ t j ɑ
պարտիզան	p ɑ ɾ t i z ɑ n
պարտիզանական	p ɑ ɾ t i z ɑ n ɑ k ɑ n
պարտություն	p ɑ ɾ t u tʰ j u n
պարտվողական	p ɑ ɾ t v ɔ ʁ ɑ k ɑ n
պարտք	p ɑ ɾ t kʰ
պացիենտ	p ɑ t͡sʰ j ɛ n t
պե	p ɛ
պեկին	p ɛ k i n
պեղել	p ɛ ʁ ɛ l
պենալ	p ɛ n ɑ l
պես	p ɛ s
պետ	p ɛ t
պետական	p ɛ t ɑ k ɑ n
պետերբուրգ	p ɛ t ɛ ɾ b u ɾ ɡ
պետրոզավոդսկ	p ɛ t ɾ ɔ z ɑ v ɔ d s k
պետրոսյան	p ɛ t ɾ ɔ s j ɑ n
պետք	p ɛ t kʰ
պերճ	p ɛ ɾ t͡ʃ
պերճախոս	p ɛ ɾ t͡ʃ ɑ χ ɔ s
պերճանք	p ɛ ɾ t͡ʃ ɑ ŋ kʰ
պերմանենտ	p ɛ ɾ m ɑ n ɛ n t
պերու	p ɛ ɾ u
պզուկ	p ə z u k
պիղատոս	p i ʁ ɑ t ɔ s
պիղծ	p i χ t͡s
պինգվին	p i ŋ ɡ v i n
պինդոս	p i n d ɔ s
պիսիդիա	p i s i d j ɑ
պիստակ	p i s t ɑ k
պիտանացու	p i t ɑ n ɑ t͡sʰ u
պիտանի	p i t ɑ n i
պիտի	p i t i
պիտույք	p i t u j kʰ
պիրենեյան	p i ɾ ɛ n ɛ j ɑ n
պլենար	p l ɛ n ɑ ɾ
պլերոմա	p l ɛ ɾ ɔ m ɑ
պլոր	p ə l ɔ ɾ
պլուզ	p ə l u z
պլուտարքոս	p l u t ɑ ɾ kʰ ɔ s
պլուտոն	p l u t ɔ n
պղինձ	p ə ʁ i n d͡z
պղպեղ	p ə χ p ɛ ʁ
պճեղ	p ə t͡ʃ ɛ ʁ
պն	p ə n ə
պնակ	p ə n ɑ k
պնդակազմ	p ə n d ɑ k ɑ z m
պնդել	p ə n d ɛ l
պնդուկ	p ə n d u k
պնչատ	p ə n t͡ʃʰ ɑ t
պոդգորիցա	p ɔ d ɡ ɔ ɾ i t͡sʰ ɑ
պոզ	p ɔ z
պոզիտիվ	p ɔ z i t i v
պոզիտիվիզմ	p ɔ z i t i v i z m
պոլիմեր	p ɔ l i m ɛ ɾ
պոլիոմիելիտ	p ɔ l i j ɔ m j ɛ l i t
պոլիս	p ɔ l i s
պոլկա	p ɔ l k ɑ
պոկել	p ɔ k ɛ l
պող	p ɔ ʁ
պողոս	p ɔ ʁ ɔ s
պողոսյան	p ɔ ʁ ɔ s j ɑ n
պողոտա	p ɔ ʁ ɔ t ɑ
պոմիդոր	p ɔ m i d ɔ ɾ
պոմպ	p ɔ m p
պոնչիկ	p ɔ n t͡ʃʰ i k
պոնտոս	p ɔ n t ɔ s
պոչ	p ɔ t͡ʃʰ
պոչատ	p ɔ t͡ʃʰ ɑ t
պոչիկ	p ɔ t͡ʃʰ i k
պոպոզ	p ɔ p ɔ z
պոպոկ	p ɔ p ɔ k
պոպուլիզմ	p ɔ p u l i z m
պոպոք	p ɔ p ɔ kʰ
պոռնիկ	p ɔ r n i k
պոռնկանոց	p ɔ r n ə k ɑ n ɔ t͡sʰ
պոռնկատուն	p ɔ r n ə k ɑ t u n
պոռնկություն	p ɔ r n ə k u tʰ j u n
պոռնոգրաֆիա	p ɔ r n ɔ ɡ ɾ ɑ f j ɑ
պոռոչ	p ɔ r ɔ t͡ʃʰ
պոռոտ	p ɔ r ɔ t
պոռոտախոս	p ɔ r ɔ t ɑ χ ɔ s
պոստմոդեռնիզմ	p ɔ s t m ɔ d ɛ r n i z m
պորուչիկ	p ɔ ɾ u t͡ʃʰ i k
պորտալար	p ɔ ɾ t ɑ l ɑ ɾ
պորտապար	p ɔ ɾ t ɑ p ɑ ɾ
պորտուգալական	p ɔ ɾ t u ɡ ɑ l ɑ k ɑ n
պորտուգալացի	p ɔ ɾ t u ɡ ɑ l ɑ t͡sʰ i
պուլպուլակ	p u l p u l ɑ k
պուճուր	p u t͡ʃ u ɾ
պուտին	p u t i n
պուրի	p u ɾ i
պսակ	p ə s ɑ k
պստիկ	p ə s t i k
պտեր	p ə t ɛ ɾ
պտկաքար	p ə t k ɑ kʰ ɑ ɾ
պտղաբեր	p ə t ʁ ɑ b ɛ ɾ
պտղատու	p ə t ʁ ɑ t u
պտուղ	p ə t u ʁ
պտույտ	p ə t u j t
պտուտակ	p ə t u t ɑ k
պտտահողմ	p ə t ə t ɑ h ɔ ʁ m
պտտել	p ə t ə t ɛ l
պրահա	p ɾ ɑ h ɑ
պրայա	p ɾ ɑ j ɑ
պրիզմա	p ɾ i z m ɑ
պրիմիտիվ	p ɾ i m i t i v
պրինտեր	p ɾ i n t ɛ ɾ
պրինց	p ə ɾ i n t͡sʰ
պրծնել	p ə ɾ t͡s n ɛ l
պրոթեզ	p ɾ ɔ tʰ ɛ z
պրոլետար	p ɾ ɔ l ɛ t ɑ ɾ
պրոկլետիե	p ɾ ɔ k l ɛ t j ɛ
պրոպագանդա	p ɾ ɔ p ɑ ɡ ɑ n d ɑ
պրովանս	p ɾ ɔ v ɑ n s
պրոցես	p ɾ ɔ t͡sʰ ɛ s
պրոֆեսիոնալ	p ɾ ɔ f ɛ s i ɔ n ɑ l
ջազ	d͡ʒ ɑ z
ջալալ	d͡ʒ ɑ l ɑ l
ջակարտա	d͡ʒ ɑ k ɑ ɾ t ɑ
ջահ	d͡ʒ ɑ h
ջահել	d͡ʒ ɑ h ɛ l
ջահուկյան	d͡ʒ ɑ h u k j ɑ n
ջաղաց	d͡ʒ ɑ ʁ ɑ t͡sʰ
ջան	d͡ʒ ɑ n
ջանասեր	d͡ʒ ɑ n ɑ s ɛ ɾ
ջանասիրաբար	d͡ʒ ɑ n ɑ s i ɾ ɑ b ɑ ɾ
ջանասիրություն	d͡ʒ ɑ n ɑ s i ɾ u tʰ j u n
ջանք	d͡ʒ ɑ ŋ kʰ
ջատագով	d͡ʒ ɑ t ɑ ɡ ɔ v
ջարդ	d͡ʒ ɑ ɾ tʰ
ջարքանդ	d͡ʒ ɑ ɾ kʰ ɑ n d
ջեբ	d͡ʒ ɛ b
ջերմ	d͡ʒ ɛ ɾ m
ջերմաչափ	d͡ʒ ɛ ɾ m ɑ t͡ʃʰ ɑ pʰ
ջերմաստիճան	d͡ʒ ɛ ɾ m ɑ s t i t͡ʃ ɑ n
ջերմոց	d͡ʒ ɛ ɾ m ɔ t͡sʰ
ջերմուկ	d͡ʒ ɛ ɾ m u k
ջիբութի	d͡ʒ i b u tʰ i
ջիգյար	d͡ʒ i ɡ j ɑ ɾ
ջիլ	d͡ʒ i l
ջիղ	d͡ʒ i ʁ
ջիմ	d͡ʒ i m
ջին	d͡ʒ i n
ջիպ	d͡ʒ i p
ջղային	d͡ʒ ə ʁ ɑ j i n
ջղայնացնել	d͡ʒ ə ʁ ɑ j n ɑ t͡sʰ n ɛ l
ջնջել	d͡ʒ ə n d͡ʒ ɛ l
ջո	d͡ʒ ɔ
ջոկ	d͡ʒ ɔ k
ջոկել	d͡ʒ ɔ k ɛ l
ջորջիա	d͡ʒ ɔ ɾ d͡ʒ i j ɑ
ջութակ	d͡ʒ u tʰ ɑ k
ջուլհակ	d͡ʒ u l h ɑ k
ջունգլի	d͡ʒ u ŋ ɡ l i
ջուր	d͡ʒ u ɾ
ջուրը	d͡ʒ u ɾ ə
ջվալ	d͡ʒ ə v ɑ l
ջրախոզուկ	d͡ʒ ə ɾ ɑ χ ɔ z u k
ջրածնային	d͡ʒ ə ɾ ɑ t͡s n ɑ j i n
ջրաղաց	d͡ʒ ə ɾ ɑ ʁ ɑ t͡sʰ
ջրամբար	d͡ʒ ə ɾ ɑ m b ɑ ɾ
ջրային	d͡ʒ ə ɾ ɑ j i n
ջրանցք	d͡ʒ ə ɾ ɑ n t͡sʰ kʰ
ջրատար	d͡ʒ ə ɾ ɑ t ɑ ɾ
ջրի	d͡ʒ ə ɾ i
ջրիմուռ	d͡ʒ ə ɾ i m u r
ջրիմուռներ	d͡ʒ ə ɾ i m u r n ɛ ɾ
ջրծաղիկ	d͡ʒ ə ɾ t͡s ɑ ʁ i k
ջրհեղեղ	d͡ʒ ə ɾ h ɛ ʁ ɛ ʁ
ջրհոր	d͡ʒ ə ɾ h ɔ ɾ
ջրշուն	d͡ʒ ə ɾ ʃ u n
ջրպան	d͡ʒ ə ɾ p ɑ n
ջրվեժ	d͡ʒ ə ɾ v ɛ ʒ
ռաբիզ	r ɑ b i z
ռադիո	r ɑ d j ɔ
ռազմագերի	r ɑ z m ɑ ɡ ɛ ɾ i
ռազմակայան	r ɑ z m ɑ k ɑ j ɑ n
ռազմական	r ɑ z m ɑ k ɑ n
ռազմաճակատ	r ɑ z m ɑ t͡ʃ ɑ k ɑ t
ռազմավարություն	r ɑ z m ɑ v ɑ ɾ u tʰ j u n
ռազմիկ	r ɑ z m i k
ռախմանինով	r ɑ χ m ɑ n i n ɔ v
ռակ	r ɑ k
ռահ	r ɑ h
ռահվիրա	r ɑ h v i ɾ ɑ
ռաղամ	r ɑ ʁ ɑ m
ռայա	r ɑ j ɑ
ռասա	r ɑ s ɑ
ռասիզմ	r ɑ s i z m
ռասիստ	r ɑ s i s t
ռացիոնալ	r ɑ t͡sʰ i ɔ n ɑ l
ռաքել	r ɑ kʰ ɛ l
ռդ	r ə d ə
ռեալ	r ɛ ɑ l
ռեակցիա	r ɛ ɑ k t͡sʰ j ɑ
ռեգբի	r ɛ ɡ b i
ռեժիսոր	r ɛ ʒ i s ɔ ɾ
ռեկորդային	r ɛ k ɔ ɾ d ɑ j i n
ռեհան	r ɛ h ɑ n
ռեմոնտ	r ɛ m ɔ n t
ռեյկյավիկ	r ɛ j k j ɑ v i k
ռեպ	r ɛ p
ռեստորան	r ɛ s t ɔ ɾ ɑ n
ռետին	r ɛ t i n
ռեփ	r ɛ pʰ
ռեֆորմ	r ɛ f ɔ ɾ m
ռիգա	r i ɡ ɑ
ռինգ	r i ŋ ɡ
ռիոն	r i j ɔ n
ռիոնի	r i j ɔ n i
ռիչարդ	r i t͡ʃʰ ɑ ɾ d
ռիսկ	r i s k
ռիցա	r i t͡sʰ ɑ
ռնգեղջյուր	r ŋ ɡ ɛ χ t͡ʃʰ j u ɾ
ռոբերտ	r ɔ b ɛ ɾ t
ռոբոտ	r ɔ b ɔ t
ռոճիկ	r ɔ t͡ʃ i k
ռոման	r ɔ m ɑ n
ռոն	r ɔ n
ռոստով	r ɔ s t ɔ v
ռուբ	r u b
ռուբեն	r u b ɛ n
ռուբինյան	r u b i n j ɑ n
ռումբ	r u m b
ռումինական	r u m i n ɑ k ɑ n
ռումինացի	r u m i n ɑ t͡sʰ i
ռումինիա	r u m i n j ɑ
ռուս	r u s
ռուսական	r u s ɑ k ɑ n
ռուսաստան	r u s ɑ s t ɑ n
ռուսաստանցի	r u s ɑ s t ɑ n t͡sʰ i
ռուստամյան	r u s t ɑ m j ɑ n
սա	s ɑ
սագ	s ɑ ɡ
սադափ	s ɑ d ɑ pʰ
սադրանք	s ɑ d ɾ ɑ ŋ kʰ
սադրել	s ɑ d ɾ ɛ l
սադրիչ	s ɑ d ɾ i t͡ʃʰ
սազ	s ɑ z
սազալ	s ɑ z ɑ l
սաթ	s ɑ tʰ
սաթենիկ	s ɑ tʰ ɛ n i k
սալ	s ɑ l
սալաթ	s ɑ l ɑ tʰ
սալաքար	s ɑ l ɑ kʰ ɑ ɾ
սալմաստ	s ɑ l m ɑ s t
սալոնիկ	s ɑ l ɔ n i k
սալվադոր	s ɑ l v ɑ d ɔ ɾ
սակայն	s ɑ k ɑ j n
սակավ	s ɑ k ɑ v
սակավաթիվ	s ɑ k ɑ v ɑ tʰ i v
սակարկում	s ɑ k ɑ ɾ k u m
սակարկվել	s ɑ k ɑ ɾ k v ɛ l
սահակ	s ɑ h ɑ k
սահակյան	s ɑ h ɑ k j ɑ n
սահարա	s ɑ h ɑ ɾ ɑ
սահել	s ɑ h ɛ l
սահման	s ɑ h m ɑ n
սահմանագծում	s ɑ h m ɑ n ɑ ɡ ə t͡s u m
սահմանադրական	s ɑ h m ɑ n ɑ d ɾ ɑ k ɑ n
սահմանադրություն	s ɑ h m ɑ n ɑ d ə ɾ u tʰ j u n
սահմանական	s ɑ h m ɑ n ɑ k ɑ n
սահմանապահ	s ɑ h m ɑ n ɑ p ɑ h
սահմանափակ	s ɑ h m ɑ n ɑ pʰ ɑ k
սահմանափակել	s ɑ h m ɑ n ɑ pʰ ɑ k ɛ l
սահմանափակող	s ɑ h m ɑ n ɑ pʰ ɑ k ɔ ʁ
սահմանափակություն	s ɑ h m ɑ n ɑ pʰ ɑ k u tʰ j u n
սահմանափակում	s ɑ h m ɑ n ɑ pʰ ɑ k u m
սահմանափակվածություն	s ɑ h m ɑ n ɑ pʰ ɑ k v ɑ t͡s u tʰ j u n
սահմանել	s ɑ h m ɑ n ɛ l
սահմանվել	s ɑ h m ɑ n v ɛ l
սաղ	s ɑ ʁ
սաղավարտ	s ɑ ʁ ɑ v ɑ ɾ t
սաղարթ	s ɑ ʁ ɑ ɾ tʰ
սաղմ	s ɑ ʁ m
սաղմոն	s ɑ ʁ m ɔ n
սամարա	s ɑ m ɑ ɾ ɑ
սամարիա	s ɑ m ɑ ɾ j ɑ
սամոսատ	s ɑ m ɔ s ɑ t
սամսար	s ɑ m s ɑ ɾ
սայթաքել	s ɑ j tʰ ɑ kʰ ɛ l
սայլ	s ɑ j l
սայլորդ	s ɑ j l ɔ ɾ tʰ
սան	s ɑ n
սանդ	s ɑ n d
սանդղակ	s ɑ n d ʁ ɑ k
սանդուղք	s ɑ n d u χ kʰ
սանկցիա	s ɑ ŋ k t͡sʰ j ɑ
սանձ	s ɑ n d͡z
սանձել	s ɑ n d͡z ɛ l
սանտիմ	s ɑ n t i m
սանտյագո	s ɑ n t j ɑ ɡ ɔ
սանր	s ɑ n ə ɾ
սանրել	s ɑ n ɾ ɛ l
սանրվածք	s ɑ n ə ɾ v ɑ t͡s kʰ
սառ	s ɑ r
սառա	s ɑ r ɑ
սառել	s ɑ r ɛ l
սառը	s ɑ r ə
սառն	s ɑ r ə n
սառնամանիք	s ɑ r n ɑ m ɑ n i kʰ
սառնարան	s ɑ r n ɑ ɾ ɑ n
սառույց	s ɑ r u j t͡sʰ
սառուցյալ	s ɑ r u t͡sʰ j ɑ l
սառչել	s ɑ r t͡ʃʰ ɛ l
սառցահատ	s ɑ r t͡sʰ ɑ h ɑ t
սասանել	s ɑ s ɑ n ɛ l
սաստիկ	s ɑ s t i k
սավան	s ɑ v ɑ n
սավառնել	s ɑ v ɑ r n ɛ l
սատանա	s ɑ t ɑ n ɑ
սատուրն	s ɑ t u ɾ n
սարայ	s ɑ ɾ ɑ j
սարատով	s ɑ ɾ ɑ t ɔ v
սարաֆյան	s ɑ ɾ ɑ f j ɑ n
սարգիս	s ɑ ɾ kʰ i s
սարգսյան	s ɑ ɾ kʰ ə s j ɑ n
սարդ	s ɑ ɾ d
սարդեր	s ɑ ɾ d ɛ ɾ
սարդի	s ɑ ɾ d i
սարդոստայն	s ɑ ɾ d ɔ s t ɑ j n
սարկազմ	s ɑ ɾ k ɑ z m
սարկավագ	s ɑ ɾ k ɑ v ɑ ɡ
սարյակ	s ɑ ɾ j ɑ k
սարում	s ɑ ɾ u m
սարումյան	s ɑ ɾ u m j ɑ n
սարսափ	s ɑ ɾ s ɑ pʰ
սարսափազդու	s ɑ ɾ s ɑ pʰ ɑ z d u
սարսափալից	s ɑ ɾ s ɑ pʰ ɑ l i t͡sʰ
սարսափահար	s ɑ ɾ s ɑ pʰ ɑ h ɑ ɾ
սարսափել	s ɑ ɾ s ɑ pʰ ɛ l
սարսափելի	s ɑ ɾ s ɑ pʰ ɛ l i
սարսափեցնել	s ɑ ɾ s ɑ pʰ ɛ t͡sʰ n ɛ l
սարսափեցնող	s ɑ ɾ s ɑ pʰ ɛ t͡sʰ n ɔ ʁ
սարսափում	s ɑ ɾ s ɑ pʰ u m
սարք	s ɑ ɾ kʰ
սարքավորում	s ɑ ɾ kʰ ɑ v ɔ ɾ u m
սարքել	s ɑ ɾ kʰ ɛ l
սացիվի	s ɑ t͡sʰ i v i
սափոր	s ɑ pʰ ɔ ɾ
սափրել	s ɑ pʰ ɾ ɛ l
սափրիչ	s ɑ pʰ ɾ i t͡ʃʰ
սաքսոֆոն	s ɑ kʰ s ɔ f ɔ n
սաֆարյան	s ɑ f ɑ ɾ j ɑ n
սդ	s ə d ə
սե	s ɛ
սեբեոս	s ɛ b ɛ ɔ s
սեգ	s ɛ ɡ
սեզոն	s ɛ z ɔ n
սեթ	s ɛ tʰ
սելավ	s ɛ l ɑ f
սելեւկիա	s ɛ l ɛ f k j ɑ
սելջուկ	s ɛ l d͡ʒ u k
սելջուկյան	s ɛ l d͡ʒ u k j ɑ n
սեխ	s ɛ χ
սեղան	s ɛ ʁ ɑ n
սեղանապետ	s ɛ ʁ ɑ n ɑ p ɛ t
սեղանատուն	s ɛ ʁ ɑ n ɑ t u n
սեմ	s ɛ m
սեմական	s ɛ m ɑ k ɑ n
սեմերջյան	s ɛ m ɛ ɾ d͡ʒ j ɑ n
սեյրան	s ɛ j ɾ ɑ n
սենատ	s ɛ n ɑ t
սենդվիչ	s ɛ n d v i t͡ʃʰ
սենյակ	s ɛ n j ɑ k
սեուլ	s ɛ u l
սեպ	s ɛ p
սեպագիր	s ɛ p ɑ ɡ i ɾ
սեպուհ	s ɛ p u h
սեպտեմբեր	s ɛ p t ɛ m b ɛ ɾ
սեռ	s ɛ r
սեռի	s ɛ r i
սեսիա	s ɛ s j ɑ
սեր	s ɛ ɾ
սերբ	s ɛ ɾ b
սերբական	s ɛ ɾ b ɑ k ɑ n
սերբիա	s ɛ ɾ b j ɑ
սերգեյ	s ɛ ɾ ɡ ɛ j
սերգո	s ɛ ɾ ɡ ɔ
սերկեւիլ	s ɛ ɾ k ɛ v i l
սերմ	s ɛ ɾ m
սերոժ	s ɛ ɾ ɔ ʒ
սերուցք	s ɛ ɾ u t͡sʰ kʰ
սերտ	s ɛ ɾ t
սեւ	s ɛ v
սեւակ	s ɛ v ɑ k
սեւան	s ɛ v ɑ n
սեփականություն	s ɛ pʰ ɑ k ɑ n u tʰ j u n
սեքս	s ɛ kʰ s
սեքսիզմ	s ɛ kʰ s i z m
սեֆիլյան	s ɛ f i l j ɑ n
սթափ	ə s tʰ ɑ pʰ
սթափվել	ə s tʰ ɑ pʰ v ɛ l
սթենդ	ə s tʰ ɛ n d
սիբիր	s i b i ɾ
սիգար	s i ɡ ɑ ɾ
սիգարետ	s i ɡ ɑ ɾ ɛ t
սիկտիր	s i k t i ɾ
սիմոնյան	s i m ɔ n j ɑ n
սիմվոլ	s i m v ɔ l
սիմվոլիկ	s i m v ɔ l i k
սին	s i n
սինդհի	s i n d h i
սինլքոր	s i n l ə kʰ ɔ ɾ
սինձ	s i n d͡z
սիսակ	s i s ɑ k
սիսեռ	s i s ɛ r
սիստեմ	s i s t ɛ m
սիրած	s i ɾ ɑ t͡s
սիրահար	s i ɾ ɑ h ɑ ɾ
սիրահարվել	s i ɾ ɑ h ɑ ɾ v ɛ l
սիրամարգ	s i ɾ ɑ m ɑ ɾ ɡ
սիրավեպ	s i ɾ ɑ v ɛ p
սիրելի	s i ɾ ɛ l i
սիրեկան	s i ɾ ɛ k ɑ n
սիրիա	s i ɾ j ɑ
սիրո	s i ɾ ɔ
սիրում	s i ɾ u m
սիրուն	s i ɾ u n
սիրվել	s i ɾ v ɛ l
սիրտ	s i ɾ t
սիցիլիա	s i t͡sʰ i l j ɑ
սլայդ	s l ɑ j d
սլավոն	s ə l ɑ v ɔ n
սլավոնական	s l ɑ v ɔ n ɑ k ɑ n
սլովակերեն	s l ɔ v ɑ k ɛ ɾ ɛ n
սլովակիա	s l ɔ v ɑ k j ɑ
սլովեներեն	s l ɔ v ɛ n ɛ ɾ ɛ n
սխալվել	s ə χ ɑ l v ɛ l
սխտոր	s ə χ t ɔ ɾ
սխրանք	s ə χ ɾ ɑ ŋ kʰ
սկանդինավյան	ə s k ɑ n d i n ɑ v j ɑ n
սկաներ	ə s k ɑ n ɛ ɾ
սկավառակ	ə s k ɑ v ɑ r ɑ k
սկեսար	ə s k ɛ s ɑ ɾ
սկեսուր	ə s k ɛ s u ɾ
սկզբնաղբյուր	ə s k ə z b n ɑ χ p j u ɾ
սկզբունքայնություն	ə s k ə z b u ŋ kʰ ɑ j n u tʰ j u n
սկիզբ	ə s k i z b
սկյուռ	ə s k j u r
սկոպյե	ə s k ɔ p j ɛ
սկոռի	ə s k ɔ r i
սկոտչ	ə s k ɔ t t͡ʃʰ
սկումբրիա	ə s k u m b ɾ j ɑ
սկսած	ə s k ə s ɑ t͡s
սղոց	s ə ʁ ɔ t͡sʰ
սմարթֆոն	s m ɑ ɾ tʰ f ɔ n
սմբատ	s ə m b ɑ t
սմբուկ	s ə m b u k
սմեգմա	s m ɛ ɡ m ɑ
սմոլենսկ	s m ɔ l ɛ n s k
սյուն	s j u n
սյունակ	s j u n ɑ k
սյունե	s j u n ɛ
սյունիք	s j u n i kʰ
սնահավատ	s ə n ɑ h ɑ v ɑ t
սնահավատություն	s ə n ɑ h ɑ v ɑ t u tʰ j u n
սնանկանալ	s ə n ɑ ŋ k ɑ n ɑ l
սնանկացում	s ə n ɑ ŋ k ɑ t͡sʰ u m
սնգույր	s ə ŋ ɡ u j ɾ
սնգուրել	s ə ŋ ɡ u ɾ ɛ l
սնդուկ	s ə n d u k
սննդակարգ	s ə n ə n d ɑ k ɑ ɾ kʰ
սննդամթերք	s ə n ə n d ɑ m ə tʰ ɛ ɾ kʰ
սննկանալ	s ə n ə ŋ k ɑ n ɑ l
սնոտի	s ə n ɔ t i
սնուցում	s ə n u t͡sʰ u m
սոխ	s ɔ χ
սոխակ	s ɔ χ ɑ k
սոխուկ	s ɔ χ u k
սոկրատես	s ɔ k ɾ ɑ t ɛ s
սողալ	s ɔ ʁ ɑ l
սողոմոն	s ɔ ʁ ɔ m ɔ n
սողոմոնյան	s ɔ ʁ ɔ m ɔ n j ɑ n
սողուն	s ɔ ʁ u n
սոճի	s ɔ t͡ʃ i
սոնա	s ɔ n ɑ
սոնիճ	s ɔ n i t͡ʃ
սոուլ	s ɔ u l
սոուս	s ɔ u s
սոջու	s ɔ d͡ʒ u
սոսի	s ɔ s i
սոսինձ	s ɔ s i n d͡z
սով	s ɔ v
սովալլուկ	s ɔ v ɑ lː u k
սոված	s ɔ v ɑ t͡s
սովամահ	s ɔ v ɑ m ɑ h
սովետական	s ɔ v ɛ t ɑ k ɑ n
սովոր	s ɔ v ɔ ɾ
սովորաբար	s ɔ v ɔ ɾ ɑ b ɑ ɾ
սովորական	s ɔ v ɔ ɾ ɑ k ɑ n
սովորել	s ɔ v ɔ ɾ ɛ l
սովորեցնել	s ɔ v ɔ ɾ ɛ t͡sʰ n ɛ l
սովորություն	s ɔ v ɔ ɾ u tʰ j u n
սորբոն	s ɔ ɾ b ɔ n
սորգո	s ɔ ɾ ɡ ɔ
սորոս	s ɔ ɾ ɔ s
սոցիալական	s ɔ t͡sʰ j ɑ l ɑ k ɑ n
սոցիոլոգիա	s ɔ t͡sʰ j ɔ l ɔ ɡ j ɑ
սոցցանց	s ɔ t͡sʰː ɑ n t͡sʰ
սուգ	s u kʰ
սուդան	s u d ɑ n
սուզանավ	s u z ɑ n ɑ v
սուզել	s u z ɛ l
սուզվել	s u z v ɛ l
սուլել	s u l ɛ l
սուլթան	s u l tʰ ɑ n
սուլուգունի	s u l u ɡ u n i
սուխում	s u χ u m
սուխումի	s u χ u m i
սուղ	s u ʁ
սումո	s u m ɔ
սույն	s u j n
սուշի	s u ʃ i
սուչավա	s u t͡ʃʰ ɑ v ɑ
սուպերմարկետ	s u p ɛ ɾ m ɑ ɾ k ɛ t
սուս	s u s
սուսեր	s u s ɛ ɾ
սուսուփուս	s u s u pʰ u s
սուտ	s u t
սուտակ	s u t ɑ k
սուտասան	s u t ɑ s ɑ n
սուր	s u ɾ
սուրամի	s u ɾ ɑ m i
սուրեն	s u ɾ ɛ n
սուրճ	s u ɾ t͡ʃ
սոֆիա	s ɔ f i ɑ
սպա	ə s p ɑ
սպանախ	ə s p ɑ n ɑ χ
սպանդ	ə s p ɑ n d
սպանդանոց	ə s p ɑ n d ɑ n ɔ t͡sʰ
սպանել	ə s p ɑ n ɛ l
սպանիա	ə s p ɑ n j ɑ
սպանվել	ə s p ɑ n v ɛ l
սպառազինության	ə s p ɑ r ɑ z i n u tʰ j ɑ n
սպառազինություն	ə s p ɑ r ɑ z i n u tʰ j u n
սպառազինությունների	ə s p ɑ r ɑ z i n u tʰ j u nː ɛ ɾ i
սպառնալիք	ə s p ɑ r n ɑ l i kʰ
սպառող	ə s p ɑ r ɔ ʁ
սպասավոր	ə s p ɑ s ɑ v ɔ ɾ
սպասարկել	ə s p ɑ s ɑ ɾ k ɛ l
սպասարկիչ	ə s p ɑ s ɑ ɾ k i t͡ʃʰ
սպասել	ə s p ɑ s ɛ l
սպասք	ə s p ɑ s kʰ
սպարապետ	ə s p ɑ ɾ ɑ p ɛ t
սպը	s ə p ə ə
սպի	ə s p i
սպիտակ	ə s p i t ɑ k
սպիտակաձյունիկ	ə s p i t ɑ k ɑ d͡z j u n i k
սպիտակամորթ	ə s p i t ɑ k ɑ m ɔ ɾ tʰ
սպիտակավուն	ə s p i t ɑ k ɑ v u n
սպիտակուց	ə s p i t ɑ k u t͡sʰ
սպիրտ	ə s p i ɾ t
սպորտ	ə s p ɔ ɾ t
սպունգ	ə s p u ŋ ɡ
սսկվել	s ə s k v ɛ l
սսհ	s ə s ə h ə
սվին	s ə v i n
սվիտեր	s v i t ɛ ɾ
ստադիոն	ə s t ɑ d i ɔ n
ստալին	ə s t ɑ l i n
ստամբակ	ə s t ɑ m b ɑ k
ստամոքս	ə s t ɑ m ɔ kʰ s
ստանալ	ə s t ɑ n ɑ l
ստանդարտ	ə s t ɑ n d ɑ ɾ t
ստավրոպոլ	ə s t ɑ v ɾ ɔ p ɔ l
ստատիստիկա	ə s t ɑ t i s t i k ɑ
ստատուս	ə s t ɑ t u s
ստարտափ	ə s t ɑ ɾ t ɑ pʰ
ստացող	ə s t ɑ t͡sʰ ɔ ʁ
ստել	s ə t ɛ l
ստեղծագործություն	ə s t ɛ χ t͡s ɑ ɡ ɔ ɾ t͡s u tʰ j u n
ստեղծել	ə s t ɛ χ t͡s ɛ l
ստեղծիչ	ə s t ɛ χ t͡s i t͡ʃʰ
ստեղն	ə s t ɛ ʁ ə n
ստեղնաշար	ə s t ɛ ʁ n ɑ ʃ ɑ ɾ
ստենդ	ə s t ɛ n d
ստենտ	ə s t ɛ n t
ստեպ	ə s t ɛ p
ստեպղին	ə s t ɛ p ʁ i n
ստերջ	ə s t ɛ ɾ d͡ʒ
ստեփան	ə s t ɛ pʰ ɑ n
ստեփանակերտ	ə s t ɛ pʰ ɑ n ɑ k ɛ ɾ t
ստեփանյան	ə s t ɛ pʰ ɑ n j ɑ n
ստին	ə s t i n
ստինք	ə s t i ŋ kʰ
ստիպել	ə s t i p ɛ l
ստոծանի	ə s t ɔ t͡s ɑ n i
ստոկհոլմ	ə s t ɔ k h ɔ l m
ստորաբաժանում	ə s t ɔ ɾ ɑ b ɑ ʒ ɑ n u m
ստորագրել	ə s t ɔ ɾ ɑ ɡ ɾ ɛ l
ստորակետ	ə s t ɔ ɾ ɑ k ɛ t
ստորացնել	ə s t ɔ ɾ ɑ t͡sʰ ə n ɛ l
ստորացում	ə s t ɔ ɾ ɑ t͡sʰ u m
ստորացվել	ə s t ɔ ɾ ɑ t͡sʰ v ɛ l
ստորգետնյա	ə s t ɔ ɾ ɡ ɛ t n j ɑ
ստուգաբանություն	ə s t u ɡ ɑ b ɑ n u tʰ j u n
ստուգաթերթ	ə s t u ɡ ɑ tʰ ɛ ɾ tʰ
ստուգել	ə s t u ɡ ɛ l
ստուգում	ə s t u ɡ u m
ստուդիա	ə s t u d j ɑ
ստվար	ə s t ə v ɑ ɾ
ստվարաթիվ	ə s t ə v ɑ ɾ ɑ tʰ i v
ստվարաթղթե	ə s t ə v ɑ ɾ ɑ tʰ ə χ tʰ ɛ
ստվարաթուղթ	ə s t ə v ɑ ɾ ɑ tʰ u χ tʰ
ստվարածավալ	ə s t ə v ɑ ɾ ɑ t͡s ɑ v ɑ l
ստվեր	ə s t ə v ɛ ɾ
ստրատեգիա	ə s t ɾ ɑ t ɛ ɡ j ɑ
ստրկություն	ə s t ə ɾ k u tʰ j u n
ստրուկ	ə s t ɾ u k
սրածայր	s ə ɾ ɑ t͡s ɑ j ɾ
սրահ	s ə ɾ ɑ h
սրանք	s ə ɾ ɑ ŋ kʰ
սրբազան	s ə ɾ pʰ ɑ z ɑ n
սրբանային	s ə ɾ pʰ ɑ n ɑ j i n
սրբապղծություն	s ə ɾ pʰ ɑ p ə χ t͡s u tʰ j u n
սրբել	s ə ɾ pʰ ɛ l
սրբիչ	s ə ɾ pʰ i t͡ʃʰ
սրբուհի	s ə ɾ pʰ u h i
սրել	s ə ɾ ɛ l
սրճաղաց	s ə ɾ t͡ʃ ɑ ʁ ɑ t͡sʰ
սրճաստան	s ə ɾ t͡ʃ ɑ s t ɑ n
սրճարան	s ə ɾ t͡ʃ ɑ ɾ ɑ n
սրճարանատեր	s ə ɾ t͡ʃ ɑ ɾ ɑ n ɑ t ɛ ɾ
սրճարար	s ə ɾ t͡ʃ ɑ ɾ ɑ ɾ
սրճել	s ə ɾ t͡ʃ ɛ l
սրճենի	s ə ɾ t͡ʃ ɛ n i
սրճիտ	s ə ɾ t͡ʃ i t
սրնքամիս	s ə ɾ ə ŋ kʰ ɑ m i s
սրված	s ə ɾ v ɑ t͡s
սրվել	s ə ɾ v ɛ l
սրտաբան	s ə ɾ t ɑ b ɑ n
սրտային	s ə ɾ t ɑ j i n
սրտանց	s ə ɾ t ɑ n t͡sʰ
սրտաշարժ	s ə ɾ t ɑ ʃ ɑ ɾ ʒ
սրտաշարժաբար	s ə ɾ t ɑ ʃ ɑ ɾ ʒ ɑ b ɑ ɾ
սրտառուչ	s ə ɾ t ɑ r u t͡ʃʰ
սցենար	ə s t͡sʰ ɛ n ɑ ɾ
սցենարիստ	ə s t͡sʰ ɛ n ɑ ɾ i s t
սփյուռք	ə s pʰ j u r kʰ
սփոփել	ə s pʰ ɔ pʰ ɛ l
սփոփվել	ə s pʰ ɔ pʰ v ɛ l
սփռել	s ə pʰ r ɛ l
սքանչելի	ə s kʰ ɑ n t͡ʃʰ ɛ l i
վագոն	v ɑ ɡ ɔ n
վագր	v ɑ ɡ ə ɾ
վադուց	v ɑ d u t͡sʰ
վազ	v ɑ z
վազգեն	v ɑ z ɡ ɛ n
վազել	v ɑ z ɛ l
վազվզել	v ɑ z v ə z ɛ l
վազք	v ɑ s kʰ
վալիզ	v ɑ l i z
վալս	v ɑ l s
վախ	v ɑ χ
վախկոտ	v ɑ χ k ɔ t
վախճան	v ɑ χ t͡ʃ ɑ n
վախճանական	v ɑ χ t͡ʃ ɑ n ɑ k ɑ n
վակուում	v ɑ k u u m
վահագ	v ɑ h ɑ ɡ
վահագն	v ɑ h ɑ ɡ ə n
վահան	v ɑ h ɑ n
վահանագեղձ	v ɑ h ɑ n ɑ ɡ ɛ ʁ d͡z
վահե	v ɑ h ɛ
վաղ	v ɑ ʁ
վաղարշ	v ɑ ʁ ɑ ɾ ʃ
վաղարշակ	v ɑ ʁ ɑ ɾ ʃ ɑ k
վաղը	v ɑ ʁ ə
վաղն	v ɑ ʁ n
վաղորդյան	v ɑ ʁ ɔ ɾ tʰ j ɑ n
վաճառական	v ɑ t͡ʃ ɑ r ɑ k ɑ n
վաճառատեղի	v ɑ t͡ʃ ɑ r ɑ t ɛ ʁ i
վաճառել	v ɑ t͡ʃ ɑ r ɛ l
վաճառք	v ɑ t͡ʃ ɑ r kʰ
վայ	v ɑ j
վայել	v ɑ j ɛ l
վայելել	v ɑ j ɛ l ɛ l
վայելուչ	v ɑ j ɛ l u t͡ʃʰ
վայելք	v ɑ j ɛ l kʰ
վայմար	v ɑ j m ɑ ɾ
վայր	v ɑ j ɾ
վայրագ	v ɑ j ɾ ɑ ɡ
վայրենի	v ɑ j ɾ ɛ n i
վայրենություն	v ɑ j ɾ ɛ n u tʰ j u n
վայրի	v ɑ j ɾ i
վայք	v ɑ j kʰ
վանադիում	v ɑ n ɑ d i j u m
վանական	v ɑ n ɑ k ɑ n
վանաձոր	v ɑ n ɑ d͡z ɔ ɾ
վանդեա	v ɑ n d ɛ j ɑ
վանկ	v ɑ ŋ k
վանկարկել	v ɑ ŋ k ɑ ɾ k ɛ l
վանկարկում	v ɑ ŋ k ɑ ɾ k u m
վաննա	v ɑ nː ɑ
վանո	v ɑ n ɔ
վանք	v ɑ ŋ kʰ
վաշինգտոն	v ɑ ʃ i ŋ ɡ t ɔ n
վաշտ	v ɑ ʃ t
վաչագան	v ɑ t͡ʃʰ ɑ ɡ ɑ n
վաչե	v ɑ t͡ʃʰ ɛ
վառել	v ɑ r ɛ l
վառելափայտ	v ɑ r ɛ l ɑ pʰ ɑ j t
վառելիք	v ɑ r ɛ l i kʰ
վառոդ	v ɑ r ɔ tʰ
վառվել	v ɑ r v ɛ l
վասալ	v ɑ s ɑ l
վասակ	v ɑ s ɑ k
վասիլ	v ɑ s i l
վաստակ	v ɑ s t ɑ k
վաստակել	v ɑ s t ɑ k ɛ l
վավեր	v ɑ v ɛ ɾ
վավերացում	v ɑ v ɛ ɾ ɑ t͡sʰ u m
վատ	v ɑ t
վատթար	v ɑ tʰː ɑ ɾ
վատթարագույն	v ɑ tʰː ɑ ɾ ɑ ɡ u j n
վարագույր	v ɑ ɾ ɑ kʰ u j ɾ
վարազ	v ɑ ɾ ɑ z
վարակ	v ɑ ɾ ɑ k
վարանում	v ɑ ɾ ɑ n u m
վարանք	v ɑ ɾ ɑ ŋ kʰ
վարդան	v ɑ ɾ tʰ ɑ n
վարդապետ	v ɑ ɾ tʰ ɑ p ɛ t
վարդենի	v ɑ ɾ tʰ ɛ n i
վարդենիս	v ɑ ɾ tʰ ɛ n i s
վարել	v ɑ ɾ ɛ l
վարժ	v ɑ ɾ ʒ
վարժարան	v ɑ ɾ ʒ ɑ ɾ ɑ n
վարիչ	v ɑ ɾ i t͡ʃʰ
վարկ	v ɑ ɾ k
վարկած	v ɑ ɾ k ɑ t͡s
վարկանիշ	v ɑ ɾ k ɑ n i ʃ
վարկերի	v ɑ ɾ k ɛ ɾ i
վարձ	v ɑ ɾ t͡sʰ
վարձկան	v ɑ ɾ t͡sʰ k ɑ n
վարյագ	v ɑ ɾ j ɑ ɡ
վարորդ	v ɑ ɾ ɔ ɾ tʰ
վարչական	v ɑ ɾ t͡ʃʰ ɑ k ɑ n
վարչապետ	v ɑ ɾ t͡ʃʰ ɑ p ɛ t
վարպետության	v ɑ ɾ p ɛ t u tʰ j ɑ n
վարպետություն	v ɑ ɾ p ɛ t u tʰ j u n
վարսակաշիլա	v ɑ ɾ s ɑ k ɑ ʃ i l ɑ
վարսավիր	v ɑ ɾ s ɑ v i ɾ
վարսավիրանոց	v ɑ ɾ s ɑ v i ɾ ɑ n ɔ t͡sʰ
վարվառա	v ɑ ɾ v ɑ r ɑ
վարվել	v ɑ ɾ v ɛ l
վարք	v ɑ ɾ kʰ
վարքականոն	v ɑ ɾ kʰ ɑ k ɑ n ɔ n
վեզիր	v ɛ z i ɾ
վեզուվ	v ɛ z u v
վելինգտոն	v ɛ l i ŋ ɡ t ɔ n
վեհ	v ɛ h
վեղար	v ɛ ʁ ɑ ɾ
վեճ	v ɛ t͡ʃ
վեմ	v ɛ m
վենդետա	v ɛ n d ɛ t ɑ
վենետիկ	v ɛ n ɛ t i k
վենետիկյան	v ɛ n ɛ t i k j ɑ n
վենետիկցի	v ɛ n ɛ t i k t͡sʰ i
վեպ	v ɛ p
վեվ	v ɛ v
վերադառնալ	v ɛ ɾ ɑ d ɑ r n ɑ l
վերադարձ	v ɛ ɾ ɑ d ɑ ɾ t͡sʰ
վերազգային	v ɛ ɾ ɑ z ɡ ɑ j i n
վերականգնում	v ɛ ɾ ɑ k ɑ ŋ ɡ n u m
վերակառուցում	v ɛ ɾ ɑ k ɑ r u t͡sʰ u m
վերահաս	v ɛ ɾ ɑ h ɑ s
վերամբարձ	v ɛ ɾ ɑ m b ɑ ɾ t͡sʰ
վերանալ	v ɛ ɾ ɑ n ɑ l
վերանորոգել	v ɛ ɾ ɑ n ɔ ɾ ɔ kʰ ɛ l
վերարկու	v ɛ ɾ ɑ ɾ k u
վերարտադրություն	v ɛ ɾ ɑ ɾ t ɑ d ɾ u tʰ j u n
վերացական	v ɛ ɾ ɑ t͡sʰ ɑ k ɑ n
վերաքննիչ	v ɛ ɾ ɑ kʰ ə nː i t͡ʃʰ
վերելակ	v ɛ ɾ ɛ l ɑ k
վերընթերցել	v ɛ ɾ ə n tʰ ɛ ɾ t͡sʰ ɛ l
վերլուծական	v ɛ ɾ l u t͡s ɑ k ɑ n
վերլուծություն	v ɛ ɾ l u t͡s u tʰ j u n
վերծանել	v ɛ ɾ t͡s ɑ n ɛ l
վերմակ	v ɛ ɾ m ɑ k
վերմակասավան	v ɛ ɾ m ɑ k ɑ s ɑ v ɑ n
վերմիշել	v ɛ ɾ m i ʃ ɛ l
վերմուտ	v ɛ ɾ m u t
վերնախավ	v ɛ ɾ n ɑ χ ɑ v
վերնաշապիկ	v ɛ ɾ n ɑ ʃ ɑ p i k
վերուվար	v ɛ ɾ u v ɑ ɾ
վերջ	v ɛ ɾ t͡ʃʰ
վերջաբան	v ɛ ɾ t͡ʃʰ ɑ b ɑ n
վերջանալի	v ɛ ɾ t͡ʃʰ ɑ n ɑ l i
վերջանալիք	v ɛ ɾ t͡ʃʰ ɑ n ɑ l i kʰ
վերջապահ	v ɛ ɾ t͡ʃʰ ɑ p ɑ h
վերջապես	v ɛ ɾ t͡ʃʰ ɑ p ɛ s
վերջավոր	v ɛ ɾ t͡ʃʰ ɑ v ɔ ɾ
վերջափակել	v ɛ ɾ t͡ʃʰ ɑ pʰ ɑ k ɛ l
վերջի	v ɛ ɾ t͡ʃʰ i
վերջին	v ɛ ɾ t͡ʃʰ i n
վերջիվերջո	v ɛ ɾ t͡ʃʰ i v ɛ ɾ t͡ʃʰ ɔ
վերջնագիր	v ɛ ɾ t͡ʃʰ n ɑ ɡ i ɾ
վերջնախաղ	v ɛ ɾ t͡ʃʰ n ɑ χ ɑ ʁ
վերջնական	v ɛ ɾ t͡ʃʰ n ɑ k ɑ n
վերջնականապես	v ɛ ɾ t͡ʃʰ n ɑ k ɑ n ɑ p ɛ s
վերջնականորեն	v ɛ ɾ t͡ʃʰ n ɑ k ɑ n ɔ ɾ ɛ n
վերջնակետ	v ɛ ɾ t͡ʃʰ n ɑ k ɛ t
վերջնակետային	v ɛ ɾ t͡ʃʰ n ɑ k ɛ t ɑ j i n
վերջնահաս	v ɛ ɾ t͡ʃʰ n ɑ h ɑ s
վերջնամշակում	v ɛ ɾ t͡ʃʰ n ɑ m ə ʃ ɑ k u m
վերջնանպատակ	v ɛ ɾ t͡ʃʰ n ɑ n ə p ɑ t ɑ k
վերջնավանկային	v ɛ ɾ t͡ʃʰ n ɑ v ɑ ŋ k ɑ j i n
վերջնավարտ	v ɛ ɾ t͡ʃʰ n ɑ v ɑ ɾ t
վերստ	v ɛ ɾ s t
վերցնել	v ɛ ɾ t͡sʰ n ɛ l
վերք	v ɛ ɾ kʰ
վեց	v ɛ t͡sʰ
վեցերորդ	v ɛ t͡sʰ ɛ ɾ ɔ ɾ tʰ
վթար	v ə tʰ ɑ ɾ
վիգեն	v i ɡ ɛ n
վիեննա	v i j ɛ nː ɑ
վիետնամ	v j ɛ t n ɑ m
վիետնամերեն	v j ɛ t n ɑ m ɛ ɾ ɛ n
վիետնամցի	v j ɛ t n ɑ m t͡sʰ i
վիզ	v i z
վիզա	v i z ɑ
վիժանուտ	v i ʒ ɑ n u t
վիլնյուս	v i l n j u s
վիկի	v i k i
վիկտոր	v i k t ɔ ɾ
վիճաբանել	v i t͡ʃ ɑ b ɑ n ɛ l
վիճակ	v i t͡ʃ ɑ k
վիճակագրական	v i t͡ʃ ɑ k ɑ ɡ ɾ ɑ k ɑ n
վիճակախաղ	v i t͡ʃ ɑ k ɑ χ ɑ ʁ
վիճարկել	v i t͡ʃ ɑ ɾ k ɛ l
վին	v i n
վիշապ	v i ʃ ɑ p
վիշի	v i ʃ i
վիշտ	v i ʃ t
վիրաբուժություն	v i ɾ ɑ b u ʒ u tʰ j u n
վիրակապ	v i ɾ ɑ k ɑ p
վիրավոր	v i ɾ ɑ v ɔ ɾ
վիրուս	v i ɾ u s
վիրք	v i ɾ kʰ
վիքի	v i kʰ i
վիքիպեդիա	v i kʰ i p ɛ d j ɑ
վլադիմիր	v l ɑ d i m i ɾ
վլադիսլավ	v l ɑ d i s l ɑ v
վլադիվոստոկ	v l ɑ d i v ɔ s t ɔ k
վլաստ	v ə l ɑ s t
վխտալ	v ə χ t ɑ l
վկա	v ə k ɑ
վկայական	v ə k ɑ j ɑ k ɑ n
վկայել	v ə k ɑ j ɛ l
վկայություն	v ə k ɑ j u tʰ j u n
վհատ	v ə h ɑ t
վհատեցնող	v ə h ɑ t ɛ t͡sʰ n ɔ ʁ
վհատեցուցիչ	v ə h ɑ t ɛ t͡sʰ u t͡sʰ i t͡ʃʰ
վհատորեն	v ə h ɑ t ɔ ɾ ɛ n
վհատություն	v ə h ɑ t u tʰ j u n
վհատված	v ə h ɑ t v ɑ t͡s
վհուկ	v ə h u k
վճար	v ə t͡ʃ ɑ ɾ
վճարել	v ə t͡ʃ ɑ ɾ ɛ l
վճռական	v ə t͡ʃ r ɑ k ɑ n
վճռականություն	v ə t͡ʃ r ɑ k ɑ n u tʰ j u n
վճռել	v ə t͡ʃ r ɛ l
վյուն	v j u n
վնասաբեր	v ə n ɑ s ɑ b ɛ ɾ
վնասակար	v ə n ɑ s ɑ k ɑ ɾ
վնասարար	v ə n ɑ s ɑ ɾ ɑ ɾ
վնասել	v ə n ɑ s ɛ l
վնասված	v ə n ɑ s v ɑ t͡s
վնասվածք	v ə n ɑ s v ɑ t͡s kʰ
վնասվել	v ə n ɑ s v ɛ l
վշտանալ	v ə ʃ t ɑ n ɑ l
վոլգա	v ɔ l ɡ ɑ
վոլգոգրադ	v ɔ l ɡ ɔ ɡ ɾ ɑ d
վոլեյբոլ	v ɔ l ɛ j b ɔ l
վորկուտա	v ɔ ɾ k u t ɑ
վուշ	v u ʃ
վռազ	v ə r ɑ z
վռամ	v ə r ɑ m
վռամշապուհ	v ə r ɑ m ʃ ɑ p u h
վռնդել	v ə r ə n d ɛ l
վստահելի	v ə s t ɑ h ɛ l i
վտանգ	v ə t ɑ ŋ ɡ
վտանգավոր	v ə t ɑ ŋ ɡ ɑ v ɔ ɾ
վտանգել	v ə t ɑ ŋ ɡ ɛ l
վտանգում	v ə t ɑ ŋ ɡ u m
վտանգվել	v ə t ɑ ŋ ɡ v ɛ l
վտարանդի	v ə t ɑ ɾ ɑ n d i
վտարում	v ə t ɑ ɾ u m
վտիտ	v ə t i t
վրա	v ə ɾ ɑ
վրաերթ	v ə ɾ ɑ j ɛ ɾ tʰ
վրան	v ə ɾ ɑ n
վրաստան	v ə ɾ ɑ s t ɑ n
վրաց	v ə ɾ ɑ t͡sʰ
վրացական	v ə ɾ ɑ t͡sʰ ɑ k ɑ n
վրդովել	v ə ɾ tʰ ɔ v ɛ l
վրդովվել	v ə ɾ tʰ ɔ vː ɛ l
վրեժ	v ə ɾ ɛ ʒ
վրթանես	v ə ɾ tʰ ɑ n ɛ s
վրիպակ	v ə ɾ i p ɑ k
վրձին	v ə ɾ t͡sʰ i n
տաբատ	t ɑ b ɑ t
տաբու	t ɑ b u
տագալերեն	t ɑ ɡ ɑ l ɛ ɾ ɛ n
տագերկին	t ɑ kʰ ɛ ɾ k i n
տագնապ	t ɑ ɡ n ɑ p
տագր	t ɑ kʰ ə ɾ
տաթեւ	t ɑ tʰ ɛ v
տաթեւիկ	t ɑ tʰ ɛ v i k
տալ	t ɑ l
տախտակ	t ɑ χ t ɑ k
տախտակամած	t ɑ χ t ɑ k ɑ m ɑ t͡s
տակ	t ɑ k
տակառ	t ɑ k ɑ r
տակնուվրա	t ɑ k n u v ə ɾ ɑ
տակտիկա	t ɑ k t i k ɑ
տահիտի	t ɑ h i t i
տաղանդավոր	t ɑ ʁ ɑ n d ɑ v ɔ ɾ
տաղլյան	t ɑ ʁ l j ɑ n
տաղտուկ	t ɑ χ t u k
տաճատ	t ɑ t͡ʃ ɑ t
տաճար	t ɑ t͡ʃ ɑ ɾ
տամբով	t ɑ m b ɔ v
տանգո	t ɑ ŋ ɡ ɔ
տանել	t ɑ n ɛ l
տանզանիա	t ɑ n z ɑ n j ɑ
տանը	t ɑ n ə
տանիք	t ɑ n i kʰ
տանձ	t ɑ n d͡z
տանուտեր	t ɑ n u t ɛ ɾ
տանտեր	t ɑ n t ɛ ɾ
տանտիկին	t ɑ n t i k i n
տանտիրուհի	t ɑ n t i ɾ u h i
տաշտ	t ɑ ʃ t
տաշքենդ	t ɑ ʃ kʰ ɛ n d
տապ	t ɑ p
տապալել	t ɑ p ɑ l ɛ l
տապակ	t ɑ p ɑ k
տապակել	t ɑ p ɑ k ɛ l
տապար	t ɑ p ɑ ɾ
տաջիկստան	t ɑ d͡ʒ i k s t ɑ n
տառ	t ɑ r
տառադարձել	t ɑ r ɑ d ɑ ɾ t͡sʰ ɛ l
տառադարձություն	t ɑ r ɑ d ɑ ɾ t͡sʰ u tʰ j u n
տառապանք	t ɑ r ɑ p ɑ ŋ kʰ
տառապել	t ɑ r ɑ p ɛ l
տառասխալ	t ɑ r ɑ s ə χ ɑ l
տառատեսակ	t ɑ r ɑ t ɛ s ɑ k
տառեղ	t ɑ r ɛ ʁ
տաս	t ɑ s
տասը	t ɑ s ə
տասնամյակ	t ɑ s n ɑ m j ɑ k
տասներեք	t ɑ s n ɛ ɾ ɛ kʰ
տասներկու	t ɑ s n ɛ ɾ k u
տասնինը	t ɑ s n i n ə
տասնհինգ	t ɑ s n ə h i ŋ ɡ
տասնչորս	t ɑ s n ə t͡ʃʰ ɔ ɾ s
տասնվեց	t ɑ s n ə v ɛ t͡sʰ
տավար	t ɑ v ɑ ɾ
տավիղ	t ɑ v i ʁ
տավուշ	t ɑ v u ʃ
տավրոս	t ɑ v ɾ ɔ s
տատ	t ɑ t
տատասկ	t ɑ t ɑ s k
տատի	t ɑ t i
տատմեր	t ɑ t m ɛ ɾ
տար	t ɑ ɾ
տարա	t ɑ ɾ ɑ
տարադրամի	t ɑ ɾ ɑ d ə ɾ ɑ m i
տարածաշրջան	t ɑ ɾ ɑ t͡s ɑ ʃ ə ɾ d͡ʒ ɑ n
տարածաշրջանային	t ɑ ɾ ɑ t͡s ɑ ʃ ə ɾ d͡ʒ ɑ n ɑ j i n
տարածել	t ɑ ɾ ɑ t͡s ɛ l
տարածված	t ɑ ɾ ɑ t͡s v ɑ t͡s
տարածք	t ɑ ɾ ɑ t͡s kʰ
տարակույս	t ɑ ɾ ɑ k u j s
տարակուսել	t ɑ ɾ ɑ k u s ɛ l
տարամիտել	t ɑ ɾ ɑ m i t ɛ l
տարատեսակ	t ɑ ɾ ɑ t ɛ s ɑ k
տարբերակ	t ɑ ɾ b ɛ ɾ ɑ k
տարբերել	t ɑ ɾ b ɛ ɾ ɛ l
տարբերություն	t ɑ ɾ b ɛ ɾ u tʰ j u n
տարեդարձ	t ɑ ɾ ɛ d ɑ ɾ t͡sʰ
տարեկան	t ɑ ɾ ɛ k ɑ n
տարենտ	t ɑ ɾ ɛ n t
տարերք	t ɑ ɾ ɛ ɾ kʰ
տարեց	t ɑ ɾ ɛ t͡sʰ
տարի	t ɑ ɾ i
տարիք	t ɑ ɾ i kʰ
տարկետում	t ɑ ɾ k ɛ t u m
տարողություն	t ɑ ɾ ɔ ʁ u tʰ j u n
տարսոն	t ɑ ɾ s ɔ n
տարվել	t ɑ ɾ v ɛ l
տարտամ	t ɑ ɾ t ɑ m
տարր	t ɑ ɾː
տարրական	t ɑ ɾː ɑ k ɑ n
տարօրինակ	t ɑ ɾ ɔ ɾ i n ɑ k
տափաստան	t ɑ pʰ ɑ s t ɑ n
տափաստանային	t ɑ pʰ ɑ s t ɑ n ɑ j i n
տաք	t ɑ kʰ
տաքդեղ	t ɑ kʰ d ɛ ʁ
տաքություն	t ɑ kʰ u tʰ j u n
տաքսի	t ɑ kʰ s i
տգետ	t ə ɡ ɛ t
տգիտություն	t ə ɡ i t u tʰ j u n
տեգերակին	t ɛ kʰ ɛ ɾ ɑ k i n
տելուր	t ɛ l u ɾ
տեխնիկա	t ɛ χ n i k ɑ
տեխնոլոգիա	t ɛ χ n ɔ l ɔ ɡ j ɑ
տեխնոպարկ	t ɛ χ n ɔ p ɑ ɾ k
տեկիլա	t ɛ k i l ɑ
տեղ	t ɛ ʁ
տեղադրում	t ɛ ʁ ɑ d ɾ u m
տեղակալ	t ɛ ʁ ɑ k ɑ l
տեղաճարակ	t ɛ ʁ ɑ t͡ʃ ɑ ɾ ɑ k
տեղանուն	t ɛ ʁ ɑ n u n
տեղանք	t ɛ ʁ ɑ ŋ kʰ
տեղաշարժել	t ɛ ʁ ɑ ʃ ɑ ɾ ʒ ɛ l
տեղատվություն	t ɛ ʁ ɑ t v u tʰ j u n
տեղափոխել	t ɛ ʁ ɑ pʰ ɔ χ ɛ l
տեղեկանալ	t ɛ ʁ ɛ k ɑ n ɑ l
տեղեկատու	t ɛ ʁ ɛ k ɑ t u
տեղեկացնել	t ɛ ʁ ɛ k ɑ t͡sʰ n ɛ l
տեղեկություն	t ɛ ʁ ɛ k u tʰ j u n
տեղի	t ɛ ʁ i
տեղիք	t ɛ ʁ i kʰ
տեղյակ	t ɛ ʁ j ɑ k
տենդ	t ɛ n d
տեռորիստ	t ɛ r ɔ ɾ i s t
տեսախցիկ	t ɛ s ɑ χ ə t͡sʰ i k
տեսակ	t ɛ s ɑ k
տեսական	t ɛ s ɑ k ɑ n
տեսականորեն	t ɛ s ɑ k ɑ n ɔ ɾ ɛ n
տեսակետ	t ɛ s ɑ k ɛ t
տեսահոլովակ	t ɛ s ɑ h ɔ l ɔ v ɑ k
տեսանելի	t ɛ s ɑ n ɛ l i
տեսանյութ	t ɛ s ɑ n j u tʰ
տեսարան	t ɛ s ɑ ɾ ɑ n
տեսարժան	t ɛ s ɑ ɾ ʒ ɑ n
տեսիլ	t ɛ s i l
տեսիլք	t ɛ s i l kʰ
տեսլական	t ɛ s l ɑ k ɑ n
տեսնալ	t ɛ s n ɑ l
տեսնել	t ɛ s n ɛ l
տեսողություն	t ɛ s ɔ ʁ u tʰ j u n
տեսք	t ɛ s kʰ
տետր	t ɛ t ə ɾ
տեր	t ɛ ɾ
տերեւ	t ɛ ɾ ɛ v
տերմին	t ɛ ɾ m i n
տերություն	t ɛ ɾ u tʰ j u n
տերունի	t ɛ ɾ u n i
տեւ	t ɛ v
տեւողություն	t ɛ v ɔ ʁ u tʰ j u n
տզրուկ	t ə z ɾ u k
տժվժալ	t ə ʒ v ə ʒ ɑ l
տի	t i
տիբեթ	t i b ɛ tʰ
տիբեթական	t i b ɛ tʰ ɑ k ɑ n
տիբեթերեն	t i b ɛ tʰ ɛ ɾ ɛ n
տիբեր	t i b ɛ ɾ
տիբերիոս	t i b ɛ ɾ i ɔ s
տիգրան	t i ɡ ɾ ɑ n
տիգրանուհի	t i ɡ ɾ ɑ n u h i
տիեզերանավ	t j ɛ z ɛ ɾ ɑ n ɑ v
տիզ	t i z
տիզբոն	t i z b ɔ n
տիկ	t i k
տիկին	t i k i n
տիկնիկ	t i k n i k
տիկնիկային	t i k n i k ɑ j i n
տիմոթեոս	t i m ɔ tʰ ɛ ɔ s
տիպաբանական	t i p ɑ b ɑ n ɑ k ɑ n
տիվ	t i v
տիրան	t i ɾ ɑ n
տիրանա	t i ɾ ɑ n ɑ
տիրապետել	t i ɾ ɑ p ɛ t ɛ l
տիրապետում	t i ɾ ɑ p ɛ t u m
տիրացու	t i ɾ ɑ t͡sʰ u
տիրել	t i ɾ ɛ l
տիք	t i kʰ
տխմար	t ə χ m ɑ ɾ
տխուր	t ə χ u ɾ
տխրություն	t ə χ ɾ u tʰ j u n
տկար	t ə k ɑ ɾ
տկլոր	t ə k l ɔ ɾ
տհաճ	t ə h ɑ t͡ʃ
տհաս	t ə h ɑ s
տղա	t ə ʁ ɑ
տղամարդ	t ə ʁ ɑ m ɑ ɾ tʰ
տղամարդիկ	t ə ʁ ɑ m ɑ ɾ tʰ i k
տմարդի	t ə m ɑ ɾ tʰ i
տնակ	t ə n ɑ k
տնական	t ə n ɑ k ɑ n
տնային	t ə n ɑ j i n
տնտեսական	t ə n t ɛ s ɑ k ɑ n
տնտեսություն	t ə n t ɛ s u tʰ j u n
տնփեսա	t ə n pʰ ɛ s ɑ
տնօրեն	t ə n ɔ ɾ ɛ n
տոգո	t ɔ ɡ ɔ
տոթ	t ɔ tʰ
տոլմա	t ɔ l m ɑ
տոկալ	t ɔ k ɑ l
տոկիո	t ɔ k i ɔ
տոկոս	t ɔ k ɔ s
տոկունություն	t ɔ k u n u tʰ j u n
տոհմ	t ɔ h m
տոհմածառ	t ɔ h m ɑ t͡s ɑ r
տող	t ɔ ʁ
տողադարձ	t ɔ ʁ ɑ d ɑ ɾ t͡sʰ
տողան	t ɔ ʁ ɑ n
տոմս	t ɔ m s
տոմսարկղ	t ɔ m s ɑ ɾ k ə ʁ
տոմսկ	t ɔ m s k
տոն	t ɔ n
տոնածառ	t ɔ n ɑ t͡s ɑ r
տոնավաճառ	t ɔ n ɑ v ɑ t͡ʃ ɑ r
տոնել	t ɔ n ɛ l
տոնոյան	t ɔ n ɔ j ɑ n
տոպրակ	t ɔ p ɾ ɑ k
տոտեմ	t ɔ t ɛ m
տորմուզ	t ɔ ɾ m u z
տորոն	t ɔ ɾ ɔ n
տորֆ	t ɔ ɾ f
տուալետ	t u ɑ l ɛ t
տուբերկուլյոզ	t u b ɛ ɾ k u l j ɔ z
տուբերկուլոզ	t u b ɛ ɾ k u l ɔ z
տուգանք	t u ɡ ɑ ŋ kʰ
տուզ	t u z
տուժել	t u ʒ ɛ l
տուժող	t u ʒ ɔ ʁ
տուժվել	t u ʒ v ɛ l
տուլա	t u l ɑ
տույժ	t u j ʒ
տուն	t u n
տունկ	t u ŋ k
տուտ	t u t
տուտուզ	t u t u z
տուր	t u ɾ
տուրիզմ	t u ɾ i z m
տուրք	t u ɾ kʰ
տուփ	t u pʰ
տպագրություն	t ə p ɑ ɡ ɾ u tʰ j u n
տպավորել	t ə p ɑ v ɔ ɾ ɛ l
տպավորիչ	t ə p ɑ v ɔ ɾ i t͡ʃʰ
տպավորված	t ə p ɑ v ɔ ɾ v ɑ t͡s
տպավորվել	t ə p ɑ v ɔ ɾ v ɛ l
տպիչ	t ə p i t͡ʃʰ
տռուզ	t ə r u z
տվեր	t v ɛ ɾ
տվյալ	t ə v j ɑ l
տտ	t ə t ə
տրական	t ə ɾ ɑ k ɑ n
տրակտոր	t ɾ ɑ k t ɔ ɾ
տրամաբանական	t ɾ ɑ m ɑ b ɑ n ɑ k ɑ n
տրամաբանություն	t ɾ ɑ m ɑ b ɑ n u tʰ j u n
տրամագիծ	t ɾ ɑ m ɑ ɡ i t͡s
տրամադրություն	t ɾ ɑ m ɑ d ɾ u tʰ j u n
տրանսգենդեր	t ɾ ɑ n s ɡ ɛ n d ɛ ɾ
տրանսիլվանիա	t ɾ ɑ n s i l v ɑ n j ɑ
տրանսպորտ	t ə ɾ ɑ n s p ɔ ɾ t
տրիբունա	t ɾ i b u n ɑ
տրոլեյբուս	t ɾ ɔ l ɛ j b u s
տրոհել	t ə ɾ ɔ h ɛ l
տրոմբոն	t ɾ ɔ m b ɔ n
տփղիս	t ə pʰ χ i s
րաֆֆի	ɾ ɑ fː i
րե	ɾ ɛ
րոպեական	ɾ ɔ p ɛ j ɑ k ɑ n
ցախ	t͡sʰ ɑ χ
ցախատուն	t͡sʰ ɑ χ ɑ t u n
ցածր	t͡sʰ ɑ t͡s ə ɾ
ցածրահասակ	t͡sʰ ɑ t͡s ɾ ɑ h ɑ s ɑ k
ցամաք	t͡sʰ ɑ m ɑ kʰ
ցամաքային	t͡sʰ ɑ m ɑ kʰ ɑ j i n
ցայգ	t͡sʰ ɑ j ɡ
ցանել	t͡sʰ ɑ n ɛ l
ցանկ	t͡sʰ ɑ ŋ k
ցանկալի	t͡sʰ ɑ ŋ k ɑ l i
ցանկանալ	t͡sʰ ɑ ŋ k ɑ n ɑ l
ցանկապատ	t͡sʰ ɑ ŋ k ɑ p ɑ t
ցանկություն	t͡sʰ ɑ ŋ k u tʰ j u n
ցանց	t͡sʰ ɑ n t͡sʰ
ցանցաթաղանթ	t͡sʰ ɑ n t͡sʰ ɑ tʰ ɑ ʁ ɑ n tʰ
ցանցենի	t͡sʰ ɑ n t͡sʰ ɛ n i
ցասկոտ	t͡sʰ ɑ s k ɔ t
ցավ	t͡sʰ ɑ v
ցավալ	t͡sʰ ɑ v ɑ l
ցավակցություն	t͡sʰ ɑ v ɑ k t͡sʰ u tʰ j u n
ցավել	t͡sʰ ɑ v ɛ l
ցավոք	t͡sʰ ɑ v ɔ kʰ
ցատկ	t͡sʰ ɑ t k
ցատկել	t͡sʰ ɑ t k ɛ l
ցար	t͡sʰ ɑ ɾ
ցարական	t͡sʰ ɑ ɾ ɑ k ɑ n
ցացիկի	t͡sʰ ɑ t͡sʰ i k i
ցաք	t͡sʰ ɑ kʰ
ցեխ	t͡sʰ ɛ χ
ցեղասպան	t͡sʰ ɛ ʁ ɑ s p ɑ n
ցեղասպանություն	t͡sʰ ɛ ʁ ɑ s p ɑ n u tʰ j u n
ցեմենտ	t͡sʰ ɛ m ɛ n t
ցեյլոն	t͡sʰ ɛ j l ɔ n
ցերեկույթ	t͡sʰ ɛ ɾ ɛ k u j tʰ
ցիգան	t͡sʰ i ɡ ɑ n
ցին	t͡sʰ i n
ցինիզմ	t͡sʰ i n i z m
ցինկ	t͡sʰ i ŋ k
ցից	t͡sʰ i t͡sʰ
ցյուրիխ	t͡sʰ j u ɾ i χ
ցնծալ	t͡sʰ ə n t͡s ɑ l
ցնծություն	t͡sʰ ə n t͡s u tʰ j u n
ցնցուղ	t͡sʰ ə n t͡sʰ u ʁ
ցո	t͡sʰ ɔ
ցողուն	t͡sʰ ɔ ʁ u n
ցորեն	t͡sʰ ɔ ɾ ɛ n
ցուլ	t͡sʰ u l
ցույց	t͡sʰ u j t͡sʰ
ցունամի	t͡sʰ u n ɑ m i
ցուպ	t͡sʰ u p
ցուրտ	t͡sʰ u ɾ t
ցուցաբերել	t͡sʰ u t͡sʰ ɑ b ɛ ɾ ɛ l
ցուցադրական	t͡sʰ u t͡sʰ ɑ d ɾ ɑ k ɑ n
ցուցադրել	t͡sʰ u t͡sʰ ɑ d ɾ ɛ l
ցուցակ	t͡sʰ u t͡sʰ ɑ k
ցուցակում	t͡sʰ u t͡sʰ ɑ k u m
ցուցանակ	t͡sʰ u t͡sʰ ɑ n ɑ k
ցուցանել	t͡sʰ u t͡sʰ ɑ n ɛ l
ցուցասրահ	t͡sʰ u t͡sʰ ɑ s ə ɾ ɑ h
ցրել	t͡sʰ ə ɾ ɛ l
փազլ	pʰ ɑ z ə l
փաթեթ	pʰ ɑ tʰ ɛ tʰ
փալաս	pʰ ɑ l ɑ s
փախուստ	pʰ ɑ χ u s t
փախստյա	pʰ ɑ χ ə s t j ɑ
փախցնել	pʰ ɑ χ t͡sʰ n ɛ l
փակագիծ	pʰ ɑ k ɑ ɡ i t͡s
փական	pʰ ɑ k ɑ n
փականագործ	pʰ ɑ k ɑ n ɑ ɡ ɔ ɾ t͡s
փակել	pʰ ɑ k ɛ l
փահլեւան	pʰ ɑ h l ɛ v ɑ n
փաղանգ	pʰ ɑ ʁ ɑ ŋ ɡ
փամփշտակալ	pʰ ɑ m pʰ ə ʃ t ɑ k ɑ l
փամփուշտ	pʰ ɑ m pʰ u ʃ t
փայլ	pʰ ɑ j l
փայլածու	pʰ ɑ j l ɑ t͡s u
փայլատակել	pʰ ɑ j l ɑ t ɑ k ɛ l
փայլել	pʰ ɑ j l ɛ l
փայլուն	pʰ ɑ j l u n
փայլունակություն	pʰ ɑ j l u n ɑ k u tʰ j u n
փայլունություն	pʰ ɑ j l u n u tʰ j u n
փայտ	pʰ ɑ j t
փայտակարան	pʰ ɑ j t ɑ k ɑ ɾ ɑ n
փայտահատ	pʰ ɑ j t ɑ h ɑ t
փայտիկ	pʰ ɑ j t i k
փայտյա	pʰ ɑ j t j ɑ
փայտոջիլ	pʰ ɑ j t ɔ t͡ʃʰ i l
փայտփորիկ	pʰ ɑ j t pʰ ɔ ɾ i k
փայփայել	pʰ ɑ j pʰ ɑ j ɛ l
փանջարա	pʰ ɑ n d͡ʒ ɑ ɾ ɑ
փառահեղ	pʰ ɑ r ɑ h ɛ ʁ
փառամոլ	pʰ ɑ r ɑ m ɔ l
փառանձեմ	pʰ ɑ r ɑ n d͡z ɛ m
փառասեր	pʰ ɑ r ɑ s ɛ ɾ
փառոք	pʰ ɑ r ɔ kʰ
փասթաթուղթ	pʰ ɑ s tʰ ɑ tʰ u χ tʰ
փասիան	pʰ ɑ s j ɑ n
փասվորդ	pʰ ɑ s v ɔ ɾ d
փաստ	pʰ ɑ s t
փաստաբան	pʰ ɑ s t ɑ b ɑ n
փաստաթուղթ	pʰ ɑ s t ɑ tʰ u χ tʰ
փաստահավաք	pʰ ɑ s t ɑ h ɑ v ɑ kʰ
փաստարկ	pʰ ɑ s t ɑ ɾ k
փաստացի	pʰ ɑ s t ɑ t͡sʰ i
փաստել	pʰ ɑ s t ɛ l
փաստորեն	pʰ ɑ s t ɔ ɾ ɛ n
փաստում	pʰ ɑ s t u m
փաստվել	pʰ ɑ s t v ɛ l
փարաջա	pʰ ɑ ɾ ɑ d͡ʒ ɑ
փարթամ	pʰ ɑ ɾ tʰ ɑ m
փարթամանալ	pʰ ɑ ɾ tʰ ɑ m ɑ n ɑ l
փարիզ	pʰ ɑ ɾ i z
փարիզյան	pʰ ɑ ɾ i z j ɑ n
փարիխան	pʰ ɑ ɾ i χ ɑ n
փարիսեցի	pʰ ɑ ɾ i s ɛ t͡sʰ i
փարիսեցիություն	pʰ ɑ ɾ i s ɛ t͡sʰ i u tʰ j u n
փարոս	pʰ ɑ ɾ ɔ s
փարպեցի	pʰ ɑ ɾ p ɛ t͡sʰ i
փարպի	pʰ ɑ ɾ p i
փարվել	pʰ ɑ ɾ v ɛ l
փափագ	pʰ ɑ pʰ ɑ ɡ
փափազյան	pʰ ɑ pʰ ɑ z j ɑ n
փափուկ	pʰ ɑ pʰ u k
փեհլիվանյան	pʰ ɛ h l i v ɑ n j ɑ n
փենջաբ	pʰ ɛ n d͡ʒ ɑ b
փենջաբի	pʰ ɛ n d͡ʒ ɑ b i
փեչ	pʰ ɛ t͡ʃʰ
փեսա	pʰ ɛ s ɑ
փեսացու	pʰ ɛ s ɑ t͡sʰ u
փետել	pʰ ɛ t ɛ l
փետուր	pʰ ɛ t u ɾ
փետրվար	pʰ ɛ t ə ɾ v ɑ ɾ
փետրվարյան	pʰ ɛ t ə ɾ v ɑ ɾ j ɑ n
փերիխան	pʰ ɛ ɾ i χ ɑ n
փիլիսոփա	pʰ i l i s ɔ pʰ ɑ
փիլիսոփայություն	pʰ i l i s ɔ pʰ ɑ j u tʰ j u n
փիղ	pʰ i ʁ
փիճի	pʰ i t͡ʃ i
փիչխ	pʰ i t͡ʃʰ χ
փիրուզա	pʰ i ɾ u z ɑ
փիփերթ	pʰ i pʰ ɛ ɾ tʰ
փլավ	pʰ ə l ɑ f
փխենյան	pʰ ə χ ɛ n j ɑ n
փղշտացի	pʰ ə ʁ ə ʃ t ɑ t͡sʰ i
փղոսկր	pʰ ə ʁ ɔ s k ɾ
փմձ	pʰ ə m ə d͡z ə
փյունիկ	pʰ j u n i k
փյունիկիա	pʰ j u n i k j ɑ
փնթի	pʰ ə n tʰ i
փնտրել	pʰ ə n t ɾ ɛ l
փշատ	pʰ ə ʃ ɑ t
փշուր	pʰ ə ʃ u ɾ
փշրանք	pʰ ə ʃ ɾ ɑ ŋ kʰ
փշրել	pʰ ə ʃ ɾ ɛ l
փոխ	pʰ ɔ χ
փոխան	pʰ ɔ χ ɑ n
փոխանակ	pʰ ɔ χ ɑ n ɑ k
փոխանակել	pʰ ɔ χ ɑ n ɑ k ɛ l
փոխանցել	pʰ ɔ χ ɑ n t͡sʰ ɛ l
փոխառել	pʰ ɔ χ ɑ r ɛ l
փոխառություն	pʰ ɔ χ ɑ r u tʰ j u n
փոխարեն	pʰ ɔ χ ɑ ɾ ɛ n
փոխարինում	pʰ ɔ χ ɑ ɾ i n u m
փոխել	pʰ ɔ χ ɛ l
փոխհատուցել	pʰ ɔ χ h ɑ t u t͡sʰ ɛ l
փոխնախագահ	pʰ ɔ χ n ɑ χ ɑ ɡ ɑ h
փոխնախարար	pʰ ɔ χ n ɑ χ ɑ ɾ ɑ ɾ
փոխվարչապետ	pʰ ɔ χ v ɑ ɾ t͡ʃʰ ɑ p ɛ t
փող	pʰ ɔ ʁ
փողատեր	pʰ ɔ ʁ ɑ t ɛ ɾ
փողերակ	pʰ ɔ ʁ ɛ ɾ ɑ k
փողկապ	pʰ ɔ χ k ɑ p
փողորակ	pʰ ɔ ʁ ɔ ɾ ɑ k
փողոց	pʰ ɔ ʁ ɔ t͡sʰ
փոշեծծիչ	pʰ ɔ ʃ ɛ t͡s ə t͡s i t͡ʃʰ
փոշեկուլ	pʰ ɔ ʃ ɛ k u l
փոշի	pʰ ɔ ʃ i
փոս	pʰ ɔ s
փոստ	pʰ ɔ s t
փոստային	pʰ ɔ s t ɑ j i n
փոստանջյան	pʰ ɔ s t ɑ n d͡ʒ j ɑ n
փորագրություն	pʰ ɔ ɾ ɑ ɡ ɾ u tʰ j u n
փորթուգալիա	pʰ ɔ ɾ tʰ u ɡ ɑ l j ɑ
փորձ	pʰ ɔ ɾ t͡sʰ
փորձագետ	pʰ ɔ ɾ t͡sʰ ɑ ɡ ɛ t
փորձառություն	pʰ ɔ ɾ t͡sʰ ɑ r u tʰ j u n
փորձարկող	pʰ ɔ ɾ t͡sʰ ɑ ɾ k ɔ ʁ
փորձարկում	pʰ ɔ ɾ t͡sʰ ɑ ɾ k u m
փորձարկվել	pʰ ɔ ɾ t͡sʰ ɑ ɾ k v ɛ l
փորձել	pʰ ɔ ɾ t͡sʰ ɛ l
փորձություն	pʰ ɔ ɾ t͡sʰ u tʰ j u n
փոցխ	pʰ ɔ t͡sʰ χ
փութ	pʰ u tʰ
փութաջան	pʰ u tʰ ɑ d͡ʒ ɑ n
փութաջանորեն	pʰ u tʰ ɑ d͡ʒ ɑ n ɔ ɾ ɛ n
փուլ	pʰ u l
փուլային	pʰ u l ɑ j i n
փունջ	pʰ u n d͡ʒ
փուշ	pʰ u ʃ
փուչ	pʰ u t͡ʃʰ
փուռ	pʰ u r
փուք	pʰ u kʰ
փոփոխություն	pʰ ɔ pʰ ɔ χ u tʰ j u n
փոքր	pʰ ɔ kʰ ə ɾ
փոքրամասնություն	pʰ ɔ kʰ ɾ ɑ m ɑ s n u tʰ j u n
փոքրացնել	pʰ ɔ kʰ ɾ ɑ t͡sʰ n ɛ l
փոքրիկ	pʰ ɔ kʰ ɾ i k
փչակ	pʰ ə t͡ʃʰ ɑ k
փչանալ	pʰ ə t͡ʃʰ ɑ n ɑ l
փչացած	pʰ ə t͡ʃʰ ɑ t͡sʰ ɑ t͡s
փռյուգական	pʰ ə r j u ɡ ɑ k ɑ n
փսխել	pʰ ə s χ ɛ l
փտած	pʰ ə t ɑ t͡s
փտել	pʰ ə t ɛ l
փրկագին	pʰ ə ɾ k ɑ ɡ i n
փրկանք	pʰ ə ɾ k ɑ ŋ kʰ
փրկել	pʰ ə ɾ k ɛ l
փրկիչ	pʰ ə ɾ k i t͡ʃʰ
փրփուր	pʰ ə ɾ pʰ u ɾ
փրփրել	pʰ ə ɾ pʰ ə ɾ ɛ l
փքաբլիթ	pʰ ə kʰ ɑ b ə l i tʰ
փքում	pʰ ə kʰ u m
փքուն	pʰ ə kʰ u n
փքունություն	pʰ ə kʰ u n u tʰ j u n
փքվել	pʰ ə kʰ v ɛ l
քաբաբ	kʰ ɑ b ɑ b
քաբուլ	kʰ ɑ b u l
քալանթարյան	kʰ ɑ l ɑ n tʰ ɑ ɾ j ɑ n
քահանա	kʰ ɑ h ɑ n ɑ
քաղաք	kʰ ɑ ʁ ɑ kʰ
քաղաքագետ	kʰ ɑ ʁ ɑ kʰ ɑ ɡ ɛ t
քաղաքական	kʰ ɑ ʁ ɑ kʰ ɑ k ɑ n
քաղաքականություն	kʰ ɑ ʁ ɑ kʰ ɑ k ɑ n u tʰ j u n
քաղաքապետ	kʰ ɑ ʁ ɑ kʰ ɑ p ɛ t
քաղաքավար	kʰ ɑ ʁ ɑ kʰ ɑ v ɑ ɾ
քաղաքավարի	kʰ ɑ ʁ ɑ kʰ ɑ v ɑ ɾ i
քաղաքացի	kʰ ɑ ʁ ɑ kʰ ɑ t͡sʰ i
քաղաքացիական	kʰ ɑ ʁ ɑ kʰ ɑ t͡sʰ i j ɑ k ɑ n
քաղբանտարկյալ	kʰ ɑ ʁ b ɑ n t ɑ ɾ k j ɑ l
քաղել	kʰ ɑ ʁ ɛ l
քաղկեդոն	kʰ ɑ χ k ɛ d ɔ n
քաղհասարակություն	kʰ ɑ χ h ɑ s ɑ ɾ ɑ k u tʰ j u n
քաղց	kʰ ɑ χ t͡sʰ
քաղցկեղ	kʰ ɑ χ t͡sʰ k ɛ ʁ
քաղցրահամ	kʰ ɑ χ t͡sʰ ɾ ɑ h ɑ m
քաղցրավուն	kʰ ɑ χ t͡sʰ ɾ ɑ v u n
քամանչա	kʰ ɑ m ɑ n t͡ʃʰ ɑ
քամել	kʰ ɑ m ɛ l
քամոտ	kʰ ɑ m ɔ t
քայլ	kʰ ɑ j l
քայլել	kʰ ɑ j l ɛ l
քայլերթ	kʰ ɑ j l ɛ ɾ tʰ
քանակական	kʰ ɑ n ɑ k ɑ k ɑ n
քանակություն	kʰ ɑ n ɑ k u tʰ j u n
քանան	kʰ ɑ n ɑ n
քանանացի	kʰ ɑ n ɑ n ɑ t͡sʰ i
քանդակ	kʰ ɑ n d ɑ k
քանդակագործ	kʰ ɑ n d ɑ k ɑ ɡ ɔ ɾ t͡s
քանդել	kʰ ɑ n d ɛ l
քանզի	kʰ ɑ n z i
քանի	kʰ ɑ n i
քանիցս	kʰ ɑ n i t͡sʰ ə s
քանոն	kʰ ɑ n ɔ n
քաշ	kʰ ɑ ʃ
քաշան	kʰ ɑ ʃ ɑ n
քաշել	kʰ ɑ ʃ ɛ l
քաշմիրի	kʰ ɑ ʃ m i ɾ i
քաոս	kʰ ɑ ɔ s
քաոսական	kʰ ɑ ɔ s ɑ k ɑ n
քաոսային	kʰ ɑ ɔ s ɑ j i n
քաոսայնորեն	kʰ ɑ ɔ s ɑ j n ɔ ɾ ɛ n
քաոսայնություն	kʰ ɑ ɔ s ɑ j n u tʰ j u n
քաջ	kʰ ɑ d͡ʒ
քաջալերանք	kʰ ɑ d͡ʒ ɑ l ɛ ɾ ɑ ŋ kʰ
քաջալերել	kʰ ɑ d͡ʒ ɑ l ɛ ɾ ɛ l
քաջալերություն	kʰ ɑ d͡ʒ ɑ l ɛ ɾ u tʰ j u n
քառանիստ	kʰ ɑ r ɑ n i s t
քառասուն	kʰ ɑ r ɑ s u n
քառորդ	kʰ ɑ r ɔ ɾ tʰ
քավ	kʰ ɑ v
քավել	kʰ ɑ v ɛ l
քավության	kʰ ɑ v u tʰ j ɑ n
քավություն	kʰ ɑ v u tʰ j u n
քար	kʰ ɑ ɾ
քարածերպ	kʰ ɑ ɾ ɑ t͡s ɛ ɾ p
քարածուխ	kʰ ɑ ɾ ɑ t͡s u χ
քարաճիկ	kʰ ɑ ɾ ɑ t͡ʃ i k
քարայր	kʰ ɑ ɾ ɑ j ɾ
քարանձավ	kʰ ɑ ɾ ɑ n d͡z ɑ v
քարեղեն	kʰ ɑ ɾ ɛ ʁ ɛ n
քարճիկ	kʰ ɑ ɾ t͡ʃ i k
քարոզ	kʰ ɑ ɾ ɔ z
քարոզարշավ	kʰ ɑ ɾ ɔ z ɑ ɾ ʃ ɑ v
քարոզել	kʰ ɑ ɾ ɔ z ɛ l
քարոզիչ	kʰ ɑ ɾ ɔ z i t͡ʃʰ
քարոզչություն	kʰ ɑ ɾ ɔ z t͡ʃʰ u tʰ j u n
քարուկիր	kʰ ɑ ɾ u k i ɾ
քարտ	kʰ ɑ ɾ t
քարտեզ	kʰ ɑ ɾ t ɛ z
քարտեզագիր	kʰ ɑ ɾ t ɛ z ɑ ɡ i ɾ
քարտեզագրական	kʰ ɑ ɾ t ɛ z ɑ ɡ ɾ ɑ k ɑ n
քարտուղարուհի	kʰ ɑ ɾ t u ʁ ɑ ɾ u h i
քացի	kʰ ɑ t͡sʰ i
քաք	kʰ ɑ kʰ
քեզ	kʰ ɛ z
քելե	kʰ ɛ l ɛ
քեմբրիջ	kʰ ɛ m b ɾ i d͡ʒ
քեն	kʰ ɛ n
քենի	kʰ ɛ n i
քենիա	kʰ ɛ n j ɑ
քեշիշյան	kʰ ɛ ʃ i ʃ j ɑ n
քեոփս	kʰ ɛ ɔ pʰ s
քեռի	kʰ ɛ r i
քեռորդի	kʰ ɛ r ɔ ɾ tʰ i
քեռու	kʰ ɛ r u
քերականորեն	kʰ ɛ ɾ ɑ k ɑ n ɔ ɾ ɛ n
քերականություն	kʰ ɛ ɾ ɑ k ɑ n u tʰ j u n
քերել	kʰ ɛ ɾ ɛ l
քերոբյան	kʰ ɛ ɾ ɔ pʰ j ɑ n
քեֆ	kʰ ɛ f
քթածակ	kʰ ə tʰ ɑ t͡s ɑ k
քթնել	kʰ ə tʰ n ɛ l
քթոց	kʰ ə tʰ ɔ t͡sʰ
քիթ	kʰ i tʰ
քիմիա	kʰ i m j ɑ
քիմիապես	kʰ i m j ɑ p ɛ s
քիմիկոս	kʰ i m i k ɔ s
քիմիոն	kʰ i m j ɔ n
քիմմաքրում	kʰ i mː ɑ kʰ ɾ u m
քիմք	kʰ i m kʰ
քիոս	kʰ i ɔ s
քիփ	kʰ i pʰ
քլինթոն	kʰ l i n tʰ ɔ n
քծինք	kʰ ə t͡s i ŋ kʰ
քծնանք	kʰ ə t͡s n ɑ ŋ kʰ
քծնել	kʰ ə t͡s n ɛ l
քյաբաբ	kʰ j ɑ b ɑ b
քյամանչա	kʰ j ɑ m ɑ n t͡ʃʰ ɑ
քյանդրբազություն	kʰ j ɑ n d ə ɾ b ɑ z u tʰ j u n
քյավառ	kʰ j ɑ v ɑ r
քյոլն	kʰ j ɔ l n
քյոխվա	kʰ j ɔ χ v ɑ
քյոմուր	kʰ j ɔ m u ɾ
քնած	kʰ ə n ɑ t͡s
քնամուկ	kʰ ə n ɑ m u k
քնաշրջություն	kʰ ə n ɑ ʃ ə ɾ d͡ʒ u tʰ j u n
քնապարկ	kʰ ə n ɑ p ɑ ɾ k
քնար	kʰ ə n ɑ ɾ
քնարահավ	kʰ ə n ɑ ɾ ɑ h ɑ v
քնել	kʰ ə n ɛ l
քնկոտ	kʰ ə ŋ k ɔ t
քննադատ	kʰ ə nː ɑ d ɑ t
քննադատաբար	kʰ ə nː ɑ d ɑ t ɑ b ɑ ɾ
քննադատել	kʰ ə nː ɑ d ɑ t ɛ l
քննադատություն	kʰ ə nː ɑ d ɑ t u tʰ j u n
քննարկում	kʰ ə nː ɑ ɾ k u m
քննել	kʰ ə nː ɛ l
քննվել	kʰ ə nː ə v ɛ l
քշել	kʰ ə ʃ ɛ l
քող	kʰ ɔ ʁ
քոչարի	kʰ ɔ t͡ʃʰ ɑ ɾ i
քոչարյան	kʰ ɔ t͡ʃʰ ɑ ɾ j ɑ n
քոչել	kʰ ɔ t͡ʃʰ ɛ l
քոչվոր	kʰ ɔ t͡ʃʰ v ɔ ɾ
քոչվորական	kʰ ɔ t͡ʃʰ v ɔ ɾ ɑ k ɑ n
քոռ	kʰ ɔ r
քոս	kʰ ɔ s
քոր	kʰ ɔ ɾ
քորել	kʰ ɔ ɾ ɛ l
քուլա	kʰ u l ɑ
քույրական	kʰ u j ɾ ɑ k ɑ n
քուն	kʰ u n
քունք	kʰ u ŋ kʰ
քուչա	kʰ u t͡ʃʰ ɑ
քուջուջ	kʰ u d͡ʒ u d͡ʒ
քուռաթ	kʰ u r ɑ tʰ
քուռակ	kʰ u r ɑ k
քուր	kʰ u ɾ
քուրդ	kʰ u ɾ d
քուրձ	kʰ u ɾ d͡z
քուրմ	kʰ u ɾ m
քոքոբելյան	kʰ ɔ kʰ ɔ b ɛ l j ɑ n
քչփորել	kʰ t͡ʃʰ pʰ ɔ ɾ ɛ l
քսակ	kʰ ə s ɑ k
քսել	kʰ ə s ɛ l
քսենոկրատես	kʰ s ɛ n ɔ k ɾ ɑ t ɛ s
քսենոփոն	kʰ s ɛ n ɔ pʰ ɔ n
քսերոքս	kʰ s ɛ ɾ ɔ kʰ s
քսուք	kʰ ə s u kʰ
քվազար	kʰ v ɑ z ɑ ɾ
քվարց	kʰ ə v ɑ ɾ t͡sʰ
քվե	kʰ ə v ɛ
քվեարկել	kʰ ə v ɛ ɑ ɾ k ɛ l
քվեարկող	kʰ ə v ɛ ɑ ɾ k ɔ ʁ
քրդերեն	kʰ ɾ d ɛ ɾ ɛ n
քրդստան	kʰ ə ɾ d ə s t ɑ n
քրեղան	kʰ ə ɾ ɛ ʁ ɑ n
քրիստոնյա	kʰ ɾ i s t ɔ n j ɑ
քրմուհի	kʰ ə ɾ m u h i
քրտինք	kʰ ə ɾ t i ŋ kʰ
քրտնաջան	kʰ ə ɾ t n ɑ d͡ʒ ɑ n
քրտնել	kʰ ə ɾ t n ɛ l
քրքում	kʰ ə ɾ kʰ u m
քրքրել	kʰ ə ɾ kʰ ə ɾ ɛ l
քցել	kʰ ə t͡sʰ ɛ l
օազիս	ɔ ɑ z i s
օբ	ɔ b
օբամա	ɔ b ɑ m ɑ
օբյեկտիվություն	ɔ b j ɛ k t i v u tʰ j u n
օգնական	ɔ kʰ n ɑ k ɑ n
օգնել	ɔ kʰ n ɛ l
օգնություն	ɔ kʰ n u tʰ j u n
օգոստոս	ɔ ɡ ɔ s t ɔ s
օգոստոսյան	ɔ ɡ ɔ s t ɔ s j ɑ n
օգուտ	ɔ kʰ u t
օգտագործել	ɔ kʰ t ɑ ɡ ɔ ɾ t͡s ɛ l
օգտագործվել	ɔ kʰ t ɑ ɡ ɔ ɾ t͡s v ɛ l
օգտակար	ɔ kʰ t ɑ k ɑ ɾ
օգտակարություն	ɔ kʰ t ɑ k ɑ ɾ u tʰ j u n
օգտանուն	ɔ kʰ t ɑ n u n
օգտատեր	ɔ kʰ t ɑ t ɛ ɾ
օդ	ɔ tʰ
օդակայան	ɔ tʰ ɑ k ɑ j ɑ n
օդանավակայան	ɔ tʰ ɑ n ɑ v ɑ k ɑ j ɑ n
օդապարիկ	ɔ tʰ ɑ p ɑ ɾ i k
օդեսա	ɔ d ɛ s ɑ
օդերեւութաբան	ɔ tʰ ɛ ɾ ɛ v u tʰ ɑ b ɑ n
օդերեւութաբանական	ɔ tʰ ɛ ɾ ɛ v u tʰ ɑ b ɑ n ɑ k ɑ n
օեկ	ɔ j ɛ k
օթել	ɔ tʰ ɛ l
օթեւան	ɔ tʰ ɛ v ɑ n
օժանդակ	ɔ ʒ ɑ n d ɑ k
օժանդակել	ɔ ʒ ɑ n d ɑ k ɛ l
օժիտ	ɔ ʒ i t
օժտել	ɔ ʒ t ɛ l
օլիգարխ	ɔ l i ɡ ɑ ɾ χ
օլիգարխիա	ɔ l i ɡ ɑ ɾ χ j ɑ
օծանելիք	ɔ t͡s ɑ n ɛ l i kʰ
օծել	ɔ t͡s ɛ l
օկուպացիա	ɔ k u p ɑ t͡sʰ j ɑ
օկտավիանոս	ɔ k t ɑ v j ɑ n ɔ s
օհայո	ɔ h ɑ j ɔ
օհան	ɔ h ɑ n
օհանյան	ɔ h ɑ n j ɑ n
օձ	ɔ t͡sʰ
օղ	ɔ ʁ
օղակ	ɔ ʁ ɑ k
օճառ	ɔ t͡ʃ ɑ r
օման	ɔ m ɑ n
օմար	ɔ m ɑ ɾ
օմսկ	ɔ m s k
օյին	ɔ j i n
օյինբազ	ɔ j i n b ɑ z
օնիկ	ɔ n i k
օշինդր	ɔ ʃ i n d ə ɾ
օպտիմալ	ɔ p t i m ɑ l
օպտիմալացում	ɔ p t i m ɑ l ɑ t͡sʰ u m
օջախային	ɔ d͡ʒ ɑ χ ɑ j i n
օս	ɔ s
օսական	ɔ s ɑ k ɑ n
օսեթ	ɔ s ɛ tʰ
օսեթական	ɔ s ɛ tʰ ɑ k ɑ n
օսեթիա	ɔ s ɛ tʰ j ɑ
օսլա	ɔ s l ɑ
օսկանյան	ɔ s k ɑ n j ɑ n
օսման	ɔ s m ɑ n
օսմանական	ɔ s m ɑ n ɑ k ɑ n
օսմաներեն	ɔ s m ɑ n ɛ ɾ ɛ n
օսմանյան	ɔ s m ɑ n j ɑ n
օսմանցի	ɔ s m ɑ n t͡sʰ i
օվկիանիա	ɔ f k i j ɑ n j ɑ
օտարագիր	ɔ t ɑ ɾ ɑ ɡ i ɾ
օտարերկրացի	ɔ t ɑ ɾ ɛ ɾ k ɾ ɑ t͡sʰ i
օտարոտի	ɔ t ɑ ɾ ɔ t i
օր	ɔ ɾ
օրագիր	ɔ ɾ ɑ ɡ i ɾ
օրական	ɔ ɾ ɑ k ɑ n
օրակարգ	ɔ ɾ ɑ k ɑ ɾ kʰ
օրան	ɔ ɾ ɑ n
օրանգուտանգ	ɔ ɾ ɑ ŋ ɡ u t ɑ ŋ ɡ
օրացույց	ɔ ɾ ɑ t͡sʰ u j t͡sʰ
օրգազմ	ɔ ɾ ɡ ɑ z m
օրգան	ɔ ɾ ɡ ɑ n
օրգանական	ɔ ɾ ɡ ɑ n ɑ k ɑ n
օրգանիզմ	ɔ ɾ ɡ ɑ n i z m
օրդուբադ	ɔ ɾ d u b ɑ d
օրենբուրգ	ɔ ɾ ɛ n b u ɾ ɡ
օրենսդիր	ɔ ɾ ɛ n s d i ɾ
օրենք	ɔ ɾ ɛ ŋ kʰ
օրենքով	ɔ ɾ ɛ ŋ kʰ ɔ v
օրեցօր	ɔ ɾ ɛ t͡sʰ ɔ ɾ
օրթախ	ɔ ɾ tʰ ɑ χ
օրինակ	ɔ ɾ i n ɑ k
օրիորդ	ɔ ɾ j ɔ ɾ tʰ
օրիսա	ɔ ɾ i s ɑ
օրյոլ	ɔ ɾ j ɔ l
օրնիբուն	ɔ ɾ n i b u n
օրորոց	ɔ ɾ ɔ ɾ ɔ t͡sʰ
օրոք	ɔ ɾ ɔ kʰ
օֆիս	ɔ f i s
ֆագոտ	f ɑ ɡ ɔ t
ֆակուլտատիվ	f ɑ k u l t ɑ t i v
ֆակուլտետ	f ɑ k u l t ɛ t
ֆամագուստա	f ɑ m ɑ ɡ u s t ɑ
ֆաշիզմ	f ɑ ʃ i z m
ֆաշիստ	f ɑ ʃ i s t
ֆաշիստական	f ɑ ʃ i s t ɑ k ɑ n
ֆարերեն	f ɑ ɾ ɛ ɾ ɛ n
ֆարերյան	f ɑ ɾ ɛ ɾ j ɑ n
ֆեյս	f ɛ j s
ֆեյսբուք	f ɛ j s b u kʰ
ֆեյք	f ɛ j kʰ
ֆեն	f ɛ n
ֆեոդալիզմ	f j ɔ d ɑ l i z m
ֆերմա	f ɛ ɾ m ɑ
ֆերմեր	f ɛ ɾ m ɛ ɾ
ֆիզիկ	f i z i k
ֆիզիկա	f i z i k ɑ
ֆիզիկական	f i z i k ɑ k ɑ n
ֆիզիկապես	f i z i k ɑ p ɛ s
ֆիզիկորեն	f i z i k ɔ ɾ ɛ n
ֆիզիոլոգիական	f i z i ɔ l ɔ ɡ j ɑ k ɑ n
ֆիլիպ	f i l i p
ֆիլիպինյան	f i l i p i n j ɑ n
ֆիլիպինուհի	f i l i p i n u h i
ֆիլիպինցի	f i l i p i n t͡sʰ i
ֆիլմ	f i l m
ֆինանսական	f i n ɑ n s ɑ k ɑ n
ֆինանսներ	f i n ɑ n s n ɛ ɾ
ֆինլանդական	f i n l ɑ n d ɑ k ɑ n
ֆինլանդացի	f i n l ɑ n d ɑ t͡sʰ i
ֆինլանդիա	f i n l ɑ n d j ɑ
ֆինն	f i nː
ֆիննական	f i nː ɑ k ɑ n
ֆիննուհի	f i nː u h i
ֆլամանդացի	f l ɑ m ɑ n d ɑ t͡sʰ i
ֆլամենկո	f l ɑ m ɛ ŋ k ɔ
ֆլամինգո	f l ɑ m i ŋ ɡ ɔ
ֆլեյտա	f l ɛ j t ɑ
ֆլեշմոբ	f l ɛ ʃ m ɔ b
ֆյուրեր	f j u ɾ ɛ ɾ
ֆոն	f ɔ n
ֆոտոխցիկ	f ɔ t ɔ χ ə t͡sʰ i k
ֆոտոն	f ɔ t ɔ n
ֆունկցիա	f u ŋ k t͡sʰ j ɑ
ֆունտ	f u n t
ֆուտբոլիստ	f u t b ɔ l i s t
ֆրանկ	f ə ɾ ɑ ŋ k
ֆրանսիական	f ɾ ɑ n s j ɑ k ɑ n
ֆրանսուհի	f ɾ ɑ n s u h i
ֆրանցիսկյան	f ə ɾ ɑ n t͡sʰ i s k j ɑ n
ֆրիզ	f ə ɾ i z
ֆրիզերեն	f ɾ i z ɛ ɾ ɛ n
ֆրիզյան	f ɾ i z j ɑ n
ֆրոյդիզմ	f ɾ ɔ j d i z m
