aad	aː t
aalst	aː l s t
aalten	aː l t ə n
aambeeld	aː m b eː l t
aanbestedingsprocedure	aː n b ə s t eː d ɪ ŋ s p r oː s ə d yː r ə
aanbetaling	aː n b ə t aː l ɪ ŋ
aanbevelen	aː m b ə v eː l ə n
aanbieden	aː n b i d ə n
aanblik	aː n b l ɪ k
aanbod	aː n b ɔ t
aanbouw	aː n b ɑ u̯
aanbouwen	aː m b ɑ u̯ ə n
aanbreekt	aː m b r eː k t
aanbrengen	aː m b r ɛ ŋ ə n
aandacht	aː n d ɑ x t
aandachtig	aː n d ɑ x t ə x
aandachtspunt	aː n d ɑ x t s p ʏ n t
aandeel	aː n d eː l
aandeelhouder	aː n d eː l ɦ ɑ u̯ d ə r
aandoening	aː n d u n ɪ ŋ
aandoenlijk	aː n d u n l ə k
aandrijfas	aː n d r ɛ i̯ f ɑ s
aandringen	aː n d r ɪ ŋ ə n
aanduiding	aː n d œ y̯ d ɪ ŋ
aaneen	aː n eː n
aangaan	aː ŋ ɣ aː n
aangaande	aː n ɣ aː n d ə
aangeboren	aː n ɣ ə b oː r ə n
aangegrepen	aː ŋ ɣ ə ɣ r eː p ə n
aangenaam	aː n ɣ ə n aː m
aangepast	aː ŋ ɣ ə p ɑ s t
aangeschoten	aː n ɣ ə s x oː t ə n
aangeslagen	aː n ɣ ə s l aː ɣ ə n
aangetekend	aː n ɣ ə t eː k ə n t
aangeven	aː ŋ ɣ eː v ə n
aangezien	aː ŋ ɣ ə z i n
aangifte	aː n ɣ ɪ f t ə
aangrenzend	aː n ɣ r ɛ n z ə n t
aangroei	aː n ɣ r u i̯
aanhaling	aː n ɦ aː l ɪ ŋ
aanhang	aː n ɦ ɑ ŋ
aanhangen	aː n ɦ ɑ ŋ ə n
aanhangsel	aː n ɦ ɑ ŋ s ə l
aanhef	aː n ɦ ɛ f
aanhoudelijk	aː n ɦ ɑ u̯ d ə l ə k
aanhouding	aː n ɦ ɑ u̯ d ɪ ŋ
aanjagen	aː n j aː ɣ ə n
aankijken	aː ŋ k ɛ i̯ k ə n
aanklacht	aː ŋ k l ɑ x t
aanklagen	aː ŋ k l aː ɣ ə n
aanklager	aː n k l aː ɣ ə r
aankleden	aː ŋ k l eː d ə n
aankomen	aː ŋ k oː m ə n
aankomst	aː ŋ k ɔ m s t
aankondiger	aː n k ɔ n d ə ɣ ə r
aankondiging	aː n k ɔ n d ə ɣ ɪ ŋ
aankoop	aː ŋ k oː p
aankopen	aː ŋ k oː p ə n
aankunnen	aː ŋ k ʏ n ə n
aanleg	aː n l ɛ x
aanleggen	aː n l ɛ ɣ ə n
aanleiding	aː n l ɛ i d ɪ ŋ
aanlengen	aː n l ɛ ŋ ə n
aanleren	aː n l eː r ə n
aanleveren	aː n l eː v ə r ə n
aanliggen	aː n l ɪ ɣ ə n
aanmaken	aː n m aː k ə n
aanmelden	aː m ɛ l d ə n
aanmerkelijk	aː n m ɛ r k ə l ə k
aanmerken	aː n m ɛ r k ə n
aanmerking	aː n m ɛ r k ɪ ŋ
aanname	aː n n aː m ə
aannemelijk	aː n eː m ə l ə k
aannemer	aː n eː m ə r
aanpak	aː m p ɑ k
aanpakken	aː m p ɑ k ə n
aanpasbaar	aː n p ɑ s b aː r
aanpassen	aː m p ɑ s ə n
aanpassing	aː m p ɑ s ɪ ŋ
aanprijzen	aː m p r ɛ i̯ z ə n
aanraden	aː n r aː d ə n
aanrader	aː n r aː d ə r
aanraken	aː n r aː k ə n
aanraking	aː n r aː k ɪ ŋ
aanrijden	aː n r ɛ i̯ d ə n
aanrijding	aː n r ɛ i̯ d ɪ ŋ
aanritsgeld	aː n r ɪ t s x ɛ l t
aanroepen	aː n r u p ə n
aanschaf	aː n s x ɑ f
aanschouwen	aː n s x ɑ u̯ ə n
aanschuiven	aː n s x œ y̯ v ə n
aanslaan	aː n s l aː n
aanslag	aː n s l ɑ x
aansluiten	aː n s l œ y̯ t ə n
aansluiting	aː n s l œ y̯ t ɪ ŋ
aanspannen	aː n s p ɑ n ə n
aanspeling	aː n s p eː l ɪ ŋ
aansprakelijk	aː n s p r aː k ə l ə k
aansprakelijkheid	aː n s p r aː k ə l ə k ɦ ɛ i t
aanspreken	aː n s p r eː k ə n
aanstekelijk	aː n s t eː k ə l ə k
aanstellen	aː n s t ɛ l ə n
aanstelling	aː n s t ɛ l ɪ ŋ
aantal	aː n t ɑ l
aantasten	aː n t ɑ s t ə n
aantekenen	aː n t eː k ə n ə n
aantocht	aː n t ɔ x t
aantreden	aː n t r eː d ə n
aantreffen	aː n t r ɛ f ə n
aantrekkelijk	aː n t r ɛ k ə l ə k
aantrekken	aː n t r ɛ k ə n
aantrekking	aː n t r ɛ k ɪ ŋ
aantrekkingskracht	aː n t r ɛ k ɪ ŋ s k r ɑ x t
aanvaardbaar	aː n v aː r t b aː r
aanvaarden	aː n v aː r d ə n
aanvaarding	aː n v aː r d ɪ ŋ
aanval	aː n v ɑ l
aanvallen	aː n v ɑ l ə n
aanvallend	aː n v ɑ l ə n t
aanvaller	aː n v ɑ l ə r
aanvalsplan	aː n v ɑ l s p l ɑ n
aanvankelijk	aː n v ɑ ŋ k ə l ə k
aanvinken	aː n v ɪ ŋ k ə n
aanvoelen	aː n v u l ə n
aanvoerder	aː n v uː r d ə r
aanvoeren	aː n v uː r ə n
aanvraag	aː n v r aː x
aanvragen	aː n v r aː ɣ ə n
aanvreten	aː n v r eː t ə n
aanvullen	aː n v ʏ l ə n
aanvulling	aː n v ʏ l ɪ ŋ
aanwakkeren	aː n ʋ ɑ k ə r ə n
aanwenden	aː n ʋ ɛ n d ə n
aanwerven	aː n ʋ ɛ r v ə n
aanwezig	aː n ʋ eː z ə x
aanwezige	aː n ʋ eː z ə ɣ ə
aanwezigheid	aː n ʋ eː z ə x ɦ ɛ i̯ t
aanwijzen	aː n ʋ ɛ i̯ z ə n
aanwijzing	aː n ʋ ɛ i z ɪ ŋ
aanwinst	aː n ʋ ɪ n s t
aanzien	aː n z i n
aanzienlijk	aː n z i n l ə k
aanzitten	aː n z ɪ t ə n
aanzoek	aː n z u k
aap	aː p
aapje	aː p j ə
aar	aː r
aard	aː r t
aardappelsalade	aː r d ɑ p ə l s aː l aː d ə
aardbeving	aː r t b eː v ɪ ŋ
aarde	aː r d ə
aarden	aː r d ə n
aardgas	aː r t x ɑ s
aardig	aː r d ə x
aards	aː r t s
aardwarmte	aː r t ʋ ɑ r m t ə
aars	aː r s
aart	aː r t
aarts	aː r t s
aartsbisschop	aː r t s b ɪ s x ɔ p
aartshertog	aː r t s ɦ ɛ r t ɔ x
aartshertogin	aː r t s ɦ ɛ r t oː ɣ ɪ n
aarzelen	aː r z ə l ə n
aas	aː s
abacus	ɑ b aː k ʏ s
abc	aː b eː s eː
abcoude	ɑ p k ɑ u̯ d ə
abdij	ɑ b d ɛ i̯
abdis	ɑ b d ɪ s
abel	aː b ə l
abn	aː b eː ɛ n
abnormaal	ɑ b n ɔ r m aː l
abonnee	ɑ b ɔ n eː
abonnement	ɑ b ɔ n ə m ɛ n t
abraham	aː b r aː ɦ ɑ m
absoluut	ɑ p s oː l y t
abstraheren	ɑ p s t r aː ɦ eː r ə n
absurd	ɑ p s ʏ r t
abt	ɑ p t
academie	aː k aː d eː m i
accent	ɑ k s ɛ n t
accentueren	ɑ k s ɛ n t y eː r ə n
acceptabel	ɑ k s ɛ p t aː b ə l
accepteren	ɑ k s ɛ p t eː r ə n
accessoire	ɑ s ə s ʋ aː r ə
accommodatie	ɑ k ɔ m oː d aː t s i
accountant	ɑ k ɑ u̯ n t ə n t
accu	ɑ k y
achilles	ɑ x ɪ l ə s
achtbaan	ɑ x t b aː n
achtduizend	ɑ x t d œ y̯ z ə n t
achteloos	ɑ x t ə l oː s
achteloosheid	ɑ x t ə l oː s ɦ ɛ i̯ t
achtenveertig	ɑ x t ə n v eː r t ə x
achteraf	ɑ x t ə r ɑ f
achterban	ɑ x t ə r b ɑ n
achterblijven	ɑ x t ə r b l ɛ i̯ v ə n
achtereen	ɑ x t ə r eː n
achtereenvolgens	ɑ x t ə r eː n v ɔ l ɣ ə n s
achtergrond	ɑ x t ə r ɣ r ɔ n t
achtergrondkleur	ɑ x t ə r ɣ r ɔ n t k l øː r
achtergrondmuziek	ɑ x t ə r ɣ r ɔ n t m y z i k
achterhaald	ɑ x t ə r ɦ aː l t
achterhalen	ɑ x t ə r ɦ aː l ə n
achterhoek	ɑ x t ə r ɦ u k
achterhoeks	ɑ x t ə r ɦ u k s
achterhoofd	ɑ x t ə r ɦ oː f t
achterin	ɑ x t ə r ɪ n
achterkant	ɑ x t ə r k ɑ n t
achterlaten	ɑ x t ə r l aː t ə n
achterlating	ɑ x t ə r l aː t ɪ ŋ
achterlijf	ɑ x t ə r l ɛ i̯ f
achternaam	ɑ x t ə r n aː m
achterop	ɑ x t ə r ɔ p
achterover	ɑ x t ə r oː v ə r
achterstand	ɑ x t ə r s t ɑ n t
achterstevoren	ɑ x t ə r s t ə v oː r ə n
achtertuin	ɑ x t ə r t œ y̯ n
achtervolgen	ɑ x t ə r v ɔ l ɣ ə n
achtervolging	ɑ x t ə r v ɔ l ɣ ɪ ŋ
achthoek	ɑ x t ɦ u k
achthonderd	ɑ x t ɦ ɔ n d ə r t
achting	ɑ x t ɪ ŋ
achtste	ɑ x t s t ə
achttien	ɑ x t i n
acne	ɑ k n eː
acrobaat	ɑ k r oː b aː t
acrobatiek	ɑ k r oː b aː t i k
acryl	ɑ k r i l
acteur	ɑ k t øː r
actie	ɑ k s i
actief	ɑ k t i f
actieradius	ɑ k s i r aː d i ʏ s
actinium	ɑ k t i n i ʏ m
activa	ɑ k t i v aː
activisme	ɑ k t i v ɪ s m ə
activiteit	ɑ k t i v i t ɛ i̯ t
actor	ɑ k t ɔ r
actrice	ɑ k t r i s ə
actualiteit	ɑ k t y aː l i t ɛ i̯ t
actualiteitenprogramma	ɑ k t y aː l i t ɛ i̯ t ə n p r oː ɣ r ɑ m aː
acupunctuur	ɑ k y p ʏ ŋ k t y r
acuut	aː k y t
ad	ɑ t
adam	aː d ɑ m
adat	aː d ɑ t
adel	aː d ə l
adelaar	aː d ə l aː r
adeldom	aː d ə l d ɔ m
adelheid	aː d ə l ɦ ɛ i̯ t
adembenemend	aː d ə m b ə n eː m ə n t
ademhaling	aː d ə m ɦ aː l ɪ ŋ
ademloos	aː d ə m l oː s
ademnood	aː d ə m n oː t
adequaat	aː d ə k ʋ aː t
ader	aː d ə r
aderlating	aː d ə r l aː t ɪ ŋ
admin	ɛ d m ɪ n
admiraal	ɑ t m i r aː l
adobe	ɑ d oː b ə
adolf	aː d ɔ l f
adopteren	aː d ɔ p t eː r ə n
adres	aː d r ɛ s
adri	aː d r i
adriaan	aː d r i aː n
adrie	aː d r i
advent	ɑ t f ɛ n t
advies	ɑ t f i s
adviseren	ɑ t f i z eː r ə n
adviseur	ɑ t f i z øː r
advocatuur	ɑ t f oː k aː t yː r
aerobics	ɛ r ɔ b ɪ k s
af	ɑ f
afbakening	ɑ f b aː k ə n ɪ ŋ
afbeelding	ɑ f b eː l d ɪ ŋ
afbetaling	ɑ v b ə t aː l ɪ ŋ
afblijven	ɑ f b l ɛ i̯ v ə n
afbraak	ɑ f b r aː k
afbreken	ɑ v b r eː k ə n
afdaling	ɑ f d aː l ɪ ŋ
afdekken	ɑ f d ɛ k ə n
afdeling	ɑ f d eː l ɪ ŋ
afdoen	ɑ f d u n
afdragen	ɑ f d r aː ɣ ə n
afdruk	ɑ v d r ʏ k
affiche	ɑ f i ʃ ə
afgaan	ɑ f x aː n
afgang	ɑ f x ɑ ŋ
afgebroken	ɑ f x ə b r oː k ə n
afgekeurd	ɑ f x ə k øː r t
afgekocht	ɑ f x ə k ɔ x t
afgelasting	ɑ f x ə l ɑ s t ɪ ŋ
afgelegen	ɑ f x ə l eː ɣ ə n
afgeleide	ɑ f x ə l ɛ i̯ d ə
afgelopen	ɑ f x ə l oː p ə n
afgeven	ɑ f x eː v ə n
afgezonderd	ɑ f x ə z ɔ n d ə r t
afghaan	ɑ f x aː n
afghaanse	ɑ f x aː n s ə
afghanistan	ɑ f x aː n i s t ɑ n
afgieten	ɑ f x i t ə n
afgietsel	ɑ f x i t s ə l
afgoderij	ɑ f x oː d ə r ɛ i̯
afhaalrestaurant	ɑ f ɦ aː l r ɛ s t oː r ɑ n t
afhalen	ɑ f ɦ aː l ə n
afhandelen	ɑ f ɦ ɑ n d ə l ə n
afhangen	ɑ f ɦ ɑ ŋ ə n
afhankelijk	ɑ f ɦ ɑ ŋ k ə l ə k
afkeer	ɑ f k eː r
afknippen	ɑ f k n ɪ p ə n
afkoeling	ɑ f k u l ɪ ŋ
afkomen	ɑ f k oː m ə n
afkomst	ɑ f k ɔ m s t
afkomstig	ɑ f k ɔ m s t ə x
afkorting	ɑ f k ɔ r t ɪ ŋ
afleiden	ɑ f l ɛ i̯ d ə n
afleveren	ɑ f l eː v ə r ə n
aflevering	ɑ f l eː v ə r ɪ ŋ
aflezen	ɑ f l eː z ə n
afloop	ɑ f l oː p
aflopen	ɑ f l oː p ə n
aflossen	ɑ f l ɔ s ə n
afluisteren	ɑ f l œ y̯ s t ə r ə n
afmelden	ɑ f m ɛ l d ə n
afmeten	ɑ f m eː t ə n
afmeting	ɑ f m eː t ɪ ŋ
afname	ɑ f n aː m ə
afnemen	ɑ f n eː m ə n
afpersen	ɑ f p ɛ r s ə n
afpersing	ɑ f p ɛ r s ɪ ŋ
afrekenen	ɑ f r eː k ə n ə n
afrij	ɑ f r ɛ i̯
afrika	aː f r i k aː
afrit	ɑ f r ɪ t
afschaffen	ɑ f s x ɑ f ə n
afscheiding	ɑ f s x ɛ i̯ d ɪ ŋ
afscheidingsbeweging	ɑ f s x ɛ i̯ d ɪ ŋ s b ə ʋ eː ɣ ɪ ŋ
afschieten	ɑ f s x i t ə n
afschrift	ɑ f s x r ɪ f t
afschrikken	ɑ f s x r ɪ k ə n
afschrikking	ɑ f s x r ɪ k ɪ ŋ
afslaan	ɑ f s l aː n
afslag	ɑ f s l ɑ x
afslanken	ɑ f s l ɑ ŋ k ə n
afsluiten	ɑ f s l œ y̯ t ə n
afsnijden	ɑ f s n ɛ i̯ d ə n
afsplitsing	ɑ f s p l ɪ t s ɪ ŋ
afspraak	ɑ f s p r aː k
afspreken	ɑ f s p r eː k ə n
afstaan	ɑ f s t aː n
afstammeling	ɑ f s t ɑ m ə l ɪ ŋ
afstamming	ɑ f s t ɑ m ɪ ŋ
afstandsbediening	ɑ f s t ɑ n t s b ə d i n ɪ ŋ
afstappen	ɑ f s t ɑ p ə n
afsteken	ɑ f s t eː k ə n
afstemmen	ɑ f s t ɛ m ə n
afstoffen	ɑ f s t ɔ f ə n
aftrap	ɑ f t r ɑ p
aftrek	ɑ f t r ɛ k
aftrekken	ɑ f t r ɛ k ə n
afvaardigen	ɑ f aː r d ə ɣ ə n
afvaart	ɑ f aː r t
afval	ɑ f ɑ l
afvallen	ɑ f ɑ l ə n
afvallig	ɑ f ɑ l ə x
afvallige	ɑ f ɑ l ə ɣ ə
afvoer	ɑ f uː r
afvragen	ɑ f r aː ɣ ə n
afwachten	ɑ f ʋ ɑ x t ə n
afwas	ɑ f ʋ ɑ s
afweging	ɑ f ʋ eː ɣ ɪ ŋ
afweren	ɑ f ʋ eː r ə n
afwerken	ɑ f ʋ ɛ r k ə n
afwezig	ɑ f ʋ eː z ə x
afwezigheid	ɑ f ʋ eː z ə x ɦ ɛ i̯ t
afwijken	ɑ f ʋ ɛ i̯ k ə n
afwijzen	ɑ f ʋ ɛ i̯ z ə n
afwikkelen	ɑ f ʋ ɪ k ə l ə n
afwisselen	ɑ f ʋ ɪ s ə l ə n
afwisselend	ɑ f ʋ ɪ s ə l ə n t
afwisseling	ɑ f ʋ ɪ s ə l ɪ ŋ
afzetmarkt	ɑ f z ɛ t m ɑ r k t
afzetten	ɑ f s ɛ t ə n
afzetting	ɑ f z ɛ t ɪ ŋ
afzonderlijk	ɑ f s ɔ n d ə r l ə k
afzuigen	ɑ f z œ y̯ ɣ ə n
afzuigkap	ɑ f z œ y̯ x k ɑ p
agaten	aː ɣ aː t ə n
agendapunt	aː ɣ ɛ n d aː p ʏ n t
agente	aː ɣ ɛ n t ə
agentschap	aː ɣ ɛ n t s x ɑ p
agogiek	aː ɣ oː ɣ i k
agressie	ɑ ɣ r ɛ s i
agressief	ɑ ɣ r ɛ s i f
ai	ɑ i
aids	eː t s
air	ɛː r
airco	ɛ r k oː
airconditioning	ɛː r k ɔ n d ɪ ʃ ə n ɪ ŋ
aivd	aː i v eː d eː
ajuin	aː j œ y̯ n
akademie	aː k aː d eː m i
akelig	aː k ə l ə x
akker	ɑ k ə r
akkerland	ɑ k ə r l ɑ n t
akkerman	ɑ k ə r m ɑ n
akkoord	ɑ k oː r t
akoestisch	aː k u s t i s
aks	ɑ k s
akte	ɑ k t ə
aktentas	ɑ k t ə n t ɑ s
al	ɑ l
alarm	aː l ɑ r m
alarmcentrale	aː l ɑ r m s ɛ n t r aː l ə
alarmsignaal	ɑ l ɑ r m s ɪ n j aː l
albanees	ɑ l b aː n eː s
albanië	ɑ l b aː n i j ə
albatros	ɑ l b aː t r ɔ s
albert	ɑ l b ə r t
album	ɑ l b ʏ m
aldaar	ɑ l d aː r
aldus	ɑ l d ʏ s
ale	eː l
alert	aː l ɛ r t
alertheid	aː l ɛ r t ɦ ɛ i̯ t
alfabet	ɑ l f aː b ɛ t
alfons	ɑ l f ɔ n s
algemeen	ɑ l ɣ ə m eː n
algemeenheid	ɑ l ɣ ə m eː n ɦ ɛ i̯ t
algerije	ɑ l ɣ ə r ɛ i̯ ə
algoritme	ɑ l ɣ oː r ɪ t m ə
alhoewel	ɑ l ɦ u ʋ ɛ l
ali	aː l i
alibi	aː l i b i
alida	aː l i d aː
alien	eː l i ə n
alkmaar	ɑ l k m aː r
allah	ɑ l aː
allang	ɑ l ɑ ŋ
alleen	ɑ l eː n
alleenheerser	ɑ l eː n ɦ eː r s ə r
allemachtig	ɑ l ə m ɑ x t ə x
allen	ɑ l ə n
allengs	ɑ l ɛ ŋ s
aller	ɑ l ə r
allerhande	ɑ l ə r ɦ ɑ n d ə
allerlei	ɑ l ə r l ɛ i̯
alles	ɑ l ə s
alleszins	ɑ l ə s ɪ n s
alliantie	ɑ l i ɑ n t s i
allicht	ɑ l ɪ x t
allochtoon	ɑ l ɔ x t oː n
almaar	ɑ l m aː r
almacht	ɑ l m ɑ x t
almere	ɑ l m eː r ə
alom	ɑ l ɔ m
alomtegenwoordig	ɑ l ɔ m t eː ɣ ə n ʋ oː r d ə x
alonso	aː l ɔ n z oː
aloë	aː l oː eː
alpaca	ɑ l p aː k aː
als	ɑ l s
alsem	ɑ l s ə m
alsjeblieft	ɑ l ʃ ə b l i f t
alsmaar	ɑ l s m aː r
alsmede	ɑ l s m eː d ə
alsnog	ɑ l s n ɔ x
alsof	ɑ l s ɔ f
alsook	ɑ l s oː k
alstublieft	ɑ l s t y b l i f t
altaar	ɑ l t aː r
althans	ɑ l t ɑ n s
altijd	ɑ l t ɛ i̯ t
altoos	ɑ l t oː s
aluminium	aː l y m i n i ʏ m
alvast	ɑ l v ɑ s t
alvleesklier	ɑ l v l eː s k l iː r
alvorens	ɑ l v oː r ə n s
alweer	ɑ l ʋ eː r
alzo	ɑ l z oː
amandel	aː m ɑ n d ə l
amaretto	aː m aː r ɛ t oː
amateur	ɑ m aː t øː r
ambacht	ɑ m b ɑ x t
ambachtelijk	ɑ m b ɑ x t ə l ə k
ambassade	ɑ m b ɑ s aː d ə
ambassadeur	ɑ m b ɑ s aː d øː r
amber	ɑ m b ə r
ambigu	ɑ m b i ɣ y
ambiguïteit	ɑ m b i ɣ y i t ɛ i̯ t
ambitie	ɑ m b i t s i
ambivalentie	ɑ m b i v aː l ɛ n t s i
ambt	ɑ m p t
ambtelijk	ɑ m p t ə l ə k
ambtenaar	ɑ m p t ə n aː r
ambtgenoot	ɑ m p t x ə n oː t
ambulance	ɑ m b y l ɑ n s ə
ameland	aː m ə l ɑ n t
amen	aː m ə n
amendement	aː m ɑ n d ə m ɛ n t
amerika	ɑ m eː r i k aː
amerikaan	aː m eː r i k aː n
amerongen	aː m ə r ɔ ŋ ə n
aminozuur	aː m i n oː z yː r
amnesie	ɑ m n eː z i
amnestie	ɑ m n ɛ s t i
ampul	ɑ m p ʏ l
amstel	ɑ m s t ə l
amstelveen	ɑ m s t ə l v eː n
amsterdam	ɑ m s t ə r d ɑ m
amsterdammer	ɑ m s t ə r d ɑ m ə r
amsterdams	ɑ m s t ə r d ɑ m s
amulet	aː m y l ɛ t
anaal	aː n aː l
analist	aː n aː l ɪ s t
analogie	aː n aː l oː ɣ i
analoog	aː n aː l oː x
analyse	aː n aː l iː z ə
analyseren	aː n aː l i z eː r ə n
analytisch	aː n aː l i t i s s
ananas	ɑ n aː n ɑ s
anatomie	aː n aː t oː m i
ander	ɑ n d ə r
anderhalf	ɑ n d ə r ɦ ɑ l f
anders	ɑ n d ə r s
andersom	ɑ n d ə r s ɔ m
anderstalig	ɑ n d ə r s t aː l ə x
andersvalide	ɑ n d ə r s f aː l i d ə
anderszins	ɑ n d ə r s ɪ n s
anderzijds	ɑ n d ə r z ɛ i̯ t s
andreas	ɑ n d r eː ɑ s
andries	ɑ n d r i s
anekdote	aː n ɛ k d oː t ə
anemie	aː n eː m i
anesthesie	ɑ n ɛ s t eː z i
angel	ɑ ŋ ə l
angina	ɑ ŋ ɣ i n aː
angstig	ɑ ŋ s t ə x
animo	aː n i m oː
anker	ɑ ŋ k ə r
anna	ɑ n aː
anne	ɑ n ə
annemieke	ɑ n ə m i k ə
annexatie	ɑ n ɛ k s aː t s i
anno	ɑ n oː
annuleren	ɑ n y l eː r ə n
anoniem	aː n oː n i m
anouk	aː n u k
ans	ɑ n s
ansichtkaart	ɑ n z ɪ x t k aː r t
antarctica	ɑ n t ɑ r k t i k aː
antarctisch	ɑ n t ɑ r k t i s
anticonceptie	ɑ n t i k ɔ n s ɛ p s i
antiek	ɑ n t i k
antiheld	ɑ n t i ɦ ɛ l t
antropologie	ɑ n t r oː p oː l oː ɣ i
antwerpen	ɑ n t ʋ ɛ r p ə n
antwerpenaar	ɑ n t ʋ ɛ r p ə n aː r
antwoord	ɑ n t ʋ oː r t
antwoorden	ɑ n t ʋ oː r d ə n
aorta	aː ɔ r t aː
apart	aː p ɑ r t
apartheid	aː p ɑ r t ɦ ɛ i̯ t
apk	aː p eː k aː
apologie	aː p oː l oː ɣ i
apostolaat	aː p ɔ s t oː l aː t
apostolisch	aː p ɔ s t oː l i s
apotheker	ɑ p oː t eː k ə r
apparaat	ɑ p aː r aː t
apparatuur	ɑ p aː r aː t yː r
appartementencomplex	ɑ p ɑ r t ə m ɛ n t ə n k ɔ m p l ɛ k s
appelhof	ɑ p ə l ɦ ɔ f
appelmoes	ɑ p ə l m u s
appelsap	ɑ p ə l s ɑ p
appeltaart	ɑ p ə l t aː r t
appendix	ɑ p ɛ n d ɪ k s
applicatie	ɑ p l i k aː t s i
appèl	ɑ p ɛ l
april	ɑ p r ɪ l
aquarist	aː k ʋ aː r ɪ s t
aquarium	aː k ʋ aː r i ʏ m
arabier	aː r aː b iː r
arabisch	ɑ r aː b i s
arabië	aː r aː b i ə
arbeidsmarkt	ɑ r b ɛ i̯ t s m ɑ r k t
arcade	ɑ r k aː d ə
arcadehal	ɑ r k aː d ə ɦ ɑ l
archeologie	ɑ r x eː j oː l oː ɣ i
archeologisch	ɑ r x eː oː l oː ɣ i s
archiefmateriaal	ɑ r x i f m aː t eː r i aː l
architectuur	ɑ r x i t ɛ k t y r
archiveren	ɑ r x i v eː r ə n
arduin	ɑ r d œ y̯ n
are	aː r ə
arend	aː r ə n t
argentinië	ɑ r ɣ ɛ n t i n i ə
argon	ɑ r ɣ ɔ n
argus	ɑ r ɣ ʏ s
arie	aː r i
aristocraat	aː r ɪ s t oː k r aː t
ariër	aː r i ə r
ark	ɑ r k
armatuur	ɑ r m aː t yː r
armband	ɑ r m b ɑ n t
armoede	ɑ r m u d ə
armoedegrens	ɑ r m u d ə ɣ r ɛ n s
arnhem	ɑ r n ɦ ɛ m
arnoud	ɑ r n ɑ u̯ t
aroma	aː r oː m aː
arp	aː ɛ r p eː
arrest	ɑ r ɛ s t
arresteren	ɑ r ɛ s t eː r ə n
arrogant	ɑ r oː ɣ ɑ n t
arrogantie	ɑ r oː ɣ ɑ n t s i
arsenaal	ɑ r s ə n aː l
artefact	ɑ r t ə f ɑ k t
arthur	ɑ r t y r
artistiek	ɑ r t ɪ s t i k
arts	ɑ r t s
as	ɑ s
asbest	ɑ s b ɛ s t
asfalt	ɑ s f ɑ l t
asiel	aː z i l
aspect	ɑ s p ɛ k t
assen	ɑ s ə n
assistent	ɑ s i s t ɛ n t
assistente	ɑ s i s t ɛ n t ə
assisteren	ɑ s i s t eː r ə n
assortiment	ɑ s ɔ r t i m ɛ n t
astma	ɑ s t m aː
astrant	ɑ s t r ɑ n t
astrid	ɑ s t r ɪ t
astrologisch	ɑ s t r oː l oː ɣ i s
asymptomatisch	aː s ɪ m p t oː m aː t i s
at	ɑ t
atelier	aː t ə l j eː
aten	aː t ə n
athene	aː t eː n ə
atheïst	aː t eː j ɪ ʃ t
atjeh	ɑ t j eː
atlas	ɑ t l ɑ s
atleet	ɑ t l eː t
atmosfeer	ɑ t m ɔ s f eː r
atol	aː t ɔ l
atoombom	aː t oː m b ɔ m
attent	ɑ t ɛ n t
attometer	ɑ t oː m eː t ə r
attractie	ɑ t r ɑ k s i
attractiepark	ɑ t r ɑ k s i p ɑ r k
attribuut	ɑ t r i b y t
au	ɑ u̯
audio	ɑ u̯ d i oː
auditie	ɑ u̯ d i t s i
augustus	ɑ u̯ ɣ ʏ s t ʏ s
aura	ɑ u̯ r aː
aureool	ɑ u̯ r eː oː l
australië	ɑ u̯ s t r aː l i j ə
australiër	ɑ u s t r aː l i ə r
autisme	ɑ u̯ t ɪ s m ə
autismespectrumstoornis	ɑ u̯ t ɪ s m ə s p ɛ k t r ʏ m s t oː r n ɪ s
automatisch	ɑ u̯ t oː m aː t i s
automatiseren	ɑ u̯ t oː m aː t i z eː r ə n
automatisering	ɑ u̯ t oː m aː t i z eː r ɪ ŋ
autorijschool	ɑ u̯ t oː r ɛ i̯ s x oː l
autoriteit	ɑ u̯ t oː t i t ɛ i̯ t
autoverzekering	ɑ u̯ t oː v ə r z eː k ə r ɪ ŋ
averechts	aː v ə r ɛ x t s
avond	aː v ɔ n t
avondeten	aː v ɔ n t eː t ə n
avondmaal	aː v ɔ n t m aː l
avondschemering	aː v ɔ n t s x eː m ə r ɪ ŋ
avontuur	aː v ɔ n t y r
axiomatisch	ɑ k s i oː m aː t i s
azië	aː z i j ə
baai	b aː i̯
baal	b aː l
baan	b aː n
baanbrekend	b aː n b r eː k ə n t
baar	b aː r
baard	b aː r t
baardig	b aː r d ə x
baarmoeder	b aː r m u d ə r
baas	b aː s
babbelen	b ɑ b ə l ə n
babel	b aː b ə l
baby	b eː b i
babylon	b aː b i l ɔ n
bacterie	b ɑ k t eː r i
baden	b aː d ə n
badjas	b ɑ t j ɑ s
badkamer	b ɑ t k aː m ə r
badplaats	b ɑ t p l aː t s
bagage	b aː ɣ aː ʒ ə
bagatelliseren	b aː ɣ aː t ɛ l i z eː r ə n
bagdad	b ɑ x d ɑ t
bahasa	b aː ɦ aː s aː
bak	b ɑ k
bakermat	b aː k ə r m ɑ t
bakfiets	b ɑ k f i t s
bakje	b ɑ k j ə
bakken	b ɑ k ə n
bakker	b ɑ k ə r
bakkerij	b ɑ k ə r ɛ i̯
bakkie	b ɑ k i
bakoe	b aː k u
bakpoeder	b ɑ k p u d ə r
bakstenen	b ɑ k s t eː n ə n
bal	b ɑ l
baldakijn	b ɑ l d aː k ɛ i̯ n
balen	b aː l ə n
balie	b aː l i
balk	b ɑ l k
balken	b ɑ l k ə n
balkon	b ɑ l k ɔ n
ballast	b ɑ l ɑ s t
ballen	b ɑ l ə n
ballet	b ɑ l ɛ t
ballingschap	b ɑ l ɪ ŋ s x ɑ p
ballon	b ɑ l ɔ n
balsem	b ɑ l s ə m
balustrade	b aː l y s t r aː d ə
bamboe	b ɑ m b u
banaan	b aː n aː n
bancair	b ɑ ŋ k ɛː r
bandbreedte	b ɑ n t b r eː t ə
banen	b aː n ə n
bang	b ɑ ŋ
bangkok	b ɑ ŋ k ɔ k
bangladesh	b ɑ ŋ ɡ l aː d ɛ ʃ
banja	b ɑ n j aː
bank	b ɑ ŋ k
bankbediende	b ɑ ŋ k b ə d i n d ə
bankovervaller	b ɑ ŋ k oː v ə r v ɑ l ə r
bankrekening	b ɑ ŋ k r eː k ə n ɪ ŋ
bankroet	b ɑ ŋ k r u t
bankschroef	b ɑ ŋ k s x r u f
banksector	b ɑ ŋ k s ɛ k t ɔ r
bankwezen	b ɑ ŋ k ʋ eː z ə n
bankzitter	b ɑ ŋ k s ɪ t ə r
banner	b ɛ n ə r
bar	b ɑ r
barbecue	b ɑ r b ə k j u
barcelona	b ɑ r s ə l oː n aː
baren	b aː r ə n
barendrecht	b aː r ə n d r ɛ x t
baret	b aː r ɛ t
bark	b ɑ r k
barman	b ɑ r m ɑ n
barmhartig	b ɑ r m ɦ ɑ r t ə x
barmhartigheid	b ɑ r m ɦ ɑ r t ə x ɦ ɛ i̯ t
barneveld	b ɑ r n ə v ɛ l t
barnsteen	b ɑ r n s t eː n
baron	b aː r ɔ n
bars	b ɑ r s
bart	b ɑ r t
baryon	b aː r i ɔ n
bas	b ɑ s
baseren	b aː z eː r ə n
basgitaar	b ɑ s x i t aː r
basilicum	b aː z i l i k ʏ m
baskenland	b ɑ s k ə n l ɑ n d
bassin	b ɑ s ɛ n
bassist	b ɑ s ɪ s t
bastion	b ɑ s t i ɔ n
baten	b aː t ə n
batterij	b ɑ t ə r ɛ i̯
bavarois	b aː v aː r ʋ aː
bazen	b aː z ə n
bazuinen	b aː z œ y̯ n ə n
bbp	b eː b eː p eː
beademing	b ə aː d ə m ɪ ŋ
beagle	b iː ɡ ə l
beantwoorden	b ə ɑ n t ʋ oː r d ə n
bebouwing	b ə b ɑ u̯ ɪ ŋ
beconcurreren	b ə k ɔ ŋ k ʏ r eː r ə n
bed	b ɛ t
bedacht	b ə d ɑ x t
beddegoed	b ɛ d ə ɣ u t
bedeesd	b ə d eː s t
bedekt	b ə d ɛ k t
bedekte	b ə d ɛ k t ə
bedelmonnik	b eː d ə l m ɔ n ɪ k
bedenken	b ə d ɛ ŋ k ə n
bedenker	b ə d ɛ ŋ k ə r
bederven	b ə d ɛ r v ə n
bedevaartsoord	b eː d ə v aː r t s oː r t
bediener	b ə d i n ə r
bediening	b ə d i n ɪ ŋ
bedoel	b ə d u l
bedoelen	b ə d u l ə n
bedoeling	b ə d u l ɪ ŋ
bedrading	b ə d r aː d ɪ ŋ
bedrag	b ə d r ɑ x
bedragen	b ə d r aː ɣ ə n
bedreigen	b ə d r ɛ i̯ ɣ ə n
bedreven	b ə d r eː v ə n
bedriegen	b ə d r i ɣ ə n
bedrijf	b ə d r ɛ i̯ f
bedrijfsleven	b ə d r ɛ i̯ f s l eː v ə n
bedrijven	b ə d r ɛ i̯ v ə n
bedrog	b ə d r ɔ x
bedruipen	b ə d r œ y̯ p ə n
bedrukken	b ə d r ʏ k ə n
beducht	b ə d ʏ x t
beduidend	b ə d œ y̯ d ə n t
beek	b eː k
beeldbuis	b eː l t b œ y̯ s
beelden	b eː l d ə n
beeldend	b eː l d ə n t
beeldenstorm	b eː l d ə n s t ɔ r m
beeldhouwer	b eː l t ɦ ɑ u̯ ə r
beeldscherm	b eː l t s x ɛ r m
beeltenis	b eː l t ə n ɪ s
been	b eː n
beenmerg	b eː n m ɛ r x
beer	b eː r
beerput	b eː r p ʏ t
beesel	b eː s ə l
beest	b eː s t
beet	b eː t
beetje	b eː t j ə
befaamd	b ə f aː m t
begaafd	b ə ɣ aː f t
begaan	b ə ɣ aː n
begeerte	b ə ɣ eː r t ə
begeleiden	b ə ɣ ə l ɛ i̯ d ə n
begeleiding	b ə ɣ ə l ɛ i̯ d ɪ ŋ
begeven	b ə ɣ eː v ə n
beginnerscursus	b ə ɣ ɪ n ə r s k ʏ r z ʏ s
beginpunt	b ə ɣ ɪ n p ʏ n t
beginsel	b ə ɣ ɪ n s ə l
begraafplaats	b ə ɣ r aː f p l aː t s
begrafenis	b ə ɣ r aː f ə n ɪ s
begraven	b ə ɣ r aː v ə n
begrensd	b ə ɣ r ɛ n s t
begrijp	b ə ɣ r ɛ i̯ p
begrijpen	b ə ɣ r ɛ i̯ p ə n
begrip	b ə ɣ r ɪ p
begrippenkader	b ə ɣ r ɪ p ə n k aː d ə r
begroeien	b ə ɣ r u i̯ ə n
begroeiing	b ə ɣ r u j ɪ ŋ
begroeten	b ə ɣ r u t ə n
begroting	b ə ɣ r oː t ɪ ŋ
begrotingsbeleid	b ə ɣ r oː t ɪ ŋ s b ə l ɛ i̯ t
begrotingsevenwicht	b ə ɣ r oː t ɪ ŋ s eː v ə n ʋ ɪ x t
behaaglijk	b ə ɦ aː x l ə k
behalen	b ə ɦ aː l ə n
behalve	b ə ɦ ɑ l v ə
behandelaar	b ə ɦ ɑ n d ə l aː r
behandeld	b ə ɦ ɑ n d ə l t
behandelen	b ə ɦ ɑ n d ə l ə n
behandeling	b ə ɦ ɑ n d ə l ɪ ŋ
behandelt	b ə ɦ ɑ n d ə l t
behang	b ə ɦ ɑ ŋ
behartigen	b ə ɦ ɑ r t ə ɣ ə n
beheer	b ə ɦ eː r
beheerbaar	b ə ɦ eː r b aː r
beheerder	b ə ɦ eː r d ə r
beheersbaar	b ə ɦ eː r s b aː r
beheersen	b ə ɦ eː r s ə n
beheersing	b ə ɦ eː r s ɪ ŋ
beheerst	b ə ɦ eː r s t
behendigheid	b ə ɦ ɛ n d ə x ɦ ɛ i̯ t
beheren	b ə ɦ eː r ə n
behoeden	b ə ɦ u d ə n
behoefte	b ə ɦ u f t ə
behoorlijk	b ə ɦ oː r l ə k
behoren	b ə ɦ oː r ə n
behoud	b ə ɦ ɑ u̯ t
behouden	b ə ɦ ɑ u̯ d ə n
behoudens	b ə ɦ ɑ u̯ d ə n s
beide	b ɛ i̯ d ə
beiden	b ɛ i̯ d ə n
beieren	b ɛ i̯ ə r ə n
beilen	b ɛ i̯ l ə n
beiroet	b ɛ i̯ r u t
bejaardentehuis	b ə j aː r d ə n t ə ɦ œ y̯ s
bek	b ɛ k
bekend	b ə k ɛ n t
bekende	b ə k ɛ n d ə
bekendheid	b ə k ɛ n t ɦ ɛ i̯ t
bekennen	b ə k ɛ n ə n
bekentenis	b ə k ɛ n t ə n ɪ s
bekerfinale	b eː k ə r f i n aː l ə
bekering	b ə k eː r ɪ ŋ
bekertoernooi	b eː k ə r t u r n oː i̯
bekeuren	b ə k øː r ə n
bekijken	b ə k ɛ i̯ k ə n
bekken	b ɛ k ə n
beklemming	b ə k l ɛ m ɪ ŋ
beklimmen	b ə k l ɪ m ə n
beknopt	b ə k n ɔ p t
beknotten	b ə k n ɔ t ə n
bekomen	b ə k oː m ə n
bekommeren	b ə k ɔ m ə r ə n
bekopen	b ə k oː p ə n
bekoren	b ə k oː r ə n
bekostigen	b ə k ɔ s t ə ɣ ə n
bekrompen	b ə k r ɔ m p ə n
bekroning	b ə k r oː n ɪ ŋ
bekwaamheid	b ə k ʋ aː m ɦ ɛ i̯ t
bel	b ɛ l
belabberd	b ə l ɑ b ə r t
beladen	b ə l aː d ə n
belagen	b ə l aː ɣ ə n
belager	b ə l aː ɣ ə r
belanden	b ə l ɑ n d ə n
belang	b ə l ɑ ŋ
belanghebbende	b ə l ɑ ŋ ɦ ɛ b ə n d ə
belangrijk	b ə l ɑ ŋ r ɛ i̯ k
belangrijkheid	b ə l ɑ ŋ r ɛ i̯ k ɦ ɛ i̯ t
belasting	b ə l ɑ s t ɪ ŋ
belastingaangifte	b ə l ɑ s t ɪ ŋ aː n ɣ ɪ f t ə
belastingbetaler	b ə l ɑ s t ɪ ŋ b ə t aː l ə r
belastinggeld	b ə l ɑ s t ɪ ŋ ɣ ɛ l t
belastingontduiking	b ə l ɑ s t ɪ ŋ ɔ n d œ y̯ k ɪ ŋ
beledigen	b ə l eː d ə ɣ ə n
belediging	b ə l eː d ə ɣ ɪ ŋ
beleefd	b ə l eː f t
beleg	b ə l ɛ x
belegering	b ə l eː ɣ ə r ɪ ŋ
beleggen	b ə l ɛ ɣ ə n
belegger	b ə l ɛ ɣ ə r
belegging	b ə l ɛ ɣ ɪ ŋ
beleid	b ə l ɛ i̯ t
beleidsmaker	b ə l ɛ i̯ t s m aː k ə r
belemmeren	b ə l ɛ m ə r ə n
belenen	b ə l eː n ə n
beletten	b ə l ɛ t ə n
beleven	b ə l eː v ə n
beleving	b ə l eː v ɪ ŋ
belgen	b ɛ l ɣ ə n
belgisch	b ɛ l ɣ i s
belgië	b ɛ l ɣ i j ə
belgrado	b ɛ l ɣ r aː d oː
belichten	b ə l ɪ x t ə n
believen	b ə l i v ə n
belijden	b ə l ɛ i̯ d ə n
belijdenis	b ə l ɛ i̯ d ə n ɪ s
bella	b ɛ l aː
bellen	b ɛ l ə n
beller	b ɛ l ə r
bello	b ɛ l oː
belofte	b ə l ɔ f t ə
belonen	b ə l oː n ə n
beloning	b ə l oː n ɪ ŋ
belt	b ɛ l t
beluisteren	b ə l œ y̯ s t ə r ə n
bemachtigen	b ə m ɑ x t ə ɣ ə n
bemerken	b ə m ɛ r k ə n
bemiddeld	b ə m ɪ d ə l t
bemiddeling	b ə m ɪ d ə l ɪ ŋ
bemoediging	b ə m u d ə ɣ ɪ ŋ
bemoeilijken	b ə m u j l ə k ə n
ben	b ɛ n
benaderen	b ə n aː d ə r ə n
benadering	b ə n aː d ə r ɪ ŋ
benadrukken	b ə n aː d r ʏ k ə n
beneden	b ə n eː d ə n
benelux	b eː n ə l y k s
benen	b eː n ə n
benoemen	b ə n u m ə n
bent	b ɛ n t
benutten	b ə n ʏ t ə n
benzinestation	b ɛ n z i n ə s t aː ʃ ɔ n
beoefenen	b ə u f ə n ə n
beoordelen	b ə oː r d eː l ə n
beoordeling	b ə oː r d eː l ɪ ŋ
bep	b ɛ p
bepaald	b ə p aː l t
bepalen	b ə p aː l ə n
bepaling	b ə p aː l ɪ ŋ
beperken	b ə p ɛ r k ə n
beperking	b ə p ɛ r k ɪ ŋ
beperkt	b ə p ɛ r k t
beplanten	b ə p l ɑ n t ə n
bepleiten	b ə p l ɛ i̯ t ə n
beraad	b ə r aː t
beraadslagen	b ə r aː t s l aː ɣ ə n
beraden	b ə r aː d ə n
berber	b ɛ r b ə r
bereid	b ə r ɛ i̯ t
bereiden	b ə r ɛ i̯ d ə n
bereidheid	b ə r ɛ i̯ t ɦ ɛ i̯ t
bereiding	b ə r ɛ i̯ d ɪ ŋ
bereik	b ə r ɛ i̯ k
bereikbaar	b ə r ɛ i̯ k b aː r
bereiken	b ə r ɛ i̯ k ə n
berekenen	b ə r eː k ə n ə n
berend	b eː r ə n t
berends	b eː r ə n t s
berg	b ɛ r x
bergachtig	b ɛ r x ɑ x t ə x
bergafwaarts	b ɛ r x ɑ f ʋ aː r t s
bergen	b ɛ r ɣ ə n
berger	b ɛ r ɣ ə r
berggeit	b ɛ r x ɛ i̯ t
berging	b ɛ r ɣ ɪ ŋ
bergketen	b ɛ r x k eː t ə n
bergman	b ɛ r x m ɑ n
bergop	b ɛ r x ɔ p
berichtgeving	b ə r ɪ x t x eː v ɪ ŋ
berm	b ɛ r m
bermbom	b ɛ r m b ɔ m
bermtoerist	b ɛ r m t u r ɪ s t
beroeps	b ə r u p s
beroepsmatig	b ə r u p s m aː t ə x
beroerte	b ə r uː r t ə
berouw	b ə r ɑ u̯
berucht	b ə r ʏ x t
berusten	b ə r ʏ s t ə n
bes	b ɛ s
beschadigen	b ə s x aː d ə ɣ ə n
beschadiging	b ə s x aː d ə ɣ ɪ ŋ
beschaving	b ə s x aː v ɪ ŋ
bescheiden	b ə s x ɛ i̯ d ə n
bescheidener	b ə s x ɛ i̯ d ə n ə r
beschermen	b ə s x ɛ r m ə n
beschermengel	b ə s x ɛ r m ɛ ŋ ə l
bescherming	b ə s x ɛ r m ɪ ŋ
beschieten	b ə s x i t ə n
beschikbaarheid	b ə s x ɪ k b aː r ɦ ɛ i̯ t
beschikken	b ə s x ɪ k ə n
beschikking	b ə s x ɪ k ɪ ŋ
beschonken	b ə s x ɔ ŋ k ə n
beschoren	b ə s x oː r ə n
beschouw	b ə s x ɑ u̯
beschouwd	b ə s x ɑ u̯ t
beschouwen	b ə s x ɑ u̯ ə n
beschouwing	b ə s x ɑ u̯ ɪ ŋ
beschrijving	b ə s x r ɛ i̯ v ɪ ŋ
beschuit	b ə s x œ y̯ t
beschuldigen	b ə s x ʏ l d ə ɣ ə n
beschuldiging	b ə s x ʏ l d ə ɣ ɪ ŋ
beschutting	b ə s x ʏ t ɪ ŋ
besef	b ə s ɛ f
beseffen	b ə s ɛ f ə n
beslaan	b ə s l aː n
beslag	b ə s l ɑ x
beslagen	b ə s l aː ɣ ə n
beslechten	b ə s l ɛ x t ə n
beslissen	b ə s l ɪ s ə n
beslist	b ə s l ɪ s t
besluit	b ə s l œ y̯ t
besluiten	b ə s l œ y̯ t ə n
besmetten	b ə s m ɛ t ə n
besmetting	b ə s m ɛ t ɪ ŋ
besmeuren	b ə s m øː r ə n
besnijdenis	b ə s n ɛ i̯ d ə n ɪ s
besparen	b ə s p aː r ə n
besparing	b ə s p aː r ɪ ŋ
bespelen	b ə s p eː l ə n
bespeuren	b ə s p øː r ə n
bespotten	b ə s p ɔ t ə n
bespreekbaar	b ə s p r eː k b aː r
bespreken	b ə s p r eː k ə n
bespreking	b ə s p r eː k ɪ ŋ
bestaan	b ə s t aː n
bestanddeel	b ə s t ɑ n t d eː l
bestanden	b ə s t ɑ n d ə n
besteden	b ə s t eː d ə n
bestek	b ə s t ɛ k
bestelformulier	b ə s t ɛ l f ɔ r m y l iː r
bestellen	b ə s t ɛ l ə n
bestelling	b ə s t ɛ l ɪ ŋ
bestelwagen	b ə s t ɛ l ʋ aː ɣ ə n
bestemming	b ə s t ɛ m ɪ ŋ
bestempelen	b ə s t ɛ m p ə l ə n
bestendig	b ə s t ɛ n d ə x
bestoken	b ə s t oː k ə n
bestraffen	b ə s t r ɑ f ə n
bestraffing	b ə s t r ɑ f ɪ ŋ
bestralen	b ə s t r aː l ə n
bestraten	b ə s t r aː t ə n
bestrijden	b ə s t r ɛ i̯ d ə n
bestrijding	b ə s t r ɛ i̯ d ɪ ŋ
bestrijken	b ə s t r ɛ i̯ k ə n
bestuderen	b ə s t y d eː r ə n
besturen	b ə s t y r ə n
besturingssysteem	b ə s t yː r ɪ ŋ s i s t eː m
bestuur	b ə s t yː r
bestuurder	b ə s t yː r d ə r
bestuurlijk	b ə s t yː r l ə k
bestuursvorm	b ə s t yː r s f ɔ r m
betaalbaar	b ə t aː l b aː r
betaling	b ə t aː l ɪ ŋ
betekenis	b ə t eː k ə n ɪ s
beter	b eː t ə r
bethlehem	b ɛ t l eː ɦ ɛ m
betogen	b ə t oː ɣ ə n
betoging	b ə t oː ɣ ɪ ŋ
beton	b ə t ɔ n
betonnen	b ə t ɔ n ə n
betoog	b ə t oː x
betoveren	b ə t oː v ə r ə n
betovering	b ə t oː v ə r ɪ ŋ
betrappen	b ə t r ɑ p ə n
betreden	b ə t r eː d ə n
betreffen	b ə t r ɛ f ə n
betreffende	b ə t r ɛ f ə n
betrekkelijk	b ə t r ɛ k ə l ə k
betrekken	b ə t r ɛ k ə n
betrekking	b ə t r ɛ k ɪ ŋ
betrokken	b ə t r ɔ k ə n
betrokkenheid	b ə t r ɔ k ə n ɦ ɛ i̯ t
betrouwbaar	b ə t r ɑ u̯ b aː r
betrouwbaarheid	b ə t r ɑ u̯ b aː r ɦ ɛ i̯ t
betweter	b ɛ t ʋ eː t ə r
betwijfelen	b ə t ʋ ɛ i̯ f ə l ə n
betwist	b ə t ʋ ɪ s t
betwistbaar	b ə t ʋ ɪ s t b aː r
beugel	b øː ɣ ə l
beuk	b øː k
beuken	b øː k ə n
beul	b øː l
beun	b øː n
beuningen	b øː n ɪ ŋ ə n
beurs	b øː r s
beurt	b øː r t
bevallen	b ə v ɑ l ə n
bevalling	b ə v ɑ l ɪ ŋ
bevaren	b ə v aː r ə n
bevatten	b ə v ɑ t ə n
beveiligen	b ə v ɛ i̯ l ə ɣ ə n
beveiliging	b ə v ɛ i̯ l ə ɣ ɪ ŋ
bevel	b ə v ɛ l
bevelhebber	b ə v ɛ l ɦ ɛ b ə r
bevestigen	b ə v ɛ s t ə ɣ ə n
bevestiging	b ə v ɛ s t ə ɣ ɪ ŋ
bevind	b ə v ɪ n t
bevindelijk	b ə v ɪ n d ə l ə k
bevinden	b ə v ɪ n d ə n
bevindingen	b ə v ɪ n d ɪ ŋ ə n
bevindt	b ə v ɪ n t
bevoegd	b ə v u x t
bevolken	b ə v ɔ l k ə n
bevolking	b ə v ɔ l k ɪ ŋ
bevoordelen	b ə v oː r d eː l ə n
bevorderen	b ə v ɔ r d ə r ə n
bevragen	b ə v r aː ɣ ə n
bevreesd	b ə v r eː s t
bevriezen	b ə v r i z ə n
bevrijden	b ə v r ɛ i̯ d ə n
bevrijding	b ə v r ɛ i̯ d ɪ ŋ
bevruchten	b ə v r ʏ x t ə n
bewaker	b ə ʋ aː k ə r
bewaking	b ə ʋ aː k ɪ ŋ
bewaren	b ə ʋ aː r ə n
bewaring	b ə ʋ aː r ɪ ŋ
beweegbaar	b ə ʋ eː x b aː r
bewegen	b ə ʋ eː ɣ ə n
beweging	b ə ʋ eː ɣ ɪ ŋ
bewegingsapparaat	b ə ʋ eː ɣ ɪ ŋ s ɑ p aː r aː t
beweren	b ə ʋ eː r ə n
bewerken	b ə ʋ ɛ r k ə n
bewerking	b ə ʋ ɛ r k ɪ ŋ
bewerkstelligen	b ə ʋ ɛ r k s t ɛ l ə ɣ ə n
bewijs	b ə ʋ ɛ i̯ s
bewijzen	b ə ʋ ɛ i̯ z ə n
bewindsvrouw	b ə ʋ ɪ n t s f r ɑ u̯
bewindvoerder	b ə ʋ ɪ n t f uː r d ə r
bewogen	b ə ʋ oː ɣ ə n
bewonderen	b ə ʋ ɔ n d ə r ə n
bewonderenswaardig	b ə ʋ ɔ n d ə r ə n s ʋ aː r d ə x
bewondering	b ə ʋ ɔ n d ə r ɪ ŋ
bewonen	b ə ʋ oː n ə n
bewoner	b ə ʋ oː n ə r
bewoond	b ə ʋ oː n t
bewusteloos	b ə ʋ ʏ s t ə l oː s
bezetter	b ə z ɛ t ə r
bezichtigen	b ə z ɪ x t ə ɣ ə n
bezielen	b ə z i l ə n
bezieling	b ə z i l ɪ ŋ
bezien	b ə z i n
bezienswaardigheid	b ə z i n s ʋ aː r d ə x ɦ ɛ i̯ t
bezig	b eː z ə x
bezigheid	b eː z ə x ɦ ɛ i̯ t
bezingen	b ə z ɪ ŋ ə n
bezinnen	b ə z ɪ n ə n
bezinning	b ə z ɪ n ɪ ŋ
bezitter	b ə z ɪ t ə r
bezocht	b ə z ɔ x t
bezoek	b ə z u k
bezoeken	b ə z u k ə n
bezoeker	b ə z u k ə r
bezoekt	b ə z u k t
bezorgd	b ə z ɔ r x t
bezorgen	b ə z ɔ r ɣ ə n
bezorging	b ə z ɔ r ɣ ɪ ŋ
bezuinigen	b ə z œ y̯ n ə ɣ ə n
bezuiniging	b ə z œ y̯ n ə ɣ ɪ ŋ
bezwaar	b ə z ʋ aː r
bezwaarschrift	b ə z ʋ aː r s x r ɪ f t
bezwaren	b ə z ʋ aː r ə n
bezweet	b ə z ʋ eː t
bezwijken	b ə z ʋ ɛ i̯ k ə n
beïnvloeden	b ə ɪ n v l u d ə n
bi	b i
bibi	b i b i
bibliografie	b i b l i j oː ɣ r aː f i
bidden	b ɪ d ə n
bieden	b i d ə n
biel	b i l
bier	b i r
bierbrouwer	b iː r b r ɑ u̯ ə r
bierbuik	b iː r b œ y̯ k
biervat	b iː r v ɑ t
biestmelk	b i s t m ɛ l k
big	b ɪ x
bij	b ɛ i̯
bijbels	b ɛ i̯ b ə l s
bijbrengen	b ɛ i̯ b r ɛ ŋ ə n
bijdrage	b ɛ i̯ d r aː ɣ ə
bijdragen	b ɛ i̯ d r aː ɣ ə n
bijeen	b ɛ i̯ eː n
bijeenkomst	b ɛ i̯ eː n k ɔ m s t
bijgebouw	b ɛ i̯ ɣ ə b ɑ u̯
bijgeloof	b ɛ i̯ ɣ ə l oː f
bijgelovigheid	b ɛ i̯ ɣ ə l oː v ə x ɦ ɛ i̯ t
bijgenaamd	b ɛ i̯ ɣ ə n aː m t
bijgevolg	b ɛ i̯ ɣ ə v ɔ l x
bijhouden	b ɛ i̯ ɦ ɑ u̯ d ə n
bijklank	b ɛ i̯ k l ɑ ŋ k
bijkomen	b ɛ i̯ k oː m ə n
bijlage	b ɛ i̯ l aː ɣ ə
bijldrager	b ɛ i̯ l d r aː ɣ ə r
bijltje	b ɛ i̯ l t j ə
bijna	b ɛ i̯ n aː
bijnaam	b ɛ i̯ n aː m
bijou	b i ʒ u
bijrol	b ɛ i̯ r ɔ l
bijstand	b ɛ i̯ s t ɑ n t
bijstellen	b ɛ i̯ s t ɛ l ə n
bijster	b ɛ i̯ s t ə r
bijt	b ɛ i̯ t
bijtanken	b ɛ i̯ t ɛ ŋ k ə n
bijten	b ɛ i̯ t ə n
bijtijds	b ɛ i̯ t ɛ i̯ t s
bijval	b ɛ i̯ v ɑ l
bijvoorbeeld	b ɛ i̯ v oː r b eː l t
bijvullen	b ɛ i̯ v ʏ l ə n
bijwerken	b ɛ i̯ ʋ ɛ r k ə n
bijwijf	b ɛ i̯ ʋ ɛ i̯ f
bijwonen	b ɛ i̯ ʋ oː n ə n
bijwoning	b ɛ i̯ ʋ oː n ɪ ŋ
bijzaak	b ɛ i̯ z aː k
bijzijn	b ɛ i̯ z ɛ i̯ n
bijzonder	b i z ɔ n d ə r
bijzonderheid	b i z ɔ n d ə r ɦ ɛ i̯ t
bildungsroman	b ɪ l d u ŋ s r oː m ɑ n
biljart	b ɪ l j ɑ r t
biljoen	b ɪ l j u n
bimbo	b ɪ m b oː
binden	b ɪ n d ə n
binding	b ɪ n d ɪ ŋ
binnenband	b ɪ n ə n b ɑ n t
binnendoor	b ɪ n ə n d oː r
binnenhalen	b ɪ n ə n ɦ aː l ə n
binnenkant	b ɪ n ə n k ɑ n t
binnenkomen	b ɪ n ə n k oː m ə n
binnenkort	b ɪ n ə n k ɔ r t
binnenlands	b ɪ n ə n l ɑ n t s
binnenmuur	b ɪ n ə n m yː r
binnenplaats	b ɪ n ə n p l aː t s
binnenstad	b ɪ n ə n s t ɑ t
binnentrekken	b ɪ n ə n t r ɛ k ə n
binnenvaart	b ɪ n ə n v aː r t
binnenvaartschip	b ɪ n ə n v aː r t s x ɪ p
binnenvallen	b ɪ n ə n v ɑ l ə n
binnenweg	b ɪ n ə n ʋ ɛ x
binnenzak	b ɪ n ə n z ɑ k
binocle	b i n ɔ k l ə
bint	b ɪ n t
bio	b i oː
biochemisch	b i oː x eː m i s
biodanza	b i oː d ɑ n z aː
biodiversiteit	b i oː d i v ɛ r s i t ɛ i̯ t
biofysica	b i oː f i z i k aː
biografisch	b i oː ɣ r aː f i s
biologisch	b i j oː l oː ɣ i s
bioloog	b i oː l oː x
bioscoop	b i ɔ s k oː p
biosfeer	b i oː s f eː r
biotechnologie	b i oː t ɛ x n oː l oː ɣ i
birma	b ɪ r m aː
birmaan	b ɪ r m aː n
bis	b i s
bisdom	b ɪ s d ɔ m
biseksueel	b i s ɛ k s y eː l
bisschop	b ɪ s x ɔ p
bisschoppelijk	b ɪ s s x ɔ p ə l ə k
bit	b ɪ t
bits	b ɪ t s
bittergarnituur	b ɪ t ə r ɣ ɑ r n i t yː r
bivak	b i v ɑ k
bizon	b i z ɔ n
blaaskapel	b l aː s k aː p ɛ l
blaasontsteking	b l aː s ɔ n t s t eː k ɪ ŋ
blad	b l ɑ t
bladeren	b l aː d ə r ə n
bladmuziek	b l ɑ t m y z i k
bladschede	b l ɑ t s x eː d ə
bladzij	b l ɑ t s ɛ i̯
bladzijde	b l ɑ t s ɛ i̯ d ə
blaren	b l aː r ə n
blauw	b l ɑ u̯
blauwdruk	b l ɑ u̯ d r ʏ k
blauwe	b l ɑ u̯ ə
blauwgrijs	b l ɑ u̯ ɣ r ɛ i̯ s
blazen	b l aː z ə n
bleek	b l eː k
bleekselderij	b l eː k s ɛ l d ə r ɛ i̯
bleker	b l eː k ə r
bles	b l ɛ s
blessure	b l ɛ s yː r ə
blessuretijd	b l ɛ s y r ə t ɛ i̯ t
blij	b l ɛ i̯
blijdschap	b l ɛ i̯ t s x ɑ p
blijk	b l ɛ i̯ k
blijkbaar	b l ɛ i̯ k b aː r
blijven	b l ɛ i̯ v ə n
blijvend	b l ɛ i̯ v ə n t
bliksem	b l ɪ k s ə m
blikvanger	b l ɪ k f ɑ ŋ ə r
blind	b l ɪ n t
blindheid	b l ɪ n d ɦ ɛ ɪ t
blinken	b l ɪ ŋ k ə n
bloedarmoede	b l u t ɑ r m u d ə
bloedbad	b l u t b ɑ t
bloeddonor	b l u t d oː n ɔ r
bloeddruk	b l u t d r ʏ k
bloedgroep	b l u t x r u p
bloedhekel	b l u t ɦ eː k ə l
bloedig	b l u d ə x
bloeding	b l u d ɪ ŋ
bloedneus	b l u t n øː s
bloedsomloop	b l u t s ɔ m l oː p
bloedstroom	b l u t s t r oː m
bloedsuiker	b l u t s œ y̯ k ə r
bloedtransfusie	b l u t t r ɑ n s f y z i
bloedvergieten	b l u t f ə r ɣ i t ə n
bloei	b l u i̯
bloem	b l u m
bloemen	b l u m ə n
bloemendaal	b l u m ə n d aː l
bloemenveiling	b l u m ə n v ɛ i̯ l ɪ ŋ
bloemlezing	b l u m l eː z ɪ ŋ
bloemrijk	b l u m r ɛ i̯ k
bloesem	b l u s ə m
blog	b l ɔ x
blok	b l ɔ k
blokkade	b l ɔ k aː d ə
blokken	b l ɔ k ə n
blokkeren	b l ɔ k eː r ə n
blom	b l ɔ m
blond	b l ɔ n t
blondine	b l ɔ n d iː n ə
blood	b l oː t
bloot	b l oː t
blootstelling	b l oː t s t ɛ l ɪ ŋ
blozen	b l oː z ə n
bluffen	b l ʏ f ə n
blunder	b ʏ n d ə r
blut	b l ʏ t
bnp	b eː ɛ n p eː
bo	b oː
boa	b oː aː
bob	b ɔ p
bochel	b ɔ x ə l
bocht	b ɔ x t
bode	b oː d ə
bodem	b oː d ə m
bodemonderzoek	b oː d ə m ɔ n d ə r z u k
bodenbrood	b oː d ə n b r oː t
body	b ɔ d i
boe	b u
boedapest	b u d aː p ɛ s t
boeddhisme	b u d ɪ s m ə
boeddhist	b u d ɪ s t
boeg	b u x
boegbeeld	b u x b eː l t
boeie	b u i̯ ə
boeien	b u i̯ ə n
boeiend	b u j ə n t
boek	b u k
boekarest	b u k aː r ɛ s t
boekdeel	b u k d eː l
boeken	b u k ə n
boeket	b u k ɛ t
boekhandel	b u k ɦ ɑ n d ə l
boekhouden	b u k ɦ ɑ u̯ d ə n
boekhouder	b u k ɦ ɑ u̯ d ə r
boekhouding	b u k ɦ ɑ u̯ d ɪ ŋ
boekjaar	b u k j aː r
boel	b u l
boemel	b u m ə l
boer	b uː r
boerderij	b u r d ə r ɛ i̯
boeren	b uː r ə n
boerenbedriegerij	b uː r ə n b ə d r i ɣ ə r ɛ i̯
boerenkaas	b uː r ə n k aː s
boerenland	b uː r ə n l ɑ n t
boerenzwaluw	b uː r ə n z ʋ aː l y u̯
boete	b u t ə
boezem	b u z ə m
bogen	b oː ɣ ə n
boiler	b ɔ i̯ l ə r
bok	b ɔ k
bokaal	b oː k aː l
bokken	b ɔ k ə n
boksen	b ɔ k s ə n
bokser	b ɔ k s ə r
bol	b ɔ l
bolleboos	b ɔ l ə b oː s
bollen	b ɔ l ə n
bolletjestrui	b ɔ l ə t j ə s t r œ y̯
bolsward	b ɔ l s ʋ ɑ r t
bolvormig	b ɔ l v ɔ r m ə x
bom	b ɔ m
bomaanslag	b ɔ m aː n s l ɑ x
bombardement	b ɔ m b ɑ r d ə m ɛ n t
bombarderen	b ɔ m b ɑ r d eː r ə n
bomen	b oː m ə n
bommenwerper	b ɔ m ə n ʋ ɛ r p ə r
bon	b ɔ n
bond	b ɔ n t
bondgenoot	b ɔ n t x ə n oː t
bondgenootschap	b ɔ n t x ə n oː t s x ɑ p
bongo	b ɔ ŋ ɡ oː
bont	b ɔ n t
bonten	b ɔ n t ə n
bonus	b oː n ʏ s
boodschap	b oː t s x ɑ p
boodschappen	b oː t s x ɑ p ə n
boog	b oː x
boon	b oː n
boor	b oː r
boord	b oː r t
boosaardig	b oː s aː r d ə x
boosdoener	b oː s d u n ə r
boosheid	b oː s ɦ ɛ i̯ t
boot	b oː t
boottocht	b oː t ɔ x t
bord	b ɔ r t
bordeaux	b ɔ r d oː
borduren	b ɔ r d y r ə n
boreling	b oː r ə l ɪ ŋ
boren	b oː r ə n
borg	b ɔ r x
borger	b ɔ r ɣ ə r
born	b ɔ r n
borne	b ɔ r n ə
borrel	b ɔ r ə l
borst	b ɔ r s t
borstel	b ɔ r s t ə l
borstelen	b ɔ r s t ə l ə n
borstelig	b ɔ r s t ə l ə x
borsten	b ɔ r s t ə n
borstkanker	b ɔ r s t k ɑ ŋ k ə r
borstkas	b ɔ r s t k ɑ s
borstvoeding	b ɔ r s t f u d ɪ ŋ
borstwapen	b ɔ r s t ʋ aː p ə n
borstwering	b ɔ r s t ʋ eː r ɪ ŋ
bos	b ɔ s
bosbouw	b ɔ s b ɑ u̯
bosbrand	b ɔ s b r ɑ n t
bosch	b ɔ s
bosnië	b ɔ s n i ə
bosrijk	b ɔ s r ɛ i̯ k
boswachter	b ɔ s ʋ ɑ x t ə r
bot	b ɔ t
boten	b oː t ə n
boter	b oː t ə r
botsen	b ɔ t s ə n
botsing	b ɔ t s ɪ ŋ
botswana	b ɔ t s ʋ aː n aː
botten	b ɔ t ə n
bouillon	b u l j ɔ n
boulevard	b u l ə v aː r
boulevardkrant	b u l ə v aː r k r ɑ n t
bourgeois	b u r ʒ ʋ aː
bouw	b ɑ u̯
bouwen	b ɑ u̯ ə n
bouwer	b ɑ u̯ ə r
bouwheer	b ɑ u̯ ɦ eː r
bouwkunde	b ɑ u̯ k ʏ n d ə
bouwkundig	b ɑ u̯ k ʏ n d ə x
bouwman	b ɑ u̯ m ɑ n
bouwmarkt	b ɑ u̯ m ɑ r k t
bouwsel	b ɑ u̯ s ə l
bouwt	b ɑ u̯ t
bouwvak	b ɑ u̯ v ɑ k
bouwvakker	b ɑ u̯ v ɑ k ə r
bouwvallig	b ɑ u̯ v ɑ l ə x
bouwwerk	b ɑ u̯ ʋ ɛ r k
bovenaan	b oː v ə n aː n
bovenal	b oː v ə n ɑ l
bovenbouw	b oː v ə n b ɑ u̯
bovenkant	b oː v ə n k ɑ n t
bovenop	b oː v ə n ɔ p
bovenstaand	b oː v ə n s t aː n t
bovenstad	b oː v ə n s t ɑ t
boventoon	b oː v ə n t oː n
bovenwereld	b oː v ə n ʋ eː r ə l t
bovenzijde	b oː v ə n z ɛ i̯ d ə
box	b ɔ k s
boy	b ɔ i̯
boycot	b ɔ i̯ k ɔ t
brabant	b r aː b ɑ n t
braderie	b r aː d ə r i
brak	b r ɑ k
braken	b r aː k ə n
brallen	b r ɑ l ə n
bram	b r ɑ m
brancard	b r ɑ ŋ k aː r
brand	b r ɑ n t
brander	b r ɑ n d ə r
branding	b r ɑ n d ɪ ŋ
brandstapel	b r ɑ n t s t aː p ə l
brandstof	b r ɑ n t s t ɔ f
brandweer	b r ɑ n t ʋ eː r
brandweerkorps	b r ɑ n t ʋ eː r k ɔ r p s
brandweerwagen	b r ɑ n t ʋ eː r ʋ aː ɣ ə n
brandwond	b r ɑ n t ʋ ɔ n t
brauw	b r ɑ u̯
braziliaan	b r aː z i l i aː n
brazilië	b r aː z i l i ə
breda	b r eː d aː
breed	b r eː t
breedband	b r eː t b ɑ n t
breedte	b r eː t ə
breekpunt	b r eː k p ʏ n t
breeuwen	b r eː u̯ ə n
brein	b r ɛ i̯ n
breken	b r eː k ə n
breking	b r eː k ɪ ŋ
breng	b r ɛ ŋ
brengen	b r ɛ ŋ ə n
bres	b r ɛ s
bretagne	b r ə t ɑ n j ə
breuk	b r øː k
breukelen	b r øː k ə l ə n
brief	b r i f
briefomslag	b r i f ɔ m s l ɑ x
brievenbus	b r i v ə n b ʏ s
brij	b r ɛ i̯
bril	b r ɪ l
brillen	b r ɪ l ə n
brit	b r ɪ t
brits	b r ɪ t s
brittannië	b r ɪ t ɑ n i ə
brochure	b r ɔ ʃ yː r ə
broedseizoen	b r u t s ɛ i̯ z u n
broeikaseffect	b r u i̯ k ɑ s ɛ f ɛ k t
broekzak	b r u k s ɑ k
broer	b r uː r
brok	b r ɔ k
brokken	b r ɔ k ə n
bromfiets	b r ɔ m f i t s
brommer	b r ɔ m ə r
brompot	b r ɔ m p ɔ t
bron	b r ɔ n
broncode	b r ɔ n k oː d ə
bronkhorst	b r ɔ ŋ k ɦ ɔ r s t
brood	b r oː t
broodje	b r oː t j ə
broom	b r oː m
broos	b r oː s
brosser	b r ɔ s ə r
brouwen	b r ɑ u̯ ə n
brouwer	b r ɑ u̯ ə r
brouwerij	b r ɑ u̯ ə r ɛ i̯
brouwsel	b r ɑ u̯ s ə l
browsen	b r ɑ u̯ z ə n
browser	b r ɑ u̯ z ə r
brug	b r ʏ x
brugwachter	b r ʏ x ʋ ɑ x t ə r
bruidegom	b r œ y̯ d ə ɣ ɔ m
bruikbaar	b r œ y̯ k b aː r
bruikbaarheid	b r œ y̯ k b aː r ɦ ɛ i̯ t
bruikleen	b r œ y̯ k l eː n
bruiloft	b r œ y̯ l ɔ f t
bruin	b r œ y̯ n
bruine	b r œ y̯ n ə
bruinhemd	b r œ y̯ n ɦ ɛ m t
bruistablet	b r œ y̯ s t aː b l ɛ t
brunch	b r ʏ n ʃ
brunette	b r y n ɛ t ə
brussel	b r ʏ s ə l
brussels	b r ʏ s ə l s
brutaal	b r y t aː l
bruto	b r y t oː
bruut	b r y t
btw	b eː t eː ʋ eː
budgetteren	b ʏ d ʒ ɛ t eː r ə n
buggy	b ʏ ɡ i
buienradar	b œ y̯ ə n r aː d ɑ r
buigen	b œ y̯ ɣ ə n
buiging	b œ y̯ ɣ ɪ ŋ
buik	b œ y̯ k
buikgriep	b œ y̯ k x r i p
buikje	b œ y̯ k j ə
buis	b œ y̯ s
buiten	b œ y̯ t ə n
buitenaf	b œ y̯ t ə n ɑ f
buitenkans	b œ y̯ t ə n k ɑ n s
buitenkant	b œ y̯ t ə n k ɑ n t
buitenkern	b œ y̯ t ə n k ɛ r n
buitenland	b œ y̯ t ə n l ɑ n t
buitenlands	b œ y̯ t ə n l ɑ n t s
buitenlucht	b œ y̯ t ə n l ʏ x t
buitenmoeder	b œ y̯ t ə n m u d ə r
buitenmuur	b œ y̯ t ə n m yː r
buitenshuis	b œ y̯ t ə n s ɦ œ y̯ s
buitenspel	b œ y̯ t ə n s p ɛ l
buitenspelval	b œ y̯ t ə n s p ɛ l v ɑ l
buitenstaander	b œ y̯ t ə n s t aː n d ə r
buitentrouw	b œ y̯ t ə n t r ɑ u̯
bukken	b ʏ k ə n
bul	b ʏ l
bulldog	b u l d ɔ ɡ
bully	b u l i
bult	b ʏ l t
bumper	b ʏ m p ə r
bumperkleven	b ʏ m p ə r k l eː v ə n
bundel	b ʏ n d ə l
bundelen	b ʏ n d ə l ə n
bunnik	b ʏ n ɪ k
burchtheer	b ʏ r x t ɦ eː r
bureau	b y r oː
bureaublad	b y r oː b l ɑ t
bureaucratie	b yː r oː k r aː t s i
burg	b ʏ r x
burgemeester	b ʏ r ɣ ə m eː s t ə r
burgemeesterschap	b ʏ r ɣ ə m eː s t ə r s x ɑ p
burger	b ʏ r ɣ ə r
burgerbevolking	b ʏ r ɣ ə r b ə v ɔ l k ɪ ŋ
burgerlijk	b ʏ r ɣ ə r l ə k
burgeroorlog	b ʏ r ɣ ə r oː r l ɔ x
burgerschap	b ʏ r ɣ ə r s x ɑ p
burggraaf	b ʏ r x r aː f
burundi	b u r u n d i
bushalte	b ʏ s ɦ ɑ l t ə
buslijn	b ʏ s l ɛ i̯ n
busstation	b ʏ s t aː ʃ ɔ n
buurland	b yː r l ɑ n t
buurman	b yː r m ɑ n
buurten	b yː r t ə n
buurthuis	b yː r t ɦ œ y̯ s
buurtschap	b yː r t s x ɑ p
buurvrouw	b yː r v r ɑ u̯
byzantijns	b i z ɑ n t ɛ i̯ n s
bühne	b yː n ə
cabaret	k aː b aː r ɛ t
cabaretier	k aː b aː r ɛ t j eː
cabine	k aː b i n ə
cabinepersoneel	k aː b i n ə p ɛ r s oː n eː l
cabriolet	k aː b r i oː l ɛ t
cacao	k ɑ k ɑ u̯
cadans	k aː d ɑ n s
cadeau	k a d oː
cadeaubon	k aː d oː b ɔ n
cafetaria	k aː f eː t aː r i aː
cafeïne	k aː f eː i n ə
café	k aː f eː
cake	k eː k
calamiteit	k aː l aː m i t ɛ i̯ t
calcium	k ɑ l s i ʏ m
californië	k aː l i f ɔ r n i ə
calvinisme	k ɑ l v i n ɪ s m ə
cambodja	k ɑ m b ɔ t j aː
camee	k aː m eː
camera	k aː m ə r aː
cameraploeg	k aː m ə r aː p l u x
cameratoezicht	k aː m ə r aː t u z ɪ x t
campagne	k ɑ m p ɑ n j ə
camper	k ɛ m p ə r
canada	k aː n aː d aː
candela	k ɑ n d eː l aː
cannabis	k ɑ n aː b ɪ s
canon	k aː n ɔ n
cantate	k ɑ n t aː t ə
canvas	k ɑ n v ɑ s
cao	s eː aː oː
capitool	k aː p i t oː l
capituleren	k aː p i t y l eː r ə n
capoeirista	k aː p u eː r i s t aː
caravan	k ɛ r ə v ɛ n
carbon	k ɑ r b ɔ n
carcinogeen	k ɑ r s i n oː ɣ eː n
cardioloog	k ɑ r d i oː l oː x
carillon	k aː r ɪ l j ɔ n
cariës	k aː r i ɛ s
carmen	k ɑ r m ə n
carnaval	k ɑ r n aː v ɑ l
carrière	k ɑ r i ɛː r ə
carrosserie	k ɑ r ɔ s ə r i
carrousel	k ɑ r u s ɛ l
carthago	k ɑ r t aː ɣ oː
cash	k ɛ ʃ
casino	k aː z i n oː
castratie	k ɑ s t r aː t s i
catalaans	k aː t aː l aː n s
catalogus	k aː t aː l oː ɣ ʏ s
catalonië	k aː t aː l oː n i ə
cataract	k aː t aː r ɑ k t
categorie	k ɑ t ə ɣ oː r i
categorisch	k ɑ t ə ɣ oː r i s
catheter	k aː t eː t ə r
cavia	k aː v i j aː
cd	s eː d eː
cda	s eː d eː aː
ceintuur	s ɛ n t yː r
cel	s ɛ l
celgenoot	s ɛ l ɣ ə n oː t
cell	s ɛ l
cellulose	s ɛ l y l oː z ə
celstraf	s ɛ l s t r ɑ f
cement	s ə m ɛ n t
censureren	s ɛ n z yː r eː r ə n
census	s ɛ n z ʏ s
centimeter	s ɛ n t i m eː t ə r
centraal	s ɛ n t r aː l
centrale	s ɛ n t r aː l ə
centralisatie	s ɛ n t r aː l i z aː t s i
centrum	s ɛ n t r ʏ m
centrumrechts	s ɛ n t r ʏ m r ɛ x t s
ceremonie	s eː r ə m oː n i
ceremoniemeester	s eː r ə m oː n i m eː s t ə r
certificaat	s ɛ r t i f i k aː t
certificeren	s ɛ r t i f i s eː r ə n
champagne	ʃ ɑ m p ɑ n j ə
champignon	ʃ ɑ m p i n j ɔ n
chanten	t ʃ ɑ n t ə n
chanteren	ʃ ɑ n t eː r ə n
chaos	x aː ɔ s
chaotisch	x aː oː t i s
chapeau	ʃ aː p oː
charisma	x aː r ɪ s m aː
charmant	ʃ ɑ r m ɑ n t
charmeren	ʃ ɑ r m eː r ə n
chat	t ʃ ɛ t
chatten	t ʃ ɛ t ə n
checken	t ʃ ɛ k ə n
chef	ʃ ɛ f
cheffin	ʃ ɛ f ɪ n
chemie	x eː m i
chemieconcern	x eː m i k ɔ n s ʏ r n
chemisch	x eː m i s
cheque	ʃ ɛ k
chic	ʃ i k
china	ʃ i n aː
chinchilla	t ʃ ɪ n t ʃ ɪ l aː
chinees	ʃ i n eː s
chinese	ʃ i n eː s ə
chinezen	ʃ i n eː z ə n
chip	t ʃ ɪ p
chirurgie	ʃ i r ʏ r ɣ i
chloor	x l oː r
chocolade	ʃ oː k oː l aː d ə
chocolademelk	ʃ oː k oː l aː d ə m ɛ l k
chocomel	ʃ oː k oː m ɛ l
cholera	x oː l ə r aː
chris	k r ɪ s
christa	k r ɪ s t aː
christendemocratie	k r ɪ s t ə n d eː m oː k r aː t s i
christiaan	k r ɪ s t i j aː n
christine	k r ɪ s t i n ə
chromosoom	x r oː m oː s oː m
chronisch	x r oː n i s
cijfer	s ɛ i f ə r
cilinder	s i l ɪ n d ə r
cimbaal	s ɪ m b aː l
circa	s ɪ r k aː
circuit	s ɪ r k ʋ i
circus	s ɪ r k ʏ s
circusartiest	s ɪ r k ʏ s ɑ r t i s t
cirkel	s ɪ r k ə l
citaat	s i t aː t
citer	s i t ə r
citroen	s i t r u n
citroensap	s i t r u n s ɑ p
clan	k l ɛ n
classis	k l ɑ s ɪ s
clausule	k l ɑ u̯ z y l ə
cliché	k l i ʃ eː
client	k l ɑ i̯ ə n t
clown	k l ɑ u̯ n
club	k l ʏ p
clubhuis	k l ʏ p ɦ œ y̯ s
cnv	s eː ɛ n v eː
co	k oː
coach	k oː t ʃ
coalitie	k oː aː l i t s i
cobra	k oː b r aː
cocaïne	k oː k aː i n ə
cocktail	k ɔ k t eː l
code	k oː d ə
codering	k oː d eː r ɪ ŋ
coen	k u n
coevorden	k u v ɔ r d ə n
coffeeshop	k ɔ f i ʃ ɔ p
cognitief	k ɔ x n i t i f
col	k ɔ l
cola	k oː l aː
collaboratie	k ɔ l aː b oː r aː t s i
collageen	k ɔ l aː ɣ eː n
collatierecht	k ɔ l aː t s i r ɛ x t
collectie	k ɔ l ɛ k s i
collectief	k ɔ l ɛ k t i f
collega	k ɔ l eː ɣ aː
college	k ɔ l eː ʒ ə
collegezaal	k ɔ l eː ʒ ə z aː l
colombia	k oː l ɔ m b i aː
colonne	k oː l ɔ n ə
combi	k ɔ m b i
comeback	k ɑ m b ɛ k
comité	k ɔ m i t eː
commentaar	k ɔ m ɛ n t aː r
commercie	k ɔ m ɛ r s i
commissie	k ɔ m ɪ s i
commotie	k ɔ m oː t s i
communicatie	k ɔ m y n i k aː t s i
communicatiemiddel	k ɔ m y n i k aː t s i m ɪ d ə l
communiceren	k ɔ m y n i s eː r ə n
communie	k ɔ m y n i
communistisch	k ɔ m y n ɪ s t i s
compact	k ɔ m p ɑ k t
compagnie	k ɔ m p ɑ n j i
compensatie	k ɔ m p ɛ n z aː t s i
compenseren	k ɔ m p ɛ n z eː r ə n
competent	k ɔ m p ə t ɛ n t
compleet	k ɔ m p l eː t
completeren	k ɔ m p l eː t eː r ə n
complex	k ɔ m p l ɛ k s
complexiteit	k ɔ m p l ɛ k s i t ɛ i̯ t
compliment	k ɔ m p l i m ɛ n t
component	k ɔ m p oː n ɛ n t
componeren	k ɔ m p oː n eː r ə n
componist	k ɔ m p oː n ɪ s t
compositie	k ɔ m p oː z i t s i
compost	k ɔ m p ɔ s t
compressie	k ɔ m p r ɛ s i
computer	k ɔ m p j u t ə r
computerprogramma	k ɔ m p j u t ə r p r oː ɣ r ɑ m aː
computerspel	k ɔ m p j u t ə r s p ɛ l
concentratiekamp	k ɔ n s ɛ n t r aː t s i k ɑ m p
concentreren	k ɔ n s ɛ n t r eː r ə n
concept	k ɔ n s ɛ p t
concern	k ɔ n s ʏ r n
concert	k ɔ n s ɛ r t
concilie	k ɔ n s i l i
conciërge	k ɔ n ʒ ɛ r ʒ ə
concluderen	k ɔ ŋ k l y d eː r ə n
concreet	k ɔ ŋ k r eː t
concurrentie	k ɔ ŋ k y r ɛ n t s i
conditie	k ɔ n d i t s i
condoleren	k ɔ n d oː l eː r ə n
condoom	k ɔ n d oː m
confederaal	k ɔ n f eː d ə r aː l
confederalisme	k ɔ n f eː d ə r aː l ɪ s m ə
conflict	k ɔ n f l ɪ k t
conflictstof	k ɔ n f l ɪ k t s t ɔ f
confrater	k ɔ n f r aː t ə r
confronteren	k ɔ n f r ɔ n t eː r ə n
congres	k ɔ ŋ ɣ r ɛ s
congruent	k ɔ ŋ ɣ r y ɛ n t
conisch	k oː n i s
consequent	k ɔ n s ə k ʋ ɛ n t
conservatief	k ɔ n z ɛ r v aː t i f
conservatisme	k ɔ n z ɛ r v aː t ɪ s m ə
conservator	k ɔ n z ɛ r v aː t ɔ r
conserven	k ɔ n z ɛ r v ə n
constant	k ɔ n s t ɑ n t
constante	k ɔ n s t ɑ n t ə
constantijn	k ɔ n s t ɑ n t ɛ i̯ n
constateren	k ɔ n s t aː t eː r ə n
constructie	k ɔ n s t r ʏ k s i
constructief	k ɔ n s t r ʏ k t i f
consument	k ɔ n z y m ɛ n t
consumptie	k ɔ n z ʏ m p s i
consumptiemaatschappij	k ɔ n z ʏ m p s i m aː t s x ɑ p ɛ i̯
contact	k ɔ n t ɑ k t
contactlens	k ɔ n t ɑ k t l ɛ n s
contactpersoon	k ɔ n t ɑ k t p ɛ r s oː n
container	k ɔ n t eː n ə r
contant	k ɔ n t ɑ n t
context	k ɔ n t ɛ k s t
continu	k ɔ n t i n y
contract	k ɔ n t r ɑ k t
contrast	k ɔ n t r ɑ s t
controleren	k ɔ n t r oː l eː r ə n
controller	k ɔ n t r ɔ l ə r
controverse	k ɔ n t r oː v ɛ r z ə
convenant	k ɔ n v ə n ɑ n t
conventie	k ɔ n v ɛ n s i
conversie	k ɔ n v ɛ r s i
cookie	k u k i
cool	k uː l
cor	k ɔ r
cornelia	k ɔ r n eː l i aː
cornelis	k ɔ r n eː l ɪ s
corps	k oː r
corpus	k ɔ r p ʏ s
correct	k ɔ r ɛ k t
correctie	k ɔ r ɛ k s i
corrie	k ɔ r i
corrumperen	k ɔ r ʏ m p eː r ə n
corrupt	k ɔ r ʏ p t
cortège	k ɔ r t ɛː ʒ ə
coulisselandschap	k u l i z ə l ɑ n t s x ɑ p
counter	k ɑ u̯ n t ə r
coureur	k u r øː r
coördinaten	k oː ɔ r d i n aː t ə n
coördinator	k oː ɔ r d i n aː t ɔ r
creatie	k r eː j aː t s i
credo	k r eː d oː
crematorium	k r eː m aː t oː r i ʏ m
cricket	k r ɪ k ə t
criminaliteit	k r i m i n aː l i t ɛ i̯ t
crimineel	k r i m i n eː l
crisis	k r i z ɪ s
criterium	k r i t eː r i ʏ m
cruise	k r uː s
cruiseschip	k r uː s s x ɪ p
cruyff	k r œ y̯ f
crèmekleurig	k r ɛː m k l øː r ə x
cuba	k y b aː
cuijk	k œ y̯ k
culemborg	k y l ə m b ɔ r x
cultureel	k ʏ l t y r eː l
cultuur	k ʏ l t y r
curatele	k y r aː t eː l ə
curator	k y r aː t ɔ r
curatoren	k y r aː t oː r ə n
curry	k ʏ r i
cursist	k ʏ r s ɪ s t
cursus	k ʏ r s ʏ s
cv	s eː v eː
cyclisch	s i k l i s
cycloon	s i k l oː n
cyclus	s i k l ʏ s
cynisme	s i n ɪ s m ə
cyprus	s i p r ʏ s
daad	d aː t
daag	d aː x
daags	d aː x s
daalder	d aː l d ə r
daan	d aː n
daar	d aː r
daaraan	d aː r aː n
daarachter	d aː r ɑ x t ə r
daarbij	d aː r b ɛ i̯
daarboven	d aː r b oː v ə n
daardoor	d aː r d oː r
daarheen	d aː r ɦ eː n
daarin	d aː r ɪ n
daarmee	d aː r m eː
daarna	d aː r n aː
daarnaar	d aː r n aː r
daarnaast	d aː r n aː s t
daarnet	d aː r n ɛ t
daaro	d aː r oː
daarom	d aː r ɔ m
daaromheen	d aː r ɔ m ɦ eː n
daaronder	d aː r ɔ n d ə r
daarover	d aː r oː v ə r
daaroverheen	d aː r oː v ə r ɦ eː n
daartegen	d aː r t eː ɣ ə n
daartegenover	d aː r t eː ɣ ə n oː v ə r
daarvan	d aː r v ɑ n
daarvandaan	d aː r v ɑ n d aː n
daarvoor	d aː r v oː r
dada	d aː d aː
dadelijk	d aː d ə l ə k
dadendrang	d aː d ə n d r ɑ ŋ
dader	d aː d ə r
dag	d ɑ x
dagblad	d ɑ x b l ɑ t
dagboek	d ɑ x b u k
dagdeel	d ɑ x d eː l
dagelijks	d aː ɣ ə l ə k s
dagen	d aː ɣ ə n
dagenlang	d aː ɣ ə n l ɑ ŋ
dageraad	d aː ɣ ə r aː t
daglicht	d ɑ x l ɪ x t
dagvaarden	d ɑ x f aː r d ə n
dagvaarding	d ɑ x f aː r d ɪ ŋ
dak	d ɑ k
dakdekker	d ɑ k d ɛ k ə r
dakkapel	d ɑ k aː p ɛ l
dakkoffer	d ɑ k ɔ f ə r
dal	d ɑ l
dalen	d aː l ə n
daling	d aː l ɪ ŋ
dam	d ɑ m
damascus	d aː m ɑ s k ʏ s
dame	d aː m ə
dammen	d ɑ m ə n
dammer	d ɑ m ə r
damsteen	d ɑ m s t eː n
dan	d ɑ n
danig	d aː n ə x
daniël	d aː n i j ɛ l
dankbaar	d ɑ ŋ k b aː r
dankbaarheid	d ɑ ŋ k b aː r ɦ ɛ i t
dankjewel	d ɑ ŋ k j ə ʋ ɛ l
danklied	d ɑ ŋ k l i t
dankzegging	d ɑ ŋ k s ɛ ɣ ɪ ŋ
dans	d ɑ n s
dansen	d ɑ n s ə n
danseres	d ɑ n s ə r ɛ s
dantumadeel	d ɑ n t y m aː d eː l
dapper	d ɑ p ə r
dapperheid	d ɑ p ə r ɦ ɛ i̯ t
darm	d ɑ r m
darmflora	d ɑ r m f l oː r aː
darmkanker	d ɑ r m k ɑ ŋ k ə r
dartelen	d ɑ r t ə l ə n
daslook	d ɑ s l oː k
dassen	d ɑ s ə n
dat	d ɑ t
databank	d aː t aː b ɑ ŋ k
date	d eː t
daten	d eː t ə n
datering	d aː t eː r ɪ ŋ
dato	d aː t oː
datum	d aː t ʏ m
datzelfde	d ɑ t s ɛ l f d ə
dauwpunt	d ɑ u̯ p ʏ n t
david	d aː v ɪ t
ddr	d eː d eː ɛ r
de	d ə
deal	d iː l
debiteur	d eː b i t øː r
debutante	d eː b y t ɑ n t ə
decaan	d eː k aː n
decennium	d eː s ɛ n i ʏ m
decentralisatie	d eː s ɛ n t r aː l i z aː t s i
decentralisering	d eː s ɛ n t r aː l i z eː r ɪ ŋ
deceptie	d eː s ɛ p s i
declareren	d eː k l aː r eː r ə n
decor	d eː k ɔ r
decoratie	d eː k oː r aː t s i
decoreren	d eː k oː r eː r ə n
deden	d eː d ə n
deed	d eː t
deeg	d eː x
deel	d eː l
deelgemeente	d eː l ɣ ə m eː n t ə
deelgenoot	d eː l ɣ ə n oː t
deelname	d eː l n aː m ə
deelneemster	d eː l n eː m s t ə r
deelnemen	d eː l n eː m ə n
deelnemer	d eː l n eː m ə r
deelneming	d eː l n eː m ɪ ŋ
deelstaat	d eː l s t aː t
deeltijds	d eː l t ɛ i̯ t s
deen	d eː n
deerlijk	d eː r l ə k
deerniswekkend	d eː r n ɪ s ʋ ɛ k ə n t
defect	d eː f ɛ k t
defensief	d eː f ɛ n s i f
defilé	d eː f i l eː
definitie	d eː f i n i t s i
definitief	d eː f i n i t i f
degelijk	d eː ɣ ə l ə k
degene	d ə ɣ eː n ə
dehaene	d ə ɦ aː n ə
deining	d ɛ i̯ n ɪ ŋ
dek	d ɛ k
dekbed	d ɛ k b ɛ t
deken	d eː k ə n
dekken	d ɛ k ə n
dekking	d ɛ k ɪ ŋ
dekmantel	d ɛ k m ɑ n t ə l
deksel	d ɛ k s ə l
del	d ɛ l
delen	d eː l ə n
delft	d ɛ l f t
delfts	d ɛ l f t s
delfzijl	d ɛ l f z ɛ i̯ l
delgen	d ɛ l ɣ ə n
delta	d ɛ l t aː
demagogisch	d eː m aː ɣ oː ɣ i s
dementie	d eː m ɛ n t s i
democraat	d eː m oː k r aː t
democratie	d eː m oː k r aː t s i
democratisch	d eː m oː k r aː t i s
democratiseren	d eː m oː k r aː t i s eː r ə n
demonstratie	d eː m ɔ n s t r aː t s i
demonstratief	d eː m ɔ n s t r aː t i f
demonstreren	d eː m ɔ n s t r eː r ə n
dempen	d ɛ m p ə n
demper	d ɛ m p ə r
dendermonde	d ɛ n d ə r m ɔ n d ə
denemarken	d eː n ə m ɑ r k ə n
denkbaar	d ɛ ŋ k b aː r
denktank	d ɛ ŋ k t ɛ ŋ k
denominatie	d eː n oː m i n aː t s i
deo	d eː j oː
deportatie	d eː p ɔ r t aː t s i
deporteren	d eː p ɔ r t eː r ə n
depot	d eː p oː
depressief	d eː p r ɛ s i f
depri	d eː p r i
derde	d ɛ r d ə
deregulering	d eː r eː ɣ y l eː r ɪ ŋ
dergelijk	d ɛ r ɣ ə l ə k
derhalve	d ɛ r ɦ ɑ l v ə
dermate	d ɛ r m aː t ə
dertien	d ɛ r t i n
desbetreffend	d ɛ s b ə t r ɛ f ə n t
desgevraagd	d ɛ s x ə v r aː x t
desgewenst	d ɛ s x ə ʋ ɛ n s t
desinfecteren	d ɛ s ɪ n f ɛ k t eː r ə n
desiree	d eː z i r eː
desktop	d ɛ s k t ɔ p
deskundig	d ɛ s k ʏ n d ə x
deskundige	d ɛ s k ʏ n d ə ɣ ə
desnoods	d ɛ s n oː t s
desondanks	d ɛ s ɔ n d ɑ ŋ k s
desoriëntatie	d ɛ s oː r i ɛ n t aː t s i
desoriënteren	d ɛ z oː r i ɛ n t eː r ə n
destijds	d ɛ s t ɛ i̯ t s
detail	d eː t ɑ i̯
detailhandel	d eː t ɑ i̯ ɦ ɑ n d ə l
detecteren	d eː t ɛ k t eː r ə n
deugdelijk	d øː x d ə l ə k
deuk	d øː k
deuken	d øː k ə n
deur	d øː r
deurne	d øː r n ə
deva	d eː v aː
deze	d eː z ə
dezelfde	d ə z ɛ l f d ə
dezen	d eː z ə n
dia	d i aː
diabetes	d i aː b eː t ə s
diaconie	d i aː k oː n i
dialect	d i j aː l ɛ k t
dialectgroep	d i aː l ɛ k t x r u p
diamant	d i aː m ɑ n t
diameter	d i aː m eː t ə r
diarree	d i ɑ r eː
diastole	d i aː s t oː l ə
dicht	d ɪ x t
dichtader	d ɪ x t aː d ə r
dichtbij	d ɪ x t b ɛ i̯
dichtdoen	d ɪ x t d u n
dichten	d ɪ x t ə n
dichter	d ɪ x t ə r
dichteres	d ɪ x t ə r ɛ s
dichtheid	d ɪ x t ɦ ɛ i̯ t
dictator	d ɪ k t aː t ɔ r
dictatuur	d ɪ k t aː t yː r
dictee	d i k t eː
dieet	d i j eː t
dief	d i f
diefstal	d i f s t ɑ l
diegene	d i ɣ eː n ə
dien	d i n
dienaar	d i n aː r
dienen	d i n ə n
diens	d i n s
dienst	d i n s t
dienstensector	d i n s t ə n s ɛ k t ɔ r
dienstplicht	d i n s t p l ɪ x t
dienstrooster	d i n s t r oː s t ə r
diep	d i p
diepen	d i p ə n
diepgaand	d i p x aː n t
diepgang	d i p x ɑ ŋ
diepte	d i p t ə
dieptepunt	d i p t ə p ʏ n t
dier	d i r
dierbaar	d iː r b aː r
dierenarts	d iː r ə n ɑ r t s
dierenbescherming	d iː r ə n b ə s x ɛ r m ɪ ŋ
dierenhuid	d iː r ə n ɦ œ y̯ t
dierenleed	d iː r ə n l eː t
dierenpark	d iː r ə n p ɑ r k
dierenrijk	d iː r ə n r ɛ i̯ k
dierenwelzijn	d iː r ə n ʋ ɛ l z ɛ i̯ n
diergaarde	d iː r ɣ aː r d ə
diersoort	d iː r s oː r t
diesel	d i z ə l
digitaal	d i ɣ i t aː l
dijk	d ɛ i̯ k
dijkstra	d ɛ i̯ k s t r aː
dijle	d ɛ i̯ l ə
dik	d ɪ k
dikke	d ɪ k ə
dilemma	d i l ɛ m aː
dimensie	d i m ɛ n s i
diner	d i n eː
ding	d ɪ ŋ
dinsdag	d ɪ n s d ɑ x
dinsdagmorgen	d ɪ n s d ɑ x m ɔ r ɣ ə n
diploma	d i p l oː m aː
direct	d i r ɛ k t
directeur	d i r ɛ k t øː r
directie	d i r ɛ k s i
directrice	d i r ɛ k t r i s ə
dirigeren	d i r i ɣ eː r ə n
dirk	d ɪ r k
dis	d ɪ s
disco	d ɪ s k oː
discotheek	d ɪ s k oː t eː k
discours	d ɪ s k uː r
discreet	d ɪ s k r eː t
discretie	d ɪ s k r eː t s i
discriminatie	d ɪ s k r i m i n aː t s i
discrimineren	d ɪ s k r i m i n eː r ə n
discus	d ɪ s k ʏ s
discussie	d ɪ s k ʏ s i
diskette	d ɪ s k ɛ t ə
display	d ɪ s p l eː
dispuut	d ɪ s p y t
dissertatie	d ɪ s ɛ r t aː t s i
district	d ɪ s t r ɪ k t
dit	d ɪ t
diversen	d i v ɛ r z ə n
diversiteit	d i v ɛ r z i t ɛ i̯ t
divisie	d i v i z i
djembé	d ʒ ɛ m b eː
do	d oː
dobber	d ɔ b ə r
docent	d oː s ɛ n t
doch	d ɔ x
dochter	d ɔ x t ə r
doctor	d ɔ k t ɔ r
doctoraat	d ɔ k t oː r aː t
document	d oː k y m ɛ n t
documentatie	d oː k y m ɛ n t aː t s i
dode	d oː d ə
dodelijk	d oː d ə l ə k
doden	d oː d ə n
dodental	d oː d ə n t ɑ l
doedelzak	d u d ə l z ɑ k
doedens	d u d ə n s
doei	d u i̯
doek	d u k
doeken	d u k ə n
doel	d u l
doeleinde	d u l ɛ i̯ n d ə
doelen	d u l ə n
doelloos	d u l l oː s
doelmatig	d u l m aː t ə x
doelpunt	d u l p ʏ n t
doelstelling	d u l s t ɛ l ɪ ŋ
doeltreffend	d u l t r ɛ f ə n t
doelwit	d u l ʋ ɪ t
doemen	d u m ə n
does	d u s
doesburg	d u s b ʏ r x
doetinchem	d u t ɪ ŋ x ɛ m
doezelen	d u z ə l ə n
dokken	d ɔ k ə n
dokter	d ɔ k t ə r
dokwerker	d ɔ k ʋ ɛ r k ə r
dol	d ɔ l
dollar	d ɔ l ɑ r
dollen	d ɔ l ə n
domein	d oː m ɛ i̯ n
domheid	d ɔ m ɦ ɛ i̯ t
dominant	d oː m i n ɑ n t
dominee	d oː m i n eː
dommel	d ɔ m ə l
dommelen	d ɔ m ə l ə n
dompelen	d ɔ m p ə l ə n
donau	d oː n ɑ u̯
donder	d ɔ n d ə r
donderdag	d ɔ n d ə r d ɑ x
donderdagmorgen	d ɔ n d ə r d ɑ x m ɔ r ɣ ə n
donderdagochtend	d ɔ n d ə r d ɑ x ɔ x t ə n t
donderdagsochtends	d ɔ n d ə r d ɑ x s ɔ x t ə n t s
donderslag	d ɔ n d ə r s l ɑ x
doneren	d oː n eː r ə n
dongeradeel	d ɔ ŋ ə r aː d eː l
donk	d ɔ ŋ k
donker	d ɔ ŋ k ə r
donkerblauw	d ɔ ŋ k ə r b l ɑ u̯
donkerbruin	d ɔ ŋ k ə r b r œ y̯ n
donkergrijs	d ɔ ŋ k ə r ɣ r ɛ i̯ s
donor	d oː n ɔ r
donororgaan	d oː n ɔ r ɔ r ɣ aː n
dood	d oː t
dooddoener	d oː t d u n ə r
doodgaan	d oː t x aː n
doodmoe	d oː t m u
doodsbang	d oː t s b ɑ ŋ
doodslag	d oː t s l ɑ x
doodsoorzaak	d oː t s oː r z aː k
doodstraf	d oː t s t r ɑ f
doof	d oː f
doofpot	d oː f p ɔ t
dooi	d oː i̯
dooie	d oː i̯ ə
dooien	d oː i̯ ə n
doopsgezinde	d oː p s x ə z ɪ n d ə
door	d oː r
doorbrengen	d oː r b r ɛ ŋ ə n
doordat	d oː r d ɑ t
doordenken	d oː r d ɛ ŋ k ə n
doordeweeks	d oː r d ə ʋ eː k s
doordringen	d oː r d r ɪ ŋ ə n
doorgaan	d oː r ɣ aː n
doorgaans	d oː r ɣ aː n s
doorgang	d oː r ɣ ɑ ŋ
doorgedraaid	d oː r ɣ ə d r aː i̯ t
doorgeven	d oː r ɣ eː v ə n
doorgronden	d oː r ɣ r ɔ n d ə n
doorheen	d oː r ɦ eː n
doorkruisen	d oː r k r œ y̯ s ə n
doorlaten	d oː r l aː t ə n
doorlatend	d oː r l aː t ə n t
doorloop	d oː r l oː p
doorloopt	d oː r l oː p t
doorlopend	d oː r l oː p ə n t
doornbos	d oː r n b ɔ s
doornik	d oː r n ɪ k
doorscheuren	d oː r s x øː r ə n
doorslag	d oː r s l ɑ x
doorslaggevend	d oː r s l ɑ x ɣ eː ə v n t
doorsnede	d oː r s n eː d ə
doorsnee	d oː r s n eː
doorsnijden	d oː r s n ɛ i̯ d ə n
doorstart	d oː r s t ɑ r t
doorsturen	d oː r s t yː r ə n
doortastend	d oː r t ɑ s t ə n t
doortocht	d oː r t ɔ x t
doortrekken	d oː r t r ɛ k ə n
doorwerken	d oː r ʋ ɛ r k ə n
doorzetten	d oː r z ɛ t ə n
doorzichtig	d oː r z ɪ x t ə x
doorzichtigheid	d oː r z ɪ x t ə x ɦ ɛ i̯ t
doorzien	d oː r z i n
doorzoeken	d oː r z u k ə n
doos	d oː s
dop	d ɔ p
doper	d oː p ə r
doping	d oː p ɪ ŋ
doppen	d ɔ p ə n
dordrecht	d ɔ r d r ɛ x t
dordt	d ɔ r t
dorp	d ɔ r p
dorpsgezicht	d ɔ r p s x ə z ɪ x t
dorpshuis	d ɔ r p s ɦ œ y̯ s
dorpskerk	d ɔ r p s k ɛ r k
dorpsplein	d ɔ r p s p l ɛ i̯ n
dorpsstraat	d ɔ r p s t r aː t
dorst	d ɔ r s t
dos	d ɔ s
dosering	d oː z eː r ɪ ŋ
dosis	d oː z ɪ s
dot	d ɔ t
dove	d oː v ə
doven	d oː v ə n
down	d ɑ u̯ n
download	d ɑ u̯ n l oː t
downloaden	d ɑ u̯ n l oː d ə n
draadloos	d r aː t l oː s
draag	d r aː x
draagkracht	d r aː x k r ɑ x t
draagt	d r aː x t
draagvlak	d r aː x f l ɑ k
draaiboek	d r aː i̯ b u k
draaierigheid	d r aː i̯ ə r ə x ɦ ɛ i̯ t
draaisnelheid	d r aː i̯ s n ɛ l ɦ ɛ i̯ t
draak	d r aː k
dracht	d r ɑ x t
draf	d r ɑ f
dragen	d r aː ɣ ə n
drager	d r aː ɣ ə r
drama	d r aː m aː
drammen	d r ɑ m ə n
drang	d r ɑ ŋ
drank	d r ɑ ŋ k
draperie	d r aː p ə r i
drastisch	d r ɑ s t i s
draven	d r aː v ə n
dreigement	d r ɛ i̯ ɣ ə m ɛ n t
dreigen	d r ɛ i̯ ɣ ə n
drenkeling	d r ɛ ŋ k ə l ɪ ŋ
drenthe	d r ɛ n t ə
drents	d r ɛ n t s
driecilinder	d r i s i l ɪ n d ə r
driehoek	d r i ɦ u k
driehoekig	d r i ɦ u k ə x
driehonderd	d r i ɦ ɔ n d ə r t
driejarig	d r i j aː r ə x
driekwart	d r i k ʋ ɑ r t
drieluik	d r i l œ y̯ k
driemaal	d r i m aː l
driepoot	d r i p oː t
driessen	d r i s ə n
drietal	d r i t ɑ l
drievoudig	d r i v ɑ u̯ d ə x
drift	d r ɪ f t
driftig	d r ɪ f t ə x
drijfveer	d r ɛ i̯ f eː r
drilmeester	d r ɪ l m eː s t ə r
dringen	d r ɪ ŋ ə n
dringend	d r ɪ ŋ ə n t
drink	d r ɪ ŋ k
drinkt	d r ɪ ŋ k t
droeg	d r u x
droge	d r oː ɣ ə
drogen	d r oː ɣ ə n
drol	d r ɔ l
drom	d r ɔ m
dromen	d r oː m ə n
dronk	d r ɔ ŋ k
dronken	d r ɔ ŋ k ə n
dronkenlap	d r ɔ ŋ k ə l ɑ p
dronkenschap	d r ɔ ŋ k ə n s x ɑ p
droog	d r oː x
droogstoppel	d r oː x s t ɔ p ə l
droogte	d r oː x t ə
droom	d r oː m
drop	d r ɔ p
drugsbeleid	d r ʏ ɡ s b ə l ɛ i̯ t
druilmast	d r œ y̯ l m ɑ s t
druiven	d r œ y̯ v ə n
druk	d r ʏ k
drukken	d r ʏ k ə n
drukker	d r ʏ k ə r
drukkerij	d r ʏ k ə r ɛ i̯
drukte	d r ʏ k t ə
drukwerk	d r ʏ k ʋ ɛ r k
drum	d r ʏ m
drummer	d r ʏ m ə r
drumstel	d r ʏ m s t ɛ l
du	d y
dualiteit	d y aː l i t ɛ i̯ t
dubbel	d ʏ b ə l
dubbeltje	d ʏ b ə l t j ə
dubben	d ʏ b ə n
dubieus	d y b i øː s
duel	d y ʋ ɛ l
duidelijk	d œ y̯ d ə l ə k
duiden	d œ y̯ d ə n
duiding	d œ y̯ d ɪ ŋ
duif	d œ y̯ f
duikbril	d œ y̯ k b r ɪ l
duiker	d œ y̯ k ə r
duiksport	d œ y̯ k s p ɔ r t
duim	d œ y̯ m
duimen	d œ y̯ m ə n
duin	d œ y̯ n
duisburg	d œ y̯ s b ʏ r x
duisternis	d œ y̯ s t ə r n ɪ s
duits	d œ y̯ t s
duitser	d œ y̯ t s ə r
duitsland	d œ y̯ t s l ɑ n t
duivel	d œ y̯ v ə l
duivels	d œ y̯ v ə l s
duiven	d œ y̯ v ə n
duiventil	d œ y̯ v ə n t ɪ l
duizelingwekkend	d œ y̯ z ə l ɪ ŋ ʋ ɛ k ə n t
dun	d ʏ n
dunk	d ʏ ŋ k
dupe	d y p ə
duren	d y r ə n
durf	d ʏ r f
durven	d ʏ r v ə n
dus	d ʏ s
dusdanig	d ʏ s d aː n ə x
dusverre	d ʏ s f ɛ r ə
duur	d y r
duurzaam	d yː r z aː m
duurzaamheid	d yː r z aː m ɦ ɛ i̯ t
duut	d y t
duw	d y u̯
duwen	d y u̯ ə n
dvd	d eː v eː d eː
dwaalgast	d ʋ aː l ɣ ɑ s t
dwaas	d ʋ aː s
dwang	d ʋ ɑ ŋ
dwangsom	d ʋ ɑ ŋ s ɔ m
dwars	d ʋ ɑ r s
dwarsliggen	d ʋ ɑ r s l ɪ ɣ ə n
dwarszitten	d ʋ ɑ r s ɪ t ə n
dweil	d ʋ ɛ i̯ l
dweilen	d ʋ ɛ i̯ l ə n
dweilorkest	d ʋ ɛ i̯ l ɔ r k ɛ s t
dwingen	d ʋ ɪ ŋ ə n
dynamiek	d i n aː m i k
dynamisch	d i n aː m i s
dynamo	d i n aː m oː
dyslexie	d ɪ s l ɛ k s i
ebbenhout	ɛ b ə n ɦ ɑ u̯ t
echt	ɛ x t
echtgenoot	ɛ x t x ə n oː t
echtpaar	ɛ x t p aː r
echtscheiding	ɛ x t s x ɛ i̯ d ɪ ŋ
eclips	eː k l ɪ p s
ecoduct	eː k oː d ʏ k t
ecosysteem	eː k oː s i s t eː m
ede	eː d ə
edel	eː d ə l
edelhert	eː d ə l ɦ ɛ r t
eden	eː d ə n
edgar	ɛ t x ɑ r
eed	eː t
eekhoorn	eː k ɦ oː r ə n
eenduidig	eː n d œ y̯ d ə x
eenenzestig	eː n ə n s ɛ s t ə x
eenheid	eː n ɦ ɛ i̯ t
eenheidsstaat	eː n ɦ ɛ i̯ t s t aː t
eenheidsworst	eː n ɦ ɛ i̯ t s ʋ ɔ r s t
eenhoorn	eː n ɦ oː r n
eens	eː n s
eenvoud	eː n v ɑ u̯ t
eenvoudig	eː n v ɑ u̯ d ə x
eenzaam	eː n z aː m
eer	eː r
eerbied	eː r b i t
eerder	eː r d ə r
eerherstel	eː r ɦ ɛ r s t ɛ l
eerlijk	eː r l ə k
eerst	eː r s t
eerstdaags	eː r s t d aː x s
eerste	eː r s t ə
eerstejaars	eː r s t ə j aː r s
eet	eː t
eetstoornis	eː t s t oː r n ɪ s
eeuw	eː u̯
eeuwig	eː u̯ ə x
eeuwigheid	eː u̯ ə x ɦ ɛ i̯ t
effen	ɛ f ə n
eg	ɛ x
egel	eː ɣ ə l
egoïsme	eː ɣ oː ɪ s m ə
egyptisch	eː ɣ ɪ p t i s
ehbo	eː ɦ aː b eː oː
ei	ɛ i̯
eieren	ɛ i̯ j ə r ə n
eierstok	ɛ i̯ ə r s t ɔ k
eigendom	ɛ i̯ ɣ ə n d ɔ m
eigenlijk	ɛ i̯ ɣ ə n l ə k
eigenschap	ɛ i ɣ ə n s x ɑ p
eigenwijs	ɛ i̯ ɣ ə n ʋ ɛ i̯ s
eiken	ɛ i̯ k ə n
eiland	ɛ i̯ l ɑ n t
eilandengroep	ɛ i̯ l ɑ n d ə n ɣ r u p
eindbestemming	ɛ i̯ n t b ə s t ɛ m ɪ ŋ
einde	ɛ i̯ n d ə
einder	ɛ i̯ n d ə r
eindigen	ɛ i̯ n d ə ɣ ə n
eis	ɛ i̯ s
eisen	ɛ i̯ s ə n
eiser	ɛ i̯ s ə r
eitje	ɛ i̯ t j ə
eksterogen	ɛ k s t ə r oː ɣ ə n
el	ɛ l
elasticiteit	eː l ɑ s t i s i t ɛ i̯ t
elburg	ɛ l b ʏ r x
elektrisch	eː l ɛ k t r i s
elektromagneet	eː l ɛ k t r oː m ɑ x n eː t
elektronisch	eː l ɛ k t r oː n i s
elf	ɛ l ə f
elfde	ɛ l f d ə
elfen	ɛ l v ə n
eline	eː l i n ə
elitair	eː l i t ɛː r
elite	eː l i t ə
elk	ɛ l k
elkaars	ɛ l k aː r s
elpee	ɛ l p eː
els	ɛ l s
elst	ɛ l s t
elvin	ɛ l v ɪ n
elzas	ɛ l z ɑ s
emigreren	eː m i ɣ r eː r ə n
emissiehandel	eː m ɪ s i ɦ ɑ n d ə l
emmer	ɛ m ə r
enclave	ɑ ŋ k l aː v ə
ene	eː n ə
enerzijds	eː n ə r z ɛ i̯ t s
eng	ɛ ŋ
engel	ɛ ŋ ə l
engels	ɛ ŋ ə l s
engelse	ɛ ŋ ə l s ə
engelsman	ɛ ŋ ə l s m ɑ n
enkel	ɛ ŋ k ə l
enkele	ɛ ŋ k ə l ə
enkelvoudig	ɛ ŋ k ə l v ɑ u̯ d ə x
enkhuizen	ɛ ŋ k ɦ œ y̯ z ə n
enschede	ɛ n s x ə d eː
ent	ɛ n t
enten	ɛ n t ə n
enthousiasme	ɑ n t u ʒ ɑ s m ə
enzym	ɛ n z i m
epe	eː p ə
epidemiologie	eː p i d eː m i oː l oː ɣ i
episch	eː p i s
epsilon	ɛ p s i l ɔ n
eraan	ə r aː n
eredivisie	eː r ə d i v i s i
eren	eː r ə n
eretitel	eː r ə t i t ə l
erfzonde	ɛ r f s ɔ n d ə
ergens	ɛ r ɣ ə n s
erin	ə r ɪ n
erkennen	ɛ r k ɛ n ə n
ervaren	ɛ r v aː r ə n
ervaring	ɛ r v aː r ɪ ŋ
erven	ɛ r v ə n
esdorp	ɛ s d ɔ r p
essay	ɛ s eː
essayist	ɛ s eː ɪ s t
essentieel	ɛ s ɛ n s j eː l
est	ɛ s t
esther	ɛ s t ə r
esthetisch	ɛ s t eː t i s
estland	ɛ s t l ɑ n t
etalage	eː t aː l aː ʒ ə
etaleren	eː t aː l eː r ə n
eten	eː t ə n
etenstijd	eː t ə n s t ɛ i̯ t
ethiek	eː t i k
ethiopië	eː t i oː p i ə
eu	eː y
euro	øː r oː
eurocent	øː r oː s ɛ n t
eurocommissaris	øː r oː k ɔ m ɪ s aː r ɪ s
europa	øː r oː p aː
europees	øː r oː p eː s
euthanasie	œ y̯ t aː n aː z i
eva	eː v aː
evacuatie	eː v aː k y aː t s i
evaluatie	eː v aː l y aː t s i
evalueren	eː v aː l y eː r ə n
evangelie	eː v ɑ ŋ ɣ eː l i
evenaar	eː v ə n aː r
evenaren	eː v ə n aː r ə n
evenknie	eː v ə n k n i
evers	eː v ə r s
evolueren	eː v oː l y eː r ə n
exact	ɛ k s ɑ k t
excuus	ɛ k s k y s
executie	ɛ k s ə k y t s i
exodus	ɛ k s oː d ʏ s
exotherm	ɛ k s oː t ɛ r m
experimenteren	ɛ k s p eː r i m ɛ n t eː r ə n
exploderen	ɛ k s p l oː d eː r ə n
exploitatie	ɛ k s p l ʋ ɑ t aː t s i
explosie	ɛ k s p l oː z iː
explosief	ɛ k s p l oː z i f
exporteren	ɛ k s p ɔ r t eː r ə n
exposeren	ɛ k s p oː z eː r ə n
extase	ɛ k s t aː z ə
extract	ɛ k t r ɑ k t
ezel	eː z ə l
ezels	eː z ə l s
faalangst	f aː l ɑ ŋ s t
faam	f aː m
fabel	f aː b ə l
fabriceren	f ɑ b r i s eː r ə n
fabriek	f aː b r i k
fabrieken	f ɑ b r i k ə n
facebook	f eː s b u k
factor	f ɑ k t ɔ r
factotumpje	f ɑ k t o t ʏ m p j ə
factureren	f ɑ k t y r eː r ə n
factuur	f ɑ k t yː r
fagot	f aː ɣ ɔ t
falen	f aː l ə n
falsifieerbaar	f ɑ l s ɪ f j ɛ r b aː r
familie	f ɑ m i l i
familielid	f aː m i l i l ɪ t
familienaam	f aː m i l i n aː m
fanclub	f ɛ n k l ʏ p
fantaseren	f ɑ n t aː z eː r ə n
fantasie	f ɑ n t aː z i
fantasievol	f ɑ n t aː z i v ɔ l
fantastisch	f ɑ n t ɑ s t i s
farmacologie	f ɑ r m aː k oː l oː ɣ i
fase	f aː z ə
faseren	f aː z eː r ə n
fataal	f aː t aː l
fauna	f ɑ u̯ n aː
fauteuil	f oː t œ y̯
fax	f ɑ k s
faxen	f ɑ k s ə n
februari	f eː b r y aː r i
federaal	f eː d ə r aː l
federatie	f eː d eː r aː t s i
feest	f eː s t
feestdag	f eː s d ɑ x
feesten	f eː s t ə n
feestgedruis	f eː s t x ə d r œ y̯ s
feestweek	f eː s t ʋ eː k
feestzaal	f eː s t s aː l
feit	f ɛ i̯ t
feminist	f eː m i n ɪ s t
festival	f ɛ s t i v ɑ l
fictie	f ɪ k s i
fier	f i r
fiets	f i t s
fietsen	f i t s ə n
fietsenstalling	f i t s ə n s t ɑ l ɪ ŋ
fietser	f i t s ə r
fietshelm	f i t s ɦ ɛ l m
fietskaart	f i t s k aː r t
fietst	f i t s t
filiaal	f i l i aː l
filmen	f ɪ l m ə n
filmmuziek	f ɪ l m m y z i k
filmregisseur	f ɪ l m r eː ɣ i s øː r
filosofie	f i l oː s oː f i
filosoof	f i l oː s oː f
filter	f ɪ l t ə r
filtratie	f ɪ l t r aː t s i
finale	f i n aː l ə
finalist	f i n aː l ɪ s t
financieren	f i n ɑ n s iː r ə n
financiën	f i n ɑ n s i j ə n
finland	f ɪ n l ɑ n t
firmament	f ɪ r m aː m ɛ n t
fixeren	f ɪ k s eː r ə n
flamingo	f l aː m ɪ ŋ ɡ oː
flauwekul	f l ɑ u̯ ʋ ə k ʏ l
fleurig	f l øː r ə x
flevoland	f l eː v oː l ɑ n t
flikker	f l ɪ k ə r
flipper	f l ɪ p ə r
flora	f l oː r aː
fluisteren	f l œ y̯ s t ə r ə n
fluit	f l œ y̯ t
fluiten	f l œ y̯ t ə n
fluwelen	f l y ʋ eː l ə n
focus	f oː k ʏ s
foetus	f øː t ʏ s
fokker	f ɔ k ə r
fokkerij	f ɔ k ə r ɛ i̯
fonetiek	f oː n eː t i k
fonopost	f oː n oː p ɔ s t
fons	f ɔ n s
fontein	f ɔ n t ɛ i̯ n
forceren	f ɔ r s eː r ə n
forensisch	f oː r ɛ n z i s
formeren	f ɔ r m eː r ə n
formule	f ɔ r m y l ə
formuleren	f ɔ r m y l eː r ə n
formulier	f ɔ r m y l iː r
fornuis	f ɔ r n œ y̯ s
forum	f oː r ʏ m
foto	f oː t oː
fotoalbum	f oː t oː ɑ l b ʏ m
fotoboek	f oː t oː b u k
fotografe	f oː t oː ɣ r aː f ə
fotograferen	f oː t oː ɣ r aː f eː r ə n
fotografie	f oː t oː ɣ r aː f i
fotografisch	f oː t oː ɣ r aː f i s
fotoreportage	f oː t oː r eː p ɔ r t aː ʒ ə
fotostudio	f oː t oː s t y d i oː
fout	f ɑ u̯ t
foutief	f ɑ u̯ t i f
frankisch	f r ɑ ŋ k i s
frankrijk	f r ɑ ŋ k r ɛ i̯ k
frans	f r ɑ n s
franse	f r ɑ n s ə
fraude	f r ɑ u̯ d ə
frederik	f r eː d ə r ɪ k
fretten	f r ɛ t ə n
fries	f r i s
friesland	f r i s l ɑ n t
fris	f r ɪ s
frits	f r ɪ t s
frituur	f r i t yː r
fronsen	f r ɔ n s ə n
frontaal	f r ɔ n t aː l
frustreren	f r ʏ s t r eː r ə n
fugitief	f y ɣ i t i f
fuiven	f œ y̯ v ə n
fulltime	f u l t ɑ i̯ m
functie	f ʏ ŋ k s i
functioneren	f ʏ n k t s j oː n eː r ə n
fundament	f ʏ n d aː m ɛ n t
fundering	f ʏ n d eː r ɪ ŋ
fungeren	f ʏ ŋ ɣ eː r ə n
fuseren	f y z eː r ə n
fysiotherapeut	f i z i oː t eː r aː p œ y̯ t
fysiotherapie	f i z i oː t eː r aː p i
föhn	f øː n
gaaf	ɣ aː f
gaan	ɣ aː n
gaarne	ɣ aː r n ə
gaas	ɣ aː s
gabber	ɣ ɑ b ə r
gabriël	ɣ aː b r i ɛ l
gade	ɣ aː d ə
gala	ɣ aː l aː
galaten	ɣ aː l aː t ə n
galerijflat	ɣ ɑ l ə r ɛ i̯ f l ɛ t
game	ɡ eː m
gamen	ɡ eː m ə n
gamer	ɡ eː m ə r
gang	ɣ ɑ ŋ
gangbaar	ɣ ɑ ŋ b aː r
gangmaker	ɣ ɑ ŋ m aː k ə r
gangster	ɡ ɛ ŋ s t ə r
gans	ɣ ɑ n s
garage	ɣ aː r aː ʒ ə
garanderen	ɣ aː r ɑ n d eː r ə n
garde	ɣ ɑ r d ə
garen	ɣ aː r ə n
gas	ɣ ɑ s
gassen	ɣ ɑ s ə n
gast	ɣ ɑ s t
gastenboek	ɣ ɑ s t ə n b u k
gastheer	ɣ ɑ s t ɦ eː r
gasthuis	ɣ ɑ s t ɦ œ y̯ s
gastronomisch	ɣ ɑ s t r oː n oː m i s
gastvrij	ɣ ɑ s t f r ɛ i̯
gastvrijheid	ɣ ɑ s t f r ɛ i̯ ɦ ɛ i̯ t
gastvrouw	ɣ ɑ s t f r ɑ u̯
gat	ɣ ɑ t
gave	ɣ aː v ə
gaza	ɣ aː z aː
gazastrook	ɣ aː z aː s t r oː k
gazon	ɣ aː z ɔ n
ge	ɣ ə
gebaar	ɣ ə b aː r
gebakken	ɣ ə b ɑ k ə n
gebarentaal	ɣ ə b aː r ə n t aː l
gebed	ɣ ə b ɛ t
gebergte	ɣ ə b ɛ r x t ə
gebeten	ɣ ə b eː t ə n
gebeuren	ɣ ə b øː r ə n
gebeurtenis	ɣ ə b øː r t ə n ɪ s
gebied	ɣ ə b i t
gebieden	ɣ ə b i d ə n
geboefte	ɣ ə b u f t ə
gebogen	ɣ ə b oː ɣ ə n
geboorte	ɣ ə b oː r t ə
geboortebeperking	ɣ ə b oː r t ə b ə p ɛ r k ɪ ŋ
geboren	ɣ ə b oː r ə n
geborgenheid	ɣ ə b ɔ r ɣ ə n ɦ ɛ i̯ t
gebouw	ɣ ə b ɑ u̯
gebrild	ɣ ə b r ɪ l t
gebruik	ɣ ə b r œ y̯ k
gebruikelijk	ɣ ə b r œ y̯ k ə l ə k
gebruiken	ɣ ə b r œ y̯ k ə n
gebruikersvriendelijk	ɣ ə b r œ y̯ k ə r s f r i n d ə l ə k
gebruikmaken	ɣ ə b r œ y̯ k m aː k ə n
gebruiksaanwijzing	ɣ ə b r œ y̯ k s aː n ʋ ɛ i̯ z ɪ ŋ
gebruikt	ɣ ə b r œ y̯ k t
gedaan	ɣ ə d aː n
gedacht	ɣ ə d ɑ x t
gedachte	ɣ ə d ɑ x t ə
gedachtegang	ɣ ə d ɑ x t ə ɣ ɑ ŋ
gedachtegoed	ɣ ə d ɑ x t ə ɣ u t
gedachtenis	ɣ ə d ɑ x t ə n ɪ s
gedeeld	ɣ ə d eː l t
gedicht	ɣ ə d ɪ x t
gedoe	ɣ ə d u
gedogen	ɣ ə d oː ɣ ə n
gedoogbeleid	ɣ ə d oː x b ə l ɛ i̯ t
gedragen	ɣ ə d r aː ɣ ə n
geduld	ɣ ə d ʏ l t
geduldig	ɣ ə d ʏ l d ə x
gedwee	ɣ ə d ʋ eː
geef	ɣ eː f
geel	ɣ eː l
geest	ɣ eː s t
gegaan	ɣ ə ɣ aː n
gegeven	ɣ ə ɣ eː v ə n
gegooid	ɣ ə ɣ oː i̯ t
gegrepen	ɣ ə ɣ r eː p ə n
gehaaid	ɣ ə ɦ aː i̯ t
gehakt	ɣ ə ɦ ɑ k t
gehaktbal	ɣ ə ɦ ɑ k t b ɑ l
gehalte	ɣ ə ɦ ɑ l t ə
gehemelte	ɣ ə ɦ eː m ə l t ə
geheten	ɣ ə ɦ eː t ə n
geheugen	ɣ ə ɦ øː ɣ ə n
gehoopt	ɣ ə ɦ oː p t
gehoorapparaat	ɣ ə ɦ oː r ɑ p aː r aː t
gehoorzaam	ɣ ə ɦ oː r z aː m
gehucht	ɣ ə ɦ ʏ x t
gehuwd	ɣ ə ɦ y u̯ t
gehuwde	ɣ ə ɦ y u̯ d ə
geil	ɣ ɛ i̯ l
geit	ɣ ɛ i̯ t
geiten	ɣ ɛ i̯ t ə n
gek	ɣ ɛ k
gekkekoeienziekte	ɣ ɛ k ə k u i̯ ə n z i k t ə
gekocht	ɣ ə k ɔ x t
gelaat	ɣ ə l aː t
geld	ɣ ɛ l t
geldbuidel	ɣ ɛ l t b œ y̯ d ə l
gelden	ɣ ɛ l d ə n
geldermalsen	ɣ ɛ l d ə r m ɑ l s ə n
geldhoeveelheid	ɣ ɛ l t ɦ u v eː l ɦ ɛ i̯ t
geldigheid	ɣ ɛ l d ə x ɦ ɛ i̯ t
gele	ɣ eː l ə
geleden	ɣ ə l eː d ə n
geleen	ɣ ə l eː n
gelegd	ɣ ə l ɛ x t
gelegen	ɣ ə l eː ɣ ə n
gelegenheid	ɣ ə l eː ɣ ə n ɦ ɛ i̯ t
geleider	ɣ ə l ɛ i̯ d ə r
geleiding	ɣ ə l ɛ i̯ d ɪ ŋ
gelezen	ɣ ə l eː z ə n
gelieve	ɣ ə l i v ə
gelijkmaker	ɣ ə l ɛ i̯ k m aː k ə r
gelijkstelling	ɣ ə l ɛ i̯ k s t ɛ l ɪ ŋ
gelijktijdigheid	ɣ ə l ɛ i̯ k t ɛ i̯ d ə ɣ ɦ ɛ i̯ d
geloofwaardig	ɣ ə l oː f ʋ aː r d ə x
geloofwaardigheid	ɣ ə l oː f ʋ aː r d ə x ɦ ɛ i̯ t
gelovig	ɣ ə l oː v ə x
gelovige	ɣ ə l oː v ə ɣ ə
geluid	ɣ ə l œ y̯ t
geluidskaart	ɣ ə l œ y̯ t k aː r t
geluidsoverlast	ɣ ə l œ y̯ t s oː v ə r l ɑ s t
geluk	ɣ ə l ʏ k
gelukzalig	ɣ ə l ʏ k s aː l ə x
gemaal	ɣ ə m aː l
gemak	ɣ ə m ɑ k
gematigd	ɣ ə m aː t ə x t
gember	ɣ ɛ m b ə r
gemeenschap	ɣ ə m eː n s x ɑ p
gemeente	ɣ ə m eː n t ə
gemeentehuis	ɣ ə m eː n t ə ɦ œ y̯ s
gemeenteraad	ɣ ə m eː n t ə r aː t
gemeenteraadslid	ɣ ə m eː n t ə r aː t s l ɪ t
gemis	ɣ ə m ɪ s
gemoeten	ɣ ə m u t ə n
gen	ɣ ɛ n
genaamde	ɣ ə n aː m d ə
genadeloos	ɣ ə n aː d ə l oː s
geneesheer	ɣ ə n eː s ɦ eː r
geneeskunde	ɣ ə n eː s k ʏ n d ə
geneesmiddel	ɣ ə n eː s m ɪ d ə l
generaal	ɣ eː n ə r aː l
generaliseren	ɣ eː n ə r aː l i z eː r ə n
generatie	ɣ eː n ə r aː t s i
genezen	ɣ ə n eː z ə n
geniaal	ɣ eː n i j aː l
genieten	ɣ ə n i t ə n
genoegen	ɣ ə n u ɣ ə n
genoot	ɣ ə n oː t
genoten	ɣ ə n oː t ə n
genre	ʒ ɑ n r ə
gent	ɣ ɛ n t
genua	ɣ eː n y ʋ aː
genève	z j ə n ɛː v ə
geodesie	ɣ eː oː d eː z i
geografie	ɣ eː oː ɣ r aː f i
geologie	ɣ eː oː l oː ɣ i
geologisch	ɣ eː oː l oː ɣ i s
georgië	ɣ eː j ɔ r ɣ i j ə
geraken	ɣ ə r aː k ə n
gerard	ɣ eː r ɑ r t
gerecht	ɣ ə r ɛ x t
gereed	ɣ ə r eː t
gereedschap	ɣ ə r eː t s x ɑ p
gereformeerd	ɣ ə r eː f ɔ r m eː r t
gerst	ɣ ɛ r s t
gerucht	ɣ ə r ʏ x t
gerven	ɣ ɛ r v ə n
geschenk	ɣ ə s x ɛ ŋ k
geschiedenis	ɣ ə s x i d ə n ɪ s
geschil	ɣ ə s x ɪ l
geschonden	ɣ ə s x ɔ n d ə n
geschreven	ɣ ə s x r eː v ə n
geschut	ɣ ə s x ʏ t
geslacht	ɣ ə s l ɑ x t
geslachtsrijp	ɣ ə s l ɑ x t s r ɛ i̯ p
gesloten	ɣ ə s l oː t ə n
gesneden	ɣ ə s n eː d ə n
gespierd	ɣ ə s p iː r t
gesprek	ɣ ə s p r ɛ k
gesproken	ɣ ə s p r ɔ k ə n
gestel	ɣ ə s t ɛ l
gestemd	ɣ ə s t ɛ m t
getogen	ɣ ə t oː ɣ ə n
getrokken	ɣ ə t r ɔ k ə n
getrouw	ɣ ə t r ɑ u
getrouwd	ɣ ə t r ɑ u̯ t
getuige	ɣ ə t œ y̯ ɣ ə
getuigen	ɣ ə t œ y̯ ɣ ə n
getuigenis	ɣ ə t œ y̯ ɣ ə n ɪ s
geuit	ɣ ə œ y̯ t
geul	ɣ øː l
geur	ɣ øː r
geuren	ɣ øː r ə n
geus	ɣ øː s
gevaar	ɣ ə v aː r
geval	ɣ ə v ɑ l
gevallen	ɣ ə v ɑ l ə n
gevangen	ɣ ə ʋ ɑ ŋ ə n
gevangenis	ɣ ə v ɑ ŋ ə n ɪ s
gevecht	ɣ ə v ɛ x t
gevel	ɣ eː v ə l
geven	ɣ eː v ə n
gevoel	ɣ ə v u l
gewacht	ɣ ə ʋ ɑ x t
geweer	ɣ ə ʋ eː r
geweest	ɣ ə ʋ eː s t
geweld	ɣ ə ʋ ɛ l t
gewelddadig	ɣ ə ʋ ɛ l d aː d ə x
geweldig	ɣ ə ʋ ɛ l d ə x
gewervelde	ɣ ə ʋ ɛ r v ə l d ə
gewest	ɣ ə ʋ ɛ s t
gewestelijk	ɣ ə ʋ ɛ s t ə l ə k
geweten	ɣ ə ʋ eː t ə n
gewetensbezwaarde	ɣ ə ʋ eː t ə n s b ə z ʋ aː r d ə
gewild	ɣ ə ʋ ɪ l t
gewillig	ɣ ə ʋ ɪ l ə x
gewonnen	ɣ ə ʋ ɔ n ə n
gewoon	ɣ ə ʋ oː n
gewoond	ɣ ə ʋ oː n t
gewoonte	ɣ ə ʋ oː n t ə
gewoonterecht	ɣ ə ʋ oː n t ə r ɛ x t
geworden	ɣ ə ʋ ɔ r d ə n
gezag	ɣ ə z ɑ x
gezagvoerder	ɣ ə z ɑ x f uː r d ə r
gezegd	ɣ ə z ɛ x t
gezegde	ɣ ə z ɛ x d ə
gezegende	ɣ ə z eː ɣ ə n d ə
gezel	ɣ ə z ɛ l
gezellig	ɣ ə z ɛ l ə x
gezelschapsspel	ɣ ə z ɛ l s x ɑ p s p ɛ l
gezicht	ɣ ə z ɪ x t
gezogen	ɣ ə z oː ɣ ə n
gezond	ɣ ə z ɔ n t
gezondheid	ɣ ə z ɔ n t ɦ ɛ i̯ t
geëerd	ɣ ə eː r t
ghana	ɣ aː n aː
gids	ɣ ɪ t s
gidsland	ɣ ɪ t s l ɑ n t
giek	ɣ i k
gieren	ɣ iː r ə n
gieten	ɣ i t ə n
gift	ɣ ɪ f t
giftig	ɣ ɪ f t ə x
giftigheid	ɣ ɪ f t ə x ɦ ɛ i̯ t
gij	ɣ ɛ i̯
gil	ɣ ɪ l
gilde	ɣ ɪ l d ə
gildos	ɣ ɪ l t ɔ s
gillen	ɣ ɪ l ə n
gips	ɣ ɪ p s
gist	ɣ ɪ s t
gisten	ɣ ɪ s t ə n
gisteren	ɣ ɪ s t ə r ə n
glaaien	ɣ l aː j ə n
glans	ɣ l ɑ n s
glastuinbouw	ɣ l ɑ s t œ y̯ n b ɑ u̯
glibberig	ɣ l ɪ b ə r ə x
glijbaan	ɣ l ɛ i b aː n
glijden	ɣ l ɛ i̯ d ə n
glijvlucht	ɣ l ɛ i̯ v l ʏ x t
glimmen	ɣ l ɪ m ə n
glippen	ɣ l ɪ p ə n
gloed	ɣ l u t
gloeilamp	ɣ l u i̯ l ɑ m p
goal	ɡ oː l
god	ɣ ɔ t
godheid	ɣ ɔ t ɦ ɛ i̯ t
godin	ɣ oː d ɪ n
godsdienst	ɣ ɔ t s d i n s t
goed	ɣ u t
goeddeels	ɣ u t d eː l s
goede	ɣ u d ə
goedemorgen	ɣ u d ə m ɔ r ɣ ə n
goedkeuren	ɣ u t k øː r ə n
goedkeuring	ɣ u t k øː r ɪ ŋ
goedkoop	ɣ u t k oː p
goeie	ɣ u j ə
goeiemorgen	ɣ u j ə m ɔ r ɣ ə n
goes	ɣ u s
gokverslaving	ɣ ɔ k f ə r s l aː v ɪ ŋ
golfslagbad	ɣ ɔ l f s l ɑ x b ɑ t
gondel	ɣ ɔ n d ə l
gonorroe	ɣ oː n ɔ r øː
goodwill	ɡ u t ʋ ɪ l
gooi	ɣ oː i̯
gooien	ɣ oː i̯ ə n
gooit	ɣ oː i̯ t
goot	ɣ oː t
gordijn	ɣ ɔ r d ɛ i̯ n
goud	ɣ ɑ u̯ t
gouden	ɣ ɑ u̯ d ə n
gourmetten	ɣ uː r m ɛ t ə n
gouvernement	ɣ u v ɛ r n ə m ɛ n t
graad	ɣ r aː t
graag	ɣ r aː x
graaicultuur	ɣ r aː i̯ k ʏ l t yː r
graan	ɣ r aː n
graancirkel	ɣ r aː n s ɪ r k ə l
gracht	ɣ r ɑ x t
grachtenhuis	ɣ r ɑ x t ə n ɦ œ y̯ s
gracieus	ɣ r aː s i øː s
graf	ɣ r ɑ f
grafiet	ɣ r aː f i t
grafsteen	ɣ r ɑ f s t eː n
gram	ɣ r ɑ m
granaat	ɣ r aː n aː t
granaatwerper	ɣ r aː n aː t ʋ ɛ r p ə r
grap	ɣ r ɑ p
grapjas	ɣ r ɑ p j ɑ s
grasduin	ɣ r ɑ s d œ y̯ n
grasduinen	ɣ r ɑ s d œ y̯ n ə n
grasland	ɣ r ɑ s l ɑ n t
grassen	ɣ r ɑ s ə n
grasveld	ɣ r ɑ s v ɛ l t
gratie	ɣ r aː t s i
gratis	ɣ r aː t ɪ s
grauw	ɣ r ɑ u̯
graven	ɣ r aː v ə n
gravin	ɣ r aː v ɪ n
grazen	ɣ r aː z ə n
grenen	ɣ r eː n ə n
grenzeloos	ɣ r ɛ n z ə l oː s
griek	ɣ r i k
griekenland	ɣ r i k ə n l ɑ n t
griep	ɣ r i p
griezel	ɣ r i z ə l
grijpen	ɣ r ɛ i̯ p ə n
grillen	ɣ r ɪ l ə n
grind	ɣ r ɪ n t
grip	ɣ r ɪ p
gristen	ɣ r ɪ s t ə n
groei	ɣ r u i̯
groeihormoon	ɣ r u i̯ ɦ ɔ r m oː n
groene	ɣ r u n ə
groente	ɣ r u n t ə
groesbeek	ɣ r u s b eː k
groet	ɣ r u t
groeten	ɣ r u t ə n
grof	ɣ r ɔ f
grond	ɣ r ɔ n t
gronden	ɣ r ɔ n d ə n
grondgebied	ɣ r ɔ n t x ə b i t
grondrecht	ɣ r ɔ n t r ɛ x t
grondslag	ɣ r ɔ n t s l ɑ x
grondstof	ɣ r ɔ n t s t ɔ f
grondvesten	ɣ r ɔ n t f ɛ s t ə n
grondwet	ɣ r ɔ n t ʋ ɛ t
grondwettelijk	ɣ r ɔ n t ʋ ɛ t ə l ə k
groninger	ɣ r oː n ɪ ŋ ə r
groot	ɣ r oː t
grootmacht	ɣ r oː t m ɑ x t
grootste	ɣ r oː t s t ə
grootvader	ɣ r oː t f aː d ə r
grootzeil	ɣ r oː t s ɛ i̯ l
grot	ɣ r ɔ t
grotbewoner	ɣ r ɔ t b ə ʋ oː n ə r
grote	ɣ r oː t ə
grotesk	ɣ r oː t ɛ s k
gruis	ɣ r œ y̯ s
gruweldaad	ɣ r y ə l d aː t
gsm	ɣ eː ɛ s ɛ m
guichelheil	ɣ œ y̯ x ə l ɦ ɛ i̯ l
gulden	ɣ ʏ l d ə n
gulp	ɣ ʏ l p
gun	ɣ ʏ n
gunnen	ɣ ʏ n ə n
gunst	ɣ ʏ n s t
haaksbergen	ɦ aː k s b ɛ r ɣ ə n
haal	ɦ aː l
haalt	ɦ aː l t
haan	ɦ aː n
haar	ɦ aː r
haard	ɦ aː r t
haardos	ɦ aː r d ɔ s
haarlem	ɦ aː r l ɛ m
haarlemmer	ɦ aː r l ɛ m ə r
haarlemmermeer	ɦ aː r l ɛ m ə r m eː r
haarscherp	ɦ aː r s x ɛ r p
haas	ɦ aː s
haasachtige	ɦ aː s ɑ x t ə ɣ ə
haast	ɦ aː s t
haat	ɦ aː t
hachelijk	ɦ ɑ x ə l ə k
hagedis	ɦ aː ɣ ə d ɪ s
hagelwit	ɦ aː ɣ ə l ʋ ɪ t
hak	ɦ ɑ k
haken	ɦ aː k ə n
hal	ɦ ɑ l
halal	ɦ aː l ɑ l
halen	ɦ aː l ə n
half	ɦ ɑ l f
halfstok	ɦ ɑ l f s t ɔ k
halsband	ɦ ɑ l s b ɑ n t
halsketting	ɦ ɑ l s k ɛ t ɪ ŋ
halte	ɦ ɑ l t ə
halve	ɦ ɑ l v ə
halvering	ɦ ɑ l v eː r ɪ ŋ
ham	ɦ ɑ m
hamer	ɦ aː m ə r
hamvraag	ɦ ɑ m v r aː x
hand	ɦ ɑ n t
handdoek	ɦ ɑ n d u k
handen	ɦ ɑ n d ə n
handgranaat	ɦ ɑ n t x r aː n aː t
handhaving	ɦ ɑ n t ɦ aː v ɪ ŋ
handicap	ɦ ɛ n d i k ɛ p
handig	ɦ ɑ n d ə x
handtas	ɦ ɑ n t ɑ s
handtekening	ɦ ɑ n t eː k ə n ɪ ŋ
handwerk	ɦ ɑ n t ʋ ɛ r k
hang	ɦ ɑ ŋ
hangar	ɦ ɑ ŋ ɡ aː r
hangen	ɦ ɑ ŋ ə n
hangt	ɦ ɑ ŋ t
hansworst	ɦ ɑ n s ʋ ɔ r s t
hanteerbaar	ɦ ɑ n t eː r b aː r
har	ɦ ɑ r
hard	ɦ ɑ r t
hardenberg	ɦ ɑ r d ə n b ɛ r x
harder	ɦ ɑ r d ə r
hardhouten	ɦ ɑ r t ɦ ɑ u̯ t ə n
hardnekkig	ɦ ɑ r t n ɛ k ə x
hare	ɦ aː r ə
haring	ɦ aː r ɪ ŋ
harlingen	ɦ ɑ r l ɪ ŋ ə n
harm	ɦ ɑ r m
harmelen	ɦ ɑ r m ə l ə n
harmonisch	ɦ ɑ r m oː n i s
harmonische	ɦ ɑ r m oː n i s ə
harmonischen	ɦ ɑ r m oː n i s ə n
harmsen	ɦ ɑ r m s ə n
harp	ɦ ɑ r p
hart	ɦ ɑ r t
hartaanval	ɦ ɑ r t aː n v ɑ l
hartelijk	ɦ ɑ r t ə l ə k
hartfalen	ɦ ɑ r t f aː l ə n
hassan	ɦ ɑ s ɑ n
hasselt	ɦ ɑ s ə l t
haten	ɦ aː t ə n
hattem	ɦ ɑ t ə m
havengebied	ɦ aː v ə n ɣ ə b i t
havenstad	ɦ aː v ə n s t ɑ t
havo	ɦ aː v oː
haïti	ɦ aː i t i
hebreeuws	ɦ eː b r eː u̯ s
hecht	ɦ ɛ x t
hechten	ɦ ɛ x t ə n
hectare	ɦ ɛ k t aː r ə
hector	ɦ ɛ k t ɔ r
hedendaags	ɦ eː d ə n d aː x s
heel	ɦ eː l
heelal	ɦ eː l ɑ l
heelkunde	ɦ eː l k ʏ n d ə
heem	ɦ eː m
heemskerk	ɦ eː m s k ɛ r k
heen	ɦ eː n
heerenveen	ɦ eː r ə n v eː n
heerlen	ɦ eː r l ə n
heerlijk	ɦ eː r l ə k
heersen	ɦ eː r s ə n
heerst	ɦ eː r s t
heet	ɦ eː t
heffen	ɦ ɛ f ə n
heffing	ɦ ɛ f ɪ ŋ
heft	ɦ ɛ f t
heftig	ɦ ɛ f t ə x
heg	ɦ ɛ x
heiden	ɦ ɛ i̯ d ə n
heil	ɦ ɛ i̯ l
heiland	ɦ ɛ i̯ l ɑ n t
heilbot	ɦ ɛ i̯ l b ɔ t
heiligdom	ɦ ɛ i̯ l ə ɣ d ɔ m
heiligen	ɦ ɛ i̯ l ə ɣ ə n
heiloo	ɦ ɛ i̯ l oː
heilstaat	ɦ ɛ i̯ l s t aː t
heim	ɦ ɛ i̯ m
heisa	ɦ ɛ i̯ s aː
hek	ɦ ɛ k
hekkensluiter	ɦ ɛ k ə n s l œ y̯ t ə r
heks	ɦ ɛ k s
heksen	ɦ ɛ k s ə n
helaas	ɦ eː l aː s
held	ɦ ɛ l t
helder	ɦ ɛ l d ə r
heldhaftig	ɦ ɛ l t ɦ ɑ f t ə x
hele	ɦ eː l ə
heleboel	ɦ eː l ə b u l
heleen	ɦ eː l eː n
helemaal	ɦ eː l ə m aː l
helena	ɦ eː l eː n aː
helft	ɦ ɛ l f t
helgoland	ɦ ɛ l ɣ oː l ɑ n t
helikopter	ɦ eː l i k ɔ p t ə r
heling	ɦ eː l ɪ ŋ
helium	ɦ eː l i ʏ m
helling	ɦ ɛ l ɪ ŋ
helmond	ɦ ɛ l m ɔ n t
helpen	ɦ ɛ l p ə n
hels	ɦ ɛ l s
helsinki	ɦ ɛ l s i ŋ k i
hem	ɦ ɛ m
hemd	ɦ ɛ m t
hemel	ɦ eː m ə l
hemelbed	ɦ eː m ə l b ɛ t
hemelvaart	ɦ eː m ə l v aː r t
hendrik	ɦ ɛ n d r ɪ k
hendriks	ɦ ɛ n d r ɪ k s
heraldiek	ɦ eː r ɑ l d i k
herberg	ɦ ɛ r b ɛ r x
herbronnen	ɦ ɛ r b r ɔ n ə n
herder	ɦ ɛ r d ə r
herdershond	ɦ ɛ r d ə r s ɦ ɔ n t
here	ɦ eː r ə
herenhuis	ɦ eː r ə n ɦ œ y̯ s
herfst	ɦ ɛ r f s t
herfstvakantie	ɦ ɛ r f s t f aː k ɑ n s i
herinnering	ɦ ɛ r ɪ n ə r ɪ ŋ
hermans	ɦ ɛ r m ɑ n s
herrie	ɦ ɛ r i
hersenen	ɦ ɛ r s ə n ə n
hersens	ɦ ɛ r s ə n s
herstel	ɦ ɛ r s t ɛ l
herstellen	ɦ ɛ r s t ɛ l ə n
hertog	ɦ ɛ r t ɔ x
hervormd	ɦ ɛ r v ɔ r m t
hervorming	ɦ ɛ r v ɔ r m ɪ ŋ
hesselink	ɦ ɛ s ə l ɪ ŋ k
hester	ɦ ɛ s t ə r
heten	ɦ eː t ə n
hetero	ɦ eː t ə r oː
heugen	ɦ øː ɣ ə n
heulen	ɦ øː l ə n
heupen	ɦ øː p ə n
heus	ɦ øː s
heusden	ɦ øː z d ə n
heuvel	ɦ øː v ə l
heuvelrug	ɦ øː v ə l r ʏ x
hexaan	ɦ ɛ k s aː n
hier	ɦ i r
hij	ɦ ɛ i̯
hijsen	ɦ ɛ i̯ s ə n
hilarisch	ɦ i l aː r i s
hilariteit	ɦ i l aː r i t ɛ i̯ t
hilhorst	ɦ ɪ l ɦ ɔ r s t
hillegom	ɦ ɪ l ə ɣ ɔ m
hilversum	ɦ ɪ l v ə r s ʏ m
hinde	ɦ ɪ n d ə
hindoeïsme	ɦ ɪ n d u ɪ s m ə
historie	ɦ ɪ s t oː r i
historisch	ɦ ɪ s t oː r i s
hit	ɦ ɪ t
hitlijst	ɦ ɪ t l ɛ i̯ s t
hitte	ɦ ɪ t ə
hittegolf	ɦ ɪ t ə ɣ ɔ l f
hiërarchie	ɦ iː r ɑ r x i
hobbel	ɦ ɔ b ə l
hockey	ɦ ɔ k i
hoe	ɦ u
hoed	ɦ u t
hoeden	ɦ u d ə n
hoekstra	ɦ u k s t r aː
hoelang	ɦ u l ɑ ŋ
hoera	ɦ u r aː
hoesten	ɦ u s t ə n
hoeveelheid	ɦ u v eː l ɦ ɛ i̯ t
hoeven	ɦ u v ə n
hoezo	ɦ u z oː
hof	ɦ ɔ f
hofman	ɦ ɔ f m ɑ n
hogeschool	ɦ oː ɣ ə s x oː l
hogesnelheidstrein	ɦ oː ɣ ə s n ɛ l ɦ ɛ i̯ t s t r ɛ i̯ n
hoi	ɦ ɔ i̯
hok	ɦ ɔ k
hol	ɦ ɔ l
holebi	ɦ oː l ə b i
holland	ɦ ɔ l ɑ n t
hollander	ɦ ɔ l ɑ n d ə r
hollands	ɦ ɔ l ɑ n t s
hollen	ɦ ɔ l ə n
holte	ɦ ɔ l t ə
homeopathie	ɦ oː m eː oː p aː t i
homeopathisch	ɦ oː m eː oː p aː t i s
homo	ɦ oː m oː
homofobie	ɦ oː m oː f oː b i
homohaat	ɦ oː m oː ɦ aː t
homoseksualiteit	ɦ oː m oː s ɛ k s y aː l i t ɛ i̯ t
hond	ɦ ɔ n t
honden	ɦ ɔ n d ə n
honderd	ɦ ɔ n d ə r t
honderdduizend	ɦ ɔ n d ə r t d œ y̯ z ə n t
hongarije	ɦ ɔ ŋ ɣ aː r ɛ i̯ j ə
hongerig	ɦ ɔ ŋ ə r ə x
hongersnood	ɦ ɔ ŋ ə r s n oː t
honing	ɦ oː n ɪ ŋ
honk	ɦ ɔ ŋ k
honkbal	ɦ ɔ ŋ k b ɑ l
honkbalknuppel	ɦ ɔ ŋ k b ɑ l k n ʏ p ə l
honorarium	ɦ oː n oː r aː r i ʏ m
hoofden	ɦ oː v d ə n
hoofdinspecteur	ɦ oː f t ɪ n s p ɛ k t øː r
hoofdje	ɦ oː f t j ə
hoofdletter	ɦ oː f t l ɛ t ə r
hoofdmacht	ɦ oː f t m ɑ x t
hoofdpersoon	ɦ oː f t p ɛ r s oː n
hoofdpijn	ɦ oː f t p ɛ i̯ n
hoofdplaats	ɦ oː f t p l aː t s
hoofdredacteur	ɦ oː f t r eː d ɑ k t øː r
hoofdreeksster	ɦ oː f t r eː k s s t ɛ r
hoofdrol	ɦ oː f t r ɔ l
hoofdstad	ɦ oː f t s t ɑ t
hoofdstraat	ɦ oː f t s t r aː t
hoofdweg	ɦ oː f t ʋ ɛ x
hoog	ɦ oː x
hoogbejaarde	ɦ oː x b ə j aː r d ə
hoogbouw	ɦ oː x b ɑ u̯
hoogheemraadschap	ɦ oː x ɦ eː m r aː t s x ɑ p
hoogstens	ɦ oː x s t ə n s
hooguit	ɦ oː x œ y̯ t
hoogwerker	ɦ oː x ʋ ɛ r k ə r
hooi	ɦ oː i̯
hooivork	ɦ oː i̯ v ɔ r k
hoop	ɦ oː p
hoor	ɦ oː r
hoorn	ɦ oː r n
hoort	ɦ oː r t
hoorzitting	ɦ oː r z ɪ t ɪ ŋ
hopen	ɦ oː p ə n
hoppen	ɦ ɔ p ə n
horeca	ɦ oː r eː k aː
horen	ɦ oː r ə n
horizon	ɦ oː r i z ɔ n
horloge	ɦ ɔ r l oː ʒ ə
hormonenbom	ɦ ɔ r m oː n ə n b ɔ m
hors	ɦ ɔ r s
hospitaal	ɦ ɔ s p i t aː l
hosselen	ɦ ɔ s ə l ə n
hot	ɦ ɔ t
hotel	ɦ oː t ɛ l
hou	ɦ ɑ u̯
houden	ɦ ɑ u̯ d ə n
houdgreep	ɦ ɑ u̯ t x r eː p
houdt	ɦ ɑ u̯ t
hout	ɦ ɑ u̯ t
houtskool	ɦ ɑ u̯ t s k oː l
houtworm	ɦ ɑ u̯ t ʋ ɔ r m
houwen	ɦ ɑ u̯ ə n
hovaardij	ɦ oː v aː r d ɛ i̯
hoveling	ɦ oː v ə l ɪ ŋ
huib	ɦ œ y̯ p
huid	ɦ œ y̯ t
huidig	ɦ œ y̯ d ə x
huilebalk	ɦ œ y̯ l ə b ɑ l k
huilen	ɦ œ y̯ l ə n
huis	ɦ œ y̯ s
huisafval	ɦ œ y̯ s ɑ f ɑ l
huisdier	ɦ œ y̯ s d iː r
huiselijk	ɦ œ y̯ s ə l ə k
huisgenoot	ɦ œ y̯ s x ə n oː t
huishoudelijk	ɦ œ y̯ s ɦ ɑ u̯ d ə l ə k
huishouden	ɦ œ y̯ s ɦ ɑ u̯ d ə n
huishouding	ɦ œ y̯ s ɦ ɑ u̯ d ə n
huiskamer	ɦ œ y̯ s k aː m ə r
huisman	ɦ œ y̯ s m ɑ n
huisnummer	ɦ œ y̯ s n ʏ m ə r
huisstofmijt	ɦ œ y̯ s t ɔ f m ɛ i̯ t
huiswerk	ɦ œ y̯ s ʋ ɛ r k
huiverig	ɦ œ y̯ v ə r ə x
huizenmarkt	ɦ œ y̯ z ə n m ɑ r k t
huizinga	ɦ œ y̯ z ɪ ŋ ɣ aː
hulp	ɦ ʏ l p
hulphond	ɦ ʏ l p ɦ ɔ n t
hulpmiddel	ɦ ʏ l p m ɪ d ə l
hulpvaardigheid	ɦ ʏ l p f aː r d ə x ɦ ɛ i̯ t
hulst	ɦ ʏ l s t
humeur	ɦ y m øː r
humor	ɦ y m ɔ r
humus	ɦ y m ʏ s
hun	ɦ ʏ n
hup	ɦ ʏ p
huren	ɦ y r ə n
huur	ɦ y r
huwelijksreis	ɦ y ʋ ə l ə k s r ɛ i̯ s
huwen	ɦ y u̯ ə n
hyperbool	ɦ i p ə r b oː l
hyperoniem	ɦ i p ə r oː n i m
hypocrisie	ɦ i p oː k r i z i
hypothecair	ɦ i p oː t eː k ɛː r
hypotheekrenteaftrek	ɦ i p oː t eː k r ɛ n t ə ɑ f t r ɛ k
hè	ɦ ɛ
hé	ɦ eː
icoon	i k oː n
ida	i d aː
ideaal	i d eː aː l
idealistisch	i d eː aː l ɪ s t i s
idee	i d eː
ideeën	i d eː j ə n
identiteitskaart	i d ɛ n t i t ɛ i̯ t s k aː r t
ideologie	i d eː oː l oː ɣ i
idioot	i d i j oː t
idool	i d oː l
iemand	i m ɑ n t
ieper	i p ə r
ierland	iː r l ɑ n t
iers	iː r s
iets	i t s
ifa	i ɛ f aː
ij	ɛ i̯
ijmuiden	ɛ i̯ m œ y̯ d ə n
ijs	ɛ i̯ s
ijscoman	ɛ i̯ s k oː m ɑ n
ijsdansen	ɛ i̯ s d ɑ n s ə n
ijsje	ɛ i̯ s j ə
ijskap	ɛ i̯ s k ɑ p
ijskast	ɛ i̯ s k ɑ s t
ijskoud	ɛ i̯ s k ɑ u̯ t
ijsland	ɛ i̯ s l ɑ n t
ijslander	ɛ i̯ s l ɑ n d ə r
ijssalon	ɛ i̯ s aː l ɔ n
ijssel	ɛ i̯ s ə l
ijsselmeer	ɛ i̯ s ə l m eː r
ijsselstein	ɛ i̯ s ə l s t ɛ i̯ n
ijstaria	ɛ i̯ s t aː r i aː
ijstijd	ɛ i̯ s t ɛ i̯ t
ijsvogel	ɛ i̯ s f oː ɣ ə l
ijsvrij	ɛ i s v r ɛ i
immens	ɪ m ɛ n s
imperium	ɪ m p eː r i ʏ m
imponeren	ɪ m p oː n eː r ə n
import	ɪ m p ɔ r t
impressie	ɪ m p r ɛ s i
improvisatie	ɪ m p r oː v i z aː t s i
in	ɪ n
ina	i n aː
inbakeren	ɪ m b aː k ə r ə n
inboezemen	ɪ n b u z ə m ə n
inborst	ɪ m b ɔ r s t
inbreker	ɪ n b r eː k ə r
inbrengen	ɪ m b r ɛ ŋ ə n
inburgering	ɪ n b ʏ r ɣ ə r ɪ ŋ
incest	ɪ n s ɛ s t
incident	ɪ n s i d ɛ n t
incongruentie	ɪ ŋ k ɔ ŋ ɣ r y ɛ n s i
incubatietijd	ɪ n k y b aː t s i t ɛ i̯ t
india	ɪ n d i aː
indicatie	ɪ n d i k aː t s i
indien	ɪ n d i n
indium	ɪ n d i j ʏ m
individu	ɪ n d i v i d y
indonesisch	ɪ n d oː n eː z i s
indonesië	ɪ n d oː n eː z i j ə
indruk	ɪ n d r ʏ k
indrukwekkend	ɪ n d r ʏ k ʋ ɛ k ə n t
ineke	i n ə k ə
infanterie	ɪ n f ɑ n t ə r i
infectie	ɪ n f ɛ k s i
infiltrant	ɪ n f ɪ l t r ɑ n t
inflatie	ɪ n f l aː t s i
info	ɪ n f oː
informatie	ɪ n f ɔ r m aː t s i
informatiebeveiliging	ɪ n f ɔ r m aː t s i b ə v ɛ i̯ l ə ɣ ɪ ŋ
informatiebron	ɪ n f ɔ r m aː t s i b r ɔ n
informeel	ɪ n f ɔ r m eː l
ingaan	ɪ n ɣ aː n
ingang	ɪ ŋ ɣ ɑ ŋ
ingeval	ɪ ŋ ɣ ə v ɑ l
ingewikkeld	ɪ n ɣ ə ʋ ɪ k ə l t
ingrid	ɪ ŋ ɣ r ɪ t
inhoud	ɪ n ɦ ɑ u̯ t
inhoudelijk	ɪ n ɦ ɑ u̯ d ə l ə k
initiatief	i n i s j aː t i f
inkoop	ɪ n k oː p
inkopen	ɪ n k oː p ə n
inkorten	ɪ n k ɔ r t ə n
inkt	ɪ ŋ k t
inlevingsvermogen	ɪ n l eː v ɪ ŋ s f ə r m oː ɣ ə n
inmenging	ɪ n m ɛ ŋ ɪ ŋ
innemen	ɪ n eː m ə n
innerlijk	ɪ n ə r l ə k
inrichting	ɪ n r ɪ x t ɪ ŋ
inrijden	ɪ n r ɛ i̯ d ə n
inschatting	ɪ n s x ɑ t ɪ ŋ
insect	ɪ n s ɛ k t
insecteneter	ɪ n s ɛ k t ə n eː t ə r
inslag	ɪ n s l ɑ x
inslikken	ɪ n s l ɪ k ə n
insnijden	ɪ n s n ɛ i̯ d ə n
inspannen	ɪ n s p ɑ n ə n
inspecteren	ɪ n s p ɛ k t eː r ə n
inspecteur	ɪ n s p ɛ k t øː r
inspectie	ɪ n s p ɛ k s i
inspelen	ɪ n s p eː l ə n
instantie	ɪ n s t ɑ n s i
instemmen	ɪ n s t ɛ m ə n
instituut	ɪ n s t i t y t
instorten	ɪ n s t ɔ r t ə n
instructie	ɪ n s t r ʏ k s i
instrument	ɪ n s t r y m ɛ n t
instrumentarium	ɪ n s t r y m ɛ n t aː r i ʏ m
intens	ɪ n t ɛ n s
intensief	ɪ n t ɛ n z i f
interbellum	ɪ n t ə r b ɛ l ʏ m
intercity	ɪ n t ə r s ɪ t i
interland	ɪ n t ə r l ɑ n t
internationaal	ɪ n t ə r n aː t ʃ oː n aː l
internet	ɪ n t ə r n ɛ t
internetcafé	ɪ n t ə r n ɛ t k aː f eː
internetsite	ɪ n t ə r n ɛ t s ɑ i̯ t
interval	ɪ n t ə r v ɑ l
interview	ɪ n t ə r v j u
interviewen	ɪ n t ə r v j u ʋ ə n
interviewer	ɪ n t ə r v j uː ə r
interviews	ɪ n t ə r v j u s
intiem	ɪ n t i m
intikken	ɪ n t ɪ k ə n
intonatie	ɪ n t oː n aː t s i
intuïtie	ɪ n t y i t s i
invalide	ɪ n v aː l i d ə
invalshoek	ɪ n v ɑ l s ɦ u k
invasie	ɪ n v aː z i
investeringsbank	ɪ n v ɛ s t eː r ɪ ŋ s b ɑ ŋ k
invloed	ɪ n v l u t
invloedrijk	ɪ n v l u t r ɛ i̯ k
invriezen	ɪ n v r i z ə n
inwerken	ɪ n ʋ ɛ r k ə n
inwoner	ɪ n ʋ oː n ə r
inzake	ɪ n z aː k ə
inzicht	ɪ n z ɪ x t
ippon	ɪ p ɔ n
irak	i r ɑ k
irakees	i r aː k eː s
irene	i r eː n ə
irritant	i r r i t ɑ n t
is	ɪ s
isabel	i z aː b ɛ l
isabella	i z aː b ɛ l aː
islamiet	ɪ s l aː m i t
islamitisch	ɪ s l aː m i t i s
islamofoob	i s l aː m oː f oː p
isolatie	i z oː l aː t s i
israël	ɪ s r aː ɛ l
israëliet	ɪ s r aː eː l i t
italiaan	i t aː l i aː n
italië	i t aː l i j ə
ja	j aː
jaap	j aː p
jaarabonnement	j aː r ɑ b ɔ n ə m ɛ n t
jaarboek	j aː r b u k
jaargang	j aː r ɣ ɑ ŋ
jaarlijks	j aː r l ə k s
jaarmarkt	j aː r m ɑ r k t
jaartelling	j aː r t ɛ l ɪ ŋ
jacht	j ɑ x t
jachthaven	j ɑ x t ɦ aː v ə n
jacobs	j aː k ɔ p s
jagen	j aː ɣ ə n
jak	j ɑ k
jaknikker	j aː k n ɪ k ə r
jaknikkers	j aː k n ɪ k ə r s
jakob	j aː k ɔ p
jaloezie	j ɑ l u z iː
jam	ʒ ɛ m
janse	j ɑ n s ə
jansen	j ɑ n s ə n
janssen	j ɑ n s ə n
januari	j ɑ n y ʋ aː r i
japan	j aː p ɑ n
jargon	j ɑ r ɣ ɔ n
jarige	j aː r ə ɣ ə
jasmijn	j ɑ s m ɛ i̯ n
java	j aː v aː
jazz	d ʒ ɛ z
jazzy	d ʒ ɛ z i
je	j ə
jeneverbes	j ə n eː v ə r b ɛ s
jeneverstad	j ə n eː v ə r s t ɑ t
jeroen	j ə r u n
jesaja	j ə z aː j aː
jeugd	j øː x t
jeugdig	j øː x d ə x
jeuk	j øː k
jezus	j eː z ʏ s
jodelen	j oː d ə l ə n
joegoslavisch	j u ɣ oː s l aː v i s
johanna	j oː ɦ ɑ n aː
johannesburg	j oː ɦ ɑ n ə s b ʏ r x
joke	j oː k ə
jonas	j oː n ɑ s
jong	j ɔ ŋ
jonge	j ɔ ŋ ə
jongedame	j ɔ ŋ ə d aː m ə
jongelui	j ɔ ŋ ə l œ y̯
jongen	j ɔ ŋ ə n
jongens	j ɔ ŋ ə n s
jongensachtig	j ɔ ŋ ə n s ɑ x t ə x
jongleren	j ɔ ŋ l eː r ə n
jood	j oː t
joop	j oː p
joost	j oː s t
joris	j oː r ɪ s
jos	j ɔ s
jota	j oː t aː
jou	j ɑ u̯
joure	j ɑ u̯ r ə
journalist	ʒ uː r n aː l ɪ s t
journalistiek	ʒ uː r n aː l ɪ s t i k
jouw	j ɑ u̯
jozef	j oː z ə f
juda	j y d aː
juf	j ʏ f
juichen	j œ y̯ x ə n
juist	j œ y̯ s t
julia	j y l i aː
juliana	j y l i aː n aː
julianadorp	j y l i aː n aː d ɔ r p
jungle	d ʒ ʏ ŋ ɡ ə l
jupiter	j y p i t ɛ r
jurk	j ʏ r k
jury	ʒ yː r i
jurylid	ʒ yː r i l ɪ t
juwelen	j y ʋ eː l ə n
ka	k aː
kaak	k aː k
kaal	k aː l
kaapstad	k aː p s t ɑ t
kaars	k aː r s
kaarsvlam	k aː r s v l ɑ m
kaart	k aː r t
kaartenbak	k aː r t ə n b ɑ k
kaartspel	k aː r t s p ɛ l
kaas	k aː s
kaat	k aː t
kaatst	k aː t s t
kabaal	k aː b aː l
kabel	k aː b ə l
kabinet	k aː b i n ɛ t
kabouter	k aː b ɑ u̯ t ə r
kachel	k ɑ x ə l
kacheloven	k ɑ x ə l oː v ə n
kadaster	k aː d ɑ s t ə r
kado	k aː d oː
kaf	k ɑ f
kalf	k ɑ l f
kalief	k aː l i f
kalk	k ɑ l k
kalligraferen	k ɑ l i ɣ r aː f eː r ə n
kalm	k ɑ l m
kalmte	k ɑ l m t ə
kam	k ɑ m
kamp	k ɑ m p
kampeert	k ɑ m p eː r t
kampen	k ɑ m p ə n
kamperen	k ɑ m p eː r ə n
kampioen	k ɑ m p i j u n
kampioenschap	k ɑ m p i j u n s x ɑ p
kamsalamander	k ɑ m s aː l aː m ɑ n d ə r
kan	k ɑ n
kanaal	k aː n aː l
kandidaat	k ɑ n d i d aː t
kandidate	k ɑ n d i d aː t ə
kanjer	k ɑ n j ə r
kanker	k ɑ ŋ k ə r
kankerhoer	k ɑ ŋ k ə r ɦ uː r
kano	k aː n oː
kanon	k aː n ɔ n
kansel	k ɑ n s ə l
kanselier	k ɑ n s ə l iː r
kanten	k ɑ n t ə n
kantine	k ɑ n t i n ə
kantjil	k ɑ n t j ɪ l
kantoor	k ɑ n t oː r
kap	k ɑ p
kapel	k aː p ɛ l
kapoen	k ɑ p uː n
kapper	k ɑ p ə r
kapsalon	k ɑ p s aː l ɔ n
kapster	k ɑ p s t ə r
kapstok	k ɑ p s t ɔ k
kar	k ɑ r
karakter	k aː r ɑ k t ə r
karate	k aː r aː t ə
karavaan	k aː r aː v aː n
kardinaal	k ɑ r d i n aː l
karel	k aː r ə l
karikatuur	k aː r i k aː t y r
karma	k ɑ r m ɑ
karpaten	k ɑ r p aː t ə n
karst	k ɑ r s t
karton	k ɑ r t ɔ n
kas	k ɑ s
kassen	k ɑ s ə n
kast	k ɑ s t
kaste	k ɑ s t ə
kasteel	k ɑ s t eː l
kasteleines	k ɑ s t ə l ɛ i̯ n ɛ s
kasten	k ɑ s t ə n
kat	k ɑ t
kater	k aː t ə r
katholiek	k ɑ t oː l i k
katje	k ɑ t j ə
katoen	k aː t u n
katoenen	k aː t u n ə n
katten	k ɑ t ə n
kattenkwaad	k ɑ t ə ŋ k ʋ aː t
katwijk	k ɑ t ʋ ɛ i̯ k
kauwgom	k ɑ u ɣ ɔ m
kazen	k aː z ə n
kazerne	k aː z ɛ r n ə
kech	k ɛ x
keek	k eː k
keel	k eː l
keet	k eː t
kegelbaan	k eː ɣ ə l b aː n
keizer	k ɛ i̯ z ə r
kek	k ɛ k
kelk	k ɛ l k
kelly	k ɛ l i
kelner	k ɛ l n ə r
kempen	k ɛ m p ə n
kenia	k eː n i aː
kennel	k ɛ n ə l
kennen	k ɛ n ə n
kennisgeving	k ɛ n ɪ s x eː v ɪ ŋ
kentekenplaat	k ɛ n t eː k ə n p l aː t
kentering	k ɛ n t ə r ɪ ŋ
kerel	k eː r ə l
keren	k eː r ə n
kerk	k ɛ r k
kerker	k ɛ r k ə r
kerkhistoricus	k ɛ r k ɦ ɪ s t oː r i k ʏ s
kerkhof	k ɛ r k ɦ ɔ f
kerkorde	k ɛ r k ɔ r d ə
kerkrade	k ɛ r k r aː d ə
kerktoren	k ɛ r k t oː r ə n
kerkvader	k ɛ r k f aː d ə r
kerkzaal	k ɛ r k s aː l
kern	k ɛ r n
kerncentrale	k ɛ r n s ɛ n t r aː l ə
kernraket	k ɛ r n r aː k ɛ t
kerst	k ɛ r s t
kerstboom	k ɛ r s t b oː m
kerstdag	k ɛ r s d ɑ x
kerstmarkt	k ɛ r s t m ɑ r k t
kerstvakantie	k ɛ r s t f aː k ɑ n s i
ketel	k eː t ə l
keten	k eː t ə n
ketterij	k ɛ t ə r ɛ i̯
ketting	k ɛ t ɪ ŋ
keu	k øː
keuren	k øː r ə n
keus	k øː s
kick	k ɪ k
kies	k i s
kiescollege	k i s k ɔ l eː ʒ ə
kiesdistrict	k i s d ɪ s t r ɪ k t
kiesdrempel	k i s d r ɛ m p ə l
kieskring	k i s k r ɪ ŋ
kiespijn	k i s p ɛ i̯ n
kietelen	k i t ə l ə n
kiezen	k i z ə n
kijk	k ɛ i̯ k
kijken	k ɛ i̯ k ə n
kijkt	k ɛ i̯ k t
kikker	k ɪ k ə r
kille	k ɪ l ə
kilometer	k i l oː m eː t ə r
kin	k ɪ n
kinderarbeid	k ɪ n d ə r ɑ r b ɛ i̯ t
kinderarts	k ɪ n d ə r ɑ r t s
kinderbijslag	k ɪ n d ə r b ɛ i̯ s l ɑ x
kinderboek	k ɪ n d ə r b u k
kinderboerderij	k ɪ n d ə r b u r d ə r ɛ i̯
kinderen	k ɪ n d ə r ə n
kinderkoor	k ɪ n d ə r k oː r
kinderloos	k ɪ n d ə r l oː s
kinderoppas	k ɪ n d ə r ɔ p ɑ s
kinderopvang	k ɪ n d ə r ɔ p f ɑ ŋ
kinderstoel	k ɪ n d ə r s t u l
kindertehuis	k ɪ n d ə r t ə ɦ œ y̯ s
kinderwens	k ɪ n d ə r ʋ ɛ n s
kindje	k ɪ n t j ə
kinshasa	k ɪ n ʃ aː s aː
kip	k ɪ p
kippenvel	k ɪ p ə v ɛ l
kissebissen	k ɪ s ə b ɪ s ə n
kist	k ɪ s t
klaarblijkelijk	k l aː r b l ɛ i̯ k ə l ə k
klaarmaken	k l aː r m aː k ə n
klaas	k l aː s
klacht	k l ɑ x t
klagen	k l aː ɣ ə n
klank	k l ɑ ŋ k
klankbeeld	k l ɑ ŋ k b eː l t
klant	k l ɑ n t
klantenkaart	k l ɑ n t ə n k aː r t
klap	k l ɑ p
klas	k l ɑ s
klaslokaal	k l ɑ s l oː k aː l
klassieker	k l ɑ s i k ə r
klauteren	k l ɑ u̯ t ə r ə n
klauw	k l ɑ u̯
kledingstuk	k l eː d ɪ ŋ s t ʏ k
kleed	k l eː t
klei	k l ɛ i̯
kleindochter	k l ɛ i̯ n d ɔ x t ə r
kleine	k l ɛ i̯ n ə
kleingeld	k l ɛ i̯ n ɣ ɛ l t
kleinkind	k l ɛ i̯ n k ɪ n t
kleinkunst	k l ɛ i̯ n k ʏ n s t
kleinood	k l ɛ i̯ n oː t
kleinoogrog	k l ɛ i̯ n oː x r ɔ x
kleinzoon	k l ɛ i̯ n z oː n
klem	k l ɛ m
klemmen	k l ɛ m ə n
klep	k l ɛ p
kleren	k l eː r ə n
kleuter	k l øː t ə r
kleuterleidster	k l øː t ə r l ɛ i̯ t s t ə r
kleven	k l eː v ə n
klikken	k l ɪ k ə n
klikspaan	k l i k s p aː n
klim	k l ɪ m
klimaat	k l i m aː t
klimaatbeleid	k l i m aː t b ə l ɛ i̯ t
klimmen	k l ɪ m ə n
klimplant	k l ɪ m p l ɑ n t
klimt	k l ɪ m t
kliniek	k l i n i k
klit	k l ɪ t
kloek	k l u k
klok	k l ɔ k
klokke	k l ɔ k ə
klokken	k l ɔ k ə n
klokkenluider	k l ɔ k ə n l œ y̯ d ə r
klom	k l ɔ m
klompen	k l ɔ m p ə n
klompendans	k l ɔ m p ə n d ɑ n s
klont	k l ɔ n t
kloof	k l oː f
kloppen	k l ɔ p ə n
klopt	k l ɔ p t
klos	k l ɔ s
kluiven	k l œ y̯ v ə n
kluwen	k l y u̯ ə n
knaag	k n aː x
knaak	k n aː k
knaap	k n aː p
knagen	k n aː ɣ ə n
knaller	k n ɑ l ə r
knap	k n ɑ p
knappen	k n ɑ p ə n
knar	k n ɑ r
kneden	k n eː d ə n
knieschijf	k n i s x ɛ i̯ f
knieën	k n i ə n
knijpen	k n ɛ i̯ p ə n
knikken	k n ɪ k ə n
knil	k n ɪ l
knipoog	k n ɪ p oː x
knippen	k n ɪ p ə n
knipperlicht	k n ɪ p ə r l ɪ x t
knipsel	k n ɪ p s ə l
knisperen	k n ɪ s p ə r ə n
knoflook	k n ɔ f l oː k
knokken	k n ɔ k ə n
knokpartij	k n ɔ k p ɑ r t ɛ i̯
knoop	k n oː p
knopen	k n oː p ə n
knuffel	k n ʏ f ə l
knuffelen	k n ʏ f ə l ə n
kocht	k ɔ x t
kochten	k ɔ x t ə n
koeien	k u i̯ ə n
koekenpan	k u k ə m p ɑ n
koekje	k u k j ə
koekoek	k u k u k
koel	k u l
koelen	k u l ə n
koeling	k u l ɪ ŋ
koelkast	k u l k ɑ s t
koelte	k u l t ə
koeltoren	k u l t oː r ə n
koepel	k u p ə l
koers	k uː r s
koesteren	k u s t ə r ə n
koetshuis	k u t s ɦ œ y̯ s
koetsier	k u t s iː r
koffer	k ɔ f ə r
koffie	k ɔ f i
koffieboon	k ɔ f i b oː n
kok	k ɔ k
kokarde	k oː k ɑ r d ə
koker	k oː k ə r
kokos	k oː k ɔ s
kokstoven	k ɔ k s t oː v ə n
kolder	k ɔ l d ə r
kolonel	k oː l oː n ɛ l
kom	k ɔ m
komaf	k ɔ m ɑ f
komen	k oː m ə n
komisch	k oː m i s
kompas	k ɔ m p ɑ s
komplot	k ɔ m p l ɔ t
komt	k ɔ m t
kon	k ɔ n
konijn	k oː n ɛ i̯ n
konijnenhol	k oː n ɛ i̯ n ə n ɦ ɔ l
koning	k oː n ɪ ŋ
koningin	k oː n ɪ ŋ ɪ n
koninginnedag	k oː n ɪ ŋ ɪ n ə d ɑ x
koningshuis	k oː n ɪ ŋ s ɦ œ y̯ s
koninklijk	k oː n ɪ ŋ k l ə k
koninkrijk	k oː n ɪ ŋ k r ɛ i̯ k
kont	k ɔ n t
konvooi	k ɔ n v oː i̯
koog	k oː x
kooi	k oː i̯
kookboek	k oː k b u k
kookkunst	k oː k ʏ n s t
kookplaat	k oː k p l aː t
kookpunt	k oː k p ʏ n t
kooldioxide	k oː l d i ɔ k s i d ə
koolmonoxide	k oː l m oː n ɔ k s i d ə
koolrabi	k oː l r aː b i
koolstofmonoxide	k oː l s t ɔ f m oː n ɔ k s i d ə
koop	k oː p
koopavond	k oː p aː v ɔ n t
koopt	k oː p t
koopvaardijschip	k oː p f aː r d ɛ i̯ s x ɪ p
koopzondag	k oː p s ɔ n d ɑ x
koor	k oː r
koortsachtig	k oː r t s ɑ x t ə x
kopen	k oː p ə n
koper	k oː p ə r
koploper	k ɔ p l oː p ə r
koprol	k ɔ p r ɔ l
kopstuk	k ɔ p s t ʏ k
koptelefoon	k ɔ p t eː l ə f oː n
koptisch	k ɔ p t i s
kor	k ɔ r
koraal	k oː r aː l
korea	k oː r eː aː
korrel	k ɔ r ə l
kort	k ɔ r t
korten	k ɔ r t ə n
korting	k ɔ r t ɪ ŋ
kortzichtig	k ɔ r t s ɪ x t ə x
kosmopolitisch	k ɔ s m oː p oː l i t i s
kost	k ɔ s t
kostbaar	k ɔ s t b aː r
kostelijk	k ɔ s t ə l ə k
kosteloos	k ɔ s t ə l oː s
kosten	k ɔ s t ə n
koster	k ɔ s t ə r
koter	k oː t ə r
kou	k ɑ u̯
koud	k ɑ u̯ t
kouwe	k ɑ u̯ ə
kraag	k r aː x
kraai	k r aː i̯
kraaien	k r aː i̯ ə n
kraan	k r aː n
kraanwater	k r aː n ʋ aː t ə r
krab	k r ɑ p
kracht	k r ɑ x t
krachteloos	k r ɑ x t ə l oː s
krachtig	k r ɑ x t ə x
krachtmeting	k r ɑ x t m eː t ɪ ŋ
krachtterm	k r ɑ x t ɛ r m
kraken	k r aː k ə n
kramer	k r aː m ə r
kranenburg	k r aː n ə n b ʏ r x
kranendonk	k r aː n ə n d ɔ ŋ k
krans	k r ɑ n s
krant	k r ɑ n t
krap	k r ɑ p
krat	k r ɑ t
krater	k r aː t ə r
kreng	k r ɛ ŋ
krentenbol	k r ɛ n t ə n b ɔ l
krenterig	k r ɛ n t ə r ə x
kreupel	k r øː p ə l
krijg	k r ɛ i̯ x
krijgen	k r ɛ i̯ ɣ ə n
krijger	k r ɛ i̯ ɣ ə r
krijgsmacht	k r ɛ i̯ x s m ɑ x t
krijgsman	k r ɛ i̯ x s m ɑ n
krijt	k r ɛ i̯ t
krikken	k r ɪ k ə n
kringloopwinkel	k r ɪ ŋ l oː p ʋ ɪ ŋ k ə l
kristal	k r ɪ s t ɑ l
kritiek	k r i t i k
kroatië	k r oː aː t s i j ə
kroeg	k r u x
kroes	k r u s
krokus	k r oː k ʏ s
krokusvakantie	k r oː k ʏ s f aː k ɑ n t s i
kronen	k r oː n ə n
kroongetuige	k r oː n ɣ ə t œ y̯ ɣ ə
kroonlijst	k r oː n l ɛ i̯ s t
kroonluchter	k r oː n l ʏ x t ə r
kroonprinses	k r oː n p r ɪ n s ɛ s
krop	k r ɔ p
kruid	k r œ y̯ t
kruiden	k r œ y̯ d ə n
kruin	k r œ y̯ n
kruipen	k r œ y̯ p ə n
kruis	k r œ y̯ s
kruisboog	k r œ y̯ s b oː x
kruisen	k r œ y̯ s ə n
kruising	k r œ y̯ s ɪ ŋ
kruispunt	k r œ y̯ s p ʏ n t
kruiwagen	k r œ y̯ ʋ aː ɣ ə n
krukas	k r ʏ k ɑ s
kudde	k ʏ d ə
kuijpers	k œ y̯ p ə r s
kuiken	k œ y̯ k ə n
kuil	k œ y̯ l
kuip	k œ y̯ p
kuiper	k œ y̯ p ə r
kul	k ʏ l
kummel	k ʏ m ə l
kun	k ʏ n
kunde	k ʏ n d ə
kunnen	k ʏ n ə n
kunst	k ʏ n s t
kunstlicht	k ʏ n s t l ɪ x t
kunstmest	k ʏ n s t m ɛ s t
kunstmestzak	k ʏ n s t m ɛ s t z ɑ k
kunstwerk	k ʏ n s t ʋ ɛ r k
kuren	k y r ə n
kus	k ʏ s
kussen	k ʏ s ə n
kust	k ʏ s t
kustplaats	k ʏ s t p l aː t s
kustwater	k ʏ s t ʋ aː t ə r
kut	k ʏ t
kwaad	k ʋ aː t
kwadraat	k ʋ aː d r aː t
kwak	k ʋ ɑ k
kwalijk	k ʋ aː l ə k
kwalijker	k ʋ aː l ə k ə r
kwart	k ʋ ɑ r t
kwartaal	k ʋ ɑ r t aː l
kwartel	k ʋ ɑ r t ə l
kwast	k ʋ ɑ s t
kweekschool	k ʋ eː k s x oː l
kweekvijver	k ʋ eː k f ɛ i̯ v ə r
kwekerij	k ʋ eː k ə r ɛ i̯
kwestie	k ʋ ɛ s t i
kwetsbaar	k ʋ ɛ t s b aː r
kwetsbaarheid	k ʋ ɛ t s b aː r ɦ ɛ i̯ t
kwetsen	k ʋ ɛ t s ə n
kwiek	k ʋ i k
kwijtschelding	k ʋ ɛ i̯ t s x ɛ l d ɪ ŋ
kwispel	k ʋ ɪ s p ə l
kwistig	k ʋ ɪ s t ə x
la	l aː
laag	l aː x
laagste	l aː x s t ə
laan	l aː n
laars	l aː r s
laat	l aː t
laatst	l aː t s t
laatste	l aː t s t ə
lach	l ɑ x
lachen	l ɑ x ə n
lacht	l ɑ x t
lactase	l ɑ k t aː z ə
lactose	l ɑ k t oː z ə
laden	l aː d ə n
lager	l aː ɣ ə r
lak	l ɑ k
laken	l aː k ə n
lakken	l ɑ k ə n
lam	l ɑ m
lama	l aː m aː
lamlendig	l ɑ m l ɛ n d ə x
lanceren	l ɑ n s eː r ə n
land	l ɑ n t
landbouw	l ɑ n t b ɑ u̯
landbouwgif	l ɑ n t b ɑ u̯ ɣ ɪ f
lande	l ɑ n d ə
landen	l ɑ n d ə n
landgoed	l ɑ n t x uː t
landgraaf	l ɑ n t x r aː f
landman	l ɑ n t m ɑ n
landschap	l ɑ n t s x ɑ p
landzaat	l ɑ n t s aː t
lang	l ɑ ŋ
lange	l ɑ ŋ ə
langlaufen	l ɑ ŋ l ɑ u̯ f ə n
langs	l ɑ ŋ s
langwerpig	l ɑ ŋ ʋ ɛ r p ə x
langzaam	l ɑ ŋ z aː m
lans	l ɑ n s
lanskorporaal	l ɑ n s k ɔ r p oː r aː l
lappen	l ɑ p ə n
larf	l ɑ r f
lars	l ɑ r s
larve	l ɑ r v ə
laser	l eː z ə r
lassen	l ɑ s ə n
last	l ɑ s t
lasten	l ɑ s t ə n
lastercampagne	l ɑ s t ə r k ɑ m p ɑ n j ə
lasterlijk	l ɑ s t ə r l ə k
lat	l ɑ t
late	l aː t ə
laten	l aː t ə n
laura	l ɑ u̯ r aː
laurens	l ɑ u̯ r ə n s
lauw	l ɑ u̯
lavendel	l aː v ɛ n d ə l
ledenbestand	l eː d ə n b ə s t ɑ n t
leder	l eː d ə r
leefgebied	l eː f x ə b i t
leefmilieu	l eː f m ɪ l j øː
leeftijd	l eː f t ɛ i̯ t
leeg	l eː x
leek	l eː k
leen	l eː n
leer	l eː r
leerachterstand	l eː r ɑ x t ə r s t ɑ n t
leerdam	l eː r d ɑ m
leergang	l eː r ɣ ɑ ŋ
leerkracht	l eː r k r ɑ x t
leerling	l eː r l ɪ ŋ
leerlinge	l eː r l ɪ ŋ ə
leerlooierij	l eː r l oː i̯ ə r ɛ i̯
leerstof	l eː r s t ɔ f
leersum	l eː r s ʏ m
leert	l eː r t
leerzaam	l eː r z aː m
lees	l eː s
leest	l eː s t
leesten	l eː s t ə n
leesvoer	l eː s v uː r
leeuw	l eː u̯
leeuwarden	l eː ʋ ɑ r d ə n
leeuwendeel	l eː u̯ ə n d eː l
leg	l ɛ x
leger	l eː ɣ ə r
legerkorps	l eː ɣ ə r k ɔ r p s
legerleiding	l eː ɣ ə r l ɛ i̯ d ɪ ŋ
legerofficier	l eː ɣ ə r ɔ f i s iː r
leggen	l ɛ ɣ ə n
legio	l eː ɣ i oː
legionella	l eː ɣ i oː n ɛ l aː
legt	l ɛ x t
leiband	l ɛ i̯ b ɑ n t
leid	l ɛ i̯ t
leider	l ɛ i̯ d ə r
leiderschap	l ɛ i̯ d ə r s x ɑ p
leiding	l ɛ i̯ d ɪ ŋ
leidingwater	l ɛ i̯ d ɪ ŋ ʋ aː t ə r
leidschendam	l ɛ i̯ t s ə n d ɑ m
leidt	l ɛ i̯ t
leie	l ɛ i̯ ə
leken	l eː k ə n
lekkage	l ɛ k aː ʒ ə
lelijk	l eː l ə k
lelystad	l eː l i s t ɑ t
lemma	l ɛ m aː
lenen	l eː n ə n
lengte	l ɛ ŋ t ə
lens	l ɛ n s
lentefeest	l ɛ n t ə f eː s t
leo	l eː oː
leopold	l eː oː p ɔ l t
leraar	l eː r aː r
leren	l eː r ə n
lesbienne	l ɛ s b i ɛ n ə
lesgeven	l ɛ s x eː v ə n
lessen	l ɛ s ə n
letten	l ɛ t ə n
letter	l ɛ t ə r
letterkundig	l ɛ t ə r k ʏ n d ə x
letterlijk	l ɛ t ə r l ə k
leudal	l øː d ɑ l
leugen	l øː ɣ ə n
leuk	l øː k
leusden	l øː s d ə n
leuven	l øː v ə n
leven	l eː v ə n
levendig	l eː v ə n d ə x
levensecht	l eː v ə n s ɛ x t
levensgeschiedenis	l eː v ə n s x ə s x i d ə n ɪ s
levensgevaar	l eː v ə n s x ə v aː r
levensgevaarlijk	l eː v ə n s x ə v aː r l ə k
levensvatbaar	l eː v ə n s f ɑ t b aː r
lever	l eː v ə r
leveren	l eː v ə r ə n
lexmond	l ɛ k s m ɔ n t
lezen	l eː z ə n
lezer	l eː z ə r
lezing	l eː z ɪ ŋ
lia	l i aː
libelle	l i b ɛ l ə
libië	l i b i j ə
lichaam	l ɪ x aː m
lichaamsbouw	l ɪ x aː m s b ɑ u̯
licht	l ɪ x t
lichten	l ɪ x t ə n
lichtgewicht	l ɪ x t x ə ʋ ɪ x t
lichtinval	l ɪ x t ɪ n v ɑ l
lichtsnelheid	l ɪ x t s n ɛ l ɦ ɛ i̯ t
lid	l ɪ t
lidstaat	l ɪ t s t aː t
lied	l i t
lief	l i f
liefde	l i f d ə
liefdesleven	l i f d ə s l eː v ə n
liefhebben	l i f ɦ ɛ b ə n
lieke	l i k ə
lier	l i r
lieslaars	l i s l aː r s
lift	l ɪ f t
lig	l ɪ x
ligfiets	l ɪ x f i t s
liggen	l ɪ ɣ ə n
ligt	l ɪ x t
ligweide	l ɪ x ʋ ɛ i̯ d ə
lijden	l ɛ i̯ d ə n
lijfspreuk	l ɛ i̯ f s p r øː k
lijk	l ɛ i̯ k
lijken	l ɛ i̯ k ə n
lijkfeest	l ɛ i̯ k f eː s t
lijkschouwing	l ɛ i̯ k s x ɑ u̯ ɪ ŋ
lijm	l ɛ i̯ m
lijmen	l ɛ i̯ m ə n
lijn	l ɛ i̯ n
lijnen	l ɛ i̯ n ə n
lijnzaad	l ɛ i̯ n z aː t
lijnzaadolie	l ɛ i̯ n z aː t oː l i
lijst	l ɛ i̯ s t
likken	l ɪ k ə n
limbo	l ɪ m b oː
limburg	l ɪ m b ʏ r x
limburger	l ɪ m b ʏ r ɣ ə r
limburgs	l ɪ m b ʏ r x s
limiet	l i m i t
limpido	l ɪ m p i d oː
linda	l ɪ n d aː
linde	l ɪ n d ə
lindeboom	l ɪ n d ə b oː m
link	l ɪ ŋ k
links	l ɪ ŋ k s
linnen	l ɪ n ə n
linschoten	l ɪ n s x oː t ə n
lint	l ɪ n t
lip	l ɪ p
lipide	l i p i d ə
lippenstift	l ɪ p ə n s t ɪ f t
lipstick	l ɪ p s t ɪ k
lisa	l i z aː
lissabon	l ɪ s aː b ɔ n
lisse	l ɪ s ə
list	l ɪ s t
listig	l ɪ s t ə x
liter	l i t ə r
literatuur	l i t ə r aː t y r
litteken	l ɪ t eː k ə n
liturgie	l i t ʏ r ɣ i
livestream	l ɑ i̯ v s t r iː m
living	l ɪ v ɪ ŋ
lochem	l ɔ x ə m
locomotief	l oː k oː m oː t i f
lodewijk	l oː d ə ʋ ɛ i̯ k
lof	l ɔ f
log	l ɔ x
logboek	l ɔ x b u k
logica	l oː ɣ i k aː
logisch	l oː ɣ i s
lokaal	l oː k aː l
loket	l oː k ɛ t
lol	l ɔ l
londen	l ɔ n d ə n
london	l ɔ n d ə n
lonen	l oː n ə n
long	l ɔ ŋ
longkanker	l ɔ ŋ k ɑ ŋ k ə r
loo	l oː
loochenen	l oː x ə n ə n
lood	l oː t
loods	l oː t s
loodsen	l oː t s ə n
loon	l oː n
loop	l oː p
loopafstand	l oː p ɑ f s t ɑ n t
loopbaan	l oː p b aː n
loopgraaf	l oː p x r aː f
loopjongen	l oː p j ɔ ŋ ə n
loopt	l oː p t
loos	l oː s
lopen	l oː p ə n
los	l ɔ s
loslaten	l ɔ s l aː t ə n
losser	l ɔ s ə r
lot	l ɔ t
loten	l oː t ə n
lotgenoot	l ɔ t x ə n oː t
lotharingen	l oː t aː r ɪ ŋ ə n
lotte	l ɔ t ə
lotus	l oː t ʏ s
louis	l u i
louter	l ɑ u̯ t ə r
loven	l oː v ə n
lover	l oː v ə r
loyaliteit	l oː j aː l i t ɛ i̯ t
lucas	l y k ɑ s
lucht	l ʏ x t
luchten	l ʏ x t ə n
luchtfilter	l ʏ x t f ɪ l t ə r
luchtmacht	l ʏ x t m ɑ x t
luchtruim	l ʏ x t r œ y̯ m
luchtvochtigheid	l ʏ x t v ɔ x t ə x ɦ ɛ i̯ t
luchtweerstand	l ʏ x t ʋ eː r s t ɑ n t
lucifer	l y s i f ɛ r
luid	l œ y̯ t
luide	l œ y̯ d ə
luiden	l œ y̯ d ə n
luier	l œ y̯ ə r
luis	l œ y̯ s
luister	l œ y̯ s t ə r
luisteraar	l œ y̯ s t ə r aː r
luisterboek	l œ y̯ s t ə r b u k
luisteren	l œ y̯ s t ə r ə n
luitenant	l œ y̯ t ə n ɑ n t
lullen	l ʏ l ə n
lunch	l ʏ n ʃ
lunchen	l ʏ n ʃ ə n
lutherse	l y t ə r s ə
luuk	l y k
luxemburg	l y k s ə m b ʏ r x
maag	m aː x
maagd	m aː x t
maaien	m aː i̯ ə n
maaike	m aː i̯ k ə
maak	m aː k
maakt	m aː k t
maakte	m aː k t ə
maakten	m aː k t ə n
maal	m aː l
maaltijden	m aː l t ɛ i̯ d ə n
maand	m aː n t
maandag	m aː n d ɑ x
maandblad	m aː n t b l ɑ t
maandelijks	m aː n d ə l ə k s
maanden	m aː n d ə n
maarn	m aː r n
maarschalk	m aː r s x ɑ l k
maart	m aː r t
maarten	m aː r t ə n
maas	m aː s
maastricht	m aː s t r ɪ x t
maat	m aː t
maatregel	m aː t r eː ɣ ə l
maatschappij	m aː t s x ɑ p ɛ i̯
maatschappijleer	m aː t s x ɑ p ɛ i̯ l eː r
maatstaf	m aː t s t ɑ f
macedonië	m ɑ s ə d oː n i j ə
machinaal	m aː ʃ i n aː l
machine	m ɑ ʃ i n ə
machines	m ɑ ʃ i n ə s
macho	m ɑ t ʃ oː
machteloos	m ɑ x t ə l oː s
machteloosheid	m ɑ x t ə l oː s ɦ ɛ i̯ t
machtiging	m ɑ x t ə ɣ ɪ ŋ
machtsovername	m ɑ x t s oː v ə r n aː m ə
machtsstrijd	m ɑ x t s t r ɛ i̯ t
machtsvacuüm	m ɑ x t s v aː k y ʏ m
made	m aː d ə
maf	m ɑ f
mag	m ɑ x
mager	m aː ɣ ə r
magie	m aː ɣ i
magisch	m aː ɣ i s
magnolia	m ɑ x n oː l i aː
mailen	m eː l ə n
majoor	m aː j oː r
mak	m ɑ k
make	m aː k ə
makelij	m aː k ə l ɛ i̯
maken	m aː k ə n
makkelijk	m ɑ k ə l ə k
mal	m ɑ l
malen	m aː l ə n
mallemolen	m ɑ l ə m oː l ə n
malware	m ɑ l ʋ ɛː r
mama	m ɑ m aː
mammoet	m ɑ m u t
mand	m ɑ n t
mango	m ɑ ŋ ɡ oː
manieren	m ɑ n iː r ə n
manja	m ɑ n j aː
mankeren	m ɑ ŋ k eː r ə n
mannelijk	m ɑ n ə l ə k
mannen	m ɑ n ə n
mannetje	m ɑ n ə t j ə
manon	m aː n ɔ n
mantel	m ɑ n t ə l
mantelzorg	m ɑ n t ə l z ɔ r x
mantelzorger	m ɑ n t ə l z ɔ r ɣ ə r
manuscript	m aː n y s k r ɪ p t
map	m ɑ p
margarine	m ɑ r ɣ aː r i n ə
maria	m aː r i j aː
marieke	m aː r i k ə
marien	m aː r i n
marijke	m aː r ɛ i̯ k ə
marijnissen	m aː r ɛ i̯ n ɪ s ə n
marina	m aː r i n aː
marinade	m aː r i n aː d ə
marine	m aː r i n ə
marionet	m aː r i oː n ɛ t
maris	m aː r ɪ s
marja	m ɑ r j aː
mark	m ɑ r k
markgraaf	m ɑ r k x r aː f
markt	m ɑ r k t
marktconform	m ɑ r k t k ɔ n f ɔ r m
marktdenken	m ɑ r k t d ɛ ŋ k ə n
markteconomie	m ɑ r k t eː k oː n oː m i
marktleider	m ɑ r k t l ɛ i̯ d ə r
marktplaats	m ɑ r k t p l aː t s
marktplein	m ɑ r k t p l ɛ i̯ n
marktwerking	m ɑ r k t ʋ ɛ r k ɪ ŋ
marmer	m ɑ r m ə r
marokko	m aː r ɔ k oː
mars	m ɑ r s
martelen	m ɑ r t ə l ə n
martens	m ɑ r t ə n s
marter	m ɑ r t ə r
martijn	m ɑ r t ɛ i̯ n
martyrium	m ɑ r t iː r i ʏ m
masker	m ɑ s k ə r
massage	m ɑ s aː ʒ ə
masseur	m ɑ s øː r
massief	m ɑ s i f
mast	m ɑ s t
materialisme	m aː t eː r i aː l ɪ s m ə
matkop	m ɑ t k ɔ p
matthijs	m ɑ t ɛ i̯ s
maurits	m ɑ u̯ r ɪ t s
mausoleum	m ɑ u̯ z oː l eː ʏ m
mavo	m aː v oː
max	m ɑ k s
maximum	m ɑ k s i m ʏ m
maya	m aː j aː
mazzel	m ɑ z ə l
maïzena	m ɑ i z eː n aː
me	m ə
mechanica	m eː x aː n i k aː
mechelen	m ɛ x ə l ə n
mededogen	m eː d ə d oː ɣ ə n
medeplichtig	m eː d ə p l ɪ x t ə x
medeplichtigheid	m eː d ə p l ɪ x t ə x ɦ ɛ i̯ t
medeschuldig	m eː d ə s x ʏ l d ə x
medezeggenschap	m eː d ə z ɛ ɣ ə n s x ɑ p
medezeggenschapsraad	m eː d ə z ɛ ɣ ə n s x ɑ p s r aː t
mediatheek	m eː d i aː t eː k
medicatie	m eː d i k aː t s i
medicijn	m eː d i s ɛ i̯ n
mee	m eː
meedenken	m eː d ɛ ŋ k ə n
meedingen	m eː d ɪ ŋ ə n
meegenomen	m eː ɣ ə n oː m ə n
meehelpen	m eː ɦ ɛ l p ə n
meel	m eː l
meelopen	m eː l oː p ə n
meent	m eː n t
meer	m eː r
meerderheid	m eː r d ə r ɦ ɛ i̯ t
meerderheidsbelang	m eː r d ə r ɦ ɛ i̯ t s b ə l ɑ ŋ
meerjarenbegroting	m eː r j aː r ə n b ə ɣ r oː t ɪ ŋ
meerjarig	m eː r j aː r ə x
meerpolder	m eː r p ɔ l d ə r
meerssen	m eː r s ə n
meertaligheid	m eː r t aː l ə x ɦ ɛ i̯ t
meervoud	m eː r v ɑ u̯ t
meerwaarde	m eː r ʋ aː r d ə
meestal	m eː s t ɑ l
meesten	m eː s t ə n
meester	m eː s t ə r
meet	m eː t
meetinstrument	m eː t ɪ n s t r y m ɛ n t
meetsysteem	m eː t s i s t eː m
meeuw	m eː u̯
mei	m ɛ i̯
meid	m ɛ i̯ t
meijer	m ɛ i̯ ə r
meikever	m ɛ i̯ k eː v ə r
meisje	m ɛ i̯ ʃ ə
meisjes	m ɛ i̯ s j ə s
melden	m ɛ l d ə n
melding	m ɛ l d ɪ ŋ
melk	m ɛ l k
melken	m ɛ l k ə n
melkweg	m ɛ l k ʋ ɛ x
memorandum	m eː m oː r ɑ n d ʏ m
menen	m eː n ə n
mengpaneel	m ɛ ŋ p aː n eː l
mening	m eː n ɪ ŋ
meningsuiting	m eː n ɪ ŋ s œ y̯ t ɪ ŋ
menno	m ɛ n oː
mens	m ɛ n s
mensachtige	m ɛ n s ɑ x t ə ɣ ə
menselijkheid	m ɛ n s ə l ə k ɦ ɛ i̯ t
mensen	m ɛ n s ə n
mensenmassa	m ɛ n s ə n m ɑ s aː
mensenrechtenschending	m ɛ n s ə n r ɛ x t ə n s x ɛ n d ɪ ŋ
mensensmokkel	m ɛ n s ə n s m ɔ k ə l
mentaliteit	m ɛ n t aː l i t ɛ i t
menu	m ə n y
meppel	m ɛ p ə l
meppen	m ɛ p ə n
mercurius	m ɛ r k yː r i ʏ s
merel	m eː r ə l
meren	m eː r ə n
merkkleding	m ɛ r k l eː d ɪ ŋ
merrie	m ɛ r i
mes	m ɛ s
mesdjid	m ɛ s d ʒ i t
messias	m ɛ s i ɑ s
messing	m ɛ s ɪ ŋ
mest	m ɛ s t
metaal	m eː t aː l
metaaldetector	m eː t aː l d eː t ɛ k t ɔ r
metadata	m eː t aː d aː t aː
metal	m ɛ t ə l
meten	m eː t ə n
meter	m eː t ə r
metro	m eː t r oː
metropool	m eː t r oː p oː l
metselen	m ɛ t s ə l ə n
meubel	m øː b ə l
mevrouw	m ə v r ɑ u̯
meyer	m ɛ i̯ ə r
mezelf	m ə z ɛ l f
mia	m i aː
michel	m i ʃ ə l
michiel	m ɪ x i l
middag	m ɪ d ɑ x
middagmaal	m ɪ d ɑ x m aː l
middaguur	m ɪ d ɑ x yː r
middel	m ɪ d ə l
middelburg	m ɪ d ə l b ʏ r x
middeleeuwen	m ɪ d ə l eː u̯ ə n
middeleeuws	m ɪ d ə l eː u̯ s
middelen	m ɪ d ə l ə n
middelvinger	m ɪ d ə l v ɪ ŋ ə r
middenin	m ɪ d ə n ɪ n
middenmoot	m ɪ d ə n m oː t
middenstand	m ɪ d ə n s t ɑ n t
middenstip	m ɪ d ə n s t ɪ p
middenvelder	m ɪ d ə n v ɛ l t
middernacht	m ɪ d ə r n ɑ x t
mie	m i
mietje	m i t j ə
migrant	m i ɣ r ɑ n t
mij	m ɛ i̯
mijlpaal	m ɛ i̯ l p aː l
mijne	m ɛ i̯ n ə
mijnen	m ɛ i̯ n ə n
mijnheer	m ə n eː r
mijns	m ɛ i̯ n s
mijnwet	m ɛ i̯ n ʋ ɛ t
milieu	m ɪ l j øː
milieubelasting	m ɪ l j øː b ə l ɑ s t ɪ ŋ
militair	m i l i t ɛː r
militaristisch	m i l i t aː r ɪ s t i ʃ
miljard	m ɪ l j ɑ r t
miljoen	m ɪ l j u n
miljonair	m ɪ l j oː n ɛ r
millennium	m i l ɛ n i ʏ m
milliliter	m i l i l i t ə r
min	m ɪ n
minderwaardig	m ɪ n d ə r ʋ aː r d ə x
miniem	m iː n iː m
minimum	m i n i m ʏ m
minister	m i n ɪ s t ə r
minnen	m ɪ n ə n
minuut	m i n y t
miranda	m i r ɑ n d aː
mirjam	m ɪ r j ɑ m
mis	m ɪ s
misbruik	m ɪ s b r œ y̯ k
misbruiken	m ɪ s b r œ y̯ k ə n
miscommunicatie	m ɪ s k ɔ m y n i k aː t s i
misdaad	m ɪ s d aː t
misdadig	m ɪ s d aː d ə x
misdragen	m ɪ s d r aː ɣ ə n
mishandelen	m ɪ s ɦ ɑ n d ə l ə n
mislukken	m ɪ s l ʏ k ə n
miss	m ɪ s
misselijk	m ɪ s ə l ə k
misselijkheid	m ɪ s ə l ə k ɦ ɛ i̯ t
missen	m ɪ s ə n
missie	m ɪ s i
mist	m ɪ s t
mitella	m i t ɛ l aː
mits	m ɪ t s
mitsgaders	m ɪ t s x aː d ə r s
mixer	m ɪ k s ə r
mobiel	m oː b i l
mobieltje	m oː b i l t j ə
mobiliseren	m oː b i l i z eː r ə n
mode	m oː d ə
model	m oː d ɛ l
modelbouwer	m oː d ɛ l b ɑ u̯ ə r
modern	m oː d ɛ r n
modieus	m oː d i øː s
moe	m u
moedeloos	m u d ə l oː s
moeder	m u d ə r
moederdag	m u d ə r d ɑ x
moeheid	m u ɦ ɛ i̯ t
moeite	m u i̯ t ə
moeiteloos	m u i̯ t ə l oː s
moeras	m u r ɑ s
moet	m u t
moeten	m u t ə n
mogelijk	m oː ɣ ə l ə k
mogelijkheid	m oː ɣ ə l ə k ɦ ɛ i̯ t
mogen	m oː ɣ ə n
mohammed	m oː ɦ ɑ m ɛ t
moker	m oː k ə r
moleculair	m oː l ə k y l ɛː r
molecuul	m oː l ə k y l
molen	m oː l ə n
molenaar	m oː l ə n aː r
mollen	m ɔ l ə n
moment	m oː m ɛ n t
mond	m ɔ n t
monddood	m ɔ n d oː t
mondiaal	m ɔ n d i aː l
monding	m ɔ n d ɪ ŋ
monitor	m oː n i t ɔ r
monnik	m ɔ n ɪ k
monoplan	m oː n oː p l ɑ n
monopolie	m oː n oː p oː l i
monotoon	m oː n oː t oː n
monster	m ɔ n s t ə r
monument	m oː n y m ɛ n t
mooi	m oː i̯
mooier	m oː j ə r
mooist	m oː i̯ s t
moord	m oː r t
moorden	m oː r d ə n
moordenaar	m oː r d ə n aː r
moordkuil	m oː r t k œ y̯ l
mooren	m oː r ə n
mop	m ɔ p
moraal	m oː r aː l
moreel	m oː r eː l
morgen	m ɔ r ɣ ə n
mortier	m ɔ r t iː r
moskee	m ɔ s k eː
moskou	m ɔ s k ɑ u̯
moslim	m ɔ s l ɪ m
mossel	m ɔ s ə l
most	m ɔ s t
mosterd	m ɔ s t ə r t
mot	m ɔ t
motie	m oː t s i
motief	m oː t i f
motormuis	m oː t ɔ r m œ y̯ s
motorrijder	m oː t ɔ r r ɛ i̯ d ə r
motten	m ɔ t ə n
mout	m ɑ u̯ t
mozaïek	m oː z aː i k
mudjevol	m ʏ t j ə v ɔ l
mug	m ʏ x
muggenzifter	m ʏ ɣ ə n z ɪ f t ə r
muiden	m œ y̯ d ə n
muis	m œ y̯ s
mulder	m ʏ l d ə r
multiculti	m ʏ l t i k ʏ l t i
multicultureel	m ʏ l t i k ʏ l t y r eː l
multimiljonair	m ʏ l t i m ɪ l j oː n ɛː r
multinational	m ʏ l t i n ɛ ʃ ə n ə l
municipaliteit	m y n i s i p aː l i t ɛ i̯ t
munt	m ʏ n t
munten	m ʏ n t ə n
muntstuk	m ʏ n t s t ʏ k
museum	m y z eː ʏ m
muskusrat	m ʏ s k ʏ s r ɑ t
must	m ʏ s t
mutant	m y t ɑ n t
muts	m ʏ t s
muziek	m y z i k
muziekschool	m y z i k s x oː l
muzikant	m y z i k ɑ n t
mystiek	m ɪ s t i k
mythologie	m i t oː l oː ɣ i
na	n aː
naakt	n aː k t
naaktstrand	n aː k t s t r ɑ n t
naald	n aː l t
naam	n aː m
naambord	n aː m b ɔ r t
naar	n aː r
naargelang	n aː r ɣ ə l ɑ ŋ
nacht	n ɑ x t
nachtmerrie	n ɑ x t m ɛ r i
nader	n aː d ə r
naderen	n aː d ə r ə n
nadruk	n aː d r ʏ k
nagel	n aː ɣ ə l
nagellak	n aː ɣ ə l l ɑ k
nagerecht	n aː ɣ ə r ɛ x t
najaar	n aː j aː r
nakijken	n aː k ɛ i̯ k ə n
nalatenschap	n aː l aː t ə n s x ɑ p
namaken	n aː m aː k ə n
namiddag	n aː m ɪ d ɑ x
naomi	n aː oː m i
nap	n ɑ p
nasmaak	n aː s m aː k
natasja	n aː t ɑ ʃ aː
natiestaat	n aː t s i s t aː t
nationaal	n aː t ʃ oː n aː l
natrium	n aː t r i ʏ m
natuur	n aː t y r
natuurgeweld	n aː t yː r ɣ ə ʋ ɛ l t
natuurijs	n aː t y r ɛ i s
natuurkunde	n aː t y r k ʏ n d ə
natuurlijk	n aː t y r l ə k
natuursteen	n aː t yː r s t eː n
nauwelijks	n ɑ u̯ ə l ə k s
nauwkeurig	n ɑ u̯ k øː r ə x
navo	n aː v oː
navolging	n aː v ɔ l ɣ ɪ ŋ
nazaat	n aː z aː t
nazorg	n aː z ɔ r x
necrose	n eː k r oː z ə
neder	n eː d ə r
nederland	n eː d ə r l ɑ n t
nederlanden	n eː d ə r l ɑ n d ə n
nederlands	n eː d ə r l ɑ n t s
nederlandse	n eː d ə r l ɑ n t s ə
nederlandstalig	n eː d ə r l ɑ n t s t aː l ə x
nederweert	n eː d ə r ʋ eː r t
nederzetting	n eː d ə r z ɛ t ɪ ŋ
nee	n eː
neen	n eː n
neerslachtig	n eː r s l ɑ x t ə x
neerslag	n eː r s l ɑ x
negatief	n eː x aː t i f
negende	n eː ɣ ə n d ə
negenhonderd	n eː ɣ ə n ɦ ɔ n d ə r t
negentiende	n eː ɣ ə n t i n d ə
negentig	n eː ɣ ə n t ə x
nep	n ɛ p
neptunus	n ɛ p t y n ʏ s
nergens	n ɛ r ɣ ə n s
nest	n ɛ s t
net	n ɛ t
netjes	n ɛ t j ə s
netwerk	n ɛ t ʋ ɛ r k
neuk	n øː k
neuken	n øː k ə n
neurochirurg	n øː r oː ʃ i r ʏ r x
neutraliseren	n øː t r aː l i z eː r ə n
nevel	n eː v ə l
nicht	n ɪ x t
nicodemus	n i k oː d eː m ʏ s
niels	n i l s
niemand	n i m ɑ n t
nier	n i r
nietwaar	n i t ʋ aː r
nieuwbouw	n i u̯ b ɑ u̯
nieuwbouwhuis	n i u̯ b ɑ u̯ ɦ œ y̯ s
nieuwegein	n i u̯ ə ɣ ɛ i̯ n
nieuwkomer	n i u̯ k oː m ə r
nieuws	n i u̯ s
nieuwsgierig	n i u̯ s x iː r ə x
nieuwsgierigheid	n i u̯ s x iː r ə x ɦ ɛ i̯ t
nijd	n ɛ i̯ t
nijl	n ɛ i̯ l
nijlpaard	n ɛ i̯ l p aː r t
nijmegen	n ɛ i̯ m eː ɣ ə n
nijverdal	n ɛ i̯ v ə r d ɑ l
niks	n ɪ k s
nimmer	n ɪ m ə r
nis	n ɪ s
niveau	n i v oː
noach	n oː ɑ x
nodebeek	n oː d ə b eː k
nodig	n oː d ə x
noemen	n u m ə n
noemer	n u m ə r
nog	n ɔ x
nogal	n ɔ ɣ ɑ l
nogmaals	n ɔ x m aː l s
nok	n ɔ k
nominatie	n oː m i n aː t s i
nood	n oː t
noodlottig	n oː t l ɔ t ə x
noodweer	n oː t ʋ eː r
noodzaak	n oː t s aː k
nooit	n oː i t
noord	n oː r t
noorden	n oː r d ə n
noordwaarts	n oː r t ʋ aː r t s
noordzee	n oː r t s eː
noot	n oː t
nor	n ɔ r
nora	n oː r aː
normaal	n ɔ r m aː l
notarieel	n oː t aː r i eː l
nou	n ɑ u̯
nova	n oː v aː
novelle	n oː v ɛ l ə
novum	n oː v ʏ m
nozem	n oː z ə m
nu	n y
nuance	n y ɑ n s ə
nuancering	n y ɑ n s eː r ɪ ŋ
nucleair	n y k l eː ɛː r
nudorp	n y d ɔ r p
nummer	n ʏ m ə r
nuntius	n ʏ n t s i ʏ s
nut	n ʏ t
nutsman	n ʏ t s m ɑ n
ober	oː b ə r
obesitas	oː b eː s i t ɑ s
obstakel	ɔ p s t aː k ə l
oceaan	oː s eː j aː n
och	ɔ x
oculair	oː k y l ɛː r
ode	oː d ə
oefenen	u f ə n ə n
oefent	u f ə n t
oekaze	u k aː z ə
oekraïne	u k r aː i n ə
oeps	u p s
oercontinent	uː r k ɔ n t i n ɛ n t
oester	u s t ə r
oesters	u s t ə r s
oezbekistan	u z b eː k i s t ɑ n
of	ɔ f
offensief	ɔ f ɛ n s i f
offer	ɔ f ə r
ofschoon	ɔ f s x oː n
ofte	ɔ f t ə
ogen	oː ɣ ə n
ogenblik	oː ɣ ə n b l ɪ k
oirschot	oː r s x ɔ t
oisterwijk	oː s t ə r ʋ ɛ i k
ok	oː k aː
oke	ɔ k e ɪ̯
oldenzaal	ɔ l d ə n z aː l
olie	oː l i
olielamp	oː l i l ɑ m p
olietanker	oː l i t ɛ ŋ k ə r
oliewinning	oː l i ʋ ɪ n ɪ ŋ
olifant	oː l i f ɑ n t
olifantenpad	oː l i f ɑ n t ə n p ɑ t
olijf	oː l ɛ i̯ f
olijfolie	oː l ɛ i̯ f oː l iː
ollie	ɔ l i
om	ɔ m
oma	oː m aː
omarmen	ɔ m ɑ r m ə n
ombouwen	ɔ m b ɑ u̯ ə n
ombudsman	ɔ m b ʏ t s m ɑ n
omdat	ɔ m d ɑ t
omelet	oː m ə l ɛ t
omgang	ɔ m ɣ ɑ ŋ
omgeven	ɔ m ɣ eː v ə n
omgeving	ɔ m ɣ eː v ɪ ŋ
omhakken	ɔ m ɦ ɑ k ə n
omhelzing	ɔ m ɦ ɛ l z ɪ ŋ
omkleden	ɔ m k l eː d ə n
omkoping	ɔ m k oː p ɪ ŋ
omleiding	ɔ m l ɛ i d ɪ ŋ
ommen	ɔ m ə n
ommetje	ɔ m ə t j ə
omschreven	ɔ m s x r eː v ə n
omschrijven	ɔ m s x r ɛ i v ə n
omsingelen	ɔ m s ɪ ŋ ə l ə n
omslag	ɔ m s l ɑ x
omstandigheid	ɔ m s t ɑ n d ə x ɦ ɛ i̯ t
omvang	ɔ m v ɑ ŋ
omvat	ɔ m v ɑ t
omvatten	ɔ m v ɑ t ə n
omzet	ɔ m z ɛ t
onafhankelijk	ɔ n ɑ f ɦ ɑ ŋ k ə l ə k
onbegrensd	ɔ n b ə ɣ r ɛ n s t
onbegrijpelijk	ɔ m b ə ɣ r ɛ i̯ p ə l ə k
onbelangrijk	ɔ m b ə l ɑ ŋ r ɛ i̯ k
onbenul	ɔ n b ə n ʏ l
onbereikbaar	ɔ n b ə r ɛ i̯ k b aː r
onbestaanbaar	ɔ m b ə s t aː n b aː r
onbuigzaam	ɔ n b œ y̯ x s aː m
onder	ɔ n d ə r
onderbreken	ɔ n d ə r b r eː k ə n
onderdompelen	ɔ n d ə r d ɔ m p ə l ə n
onderdrukken	ɔ n d ə r d r ʏ k ə n
ondergaan	ɔ n d ə r ɣ aː n
ondergeschikt	ɔ n d ə r ɣ ə s x ɪ k t
ondergeschikte	ɔ n d ə r ɣ ə s x ɪ k t ə
ondergoed	ɔ n d ə r ɣ uː t
ondergrens	ɔ n d ə r ɣ r ɛ n s
onderhandelen	ɔ n d ə r ɦ ɑ n d ə l ə n
ondermijnen	ɔ n d ə r m ɛ i̯ n ə n
onderonsje	ɔ n d ə r ɔ n ʃ ə
onderricht	ɔ n d ə r r ɪ x t
onderscheid	ɔ n d ə r s x ɛ i̯ t
onderscheiden	ɔ n d ə r s x ɛ i̯ d ə n
onderscheiding	ɔ n d ə r s x ɛ i̯ d ɪ ŋ
onderscheidt	ɔ n d ə r s x ɛ i̯ t
onderscheppen	ɔ n d ə r s x ɛ p ə n
onderschrijven	ɔ n d ə r s x r ɛ i̯ v ə n
ondersoort	ɔ n d ə r s oː r t
onderstaand	ɔ n d ə r s t aː n t
onderstaande	ɔ n d ə r s t aː n d ə
onderstel	ɔ n d ə r s t ɛ l
onderstellen	ɔ n d ə r s t ɛ l ə n
ondersteunen	ɔ n d ə r s t øː n ə n
onderstrepen	ɔ n d ə r s t r eː p ə n
ondertekenen	ɔ n d ə r t eː k ə n ə n
ondervangen	ɔ n d ə r v ɑ ŋ ə n
ondervinden	ɔ n d ə r v ɪ n d ə n
ondervragen	ɔ n d ə r v r aː ɣ ə n
onderwereld	ɔ n d ə r ʋ eː r ə l t
onderwerpen	ɔ n d ə r ʋ ɛ r p ə n
onderwijs	ɔ n d ə r ʋ ɛ i̯ s
onderwijzer	ɔ n d ə r ʋ ɛ i̯ z ə r
onderzoek	ɔ n d ə r z u k
onderzoeken	ɔ n d ə r z u k ə n
onderzoeker	ɔ n d ə r z u k ə r
onderzoeksmethode	ɔ n d ə r z u k s m eː t oː d ə
onderzoeksstation	ɔ n d ə r z u k s t aː ʃ ɔ n
onderzoeksvraag	ɔ n d ə r z u k s f r aː x
ondeugdelijk	ɔ n d øː x d ə l ə k
onduidelijk	ɔ n d œ y̯ d ə l ə k
ongedierte	ɔ n ɣ ə d iː r t ə
ongehoorzaam	ɔ n ɣ ə ɦ ɔː r z aː m
ongehuwd	ɔ ŋ ɣ ə ɦ y u̯ t
ongeloofwaardig	ɔ n ɣ ə l oː f ʋ aː r d ə x
ongeluk	ɔ ŋ ɣ ə l ʏ k
ongeval	ɔ n ɣ ə v ɑ l
ongewassen	ɔ ŋ ɣ ə ʋ ɑ s ə n
ongrondwettelijk	ɔ n ɣ r ɔ n t ʋ ɛ t ə l ə k
onheil	ɔ n ɦ ɛ i̯ l
onheus	ɔ n ɦ øː s
onhoudbaar	ɔ n ɦ ɑ u̯ t b aː r
online	ɔ n l ɑ i̯ n
onlogisch	ɔ n l oː ɣ i s
onmiddellijk	ɔ n m ɪ d ə l ə k
onmogelijk	ɔ n m oː ɣ ə l ə k
onno	ɔ n oː
onnodig	ɔ n oː d ə x
onnozel	ɔ n oː z ə l
onopvallend	ɔ n ɔ p f ɑ l ə n t
onpartijdig	ɔ m p ɑ r t ɛ i̯ d ə x
onrust	ɔ n r ʏ s t
ons	ɔ n s
ontaarden	ɔ n t aː r d ə n
ontberingen	ɔ n t b eː r ɪ ŋ ə n
ontbinden	ɔ n t b ɪ n d ə n
ontbranden	ɔ n t b r ɑ n d ə n
ontbreken	ɔ n t b r eː k ə n
ontdekken	ɔ n d ɛ k ə n
ontdekkingsreiziger	ɔ n d ɛ k ɪ ŋ s r ɛ i̯ z ə ɣ ə r
ontdooien	ɔ n t d oː i̯ ə n
onteigenen	ɔ n t ɛ i̯ ɣ ə n ə n
onterecht	ɔ n t ə r ɛ x t
ontgelden	ɔ n t ɣ ɛ l d ə n
ontgroening	ɔ n t x r u n ɪ ŋ
onthoofd	ɔ n t ɦ oː f t
onthoofden	ɔ n t ɦ oː f d ə n
onthouden	ɔ n t ɦ ɑ u̯ d ə n
onthullen	ɔ n t ɦ ʏ l ə n
ontkennen	ɔ n t k ɛ n ə n
ontkenning	ɔ n t k ɛ n ɪ ŋ
ontkenningsfase	ɔ n t k ɛ n ɪ ŋ f aː z ə
ontketenen	ɔ n t k eː t ə n ə n
ontkomen	ɔ n t k oː m ə n
ontladen	ɔ n t l aː d ə n
ontlasten	ɔ n t l ɑ s t ə n
ontleden	ɔ n t l eː d ə n
ontlenen	ɔ n t l eː n ə n
ontluchten	ɔ n t l ʏ x t ə n
ontnemen	ɔ n t n eː m ə n
ontploffen	ɔ n t p l ɔ f ə n
ontploffing	ɔ n t p l ɔ f ɪ ŋ
ontplooien	ɔ n t p l oː i̯ ə n
ontpoppen	ɔ n t p ɔ p ə n
ontraden	ɔ n t r aː d ə n
ontrijzen	ɔ n t r ɛ i z ə n
ontroeren	ɔ n t r u r ə n
ontruimen	ɔ n t r œ y̯ m ə n
ontslaan	ɔ n t s l aː n
ontslagrecht	ɔ n t s l ɑ x r ɛ x t
ontsluiten	ɔ n t s l œ y̯ t ə n
ontspannen	ɔ n t s p ɑ n ə n
ontsteken	ɔ n t s t eː k ə n
ontsteking	ɔ n t s t eː k ɪ ŋ
ontstijgen	ɔ n t s t ɛ i̯ ɣ ə n
onttrekken	ɔ n t t r ɛ k ə n
ontucht	ɔ n t ʏ x t
ontvang	ɔ n t f ɑ ŋ
ontvangen	ɔ n t f ɑ ŋ ə n
ontvanger	ɔ n t f ɑ ŋ ə r
ontvluchten	ɔ n t v l ʏ x t ə n
ontvoeren	ɔ n t f u r ə n
ontvouwen	ɔ n t v ɑ u̯ ə n
ontwaken	ɔ n t ʋ aː k ə n
ontwaren	ɔ n t ʋ aː r ə n
ontwerpen	ɔ n t ʋ ɛ r p ə n
ontwikkelen	ɔ n t ʋ ɪ k ə l ə n
ontwikkeling	ɔ n t ʋ ɪ k ə l ɪ ŋ
ontwikkelingsland	ɔ n t ʋ ɪ k ə l ɪ ŋ s l ɑ n t
ontwrichten	ɔ n t v r ɪ x t ə n
ontzeggen	ɔ n t z ɛ ɣ ə n
onverschilligheid	ɔ n v ə r s x ɪ l ə x ɦ ɛ i t
onwaardig	ɔ n ʋ aː r d ə x
onweer	ɔ n ʋ eː r
onwel	ɔ n ʋ ɛ l
onwennig	ɔ n ʋ ɛ n ə x
onwetend	ɔ n ʋ eː t ə n t
onze	ɔ n z ə
onzichtbaarheid	ɔ n z ɪ x t b aː r ɦ ɛ i̯ t
oog	oː x
ooggetuige	oː x ə t œ y̯ ɣ ə
oogheelkundig	oː x ɦ eː l k ʏ n d ə x
ooglid	oː x l ɪ t
oogst	oː x s t
ooievaar	oː i̯ ə v aː r
ooit	oː i̯ t
ook	oː k
oom	oː m
oor	oː r
oorbeek	oː r b eː k
oord	oː r t
oordeel	oː r d eː l
oorlog	oː r l ɔ x
oorlogsgeweld	oː r l ɔ x s x ə ʋ ɛ l t
oorlogsschip	oː r l ɔ x s x ɪ p
oormerken	oː r m ɛ r k ə n
oorsprong	oː r s p r ɔ ŋ
oosten	oː s t ə n
oostenrijk	oː s t ə n r ɛ i̯ k
oosterbuur	oː s t ə r b yː r
oosterhof	oː s t ə r ɦ ɔ f
oostwaarts	oː s t ʋ aː r t s
oostzee	oː s t s eː
op	ɔ p
opbellen	ɔ b ɛ l ə n
opbouw	ɔ p b ɑ u̯
opbouwen	ɔ p b ɑ u̯ ə n
opbrengst	ɔ p b r ɛ ŋ s t
opdagen	ɔ p d aː ɣ ə n
opdracht	ɔ p d r ɑ x t
opdrachtgever	ɔ p d r ɑ x t x eː v ə r
opdrinken	ɔ p d r i ŋ k ə n
open	oː p ə n
openbreken	oː p ə n b r eː k ə n
opening	oː p ə n ɪ ŋ
opera	oː p ə r aː
operatie	oː p ə r aː t s i
operette	oː p ə r ɛ t ə
opeten	ɔ p eː t ə n
opgaan	ɔ p x aː n
opgeruimd	ɔ p x ə r œ y̯ m t
opgeven	ɔ p x eː v ə n
opgewonden	ɔ p x ə ʋ ɔ n d ə n
opgraven	ɔ p x r aː v ə n
opgraving	ɔ p x r aː v ɪ ŋ
ophangen	ɔ p ɦ ɑ ŋ ə n
ophouden	ɔ p ɦ ʌ u̯ d ə n
opinie	oː p i n i
opknappen	ɔ p k n ɑ p ə n
opkomen	ɔ p k oː m ə n
oploop	ɔ p l oː p
oplossen	ɔ p l ɔ s ə n
opmaken	ɔ p m aː k ə n
opmars	ɔ p m ɑ r s
opnemen	ɔ p n eː m ə n
opnieuw	ɔ p n i u̯
opperbevelhebber	ɔ p ə r b ə v ɛ l ɦ ɛ b ə r
oppervlakte	ɔ p ə r v l ɑ k t ə
oppervlaktewater	ɔ p ə r v l ɑ k t ə ʋ aː t ə r
oppositie	ɔ p oː z i t s i
opruimen	ɔ p r œ y̯ m ə n
opstaan	ɔ p s t aː n
opstand	ɔ p s t ɑ n t
opstel	ɔ p s t ɛ l
opstijgen	ɔ p s t ɛ i̯ ɣ ə n
optie	ɔ p s i
optimaal	ɔ p t i m aː l
optimalisatie	ɔ p t i m aː l i z aː t s i
optrekken	ɔ p t r ɛ k ə n
opvang	ɔ p f ɑ ŋ
opvijzelen	ɔ p f ɛ i̯ z ɛ l ɛ n
opwarmen	ɔ p ʋ ɑ r m ə n
opzetten	ɔ p z ɛ t ə n
orakel	oː r aː k ə l
oranje	oː r ɑ n j ə
oratorium	oː r aː t oː r i ʏ m
orchidee	ɔ r x i d eː
orde	ɔ r d ə
order	ɔ r d ə r
ordner	ɔ r t n ə r
oregano	oː r eː ɣ aː n oː
orgaan	ɔ r ɣ aː n
organisatie	ɔ r ɣ aː n i s aː t s i
orgasme	ɔ r ɣ ɑ s m ə
orgel	ɔ r ɣ ə l
orkaan	ɔ r k aː n
orkaanseizoen	ɔ r k aː n s ɛ i̯ z u n
orkest	ɔ r k ɛ s t
orthodox	ɔ r t oː d ɔ k s
os	ɔ s
oss	ɔ s
osteoporose	ɔ s t eː oː p oː r oː z ə
ouderschap	ɑ u̯ d ə r s x ɑ p
oudtante	ɑ u̯ t ɑ n t ə
ouwe	ɑ u̯ ə
ovaal	oː v aː l
ovatie	oː v aː t s i
oven	oː v ə n
over	oː v ə r
overal	oː v ə r ɑ l
overbieden	oː v ə r b i d ə n
overblijfsel	oː v ə r b l ɛ i̯ f s ə l
overblijven	oː v ə r b l ɛ i̯ v ə n
overdag	oː v ə r d ɑ x
overdenken	oː v ə r d ɛ ŋ k ə n
overdoen	oː v ə r d u n
overeenkomst	oː v ə r eː n k ɔ m s t
overgang	oː v ə r ɣ ɑ ŋ
overgewicht	oː v ə r ɣ ə ʋ ɪ x t
overhalen	oː v ə r ɦ aː l ə n
overheidsgeld	oː v ə r ɦ ɛ i̯ t s x ɛ l t
overig	oː v ə r ə x
overijssel	oː v ə r ɛ i̯ s ə l
overkoken	oː v ə r k oː k ə n
overkomen	oː v ə r k oː m ə n
overlast	oː v ə r l ɑ s t
overlaten	oː v ə r l aː t ə n
overledene	oː v ə r l eː d ə n ə
overlijden	oː v ə r l ɛ i̯ d ə n
overmacht	oː v ə r m ɑ x t
overmeesteren	oː v ə r m eː s t ə r ə n
overnachten	oː v ə r n ɑ x t ə n
overname	oː v ə r n aː m ə
overnieuw	oː v ə r n i u̯
overplaatsen	oː v ə r p l aː t s ə n
overplaatsing	oː v ə r p l aː t s ɪ ŋ
overreden	oː v ə r eː d ə n
overrompelen	oː v ə r ɔ m p ə l ə n
overschrijden	oː v ə r s x r ɛ i̯ d ə n
overslaan	oː ʋ ə r s l aː n
oversteken	oː v ə r s t eː k ə n
overstijgen	oː v ə r s t ɛ i̯ ɣ ə n
overtreden	oː v ə r t r eː d ə n
overtreffen	oː v ə r t r ɛ f ə n
overtuigen	oː v ə r t œ y̯ ɣ ə n
overtuiging	oː v ə r t œ y̯ ɣ ɪ ŋ
overvallen	oː v ə r v ɑ l ə n
overweg	oː v ə r ʋ ɛ x
overwegen	oː v ə r ʋ eː ɣ ə n
overweging	oː v ə r ʋ eː ɣ ɪ ŋ
overwinnen	oː v ə r ʋ ɪ n ə n
overzetten	oː v ə r z ɛ t ə n
overzicht	oː v ə r z ɪ x t
overzien	oː v ə r z i n
oxaalzuur	ɔ k s aː l z yː r
ozon	oː z o n
ozonlaag	oː z ɔ n l aː x
pa	p aː
paadje	p aː t ʃ ə
paar	p aː r
paarden	p aː r d ə n
paardenbloem	p aː r d ə n b l u m
paars	p aː r s
paaseiland	p aː s ɛ i̯ l ɑ n t
paasfeest	p aː s f eː s t
pacht	p ɑ x t
pachter	p ɑ x t ə r
page	p aː ʒ ə
pagina	p aː ɣ i n aː
pak	p ɑ k
pakbon	p ɑ k b ɔ n
pakkans	p ɑ k ɑ n s
pakt	p ɑ k t
paleis	p aː l ɛ i̯ s
palen	p aː l ə n
palestina	p aː l ɛ s t i n aː
palladium	p ɑ l aː d i ʏ m
palm	p ɑ l m
palmpasen	p ɑ l m p aː s ə n
paludarium	p aː l y d aː r i ʏ m
pamflet	p ɑ m f l ɛ t
pamfletten	p ɑ m f l ɛ t ə n
pampus	p ɑ m p ʏ s
pan	p ɑ n
panda	p ɑ n d aː
pandemie	p ɑ n d eː m i
paneel	p aː n eː l
paneermeel	p aː n eː r m eː l
paniek	p aː n i k
paniekvoetbal	p aː n i k f u t b ɑ l
panorama	p aː n oː r aː m aː
pantser	p ɑ n t s ə r
pantserjuffer	p ɑ n t s ə r j ʏ f ə r
pantserwagen	p ɑ n t s ə r ʋ aː ɣ ə n
pap	p ɑ p
papier	p aː p iː r
papierwerk	p aː p iː r ʋ ɛ r k
pappen	p ɑ p ə n
parachute	p aː r aː ʃ y t
parade	p aː r aː d ə
paradijs	p aː r aː d ɛ i̯ s
paradoxaal	p aː r aː d ɔ k s aː l
paragraaf	p aː r aː ɣ r aː f
paraplu	p aː r aː p l y
parasol	p aː r aː s ɔ l
pardon	p ɑ r d ɔ n
parelmoer	p aː r ə l m uː r
paren	p aː r ə n
parenclub	p aː r ə n k l ʏ p
parijs	p aː r ɛ i̯ s
park	p ɑ r k
parkeerplaats	p ɑ r k eː r p l aː t s
parkeerruimte	p ɑ r k eː r r œ y̯ m t ə
parkiet	p ɑ r k i t
parking	p ɑ r k ɪ ŋ
parlement	p ɑ r l ə m ɛ n t
parlementair	p ɑ r l ə m ɛ n t ɛː r
parlementariër	p ɑ r l ə m ɛ n t aː r i ə r
parlementsgebouw	p ɑ r l ə m ɛ n t s x ə b ɑ u̯
parochiaan	p aː r ɔ x i aː n
parochie	p aː r ɔ x i
part	p ɑ r t
parterre	p ɑ r t ɛː r ə
participeren	p ɑ r t i s i p eː r ə n
partij	p ɑ r t ɛ i̯
partijbestuur	p ɑ r t ɛ i̯ b ə s t yː r
partijleider	p ɑ r t ɛ i̯ l ɛ i̯ d ə r
partijpolitiek	p ɑ r t ɛ i̯ p oː l i t i k
parttime	p ɑ r t ɑ i̯ m
pas	p ɑ s
pasen	p aː s ə n
pasfoto	p ɑ s f oː t oː
pasgeboren	p ɑ s x ə b oː r ə n
pasja	p aː ʃ aː
paspoort	p ɑ s p oː r t
passie	p ɑ s i
passief	p ɑ s iː f
past	p ɑ s t
pastoor	p ɑ s t oː r
pater	p aː t ə r
patiënt	p ɑ ʃ ɛ n t
patriot	p aː t r i ɔ t
pauw	p ɑ u̯
pech	p ɛ x
peer	p eː r
peeters	p eː t ə r s
peetoom	p eː t oː m
pegel	p eː ɣ ə l
peil	p ɛ i̯ l
peilbuis	p ɛ i̯ l b œ y̯ s
peilen	p ɛ i̯ l ə n
pekela	p eː k ə l aː
peking	p eː k ɪ ŋ
pelgrimstocht	p ɛ l ɣ r ɪ m s t ɔ x t
pellen	p ɛ l ə n
pen	p ɛ n
penetrant	p eː n ə t r ɑ n t
pensioen	p ɛ n ʃ u n
pensioenfonds	p ɛ n ʃ u n f ɔ n t s
pensioenstelsel	p ɛ n ʃ u n s t ɛ l s ə l
perceel	p ɛ r s eː l
periode	p eː r i j oː d ə
permissie	p ɛ r m ɪ s i
pers	p ɛ r s
persbericht	p ɛ r s b ə r ɪ x t
persconferentie	p ɛ r s k ɔ n f ə r ɛ n t s i
persen	p ɛ r s ə n
persiflage	p ɛ r s i f l aː ʒ ə
persoonsgegevens	p ɛ r s oː n s x ə ɣ eː v ə n s
persoonsvorm	p ɛ r s oː n s f ɔ r m
perversie	p ɛ r v ɛ r s i
pester	p ɛ s t ə r
pet	p ɛ t
peter	p eː t ə r
peterselie	p eː t ə r s eː l i
petra	p eː t r aː
petronella	p eː t r oː n ɛ l aː
petrus	p eː t r ʏ s
peuter	p øː t ə r
peuterspeelzaal	p øː t ə r s p eː l z aː l
pezen	p eː z ə n
pias	p i ɑ s
picknick	p ɪ k n ɪ k
piercen	p iː r s ə n
piet	p i t
pieter	p i t ə r
pijl	p ɛ i̯ l
pijn	p ɛ i̯ n
pijnlijk	p ɛ i̯ n l ə k
pijnloos	p ɛ i̯ n l oː s
pijp	p ɛ i̯ p
pijpen	p ɛ i p ə n
pijpleiding	p ɛ i̯ p l ɛ i̯ d ɪ ŋ
pik	p ɪ k
pikaks	p ɪ k ɑ k s
pikdonker	p ɪ k d ɔ ŋ k ə r
pikken	p ɪ k ə n
pil	p ɪ l
pillewegge	p ɪ l ə ʋ ɛ ɣ ə
piloot	p i l oː t
pim	p ɪ m
pin	p ɪ n
pindakaas	p ɪ n d aː k aː s
pink	p ɪ ŋ k
pinksteren	p ɪ ŋ k s t ə r ə n
pionier	p i oː n iː r
pipet	p i p ɛ t
pipo	p i p oː
piraat	p i r aː t
piraterij	p i r aː t ə r ɛ i̯
pis	p ɪ s
pissebed	p ɪ s ə b ɛ t
pistool	p i s t oː l
pixel	p ɪ k s ə l
piëtisme	p i j eː t ɪ s m ə
plaag	p l aː x
plaat	p l aː t
plaatsvinden	p l aː t s f ɪ n d ə n
plaatwerk	p l aː t ʋ ɛ r k
plafond	p l aː f ɔ n
plak	p l ɑ k
plakband	p l ɑ k b ɑ n t
plakken	p l ɑ k ə n
plan	p l ɑ n
planeet	p l aː n eː t
plank	p l ɑ ŋ k
plantage	p l ɑ n t aː ʒ ə
planten	p l ɑ n t ə n
plas	p l ɑ s
plasma	p l ɑ s m aː
plassen	p l ɑ s ə n
plastiek	p l ɑ s t i k
plateau	p l aː t oː
platteland	p l ɑ t ə l ɑ n t
plechtigheid	p l ɛ x t ə x ɦ ɛ i̯ t
pleegzorg	p l eː x s ɔ r x
plein	p l ɛ i̯ n
pleister	p l ɛ i s t ə r
pleiten	p l ɛ i̯ t ə n
plek	p l ɛ k
plezier	p l ə z iː r
plezierig	p l ə z i r ə x
plicht	p l ɪ x t
ploert	p l uː r t
ploeteren	p l u t ə r ə n
plotsklaps	p l ɔ t s k l ɑ p s
pluchen	p l y ʃ ə n
plug	p l ʏ x
pluim	p l œ y̯ m
pluimvee	p l œ y̯ m v eː
pluk	p l ʏ k
plukken	p l ʏ k ə n
plunderen	p l ʏ n d ə r ə n
po	p oː
pocket	p ɔ k ə t
podium	p oː d i j ʏ m
poedersuiker	p u d ə r s œ y̯ k ə r
poel	p u l
poels	p u l s
poen	p u n
poes	p u s
poetsen	p u t s ə n
pokken	p ɔ k ə n
pol	p ɔ l
polder	p ɔ l d ə r
polemist	p oː l eː m ɪ s t
polen	p oː l ə n
polikliniek	p oː l i k l i n i k
politie	p oː l i t s i
politieagente	p oː l i t s i aː ɣ ɛ n t ə
politiebureau	p oː l i t s i b y r oː
politiek	p oː l i t i k
politieker	p oː l i t i k ə r
politiestaat	p oː l i t s i s t aː t
pols	p ɔ l s
polytheïsme	p oː l i t eː ɪ s m ə
pomp	p ɔ m p
pompen	p ɔ m p ə n
pond	p ɔ n t
pool	p oː l
poolvos	p oː l v ɔ s
poort	p oː r t
poot	p oː t
pop	p ɔ p
popgroep	p ɔ p x r u p
poppen	p ɔ p ə n
poppenkast	p ɔ p ə n k ɑ s t
poppodium	p ɔ p p oː d i ʏ m
popster	p ɔ p s t ɛ r
populair	p oː p y l ɛː r
porno	p ɔ r n oː
port	p ɔ r t
portefeuille	p ɔ r t ə f œ y̯ j ə
portie	p ɔ r s i
portier	p ɔ r t iː r
porto	p ɔ r t oː
portret	p ɔ r t r ɛ t
portugal	p ɔ r t y ɣ ɑ l
positie	p oː z i t s i
postbode	p ɔ s t b oː d ə
postbus	p ɔ s t b ʏ s
postcode	p ɔ s t k oː d ə
poster	p oː s t ə r
postkantoor	p ɔ s t k ɑ n t oː r
postma	p ɔ s t m aː
postorderbedrijf	p ɔ s t ɔ r d ə r b ə d r ɛ i̯ f
pot	p ɔ t
poten	p oː t ə n
potentie	p oː t ɛ n s i
potlood	p ɔ t l oː t
potplant	p ɔ t p l ɑ n t
potsierlijk	p ɔ t s i r l ə k
potverdorie	p ɔ t f ə r d oː r i
pover	p oː v ə r
poëet	p oː eː t
praag	p r aː x
praalgraf	p r aː l ɣ r ɑ f
praat	p r aː t
prachtig	p r ɑ x t ə x
praktisch	p r ɑ k t i s
praten	p r aː t ə n
precies	p r ə s i s
preekstoel	p r eː k s t u l
prehistorisch	p r eː ɦ ɪ s t oː r i s
prei	p r ɛ i̯
premie	p r eː m i
premier	p r ə m j eː
première	p r ə m j ɛː r ə
prent	p r ɛ n t
presidentschap	p r eː z i d ɛ n t s x ɑ p
prestige	p r ɛ s t iː ʒ ə
pret	p r ɛ t
pretpark	p r ɛ t p ɑ r k
prettig	p r ɛ t ə x
preventie	p r eː v ɛ n s i
preventief	p r eː v ɛ n t i f
prijken	p r ɛ i̯ k ə n
prijs	p r ɛ i̯ s
prijsgeven	p r ɛ i̯ s ɣ eː v ə n
prijzen	p r ɛ i̯ z ə n
primair	p r i m ɛː r
primeur	p r i m øː r
principe	p r ɪ n s i p ə
prins	p r ɪ n s
prinsjesdag	p r ɪ n ʃ ə s d ɑ x
printen	p r ɪ n t ə n
printer	p r ɪ n t ə r
priscilla	p r ɪ s ɪ l aː
privatiseren	p r i v aː t i z eː r ə n
privatisering	p r i v aː t i z eː r ɪ ŋ
proberen	p r oː b eː r ə n
probleem	p r oː b l eː m
probleemloos	p r oː b l eː m l oː s
problematiek	p r oː b l eː m aː t i k
procedure	p r oː s ə d yː r ə
proces	p r oː s ɛ s
proef	p r u f
proefschrift	p r u f s x r ɪ f t
proeven	p r u v ə n
profeet	p r oː f eː t
professie	p r oː f ɛ s i
profiel	p r oː f i l
programmatuur	p r oː ɣ r ɑ m aː t yː r
progressief	p r oː ɣ r ɛ s i f
project	p r oː j ɛ k t
prompt	p r ɔ m p t
pronk	p r ɔ ŋ k
pronken	p r ɔ ŋ k ə n
prooi	p r oː i̯
proost	p r oː s t
proper	p r oː p ə r
prostaatkanker	p r ɔ s t aː t k ɑ ŋ k ə r
prostituee	p r ɔ s t i t y eː
protest	p r oː t ɛ s t
protesteren	p r oː t ɛ s t eː r ə n
proteïne	p r o t e j i n ə
prothese	p r oː t eː z ə
protocol	p r oː t oː k ɔ l
provider	p r oː v ɑ i̯ d ə r
provincie	p r oː v ɪ n s i
provinciehuis	p r oː v ɪ n s i ɦ œ y̯ s
provinciën	p r oː v ɪ n s i ə n
provoceren	p r oː v oː s eː r ə n
pruik	p r œ y̯ k
pruim	p r œ y̯ m
pruimen	p r œ y̯ m ə n
prullenbak	p r ʏ l ə n b ɑ k
prutser	p r ʏ t s ə r
pruttelen	p r ʏ t ə l ə n
psychiatrie	p s i x i a t r i
psychologie	p s i x oː l oː ɣ i
psychologisch	p s i x oː l oː ɣ i s
psychose	p s i x oː z ə
psychotherapie	p s i x oː t eː r aː p i
ptt	p eː t eː t eː
publiceren	p y b l i s eː r ə n
publiek	p y b l i k
puin	p œ y̯ n
punkrock	p ʏ ŋ k r ɔ k
punt	p ʏ n t
puntje	p ʏ n t j ə
puntkomma	p ʏ n t k ɔ m aː
puntmuts	p ʏ n t m ʏ t s
purmerend	p ʏ r m ə r ɛ n t
puur	p y r
python	p i t ɔ n
quarantaine	k aː r ɑ n t ɛː n ə
quint	k ʋ ɪ n t
raad	r aː t
raadplegen	r aː t p l eː ɣ ə n
raadsel	r aː t s ə l
raadslid	r aː t s l ɪ t
raadsman	r aː t s m ɑ n
raadzaam	r aː t s aː m
raaf	r aː f
raak	r aː k
raalte	r aː l t ə
raam	r aː m
raap	r aː p
raar	r aː r
race	r eː s
racer	r eː s ə r
radar	r aː d ɑ r
raden	r aː d ə n
radio	r aː d i j oː
radioactiviteit	r aː d i oː ɑ k t i v i t ɛ i̯ t
rage	r aː ʒ ə
raken	r aː k ə n
raket	r aː k ɛ t
raketbasis	r aː k ɛ t b aː z ɪ s
raketschild	r aː k ɛ t s x ɪ l t
rakker	r ɑ k ə r
ral	r ɑ l
ram	r ɑ m
ramen	r aː m ə n
rand	r ɑ n t
rang	r ɑ ŋ
rapen	r aː p ə n
rare	r aː r ə
ras	r ɑ s
raspen	r ɑ s p ə n
rat	r ɑ t
ratel	r aː t ə l
ratio	r aː t s i oː
rationalisme	r aː t ʃ oː n aː l ɪ s m ə
rationeel	r aː t ʃ oː n eː l
rauw	r ɑ u̯
ravage	r aː v aː ʒ ə
razendsnel	r aː z ə n t s n ɛ l
re	r eː
reactie	r eː j ɑ k s i
reagens	r eː aː ɣ ɛ n s
reageren	r eː j aː ɣ eː r ə n
realisme	r eː aː l ɪ s m ə
realist	r eː aː l ɪ s t
realiteit	r eː aː l i t ɛ i̯ t
recentelijk	r ə s ɛ n t ə l ə k
recept	r ə s ɛ p t
recepten	r ə s ɛ p t ə n
recht	r ɛ x t
rechtbank	r ɛ x t b ɑ ŋ k
rechter	r ɛ x t ə r
rechts	r ɛ x t s
rechtse	r ɛ x t s ə
rechtsorde	r ɛ x t s ɔ r d ə
rechtsstaat	r ɛ x t s t aː t
rechtsstatelijk	r ɛ x t s s t aː t ə l ə k
rechtszaak	r ɛ x t s aː k
rechtvaardig	r ɛ x t f aː r d ə x
reclame	r ə k l aː m ə
red	r ɛ t
redden	r ɛ d ə n
redding	r ɛ d ɪ ŋ
reddingsboot	r ɛ d ɪ ŋ s b oː t
rede	r eː d ə
redelijk	r eː d ə l ə k
reden	r eː d ə n
redenen	r eː d ə n ə n
redeneren	r eː d ə n eː r ə n
ree	r eː
reed	r eː t
reeks	r eː k s
reep	r eː p
rees	r eː s
referentiekader	r eː f ə r ɛ n t s i k aː d ə r
reformatie	r eː f ɔ r m aː t s i
reformatorisch	r eː f ɔ r m aː t oː r i s
regel	r eː ɣ ə l
regelen	r eː ɣ ə l ə n
regelmaat	r eː ɣ ə l m aː t
regelmatig	r eː ɣ ə l m aː t ə x
regen	r eː ɣ ə n
regenachtig	r eː ɣ ə n ɑ x t ə x
regenbui	r eː ɣ ə n b œ y̯
regenen	r eː ɣ ə n ə n
regenjas	r eː ɣ ə n j ɑ s
regenseizoen	r eː ɣ ə n s ɛ i̯ z u n
regenval	r eː ɣ ə n v ɑ l
regenwater	r eː ɣ ə n ʋ aː t ə r
regering	r ə ɣ eː r ɪ ŋ
regiment	r eː ʒ i m ɛ n t
regisseur	r eː ɣ i s øː r
reiken	r ɛ i̯ k ə n
reikwijdte	r ɛ i̯ k ʋ ɛ i̯ t ə
rein	r ɛ i̯ n
reiniger	r ɛ i̯ n ə ɣ ə r
reis	r ɛ i̯ s
reisagent	r ɛ i̯ s aː ɣ ɛ n t
reisbureau	r ɛ i̯ s b y r oː
reizen	r ɛ i̯ z ə n
reiziger	r ɛ i̯ z ə ɣ ə r
rek	r ɛ k
reken	r eː k ə n
rekenen	r eː k ə n ə n
rekening	r eː k ə n ɪ ŋ
religie	r ə l i ɣ i
rellen	r ɛ l ə n
rem	r ɛ m
remmen	r ɛ m ə n
remmerswaal	r ɛ m ə r s ʋ aː l
remming	r ɛ m ɪ ŋ
remweg	r ɛ m ʋ ɛ x
rendabel	r ɛ n d aː b ə l
renswoude	r ɛ n s ʋ ɑ u̯ d ə
rent	r ɛ n t
rente	r ɛ n t ə
rentmeester	r ɛ n t m eː s t ə r
reparatie	r eː p aː r aː t s i
repeteren	r eː p ə t eː r ə n
republiek	r eː p y b l i k
reserve	r ə z ɛ r v ə
reserveren	r eː z ɛ r v eː r ə n
resolutie	r e s o l y t s i
resort	r i z ɔ r t
rest	r ɛ s t
restafval	r ɛ s t ɑ f ɑ l
reu	r øː
reus	r øː s
reuze	r øː z ə
revolutie	r eː v oː l y t s i
reëel	r eː j eː l
rhenen	r eː n ə n
riant	r i ɑ n t
richten	r ɪ x t ə n
richting	r ɪ x t ɪ ŋ
richtlijn	r ɪ x t l ɛ i̯ n
ridder	r ɪ d ə r
ridderlijk	r ɪ d ə r l ə k
ridderorde	r ɪ d ə r ɔ r d ə
riemen	r i m ə n
riet	r i t
rij	r ɛ i̯
rijbewijs	r ɛ i̯ b ə ʋ ɛ i̯ s
rijd	r ɛ i̯ t
rijdt	r ɛ i̯ t
rijk	r ɛ i̯ k
rijkdom	r ɛ i̯ k d ɔ m
rijksdaalder	r ɛ i̯ k s d aː l d ə r
rijkspolitie	r ɛ i̯ k s p oː l i t s i
rijksweg	r ɛ i̯ k s ʋ ɛ x
rijkunst	r ɛ i̯ k ʏ n s t
rijn	r ɛ i n
rijnsburg	r ɛ i̯ n s b ʏ r x
rijp	r ɛ i̯ p
rijschool	r ɛ i̯ s x oː l
rijsel	r ɛ i̯ s ə l
rijst	r ɛ i̯ s t
rijstrook	r ɛ i̯ s t r oː k
rijsttafel	r ɛ i̯ s t aː f ə l
rijswijk	r ɛ i̯ s ʋ ɛ i̯ k
rijweg	r ɛ i̯ ʋ ɛ x
rijwiel	r ɛ i̯ ʋ i l
rijzen	r ɛ i z ə n
ring	r ɪ ŋ
ringen	r ɪ ŋ ə n
ringtone	r ɪ ŋ t oː n
ringweg	r ɪ ŋ ʋ ɛ x
ringworm	r ɪ ŋ ʋ ɔ r m
riolering	r i oː l eː r ɪ ŋ
risico	r i z i k oː
risicogroep	r i z i k oː ɣ r u p
rit	r ɪ t
ritme	r ɪ t m ə
rits	r ɪ t s
ritsen	r ɪ t s ə n
ritten	r ɪ t ə n
rivaal	r i v aː l
rivaliteit	r i v aː l i t ɛ i̯ t
rivier	r iː v iː r
rivierdelta	r i v iː r d ɛ l t aː
rivierengebied	r i v iː r ə n ɣ ə b i t
rob	r ɔ p
robben	r ɔ b ə n
robijn	r oː b ɛ i̯ n
robot	r oː b ɔ t
rock	r ɔ k
rockband	r ɔ k b ɛ n t
rocker	r ɔ k ə r
roddel	r ɔ d ə l
roddelpers	r ɔ d ə l p ɛ r s
rode	r oː d ə
roede	r u d ə
roeiboot	r u i̯ b oː t
roeien	r u i̯ ə n
roemenië	r u m eː n i j ə
roepen	r u p ə n
roepnaam	r u p n aː m
roer	r u r
roerdalen	r uː r d aː l ə n
roeren	r u r ə n
roerig	r uː r ə x
roermond	r uː r m ɔ n t
roest	r u s t
rog	r ɔ x
roken	r oː k ə n
roker	r oː k ə r
rokerig	r oː k ə r ə x
rokken	r ɔ k ə n
rol	r ɔ l
rollade	r ɔ l aː d ə
rollator	r ɔ l aː t ɔ r
rollen	r ɔ l ə n
rolstoel	r ɔ l s t u l
roman	r oː m ɑ n
romein	r oː m ɛ i̯ n
romeins	r oː m ɛ i̯ n s
rommelig	r ɔ m ə l ə x
rond	r ɔ n t
ronde	r ɔ n d ə
ronden	r ɔ n d ə n
rondvaart	r ɔ n t f aː r t
rondweg	r ɔ n t ʋ ɛ x
rood	r oː t
roof	r oː f
roofvogel	r oː f oː ɣ ə l
rook	r oː k
roomboter	r oː m b oː t ə r
roomijs	r oː m ɛ i̯ s
roos	r oː s
roosendaal	r oː z ə n d aː l
rooster	r oː s t ə r
rosita	r oː z i t aː
roskam	r ɔ s k ɑ m
rot	r ɔ t
rotonde	r oː t ɔ n d ə
rots	r ɔ t s
rotten	r ɔ t ə n
rotterdam	r ɔ t ə r d ɑ m
routebeschrijving	r u t ə b ə s x r ɛ i̯ v ɪ ŋ
rouwmoed	r ɑ u̯ m u t
rouwmoedig	r ɑ u̯ m u d ə x
rubriek	r y b r i k
ruchtbaarheid	r ʏ x t b aː r ɦ ɛ i̯ t
rug	r ʏ x
ruggegraat	r ʏ ɣ ə ɣ r aː t
ruggengraat	r ʏ ɣ ə ɣ r aː t
rugleuning	r ʏ x l øː n ɪ ŋ
ruig	r œ y̯ x
ruiken	r œ y̯ k ə n
ruim	r œ y̯ m
ruimen	r œ y̯ m ə n
ruimschoots	r œ y̯ m s x oː t s
ruimte	r œ y̯ m t ə
ruimtekromme	r œ y̯ m t ə k r ɔ m ə
ruimtelijk	r œ y̯ m t ə l ə k
ruimtestation	r œ y̯ m t ə s t aː ʃ ɔ n
ruimtevaart	r œ y̯ m t ə v aː r t
ruimteveer	r œ y̯ m t ə v eː r
ruin	r œ y̯ n
ruis	r œ y̯ s
ruit	r œ y̯ t
ruiter	r œ y̯ t ə r
ruk	r ʏ k
rukken	r ʏ k ə n
rum	r ʏ m
rundvee	r ʏ n t f eː
runnen	r ʏ n ə n
rusland	r ʏ s l ɑ n t
russisch	r ʏ s i s
rust	r ʏ s t
rustdag	r ʏ s d ɑ x
rustig	r ʏ s t ə x
ruth	r ʏ t
ruud	r y t
ruw	r y u̯
ruzie	r y z i
ruïne	r y i n ə
ruïneren	r y i n eː r ə n
saai	s aː i
saamhorigheid	s aː m ɦ oː r ə x ɦ ɛ i̯ t
sabine	s aː b i n ə
sabotage	s aː b oː t aː ʒ ə
safari	s aː f aː r i
saffier	s ɑ f iː r
sake	s aː k eː
saksen	s ɑ k s ə n
salade	s aː l aː d ə
salamander	s aː l aː m ɑ n d ə r
salaris	s aː l aː r ɪ s
salarisschaal	s aː l aː r ɪ s s x aː l
saldo	s ɑ l d oː
sallands	s ɑ l ɑ n t s
salomon	s aː l oː m ɔ n
salomonseilanden	s aː l oː m ɔ n s ɛ i̯ l ɑ n d ə n
salontafel	s aː l ɔ n t aː f ə l
salp	s ɑ l p
salsa	s ɑ l s aː
sam	s ɑ m
samenkomst	s aː m ə n k ɔ m s t
samenspraak	s aː m ə n s p r aː k
samenstelling	s aː m ə n s t ɛ l ɪ ŋ
samenwerking	s aː m ə n ʋ ɛ r k ɪ ŋ
sander	s ɑ n d ə r
sanders	s ɑ n d ə r s
sanitair	s aː n i t ɛː r
sanne	s ɑ n ə
sanskriet	s ɑ n s k r i t
sara	s aː r aː
sarah	s aː r aː
sarnami	s ɑ r n aː m i
sas	s ɑ s
sassenheim	s ɑ s ə n ɦ ɛ i̯ m
saté	s aː t eː
saus	s ɑ u̯ s
scanner	s k ɛ n ə r
schaaf	s x aː f
schaal	s x aː l
schaam	s x aː m
schaamte	s x aː m t ə
schaap	s x aː p
schaapherder	s x aː p ɦ ɛ r d ə r
schaapsherder	s x aː p s ɦ ɛ r d ə r
schaarbeek	s x aː r b eː k
schaars	s x aː r s
schacht	s x ɑ x t
schade	s x aː d ə
schadelijk	s x aː d ə l ə k
schaden	s x aː d ə n
schaduw	s x aː d y u̯
schaduwzijde	s x aː d y u̯ z ɛ i̯ d ə
schaffen	s x ɑ f ə n
schagen	s x aː ɣ ə n
schakel	s x aː k ə l
schakelen	s x aː k ə l ə n
schaken	s x aː k ə n
schaker	s x aː k ə r
schans	s x ɑ n s
schapen	s x aː p ə n
schapenvlees	s x aː p ə n v l eː s
schare	s x aː r ə
schat	s x ɑ t
schatkist	s x ɑ t k ɪ s t
schatten	s x ɑ t ə n
schatting	s x ɑ t ɪ ŋ
schedel	s x eː d ə l
scheen	s x eː n
scheepsblok	s x eː p s b l ɔ k
scheepsbouwer	s x eː p s b ɑ u̯ ə r
scheepswerf	s x eː p s ʋ ɛ r f
scheepvaart	s x eː p v aː r t
scheiden	s x ɛ i̯ d ə n
scheiding	s x ɛ i̯ d ɪ ŋ
scheidslijn	s x ɛ i̯ t s l ɛ i̯ n
scheidsrechter	s x ɛ i̯ t s r ɛ x t ə r
schelden	s x ɛ l d ə n
schelp	s x ɛ l p
schelpenpad	s x ɛ l p ə n p ɑ t
schemer	s x eː m ə r
schenden	s x ɛ n d ə n
schending	s x ɛ n d ɪ ŋ
schenken	s x ɛ ŋ k ə n
schenker	s x ɛ ŋ k ə r
schenking	s x ɛ ŋ k ɪ ŋ
schep	s x ɛ p
schepen	s x eː p ə n
scheppen	s x ɛ p ə n
schepper	s x ɛ p ə r
schepping	s x ɛ p ɪ ŋ
schepsel	s x ɛ p s ə l
scherf	s x ɛ r f
schermen	s x ɛ r m ə n
scherp	s x ɛ r p
scherpen	s x ɛ r p ə n
scherprechter	s x ɛ r p r ɛ x t ə r
schets	s x ɛ t s
schetsen	s x ɛ t s ə n
scheuren	s x øː r ə n
schier	s x iː r
schiereiland	s x iː r ɛ i̯ l ɑ n t
schiermonnikoog	s x iː r m ɔ n ɪ k oː x
schietbaan	s x i t b aː n
schieten	s x i t ə n
schietschijf	s x i t s x ɛ i̯ f
schijf	s x ɛ i̯ f
schijn	s x ɛ i̯ n
schijnen	s x ɛ i̯ n ə n
schijnheilig	s x ɛ i̯ n ɦ ɛ i̯ l ə x
schil	s x ɪ l
schild	s x ɪ l t
schilder	s x ɪ l d ə r
schilderachtig	s x ɪ l d ə r ɑ x t ə x
schilderen	s x ɪ l d ə r ə n
schilderij	s x ɪ l d ə r ɛ i̯
schilderkunst	s x ɪ l d ə r k ʏ n s t
schilderwerk	s x ɪ l d ə r ʋ ɛ r k
schildpad	s x ɪ l t p ɑ t
schimmel	s x ɪ m ə l
schip	s x ɪ p
schiphol	s x ɪ p ɦ ɔ l
schipper	s x ɪ p ə r
schitterend	s x ɪ t ə r ə n t
schizofrenie	s x i t s oː f r eː n i
schoeien	s x u i̯ ə n
schoen	s x u n
schoenen	s x u n ə n
schoenmakerij	s x u n m aː k ə r ɛ i̯
schoep	s x u p
schoffel	s x ɔ f ə l
schoffelen	s x ɔ f ə l ə n
schokken	s x ɔ k ə n
schokland	s x ɔ k l ɑ n t
scholier	s x oː l iː r
scholing	s x oː l ɪ ŋ
schoner	s x oː n ə r
school	s x oː l
schoolreis	s x oː l r ɛ i̯ s
schoon	s x oː n
schoonmaakster	s x oː n m aː k s t ə r
schoonmaken	s x oː n m aː k ə n
schoonmaker	s x oː n m aː k ə r
schoonmoeder	s x oː n m u d ə r
schoonzoon	s x oː n z oː n
schoorl	s x oː r ə l
schoorsteenveger	s x oː r s t eː n v eː ɣ ə r
schoot	s x oː t
schop	s x ɔ p
schoppen	s x ɔ p ə n
schorpioen	s x ɔ r p i u n
schors	s x ɔ r s
schorsen	s x ɔ r s ə n
schort	s x ɔ r t
schot	s x ɔ t
schotel	s x oː t ə l
schotland	s x ɔ t l ɑ n t
schots	s x ɔ t s
schotse	s x ɔ t s ə
schouder	s x ɑ u̯ d ə r
schout	s x ɑ u̯ t
schrappen	s x r ɑ p ə n
schreef	s x r eː f
schrift	s x r ɪ f t
schrijfmachine	s x r ɛ i̯ f m ɑ ʃ i n ə
schrijven	s x r ɛ i̯ v ə n
schrijver	s x r ɛ i̯ v ə r
schrik	s x r ɪ k
schrikbarend	s x r ɪ k b aː r ə n t
schrikbewind	s x r ɪ k b ə ʋ ɪ n t
schrikken	s x r ɪ k ə n
schroef	s x r u f
schromelijk	s x r oː m ə l ə k
schudden	s x ʏ d ə n
schuil	s x œ y̯ l
schuilen	s x œ y̯ l ə n
schuilgaan	s x œ y̯ l ɣ aː n
schuim	s x œ y̯ m
schuin	s x œ y̯ n
schuiven	s x œ y̯ v ə n
schuld	s x ʏ l t
schuldenberg	s x ʏ l d ə n b ɛ r x
schuldig	s x ʏ l d ə x
schut	s x ʏ t
schutter	s x ʏ t ə r
schutting	s x ʏ t ɪ ŋ
schuur	s x y r
schuw	s x y u̯
schuwen	s x y u̯ ə n
schwalbe	ʃ ʋ ɑ l b ə
scooter	s k u t ə r
scoren	s k oː r ə n
scout	s k ɑ u̯ t
script	s k r ɪ p t
scène	s ɛː n ə
seconde	s ɛ k ɔ n d ə
secretaresse	s ɪ k r ə t aː r ɛ s ə
secretaris	s ɪ k r ə t aː r ɪ s
sector	s ɛ k t ɔ r
sedert	s eː d ə r t
segment	s ɛ x m ɛ n t
sein	s ɛ i̯ n
seintjes	s ɛ i̯ n t j ə s
seizoen	s ɛ i̯ z u n
seks	s ɛ k s
sekse	s ɛ k s ə
seminarie	s eː m i n aː r i
sensor	s ɛ n z ɔ r
serie	s eː r i
serre	s ɛː r ə
serum	s eː r ʏ m
set	s ɛ t
shampoo	ʃ ɑ m p oː
shot	ʃ ɔ t
show	ʃ oː
shuttle	ʃ ʏ t ə l
siberië	s i b eː r i ə
sicilië	s i s i l i ə
siemens	s i m ə n s
sier	s i r
sieren	s i r ə n
sietske	s i t s k ə
sigaar	s i ɣ aː r
sigaret	s i ɣ aː r ɛ t
simpelveld	s ɪ m p ə l v ɛ l t
simpelweg	s ɪ m p ə l ʋ ɛ x
simultaan	s i m ʏ l t aː n
singel	s ɪ ŋ ə l
sint	s ɪ n t
sirene	s i r ɛ n ə
sirocco	s i r ɔ k oː
site	s ɑ i̯ t
situatie	s i t y aː t s i
sjaan	ʃ aː n
sjap	t ʃ ɑ p
sjezen	ʃ eː z ə n
sjiitisch	ʃ i i t i s
sjofel	ʃ oː f ə l
sjouwen	ʃ ɑ u̯ ə n
ska	s k aː
skiën	s k i j ə n
sla	s l aː
slaaf	s l aː f
slaan	s l aː n
slaap	s l aː p
slaapstand	s l aː p s t ɑ n t
slaapt	s l aː p t
slaapzand	s l aː p z ɑ n t
slachting	s l ɑ x t ɪ ŋ
slagboom	s l ɑ x b oː m
slagen	s l aː ɣ ə n
slager	s l aː ɣ ə r
slagerij	s l aː ɣ ə r ɛ i̯
slagkracht	s l ɑ x k r ɑ x t
slagroom	s l ɑ x r oː m
slak	s l ɑ k
slangengif	s l ɑ ŋ ə n ɣ ɪ f
slank	s l ɑ ŋ k
slanken	s l ɑ ŋ k ə n
slap	s l ɑ p
slapen	s l aː p ə n
slaper	s l aː p ə r
slavernij	s l aː v ə r n ɛ i̯
slavin	s l aː v ɪ n
slavische	s l aː v i s ə
slecht	s l ɛ x t
slechte	s l ɛ x t ə
slechterik	s l ɛ x t ə r ɪ k
slechts	s l ɛ x t s
slee	s l eː
slepen	s l eː p ə n
slet	s l ɛ t
sleutelbeen	s l øː t ə l b eː n
sleutelrol	s l øː t ə l r ɔ l
slib	s l ɪ p
sliep	s l i p
slijten	s l ɛ i̯ t ə n
slinger	s l ɪ ŋ ə r
slingeren	s l ɪ ŋ ə r ə n
slip	s l ɪ p
sloeber	s l u b ə r
sloeg	s l u x
sloegen	s l u ɣ ə n
slok	s l ɔ k
sloom	s l oː m
sloop	s l oː p
sloot	s l oː t
slop	s l ɔ p
slot	s l ɔ t
sloten	s l oː t ə n
slovenië	s l oː v eː n i j ə
sluier	s l œ y̯ ə r
sluis	s l œ y̯ s
sluit	s l œ y̯ t
sluiten	s l œ y̯ t ə n
sluitstuk	s l œ y̯ k s t ʏ k
sluizen	s l œ y̯ z ə n
sm	ɛ z ɛ m
smaak	s m aː k
smaakt	s m aː k t
smakelijk	s m aː k ə l ə k
smaken	s m aː k ə n
smart	s m ɑ r t
smartphone	s m ɑ r t f oː n
smeekbede	s m eː k b eː d ə
smeren	s m eː r ə n
smet	s m ɛ t
smits	s m ɪ t s
smoel	s m u l
smokkelen	s m ɔ k ə l ə n
smullen	s m ʏ l ə n
smurfen	s m ʏ r f ə n
snaar	s n aː r
snavel	s n aː v ə l
snede	s n eː d ə
snee	s n eː
sneeuwbui	s n eː u̯ b œ y̯
sneeuwdek	s n eː u̯ d ɛ k
sneeuwgeit	s n eː u̯ ɣ ɛ i̯ t
sneeuwklokje	s n eː u̯ k l ɔ k j ə
sneeuwschuiver	s n eː u̯ s x œ y̯ v ə r
sneeuwwoestijn	s n eː u̯ ʋ u s t ɛ i̯ n
sneijder	s n ɛ i̯ d ə r
snelheid	s n ɛ l ɦ ɛ i̯ t
sneller	s n ɛ l ə r
snelweg	s n ɛ l ʋ ɛ x
sneuvelen	s n øː v ə l ə n
snijwond	s n ɛ i̯ ʋ ɔ n t
snoeien	s n u i̯ ə n
snoek	s n u k
snoepje	s n u p j ə
snoepreis	s n u p r ɛ i̯ s
snotneus	s n ɔ t n øː s
snuffelhond	s n ʏ f ə l ɦ ɔ n t
snugger	s n ʏ ɣ ə r
snuiven	s n œ y̯ v ə n
soa	s oː aː
soennitisch	s u n i t i s
soep	s u p
soera	s uː r aː
soest	s u s t
soeverein	s u v ə r ɛ i̯ n
soevereiniteit	s u v ə r ɛ i̯ n i t ɛ i̯ t
sok	s ɔ k
sokkel	s ɔ k ə l
sokken	s ɔ k ə n
sol	s ɔ l
soldaat	s ɔ l d aː t
solist	s oː l ɪ s t
solo	s oː l oː
som	s ɔ m
sommige	s ɔ m ə ɣ ə
soms	s ɔ m s
somtijds	s ɔ m t ɛ i̯ t s
sonde	s ɔ n d ə
soort	s oː r t
sop	s ɔ p
sorry	s ɔ r i
sorteren	s ɔ r t eː r ə n
spaanplaat	s p aː n p l aː t
spaans	s p aː n s
spaarbank	s p aː r b ɑ ŋ k
spaargeld	s p aː r ɣ ɛ l t
spaarrekening	s p aː r eː k ə n ɪ ŋ
span	s p ɑ n
spandoek	s p ɑ n d u k
spanje	s p ɑ n j ə
spannen	s p ɑ n ə n
spannend	s p ɑ n ə n t
spanningsveld	s p ɑ n ɪ ŋ s f ɛ l t
spar	s p ɑ r
speciaal	s p eː ʃ aː l
specialist	s p eː ʃ aː l ɪ s t
specie	s p eː s i
speech	s p i t ʃ
speeksel	s p eː k s ə l
speelgoed	s p eː l ɣ u t
speelster	s p eː l s t ə r
speeltje	s p eː l t j ə
speelveld	s p eː l v ɛ l t
spek	s p ɛ k
spel	s p ɛ l
spelen	s p eː l ə n
speler	s p eː l ə r
spellen	s p ɛ l ə n
spelling	s p ɛ l ɪ ŋ
spelt	s p ɛ l t
sperma	s p ɛ r m aː
spervuur	s p ɛ r v yː r
speurhond	s p øː r ɦ ɔ n t
spiegel	s p i ɣ ə l
spieken	s p i k ə n
spies	s p i s
spijker	s p ɛ i̯ k ə r
spijkeren	s p ɛ i̯ k ɛ r ə n
spin	s p ɪ n
spindel	s p ɪ n d ə l
spinnen	s p ɪ n ə n
spits	s p ɪ t s
spitsstrook	s p ɪ t s t r oː k
splinternieuw	s p l ɪ n t ə r n i u̯
spoed	s p u t
spoedig	s p u d ə x
spoel	s p u l
spoelbak	s p u l b ɑ k
spoelen	s p u l ə n
spokerij	s p oː k ə r ɛ i̯
spook	s p oː k
spookhuis	s p oː k ɦ œ y̯ s
spookstad	s p oː k s t ɑ t
spoor	s p oː r
spoorlijn	s p oː r l ɛ i̯ n
spoorloos	s p oː r l oː s
spoorslags	s p oː r s l ɑ x s
spoorweg	s p oː r ʋ ɛ x
sporen	s p oː r ə n
sport	s p ɔ r t
sporten	s p ɔ r t ə n
spot	s p ɔ t
spraak	s p r aː k
spraakwaterval	s p r aː k ʋ aː t ə r v ɑ l
sprak	s p r ɑ k
spray	s p r eː
spreek	s p r eː k
spreekbeurt	s p r eː k b øː r t
spreekkamer	s p r eː k aː m ə r
spreekt	s p r eː k t
spreektaal	s p r eː k t aː l
spreekuur	s p r eː k yː r
spreekwoord	s p r eː k ʋ oː r t
spreken	s p r eː k ə n
spreuk	s p r øː k
spreuken	s p r øː k ə n
spring	s p r ɪ ŋ
springen	s p r ɪ ŋ ə n
springkussen	s p r ɪ ŋ k ʏ s ə n
springplank	s p r ɪ ŋ p l ɑ ŋ k
springt	s p r ɪ ŋ t
springvorm	s p r ɪ ŋ v ɔ r m
sprinten	s p r ɪ n t ə n
sproeien	s p r u i̯ ə n
sprong	s p r ɔ ŋ
sprookje	s p r oː k j ə
spruit	s p r œ y̯ t
spruiten	s p r œ y̯ t ə n
spuit	s p œ y̯ t
spuiten	s p œ y̯ t ə n
spul	s p ʏ l
srebrenica	s r ɛ b r eː n i t s aː
staafmixer	s t aː f m ɪ k s ə r
staal	s t aː l
staan	s t aː n
staart	s t aː r t
staat	s t aː t
staatkundig	s t aː t k ʏ n d ə x
staats	s t aː t s
staatsbedrijf	s t aː t s b ə d r ɛ i̯ f
staatsbezoek	s t aː t s b ə z u k
staatsgevaarlijk	s t aː t s x ə v aː r l ə k
staatsgreep	s t aː t s x r eː p
staatshoofd	s t aː t s ɦ oː f t
staatspensioen	s t aː t s p ɛ n ʃ u n
staatsschuld	s t aː t s x ʏ l t
staatssecretaris	s t aː t s eː k r ə t aː r ɪ s
stabiel	s t aː b i l
stad	s t ɑ t
stadhouder	s t ɑ t ɦ ɑ u̯ d ə r
stadhuis	s t ɑ t ɦ œ y̯ s
stadsbus	s t ɑ t s b ʏ s
stadscentrum	s t ɑ t s ɛ n t r ʏ m
stadsgezicht	s t ɑ t s x ə z ɪ x t
stadskern	s t ɑ t s k ɛ r n
stadsmuur	s t ɑ t s m yː r
stagiair	s t aː ʒ ɛː r
staken	s t aː k ə n
staking	s t aː k ɪ ŋ
stalen	s t aː l ə n
stam	s t ɑ m
stamboek	s t ɑ m b u k
stamboom	s t ɑ m b oː m
stamhoofd	s t ɑ m ɦ oː f t
stammen	s t ɑ m ə n
stampvol	s t ɑ m p v ɔ l
stamvader	s t ɑ m v aː d ə r
standaard	s t ɑ n d aː r t
standaardwerk	s t ɑ n d aː r t ʋ ɛ r k
standplaats	s t ɑ n d p l a t s
standpunt	s t ɑ n t p ʏ n t
standvastig	s t ɑ n t v ɑ s t i ɡ ə x
stapel	s t aː p ə l
stapelgek	s t aː p ə l ɣ ɛ k
start	s t ɑ r t
starter	s t ɑ r t ə r
startsein	s t ɑ r t s ɛ i̯ n
statief	s t aː t i f
station	s t aː ʃ ɔ n
statuut	s t aː t y t
stavoren	s t aː v oː r ə n
steden	s t eː d ə n
steeg	s t eː x
steek	s t eː k
steel	s t eː l
steen	s t eː n
steenkool	s t eː n k oː l
steenwijk	s t eː n ʋ ɛ i̯ k
stek	s t ɛ k
stekel	s t eː k ə l
stekelhuidige	s t eː k ə l ɦ œ y̯ d ə ɣ ə
steken	s t eː k ə n
stekker	s t ɛ k ə r
stelen	s t eː l ə n
stellen	s t ɛ l ə n
stelling	s t ɛ l ɪ ŋ
stem	s t ɛ m
stembus	s t ɛ m b ʏ s
stemhok	s t ɛ m ɦ ɔ k
stemmen	s t ɛ m ə n
stemming	s t ɛ m ɪ ŋ
stemt	s t ɛ m t
stemwijzer	s t ɛ m ʋ ɛ i̯ z ə r
stengel	s t ɛ ŋ ə l
step	s t ɛ p
ster	s t ɛ r
sterfbed	s t ɛ r f b ɛ t
sterfdag	s t ɛ r f d ɑ x
sterfte	s t ɛ r f t ə
sterk	s t ɛ r k
sterren	s t ɛ r ə n
sterrenkunde	s t ɛ r ə n k ʏ n d ə
sterven	s t ɛ r v ə n
steunen	s t øː n ə n
steven	s t eː v ə n
stevens	s t eː v ə n s
stiekem	s t i k ə m
stier	s t iː r
stijgen	s t ɛ i̯ ɣ ə n
stijn	s t ɛ i̯ n
stijve	s t ɛ i v ə
stilleven	s t ɪ l l eː v ə n
stilstand	s t ɪ l s t ɑ n t
stilte	k ɪ l t ə
stilzwijgen	s t ɪ l z ʋ ɛ i̯ ɣ ə n
stimulans	s t i m y l ɑ n s
stins	s t ɪ n s
stockholm	s t ɔ k ɦ ɔ l m
stoel	s t u l
stoelen	s t u l ə n
stoep	s t u p
stoepa	s t u p aː
stoeterij	s t u t ə r ɛ i̯
stof	s t ɔ f
stoffen	s t ɔ f ə n
stofvrij	s t ɔ f r ɛ i̯
stofwisseling	s t ɔ f ʋ ɪ s ə l ɪ ŋ
stofwolk	s t ɔ f ʋ ɔ l k
stofzuiger	s t ɔ f s œ y̯ ɣ ə r
stok	s t ɔ k
stokbrood	s t ɔ k b r oː t
stoken	s t oː k ə n
stol	s t ɔ l
stollen	s t ɔ l ə n
stom	s t ɔ m
stomen	s t oː m ə n
stomerij	s t oː m ə r ɛ i̯
stomp	s t ɔ m p
stond	s t ɔ n t
stookolie	s t oː k oː l i
stoom	s t oː m
stoombad	s t oː m b ɑ t
stoomboot	s t oː m b oː t
stoomgemaal	s t oː m ɣ ə m aː l
stoomturbine	s t oː m t ʏ r b i n ə
stop	s t ɔ p
stopcontact	s t ɔ p k ɔ n t ɑ k t
stoplicht	s t ɔ p l ɪ x t
storen	s t oː r ə n
storing	s t oː r ɪ ŋ
stork	s t ɔ r k
storm	s t ɔ r m
stormachtig	s t ɔ r m ɑ x t ə x
stormbandpinguïn	s t ɔ r m b ɑ n t p ɪ ŋ ɡ ʋ ɪ n
stort	s t ɔ r t
storten	s t ɔ r t ə n
storting	s t ɔ r t ɪ ŋ
stoten	s t oː t ə n
stout	s t ɑ u̯ t
straaljager	s t r aː l j aː ɣ ə r
straalvinnige	s t r aː l v ɪ n ə ɣ ə
straat	s t r aː t
straatnaam	s t r aː t n aː m
straatsburg	s t r aː t s b ʏ r x
strafbaar	s t r ɑ f b aː r
straffen	s t r ɑ f ə n
strafkamp	s t r ɑ f k ɑ m p
strafrecht	s t r ɑ f r ɛ x t
strafschop	s t r ɑ f s x ɔ p
strafstudie	s t r ɑ f s t y d i
strak	s t r ɑ k
stralen	s t r aː l ə n
strandpaviljoen	s t r ɑ n t p aː v ɪ l j u n
stream	s t r iː m
streek	s t r eː k
streep	s t r eː p
strekken	s t r ɛ k ə n
streng	s t r ɛ ŋ
strepen	s t r eː p ə n
streven	s t r eː v ə n
striep	s t r i p
strijden	s t r ɛ i̯ d ə n
strijdtoneel	s t r ɛ i̯ t oː n eː l
strijken	s t r ɛ i̯ k ə n
stripboek	s t r ɪ p b u k
stripfiguur	s t r ɪ p f i ɣ yː r
strippenkaart	s t r ɪ p ə n k aː r t
stromen	s t r oː m ə n
stront	s t r ɔ n t
strontium	s t r ɔ n t s i ʏ m
strooien	s t r oː i̯ ə n
strook	s t r oː k
stroom	s t r oː m
stroop	s t r oː p
strop	s t r ɔ p
stropen	s t r oː p ə n
stropop	s t r oː p ɔ p
strot	s t r ɔ t
structuur	s t r ʏ k t y r
struikelen	s t r œ y̯ k ə l ə n
studeerkamer	s t y d eː r k aː m ə r
studeren	s t y d eː r ə n
studie	s t y d i
studio	s t y d i oː
stug	s t ʏ x
stuifsneeuw	s t œ y̯ f s n eː u̯
stuk	s t ʏ k
sturen	s t y r ə n
stuur	s t y r
stuurbekrachtiging	s t yː r b ə k r ɑ x t ə ɣ ɪ ŋ
stuurhut	s t yː r ɦ ʏ t
stuurwiel	s t yː r ʋ i l
stylus	s t i l ʏ s
substantie	s ʏ b s t ɑ n s i
sudderen	s ʏ d ə r ə n
sufferd	s ʏ f ə r t
suiker	s œ y̯ k ə r
suikerpatiënt	s œ y̯ k ə r p aː ʃ ɛ n t
suikerziekte	s œ y̯ k ə r z i k t ə
sultan	s ʏ l t ɑ n
sumatra	s y m aː t r aː
superheld	s y p ə r ɦ ɛ l t
superieur	s y p eː r i øː r
supermarkt	s y p ə r m ɑ r k t
supplement	s ʏ p l ə m ɛ n t
suppletie	s ʏ p l eː t s i
supporter	s ʏ p ɔ r t ə r
supporters	s ʏ p ɔ r t ə r s
surinaams	s y r i n aː m s
suriname	s y r i n aː m ə
surinamer	s y r i n aː m ə r
surprise	s ʏ r p r iː z ə
sushi	s u ʃ i
suspensie	s ʏ s p ɛ n s i
sven	s ʋ ɛ n
swingen	s ʋ ɪ ŋ ə n
symboliek	s ɪ m b oː l i k
symbool	s ɪ m b oː l
synagoge	s i n aː ɣ oː ɣ ə
syndroom	s ɪ n d r oː m
synthese	s ɪ n t eː z ə
synthetisch	s ɪ n t eː t i s
syrinx	s iː r ɪ ŋ k s
taak	t aː k
taakstraf	t aː k s t r ɑ f
taal	t aː l
taalfilosofie	t aː l f i l oː s oː f i
taalgebied	t aː l ɣ ə b i t
taalgrens	t aː l ɣ r ɛ n s
taalwetenschap	t aː l ʋ eː t ə n s x ɑ p
tabak	t aː b ɑ k
tabblad	t ɑ b l ɑ t
tabel	t aː b ɛ l
taboe	t aː b u
tachtig	t ɑ x t ə x
tafel	t aː f ə l
tafeltennis	t aː f ə l t ɛ n ɪ s
tafelzilver	t aː f ə l z ɪ l v ə r
taille	t ɑ j ə
tak	t ɑ k
taken	t aː k ə n
taks	t ɑ k s
talen	t aː l ə n
talent	t aː l ɛ n t
tam	t ɑ m
tamboer	t ɑ m b uː r
tamelijk	t aː m ə l ə k
tamil	t aː m i l
tand	t ɑ n t
tandarts	t ɑ n d ɑ r t s
tandem	t ɑ n d ɛ m
tanden	t ɑ n d ə n
tandheelkunde	t ɑ n t ɦ eː l k ʏ n d ə
tandpasta	t ɑ n t p ɑ s t aː
tandplak	t ɑ n t p l ɑ k
tandsteen	t ɑ n t s t eː n
tandvlees	t ɑ n t f l eː s
tang	t ɑ ŋ
tango	t ɑ ŋ ɡ oː
tanker	t ɛ ŋ k ə r
tante	t ɑ n t ə
tap	t ɑ p
tapijt	t aː p ɛ i̯ t
tapir	t aː p i r
tarief	t aː r i f
tas	t ɑ s
tatoeëren	t ɑ t u eː r ə n
taugé	t ɑ u̯ ɡ eː
taxi	t ɑ k s i
te	t ə
team	t iː m
teamwerk	t iː m ʋ ɛ r k
technicus	t ɛ x n i k ʏ s
teef	t eː f
teelt	t eː l t
teen	t eː n
tegelen	t eː ɣ ə l ə n
tegen	t eː ɣ ə n
tegenaan	t eː ɣ ə n aː n
tegenaanval	t eː ɣ ə n aː n v ɑ l
tegengif	t eː ɣ ə n ɣ ɪ f
tegenover	t eː ɣ ə n oː v ə r
tegenovergestelde	t eː ɣ ə n oː v ə r ɣ ə s t ɛ l d ə
tegenpartij	t eː ɣ ə n p ɑ r t ɛ i̯
tegenspeler	t eː ɣ ə n s p eː l ə r
tegenspoed	t eː ɣ ə n s p u t
tegenwerpen	t eː ɣ ə n ʋ ɛ r p ə n
tegenwicht	t eː ɣ ə n ʋ ɪ x t
tehuis	t ə ɦ œ y̯ s
tekenaar	t eː k ə n aː r
tekenen	t eː k ə n ə n
tekenfilm	t eː k ə n f ɪ l m
tekort	t ə k ɔ r t
tekst	t ɛ k s t
telefonisch	t eː l ə f oː n i s
telefoon	t eː l ə f oː n
telefoongesprek	t eː l ə f oː n ɣ ə s p r ɛ k
telefoongids	t eː l ə f oː n ɣ ɪ t s
telefoonnummer	t eː l ə f oː n ʏ m ə r
telegraaf	t eː l ə ɣ r aː f
telegram	t eː l ə ɡ r ɑ m
telen	t eː l ə n
teletekst	t eː l ə t ɛ k s t
teleurstellen	t ə l øː r s t ɛ l ə n
televisie	t eː l ə v i z i
telg	t ɛ l x
tempel	t ɛ m p ə l
tempelman	t ɛ m p ə l m ɑ n
temperatuur	t ɛ m p ə r aː t yː r
ten	t ɛ n
tenach	t ə n ɑ x
teneinde	t ɛ n ɛ i̯ n d ə
tenen	t eː n ə n
tennis	t ɛ n ə s
tennisbaan	t ɛ n ə s b aː n
tennissen	t ɛ n ɪ s ə n
tennisser	t ɛ n ɪ s ə r
tent	t ɛ n t
tepel	t eː p ə l
terdege	t ɛ r d eː ɣ ə
terechtstelling	t ə r ɛ x t s t ɛ l ɪ ŋ
terloops	t ɛ r l oː p s
termen	t ɛ r m ə n
territorium	t ɛ r ɪ t oː r i ʏ m
terrorisme	t ɛ r ɔ r ɪ s m ə
terschelling	t ɛ r s x ɛ l ɪ ŋ
teruggaan	t ə r ʏ x aː n
test	t ɛ s t
testament	t ɛ s t a m ɛ n t
teug	t øː x
teun	t øː n
teveel	t ə v eː l
teweegbrengen	t ə ʋ eː x b r ɛ ŋ ə n
texas	t ɛ k s ɑ s
texel	t ɛ s ə l
thai	t ɑ i̯
thailand	t ɑ i l ɑ n t
thans	t ɑ n s
theater	t eː j aː t ə r
thee	t eː
theetuin	t eː t œ y̯ n
theo	t eː j oː
theorie	t eː oː r i
thermodynamisch	t ɛ r m oː d i n aː m i s
thomas	t oː m ɑ s
thorn	t ɔ r n
thuis	t œ y̯ s
thuisfront	t œ y̯ s f r ɔ n t
thuisgevoel	t œ y̯ s x ə v u l
thuiskomst	t œ y̯ s k ɔ m s t
ticket	t ɪ k ə t
tiel	t i l
tien	t i n
tiende	t i n d ə
tienjarig	t i n j aː r ə x
tij	t ɛ i̯
tijd	t ɛ i̯ t
tijdens	t ɛ i̯ d ə n s
tijdgenoot	t ɛ i̯ t x ə n oː t
tijdperk	t ɛ i̯ t p ɛ r k
tijdschema	t ɛ i̯ t s x eː m aː
tijdschrift	t ɛ i̯ t s x r ɪ f t
tijdsduur	t ɛ i̯ t s d yː r
tijdstip	t ɛ i̯ t s t ɪ p
tikken	t ɪ k ə n
tilburg	t ɪ l b ʏ r x
tim	t ɪ m
timing	t ɑ i̯ m ɪ ŋ
timmer	t ɪ m ə r
timmeren	t ɪ m ə r ə n
timmerman	t ɪ m ə r m ɑ n
tin	t ɪ n
tintelfris	t ɪ n t ə l f r ɪ s
tobben	t ɔ b ə n
toch	t ɔ x
tocht	t ɔ x t
tochtgenoot	t ɔ x t x ə n oː t
toe	t u
toekan	t u k ɑ n
toekomst	t u k ɔ m s t
toekomstige	t u k ɔ m s t ə ɣ ə
toendra	t u n d r aː
toenemen	t u n eː m ə n
toeren	t uː r ə n
toerisme	t u r ɪ s m ə
toerist	t u r ɪ s t
toeslaan	t u s l aː n
toeslag	t u s l ɑ x
toespraak	t u s p r aː k
toetreding	t u t r eː d ɪ ŋ
toets	t u t s
toetsenbord	t u t s ə n b ɔ r t
toeval	t uː v ɑ l
toeven	t u v ə n
toevlucht	t u v l ʏ x t
toevluchtsoord	t u v l ʏ x t s oː r t
toevoegen	t u v u ɣ ə n
toewijding	t u ʋ ɛ i̯ d ɪ ŋ
toezicht	t u z ɪ x t
toilet	t ʋ aː l ɛ t
tokio	t oː k i j oː
toko	t oː k oː
tol	t ɔ l
tolheffing	t ɔ l ɦ ɛ f ɪ ŋ
tolhuis	t ɔ l ɦ œ y̯ s
tolken	t ɔ l k ə n
tolweg	t ɔ l ʋ ɛ x
tomaat	t oː m aː t
tomatensaus	t oː m aː t ə n s ɑ u̯ s
ton	t ɔ n
toneel	t oː n eː l
toneelspeler	t oː n eː l s p eː l ə r
tonen	t oː n ə n
tong	t ɔ ŋ
tongen	t ɔ ŋ ə n
toog	t oː x
tool	t uː l
toon	t oː n
toonbank	t oː n b ɑ ŋ k
toonbeeld	t oː n b eː l t
toonsoort	t oː n s oː r t
topless	t ɔ p l ə s
topman	t ɔ p m ɑ n
topoi	t o p ɔ ɪ
topper	t ɔ p ə r
topprioriteit	t ɔ p p r i oː r i t ɛ i̯ t
topscoorder	t ɔ p s k oː r d ə r
tora	t oː r aː
torsen	t ɔ r s ə n
tosti	t ɔ s t i
tot	t ɔ t
totdat	t ɔ t d ɑ t
touw	t ɑ u̯
toveren	t oː v ə r ə n
toverspreuk	t oː v ə r s p r øː k
traag	t r aː x
trachten	t r ɑ x t ə n
traditie	t r aː d i t s i
traditiegetrouw	t r aː d i t s i ɣ ə t r ɑ u̯
tragisch	t r aː ɣ i s
tragische	t r aː ɣ i s ə
training	t r eː n ɪ ŋ
transformatie	t r ɑ n s f ɔ r m aː t s i
trap	t r ɑ p
trappen	t r ɑ p ə n
trechter	t r ɛ x t ə r
trede	t r eː d ə
treden	t r eː d ə n
tree	t r eː
treffen	t r ɛ f ə n
treffer	t r ɛ f ə r
trein	t r ɛ i̯ n
trek	t r ɛ k
trekhaak	t r ɛ k ɦ aː k
trend	t r ɛ n t
treur	t r øː r
trijntje	t r ɛ i̯ n j t j ə
trillen	t r ɪ l ə n
trilling	t r ɪ l ɪ ŋ
triton	t r i t ɔ n
troef	t r u f
troep	t r u p
troeteldier	t r u t ə l d iː r
trok	t r ɔ k
trollen	t r ɔ l ə n
trombone	t r ɔ m b ɔː n ə
trombose	t r ɔ m b oː z ə
tromp	t r ɔ m p
trompet	t r ɔ m p ɛ t
trompetter	t r ɔ m p ɛ t ə r
troon	t r oː n
troonsafstand	t r oː n s ɑ f s t ɑ n t
troost	t r oː s t
trossen	t r ɔ s ə n
trouw	t r ɑ u̯
trouwen	t r ɑ u̯ ə n
truc	t r y k
trui	t r œ y̯
tsaar	t s aː r
tsarina	t s aː r i n aː
tsjechië	t ʃ ɛ x i j ə
tsunami	t s u n aː m i
tuig	t œ y̯ x
tuigleer	t œ y̯ x l eː r
tuinbouw	t œ y̯ n b ɑ u̯
tuinen	t œ y̯ n ə n
tuinkers	t œ y̯ ŋ k ɛ r s
tuinman	t œ y̯ n m ɑ n
tulp	t ʏ l p
tumor	t y m ɔ r
tuniek	t y n i k
tunnel	t ʏ n ə l
turbulentie	t ʏ r b y l ɛ n s i
tureluur	t yː r ə l yː r
turijn	t y r ɛ i̯ n
tussen	t ʏ s ə n
tussenruimtetjes	t ʏ s ə n r œ y̯ m t ə t j ə s
tussenstop	t ʏ s ə n s t ɔ p
twaalf	t ʋ aː l ə f
twaalfde	t ʋ aː l f d ə
twee	t ʋ eː
tweede	t ʋ eː d ə
tweedejaars	t ʋ eː d ə j aː r s
tweehonderd	t ʋ eː ɦ ɔ n d ə r t
tweepersoonsbed	t ʋ eː p ɛ r s oː n s b ɛ t
twente	t ʋ ɛ n t ə
twijfel	t ʋ ɛ i̯ f ə l
twijfelen	t ʋ ɛ i̯ f ə l ə n
twintig	t ʋ ɪ n t ə x
twintigste	t ʋ ɪ n t ə x s t ə
twisten	t ʋ ɪ s t ə n
typen	t i p ə n
typesoort	t i p ə s oː r t
typisch	t i p i s
ui	œ y̯
uil	œ y̯ l
uit	œ y̯ t
uitbarsting	œ y̯ t b ɑ r s t ɪ ŋ
uitblijven	œ y̯ d b l ɛ i̯ v ə n
uitbraak	œ y̯ t b r aː k
uitbreiding	œ y̯ t b r ɛ i̯ d ɪ ŋ
uitbreidingspakket	œ y̯ t b r ɛ i̯ d ɪ ŋ s p ɑ k ɛ t
uitbuiten	œ y̯ t b œ y̯ t ə n
uitbuiting	œ y̯ t b œ y̯ t ɪ ŋ
uitdaging	œ y̯ t d aː ɣ ɪ ŋ
uitdragen	œ y̯ d r aː ɣ ə n
uitdrukken	œ y̯ d r ʏ k ə n
uitdrukking	œ y̯ t d r ʏ k ɪ ŋ
uitdunnen	œ y̯ d ʏ n ə n
uiterst	œ y̯ t ə r s t
uiterwaard	œ y̯ t ə r ʋ aː r t
uitgebaat	œ y̯ t x ə b aː t
uitgedrukt	œ y̯ t x ə d r ʏ k t
uitgekookt	œ y̯ t x ə k oː k t
uitgeleverd	œ y̯ t x ə l eː v ə r t
uitgescheiden	œ y̯ t x ə s x ɛ i̯ d ə n
uitgesproken	œ y̯ t x ə s p r oː k ə n
uitgestoken	œ y̯ t x ə s t oː k ə n
uitgeven	œ y̯ t ɣ eː v ə n
uitgever	œ y̯ t x eː v ə r
uitgeverij	œ y̯ t x eː v ə r ɛ i̯
uitgezet	œ y̯ t x ə z ɛ t
uitgroeien	œ y̯ t ɣ r u i̯ ə n
uithangbord	œ y̯ t ɦ ɑ ŋ b ɔ r t
uithoek	œ y̯ t ɦ u k
uiting	œ y̯ t ɪ ŋ
uitkering	œ y̯ t k eː r ɪ ŋ
uitkijk	œ y̯ t k ɛ i̯ k
uitkomen	œ y̯ t k oː m ə n
uitkomst	œ y̯ t k ɔ m s t
uitleg	œ y̯ t l ɛ x
uitleggen	œ y̯ t l ɛ ɣ ə n
uitloper	œ y̯ t l oː p ə r
uitmaken	œ y̯ t m aː k ə n
uitnodiging	œ y̯ t n oː d ə ɣ ɪ ŋ
uitpakken	œ y̯ t p ɑ k ə n
uitrekenen	œ y̯ t r eː k ə n ə n
uitscheiden	œ y̯ t s x ɛ i̯ d ə n
uitslag	œ y̯ t s l ɑ x
uitspraak	œ y̯ t s p r aː k
uitstapje	œ y̯ t s t ɑ p j ə
uitstekende	œ y̯ t s t eː k ə n d ə
uitstel	œ y̯ t s t ɛ l
uitte	œ y̯ t ə
uitvechten	œ y̯ t f ɛ x t ə n
uitvergroot	œ y̯ t f ə r ɣ r oː t
uitverkocht	œ y̯ t f ə r k ɔ x t
uitverkoop	œ y̯ t f ə r k oː p
uitzichtloos	œ y̯ t z ɪ x t l oː s
uitzien	œ y̯ t s i n
uitzitten	œ y̯ t s ɪ t ə n
uitzondering	œ y̯ t s ɔ n d ə r ɪ ŋ
ultimatum	ʏ l t i m aː t ʏ m
unaniem	y n aː n i m
unie	y n i
uniform	y n i f ɔ r m
universeel	y n i v ɛ r z eː l
universitair	y n i v ɛ r z i t ɛː r
universiteit	y n i v ɛ r z i t ɛ i̯ t
universiteitsbibliotheek	y n i v ɛ r z i t ɛ i̯ t s b i b l i oː t eː k
universiteitsstad	y n i v ɛ r z i t ɛ i̯ t s t ɑ t
universum	y n i v ɛ r z ʏ m
update	ʏ p d eː t
updaten	ʏ p d eː t ə n
upgrade	ʏ p ɡ r ɛ i̯ t
upgraden	ʏ p ɡ r eː d ə n
upload	ʏ p l oː t
uploaden	ʏ p l oː d ə n
uranium	y r aː n i ʏ m
uren	y r ə n
urenlang	yː r ə n l ɑ ŋ
urine	y r i n ə
uur	y r
uva	y v aː
uw	y u̯
uwe	y u̯ ə
vaag	v aː x
vaak	v aː k
vaal	v aː l
vaardig	v aː r d ə x
vaart	v aː r t
vaarwel	v aː r ʋ ɛ l
vaas	v aː s
vaatwasser	v aː t ʋ ɑ s ə r
vacht	v ɑ x t
vader	v aː d ə r
vaderland	v aː d ə r l ɑ n t
vadermoord	v aː d ə r m oː r t
vagina	v aː ɣ i n aː
vak	v ɑ k
vakantie	v aː k ɑ n t s i
vakantieganger	v aː k ɑ n t s i ɣ ɑ ŋ ə r
vakantiehuis	v aː k ɑ n t s i ɦ œ y̯ s
vakbond	v ɑ k b ɔ n t
vakgebied	v ɑ k x ə b i t
vakkenvuller	v ɑ k ə n v ʏ l ə r
vakman	v ɑ k m ɑ n
vakmanschap	v ɑ k m ɑ n s x ɑ p
val	v ɑ l
valk	v ɑ l k
vallen	v ɑ l ə n
valt	v ɑ l t
valuta	v aː l y t aː
van	v ɑ n
vanavond	v ɑ n aː v ɔ n t
vandaag	v ɑ n d aː x
vandalisme	v ɑ n d aː l ɪ s m ə
vangen	v ɑ ŋ ə n
vangrail	v ɑ ŋ r eː l
vangst	v ɑ ŋ s t
vangt	v ɑ ŋ t
vannacht	v ɑ n ɑ x t
vanwaar	v ɑ n ʋ aː r
vanwege	v ɑ n ʋ eː ɣ ə
vanzelfsprekend	v ɑ n z ɛ l f s p r eː k ə n t
vara	v aː r aː
varen	v aː r ə n
variant	v aː r i ɑ n t
variatie	v aː r i aː t s i
varken	v ɑ r k ə n
varkensgriep	v ɑ r k ə n s x r i p
vast	v ɑ s t
vastleggen	v ɑ s t l ɛ ɣ ə n
vaststellen	v ɑ s s t ɛ l ə n
vat	v ɑ t
vatbaar	v ɑ t b aː r
vaticaan	v aː t i k aː n
vaticaans	v aː t i k aː n s
vatten	v ɑ t ə n
vazen	v aː z ə n
vecht	v ɛ x t
vechten	v ɛ x t ə n
vechtpartij	v ɛ x t p ɑ r t ɛ i̯
veder	v eː d ə r
vederlicht	v eː d ə r l ɪ x t
vee	v eː
veeg	v eː x
veegt	v eː x t
veel	v eː l
veelbelovend	v eː l b ə l oː v ə n t
veeleer	v eː l eː r
veelhoek	v eː l ɦ u k
veelvoud	v eː l v ɑ u̯ t
veendam	v eː n d ɑ m
veenendaal	v eː n ə n d aː l
veere	v eː r ə
veerman	v eː r m ɑ n
veertien	v eː r t i n
veertiende	v eː r t i n d ə
veestapel	v eː s t aː p ə l
vega	v eː ɣ aː
vegetarisch	v eː ɣ ə t aː r i s
vegetatie	v eː ɣ ə t aː t s i
veghel	v ɛ x ə l
veiligheid	v ɛ i̯ l ə x ɦ ɛ i̯ t
veiling	v ɛ i̯ l ɪ ŋ
vel	v ɛ l
veldtocht	v ɛ l t ɔ x t
vele	v eː l ə
velen	v eː l ə n
vellen	v ɛ l ə n
velsen	v ɛ l z ə n
ven	v ɛ n
venkel	v ɛ ŋ k ə l
venlo	v ɛ n l oː
vennootschap	v ɛ n oː t s x ɑ p
vennootschapsbelasting	v ɛ n oː t s x ɑ p s b ə l ɑ s t ɪ ŋ
venster	v ɛ n s t ə r
vensterbank	v ɛ n s t ə r b ɑ ŋ k
ventiel	v ɛ n t i l
ventilator	v ɛ n t i l aː t ɔ r
ver	v ɛ r
veranda	v ə r ɑ n d aː
verantwoordelijk	v ə r ɑ n t ʋ oː r d ə l ə k
verantwoorden	v ə r ɑ n t ʋ oː r d ə n
verbaal	v ɛ r b aː l
verbinden	v ə r b ɪ n d ə n
verbod	v ə r b ɔ t
verder	v ɛ r d ə r
verdichtsel	v ɛ r d ɪ x t s ə l
verdieping	v ɛ r d i p ɪ ŋ
verdwaald	v ə r d ʋ aː l t
verenigd	v ə r eː n ɪ x t
verenigde	v ə r eː n ɪ ɣ d ə
verf	v ɛ r f
verfoeilijk	v ə r f u j l ə k
vergaren	v ə r ɣ aː r ə n
vergrootglas	v ə r ɣ r oː t x l ɑ s
verkalken	v ə r k ɑ l k ə n
verkeerd	v ə r k eː r t
verkeerde	v ə r k eː r d ə
verkoopprijs	v ɛ r k oː p r ɛ i̯ s
verkoopt	v ə r k oː p t
verkopen	v ə r k oː p ə n
verkracht	v ə r k r ɑ x t
verkrachten	v ə r k r ɑ x t ə n
verkrachting	v ə r k r ɑ x t ɪ ŋ
verkrachtingen	v ə r k r ɑ x t ɪ ŋ ə n
verkrachtte	v ə r k r ɑ x t ə
verkrachtten	v ə r k r ɑ x t ə n
verlaat	v ə r l aː t
verleiding	v ə r l ɛ i d ɪ ŋ
verliest	v ə r l i s t
verlof	v ə r l ɔ f
verloor	v ə r l oː r
verloren	v ə r l oː r ə n
vermogen	v ə r m oː ɣ ə n
vernietigen	v ə r n i t ə ɣ ə n
veroorzaken	v ə r oː r z aː k ə n
verraad	v ə r aː t
verre	v ɛ r ə
verrekijker	v ɛ r ə k ɛ i̯ k ə r
verrichten	v ə r ɪ x t ə n
verschillend	v ə r s x ɪ l ə n t
verschonen	v ə r s x oː n ə n
verschoven	v ə r s x oː v ə n
verschrikkelijk	v ə r s x r ɪ k ə l ə k
verschuift	v ə r s x œ y̯ f t
verschuiven	v ə r s x œ y̯ v ə n
versie	v ɛ r z i
verslag	v ə r s l ɑ x
verslaggever	v ə r s l ɑ x ɣ eː v ə r
verslinden	v ə r s l ɪ n d ə n
verspillen	v ɛ r s p ɪ l ə n
verspilling	v ə r s p ɪ l ɪ ŋ
vertaalwoordenboekjes	v ə r t aː l ʋ oː r d ə n b u k j ə s
vertellen	v ə r t ɛ l ə n
vertelling	v ə r t ɛ l ɪ ŋ
vertier	v ə r t i r
vertoog	v ɛ r t oː x
vertrekt	v ə r t r ɛ k t
vertroebelen	v ə r t r u b ə l ə n
vertrouwen	v ə r t r ɑ u̯ ə n
vervaldatum	v ə r v ɑ l d aː t ʏ m
vervangen	v ə r v ɑ ŋ ə n
vervelend	v ə r v eː l ə n t
verven	v ɛ r v ə n
vervlieten	v ə r v l i t ə n
vervoer	v ə r v u r
vervroegd	v ɛ r v r u x t
vervuiling	v ə r v œ y̯ l ɪ ŋ
verwelkomen	v ə r ʋ ɛ l k oː m ə n
verwennen	v ə r ʋ ɛ n ə n
verwerken	v ə r ʋ ɛ r k ə n
verzamelaar	v ə r z aː m ə l aː r
verzendkosten	v ə r z ɛ n t k ɔ s t ə n
verzorgingsstaat	v ə r z ɔ r ɣ ɪ ŋ s s t aː t
verzuipen	v ə r z œ y̯ p ə n
vest	v ɛ s t
vesten	v ɛ s t ə n
vestigen	v ɛ s t ə ɣ ə n
vestiging	v ɛ s t ə ɣ ɪ ŋ
vesting	v ɛ s t ɪ ŋ
vestingstad	v ɛ s t ɪ ŋ s t ɑ t
vet	v ɛ t
vete	v eː t ə
vette	v ɛ t ə
vetzuur	v ɛ t z y r
veulen	v øː l ə n
vianen	v i aː n ə n
vicepresident	v i s ə p r eː s i d ɛ n t
video	v i d i oː
videotheek	v i d i oː t eː k
vierdaags	v iː r d aː x s
vierendertig	v iː r ɛ n d ɛ r t ə x
vierentwintig	v iː r ɛ n t ʋ ɪ n t ə x
vierhonderd	v iː r ɦ ɔ n d ə r t
viering	v i r ɪ ŋ
vierkant	v iː r k ɑ n t
vietnam	v j ɛ t n ɑ m
vijand	v ɛ i̯ ɑ n t
vijf	v ɛ i̯ f
vijfde	v ɛ i̯ f d ə
vijfendertig	v ɛ i̯ f ɛ n d ɛ r t ə x
vijfentwintig	v ɛ i̯ f ɛ n t ʋ ɪ n t ə x
vijfenveertig	v ɛ i̯ f ə n v eː r t ə x
vijftien	v ɛ i̯ f t i n
vijftiende	v ɛ i̯ f t i n d ə
vijs	v ɛ i̯ s
vijver	v ɛ i̯ v ə r
vijzel	v ɛ i̯ z ə l
viking	v i k ɪ ŋ
vinden	v ɪ n d ə n
vinder	f ɪ n d ə r
vinger	v ɪ ŋ ə r
vingeren	v ɪ ŋ ə r ə n
vingers	v ɪ ŋ ə r s
vinoloog	v i n oː l oː x
violen	v i j oː l ə n
viool	v i j oː l
virtuoos	v ɪ r t y oː s
virus	v iː r ʏ s
virusremmer	v iː r ʏ s r ɛ m ə r
vis	v ɪ s
visa	v i z aː
visie	v i z i
vissen	v ɪ s ə n
visser	v ɪ s ə r
vissers	v ɪ s ə r s
visum	v i z ʏ m
vitaal	v i t aː l
vitamine	v i t aː m i n ə
vitrine	v i t r i n ə
vlaai	v l aː i̯
vlaams	v l aː m s
vlaanderen	v l aː n d ə r ə n
vlaardingen	v l aː r d ɪ ŋ ə n
vlakte	v l ɑ k t ə
vlam	v l ɑ m
vlaming	v l aː m ɪ ŋ
vledder	v l ɛ d ə r
vleermuis	v l eː r m œ y̯ s
vlees	v l eː s
vlekken	v l ɛ k ə n
vleugel	v l øː ɣ ə l
vleugeltip	v l øː ɣ ə l t ɪ p
vlieg	v l i x
vliegbasis	v l i x b aː z ɪ s
vliegen	v l i ɣ ə n
vliegende	v l i ɣ ə n d ə
vliegt	v l i x t
vliegtuig	v l i x t œ y̯ x
vliegveld	v l iː x f ɛ l t
vlieland	v l i l ɑ n t
vliering	v l iː r ɪ ŋ
vliet	v l i t
vlinder	v l ɪ n d ə r
vloed	v l u t
vloedgolf	v l u t x ɔ l f
vloeien	v l u i̯ ə n
vloer	v l u r
vloerbedekking	v l uː r b ə d ɛ k ɪ ŋ
vlonder	v l ɔ n d ə r
vloot	v l oː t
vlot	v l ɔ t
vlucht	v l ʏ x t
vluchteling	v l ʏ x t ə l ɪ ŋ
vocabulaire	v oː k aː b y l ɛː r
vocht	v ɔ x t
vochten	v ɔ x t ə n
vochtig	v ɔ x t ə x
vochtigheid	v ɔ x t ə x ɦ ɛ i̯ t
voeding	v u d ɪ ŋ
voedsel	v u t s ə l
voeg	v u x
voegen	v u ɣ ə n
voelen	v u l ə n
voer	v uː r
voeren	v uː r ə n
voet	v u t
voetafdruk	v u t ɑ f d r ʏ k
voetbal	v u t b ɑ l
voetbalclub	v u t b ɑ l k l ʏ p
voetballen	v u t b ɑ l ə n
voetballer	v u t b ɑ l ə r
voetbalveld	v u t b ɑ l v ɛ l t
voeten	v u t ə n
voetganger	v u t x ɑ ŋ ə r
voetnoot	v u t n oː t
vogel	v oː ɣ ə l
vogelaar	v oː ɣ ə l aː r
vogeltrek	v oː ɣ ə l t r ɛ k
vogelvlucht	v oː ɣ ə l v l ʏ x t
vogelvrij	v oː ɣ ə l v r ɛ i̯
vol	v ɔ l
volg	v ɔ l x
volgen	v ɔ l ɣ ə n
volgende	v ɔ l ɣ ə n d ə
volharding	v ɔ l ɦ ɑ r d ɪ ŋ
volkerenmoord	v ɔ l k ə r ə n m oː r t
volkslied	v ɔ l k s l i t
volkstelling	v ɔ l k s t ɛ l ɪ ŋ
volksuniversiteit	v ɔ l k s y n i v ɛ r z i t ɛ i̯ t
volksvertegenwoordiger	v ɔ l k s f ə r t eː ɣ ə n ʋ oː r d ə ɣ ə r
voller	v ɔ l ə r
voltallig	v ɔ l t ɑ l ə x
voltrekken	v ɔ l t r ɛ k ə n
vond	v ɔ n t
vondst	v ɔ n t s t
vonk	v ɔ ŋ k
vonkelwijn	v ɔ ŋ k ə l ʋ ɛ i̯ n
voor	v oː r
vooral	v oː r ɑ l
voorarrest	v oː r ɑ r ɛ s t
vooravond	v oː r aː v ɔ n t
voorbaat	v oː r b aː t
voorbeeld	v oː r b eː l t
voorbehouden	v oː r b ə ɦ ɑ u̯ d ə n
voorbij	v oː r b ɛ i̯
voorbijgaan	v oː r b ɛ i̯ ɣ aː n
voorbode	v oː r b oː d ə
voorburg	v oː r b ʏ r x
voordeur	v oː r d øː r
voordoen	v oː r d u n
voordragen	v oː r d r aː ɣ ə n
voorhoofd	v oː r ɦ oː f t
voorkomen	v oː r k oː m ə n
voorkomende	v oː r k oː m ə n d ə
voorlader	v oː r l aː d ə r
voorlezen	v oː r l eː z ə n
voorlichten	v oː r l ɪ x t ə n
voorlichter	v oː r l ɪ x t ə r
voorlichting	v oː r l ɪ x t ɪ ŋ
voorliefde	v oː r l i f d ə
voormiddag	v oː r m ɪ d ɑ x
voornaam	v oː r n aː m
voornemen	v oː r n eː m ə n
voorouder	v oː r ɑ u̯ d ə r
voorraad	v oː r aː t
voorrang	v oː r ɑ ŋ
voorschrift	v oː r s x r ɪ f t
voorschrijven	v oː r s x r ɛ i̯ v ə n
voorspoed	v oː r s p u t
voorspoedig	v oː r s p u d ə x
voorsprong	v oː r s p r ɔ ŋ
voorstaan	v oː r s t aː n
voorstad	v oː r s t ɑ t
voorste	v ɔː r s t ə
voorstel	v oː r s t ɛ l
voorstellen	v oː r s t ɛ l ə n
voorstelling	v oː r s t ɛ l ɪ ŋ
voort	v oː r t
voortaan	v oː r t aː n
voortplanting	v oː r t p l ɑ n t ɪ ŋ
voortslepen	v oː r t s l eː p ə n
voortvluchtig	v oː r t f l ʏ x t ə x
voortvluchtige	v oː r t f l ʏ x t ə ɣ ə
vooruit	v oː r œ y̯ t
vooruitgang	v oː r œ y̯ t x ɑ ŋ
vooruitzicht	v oː r œ y̯ t s ɪ x t
voorvader	v oː r v aː d ə r
voorvaderlijk	v oː r v aː d ə r l ə k
voorval	v oː r v ɑ l
voorvork	v oː r v ɔ r k
voorwaar	v oː r ʋ aː r
voorwaardelijk	v oː r ʋ aː r d ə l ə k
voorwerp	v oː r ʋ ɛ r p
voorwoord	v oː r ʋ oː r t
voorzeggen	v oː r z ɛ ɣ ə n
voorzetten	v oː r z ɛ t ə n
voorzitster	v oː r z ɪ t s t ə r
voren	v oː r ə n
vorm	v ɔ r m
vormen	v ɔ r m ə n
vormsel	v ɔ r m s ə l
vorst	v ɔ r s t
vorstelijk	v ɔ r s t ə l ə k
vorstendom	v ɔ r s t ə n d ɔ m
vorstenhuis	v ɔ r s t ə n ɦ œ y̯ s
vorstin	v ɔ r s t ɪ n
vos	v ɔ s
vossen	v ɔ s ə n
vouwen	v ɑ u̯ ə n
vouwfiets	v ɑ u̯ f i t s
vraag	v r aː x
vraagprijs	v r aː x p r ɛ i̯ s
vraagstuk	v r aː x s t ʏ k
vraagt	v r aː x t
vraagteken	v r aː x t eː k ə n
vrachtwagen	v r ɑ x t ʋ aː ɣ ə n
vragen	v r aː ɣ ə n
vrede	v r eː d ə
vredesmacht	v r eː d ə s m ɑ x t
vredesmissie	v r eː d ə s m ɪ s i
vredig	v r eː d ə x
vreemd	v r eː m t
vrees	v r eː s
vreten	v r eː t ə n
vreugdedans	v r øː x d ə d ɑ n s
vrezen	v r eː z ə n
vriendelijk	v r i n d ə l ə k
vrienden	v r i n d ə n
vriendschap	v r i n t s x ɑ p
vrij	v r ɛ i
vrijbuiter	v r ɛ i̯ b œ y̯ t ə r
vrijen	v r ɛ i̯ ə n
vrijgevigheid	v r ɛ i̯ ɣ eː v ə x ɦ ɛ i̯ t
vrijgezellenfeest	v r ɛ i̯ ɣ ə z ɛ l ə n f eː s t
vrijheid	v r ɛ i ɦ ɛ i̯ t
vrijmarkt	v r ɛ i̯ m ɑ r k t
vrijplaats	v r ɛ i̯ p l aː t s
vrijspraak	v r ɛ i̯ s p r aː k
vrijwel	v r ɛ i̯ ʋ ɛ l
vrijwilliger	v r ɛ i̯ ʋ ɪ l ə ɣ ə r
vrijwilligerswerk	v r ɛ i̯ ʋ ɪ l ə ɣ ə r s ʋ ɛ r k
vroeg	v r u x
vroeger	v r u ɣ ə r
vroeggeboorte	v r u x ə b oː r t ə
vrouw	v r ɑ u̯
vrouwelijk	v r ɑ u̯ ə l ə k
vrouwen	v r ɑ u̯ ə n
vruchtwater	v r ʏ x t ʋ aː t ə r
vsa	v eː ɛ s aː
vught	v ʏ x t
vuil	v œ y̯ l
vuilnis	v œ y̯ l n ɪ s
vulgaat	v ʏ l ɣ aː t
vulkaan	v ʏ l k aː n
vulpen	v ʏ l p ɛ n
vuren	v y r ə n
vuur	v y r
vuurdoop	v yː r d oː p
vuurkracht	v yː r k r ɑ x t
vuurpijl	v yː r p ɛ i̯ l
vuurproef	v yː r p r u f
vuurtoren	v yː r t oː r ə n
vuurvlinder	v yː r v l ɪ n d ə r
vuurwapen	v yː r ʋ aː p ə n
vuurwerk	v yː r ʋ ɛ r k
vwo	v eː ʋ eː oː
waag	ʋ aː x
waal	ʋ aː l
waals	ʋ aː l s
waar	ʋ aː r
waaraan	ʋ aː r aː n
waard	ʋ aː r t
waarderen	ʋ aː r d eː r ə n
waardering	ʋ aː r d eː r ɪ ŋ
waardigheid	ʋ aː r d ə x ɦ ɛ i̯ t
waarheen	ʋ aː r ɦ eː n
waarheid	ʋ aː r ɦ ɛ i̯ t
waarin	ʋ aː r ɪ n
waarnemen	ʋ aː r n eː m ə n
waarom	ʋ aː r ɔ m
waarschijnlijk	ʋ aː r s x ɛ i̯ n l ə k
waarschijnlijkheid	ʋ aː r s x ɛ i̯ n l ə k ɦ ɛ i̯ t
waarschuwen	ʋ aː r s x y u̯ ə n
waarschuwing	ʋ aː r s x y u̯ ɪ ŋ
waarschuwingsschot	ʋ aː r s x y u̯ ɪ ŋ s x ɔ t
wacht	ʋ ɑ x t
wachter	ʋ ɑ x t ə r
wachtlijst	ʋ ɑ x t l ɛ i̯ s t
wachttijd	ʋ ɑ x t ɛ i̯ t
wachttoren	ʋ ɑ x t oː r ə n
wad	ʋ ɑ t
waddenzee	ʋ ɑ d ə n z eː
wade	ʋ aː d ə
wagenpark	ʋ aː ɣ ə n p ɑ r k
wagon	ʋ aː ɣ ɔ n
waken	ʋ aː k ə n
wakker	ʋ ɑ k ə r
wal	ʋ ɑ l
walcheren	ʋ ɑ l x ə r ə n
walgelijk	ʋ ɑ l ɣ ə l ə k
wallonië	ʋ ɑ l oː n i j ə
walvis	ʋ ɑ l v ɪ s
wam	ʋ ɑ m
wandelstok	ʋ ɑ n d ə l s t ɔ k
wandeltocht	ʋ ɑ n d ə l t ɔ x t
wang	ʋ ɑ ŋ
wanhoop	ʋ ɑ n ɦ oː p
wanhopig	ʋ ɑ n ɦ oː p ə x
wanneer	ʋ ɑ n eː r
want	ʋ ɑ n t
wao	ʋ eː j aː oː
wapen	ʋ aː p ə n
wapenstok	ʋ aː p ə n s t ɔ k
war	ʋ ɑ r
ware	ʋ aː r ə
waren	ʋ aː r ə n
warenhuis	ʋ aː r ə n ɦ œ y̯ s
warm	ʋ ɑ r ə m
warmte	ʋ ɑ r m t ə
warmtepomp	ʋ ɑ r m t ə p ɔ m p
warrig	ʋ ɑ r ə x
warschau	ʋ ɑ r ʃ ɑ u̯
was	ʋ ɑ s
wasbak	ʋ ɑ s b ɑ k
wasgoed	ʋ ɑ s x u t
wassen	ʋ ɑ s ə n
wassenaar	ʋ ɑ s ə n aː r
wasstraat	ʋ ɑ s t r aː t
wast	ʋ ɑ s t
wastafel	ʋ ɑ s t aː f ə l
waste	ʋ ɑ s t ə
wat	ʋ ɑ t
water	ʋ aː t ə r
waterbed	ʋ aː t ə r b ɛ t
watergang	ʋ aː t ə r ɣ ɑ ŋ
waterkering	ʋ aː t ə r k eː r ɪ ŋ
waterland	ʋ aː t ə r l ɑ n t
watermerk	ʋ aː t ə r m ɛ r k
waterpas	ʋ aː t ə r p ɑ s
waterpijp	ʋ aː t ə r p ɛ i̯ p
waterpolo	ʋ aː t ə r p oː l oː
waterschap	ʋ aː t ə r s x ɑ p
waterstaat	ʋ aː t ə r s t aː t
waterstof	ʋ aː t ə r s t ɔ f
wc	ʋ eː s eː
we	ʋ ə
web	ʋ ɛ p
weblog	ʋ ɛ p l ɔ x
website	ʋ ɛ p s ɑ i̯ t
webstek	ʋ ɛ p s t ɛ k
wederdoper	ʋ eː d ə r d oː p ə r
wederstrevig	ʋ eː d ə r s t r eː v ə x
weduwe	ʋ eː d y ʋ ə
weefgetouw	ʋ eː f x ə t ɑ u̯
weeg	ʋ eː x
weegschaal	ʋ eː x s x aː l
week	ʋ eː k
weekblad	ʋ eː k b l ɑ t
weekeinde	ʋ eː k ɛ i̯ n d ə
weekend	ʋ i k ɛ n t
weer	ʋ eː r
weergegeven	ʋ eː r ɣ ə ɣ eː v ə n
weergeven	ʋ eː r ɣ eː v ə n
weerhaan	ʋ eː r ɦ aː n
weerhouden	ʋ eː r ɦ ɑ u̯ d ə n
weerstand	ʋ eː r s t ɑ n t
weerzin	ʋ eː r z ɪ n
wees	ʋ eː s
weeshuis	ʋ eː s ɦ œ y̯ s
weet	ʋ eː t
wegdek	ʋ ɛ x d ɛ k
wegen	ʋ eː ɣ ə n
wegennet	ʋ eː ɣ ə n ɛ t
wegens	ʋ eː ɣ ə n s
weggaan	ʋ ɛ x aː n
weggooien	ʋ ɛ x ɣ oː i̯ ə n
weglopen	ʋ ɛ x l oː p ə n
wegschrijven	ʋ ɛ x s x r ɛ i̯ v ə n
wegslepen	ʋ ɛ x s l eː p ə n
wegwijzer	ʋ ɛ x ʋ ɛ i̯ z ə r
wei	ʋ ɛ i̯
weide	ʋ ɛ i̯ d ə
weigeren	ʋ ɛ i̯ ɣ ə r ə n
weiland	ʋ ɛ i̯ l ɑ n t
weinig	ʋ ɛ i̯ n ə x
wekelijks	ʋ eː k ə l ə k s
weken	ʋ eː k ə n
wekker	ʋ ɛ k ə r
wel	ʋ ɛ l
welbevinden	ʋ ɛ l b ə v ɪ n d ə n
weleer	ʋ ɛ l eː r
weliswaar	ʋ ɛ l ɪ s ʋ aː r
welk	ʋ ɛ l k
welke	ʋ ɛ l k ə
welkom	v ɛ l k ɔ m
welvaartsstaat	ʋ ɛ l v aː r t s t aː t
welzijn	ʋ ɛ l z ɛ i̯ n
wen	ʋ ɛ n
wenden	ʋ ɛ n d ə n
wenen	ʋ eː n ə n
wennen	ʋ ɛ n ə n
wentelen	ʋ ɛ n t ə l ə n
werd	ʋ ɛ r t
werden	ʋ ɛ r d ə n
wereldbeeld	ʋ eː r ə l t b eː l t
wereldbevolking	ʋ eː r ə l t b ə v ɔ l k ɪ ŋ
wereldhandel	ʋ eː r ə l t ɦ ɑ n d ə l
wereldkampioen	ʋ eː r ə l t k ɑ m p i u n
wereldkampioenschap	ʋ eː r ə l t k ɑ m p i u n s x ɑ p
wereldschokkend	ʋ eː r ə l t s x ɔ k ə n t
wereldverbeteraar	ʋ eː r ə l t v ə r b eː t ə r aː r
weren	ʋ eː r ə n
werk	ʋ ɛ r k
werkbaar	ʋ ɛ r k b aː r
werkelijk	ʋ ɛ r k ə l ə k
werkelijkheid	ʋ ɛ r k ə l ə k ɦ ɛ i̯ t
werkeloos	ʋ ɛ r k ə l oː s
werken	ʋ ɛ r k ə n
werker	ʋ ɛ r k ə r
werkgebied	ʋ ɛ r k x ə b i t
werkgever	ʋ ɛ r k x eː v ə r
werkloosheid	ʋ ɛ r k l oː s ɦ ɛ i̯ t
werkloze	ʋ ɛ r k l oː z ə
werknemer	ʋ ɛ r k n eː m ə r
werkplaats	ʋ ɛ r k p l aː t s
werkplek	ʋ ɛ r k p l ɛ k
werkster	ʋ ɛ r k s t ə r
werkt	ʋ ɛ r k t
werkte	ʋ ɛ r k t ə
werkwoord	ʋ ɛ r ə k ʋ oː r t
werpen	ʋ ɛ r p ə n
wervel	ʋ ɛ r v ə l
wervelkolom	ʋ ɛ r v ə l k oː l ɔ m
werven	ʋ ɛ r v ə n
wesp	ʋ ɛ s p
wespenspin	ʋ ɛ s p ə n s p ɪ n
west	ʋ ɛ s t
westland	ʋ ɛ s t l ɑ n t
wet	ʋ ɛ t
wetboek	ʋ ɛ t b u k
weten	ʋ eː t ə n
wetenschappelijk	ʋ eː t ə n s x ɑ p ə l ə k
wetgever	ʋ ɛ t x eː v ə r
wetsvoorstel	ʋ ɛ t s f oː r s t ɛ l
wetten	ʋ ɛ t ə n
weven	ʋ eː v ə n
wezenlijk	ʋ eː z ə n l ə k
wezens	ʋ eː z ə n s
wezep	ʋ eː z ə p
whisky	ʋ ɪ s k i
wie	ʋ i
wielrennen	ʋ i l r ɛ n ə n
wielrenner	ʋ i l r ɛ n ə r
wieringen	ʋ iː r ɪ ŋ ə n
wierp	ʋ i r p
wifi	ʋ i f i
wig	ʋ ɪ x
wijden	ʋ ɛ i̯ d ə n
wijf	ʋ ɛ i̯ f
wijk	ʋ ɛ i̯ k
wijkagent	ʋ ɛ i̯ k aː ɣ ɛ n t
wijken	ʋ ɛ i̯ k ə n
wijl	ʋ ɛ i̯ l
wijle	ʋ ɛ i̯ l ə
wijn	ʋ ɛ i̯ n
wijnboer	ʋ ɛ i m b uː r
wijngaard	ʋ ɛ i̯ n ɣ aː r t
wijnrood	ʋ ɛ i̯ n r oː t
wijs	ʋ ɛ i̯ s
wijzen	ʋ ɛ i̯ z ə n
wijzer	ʋ ɛ i̯ z ə r
wijziging	ʋ ɛ i̯ z ə ɣ ɪ ŋ
wil	ʋ ɪ l
wilco	ʋ ɪ l k oː
wild	ʋ ɪ l t
wildebras	ʋ ɪ l d ə b r ɑ s
wildernis	ʋ ɪ l d ə r n ɪ s
wildgroei	ʋ ɪ l t x r u i̯
wilg	ʋ ɪ l x
wilhelmina	ʋ ɪ l ɦ ɛ l m i n aː
willems	ʋ ɪ l ə m s
willen	ʋ ɪ l ə n
wilskracht	ʋ ɪ l s k r ɑ x t
wilt	ʋ ɪ l t
win	ʋ ɪ n
wind	ʋ ɪ n t
winderig	ʋ ɪ n d ə r ə x
windkracht	ʋ ɪ n t k r ɑ x t
windmolen	ʋ ɪ n t m oː l ə n
windmolenpark	ʋ ɪ n t m oː l ə n p ɑ r k
windrichting	ʋ ɪ n t r ɪ x t ɪ ŋ
windschade	ʋ ɪ n t s x aː d ə
winkel	ʋ ɪ ŋ k ə l
winkelen	ʋ ɪ ŋ k ə l ə n
winnen	ʋ ɪ n ə n
winning	ʋ ɪ n ɪ ŋ
winschoten	ʋ ɪ n s x oː t ə n
winst	ʋ ɪ n s t
winstgevend	ʋ ɪ n s t x eː v ə n t
wint	ʋ ɪ n t
winter	ʋ ɪ n t ə r
winters	ʋ ɪ n t ə r s
winterslaap	ʋ ɪ n t ə r s l aː p
wintersport	ʋ ɪ n t ə r s p ɔ r t
wintersporter	ʋ ɪ n t ə r s p ɔ r t ə r
wis	ʋ ɪ s
wiskunde	ʋ ɪ s k ʏ n d ə
wiskundig	ʋ ɪ s k ʏ n d ə x
wissel	ʋ ɪ s ə l
wisselen	ʋ ɪ s ə l ə n
wisselgeld	ʋ ɪ s ə l ɣ ɛ l t
wisselwerking	ʋ ɪ s ə l ʋ ɛ r k ɪ ŋ
wisten	ʋ ɪ s t ə n
wit	ʋ ɪ t
witlof	ʋ ɪ t l ɔ f
witte	ʋ ɪ t ə
witwassen	ʋ ɪ t ʋ ɑ s ə n
wodan	ʋ oː d ɑ n
woekeren	ʋ u k ə r ə n
woelmuis	ʋ u l m œ y̯ s
woensdag	ʋ u n z d ɑ x
woerden	ʋ uː r d ə n
woest	ʋ u s t
wok	ʋ ɔ k
wol	ʋ ɔ l
wolf	ʋ ɔ l f
wollen	ʋ ɔ l ə n
wolters	ʋ ɔ l t ə r s
wolven	ʋ ɔ l v ə n
wond	ʋ ɔ n t
wonde	ʋ ɔ n d ə
wonder	ʋ ɔ n d ə r
wonderkind	ʋ ɔ n d ə r k ɪ n t
wonderlijk	ʋ ɔ n d ə r l ə k
wonderwel	ʋ ɔ n d ə r ʋ ɛ l
wonen	ʋ oː n ə n
woning	ʋ oː n ɪ ŋ
woningbouw	ʋ oː n ɪ ŋ b ɑ u̯
woon	ʋ oː n
woonde	ʋ oː n d ə
woonhuis	ʋ oː n ɦ œ y̯ s
woonkamer	ʋ oː n k aː m ə r
woonplaats	ʋ oː n p l aː t s
woonruimte	ʋ oː n r œ y̯ m t ə
woont	ʋ oː n t
woorden	ʋ ɔː r d ə n
woordenboek	ʋ oː r d ə n b u k
woordenschat	ʋ oː r d ə n s x ɑ t
woordenwisseling	ʋ oː r d ə n ʋ ɪ s ə l ɪ ŋ
woordje	ʋ oː r t ʃ ə
woordvoerder	ʋ oː r t f uː r d ə r
word	ʋ ɔ r t
worden	ʋ ɔ r d ə n
wordt	ʋ ɔ r t
workum	ʋ ɔ r k ʏ m
worm	ʋ ɔ r m
worp	ʋ ɔ r p
worstelen	ʋ ɔ r s t ə l ə n
woud	ʋ ɑ u̯ t
woudaap	ʋ ɑ u̯ t aː p
woudreus	ʋ ɑ u̯ t r øː s
wout	ʋ ɑ u̯ t
wraak	v r aː k
wrak	v r ɑ k
wrevel	v r eː v ə l
wrijving	v r ɛ i̯ v ɪ ŋ
wurgen	ʋ ʏ r ɣ ə n
ww	ʋ eː ʋ eː
xenofobie	k s eː n oː f oː b i
xenotransplantatie	k s eː n oː t r ɑ n s p l ɑ n t aː t s i
yam	j ɑ m
yen	j ɛ n
yes	j ɛ s
yeti	j eː t i
yoga	j oː ɣ aː
yoghurt	j ɔ x ʏ r t
zaaien	z aː i̯ ə n
zaailand	z aː i̯ l ɑ n t
zaak	z aː k
zaakwaarnemer	z aː k ʋ aː r n eː m ə r
zaan	z aː n
zaanstreek	z aː n s t r eː k
zacht	z ɑ x t
zachtheid	z ɑ x t ɦ ɛ i̯ t
zachtzinnig	z ɑ x t s ɪ n ə x
zadelen	z aː d ə l ə n
zag	z ɑ x
zagen	z aː ɣ ə n
zak	z ɑ k
zakdoek	z ɑ k d u k
zake	z aː k ə
zakelijk	z aː k ə l ə k
zakenbank	z aː k ə n b ɑ ŋ k
zakenman	z aː k ə n m ɑ n
zakenvrouw	z aː k ə n v r ɑ u̯
zakenwereld	z aː k ə n ʋ eː r ə l t
zakgeld	z ɑ k x ɛ l t
zakje	z ɑ k j ə
zakkenvuller	z ɑ k ə n v ʏ l ə r
zaklantaarn	z ɑ k l ɑ n t aː r n
zal	z ɑ l
zalig	z aː l ə x
zaligen	z aː l ə ɣ ə n
zalm	z ɑ l m
zaltbommel	z ɑ l t b ɔ m ə l
zambia	z ɑ m b i aː
zand	z ɑ n t
zandbak	z ɑ n t b ɑ k
zandgrond	z ɑ n t x r ɔ n t
zandloper	z ɑ n t l oː p ə r
zandsteen	z ɑ n t s t eː n
zandvoort	z ɑ n t f oː r t
zandzak	z ɑ n t s ɑ k
zang	z ɑ ŋ
zanger	z ɑ ŋ ə r
zangvogel	z ɑ ŋ v oː ɣ ə l
zat	z ɑ t
zaterdag	z aː t ə r d ɑ x
zaterdagmorgen	z aː t ə r d ɑ x m ɔ r ɣ ə n
zaterdagochtend	z aː t ə r d ɑ x ɔ x t ə n t
zaterdags	z aː t ə r d ɑ x s
zavel	z aː v ə l
ze	z ə
zebra	z eː b r aː
zebrapad	z eː b r aː p ɑ t
zedig	z eː d ə x
zee	z eː
zeearend	z eː aː r ə n t
zeebodem	z eː b oː d ə m
zeebrugge	z eː b r ʏ ɣ ə
zeegat	z eː ɣ ɑ t
zeeland	z eː l ɑ n t
zeelandia	z eː l ɑ n d i aː
zeeman	z eː m ɑ n
zeemonster	z eː m ɔ n s t ə r
zeenimf	z eː n ɪ m f
zeeniveau	z eː n i v oː
zeeoor	z eː oː r
zeeotter	z eː ɔ t ə r
zeep	z eː p
zeepbel	z eː p b ɛ l
zeer	z eː r
zeerover	z eː r oː v ə r
zeeslag	z eː s l ɑ x
zeespiegel	z eː s p i ɣ ə l
zeevaarder	z eː v aː r d ə r
zeewier	z eː ʋ iː r
zeewolde	z eː ʋ ɔ l d ə
zeg	z ɛ x
zege	z eː ɣ ə
zegers	z eː ɣ ə r s
zeggenschap	z ɛ ɣ ə n s x ɑ p
zeggingskracht	z ɛ ɣ ɪ ŋ s k r ɑ x t
zegsman	z ɛ x s m ɑ n
zegsvrouw	z ɛ x s f r ɑ u̯
zegt	z ɛ x t
zei	z ɛ i̯
zeiken	z ɛ i k ə n
zeil	z ɛ i̯ l
zeilen	z ɛ i̯ l ə n
zeist	z ɛ i̯ s t
zeker	z eː k ə r
zelden	z ɛ l d ə n
zeldzaam	z ɛ l t s aː m
zelf	z ɛ l f
zelfbeschikking	z ɛ l f b ə s x ɪ k ɪ ŋ
zelfbeschikkingsrecht	z ɛ l f b ə s x ɪ k ɪ ŋ s r ɛ x t
zelfbewust	z ɛ l f b ə ʋ ʏ s t
zelfde	z ɛ l f d ə
zelfgenoegzaam	z ɛ l f x ə n u x s aː m
zelfkennis	z ɛ l f k ɛ n ɪ s
zelfmoord	z ɛ l f m oː r t
zelfmoordaanslag	z ɛ l f m oː r t aː n s l ɑ x
zelfonderricht	z ɛ l f ɔ n d ə r r ɪ x t
zelfs	z ɛ l f s
zelfstandig	z ɛ l f s t ɑ n d ə x
zelfstandigheid	z ɛ l f s t ɑ n d ə x ɦ ɛ i̯ t
zelfverzekerd	z ɛ l f ə r z eː k ə r t
zendeling	z ɛ n d ə l ɪ ŋ
zender	z ɛ n d ə r
zending	z ɛ n d ɪ ŋ
zendmast	z ɛ n t m ɑ s t
zendtijd	z ɛ n t ɛ i̯ t
zenit	z eː n ɪ t
zenne	z ɛ n ə
zenuwinzinking	z eː n y u̯ ɪ n z ɪ ŋ t ɪ ŋ
zenuwstelsel	z eː n y u̯ s t ɛ l s ə l
zeppelin	z ɛ p ə l ɪ n
zesde	z ɛ s d ə
zesentwintig	z ɛ s ɛ n t ʋ ɪ n t ə x
zesenzeventig	z ɛ s ə n s eː v ə n t ə x
zesjarig	z ɛ s j aː r ə x
zestien	z ɛ s t i n
zestiende	z ɛ s t i n d ə
zestienhoven	z ɛ s t i n ɦ oː v ə n
zestigste	z ɛ s t ə x s t ə
zetel	z eː t ə l
zette	z ɛ t ə
zetten	z ɛ t ə n
zeug	z øː x
zeus	z œ y̯ s
zevenaar	z eː v ə n aː r
zevenenzeventig	z eː v ə n ə n s eː v ə n t ə x
zeventiende	z eː v ə n t i n d ə
zeventigste	s eː v ə n t ə x s t ə
zich	z ɪ x
zichtbaar	z ɪ x t b aː r
zichtbaarheid	z ɪ x t b aː r ɦ ɛ i̯ t
zichzelf	z ɪ x z ɛ l f
zie	z i
ziek	z i k
zieke	z i k ə
ziekenboeg	z i k ə n b u x
ziekte	z i k t ə
ziektekosten	z i k t ə k ɔ s t ə n
ziel	z i l
zielig	z i l ə x
zien	z i n
zienswijze	z i n s ʋ ɛ i̯ z ə
zierikzee	z i r ɪ k z eː
ziet	z i t
zijd	z ɛ i̯ t
zijde	z ɛ i̯ d ə
zijdelings	z ɛ i̯ d ə l ɪ ŋ s
zijden	z ɛ i̯ d ə n
zijderoute	z ɛ i̯ d ə r u t ə
zijkant	z ɛ i̯ k ɑ n t
zijl	z ɛ i̯ l
zijns	z ɛ i̯ n s
zijspan	z ɛ i̯ s p ɑ n
zijtak	z ɛ i̯ t ɑ k
zijwaarts	z ɛ i̯ ʋ aː r t s
ziljoen	z ɪ l j u n
zilver	z ɪ l v ə r
zilveren	z ɪ l v ə r ə n
zilverkleurig	z ɪ l v ə r k l øː r ə x
zin	z ɪ n
zindelijk	z ɪ n d ə l ə k
zindelijkheid	z ɪ n d ə l ə k ɦ ɛ i̯ t
zingeving	z ɪ n ɣ eː v ɪ ŋ
zink	z ɪ ŋ k
zinken	z ɪ ŋ k ə n
zinloos	z ɪ n l oː s
zinnebeeld	z ɪ n ə b eː l t
zintuig	z ɪ n t œ y̯ x
zinvol	z ɪ n v ɔ l
zionisme	z i j oː n ɪ s m ə
zit	z ɪ t
zittend	z ɪ t ə n t
zitting	z ɪ t ɪ ŋ
zitvlak	z ɪ t f l ɑ k
zitzak	z ɪ t s ɑ k
zo	z oː
zoals	z oː ɑ l s
zodanig	z oː d aː n ə x
zodat	z oː d ɑ t
zodoende	z oː d u n d ə
zodra	z oː d r aː
zoek	z u k
zoeken	z u k ə n
zoekmachine	z u k m aː ʃ i n ə
zoekopdracht	z u k ɔ p d r ɑ x t
zoekt	z u k t
zoektocht	z u k t ɔ x t
zoet	z u t
zoeten	z u t ə n
zoetigheid	z u t ə x ɦ ɛ i̯ t
zoetstof	z u t s t ɔ f
zogeheten	z oː ɣ ə ɦ eː t ə n
zogen	z oː ɣ ə n
zogenoemd	z oː ɣ ə n u m t
zoiets	z oː i t s
zojuist	z oː j œ y̯ s t
zolang	z oː l ɑ ŋ
zolder	z ɔ l d ə r
zolderkamer	z ɔ l d ə r k aː m ə r
zolen	z oː l ə n
zomaar	z oː m aː r
zomer	z oː m ə r
zomerhuis	z oː m ə r ɦ œ y̯ s
zomers	z oː m ə r s
zon	z ɔ n
zondag	z ɔ n d ɑ x
zondagmorgen	z ɔ n d ɑ x m ɔ r ɣ ə n
zondagochtend	z ɔ n d ɑ x ɔ x t ə n t
zondags	z ɔ n d ɑ x s
zondagsrust	z ɔ n d ɑ x s r ʏ s t
zonder	z ɔ n d ə r
zondig	z ɔ n d ə x
zondigen	z ɔ n d ə ɣ ə n
zondvloed	z ɔ n t f l u t
zone	z ɔː n ə
zonecht	z ɔ n ɛ x t
zonlicht	z ɔ n l ɪ x t
zonnebank	z ɔ n ə b ɑ ŋ k
zonnebloem	z ɔ n ə b l u m
zonnebril	z ɔ n ə b r ɪ l
zonnegod	z ɔ n ə ɣ ɔ t
zonneklaar	z ɔ n ə k l aː r
zonnen	z ɔ n ə n
zonnestelsel	z ɔ n ə s t ɛ l s ə l
zonnestudio	z ɔ n ə s t y d i oː
zonneveld	z ɔ n ə v ɛ l t
zonnewijzer	z ɔ n ə ʋ ɛ i̯ z ə r
zonsondergang	z ɔ n s ɔ n d ə r ɣ ɑ ŋ
zonsopgang	z ɔ n s ɔ p x ɑ ŋ
zonvakantie	z ɔ n v aː k ɑ n s i
zool	z oː l
zoon	z oː n
zorg	z ɔ r x
zorgen	z ɔ r ɣ ə n
zorgvuldig	z ɔ r x f ʏ l d ə x
zorgvuldigheid	z ɔ r x f ʏ l d ə x ɦ ɛ i̯ t
zorgzaam	z ɔ r x s aː m
zot	z ɔ t
zotte	z ɔ t ə
zou	z ɑ u̯
zouden	z ɑ u̯ d ə n
zout	z ɑ u̯ t
zouten	z ɑ u̯ t ə n
zoveel	z oː v eː l
zowaar	z oː ʋ aː r
zowat	z oː ʋ ɑ t
zozeer	z oː z eː r
zoönose	z oː oː n oː z ə
zucht	z ʏ x t
zuid	z œ y̯ t
zuidelijk	z œ y̯ d ə l ə k
zuiden	z œ y̯ d ə n
zuiderling	z œ y̯ d ə r l ɪ ŋ
zuiderzee	z œ y̯ d ə r z eː
zuidoost	z œ y̯ t oː s t
zuidoosten	z œ y̯ t oː s t ə n
zuidwest	z œ y̯ t ʋ ɛ s t
zuidwesten	z œ y̯ t ʋ ɛ s t ə n
zuidwester	z œ y̯ t ʋ ɛ s t ə r
zuigen	z œ y̯ ɣ ə n
zuiger	z œ y̯ ɣ ə r
zuil	z œ y̯ l
zuinig	z œ y̯ n ə x
zuinigheid	z œ y̯ n ə x ɦ ɛ i̯ t
zuivel	z œ y̯ v ə l
zuivelproduct	z œ y̯ v ə l p r oː d ʏ k t
zuiver	z œ y̯ v ə r
zuiverheid	z œ y̯ v ə r ɦ ɛ i̯ t
zulk	z ʏ l k
zulks	z ʏ l k s
zullen	z ʏ l ə n
zult	z ʏ l t
zuster	z ʏ s t ə r
zutphen	z ʏ t f ə n
zuurstof	z yː r s t ɔ f
zwaailicht	z ʋ aː i̯ l ɪ x t
zwaargewicht	z ʋ aː r ɣ ə ʋ ɪ x t
zwaargewond	z ʋ aː r ɣ ə ʋ ɔ n t
zwaarte	z ʋ aː r t ə
zwaartekracht	z ʋ aː r t ə k r ɑ x t
zwaartepunt	z ʋ aː r t ə p ʏ n t
zwaarwegend	z ʋ aː r ʋ eː ɣ ə n t
zwaarwichtig	z ʋ aː r ʋ ɪ x t ə x
zwaben	z ʋ aː b ə n
zwak	z ʋ ɑ k
zwaluw	z ʋ aː l y u̯
zwam	z ʋ ɑ m
zwanger	z ʋ ɑ ŋ ə r
zwangerschap	z ʋ ɑ ŋ ə r s x ɑ p
zwart	z ʋ ɑ r t
zwarte	z ʋ ɑ r t ə
zweden	z ʋ eː d ə n
zweeds	z ʋ eː t s
zweedse	z ʋ eː t s ə
zweefvliegen	z ʋ eː f f l i ɣ ə n
zweepslag	z ʋ eː p s l ɑ x
zwem	z ʋ ɛ m
zwembad	z ʋ ɛ m b ɑ t
zwembroek	z ʋ ɛ m b r u k
zwemmen	z ʋ ɛ m ə n
zwerfkatten	z ʋ ɛ r f k ɑ t ə n
zwerfvuil	z ʋ ɛ r f œ y̯ l
zwerven	z ʋ ɛ r v ə n
zwerver	z ʋ ɛ r v ə r
zweten	z ʋ eː t ə n
zwijgen	z ʋ ɛ i̯ ɣ ə n
zwijgzaam	z ʋ ɛ i̯ x s aː m
zwijn	z ʋ ɛ i̯ n
zwijnen	z ʋ ɛ i̯ n ə n
zwitserland	z ʋ ɪ t s ə r l ɑ n t
zwolle	z ʋ ɔ l ə
