aa	a a
abandon	a b ɑ̃ d ɔ̃
abandonner	a b ɑ̃ d ɔ n e
abattement	a b a t m ɑ̃
abattre	a b a t ʁ
abc	a b e s e
abdomen	a b d ɔ m ɛ n
abdoul	a b d u l
abdoulaye	a b d u l a i
abel	a b ɛ l
ablatif	a b l a t i f
abnégation	a b n e ɡ a s j ɔ̃
abolition	a b ɔ l i s j ɔ̃
abominable	a b ɔ m i n a b l
abominât	a b ɔ m i n ɑ
abominèrent	a b ɔ m i n ɛ ʁ
abondamment	a b ɔ̃ d a m ɑ̃
abondance	a b ɔ̃ d ɑ̃ s
abondant	a b ɔ̃ d ɑ̃
abonnement	a b ɔ n m ɑ̃
abonnirais	a b ɔ n i ʁ ɛ
abord	a b ɔ ʁ
abordable	a b ɔ ʁ d a b l
aborder	a b ɔ ʁ d e
aborigène	a b ɔ ʁ i ʒ ɛ n
abot	a b o
abou	a b u
aboutir	a b u t i ʁ
aboutissant	a b u t i s ɑ̃
abri	a b ʁ i
abris	a b ʁ i
abriter	a b ʁ i t e
absent	a p s ɑ̃
absents	a p s ɑ̃
absolue	a p s ɔ l y
absolument	a p s ɔ l y m ɑ̃
absorber	a p s ɔ ʁ b e
abstention	a p s t ɑ̃ s j ɔ̃
absurde	a p s y ʁ d
abus	a b y
abusent	a b y z
abusivement	a b y z i v m ɑ̃
abîme	a b i m
académicienne	a k a d e m i s j ɛ n
académie	a k a d e m i
académique	a k a d e m i k
accent	a k s ɑ̃
acceptant	a k s ɛ p t ɑ̃
accepter	a k s ɛ p t e
acception	a k s ɛ p s j ɔ̃
accepté	a k s ɛ p t e
accessibles	a k s ɛ s i b l
accidentellement	a k s i d ɑ̃ t ɛ l m ɑ̃
acclamative	a k l a m a t i v
accolade	a k ɔ l a d
accommoder	a k ɔ m ɔ d e
accompagnement	a k ɔ̃ p a ɲ m ɑ̃
accomplissement	a k ɔ̃ p l i s m ɑ̃
accord	a k ɔ ʁ
accorder	a k ɔ ʁ d e
accordé	a k ɔ ʁ d e
accordée	a k ɔ ʁ d e
accordéoniste	a k ɔ ʁ d e ɔ n i s t
accoutumer	a k u t y m e
accroc	a k ʁ o
accrocher	a k ʁ ɔ ʃ e
accroissement	a k ʁ w a s m ɑ̃
accroître	a k ʁ w a t ʁ
accrue	a k ʁ y
accréditer	a k ʁ e d i t e
accueil	a k œ j
accueillir	a k œ j i ʁ
accumulateur	a k y m y l a t œ ʁ
accumuler	a k y m y l e
accusation	a k y z a s j ɔ̃
accuser	a k y z e
accusé	a k y z e
accès	a k s ɛ
accéder	a k s e d e
accélère	a k s e l ɛ ʁ
accélérer	a k s e l e ʁ e
acerbe	a s ɛ ʁ b
acheter	a ʃ t e
acheteur	a ʃ t œ ʁ
achever	a ʃ v e
achevé	a ʃ v e
achille	a ʃ i l
acide	a s i d
acier	a s j e
acineuse	a s i n ø z
acné	a k n e
acoustique	a k u s t i k
acquisition	a k i z i s j ɔ̃
acquitter	a k i t e
acquitté	a k i t e
acquéreur	a k e ʁ œ ʁ
acrobatique	a k ʁ ɔ b a t i k
acte	a k t
actes	a k t
acteur	a k t œ ʁ
action	a k s j ɔ̃
actionnaire	a k s j ɔ n ɛ ʁ
activaient	a k t i v ɛ
activation	a k t i v a s j ɔ̃
activement	a k t i v m ɑ̃
activent	a k t i v
actives	a k t i v
activité	a k t i v i t e
activés	a k t i v e
actrice	a k t ʁ i s
actuaires	a k t ɥ ɛ ʁ
actuel	a k t ɥ ɛ l
actuelle	a k t ɥ ɛ l
actuellement	a k t ɥ ɛ l m ɑ̃
actuelles	a k t ɥ ɛ l
actuels	a k t ɥ ɛ l
acuité	a k ɥ i t e
acéré	a s e ʁ e
adam	a d ɑ̃
adapter	a d a p t e
adapté	a d a p t e
addition	a d i s j ɔ̃
adhérent	a d e ʁ ɑ̃
adhérents	a d e ʁ ɑ̃
adhésion	a d e z j ɔ̃
adjoindre	a d ʒ w ɛ̃ d ʁ
adjoint	a d ʒ w ɛ̃
adjudication	a d ʒ y d i k a s j ɔ̃
adjuge	a d ʒ y ʒ
adjugeait	a d ʒ y ʒ ɛ
adjugé	a d ʒ y ʒ e
administrateur	a d m i n i s t ʁ a t œ ʁ
administratif	a d m i n i s t ʁ a t i f
administration	a d m i n i s t ʁ a s j ɔ̃
administratrice	a d m i n i s t ʁ a t ʁ i s
admirable	a d m i ʁ a b l
admission	a d m i s j ɔ̃
adn	a d e ɛ n
ado	a d o
adobe	a d ɔ b
adolescent	a d ɔ l ɛ s ɑ̃
adolescente	a d ɔ l ɛ s ɑ̃ t
adopta	a d ɔ p t a
adopte	a d ɔ p t
adopter	a d ɔ p t e
adoption	a d ɔ p s j ɔ̃
adorable	a d ɔ ʁ a b l
adorais	a d ɔ ʁ ɛ
adore	a d ɔ ʁ
adorez	a d ɔ ʁ e
adorée	a d ɔ ʁ e
adouci	a d u s i
adoucis	a d u s i
adresse	a d ʁ ɛ s
adresses	a d ʁ ɛ s
adrien	a d ʁ i j ɛ̃
adultère	a d y l t ɛ ʁ
adversaire	a d v ɛ ʁ s ɛ ʁ
adèle	a d ɛ l
adéquat	a d e k w a
adéquats	a d e k w a
affable	a f a b l
affaire	a f ɛ ʁ
affaires	a f ɛ ʁ
affectueusement	a f ɛ k t ɥ ø z m ɑ̃
affichage	a f i ʃ a ʒ
affiche	a f i ʃ
afficher	a f i ʃ e
affinage	a f i n a ʒ
affirmait	a f i ʁ m ɛ
affirmant	a f i ʁ m ɑ̃
affirmation	a f i ʁ m a s j ɔ̃
affirmative	a f i ʁ m a t i v
affirme	a f i ʁ m
affirment	a f i ʁ m
affirmer	a f i ʁ m e
affirmé	a f i ʁ m e
affirmés	a f i ʁ m e
affluer	a f l y e
afflux	a f l y
affolant	a f ɔ l ɑ̃
affranchir	a f ʁ ɑ̃ ʃ i ʁ
affrontement	a f ʁ ɔ̃ t m ɑ̃
affronter	a f ʁ ɔ̃ t e
affûter	a f y t e
afghan	a f ɡ ɑ̃
afghanistan	a f ɡ a n i s t ɑ̃
afin	a f ɛ̃
africaine	a f ʁ i k ɛ n
afrique	a f ʁ i k
agace	a ɡ a s
agen	a ʒ ɛ̃
agence	a ʒ ɑ̃ s
agenda	a ʒ ɛ̃ d a
agent	a ʒ ɑ̃
agglomération	a ɡ l ɔ m e ʁ a s j ɔ̃
aggravant	a ɡ ʁ a v ɑ̃
agile	a ʒ i l
agir	a ʒ i ʁ
agissant	a ʒ i s ɑ̃
agitation	a ʒ i t a s j ɔ̃
agneau	a ɲ o
agrandi	a ɡ ʁ ɑ̃ d i
agrandir	a ɡ ʁ ɑ̃ d i ʁ
agrandirai	a ɡ ʁ ɑ̃ d i ʁ e
agresser	a ɡ ʁ ɛ s e
agressif	a ɡ ʁ ɛ s i f
agression	a ɡ ʁ ɛ s j ɔ̃
agressive	a ɡ ʁ ɛ s i v
agricole	a ɡ ʁ i k ɔ l
agriculture	a ɡ ʁ i k y l t y ʁ
agréable	a ɡ ʁ e a b l
agréablement	a ɡ ʁ e a b l ə m ɑ̃
agrément	a ɡ ʁ e m ɑ̃
aigle	ɛ ɡ l
aigriras	ɛ ɡ ʁ i ʁ ɑ
aile	ɛ l
aileron	ɛ l ʁ ɔ̃
ailes	ɛ l
ailier	ɛ l j e
aille	a j
aimable	ɛ m a b l
aimables	ɛ m a b l
ainsi	ɛ̃ s i
air	ɛ ʁ
aire	ɛ ʁ
aisance	ɛ z ɑ̃ s
aisne	ɛ n
ajouter	a ʒ u t e
ajouté	a ʒ u t e
ajuster	a ʒ y s t e
alain	a l ɛ̃
alangui	a l ɑ̃ ɡ i
alarmantes	a l a ʁ m ɑ̃ t
alarme	a l a ʁ m
alarmer	a l a ʁ m e
alban	a l b ɑ̃
albert	a l b ɛ ʁ
alberta	a l b ɛ ʁ t a
albi	a l b i
album	a l b ɔ m
alcool	a l k ɔ l
alcools	a l k ɔ l
alentour	a l ɑ̃ t u ʁ
alerte	a l ɛ ʁ t
alerter	a l ɛ ʁ t e
alex	a l ɛ k s
alexandra	a l ɛ k s ɑ̃ d ʁ a
alexandre	a l ɛ k s ɑ̃ d ʁ
alexia	a l ɛ k s i a
alexis	a l ɛ k s i
alger	a l ʒ e
alice	a l i s
aligner	a l i ɲ e
aligné	a l i ɲ e
alignées	a l i ɲ e
aliment	a l i m ɑ̃
alimentaire	a l i m ɑ̃ t ɛ ʁ
alimentation	a l i m ɑ̃ t a s j ɔ̃
alimentations	a l i m ɑ̃ t a s j ɔ̃
aliénation	a l j e n a s j ɔ̃
allaient	a l ɛ
allait	a l ɛ
allemagne	a l m a ɲ
aller	a l e
allergique	a l ɛ ʁ ʒ i k
allez	a l e
alliacé	a l j a s e
alliance	a l j ɑ̃ s
allier	a l j e
allions	a l j ɔ̃
allonger	a l ɔ̃ ʒ e
allons	a l ɔ̃
allouer	a l w e
allumer	a l y m e
allumé	a l y m e
allure	a l y ʁ
allusion	a l y z j ɔ̃
allègre	a l ɛ ɡ ʁ
allé	a l e
allécher	a l e ʃ e
allée	a l e
alouettes	a l w ɛ t
alpes	a l p
alpha	a l f a
alphonse	a l f ɔ̃ s
alpin	a l p ɛ̃
alsacien	a l z a s j ɛ̃
altercation	a l t ɛ ʁ k a s j ɔ̃
alternatif	a l t ɛ ʁ n a t i f
altitude	a l t i t y d
aluminerie	a l y m i n ʁ i
aluminium	a l y m i n j ɔ m
aléatoires	a l e a t w a ʁ
amalgame	a m a l ɡ a m
amanda	a m ɑ̃ d a
amant	a m ɑ̃
amassent	a m a s
amasser	a m ɑ s e
amassé	a m a s e
amateur	a m a t œ ʁ
amazonie	a m a z ɔ n i
ambassade	ɑ̃ b a s a d
ambassadeur	ɑ̃ b a s a d œ ʁ
ambassadrice	ɑ̃ b a s a d ʁ i s
ambiance	ɑ̃ b j ɑ̃ s
ambigu	ɑ̃ b i ɡ y
ambigüité	ɑ̃ b i ɡ ɥ i t e
ambitieux	ɑ̃ b i s j ø
ambition	ɑ̃ b i s j ɔ̃
ambra	ɑ̃ b ʁ a
ambroisie	ɑ̃ b ʁ w a z i
ambulante	ɑ̃ b y l ɑ̃ t
amende	a m ɑ̃ d
amendement	a m ɑ̃ d m ɑ̃
amener	a m n e
amer	a m ɛ ʁ
amertume	a m ɛ ʁ t y m
ami	a m i
amiable	a m j a b l
amical	a m i k a l
amicale	a m i k a l
amiens	a m j ɛ̃
amies	a m i
amincirais	a m ɛ̃ s i ʁ ɛ
amiral	a m i ʁ a l
amis	a m i
amitiés	a m i t j e
ammonium	a m ɔ n j ɔ m
amont	a m ɔ̃
amorti	a m ɔ ʁ t i
amortir	a m ɔ ʁ t i ʁ
amour	a m u ʁ
amoureux	a m u ʁ ø
amphithéâtre	ɑ̃ f i t e ɑ t ʁ
ample	ɑ̃ p l
amputer	ɑ̃ p y t e
amusant	a m y z ɑ̃
amuse	a m y z
amuser	a m y z e
amène	a m ɛ n
améliorer	a m e l j ɔ ʁ e
aménagez	a m e n a ʒ e
américaine	a m e ʁ i k ɛ n
amérique	a m e ʁ i k
anachronisme	a n a k ʁ ɔ n i z m
analyse	a n a l i z
analyser	a n a l i z e
analyses	a n a l i z
analyste	a n a l i s t
analystes	a n a l i s t
anatomie	a n a t ɔ m i
ancien	ɑ̃ s j ɛ̃
ancienne	ɑ̃ s j ɛ n
ancrage	ɑ̃ k ʁ a ʒ
ancêtre	ɑ̃ s ɛ t ʁ
andalousie	ɑ̃ d a l u z i
andes	ɑ̃ d
andorre	ɑ̃ d ɔ ʁ
andré	ɑ̃ d ʁ e
ange	ɑ̃ ʒ
angers	ɑ̃ ʒ e
angle	ɑ̃ ɡ l
angleterre	ɑ̃ ɡ l ə t ɛ ʁ
anglicane	ɑ̃ ɡ l i k a n
anglicans	ɑ̃ ɡ l i k ɑ̃
angoisse	ɑ̃ ɡ w a s
angoulême	ɑ̃ ɡ u l ɛ m
animal	a n i m a l
animale	a n i m a l
animales	a n i m a l
animateur	a n i m a t œ ʁ
animaux	a n i m o
anime	a n i m
animer	a n i m e
animé	a n i m e
ankara	ɑ̃ k a ʁ a
anna	a n a
annales	a n a l
anneau	a n o
anneaux	a n o
annecy	a n s i
annette	a n ɛ t
annonce	a n ɔ̃ s
annoncer	a n ɔ̃ s e
annuel	a n ɥ ɛ l
annuellement	a n ɥ ɛ l m ɑ̃
annulation	a n y l a s j ɔ̃
annule	a n y l
annuler	a n y l e
annuleras	a n y l ʁ ɑ
années	a n e
anodin	a n ɔ d ɛ̃
anonymat	a n ɔ n i m a
anonyme	a n ɔ n i m
anse	ɑ̃ s
antenne	ɑ̃ t ɛ n
anthropologie	ɑ̃ t ʁ ɔ p ɔ l ɔ ʒ i
anthropologue	ɑ̃ t ʁ ɔ p ɔ l ɔ ɡ
antibactérien	ɑ̃ t i b a k t e ʁ j ɛ̃
antibiotique	ɑ̃ t i b j ɔ t i k
anticipation	ɑ̃ t i s i p a s j ɔ̃
antihémorroïdale	ɑ̃ t i e m ɔ ʁ ɔ i d a l
antilles	ɑ̃ t i j
antivols	ɑ̃ t i v ɔ l
antoine	ɑ̃ t w a n
antre	ɑ̃ t ʁ
anus	a n y s
anéantir	a n e ɑ̃ t i ʁ
anéantissement	a n e ɑ̃ t i s m ɑ̃
anéantîtes	a n e ɑ̃ t i t
aoûtien	a u s j ɛ̃
apache	a p a ʃ
apercevoir	a p ɛ ʁ s ə v w a ʁ
aperçu	a p ɛ ʁ s y
apeuré	a p œ ʁ e
aphone	a f o n
apogée	a p ɔ ʒ e
apollinienne	a p ɔ l i n j ɛ n
apologie	a p ɔ l ɔ ʒ i
apostrophe	a p ɔ s t ʁ ɔ f
apparaître	a p a ʁ ɛ t ʁ
appareil	a p a ʁ ɛ j
apparemment	a p a ʁ a m ɑ̃
apparence	a p a ʁ ɑ̃ s
apparences	a p a ʁ ɑ̃ s
apparent	a p a ʁ ɑ̃
apparenté	a p a ʁ ɑ̃ t e
apparition	a p a ʁ i s j ɔ̃
appartement	a p a ʁ t ə m ɑ̃
appartenir	a p a ʁ t ə n i ʁ
appel	a p ɛ l
appelait	a p l ɛ
appelant	a p l ɑ̃
appeler	a p ə l e
appellation	a p ɛ l a s j ɔ̃
appelle	a p ɛ l
applicable	a p l i k a b l
application	a p l i k a s j ɔ̃
appliquer	a p l i k e
appliqué	a p l i k e
apport	a p ɔ ʁ
apporter	a p ɔ ʁ t e
approprier	a p ʁ ɔ p ʁ i j e
approprié	a p ʁ ɔ p ʁ i j e
approuver	a p ʁ u v e
approvisionner	a p ʁ ɔ v i z j ɔ n e
approximatif	a p ʁ ɔ k s i m a t i f
approximativement	a p ʁ ɔ k s i m a t i v m ɑ̃
apprécier	a p ʁ e s j e
appréhender	a p ʁ e ɑ̃ d e
appréhension	a p ʁ e ɑ̃ s j ɔ̃
appui	a p ɥ i
appâtasses	a p a t a s
aptes	a p t
aptitude	a p t i t y d
apura	a p y ʁ a
apéro	a p e ʁ o
apéros	a p e ʁ o
apôtres	a p o t ʁ
aquitaine	a k i t ɛ n
arabe	a ʁ a b
arabica	a ʁ a b i k a
arabie	a ʁ a b i
araignée	a ʁ ɛ ɲ e
arbitraire	a ʁ b i t ʁ ɛ ʁ
arbitral	a ʁ b i t ʁ a l
arbitre	a ʁ b i t ʁ
arbre	a ʁ b ʁ
arcade	a ʁ k a d
archaïque	a ʁ k a i k
archimède	a ʁ ʃ i m ɛ d
archipel	a ʁ ʃ i p ɛ l
archéologique	a ʁ k e ɔ l ɔ ʒ i k
ardemment	a ʁ d a m ɑ̃
ardent	a ʁ d ɑ̃
ardu	a ʁ d y
argent	a ʁ ʒ ɑ̃
argentan	a ʁ ʒ ɑ̃ t ɑ̃
argentine	a ʁ ʒ ɑ̃ t i n
argile	a ʁ ʒ i l
ariane	a ʁ j a n
arles	a ʁ l
arlette	a ʁ l ɛ t
armand	a ʁ m ɑ̃
arme	a ʁ m
armer	a ʁ m e
armes	a ʁ m
armure	a ʁ m y ʁ
armé	a ʁ m e
arménie	a ʁ m e n i
arnaud	a ʁ n o
arrache	a ʁ a ʃ
arracher	a ʁ a ʃ e
arraché	a ʁ a ʃ e
arrangement	a ʁ ɑ̃ ʒ m ɑ̃
arrestation	a ʁ ɛ s t a s j ɔ̃
arrivée	a ʁ i v e
arrière	a ʁ j ɛ ʁ
arrogante	a ʁ ɔ ɡ ɑ̃ t
arrondi	a ʁ ɔ̃ d i
arrondisse	a ʁ ɔ̃ d i s
arrondissement	a ʁ ɔ̃ d i s m ɑ̃
arrêt	a ʁ ɛ
arrête	a ʁ ɛ t
arsenal	a ʁ s ə n a l
arsène	a ʁ s ɛ n
art	a ʁ
arthur	a ʁ t y ʁ
article	a ʁ t i k l
articulation	a ʁ t i k y l a s j ɔ̃
artifice	a ʁ t i f i s
artificiel	a ʁ t i f i s j ɛ l
artillerie	a ʁ t i j ʁ i
artiste	a ʁ t i s t
artistiques	a ʁ t i s t i k
arts	a ʁ
arête	a ʁ ɛ t
ascension	a s ɑ̃ s j ɔ̃
ascensions	a s ɑ̃ s j ɔ̃
asie	a z i
asile	a z i l
assainir	a s ɛ n i ʁ
assassin	a s a s ɛ̃
assassinat	a s a s i n a
assaut	a s o
assemblage	a s ɑ̃ b l a ʒ
assemblée	a s ɑ̃ b l e
assemblées	a s ɑ̃ b l e
asseoir	a s w a ʁ
assez	a s e
assiette	a s j ɛ t
assis	a s i
assise	a s i z
assises	a s i z
assistant	a s i s t ɑ̃
assiste	a s i s t
assistent	a s i s t
assister	a s i s t e
assisté	a s i s t e
association	a s ɔ s j a s j ɔ̃
associations	a s ɔ s j a s j ɔ̃
associative	a s ɔ s j a t i v
assortira	a s ɔ ʁ t i ʁ a
assoupliras	a s u p l i ʁ ɑ
assourdissant	a s u ʁ d i s ɑ̃
assouvir	a s u v i ʁ
assurance	a s y ʁ ɑ̃ s
assurer	a s y ʁ e
assureur	a s y ʁ œ ʁ
assurément	a s y ʁ e m ɑ̃
astral	a s t ʁ a l
astres	a s t ʁ
astronaute	a s t ʁ ɔ n o t
astronomique	a s t ʁ ɔ n ɔ m i k
astucieux	a s t y s j ø
athlète	a t l ɛ t
athlétisme	a t l e t i z m
athènes	a t ɛ n
atlantique	a t l ɑ̃ t i k
atmosphère	a t m ɔ s f ɛ ʁ
atomique	a t ɔ m i k
atone	a t ɔ n
atout	a t u
attachante	a t a ʃ ɑ̃ t
attachement	a t a ʃ m ɑ̃
attaquant	a t a k ɑ̃
attaque	a t a k
attaquer	a t a k e
attaques	a t a k
atteindre	a t ɛ̃ d ʁ
attend	a t ɑ̃
attendent	a t ɑ̃ d
attendez	a t ɑ̃ d e
attendons	a t ɑ̃ d ɔ̃
attendre	a t ɑ̃ d ʁ
attendrir	a t ɑ̃ d ʁ i ʁ
attends	a t ɑ̃
attendu	a t ɑ̃ d y
attente	a t ɑ̃ t
attention	a t ɑ̃ s j ɔ̃
attentivement	a t ɑ̃ t i v m ɑ̃
atterrir	a t ɛ ʁ i ʁ
attirer	a t i ʁ e
attitude	a t i t y d
attractif	a t ʁ a k t i f
attractive	a t ʁ a k t i v
attraper	a t ʁ a p e
attrayant	a t ʁ ɛ j ɑ̃
attribuer	a t ʁ i b ɥ e
attribut	a t ʁ i b y
atténuer	a t e n ɥ e
aubergiste	o b ɛ ʁ ʒ i s t
aucun	o k œ̃
aucune	o k y n
audace	o d a s
audacieux	o d a s j ø
audience	o d j ɑ̃ s
audio	o d j o
auditeurs	o d i t œ ʁ
audition	o d i s j ɔ̃
auditorium	o d i t ɔ ʁ j ɔ m
auger	o ʒ e
augure	o ɡ y ʁ
auguste	o ɡ y s t
augustin	o ɡ y s t ɛ̃
aune	o n
auprès	o p ʁ ɛ
auquel	o k ɛ l
aurélie	o ʁ e l i
aussi	o s i
aussitôt	o s i t o
australien	o s t ʁ a l j ɛ̃
autant	o t ɑ̃
authentique	o t ɑ̃ t i k
autobiographie	o t ɔ b j ɔ ɡ ʁ a f i
autobus	o t o b y s
autocar	o t o k a ʁ
automatiquement	o t ɔ m a t i k m ɑ̃
automatiques	o t ɔ m a t i k
automatisé	o t ɔ m a t i z e
automobile	o t ɔ m ɔ b i l
automobiliste	o t ɔ m ɔ b i l i s t
autopsie	o t ɔ p s i
autorisé	o t ɔ ʁ i z e
autoroute	o t ɔ ʁ u t
autoroutes	o t ɔ ʁ u t
autoroutier	o t ɔ ʁ u t j e
autre	o t ʁ
autrefois	o t ʁ ə f w a
autrement	o t ʁ ə m ɑ̃
autres	o t ʁ
autriche	o t ʁ i ʃ
autrichien	o t ʁ i ʃ j ɛ̃
autruche	o t ʁ y ʃ
auxerre	o s ɛ ʁ
auxquelles	o k ɛ l
auxquels	o k ɛ l
aval	a v a l
avalanche	a v a l ɑ̃ ʃ
avaler	a v a l e
avance	a v ɑ̃ s
avancement	a v ɑ̃ s m ɑ̃
avancer	a v ɑ̃ s e
avances	a v ɑ̃ s
avancé	a v ɑ̃ s e
avancée	a v ɑ̃ s e
avant	a v ɑ̃
avantage	a v ɑ̃ t a ʒ
avare	a v a ʁ
avatar	a v a t a ʁ
avec	a v ɛ k
avenir	a v n i ʁ
aventure	a v ɑ̃ t y ʁ
avenue	a v n y
avertir	a v ɛ ʁ t i ʁ
avertissement	a v ɛ ʁ t i s m ɑ̃
aveu	a v ø
aveugle	a v œ ɡ l
aveugles	a v œ ɡ l
aviation	a v j a s j ɔ̃
avion	a v j ɔ̃
avis	a v i
aviser	a v i z e
avisé	a v i z e
avocat	a v ɔ k a
avortement	a v ɔ ʁ t ə m ɑ̃
avorter	a v ɔ ʁ t e
avouer	a v w e
avril	a v ʁ i l
avérer	a v e ʁ e
axe	a k s
azur	a z y ʁ
açores	a s ɔ ʁ
aérien	a e ʁ j ɛ̃
aéronautique	a e ʁ ɔ n o t i k
aéronavale	a e ʁ ɔ n a v a l
baby	b a b i
bac	b a k
baccalauréat	b a k a l o ʁ e a
bactéries	b a k t e ʁ i
badaud	b a d o
badge	b a d ʒ
badminton	b a d m i n t ɔ n
bagage	b a ɡ a ʒ
bagages	b a ɡ a ʒ
bagues	b a ɡ
bah	b a
bahreïn	b a ʁ ɛ j n
baie	b ɛ
baignade	b ɛ ɲ a d
baignoire	b ɛ ɲ w a ʁ
bail	b a j
bain	b ɛ̃
baisse	b ɛ s
bakinoises	b a k i n w a z
balance	b a l ɑ̃ s
balayer	b a l ɛ j e
baleine	b a l ɛ n
balisage	b a l i z a ʒ
balise	b a l i z
baliser	b a l i z e
balivassiez	b a l i v a s j e
balkaniserons	b a l k a n i z ʁ ɔ̃
balle	b a l
ballet	b a l ɛ
ballon	b a l ɔ̃
balnéaire	b a l n e ɛ ʁ
balte	b a l t
balzac	b a l z a k
balèze	b a l ɛ z
bambin	b ɑ̃ b ɛ̃
bambou	b ɑ̃ b u
ban	b ɑ̃
banale	b a n a l
banc	b ɑ̃
bandage	b ɑ̃ d a ʒ
banderole	b ɑ̃ d ʁ ɔ l
bangkok	b ɑ̃ k ɔ k
banlieue	b ɑ̃ l j ø
bannière	b a n j ɛ ʁ
banque	b ɑ̃ k
banquet	b ɑ̃ k ɛ
baptiste	b a t i s t
baptême	b a t ɛ m
bar	b a ʁ
baragouinerait	b a ʁ a ɡ w i n ʁ ɛ
baraques	b a ʁ a k
barbichette	b a ʁ b i ʃ ɛ t
barbier	b a ʁ b j e
barbu	b a ʁ b y
barcelone	b a ʁ s ə l ɔ n
baromètre	b a ʁ ɔ m ɛ t ʁ
baron	b a ʁ ɔ̃
baroque	b a ʁ ɔ k
barrette	b a ʁ ɛ t
barricades	b a ʁ i k a d
barricadé	b a ʁ i k a d e
barrière	b a ʁ j ɛ ʁ
bars	b a ʁ
barthélemy	b a ʁ t e l e m i
baseball	b ɛ z b ɔ l
basile	b a z i l
basilique	b a z i l i k
basket	b a s k ɛ t
baskets	b a s k ɛ t
basque	b a s k
basques	b a s k
basse	b ɑ s
bassin	b a s ɛ̃
bastion	b a s t j ɔ̃
batave	b a t a v
batterie	b a t ʁ i
batteur	b a t œ ʁ
baudouin	b o d w ɛ̃
baume	b o m
bavarois	b a v a ʁ w a
bavures	b a v y ʁ
bd	b e d e
beauchamp	b o ʃ ɑ̃
beaucoup	b o k u
beaune	b o n
beaupré	b o p ʁ e
beauté	b o t e
beaux	b o
bec	b ɛ k
beijing	b e ʒ i ŋ
bel	b ɛ l
belfort	b ɛ l f ɔ ʁ
belle	b ɛ l
belles	b ɛ l
belvédère	b ɛ l v e d ɛ ʁ
benjamin	b ɛ̃ ʒ a m ɛ̃
benoît	b ə n w a
berbère	b ɛ ʁ b ɛ ʁ
bercer	b ɛ ʁ s e
bercy	b ɛ ʁ s i
berge	b ɛ ʁ ʒ
bergers	b ɛ ʁ ʒ e
berlin	b ɛ ʁ l ɛ̃
berna	b ɛ ʁ n a
bernadette	b ɛ ʁ n a d ɛ t
bernard	b ɛ ʁ n a ʁ
berne	b ɛ ʁ n
besogner	b ə z ɔ ɲ e
besoin	b ə z w ɛ̃
besson	b ɛ s ɔ̃
biarrote	b j a ʁ ɔ t
biathlon	b j a t l ɔ̃
biberon	b i b ʁ ɔ̃
bibi	b i b i
bibliothèque	b i b l i j ɔ t ɛ k
bic	b i k
biceps	b i s ɛ p s
bicipital	b i s i p i t a l
bicuspidée	b i k y s p i d e
bicyclette	b i s i k l ɛ t
bide	b i d
bidonville	b i d ɔ̃ v i l
bien	b j ɛ̃
bientôt	b j ɛ̃ t o
bienveillant	b j ɛ̃ v ɛ j ɑ̃
bienvenu	b j ɛ̃ v ə n y
bienvenue	b j ɛ̃ v ə n y
bigot	b i ɡ o
bikini	b i k i n i
bilan	b i l ɑ̃
bilatéral	b i l a t e ʁ a l
bilatérale	b i l a t e ʁ a l
bilatéraux	b i l a t e ʁ o
bill	b i l
bille	b i j
bingo	b i ŋ ɡ o
bio	b j o
biographie	b j ɔ ɡ ʁ a f i
biologique	b j ɔ l ɔ ʒ i k
biopic	b j ɔ p i k
biotechnologie	b j ɔ t ɛ k n ɔ l ɔ ʒ i
birdie	b œ ʁ d i
birman	b i ʁ m ɑ̃
birmanie	b i ʁ m a n i
biscaïen	b i s k a j ɛ̃
bitume	b i t y m
bizarre	b i z a ʁ
bière	b j ɛ ʁ
biélorussie	b j e l ɔ ʁ y s i
blablatant	b l a b l a t ɑ̃
black	b l a k
blacks	b l a k
blague	b l a ɡ
blair	b l ɛ ʁ
blaise	b l ɛ z
blanc	b l ɑ̃
blanche	b l ɑ̃ ʃ
blanchiment	b l ɑ̃ ʃ i m ɑ̃
blanchir	b l ɑ̃ ʃ i ʁ
blanchissage	b l ɑ̃ ʃ i s a ʒ
blanco	b l ɑ̃ k o
blase	b l a z
blasphématoires	b l a s f e m a t w a ʁ
blesse	b l ɛ s
blesser	b l e s e
blessure	b l e s y ʁ
blessures	b l e s y ʁ
blessé	b l e s e
bleu	b l ø
bleues	b l ø
bleus	b l ø
bloc	b l ɔ k
blocage	b l ɔ k a ʒ
blocus	b l ɔ k y s
blogue	b l ɔ ɡ
blonde	b l ɔ̃ d
blondîtes	b l ɔ̃ d i t
bloquer	b l ɔ k e
bloquiste	b l ɔ k i s t
bluff	b l œ f
bluffant	b l œ f ɑ̃
blâmé	b l a m e
blé	b l e
bob	b ɔ b
bobo	b o b o
bocal	b ɔ k a l
boire	b w a ʁ
boisson	b w a s ɔ̃
boite	b w a t
boiteux	b w a t ø
bolivie	b ɔ l i v i
bolivien	b ɔ l i v j ɛ̃
bombarder	b ɔ̃ b a ʁ d e
bombardier	b ɔ̃ b a ʁ d j e
bombay	b ɔ̃ b ɛ
bombe	b ɔ̃ b
bombes	b ɔ̃ b
bonaparte	b ɔ n a p a ʁ t
bonbons	b ɔ̃ b ɔ̃
bond	b ɔ̃
bonheur	b ɔ n œ ʁ
bonne	b ɔ n
bonnes	b ɔ n
bonnet	b ɔ n ɛ
bonshommes	b ɔ̃ z ɔ m
bonté	b ɔ̃ t e
bonus	b ɔ n y s
bordeaux	b ɔ ʁ d o
bordel	b ɔ ʁ d ɛ l
border	b ɔ ʁ d e
bordure	b ɔ ʁ d y ʁ
boré	b ɔ ʁ e
boréale	b ɔ ʁ e a l
boss	b ɔ s
bosser	b ɔ s e
botswana	b ɔ t s w a n a
botter	b ɔ t e
botté	b ɔ t e
boucan	b u k ɑ̃
bouche	b u ʃ
boucher	b u ʃ e
bouchon	b u ʃ ɔ̃
bouché	b u ʃ e
bouclages	b u k l a ʒ
boucle	b u k l
boucler	b u k l e
bouclette	b u k l ɛ t
bouder	b u d e
boue	b u
bouffe	b u f
bouffon	b u f ɔ̃
bouffée	b u f e
bouge	b u ʒ
bouger	b u ʒ e
bougie	b u ʒ i
bougnoule	b u ɲ u l
bougonnerez	b u ɡ ɔ n ʁ e
bouillir	b u j i ʁ
bouillon	b u j ɔ̃
boulanger	b u l ɑ̃ ʒ e
boulangère	b u l ɑ̃ ʒ ɛ ʁ
boulet	b u l ɛ
boulevard	b u l v a ʁ
bouleversement	b u l v ɛ ʁ s ə m ɑ̃
bouleverser	b u l v ɛ ʁ s e
boulingrin	b u l ɛ̃ ɡ ʁ ɛ̃
boulot	b u l o
boum	b u m
bouquet	b u k ɛ
bourdonnement	b u ʁ d ɔ n m ɑ̃
bourg	b u ʁ
bourgade	b u ʁ ɡ a d
bourgeois	b u ʁ ʒ w a
bourges	b u ʁ ʒ
bourgogne	b u ʁ ɡ ɔ ɲ
bourrasque	b u ʁ a s k
bourreau	b u ʁ o
bourse	b u ʁ s
boursière	b u ʁ s j ɛ ʁ
boursières	b u ʁ s j ɛ ʁ
bousculent	b u s k y l
bousculer	b u s k y l e
bousculé	b u s k y l e
bouteille	b u t ɛ j
bouteilles	b u t ɛ j
boutique	b u t i k
bouton	b u t ɔ̃
box	b ɔ k s
boxe	b ɔ k s
boxeur	b ɔ k s œ ʁ
boy	b ɔ j
boycott	b ɔ j k ɔ t
boyer	b w a j e
bracelet	b ʁ a s l ɛ
braisé	b ʁ ɛ z e
branche	b ʁ ɑ̃ ʃ
brandir	b ʁ ɑ̃ d i ʁ
brandis	b ʁ ɑ̃ d i
brandon	b ʁ ɑ̃ d ɔ̃
branleur	b ʁ ɑ̃ l œ ʁ
branlocher	b ʁ ɑ̃ l ɔ ʃ e
braquage	b ʁ a k a ʒ
braquer	b ʁ a k e
braserais	b ʁ a z ʁ ɛ
brassard	b ʁ a s a ʁ
brasser	b ʁ a s e
brasseur	b ʁ a s œ ʁ
brassée	b ʁ a s e
braver	b ʁ a v e
braves	b ʁ a v
bravo	b ʁ a v o
bref	b ʁ ɛ f
breloque	b ʁ ə l ɔ k
bretagne	b ʁ ə t a ɲ
bretelles	b ʁ ə t ɛ l
breton	b ʁ ə t ɔ̃
bretons	b ʁ ə t ɔ̃
brevet	b ʁ ə v ɛ
brice	b ʁ i s
brick	b ʁ i k
brigade	b ʁ i ɡ a d
brigitte	b ʁ i ʒ i t
brindille	b ʁ ɛ̃ d i j
brio	b ʁ i j o
brise	b ʁ i z
briser	b ʁ i z e
britannique	b ʁ i t a n i k
british	b ʁ i t i ʃ
brièvement	b ʁ i j ɛ v m ɑ̃
brocarder	b ʁ ɔ k a ʁ d e
brocoli	b ʁ ɔ k ɔ l i
brou	b ʁ u
brouillard	b ʁ u j a ʁ
broussaille	b ʁ u s a j
brousse	b ʁ u s
broyer	b ʁ w a j e
bruges	b ʁ y ʒ
brume	b ʁ y m
brunch	b ʁ œ n ʃ
brune	b ʁ y n
bruno	b ʁ y n o
brushing	b ʁ œ ʃ i ŋ
brusquement	b ʁ y s k ə m ɑ̃
brut	b ʁ y t
brutale	b ʁ y t a l
brutalement	b ʁ y t a l m ɑ̃
brutales	b ʁ y t a l
brutalité	b ʁ y t a l i t e
brève	b ʁ ɛ v
brésil	b ʁ e z i l
brésilien	b ʁ e z i l j ɛ̃
brême	b ʁ ɛ m
brûler	b ʁ y l e
brûlé	b ʁ y l e
bu	b y
bucarest	b y k a ʁ ɛ s t
budapest	b y d a p ɛ s t
budget	b y d ʒ ɛ
buffet	b y f ɛ
bulgare	b y l ɡ a ʁ
bulgarie	b y l ɡ a ʁ i
bulle	b y l
bulletin	b y l t ɛ̃
buraliste	b y ʁ a l i s t
bureau	b y ʁ o
bureautique	b y ʁ o t i k
burlesque	b y ʁ l ɛ s k
business	b i z n ɛ s
businessmen	b i z n ɛ s m ɛ n
buter	b y t e
butin	b y t ɛ̃
butoir	b y t w a ʁ
butte	b y t
buttions	b y t j ɔ̃
buttèrent	b y t ɛ ʁ
buée	b ɥ e
bye	b a j
bâti	b ɑ t i
bâtie	b ɑ t i
bâties	b ɑ t i
bâtiment	b ɑ t i m ɑ̃
bâtir	b ɑ t i ʁ
bâton	b ɑ t ɔ̃
bègue	b ɛ ɡ
bébé	b e b e
bélître	b e l i t ʁ
bémol	b e m ɔ l
bénédiction	b e n e d i k s j ɔ̃
bénéficiaire	b e n e f i s j ɛ ʁ
bénéficiaires	b e n e f i s j ɛ ʁ
bénéficie	b e n e f i s i
bénéficient	b e n e f i s i
bénéficier	b e n e f i s j e
bénéficié	b e n e f i s j e
bénéfique	b e n e f i k
bénévole	b e n e v ɔ l
bétail	b e t a j
béton	b e t ɔ̃
bête	b ɛ t
bêtise	b e t i z
ca	s e a
cabale	k a b a l
cabaret	k a b a ʁ ɛ
cabine	k a b i n
cabines	k a b i n
cabinet	k a b i n ɛ
cac	k a k
cacao	k a k a o
cache	k a ʃ
caché	k a ʃ e
cacophonie	k a k ɔ f ɔ n i
cadavre	k a d ɑ v ʁ
cadavres	k a d a v ʁ
cadeaux	k a d o
cadenette	k a d n ɛ t
cadet	k a d ɛ
cadre	k ɑ d ʁ
caen	k ɑ̃
café	k a f e
caféine	k a f e i n
cage	k a ʒ
cagnotte	k a ɲ ɔ t
cahier	k a j e
cahiers	k a j e
caisse	k ɛ s
caissière	k ɛ s j ɛ ʁ
cake	k ɛ k
cal	k a l
calabre	k a l a b ʁ
calcul	k a l k y l
calculer	k a l k y l e
calendrier	k a l ɑ̃ d ʁ i j e
caler	k a l e
calibre	k a l i b ʁ
californie	k a l i f ɔ ʁ n i
calme	k a l m
calmer	k a l m e
calmes	k a l m
calomnieuse	k a l ɔ m n j ø z
calvitie	k a l v i s i
cam	k a m
camarade	k a m a ʁ a d
cambodge	k ɑ̃ b ɔ d ʒ
cameroun	k a m ʁ u n
camerounais	k a m ʁ u n ɛ
camphrier	k ɑ̃ f ʁ i j e
camps	k ɑ̃
campus	k ɑ̃ p y s
caméra	k a m e ʁ a
canadien	k a n a d j ɛ̃
canadienne	k a n a d j ɛ n
canadiens	k a n a d j ɛ̃
canal	k a n a l
canaux	k a n o
cancer	k ɑ̃ s ɛ ʁ
candidats	k ɑ̃ d i d a
canicule	k a n i k y l
caniveau	k a n i v o
canne	k a n
cannelle	k a n ɛ l
cannes	k a n
cannibale	k a n i b a l
canon	k a n ɔ̃
canot	k a n o
canoë	k a n ɔ e
cantal	k ɑ̃ t a l
canterbury	k ɑ̃ t ɛ ʁ b œ ʁ i
cantine	k ɑ̃ t i n
canton	k ɑ̃ t ɔ̃
cap	k a p
capa	k a p a
capable	k a p a b l
capacité	k a p a s i t e
capacités	k a p a s i t e
cape	k a p
capita	k a p i t a
capitaine	k a p i t ɛ n
capital	k a p i t a l
capitales	k a p i t a l
capitaliser	k a p i t a l i z e
capitaux	k a p i t o
capot	k a p o
capte	k a p t
capter	k a p t e
capturer	k a p t y ʁ e
capuche	k a p y ʃ
car	k a ʁ
carabine	k a ʁ a b i n
caractère	k a ʁ a k t ɛ ʁ
caramel	k a ʁ a m ɛ l
caravane	k a ʁ a v a n
caraïbes	k a ʁ a i b
carbone	k a ʁ b ɔ n
carcasse	k a ʁ k a s
cardinal	k a ʁ d i n a l
carence	k a ʁ ɑ̃ s
caresse	k a ʁ ɛ s
cargaison	k a ʁ ɡ ɛ z ɔ̃
cargo	k a ʁ ɡ o
cari	k a ʁ i
carillon	k a ʁ i j ɔ̃
carla	k a ʁ l a
carnaval	k a ʁ n a v a l
carole	k a ʁ ɔ l
caroline	k a ʁ ɔ l i n
caron	k a ʁ ɔ̃
carotte	k a ʁ ɔ t
carreau	k a ʁ o
carrefour	k a ʁ f u ʁ
carrera	k a ʁ ə ʁ a
carrez	k a ʁ e
carrier	k a ʁ j e
carrière	k a ʁ j ɛ ʁ
carrément	k a ʁ e m ɑ̃
carte	k a ʁ t
cartel	k a ʁ t ɛ l
cartes	k a ʁ t
cartilage	k a ʁ t i l a ʒ
cartographie	k a ʁ t ɔ ɡ ʁ a f i
carton	k a ʁ t ɔ̃
carême	k a ʁ ɛ m
cas	k ɑ
cascade	k a s k a d
case	k ɑ z
caser	k ɑ z e
caserne	k a z ɛ ʁ n
casino	k a z i n o
casques	k a s k
cassation	k a s a s j ɔ̃
casse	k ɑ s
casser	k ɑ s e
casseroles	k a s ʁ ɔ l
casseurs	k a s œ ʁ
cassis	k a s i s
cassonade	k a s ɔ n a d
cassé	k ɑ s e
castex	k a s t ɛ k s
casting	k a s t i ŋ
castor	k a s t ɔ ʁ
castrer	k a s t ʁ e
catalan	k a t a l ɑ̃
catalans	k a t a l ɑ̃
catalogne	k a t a l ɔ ɲ
catane	k a t a n
catapulte	k a t a p y l t
cataracte	k a t a ʁ a k t
catastrophe	k a t a s t ʁ ɔ f
catastrophique	k a t a s t ʁ ɔ f i k
catholique	k a t ɔ l i k
catholiques	k a t ɔ l i k
cathédrale	k a t e d ʁ a l
cation	k a t j ɔ̃
caucase	k ɔ k a z
cause	k o z
causer	k o z e
causes	k o z
caution	k o s j ɔ̃
cautionner	k o s j ɔ n e
cavaler	k a v a l e
cavalier	k a v a l j e
cave	k a v
caveau	k a v o
cd	s e d e
ce	s ə
ceinture	s ɛ̃ t y ʁ
celle	s ɛ l
celles	s ɛ l
cellulaire	s ɛ l y l ɛ ʁ
cellules	s ɛ l y l
celui	s ə l ɥ i
cendre	s ɑ̃ d ʁ
cendrillon	s ɑ̃ d ʁ i j ɔ̃
censure	s ɑ̃ s y ʁ
censurer	s ɑ̃ s y ʁ e
centimes	s ɑ̃ t i m
central	s ɑ̃ t ʁ a l
centrale	s ɑ̃ t ʁ a l
centralisation	s ɑ̃ t ʁ a l i z a s j ɔ̃
centriste	s ɑ̃ t ʁ i s t
centristes	s ɑ̃ t ʁ i s t
cep	s ɛ p
cependant	s ə p ɑ̃ d ɑ̃
cercle	s ɛ ʁ k l
cerner	s ɛ ʁ n e
certain	s ɛ ʁ t ɛ̃
certainement	s ɛ ʁ t ɛ n m ɑ̃
certification	s ɛ ʁ t i f i k a s j ɔ̃
certitudes	s ɛ ʁ t i t y d
cerveau	s ɛ ʁ v o
cerveaux	s ɛ ʁ v o
cession	s ɛ s j ɔ̃
cet	s ɛ t ‿
cette	s ɛ t
ceux	s ø
cgt	s e ʒ e t e
chacun	ʃ a k œ̃
chacune	ʃ a k y n
chahutent	ʃ a y t
chahuter	ʃ a y t e
chaine	ʃ ɛ n
chair	ʃ ɛ ʁ
chaire	ʃ ɛ ʁ
chaise	ʃ ɛ z
chaleur	ʃ a l œ ʁ
chaleureux	ʃ a l œ ʁ ø
challenge	ʃ a l ɑ̃ ʒ
chamoiserie	ʃ a m w a z ʁ i
champ	ʃ ɑ̃
champion	ʃ ɑ̃ p j ɔ̃
championnat	ʃ ɑ̃ p j ɔ n a
champlain	ʃ ɑ̃ p l ɛ̃
chance	ʃ ɑ̃ s
chances	ʃ ɑ̃ s
chandail	ʃ ɑ̃ d a j
change	ʃ ɑ̃ ʒ
changement	ʃ ɑ̃ ʒ m ɑ̃
changer	ʃ ɑ̃ ʒ e
changé	ʃ ɑ̃ ʒ e
chansonnette	ʃ ɑ̃ s ɔ n ɛ t
chantait	ʃ ɑ̃ t ɛ
chantal	ʃ ɑ̃ t a l
chante	ʃ ɑ̃ t
chanter	ʃ ɑ̃ t e
chanteur	ʃ ɑ̃ t œ ʁ
chanteuse	ʃ ɑ̃ t ø z
chantier	ʃ ɑ̃ t j e
chanvre	ʃ ɑ̃ v ʁ
chaotique	k a ɔ t i k
chapeau	ʃ a p o
chapeaux	ʃ a p o
chaque	ʃ a k
char	ʃ a ʁ
charbon	ʃ a ʁ b ɔ̃
charge	ʃ a ʁ ʒ
chargement	ʃ a ʁ ʒ ə m ɑ̃
charges	ʃ a ʁ ʒ
charismatique	k a ʁ i s m a t i k
charlemagne	ʃ a ʁ l ə m a ɲ
charleroi	ʃ a ʁ l ə ʁ w a
charles	ʃ a ʁ l
charmant	ʃ a ʁ m ɑ̃
charme	ʃ a ʁ m
charnière	ʃ a ʁ n j ɛ ʁ
charrette	ʃ a ʁ ɛ t
charrie	ʃ a ʁ i
charrue	ʃ a ʁ y
chartres	ʃ a ʁ t ʁ
chasse	ʃ a s
chasser	ʃ a s e
chasseur	ʃ a s œ ʁ
chassé	ʃ a s e
chateaubriand	ʃ a t o b ʁ i j ɑ̃
chatouillante	ʃ a t u j ɑ̃ t
chaudron	ʃ o d ʁ ɔ̃
chauffage	ʃ o f a ʒ
chauffeur	ʃ o f œ ʁ
chaussettes	ʃ o s ɛ t
chaussure	ʃ o s y ʁ
chaussée	ʃ o s e
chauve	ʃ o v
chaîne	ʃ ɛ n
check	t ʃ ɛ k
chef	ʃ ɛ f
cheffe	ʃ ɛ f
chefferie	ʃ ɛ f ʁ i
chefs	ʃ ɛ f
cheikh	ʃ ɛ k
chelem	ʃ l ɛ m
chemin	ʃ ə m ɛ̃
chemise	ʃ ə m i z
chemises	ʃ ə m i z
chenu	ʃ ə n y
cher	ʃ ɛ ʁ
cherbourg	ʃ ɛ ʁ b u ʁ
cherchait	ʃ ɛ ʁ ʃ ɛ
cherche	ʃ ɛ ʁ ʃ
cherchent	ʃ ɛ ʁ ʃ
chercher	ʃ ɛ ʁ ʃ e
cherches	ʃ ɛ ʁ ʃ
chercheur	ʃ ɛ ʁ ʃ œ ʁ
chers	ʃ ɛ ʁ
cherté	ʃ ɛ ʁ t e
cheval	ʃ ə v a l
chevalier	ʃ ə v a l j e
chevaux	ʃ ə v o
chevelure	ʃ ə v ə l y ʁ
chevet	ʃ ə v ɛ
chevron	ʃ ə v ʁ ɔ̃
chez	ʃ e
chiant	ʃ j ɑ̃
chicago	ʃ i k a ɡ o
chicanes	ʃ i k a n
chien	ʃ j ɛ̃
chiffrage	ʃ i f ʁ a ʒ
chiffre	ʃ i f ʁ
chiffres	ʃ i f ʁ
chilien	ʃ i l j ɛ̃
chimie	ʃ i m i
chimique	ʃ i m i k
chimpanzé	ʃ ɛ̃ p ɑ̃ z e
chimère	ʃ i m ɛ ʁ
chine	ʃ i n
chinoiserez	ʃ i n w a z ʁ e
chiper	ʃ i p e
chirurgie	ʃ i ʁ y ʁ ʒ i
choisir	ʃ w a z i ʁ
choix	ʃ w a
choléra	k ɔ l e ʁ a
chopinons	ʃ ɔ p i n ɔ̃
choque	ʃ ɔ k
choquer	ʃ ɔ k e
chorale	k ɔ ʁ a l
chorégraphes	k ɔ ʁ e ɡ ʁ a f
chorégraphique	k ɔ ʁ e ɡ ʁ a f i k
christian	k ʁ i s t j ɑ̃
christiane	k ʁ i s t j a n
christophe	k ʁ i s t ɔ f
chrome	k ʁ o m
chronique	k ʁ ɔ n i k
chrono	k ʁ ɔ n o
chronologie	k ʁ ɔ n ɔ l ɔ ʒ i
chronomètre	k ʁ ɔ n ɔ m ɛ t ʁ
chrétienne	k ʁ e t j ɛ n
chu	ʃ y
chute	ʃ y t
chypre	ʃ i p ʁ
château	ʃ ɑ t o
châtelet	ʃ ɑ t l ɛ
châtiment	ʃ ɑ t i m ɑ̃
chère	ʃ ɛ ʁ
chères	ʃ ɛ ʁ
chômage	ʃ o m a ʒ
chômer	ʃ o m e
cia	s e i a
ciblant	s i b l ɑ̃
cible	s i b l
cibler	s i b l e
ciblons	s i b l ɔ̃
ciblé	s i b l e
ciel	s j ɛ l
cieux	s j ø
cigarette	s i ɡ a ʁ ɛ t
cigarettes	s i ɡ a ʁ ɛ t
cigogne	s i ɡ ɔ ɲ
ciment	s i m ɑ̃
cimes	s i m
cimetière	s i m t j ɛ ʁ
cinquantaine	s ɛ̃ k ɑ̃ t ɛ n
cinquantenaire	s ɛ̃ k ɑ̃ t n ɛ ʁ
cinquième	s ɛ̃ k j ɛ m
ciné	s i n e
cinéma	s i n e m a
cinématographique	s i n e m a t ɔ ɡ ʁ a f i k
cinématographiques	s i n e m a t ɔ ɡ ʁ a f i k
circonstance	s i ʁ k ɔ̃ s t ɑ̃ s
circuit	s i ʁ k ɥ i
circuits	s i ʁ k ɥ i
circulaire	s i ʁ k y l ɛ ʁ
circuler	s i ʁ k y l e
cirer	s i ʁ e
cirque	s i ʁ k
citation	s i t a s j ɔ̃
citer	s i t e
citoyen	s i t w a j ɛ̃
citoyenne	s i t w a j ɛ n
citron	s i t ʁ ɔ̃
cité	s i t e
civil	s i v i l
civilisation	s i v i l i z a s j ɔ̃
civique	s i v i k
clairement	k l ɛ ʁ m ɑ̃
clairvoyance	k l ɛ ʁ v w a j ɑ̃ s
clamer	k l a m e
clan	k l ɑ̃
claque	k l a k
claquements	k l a k m ɑ̃
clarté	k l a ʁ t e
classer	k l a s e
classique	k l a s i k
classiques	k l a s i k
claudia	k l o d j a
claudine	k l o d i n
clavier	k l a v j e
clef	k l e
clercs	k l ɛ ʁ
cliché	k l i ʃ e
clichés	k l i ʃ e
client	k l i j ɑ̃
clients	k l i j ɑ̃
clientèle	k l i j ɑ̃ t ɛ l
climatique	k l i m a t i k
clip	k l i p
clips	k l i p
cliquetis	k l i k t i
cloche	k l ɔ ʃ
clope	k l ɔ p
clos	k l o
closes	k l o z
clotilde	k l ɔ t i l d
clou	k l u
cloutier	k l u t j e
clown	k l u n
clé	k l e
clémence	k l e m ɑ̃ s
clés	k l e
clôture	k l o t y ʁ
clôturer	k l o t y ʁ e
coach	k o t ʃ
cocktail	k ɔ k t ɛ l
code	k ɔ d
coexistence	k ɔ ɛ ɡ z i s t ɑ̃ s
coffre	k ɔ f ʁ
coffret	k ɔ f ʁ ɛ
cognac	k ɔ ɲ a k
cogner	k ɔ ɲ e
cohabitation	k ɔ a b i t a s j ɔ̃
cohue	k ɔ y
cohérence	k ɔ e ʁ ɑ̃ s
cohérent	k ɔ e ʁ ɑ̃
cohésion	k ɔ e z j ɔ̃
coi	k w a
coiffer	k w a f e
coiffeuse	k w a f ø z
coiffure	k w a f y ʁ
coin	k w ɛ̃
coke	k ɔ k
col	k ɔ l
colin	k ɔ l ɛ̃
colisée	k ɔ l i z e
collaboratif	k ɔ l a b ɔ ʁ a t i f
collaboration	k ɔ l a b ɔ ʁ a s j ɔ̃
collaborations	k ɔ l a b ɔ ʁ a s j ɔ̃
collage	k ɔ l a ʒ
collation	k ɔ l a s j ɔ̃
colle	k ɔ l
collecte	k ɔ l ɛ k t
collectif	k ɔ l ɛ k t i f
collectifs	k ɔ l ɛ k t i f
collection	k ɔ l ɛ k s j ɔ̃
collectionneur	k ɔ l ɛ k s j ɔ n œ ʁ
collectivité	k ɔ l ɛ k t i v i t e
collectivités	k ɔ l ɛ k t i v i t e
collera	k ɔ l ʁ a
collier	k ɔ l j e
colline	k ɔ l i n
collision	k ɔ l i z j ɔ̃
collège	k ɔ l ɛ ʒ
collègue	k ɔ l ɛ ɡ
colmater	k ɔ l m a t e
cologne	k ɔ l ɔ ɲ
colombarde	k ɔ l ɔ̃ b a ʁ d
colombie	k ɔ l ɔ̃ b i
colombien	k ɔ l ɔ̃ b j ɛ̃
colonel	k ɔ l ɔ n ɛ l
colonie	k ɔ l ɔ n i
colza	k ɔ l z a
colère	k ɔ l ɛ ʁ
combattants	k ɔ̃ b a t ɑ̃
combien	k ɔ̃ b j ɛ̃
combinaison	k ɔ̃ b i n ɛ z ɔ̃
combiner	k ɔ̃ b i n e
combiné	k ɔ̃ b i n e
comble	k ɔ̃ b l
combler	k ɔ̃ b l e
combles	k ɔ̃ b l
comité	k ɔ m i t e
commandant	k ɔ m ɑ̃ d ɑ̃
commandante	k ɔ m ɑ̃ d ɑ̃ t
commande	k ɔ m ɑ̃ d
commandement	k ɔ m ɑ̃ d m ɑ̃
commander	k ɔ m ɑ̃ d e
commando	k ɔ m ɑ̃ d o
comme	k ɔ m
commencer	k ɔ m ɑ̃ s e
comment	k ɔ m ɑ̃
commentaire	k ɔ m ɑ̃ t ɛ ʁ
commentaires	k ɔ m ɑ̃ t ɛ ʁ
commenter	k ɔ m ɑ̃ t e
commerce	k ɔ m ɛ ʁ s
commercial	k ɔ m ɛ ʁ s j a l
commerciale	k ɔ m ɛ ʁ s j a l
commerciales	k ɔ m ɛ ʁ s j a l
commercialisation	k ɔ m ɛ ʁ s j a l i z a s j ɔ̃
commercialisations	k ɔ m ɛ ʁ s j a l i z a s j ɔ̃
commerciaux	k ɔ m ɛ ʁ s j o
commerçant	k ɔ m ɛ ʁ s ɑ̃
commettant	k ɔ m ɛ t ɑ̃
commettre	k ɔ m ɛ t ʁ
commis	k ɔ m i
commissariat	k ɔ m i s a ʁ j a
commun	k ɔ m œ̃
communale	k ɔ m y n a l
communauté	k ɔ m y n o t e
communautés	k ɔ m y n o t e
commune	k ɔ m y n
communication	k ɔ m y n i k a s j ɔ̃
communiquer	k ɔ m y n i k e
communisme	k ɔ m y n i s m
communiste	k ɔ m y n i s t
commémoratif	k ɔ m e m ɔ ʁ a t i f
commémorer	k ɔ m e m ɔ ʁ e
comores	k ɔ m ɔ ʁ
compact	k ɔ̃ p a k t
compagnie	k ɔ̃ p a ɲ i
compagnies	k ɔ̃ p a ɲ i
compagnon	k ɔ̃ p a ɲ ɔ̃
comparable	k ɔ̃ p a ʁ a b l
comparaison	k ɔ̃ p a ʁ ɛ z ɔ̃
comparaître	k ɔ̃ p a ʁ ɛ t ʁ
comparer	k ɔ̃ p a ʁ e
compartiment	k ɔ̃ p a ʁ t i m ɑ̃
comparution	k ɔ̃ p a ʁ y s j ɔ̃
compas	k ɔ̃ p ɑ
compassion	k ɔ̃ p a s j ɔ̃
compatible	k ɔ̃ p a t i b l
compatriote	k ɔ̃ p a t ʁ i j ɔ t
compense	k ɔ̃ p ɑ̃ s
compenser	k ɔ̃ p ɑ̃ s e
compilateur	k ɔ̃ p i l a t œ ʁ
compiler	k ɔ̃ p i l e
complaire	k ɔ̃ p l ɛ ʁ
complaisant	k ɔ̃ p l ɛ z ɑ̃
complet	k ɔ̃ p l ɛ
complexe	k ɔ̃ p l ɛ k s
complications	k ɔ̃ p l i k a s j ɔ̃
complique	k ɔ̃ p l i k
complot	k ɔ̃ p l o
complètement	k ɔ̃ p l ɛ t m ɑ̃
complément	k ɔ̃ p l e m ɑ̃
compléter	k ɔ̃ p l e t e
comportemental	k ɔ̃ p ɔ ʁ t ə m ɑ̃ t a l
comporter	k ɔ̃ p ɔ ʁ t e
composant	k ɔ̃ p o z ɑ̃
composer	k ɔ̃ p o z e
composite	k ɔ̃ p o z i t
compositeur	k ɔ̃ p o z i t œ ʁ
composition	k ɔ̃ p o z i s j ɔ̃
composé	k ɔ̃ p o z e
comprendre	k ɔ̃ p ʁ ɑ̃ d ʁ
compris	k ɔ̃ p ʁ i
compromettre	k ɔ̃ p ʁ ɔ m ɛ t ʁ
compromis	k ɔ̃ p ʁ ɔ m i
compréhension	k ɔ̃ p ʁ e ɑ̃ s j ɔ̃
compteur	k ɔ̃ t œ ʁ
comptoir	k ɔ̃ t w a ʁ
computer	k ɔ̃ p y t e
compétition	k ɔ̃ p e t i s j ɔ̃
compétitive	k ɔ̃ p e t i t i v
compétitivité	k ɔ̃ p e t i t i v i t e
comté	k ɔ̃ t e
comète	k ɔ m ɛ t
comédie	k ɔ m e d i
comédien	k ɔ m e d j ɛ̃
comédienne	k ɔ m e d j ɛ n
comédiennes	k ɔ m e d j ɛ n
comédies	k ɔ m e d i
concentrer	k ɔ̃ s ɑ̃ t ʁ e
concept	k ɔ̃ s ɛ p t
conception	k ɔ̃ s ɛ p s j ɔ̃
concernant	k ɔ̃ s ɛ ʁ n ɑ̃
concerné	k ɔ̃ s ɛ ʁ n e
concevoir	k ɔ̃ s ə v w a ʁ
conclu	k ɔ̃ k l y
conclure	k ɔ̃ k l y ʁ
conclusion	k ɔ̃ k l y z j ɔ̃
concordance	k ɔ̃ k ɔ ʁ d ɑ̃ s
concourrait	k ɔ̃ k u ʁ ʁ ɛ
concours	k ɔ̃ k u ʁ
concurrence	k ɔ̃ k y ʁ ɑ̃ s
concurrencé	k ɔ̃ k y ʁ ɑ̃ s e
condensateur	k ɔ̃ d ɑ̃ s a t œ ʁ
conditionnel	k ɔ̃ d i s j ɔ n ɛ l
condoléances	k ɔ̃ d ɔ l e ɑ̃ s
conducteur	k ɔ̃ d y k t œ ʁ
conduire	k ɔ̃ d ɥ i ʁ
conduit	k ɔ̃ d ɥ i
condé	k ɔ̃ d e
confession	k ɔ̃ f ɛ s j ɔ̃
confiance	k ɔ̃ f j ɑ̃ s
confiante	k ɔ̃ f j ɑ̃ t
confiantes	k ɔ̃ f j ɑ̃ t
confier	k ɔ̃ f j e
confirme	k ɔ̃ f i ʁ m
confirmer	k ɔ̃ f i ʁ m e
conflit	k ɔ̃ f l i
conforme	k ɔ̃ f ɔ ʁ m
conformer	k ɔ̃ f ɔ ʁ m e
conformément	k ɔ̃ f ɔ ʁ m e m ɑ̃
confortable	k ɔ̃ f ɔ ʁ t a b l
confrontation	k ɔ̃ f ʁ ɔ̃ t a s j ɔ̃
confrère	k ɔ̃ f ʁ ɛ ʁ
confrères	k ɔ̃ f ʁ ɛ ʁ
confusion	k ɔ̃ f y z j ɔ̃
confédération	k ɔ̃ f e d e ʁ a s j ɔ̃
conférencier	k ɔ̃ f e ʁ ɑ̃ s j e
congestion	k ɔ̃ ʒ ɛ s t j ɔ̃
congo	k ɔ̃ ɡ o
congolais	k ɔ̃ ɡ ɔ l ɛ
congé	k ɔ̃ ʒ e
conjoint	k ɔ̃ ʒ w ɛ̃
conjoncture	k ɔ̃ ʒ ɔ̃ k t y ʁ
conjugaison	k ɔ̃ ʒ y ɡ ɛ z ɔ̃
conjugal	k ɔ̃ ʒ y ɡ a l
conjugale	k ɔ̃ ʒ y ɡ a l
conjugales	k ɔ̃ ʒ y ɡ a l
conjuguer	k ɔ̃ ʒ y ɡ e
connais	k ɔ n ɛ
connaissance	k ɔ n ɛ s ɑ̃ s
connaissances	k ɔ n ɛ s ɑ̃ s
connaisse	k ɔ n ɛ s
connaissent	k ɔ n ɛ s
connard	k ɔ n a ʁ
connaît	k ɔ n ɛ
connaître	k ɔ n ɛ t ʁ
connerie	k ɔ n ʁ i
connexion	k ɔ n ɛ k s j ɔ̃
connotation	k ɔ n ɔ t a s j ɔ̃
connu	k ɔ n y
conquérir	k ɔ̃ k e ʁ i ʁ
conquête	k ɔ̃ k ɛ t
consacrer	k ɔ̃ s a k ʁ e
conscience	k ɔ̃ s j ɑ̃ s
conscient	k ɔ̃ s j ɑ̃
conseil	k ɔ̃ s ɛ j
conseillère	k ɔ̃ s ɛ j ɛ ʁ
consentement	k ɔ̃ s ɑ̃ t m ɑ̃
conservateur	k ɔ̃ s ɛ ʁ v a t œ ʁ
conservative	k ɔ̃ s ɛ ʁ v a t i v
conservatoire	k ɔ̃ s ɛ ʁ v a t w a ʁ
conserver	k ɔ̃ s ɛ ʁ v e
considérable	k ɔ̃ s i d e ʁ a b l
considération	k ɔ̃ s i d e ʁ a s j ɔ̃
considérer	k ɔ̃ s i d e ʁ e
consigne	k ɔ̃ s i ɲ
consolation	k ɔ̃ s ɔ l a s j ɔ̃
console	k ɔ̃ s ɔ l
consoler	k ɔ̃ s ɔ l e
consolider	k ɔ̃ s ɔ l i d e
consommateur	k ɔ̃ s ɔ m a t œ ʁ
consommation	k ɔ̃ s ɔ m a s j ɔ̃
conspiration	k ɔ̃ s p i ʁ a s j ɔ̃
conspuaient	k ɔ̃ s p ɥ ɛ
conspuer	k ɔ̃ s p ɥ e
constance	k ɔ̃ s t ɑ̃ s
constant	k ɔ̃ s t ɑ̃
constante	k ɔ̃ s t ɑ̃ t
constants	k ɔ̃ s t ɑ̃
constat	k ɔ̃ s t a
constatation	k ɔ̃ s t a t a s j ɔ̃
constatations	k ɔ̃ s t a t a s j ɔ̃
constate	k ɔ̃ s t a t
constater	k ɔ̃ s t a t e
constats	k ɔ̃ s t a
consternait	k ɔ̃ s t ɛ ʁ n ɛ
consternés	k ɔ̃ s t ɛ ʁ n e
constitution	k ɔ̃ s t i t y s j ɔ̃
constitutionnel	k ɔ̃ s t i t y s j ɔ n ɛ l
constructeur	k ɔ̃ s t ʁ y k t œ ʁ
construction	k ɔ̃ s t ʁ y k s j ɔ̃
construire	k ɔ̃ s t ʁ ɥ i ʁ
construit	k ɔ̃ s t ʁ ɥ i
consulat	k ɔ̃ s y l a
consultant	k ɔ̃ s y l t ɑ̃
consultants	k ɔ̃ s y l t ɑ̃
consulter	k ɔ̃ s y l t e
consumai	k ɔ̃ s y m e
consume	k ɔ̃ s y m
consumer	k ɔ̃ s y m e
consécration	k ɔ̃ s e k ʁ a s j ɔ̃
consécutif	k ɔ̃ s e k y t i f
conséquence	k ɔ̃ s e k ɑ̃ s
conséquent	k ɔ̃ s e k ɑ̃
contact	k ɔ̃ t a k t
contacter	k ɔ̃ t a k t e
container	k ɔ̃ t ɛ n ɛ ʁ
contamination	k ɔ̃ t a m i n a s j ɔ̃
contaminer	k ɔ̃ t a m i n e
conte	k ɔ̃ t
contempler	k ɔ̃ t ɑ̃ p l e
contemporains	k ɔ̃ t ɑ̃ p ɔ ʁ ɛ̃
contente	k ɔ̃ t ɑ̃ t
contenter	k ɔ̃ t ɑ̃ t e
contentieux	k ɔ̃ t ɑ̃ s j ø
contes	k ɔ̃ t
contestait	k ɔ̃ t ɛ s t ɛ
contestant	k ɔ̃ t ɛ s t ɑ̃
conteste	k ɔ̃ t ɛ s t
contestent	k ɔ̃ t ɛ s t
contester	k ɔ̃ t ɛ s t e
contesté	k ɔ̃ t ɛ s t e
conteur	k ɔ̃ t œ ʁ
contexte	k ɔ̃ t ɛ k s t
continent	k ɔ̃ t i n ɑ̃
contingent	k ɔ̃ t ɛ̃ ʒ ɑ̃
continuellement	k ɔ̃ t i n ɥ ɛ l m ɑ̃
contourner	k ɔ̃ t u ʁ n e
contraction	k ɔ̃ t ʁ a k s j ɔ̃
contradiction	k ɔ̃ t ʁ a d i k s j ɔ̃
contradictoire	k ɔ̃ t ʁ a d i k t w a ʁ
contraindre	k ɔ̃ t ʁ ɛ̃ d ʁ
contrarier	k ɔ̃ t ʁ a ʁ j e
contrarié	k ɔ̃ t ʁ a ʁ j e
contrat	k ɔ̃ t ʁ a
contre	k ɔ̃ t ʁ
contreproductif	k ɔ̃ t ʁ ə p ʁ ɔ d y k t i f
contrer	k ɔ̃ t ʁ e
contretemps	k ɔ̃ t ʁ ə t ɑ̃
contribuable	k ɔ̃ t ʁ i b ɥ a b l
contribuer	k ɔ̃ t ʁ i b ɥ e
contributeur	k ɔ̃ t ʁ i b y t œ ʁ
controverses	k ɔ̃ t ʁ ɔ v ɛ ʁ s
contrée	k ɔ̃ t ʁ e
contrôle	k ɔ̃ t ʁ o l
contrôler	k ɔ̃ t ʁ o l e
contrôleur	k ɔ̃ t ʁ o l œ ʁ
contusion	k ɔ̃ t y z j ɔ̃
convaincant	k ɔ̃ v ɛ̃ k ɑ̃
convalescent	k ɔ̃ v a l ɛ s ɑ̃
convalescente	k ɔ̃ v a l ɛ s ɑ̃ t
convalescentes	k ɔ̃ v a l ɛ s ɑ̃ t
convenable	k ɔ̃ v n a b l
convention	k ɔ̃ v ɑ̃ s j ɔ̃
convergé	k ɔ̃ v ɛ ʁ ʒ e
conversations	k ɔ̃ v ɛ ʁ s a s j ɔ̃
convertir	k ɔ̃ v ɛ ʁ t i ʁ
convictions	k ɔ̃ v i k s j ɔ̃
conviviale	k ɔ̃ v i v j a l
convivialité	k ɔ̃ v i v j a l i t e
conviviaux	k ɔ̃ v i v j o
convocation	k ɔ̃ v ɔ k a s j ɔ̃
convoi	k ɔ̃ v w a
convoitises	k ɔ̃ v w a t i z
convoquent	k ɔ̃ v ɔ k
convoquer	k ɔ̃ v ɔ k e
convoquions	k ɔ̃ v ɔ k j ɔ̃
convoqué	k ɔ̃ v ɔ k e
coopérant	k ɔ ɔ p e ʁ ɑ̃
coopératif	k ɔ ɔ p e ʁ a t i f
coopération	k ɔ ɔ p e ʁ a s j ɔ̃
coopérer	k ɔ ɔ p e ʁ e
coordinateur	k ɔ ɔ ʁ d i n a t œ ʁ
coordination	k ɔ ɔ ʁ d i n a s j ɔ̃
coordonnatrice	k ɔ ɔ ʁ d ɔ n a t ʁ i s
coordonné	k ɔ ɔ ʁ d ɔ n e
copain	k ɔ p ɛ̃
copine	k ɔ p i n
copines	k ɔ p i n
copte	k ɔ p t
copulas	k ɔ p y l ɑ
copulasse	k ɔ p y l a s
coque	k ɔ k
coqueluche	k ɔ k l y ʃ
coquette	k ɔ k ɛ t
corail	k ɔ ʁ a j
coraux	k ɔ ʁ o
corde	k ɔ ʁ d
cordon	k ɔ ʁ d ɔ̃
coriace	k ɔ ʁ j a s
corinne	k ɔ ʁ i n
cormier	k ɔ ʁ m j e
corne	k ɔ ʁ n
corneille	k ɔ ʁ n ɛ j
cornet	k ɔ ʁ n ɛ
cornouaille	k ɔ ʁ n w a j
corp	k ɔ ʁ p
corps	k ɔ ʁ
correction	k ɔ ʁ ɛ k s j ɔ̃
corrections	k ɔ ʁ ɛ k s j ɔ̃
correspondant	k ɔ ʁ ɛ s p ɔ̃ d ɑ̃
correspondent	k ɔ ʁ ɛ s p ɔ̃ d
corriger	k ɔ ʁ i ʒ e
corrompre	k ɔ ʁ ɔ̃ p ʁ
corruption	k ɔ ʁ y p s j ɔ̃
corrélation	k ɔ ʁ e l a s j ɔ̃
corse	k ɔ ʁ s
corset	k ɔ ʁ s ɛ
cortège	k ɔ ʁ t ɛ ʒ
corvette	k ɔ ʁ v ɛ t
corvée	k ɔ ʁ v e
cosmétique	k ɔ s m e t i k
costaud	k ɔ s t o
costume	k ɔ s t y m
cote	k ɔ t
cotisation	k ɔ t i z a s j ɔ̃
coté	k ɔ t e
couac	k w a k
coucher	k u ʃ e
cougar	k u ɡ a ʁ
couler	k u l e
couloir	k u l w a ʁ
coulée	k u l e
country	k œ̃ t ʁ i
coup	k u
coupable	k u p a b l
coupables	k u p a b l
couper	k u p e
couperet	k u p ʁ ɛ
coupole	k u p ɔ l
coupé	k u p e
cour	k u ʁ
courageux	k u ʁ a ʒ ø
courant	k u ʁ ɑ̃
courante	k u ʁ ɑ̃ t
courbe	k u ʁ b
courent	k u ʁ
courir	k u ʁ i ʁ
couronne	k u ʁ ɔ n
couronnement	k u ʁ ɔ n m ɑ̃
couronner	k u ʁ ɔ n e
courriel	k u ʁ j ɛ l
courrier	k u ʁ j e
courroie	k u ʁ w a
cours	k u ʁ
course	k u ʁ s
court	k u ʁ
courtier	k u ʁ t j e
courtois	k u ʁ t w a
courts	k u ʁ
couscous	k u s k u s
cousin	k u z ɛ̃
cousine	k u z i n
coussin	k u s ɛ̃
cout	k u
couteau	k u t o
coutume	k u t y m
couturier	k u t y ʁ j e
couvert	k u v ɛ ʁ
couverture	k u v ɛ ʁ t y ʁ
couvrir	k u v ʁ i ʁ
coyote	k ɔ j ɔ t
coïncider	k ɔ ɛ̃ s i d e
coûteux	k u t ø
cpa	s e p e a
crabe	k ʁ a b
cracher	k ʁ a ʃ e
cracovie	k ʁ a k ɔ v i
crainte	k ʁ ɛ̃ t
cran	k ʁ ɑ̃
crapahutasse	k ʁ a p a y t a s
crapahuter	k ʁ a p a y t e
crapule	k ʁ a p y l
crash	k ʁ a ʃ
cratère	k ʁ a t ɛ ʁ
cravacher	k ʁ a v a ʃ e
cravate	k ʁ a v a t
creuser	k ʁ ø z e
creux	k ʁ ø
crever	k ʁ ə v e
crevé	k ʁ ə v e
cri	k ʁ i
criant	k ʁ i j ɑ̃
crible	k ʁ i b l
crie	k ʁ i
crier	k ʁ i j e
crime	k ʁ i m
cris	k ʁ i
crise	k ʁ i z
crispation	k ʁ i s p a s j ɔ̃
cristal	k ʁ i s t a l
critique	k ʁ i t i k
critiquer	k ʁ i t i k e
critiques	k ʁ i t i k
croatie	k ʁ o a s i
crocheter	k ʁ ɔ ʃ t e
crocodile	k ʁ ɔ k ɔ d i l
croisement	k ʁ w a z m ɑ̃
croiseur	k ʁ w a z œ ʁ
croissance	k ʁ w a s ɑ̃ s
croissant	k ʁ w a s ɑ̃
croisée	k ʁ w a z e
croupit	k ʁ u p i
croyance	k ʁ w ɑ j ɑ̃ s
croît	k ʁ w a
croître	k ʁ w a t ʁ
cruchon	k ʁ y ʃ ɔ̃
crucial	k ʁ y s j a l
cruel	k ʁ y ɛ l
cruelle	k ʁ y ɛ l
crâne	k ʁ ɑ n
crèche	k ʁ ɛ ʃ
crème	k ʁ ɛ m
crèmerie	k ʁ ɛ m ʁ i
créa	k ʁ e a
créateur	k ʁ e a t œ ʁ
créatifs	k ʁ e a t i f
création	k ʁ e a s j ɔ̃
créative	k ʁ e a t i v
créativité	k ʁ e a t i v i t e
crédible	k ʁ e d i b l
crédit	k ʁ e d i
crédo	k ʁ e d o
crée	k ʁ e
créent	k ʁ e
créer	k ʁ e e
créole	k ʁ e ɔ l
crépiter	k ʁ e p i t e
crépuscule	k ʁ e p y s k y l
crû	k ʁ y
cuba	k y b a
cubassiez	k y b a s j e
cube	k y b
cubes	k y b
cueillir	k œ j i ʁ
cuisine	k ɥ i z i n
cuisiner	k ɥ i z i n e
cuisinier	k ɥ i z i n j e
cuisse	k ɥ i s
cuisses	k ɥ i s
cuisson	k ɥ i s ɔ̃
cuit	k ɥ i
cuite	k ɥ i t
cuivra	k ɥ i v ʁ a
cuivre	k ɥ i v ʁ
culot	k y l o
culte	k y l t
cultiver	k y l t i v e
cultivé	k y l t i v e
culture	k y l t y ʁ
cumulait	k y m y l ɛ
cumulative	k y m y l a t i v
cumulatives	k y m y l a t i v
cumule	k y m y l
cumulé	k y m y l e
cupidité	k y p i d i t e
cure	k y ʁ
curie	k y ʁ i
curieux	k y ʁ j ø
curiosité	k y ʁ j o z i t e
curseur	k y ʁ s œ ʁ
cursus	k y ʁ s y s
cuve	k y v
cv	s e v e
cycle	s i k l
cycliques	s i k l i k
cycliste	s i k l i s t
cyclone	s i k l o n
cygnes	s i ɲ
cynique	s i n i k
cyril	s i ʁ i l
cyrille	s i ʁ i l
câble	k ɑ b l
cécile	s e s i l
cécilia	s e s i l j a
cécité	s e s i t e
cédric	s e d ʁ i k
cégétiste	s e ʒ e t i s t
céleri	s ɛ l ʁ i
céleste	s e l ɛ s t
célibataire	s e l i b a t ɛ ʁ
céline	s e l i n
céramique	s e ʁ a m i k
cérébral	s e ʁ e b ʁ a l
cérémonie	s e ʁ e m ɔ n i
cérémonies	s e ʁ e m ɔ n i
césar	s e z a ʁ
côte	k o t
côtière	k o t j ɛ ʁ
côté	k o t e
daller	d a l e
damasse	d a m a s
damien	d a m j ɛ̃
dan	d a n
dance	d ɛ n s
dandiner	d ɑ̃ d i n e
danemark	d a n m a ʁ k
danger	d ɑ̃ ʒ e
dangereuse	d ɑ̃ ʒ ʁ ø z
dangereux	d ɑ̃ ʒ ʁ ø
dangerosité	d ɑ̃ ʒ ʁ o z i t e
danielle	d a n j ɛ l
danièle	d a n j ɛ l
danoise	d a n w a z
danseuse	d ɑ̃ s ø z
das	d a s
dater	d a t e
dauphin	d o f ɛ̃
dauphine	d o f i n
davis	d e v i s
de	d ə
dead	d ɛ d
dealeras	d i l ʁ ɑ
debout	d ə b u
degré	d ə ɡ ʁ e
degrés	d ə ɡ ʁ e
delphine	d ɛ l f i n
delta	d ɛ l t a
delà	d ə l a
demain	d ə m ɛ̃
demande	d ə m ɑ̃ d
demander	d ə m ɑ̃ d e
demandeur	d ə m ɑ̃ d œ ʁ
demeurant	d ə m œ ʁ ɑ̃
demeure	d ə m œ ʁ
demeurer	d ə m œ ʁ e
demeuré	d ə m œ ʁ e
demi	d ə m i
dengue	d ɛ̃ ɡ
denis	d ə n i
denise	d ə n i z
dent	d ɑ̃
dentelle	d ɑ̃ t ɛ l
dentelles	d ɑ̃ t ɛ l
dentier	d ɑ̃ t j e
der	d ɛ ʁ
derby	d ɛ ʁ b i
dernier	d ɛ ʁ n j e
dernièrement	d ɛ ʁ n j ɛ ʁ m ɑ̃
des	d e
descendant	d e s ɑ̃ d ɑ̃
descendants	d ɛ s ɑ̃ d ɑ̃
descendre	d e s ɑ̃ d ʁ
descente	d e s ɑ̃ t
description	d ɛ s k ʁ i p s j ɔ̃
design	d i z a j n
despote	d ɛ s p ɔ t
desquelles	d e k ɛ l
dessein	d e s ɛ̃
desserrassions	d e s e ʁ a s j ɔ̃
dessous	d ə s u
destination	d ɛ s t i n a s j ɔ̃
destinée	d ɛ s t i n e
destruction	d ɛ s t ʁ y k s j ɔ̃
destructrice	d ɛ s t ʁ y k t ʁ i s
deuil	d œ j
deux	d ø
deuxième	d ø z j ɛ m
devait	d ə v ɛ
devance	d ə v ɑ̃ s
devancent	d ə v ɑ̃ s
devancer	d ə v ɑ̃ s e
devancé	d ə v ɑ̃ s e
devant	d ə v ɑ̃
devançant	d ə v ɑ̃ s ɑ̃
devenir	d ə v ə n i ʁ
deviner	d ə v i n e
devoir	d ə v w a ʁ
devoirs	d ə v w a ʁ
devrait	d ə v ʁ ɛ
deçà	d ə s a
dia	d j a
diabolique	d j a b ɔ l i k
dialecte	d j a l ɛ k t
dialogue	d j a l ɔ ɡ
diamant	d j a m ɑ̃
diamante	d j a m ɑ̃ t
diatribe	d j a t ʁ i b
dictateur	d i k t a t œ ʁ
dictature	d i k t a t y ʁ
dicter	d i k t e
dictée	d i k t e
didacticiel	d i d a k t i s j ɛ l
didier	d i d j e
diffamation	d i f a m a s j ɔ̃
difficile	d i f i s i l
difficilement	d i f i s i l m ɑ̃
difficulté	d i f i k y l t e
diffuse	d i f y z
diffuser	d i f y z e
différemment	d i f e ʁ a m ɑ̃
différence	d i f e ʁ ɑ̃ s
différencier	d i f e ʁ ɑ̃ s j e
différend	d i f e ʁ ɑ̃
différent	d i f e ʁ ɑ̃
digital	d i ʒ i t a l
digitale	d i ʒ i t a l
digitales	d i ʒ i t a l
digne	d i ɲ
dignité	d i ɲ i t e
digue	d i ɡ
dijon	d i ʒ ɔ̃
dilettante	d i l ɛ t ɑ̃ t
diluviens	d i l y v j ɛ̃
dimanche	d i m ɑ̃ ʃ
dimension	d i m ɑ̃ s j ɔ̃
diminuer	d i m i n ɥ e
dimitri	d i m i t ʁ i
diocèse	d j ɔ s ɛ z
diplomatie	d i p l ɔ m a s i
diplôme	d i p l o m
diplômes	d i p l o m
dira	d i ʁ a
dirai	d i ʁ e
dirais	d i ʁ ɛ
dirait	d i ʁ ɛ
dire	d i ʁ
directe	d i ʁ ɛ k t
directement	d i ʁ ɛ k t ə m ɑ̃
directes	d i ʁ ɛ k t
directeur	d i ʁ ɛ k t œ ʁ
direction	d i ʁ ɛ k s j ɔ̃
directive	d i ʁ ɛ k t i v
directrice	d i ʁ ɛ k t ʁ i s
dirige	d i ʁ i ʒ
dirigeant	d i ʁ i ʒ ɑ̃
dirigent	d i ʁ i ʒ ɑ̃
diriger	d i ʁ i ʒ e
dirons	d i ʁ ɔ̃
diront	d i ʁ ɔ̃
dis	d i
disaient	d i z ɛ
disais	d i z ɛ
disait	d i z ɛ
disciplinaire	d i s i p l i n ɛ ʁ
discipline	d i s i p l i n
discorde	d i s k ɔ ʁ d
discothèque	d i s k ɔ t ɛ k
discours	d i s k u ʁ
discrimination	d i s k ʁ i m i n a s j ɔ̃
discriminatoire	d i s k ʁ i m i n a t w a ʁ
discrètement	d i s k ʁ ɛ t m ɑ̃
discussion	d i s k y s j ɔ̃
discussions	d i s k y s j ɔ̃
discutable	d i s k y t a b l
discuter	d i s k y t e
dise	d i z
disent	d i z
disette	d i z ɛ t
diseur	d i z œ ʁ
disions	d i z j ɔ̃
disons	d i z ɔ̃
disparaître	d i s p a ʁ ɛ t ʁ
disparition	d i s p a ʁ i s j ɔ̃
disperse	d i s p ɛ ʁ s
disponibilité	d i s p ɔ n i b i l i t e
disponible	d i s p ɔ n i b l
dispositif	d i s p o z i t i f
dispute	d i s p y t
disputer	d i s p y t e
disque	d i s k
dissident	d i s i d ɑ̃
distinction	d i s t ɛ̃ k s j ɔ̃
distincts	d i s t ɛ̃
distinguer	d i s t ɛ̃ ɡ e
distorsion	d i s t ɔ ʁ s j ɔ̃
distraire	d i s t ʁ ɛ ʁ
distrayant	d i s t ʁ ɛ j ɑ̃
distribuer	d i s t ʁ i b ɥ e
distributeur	d i s t ʁ i b y t œ ʁ
distribution	d i s t ʁ i b y s j ɔ̃
dit	d i
dite	d i t
dites	d i t
divan	d i v ɑ̃
divergeas	d i v ɛ ʁ ʒ ɑ
divers	d i v ɛ ʁ
diversifiée	d i v ɛ ʁ s i f j e
diversité	d i v ɛ ʁ s i t e
divertissement	d i v ɛ ʁ t i s m ɑ̃
dividende	d i v i d ɑ̃ d
diviser	d i v i z e
divorce	d i v ɔ ʁ s
divorcée	d i v ɔ ʁ s e
dixième	d i z j ɛ m
djibouti	d ʒ i b u t i
do	d o
docte	d ɔ k t
document	d ɔ k y m ɑ̃
documentaire	d ɔ k y m ɑ̃ t ɛ ʁ
documentation	d ɔ k y m ɑ̃ t a s j ɔ̃
documenter	d ɔ k y m ɑ̃ t e
dogme	d ɔ ɡ m
doigt	d w a
dois	d w a
doit	d w a
dollar	d ɔ l a ʁ
domaine	d ɔ m ɛ n
domestique	d ɔ m ɛ s t i k
domestiques	d ɔ m ɛ s t i k
domicile	d ɔ m i s i l
dominant	d ɔ m i n ɑ̃
dominateurs	d ɔ m i n a t œ ʁ
dominer	d ɔ m i n e
dominion	d ɔ m i n j ɔ̃
dominique	d ɔ m i n i k
dommage	d ɔ m a ʒ
don	d ɔ̃
donc	d ɔ̃ k
donne	d ɔ n
donner	d ɔ n e
donnée	d ɔ n e
dons	d ɔ̃
dont	d ɔ̃
dopamine	d ɔ p a m i n
dordogne	d ɔ ʁ d ɔ ɲ
dorment	d ɔ ʁ m
dormi	d ɔ ʁ m i
dormir	d ɔ ʁ m i ʁ
dorothée	d ɔ ʁ ɔ t e
dors	d ɔ ʁ
dort	d ɔ ʁ
doré	d ɔ ʁ e
dos	d o
dosage	d o z a ʒ
dose	d o z
dote	d ɔ t
doter	d ɔ t e
dotée	d ɔ t e
dotées	d ɔ t e
dotés	d ɔ t e
douane	d w a n
doublage	d u b l a ʒ
double	d u b l
doubler	d u b l e
doubles	d u b l
doublure	d u b l y ʁ
doubs	d u
doucement	d u s m ɑ̃
douceur	d u s œ ʁ
douche	d u ʃ
douillet	d u j ɛ
douloureux	d u l u ʁ ø
doute	d u t
douter	d u t e
doux	d u
douze	d u z
douzième	d u z j ɛ m
douée	d w e
dragon	d ʁ a ɡ ɔ̃
drakkar	d ʁ a k a ʁ
drame	d ʁ a m
drapeau	d ʁ a p o
draveur	d ʁ a v œ ʁ
drogue	d ʁ ɔ ɡ
drogueront	d ʁ ɔ ɡ ʁ ɔ̃
droit	d ʁ w ɑ
droite	d ʁ w a t
droiture	d ʁ w a t y ʁ
drop	d ʁ ɔ p
drôle	d ʁ o l
drôles	d ʁ o l
drôme	d ʁ o m
dubaï	d u b a j
dublin	d y b l ɛ̃
due	d y
dues	d y
duettos	d ɥ ɛ t o
dune	d y n
dunkerque	d œ̃ k ɛ ʁ k
duo	d ɥ o
duquel	d y k ɛ l
dur	d y ʁ
dura	d y ʁ a
durant	d y ʁ ɑ̃
durci	d y ʁ s i
durcir	d y ʁ s i ʁ
durcisse	d y ʁ s i s
durcit	d y ʁ s i
dure	d y ʁ
durer	d y ʁ e
durera	d y ʁ ə ʁ a
dures	d y ʁ
dureté	d y ʁ t e
durs	d y ʁ
durée	d y ʁ e
dus	d y
dut	d y
dylan	d i l a n
dynamique	d i n a m i k
dynamisassent	d i n a m i z a s
dysfonctionnement	d i s f ɔ̃ k s j ɔ n m ɑ̃
dès	d ɛ
débarrasser	d e b a ʁ a s e
débat	d e b a
débattre	d e b a t ʁ
débilitons	d e b i l i t ɔ̃
débit	d e b i
débiteur	d e b i t œ ʁ
déblayer	d e b l ɛ j e
déblocage	d e b l ɔ k a ʒ
déboires	d e b w a ʁ
débordement	d e b ɔ ʁ d ə m ɑ̃
déborder	d e b ɔ ʁ d e
déboucher	d e b u ʃ e
débouché	d e b u ʃ e
débridement	d e b ʁ i d m ɑ̃
débris	d e b ʁ i
débrouiller	d e b ʁ u j e
décadence	d e k a d ɑ̃ s
décaler	d e k a l e
décalque	d e k a l k
décalé	d e k a l e
décanter	d e k ɑ̃ t e
décaper	d e k a p e
décennie	d e s e n i
décevoir	d e s ə v w a ʁ
décharger	d e ʃ a ʁ ʒ e
déchet	d e ʃ ɛ
déchets	d e ʃ ɛ
déchirant	d e ʃ i ʁ ɑ̃
déchirure	d e ʃ i ʁ y ʁ
décider	d e s i d e
décidément	d e s i d e m ɑ̃
décision	d e s i z j ɔ̃
déclaration	d e k l a ʁ a s j ɔ̃
déclarer	d e k l a ʁ e
déclencher	d e k l ɑ̃ ʃ e
déclinaison	d e k l i n ɛ z ɔ̃
déclinante	d e k l i n ɑ̃ t
décliner	d e k l i n e
décoder	d e k ɔ d e
décodé	d e k ɔ d e
décoiffer	d e k w a f e
décollage	d e k ɔ l a ʒ
décoller	d e k ɔ l e
décor	d e k ɔ ʁ
décoration	d e k ɔ ʁ a s j ɔ̃
décorations	d e k ɔ ʁ a s j ɔ̃
décordons	d e k ɔ ʁ d ɔ̃
découdre	d e k u d ʁ
découpage	d e k u p a ʒ
décourager	d e k u ʁ a ʒ e
découverte	d e k u v ɛ ʁ t
découvrir	d e k u v ʁ i ʁ
décret	d e k ʁ ɛ
décrire	d e k ʁ i ʁ
décrocher	d e k ʁ ɔ ʃ e
décrypte	d e k ʁ i p t
déculpabiliser	d e k y l p a b i l i z e
décès	d e s ɛ
dédale	d e d a l
dédier	d e d j e
dédommagement	d e d ɔ m a ʒ m ɑ̃
dédramatiser	d e d ʁ a m a t i z e
déduction	d e d y k s j ɔ̃
déduire	d e d ɥ i ʁ
défaire	d e f ɛ ʁ
défaite	d e f ɛ t
défaut	d e f o
défendre	d e f ɑ̃ d ʁ
défendu	d e f ɑ̃ d y
défense	d e f ɑ̃ s
défi	d e f i
déficit	d e f i s i t
défier	d e f j e
défini	d e f i n i
définir	d e f i n i ʁ
définitif	d e f i n i t i f
définition	d e f i n i s j ɔ̃
définitive	d e f i n i t i v
définitivement	d e f i n i t i v m ɑ̃
déflation	d e f l a s j ɔ̃
déforestation	d e f ɔ ʁ ɛ s t a s j ɔ̃
dégager	d e ɡ a ʒ e
dégainer	d e ɡ ɛ n e
dégel	d e ʒ ɛ l
déglinguerais	d e ɡ l ɛ̃ ɡ ʁ ɛ
déglinguions	d e ɡ l ɛ̃ ɡ j ɔ̃
dégourdir	d e ɡ u ʁ d i ʁ
dégoût	d e ɡ u
dégringolade	d e ɡ ʁ ɛ̃ ɡ ɔ l a d
dégueulasse	d e ɡ œ l a s
déguster	d e ɡ y s t e
dégénéré	d e ʒ e n e ʁ e
déhancher	d e ɑ̃ ʃ e
déjeuné	d e ʒ œ n e
déjouer	d e ʒ w e
déjà	d e ʒ a
délabre	d e l a b ʁ
délai	d e l ɛ
délation	d e l a s j ɔ̃
délibérations	d e l i b e ʁ a s j ɔ̃
délicieux	d e l i s j ø
délictueux	d e l i k t ɥ ø
délire	d e l i ʁ
délivrance	d e l i v ʁ ɑ̃ s
délivrer	d e l i v ʁ e
délogera	d e l ɔ ʒ ʁ a
déluge	d e l y ʒ
délégation	d e l e ɡ a s j ɔ̃
démarche	d e m a ʁ ʃ
démarcher	d e m a ʁ ʃ e
démarquer	d e m a ʁ k e
démembrer	d e m ɑ̃ b ʁ e
démembrions	d e m ɑ̃ b ʁ i j ɔ̃
dément	d e m ɑ̃
démenti	d e m ɑ̃ t i
démentir	d e m ɑ̃ t i ʁ
démentis	d e m ɑ̃ t i
démis	d e m i
démission	d e m i s j ɔ̃
démissionnaire	d e m i s j ɔ n ɛ ʁ
démocrate	d e m ɔ k ʁ a t
démocrates	d e m ɔ k ʁ a t
démocratie	d e m ɔ k ʁ a s i
démocraties	d e m ɔ k ʁ a s i
démocratique	d e m ɔ k ʁ a t i k
démocratiques	d e m ɔ k ʁ a t i k
démographique	d e m ɔ ɡ ʁ a f i k
démolir	d e m ɔ l i ʁ
démoniaque	d e m ɔ n j a k
démonstration	d e m ɔ̃ s t ʁ a s j ɔ̃
démontrer	d e m ɔ̃ t ʁ e
démosthène	d e m ɔ s t ɛ n
déménagement	d e m e n a ʒ m ɑ̃
dénaturé	d e n a t y ʁ e
déni	d e n i
dénicher	d e n i ʃ e
dénombrer	d e n ɔ̃ b ʁ e
dénomination	d e n ɔ m i n a s j ɔ̃
dénonce	d e n ɔ̃ s
dénoncent	d e n ɔ̃ s
dénoncer	d e n ɔ̃ s e
dénonciation	d e n ɔ̃ s j a s j ɔ̃
dénoncé	d e n ɔ̃ s e
dénonçait	d e n ɔ̃ s ɛ
dénonçant	d e n ɔ̃ s ɑ̃
déodorant	d e ɔ d ɔ ʁ ɑ̃
déontologie	d e ɔ̃ t ɔ l ɔ ʒ i
département	d e p a ʁ t ə m ɑ̃
départemental	d e p a ʁ t ə m ɑ̃ t a l
départementale	d e p a ʁ t ə m ɑ̃ t a l
dépendance	d e p ɑ̃ d ɑ̃ s
dépendant	d e p ɑ̃ d ɑ̃
dépens	d e p ɑ̃
dépense	d e p ɑ̃ s
dépenser	d e p ɑ̃ s e
dépenses	d e p ɑ̃ s
dépistasse	d e p i s t a s
dépit	d e p i
dépité	d e p i t e
déplacement	d e p l a s m ɑ̃
déplacer	d e p l a s e
déplacé	d e p l a s e
dépliants	d e p l i j ɑ̃
déplorable	d e p l ɔ ʁ a b l
déployer	d e p l w a j e
déposer	d e p o z e
déposséder	d e p ɔ s e d e
dépouille	d e p u j
dépouillement	d e p u j m ɑ̃
dépourvu	d e p u ʁ v y
dépresseur	d e p ʁ ɛ s œ ʁ
dépressif	d e p ʁ ɛ s i f
dépression	d e p ʁ ɛ s j ɔ̃
dépurâmes	d e p y ʁ ɑ m
députée	d e p y t e
dépêche	d e p ɛ ʃ
dépôt	d e p o
déracinement	d e ʁ a s i n m ɑ̃
dérailler	d e ʁ ɑ j e
dérapage	d e ʁ a p a ʒ
dériver	d e ʁ i v e
dérivé	d e ʁ i v e
dérober	d e ʁ ɔ b e
dérobé	d e ʁ ɔ b e
dérogation	d e ʁ ɔ ɡ a s j ɔ̃
dérouler	d e ʁ u l e
déroute	d e ʁ u t
déréférencent	d e ʁ e f e ʁ ɑ̃ s
désaccord	d e z a k ɔ ʁ
désagréable	d e z a ɡ ʁ e a b l
désamour	d e z a m u ʁ
désarroi	d e z a ʁ w a
désarçonner	d e z a ʁ s ɔ n e
désastre	d e z a s t ʁ
désastres	d e z a s t ʁ
désaveu	d e z a v ø
désert	d e z ɛ ʁ
déserte	d e z ɛ ʁ t
désespoir	d e z ɛ s p w a ʁ
désespérant	d e z ɛ s p e ʁ ɑ̃
déshonneur	d e z ɔ n œ ʁ
désigner	d e z i ɲ e
désinvestir	d e z ɛ̃ v ɛ s t i ʁ
désireux	d e z i ʁ ø
désirs	d e z i ʁ
désobligeant	d e z ɔ b l i ʒ ɑ̃
désobéissance	d e z ɔ b e i s ɑ̃ s
désolé	d e z ɔ l e
désordre	d e z ɔ ʁ d ʁ
désormais	d e z ɔ ʁ m ɛ
désossé	d e z ɔ s e
déséquilibrer	d e z e k i l i b ʁ e
détail	d e t a j
détailler	d e t a j e
détenait	d e t n ɛ
détenteur	d e t ɑ̃ t œ ʁ
déterminer	d e t ɛ ʁ m i n e
déterminé	d e t ɛ ʁ m i n e
détester	d e t ɛ s t e
détiendra	d e t j ɛ̃ d ʁ a
détiennent	d e t j ɛ n ɛ
détour	d e t u ʁ
détournement	d e t u ʁ n ə m ɑ̃
détournée	d e t u ʁ n e
détresse	d e t ʁ ɛ s
détruire	d e t ʁ ɥ i ʁ
détrôner	d e t ʁ o n e
détériorer	d e t e ʁ j ɔ ʁ e
dévaliser	d e v a l i z e
dévalué	d e v a l ɥ e
développer	d e v l ɔ p e
développé	d e v l ɔ p e
déviation	d e v j a s j ɔ̃
dévier	d e v j e
dévoiler	d e v w a l e
dévouement	d e v u m ɑ̃
dévoué	d e v w e
déçu	d e s y
dôme	d o m
dû	d y
dûment	d y m ɑ̃
ed	ɛ d
edouard	e d w a ʁ
effacer	e f a s e
effectifs	e f ɛ k t i f
effective	e f ɛ k t i v
effectivement	e f ɛ k t i v m ɑ̃
effet	e f ɛ
efficace	e f i k a s
efficacement	e f i k a s m ɑ̃
efficacité	ɛ f i k a s i t e
efficiente	e f i s j ɑ̃ t
effondrement	ɛ f ɔ̃ d ʁ ə m ɑ̃
effondrer	e f ɔ̃ d ʁ e
effort	e f ɔ ʁ
effraction	e f ʁ a k s j ɔ̃
effraie	e f ʁ ɛ
effrité	e f ʁ i t e
egypte	e ʒ i p t
elles	ɛ l
elliptique	e l i p t i k
embarcation	ɑ̃ b a ʁ k a s j ɔ̃
embardée	ɑ̃ b a ʁ d e
embargo	ɑ̃ b a ʁ ɡ o
embarquer	ɑ̃ b a ʁ k e
embarrassantes	ɑ̃ b a ʁ a s ɑ̃ t
emblématique	ɑ̃ b l e m a t i k
embouchure	ɑ̃ b u ʃ y ʁ
emboîter	ɑ̃ b w a t e
embrasser	ɑ̃ b ʁ a s e
emma	ɛ m a
emmagasiner	ɑ̃ m a ɡ a z i n e
emmanuel	ɛ m a n ɥ ɛ l
emmanuelle	ɛ m a n ɥ ɛ l
emmener	ɑ̃ m n e
emmi	ɑ̃ m i
emparait	ɑ̃ p a ʁ ɛ
emparent	ɑ̃ p a ʁ
emparer	ɑ̃ p a ʁ e
empirassiez	ɑ̃ p i ʁ a s j e
empirer	ɑ̃ p i ʁ e
empiré	ɑ̃ p i ʁ e
emplacement	ɑ̃ p l a s m ɑ̃
emplir	ɑ̃ p l i ʁ
emploi	ɑ̃ p l w a
employer	ɑ̃ p l w a j e
employé	ɑ̃ p l w a j e
emporter	ɑ̃ p ɔ ʁ t e
empreinte	ɑ̃ p ʁ ɛ̃ t
empreintes	ɑ̃ p ʁ ɛ̃ t
empressement	ɑ̃ p ʁ ɛ s m ɑ̃
emprise	ɑ̃ p ʁ i z
emprisonne	ɑ̃ p ʁ i z ɔ n
emprisonné	ɑ̃ p ʁ i z ɔ n e
emprunt	ɑ̃ p ʁ œ̃
emprunter	ɑ̃ p ʁ œ̃ t e
empêcher	ɑ̃ p ɛ ʃ e
encadrer	ɑ̃ k ɑ d ʁ e
encaisser	ɑ̃ k ɛ s e
enceinte	ɑ̃ s ɛ̃ t
encensé	ɑ̃ s ɑ̃ s e
enchantas	ɑ̃ ʃ ɑ̃ t ɑ
enchaînement	ɑ̃ ʃ ɛ n m ɑ̃
enchaîner	ɑ̃ ʃ ɛ n e
enchérirais	ɑ̃ ʃ e ʁ i ʁ ɛ
enclave	ɑ̃ k l a v
encontre	ɑ̃ k ɔ̃ t ʁ
encore	ɑ̃ k ɔ ʁ
encoubleriez	ɑ̃ k u b l ə ʁ j e
encouragement	ɑ̃ k u ʁ a ʒ m ɑ̃
encourager	ɑ̃ k u ʁ a ʒ e
encourait	ɑ̃ k u ʁ ɛ
encourent	ɑ̃ k u ʁ
encourraient	ɑ̃ k u ʁ ʁ ɛ
encours	ɑ̃ k u ʁ
encourt	ɑ̃ k u ʁ
encrier	ɑ̃ k ʁ i j e
encyclopédie	ɑ̃ s i k l ɔ p e d i
endettement	ɑ̃ d ɛ t m ɑ̃
endommager	ɑ̃ d ɔ m a ʒ e
endroit	ɑ̃ d ʁ w a
endroits	ɑ̃ d ʁ w a
endémiques	ɑ̃ d e m i k
enfance	ɑ̃ f ɑ̃ s
enfant	ɑ̃ f ɑ̃
enfants	ɑ̃ f ɑ̃
enfer	ɑ̃ f ɛ ʁ
enfiler	ɑ̃ f i l e
enfin	ɑ̃ f ɛ̃
enfler	ɑ̃ f l e
enflure	ɑ̃ f l y ʁ
enfoncer	ɑ̃ f ɔ̃ s e
enfouir	ɑ̃ f w i ʁ
enfuir	ɑ̃ f ɥ i ʁ
engage	ɑ̃ ɡ a ʒ
engager	ɑ̃ ɡ a ʒ e
engin	ɑ̃ ʒ ɛ̃
englué	ɑ̃ ɡ l y e
engouement	ɑ̃ ɡ u m ɑ̃
engraissassiez	ɑ̃ ɡ ʁ e s a s j e
engranger	ɑ̃ ɡ ʁ ɑ̃ ʒ e
enjeu	ɑ̃ ʒ ø
enlèvement	ɑ̃ l ɛ v m ɑ̃
ennemi	ɛ n m i
ennuis	ɑ̃ n ɥ i
ennuyant	ɑ̃ n ɥ i j ɑ̃
ennuyeux	ɑ̃ n ɥ i j ø
enquête	ɑ̃ k ɛ t
enquêter	ɑ̃ k ɛ t e
enrageant	ɑ̃ ʁ a ʒ ɑ̃
enragèrent	ɑ̃ ʁ a ʒ ɛ ʁ
ensacheront	ɑ̃ s a ʃ ʁ ɔ̃
ensaches	ɑ̃ s a ʃ
enseigne	ɑ̃ s ɛ ɲ
enseignement	ɑ̃ s ɛ ɲ m ɑ̃
enseignes	ɑ̃ s ɛ ɲ
enseigné	ɑ̃ s ɛ ɲ e
ensemble	ɑ̃ s ɑ̃ b l
ensuite	ɑ̃ s ɥ i t
entame	ɑ̃ t a m
entamer	ɑ̃ t a m e
entendre	ɑ̃ t ɑ̃ d ʁ
entends	ɑ̃ t ɑ̃
entendu	ɑ̃ t ɑ̃ d y
entente	ɑ̃ t ɑ̃ t
enterrement	ɑ̃ t ɛ ʁ m ɑ̃
enterrer	ɑ̃ t ɛ ʁ e
enthousiasme	ɑ̃ t u z j a s m
enthousiasmer	ɑ̃ t u z j a s m e
entier	ɑ̃ t j e
entièrement	ɑ̃ t j ɛ ʁ m ɑ̃
entonnoir	ɑ̃ t ɔ n w a ʁ
entourage	ɑ̃ t u ʁ a ʒ
entracte	ɑ̃ t ʁ a k t
entraider	ɑ̃ t ʁ ɛ d e
entrant	ɑ̃ t ʁ ɑ̃
entrave	ɑ̃ t ʁ a v
entraînement	ɑ̃ t ʁ ɛ n m ɑ̃
entraîner	ɑ̃ t ʁ ɛ n e
entre	ɑ̃ t ʁ
entrent	ɑ̃ t ʁ
entrepreneur	ɑ̃ t ʁ ə p ʁ ə n œ ʁ
entrepôt	ɑ̃ t ʁ ə p o
entrer	ɑ̃ t ʁ e
entres	ɑ̃ t ʁ
entretemps	ɑ̃ t ʁ ə t ɑ̃
entretenir	ɑ̃ t ʁ ə t ə n i ʁ
entretenu	ɑ̃ t ʁ ə t ə n y
entretien	ɑ̃ t ʁ ə t j ɛ̃
entretiendront	ɑ̃ t ʁ ə t j ɛ̃ d ʁ ɔ̃
entretient	ɑ̃ t ʁ ə t j ɛ̃
entrons	ɑ̃ t ʁ ɔ̃
entrée	ɑ̃ t ʁ e
entêteriez	ɑ̃ t e t ə ʁ j e
enveloppe	ɑ̃ v l ɔ p
envergure	ɑ̃ v ɛ ʁ ɡ y ʁ
envie	ɑ̃ v i
envier	ɑ̃ v j e
envies	ɑ̃ v i
environ	ɑ̃ v i ʁ ɔ̃
environnemental	ɑ̃ v i ʁ ɔ n m ɑ̃ t a l
environs	ɑ̃ v i ʁ ɔ̃
envisager	ɑ̃ v i z a ʒ e
envoi	ɑ̃ v w a
envoler	ɑ̃ v ɔ l e
envoyer	ɑ̃ v w a j e
envoûte	ɑ̃ v u t
enzo	ɛ n z o
equateur	e k w a t œ ʁ
ernest	ɛ ʁ n ɛ s t
errant	e ʁ ɑ̃
erreur	e ʁ œ ʁ
escalade	ɛ s k a l a d
escaladeraient	ɛ s k a l a d ʁ ɛ
escalope	ɛ s k a l ɔ p
esclavage	ɛ s k l a v a ʒ
escroquerie	ɛ s k ʁ ɔ k ʁ i
espace	ɛ s p a s
espagne	ɛ s p a ɲ
espagnol	ɛ s p a ɲ ɔ l
espion	ɛ s p j ɔ̃
espionnage	ɛ s p j ɔ n a ʒ
esplanade	ɛ s p l a n a d
espoir	ɛ s p w a ʁ
espoirs	ɛ s p w a ʁ
esprit	ɛ s p ʁ i
espèces	ɛ s p ɛ s
espérance	ɛ s p e ʁ ɑ̃ s
espérer	ɛ s p e ʁ e
esquinterais	ɛ s k ɛ̃ t ʁ ɛ
esquinterait	ɛ s k ɛ̃ t ʁ ɛ
esquisser	ɛ s k i s e
essaie	e s ɛ
essaye	e s ɛ j
essentiel	e s ɑ̃ s j ɛ l
essuyer	e s ɥ i j e
esther	ɛ s t ɛ ʁ
estimation	ɛ s t i m a s j ɔ̃
estime	ɛ s t i m
estimer	ɛ s t i m e
estival	ɛ s t i v a l
estrade	ɛ s t ʁ a d
ethniques	ɛ t n i k
eugénisme	ø ʒ e n i z m
eure	œ ʁ
eurent	y ʁ
euro	ø ʁ o
europe	ø ʁ ɔ p
européen	ø ʁ ɔ p e ɛ̃
européenne	ø ʁ ɔ p e ɛ n
européennes	ø ʁ ɔ p e ɛ n
euthanasie	ø t a n a z i
euthanasié	ø t a n a z j e
exacte	ɛ ɡ z a k t
exactement	ɛ ɡ z a k t ə m ɑ̃
exactes	ɛ ɡ z a k t
exactitude	ɛ ɡ z a k t i t y d
examens	ɛ ɡ z a m ɛ̃
examiner	ɛ ɡ z a m i n e
excellence	ɛ k s ɛ l ɑ̃ s
excentrique	ɛ k s ɑ̃ t ʁ i k
exception	ɛ k s ɛ p s j ɔ̃
exceptionnel	ɛ k s ɛ p s j ɔ n ɛ l
exceptionnellement	ɛ k s ɛ p s j ɔ n ɛ l m ɑ̃
excepté	ɛ k s ɛ p t e
excessif	ɛ k s ɛ s i f
excessive	ɛ k s ɛ s i v
exciper	ɛ k s i p e
exclusivité	ɛ k s k l y z i v i t e
excuse	ɛ k s k y z
excusez	ɛ k s k y z e
excès	ɛ k s ɛ
exemple	ɛ ɡ z ɑ̃ p l
exemples	ɛ ɡ z ɑ̃ p l
exerce	ɛ ɡ z ɛ ʁ s
exercent	ɛ ɡ z ɛ ʁ s
exercer	ɛ ɡ z ɛ ʁ s e
exercice	ɛ ɡ z ɛ ʁ s i s
exergue	ɛ ɡ z ɛ ʁ ɡ
exerçaient	ɛ ɡ z ɛ ʁ s ɛ
exhumer	ɛ ɡ z y m e
exigence	ɛ ɡ z i ʒ ɑ̃ s
exil	ɛ ɡ z i l
existence	ɛ ɡ z i s t ɑ̃ s
exode	ɛ ɡ z ɔ d
exorcisassions	ɛ ɡ z ɔ ʁ s i z a s j ɔ̃
exorcisme	ɛ ɡ z ɔ ʁ s i s m
exotique	ɛ ɡ z ɔ t i k
expansion	ɛ k s p ɑ̃ s j ɔ̃
expert	ɛ k s p ɛ ʁ
expertise	ɛ k s p ɛ ʁ t i z
expertiser	ɛ k s p ɛ ʁ t i z e
explication	ɛ k s p l i k a s j ɔ̃
explicative	ɛ k s p l i k a t i v
explique	ɛ k s p l i k
expliquent	ɛ k s p l i k
expliquer	ɛ k s p l i k e
expliqué	ɛ k s p l i k e
exploit	ɛ k s p l w a
exploitant	ɛ k s p l w a t ɑ̃
exploitation	ɛ k s p l w a t a s j ɔ̃
exploiter	ɛ k s p l w a t e
exploration	ɛ k s p l ɔ ʁ a s j ɔ̃
explorer	ɛ k s p l ɔ ʁ e
exploser	ɛ k s p l o z e
explosion	ɛ k s p l o z j ɔ̃
exportateurs	ɛ k s p ɔ ʁ t a t œ ʁ
exportatrice	ɛ k s p ɔ ʁ t a t ʁ i s
exporter	ɛ k s p ɔ ʁ t e
expose	ɛ k s p o z
exposer	ɛ k s p o z e
exposeront	ɛ k s p o z ʁ ɔ̃
expositions	ɛ k s p o z i s j ɔ̃
exposé	ɛ k s p o z e
exposée	ɛ k s p o z e
exposées	ɛ k s p o z e
exposés	ɛ k s p o z e
express	ɛ k s p ʁ ɛ s
expressif	ɛ k s p ʁ ɛ s i f
expression	ɛ k s p ʁ ɛ s j ɔ̃
expressions	ɛ k s p ʁ e s j ɔ̃
expulsion	ɛ k s p y l s j ɔ̃
expédier	ɛ k s p e d j e
expédition	ɛ k s p e d i s j ɔ̃
expérience	ɛ k s p e ʁ j ɑ̃ s
expérimenté	ɛ k s p e ʁ i m ɑ̃ t e
exquis	ɛ k s k i
extensibilité	ɛ k s t ɑ̃ s i b i l i t e
extinction	ɛ k s t ɛ̃ k s j ɔ̃
extorquer	ɛ k s t ɔ ʁ k e
extrait	ɛ k s t ʁ ɛ
extrémisme	ɛ k s t ʁ e m i s m
extrémiste	ɛ k s t ʁ e m i s t
extrémité	ɛ k s t ʁ e m i t e
extrêmement	ɛ k s t ʁ ɛ m m ɑ̃
extrêmes	ɛ k s t ʁ ɛ m
extérieur	ɛ k s t e ʁ j œ ʁ
exécutant	ɛ ɡ z e k y t ɑ̃
exécuter	ɛ ɡ z e k y t e
exécuteur	ɛ ɡ z e k y t œ ʁ
fa	f a
fabien	f a b j ɛ̃
fabienne	f a b j ɛ n
fable	f a b l
fabricant	f a b ʁ i k ɑ̃
fabrication	f a b ʁ i k a s j ɔ̃
fabrique	f a b ʁ i k
fabriquer	f a b ʁ i k e
face	f a s
facette	f a s ɛ t
facile	f a s i l
faciliter	f a s i l i t e
facilité	f a s i l i t e
facteur	f a k t œ ʁ
factice	f a k t i s
faction	f a k s j ɔ̃
facture	f a k t y ʁ
faculté	f a k y l t e
faible	f ɛ b l
faibles	f ɛ b l
faiblesse	f ɛ b l ɛ s
faille	f a j
faim	f ɛ̃
faire	f ɛ ʁ
faisais	f ə z ɛ
faisait	f ə z ɛ
faisant	f ə z ɑ̃
faisceau	f ɛ s o
faiseurs	f ə z œ ʁ
faisons	f ə z ɔ̃
faites	f ɛ t
fallait	f a l ɛ
falloir	f a l w a ʁ
fallu	f a l y
fallut	f a l y
falot	f a l o
familial	f a m i l j a l
familiariser	f a m i l j a ʁ i z e
familier	f a m i l j e
famille	f a m i j
famine	f a m i n
famélique	f a m e l i k
fan	f a n
fanfare	f ɑ̃ f a ʁ
fanfaronner	f ɑ̃ f a ʁ ɔ n e
fantasmes	f ɑ̃ t a s m
fantastique	f ɑ̃ t a s t i k
fantômes	f ɑ̃ t o m
faon	f ɑ̃
farce	f a ʁ s
farceur	f a ʁ s œ ʁ
fardeau	f a ʁ d o
farouche	f a ʁ u ʃ
fascinant	f a s i n ɑ̃
fascinantes	f a s i n ɑ̃ t
fascinera	f a s i n ʁ a
fascinée	f a s i n e
fascisme	f a ʃ i z m
fasciste	f a ʃ i s t
fasse	f a s
fassent	f a s
fassions	f a s j ɔ̃
fat	f a
fatal	f a t a l
fatalement	f a t a l m ɑ̃
fatidique	f a t i d i k
fatigant	f a t i ɡ ɑ̃
fatigue	f a t i ɡ
fatiguer	f a t i ɡ e
fatigué	f a t i ɡ e
faucon	f o k ɔ̃
faudra	f o d ʁ a
faudrait	f o d ʁ ɛ
faune	f o n
faussement	f o s m ɑ̃
faut	f o
faute	f o t
fauteuil	f o t œ j
fautif	f o t i f
fauve	f o v
faux	f o
faveur	f a v œ ʁ
favorable	f a v ɔ ʁ a b l
favori	f a v ɔ ʁ i
favoriser	f a v ɔ ʁ i z e
favorite	f a v ɔ ʁ i t
façade	f a s a d
façon	f a s ɔ̃
fbi	ɛ f b i a j
fc	ɛ f s e
feedback	f i d b a k
feeling	f i l i ŋ
feinte	f ɛ̃ t
fellation	f ɛ l a s j ɔ̃
femelle	f ə m ɛ l
femme	f a m
fer	f ɛ ʁ
ferions	f ə ʁ j ɔ̃
ferme	f ɛ ʁ m
fermer	f ɛ ʁ m e
fermeté	f ɛ ʁ m ə t e
fermier	f ɛ ʁ m j e
fermé	f ɛ ʁ m e
fernand	f ɛ ʁ n ɑ̃
ferroviaire	f ɛ ʁ ɔ v j ɛ ʁ
ferry	f ɛ ʁ i
fertilise	f ɛ ʁ t i l i z
fervent	f ɛ ʁ v ɑ̃
ferveur	f ɛ ʁ v œ ʁ
fessée	f ɛ s e
festin	f ɛ s t ɛ̃
festival	f ɛ s t i v a l
feuille	f œ j
feuilles	f œ j
feutre	f ø t ʁ
feux	f ø
fia	ɛ f i a
fiable	f j a b l
fiasco	f j a s k o
fichier	f i ʃ j e
fiction	f i k s j ɔ̃
fidji	f i d ʒ i
fidéliser	f i d e l i z e
fief	f j ɛ f
fiefs	f j ɛ f
fierté	f j ɛ ʁ t e
fige	f i ʒ
figeait	f i ʒ ɛ
figent	f i ʒ
figurative	f i ɡ y ʁ a t i v
figure	f i ɡ y ʁ
figurer	f i ɡ y ʁ e
figurine	f i ɡ y ʁ i n
figé	f i ʒ e
filaient	f i l ɛ
filait	f i l ɛ
file	f i l
filer	f i l e
files	f i l
filet	f i l ɛ
filiale	f i l j a l
fille	f i j
filles	f i j
fillette	f i j ɛ t
film	f i l m
filmas	f i l m ɑ
filme	f i l m
fin	f ɛ̃
final	f i n a l
finalement	f i n a l m ɑ̃
finance	f i n ɑ̃ s
financer	f i n ɑ̃ s e
finances	f i n ɑ̃ s
financier	f i n ɑ̃ s j e
financière	f i n ɑ̃ s j ɛ ʁ
financièrement	f i n ɑ̃ s j ɛ ʁ m ɑ̃
financé	f i n ɑ̃ s e
fine	f i n
fines	f i n
finesse	f i n ɛ s
finir	f i n i ʁ
finira	f i n i ʁ a
finirai	f i n i ʁ e
finiront	f i n i ʁ ɔ̃
finis	f i n i
finissait	f i n i s ɛ
finissions	f i n i s j ɔ̃
finistère	f i n i s t ɛ ʁ
finit	f i n i
finlandais	f ɛ̃ l ɑ̃ d ɛ
finlande	f ɛ̃ l ɑ̃ d
fins	f ɛ̃
fiou	f j u
firme	f i ʁ m
fis	f i
fisc	f i s k
fissure	f i s y ʁ
fixation	f i k s a s j ɔ̃
fixe	f i k s
fixer	f i k s e
fièrement	f j ɛ ʁ m ɑ̃
fièvre	f j ɛ v ʁ
flagrant	f l a ɡ ʁ ɑ̃
flamand	f l a m ɑ̃
flamboyant	f l ɑ̃ b w a j ɑ̃
flancs	f l ɑ̃
flandre	f l ɑ̃ d ʁ
flaques	f l a k
fleur	f l œ ʁ
fleuron	f l œ ʁ ɔ̃
fleuve	f l œ v
fleuves	f l œ v
flexible	f l ɛ k s i b l
flexibles	f l ɛ k s i b l
flic	f l i k
floraux	f l ɔ ʁ o
flore	f l ɔ ʁ
florent	f l ɔ ʁ ɑ̃
floride	f l ɔ ʁ i d
flot	f l o
flottaison	f l ɔ t ɛ z ɔ̃
flotte	f l ɔ t
flottement	f l ɔ t m ɑ̃
flottille	f l ɔ t i j
fléau	f l e o
fléchir	f l e ʃ i ʁ
foi	f w a
foie	f w a
foire	f w a ʁ
fois	f w a
foison	f w a z ɔ̃
foisonnante	f w a z ɔ n ɑ̃ t
foisonnement	f w a z ɔ n m ɑ̃
foisonnerez	f w a z ɔ n ʁ e
folie	f ɔ l i
folle	f ɔ l
follerie	f ɔ l ʁ i
follicule	f ɔ l i k y l
foncier	f ɔ̃ s j e
foncière	f ɔ̃ s j ɛ ʁ
fonction	f ɔ̃ k s j ɔ̃
fonctionnaire	f ɔ̃ k s j ɔ n ɛ ʁ
fonctionnel	f ɔ̃ k s j ɔ n ɛ l
fonctionnelle	f ɔ̃ k s j ɔ n ɛ l
fonctionnels	f ɔ̃ k s j ɔ n ɛ l
fonctionnement	f ɔ̃ k s j ɔ n m ɑ̃
fond	f ɔ̃
fondamental	f ɔ̃ d a m ɑ̃ t a l
fondamentale	f ɔ̃ d a m ɑ̃ t a l
fondamentalement	f ɔ̃ d a m ɑ̃ t a l m ɑ̃
fondamentales	f ɔ̃ d a m ɑ̃ t a l
fondamentaux	f ɔ̃ d a m ɑ̃ t o
fondateur	f ɔ̃ d a t œ ʁ
fondation	f ɔ̃ d a s j ɔ̃
fonde	f ɔ̃ d
fondre	f ɔ̃ d ʁ
fonds	f ɔ̃
fondu	f ɔ̃ d y
fondée	f ɔ̃ d e
fondées	f ɔ̃ d e
font	f ɔ̃
fontaine	f ɔ̃ t ɛ n
for	f ɔ ʁ
forage	f ɔ ʁ a ʒ
force	f ɔ ʁ s
forcer	f ɔ ʁ s e
forces	f ɔ ʁ s
forcément	f ɔ ʁ s e m ɑ̃
foresterie	f ɔ ʁ ɛ s t ə ʁ i
forestière	f ɔ ʁ ɛ s t j ɛ ʁ
forestières	f ɔ ʁ ɛ s t j ɛ ʁ
foret	f ɔ ʁ ɛ
forfait	f ɔ ʁ f ɛ
forger	f ɔ ʁ ʒ e
forgeron	f ɔ ʁ ʒ ə ʁ ɔ̃
format	f ɔ ʁ m a
formation	f ɔ ʁ m a s j ɔ̃
forme	f ɔ ʁ m
formel	f ɔ ʁ m ɛ l
former	f ɔ ʁ m e
formidable	f ɔ ʁ m i d a b l
formulaire	f ɔ ʁ m y l ɛ ʁ
formule	f ɔ ʁ m y l
formuler	f ɔ ʁ m y l e
fort	f ɔ ʁ
fortement	f ɔ ʁ t ə m ɑ̃
forteresse	f ɔ ʁ t ə ʁ ɛ s
fortune	f ɔ ʁ t y n
forum	f ɔ ʁ ɔ m
forêt	f ɔ ʁ ɛ
fosse	f o s
fossette	f ɔ s ɛ t
fossile	f ɔ s i l
fossé	f ɔ s e
foudre	f u d ʁ
fouet	f w ɛ
fougue	f u ɡ
fouine	f w i n
foule	f u l
foulée	f u l e
four	f u ʁ
fourchette	f u ʁ ʃ ɛ t
fourgon	f u ʁ ɡ ɔ̃
fourgonnette	f u ʁ ɡ ɔ n ɛ t
fourneau	f u ʁ n o
fournisseur	f u ʁ n i s œ ʁ
fourniture	f u ʁ n i t y ʁ
fourrure	f u ʁ y ʁ
fouteur	f u t œ ʁ
foutoir	f u t w a ʁ
foyer	f w a j e
frac	f ʁ a k
fraction	f ʁ a k s j ɔ̃
fracture	f ʁ a k t y ʁ
fragile	f ʁ a ʒ i l
fragiles	f ʁ a ʒ i l
fragrance	f ʁ a ɡ ʁ ɑ̃ s
frais	f ʁ ɛ
fraise	f ʁ ɛ z
franc	f ʁ ɑ̃
france	f ʁ ɑ̃ s
francfort	f ʁ ɑ̃ k f ɔ ʁ
franche	f ʁ ɑ̃ ʃ
franchement	f ʁ ɑ̃ ʃ m ɑ̃
franchir	f ʁ ɑ̃ ʃ i ʁ
franchise	f ʁ ɑ̃ ʃ i z
franchises	f ʁ ɑ̃ ʃ i z
franck	f ʁ ɑ̃ k
francophone	f ʁ ɑ̃ k ɔ f ɔ n
francophones	f ʁ ɑ̃ k ɔ f ɔ n
frange	f ʁ ɑ̃ ʒ
frank	f ʁ ɑ̃ k
français	f ʁ ɑ̃ s ɛ
françaises	f ʁ ɑ̃ s ɛ z
françois	f ʁ ɑ̃ s w a
françoise	f ʁ ɑ̃ s w a z
frappe	f ʁ a p
frapper	f ʁ a p e
fraser	f ʁ a z e
fraternelle	f ʁ a t ɛ ʁ n ɛ l
fraternité	f ʁ a t ɛ ʁ n i t e
frayeur	f ʁ ɛ j œ ʁ
frein	f ʁ ɛ̃
freiner	f ʁ ɛ n e
frenche	f ʁ ɑ̃ t ʃ
fret	f ʁ ɛ
friable	f ʁ i j a b l
friand	f ʁ i j ɑ̃
fribourg	f ʁ i b u ʁ
fric	f ʁ i k
frileux	f ʁ i l ø
frise	f ʁ i z
frissonner	f ʁ i s ɔ n e
friture	f ʁ i t y ʁ
froid	f ʁ w ɑ
froissé	f ʁ w a s e
fromage	f ʁ ɔ m a ʒ
fronde	f ʁ ɔ̃ d
front	f ʁ ɔ̃
frontal	f ʁ ɔ̃ t a l
frontale	f ʁ ɔ̃ t a l
frontalier	f ʁ ɔ̃ t a l j e
frontières	f ʁ ɔ̃ t j ɛ ʁ
frotter	f ʁ ɔ t e
frousse	f ʁ u s
fruit	f ʁ ɥ i
fruits	f ʁ ɥ i
frère	f ʁ ɛ ʁ
frémissement	f ʁ e m i s m ɑ̃
fréquence	f ʁ e k ɑ̃ s
fréquences	f ʁ e k ɑ̃ s
fréquenter	f ʁ e k ɑ̃ t e
frêle	f ʁ ɛ l
fuel	f j u l
fui	f ɥ i
fuir	f ɥ i ʁ
fuite	f ɥ i t
fuites	f ɥ i t
fulgurant	f y l ɡ y ʁ ɑ̃
fumantes	f y m ɑ̃ t
fume	f y m
fument	f y m
fumer	f y m e
fumier	f y m j e
fumée	f y m e
funérailles	f y n e ʁ a j
fur	f y ʁ
fureur	f y ʁ œ ʁ
fuselage	f y z l a ʒ
fusil	f y z i
fusillade	f y z i j a d
fusiller	f y z i j e
fustige	f y s t i ʒ
fustigeaient	f y s t i ʒ ɛ
fustigeras	f y s t i ʒ ʁ ɑ
fustigé	f y s t i ʒ e
fusée	f y z e
futur	f y t y ʁ
future	f y t y ʁ
futures	f y t y ʁ
futurs	f y t y ʁ
futé	f y t e
fès	f ɛ s
fébrilité	f e b ʁ i l i t e
fédération	f e d e ʁ a s j ɔ̃
fédérer	f e d e ʁ e
félicien	f e l i s j ɛ̃
félix	f e l i k s
féminin	f e m i n ɛ̃
féministe	f e m i n i s t
féministes	f e m i n i s t
férir	f e ʁ i ʁ
féroce	f e ʁ ɔ s
fétichiserai	f e t i ʃ i z ʁ e
février	f e v ʁ i j e
fêlons	f ɛ l ɔ̃
fêter	f ɛ t e
führer	f y ʁ œ ʁ
gabarit	ɡ a b a ʁ i
gabegie	ɡ a b ʒ i
gabon	ɡ a b ɔ̃
gabrielle	ɡ a b ʁ i j ɛ l
gadget	ɡ a d ʒ ɛ t
gaffe	ɡ a f
gaga	ɡ a ɡ a
gageure	ɡ a ʒ y ʁ
gagne	ɡ a ɲ
gagner	ɡ a ɲ e
gaillard	ɡ a j a ʁ
gaillet	ɡ a j ɛ
galerie	ɡ a l ʁ i
galette	ɡ a l ɛ t
galoper	ɡ a l ɔ p e
galère	ɡ a l ɛ ʁ
gamer	ɡ ɛ m œ ʁ
gamin	ɡ a m ɛ̃
gamme	ɡ a m
gansâtes	ɡ ɑ̃ s ɑ t
gants	ɡ ɑ̃
garant	ɡ a ʁ ɑ̃
garantir	ɡ a ʁ ɑ̃ t i ʁ
garde	ɡ a ʁ d
gardent	ɡ a ʁ d
garder	ɡ a ʁ d e
garderie	ɡ a ʁ d ə ʁ i
gardien	ɡ a ʁ d j ɛ̃
garenne	ɡ a ʁ ɛ n
garni	ɡ a ʁ n i
garnir	ɡ a ʁ n i ʁ
garniture	ɡ a ʁ n i t y ʁ
garçon	ɡ a ʁ s ɔ̃
garçonnet	ɡ a ʁ s ɔ n ɛ
gascogne	ɡ a s k ɔ ɲ
gaspard	ɡ a s p a ʁ
gaspillage	ɡ a s p i j a ʒ
gaspiller	ɡ a s p i j e
gastriques	ɡ a s t ʁ i k
gatineau	ɡ a t i n o
gauche	ɡ o ʃ
gauchir	ɡ o ʃ i ʁ
gaudé	ɡ o d e
gauthier	ɡ o t j e
gautier	ɡ o t j e
gaver	ɡ a v e
gay	ɡ ɛ
gays	ɡ ɛ
gaz	ɡ ɑ z
gaza	ɡ a z a
gazonné	ɡ ɑ z ɔ n e
gazouillis	ɡ a z u j i
gaétan	ɡ a e t ɑ̃
gaël	ɡ a ɛ l
gaëlle	ɡ a ɛ l
gel	ʒ ɛ l
geler	ʒ ə l e
gelé	ʒ ə l e
gendarme	ʒ ɑ̃ d a ʁ m
gendarmerie	ʒ ɑ̃ d a ʁ m ə ʁ i
geneviève	ʒ ə n ə v j ɛ v
genou	ʒ ə n u
genres	ʒ ɑ̃ ʁ
gentil	ʒ ɑ̃ t i
gentiment	ʒ ɑ̃ t i m ɑ̃
geoffroy	ʒ ɔ f ʁ w a
georges	ʒ ɔ ʁ ʒ
gerbe	ʒ ɛ ʁ b
gerber	ʒ ɛ ʁ b e
germanophones	ʒ ɛ ʁ m a n ɔ f ɔ n
gesse	ʒ ɛ s
geste	ʒ ɛ s t
gestion	ʒ ɛ s t j ɔ̃
gestionnaire	ʒ ɛ s t j ɔ n ɛ ʁ
ghana	ɡ a n a
ghanéen	ɡ a n e ɛ̃
gilbert	ʒ i l b ɛ ʁ
gilles	ʒ i l
ginette	ʒ i n ɛ t
gironde	ʒ i ʁ ɔ̃ d
gisèle	ʒ i z ɛ l
gitan	ʒ i t ɑ̃
glace	ɡ l a s
glaciaire	ɡ l a s j ɛ ʁ
glacial	ɡ l a s j a l
glacée	ɡ l a s e
glapirent	ɡ l a p i ʁ
glapissons	ɡ l a p i s ɔ̃
glas	ɡ l ɑ
glissant	ɡ l i s ɑ̃
glisse	ɡ l i s
glisser	ɡ l i s e
global	ɡ l ɔ b a l
globale	ɡ l ɔ b a l
globalisation	ɡ l ɔ b a l i z a s j ɔ̃
globaux	ɡ l ɔ b o
globe	ɡ l ɔ b
gloire	ɡ l w a ʁ
glorieux	ɡ l ɔ ʁ j ø
glâne	ɡ l a n
go	ɡ o
gobes	ɡ ɔ b
goitre	ɡ w a t ʁ
golfe	ɡ ɔ l f
golfeur	ɡ ɔ l f œ ʁ
gommait	ɡ ɔ m ɛ
gomme	ɡ ɔ m
gonfler	ɡ ɔ̃ f l e
gorge	ɡ ɔ ʁ ʒ
gosses	ɡ ɔ s
gotha	ɡ ɔ t a
gothique	ɡ ɔ t i k
goudronnaient	ɡ u d ʁ ɔ n ɛ
gouffre	ɡ u f ʁ
gourmandise	ɡ u ʁ m ɑ̃ d i z
gouvernance	ɡ u v ɛ ʁ n ɑ̃ s
gouvernants	ɡ u v ɛ ʁ n ɑ̃
gouverne	ɡ u v ɛ ʁ n
gouvernement	ɡ u v ɛ ʁ n ə m ɑ̃
gouverner	ɡ u v ɛ ʁ n e
gouverneur	ɡ u v ɛ ʁ n œ ʁ
gouverneure	ɡ u v ɛ ʁ n œ ʁ
goûter	ɡ u t e
goûteuse	ɡ u t ø z
gracieusement	ɡ ʁ a s j ø z m ɑ̃
grade	ɡ ʁ a d
grain	ɡ ʁ ɛ̃
graisse	ɡ ʁ ɛ s
grandement	ɡ ʁ ɑ̃ d m ɑ̃
grandes	ɡ ʁ ɑ̃ d
grandeur	ɡ ʁ ɑ̃ d œ ʁ
grandi	ɡ ʁ ɑ̃ d i
grandiose	ɡ ʁ ɑ̃ d j o z
grandissant	ɡ ʁ ɑ̃ d i s ɑ̃
grandissime	ɡ ʁ ɑ̃ d i s i m
grandit	ɡ ʁ ɑ̃ d i
granit	ɡ ʁ a n i
gras	ɡ ʁ ɑ
grasse	ɡ ʁ ɑ s
gratuit	ɡ ʁ a t ɥ i
gratuite	ɡ ʁ a t ɥ i t
gratuitement	ɡ ʁ a t ɥ i t m ɑ̃
gratuité	ɡ ʁ a t ɥ i t e
grave	ɡ ʁ a v
gravement	ɡ ʁ a v m ɑ̃
gravi	ɡ ʁ a v i
gravir	ɡ ʁ a v i ʁ
graviraient	ɡ ʁ a v i ʁ ɛ
graviriez	ɡ ʁ a v i ʁ j e
gravissent	ɡ ʁ a v i s
gravité	ɡ ʁ ɑ v i t e
gravure	ɡ ʁ a v y ʁ
gray	ɡ ʁ ɛ j
grc	ʒ e ɛ ʁ s e
grec	ɡ ʁ ɛ k
grecques	ɡ ʁ ɛ k
grecs	ɡ ʁ ɛ k
greffe	ɡ ʁ ɛ f
grenadine	ɡ ʁ ə n a d i n
grenelle	ɡ ʁ ə n ɛ l
grenier	ɡ ʁ ə n j e
grenoble	ɡ ʁ ə n ɔ b l
grenouille	ɡ ʁ ə n u j
griffe	ɡ ʁ i f
grille	ɡ ʁ i j
grilles	ɡ ʁ i j
grimper	ɡ ʁ ɛ̃ p e
grimpeur	ɡ ʁ ɛ̃ p œ ʁ
grincer	ɡ ʁ ɛ̃ s e
grippe	ɡ ʁ i p
gris	ɡ ʁ i
grison	ɡ ʁ i z ɔ̃
grisou	ɡ ʁ i z u
grièvement	ɡ ʁ i j ɛ v m ɑ̃
grogne	ɡ ʁ ɔ ɲ
gronder	ɡ ʁ ɔ̃ d e
grossir	ɡ ʁ o s i ʁ
grossissement	ɡ ʁ o s i s m ɑ̃
grossiste	ɡ ʁ o s i s t
grotesque	ɡ ʁ ɔ t ɛ s k
grotte	ɡ ʁ ɔ t
groupe	ɡ ʁ u p
groupuscule	ɡ ʁ u p y s k y l
grues	ɡ ʁ y
grès	ɡ ʁ ɛ
grève	ɡ ʁ ɛ v
grèves	ɡ ʁ ɛː v
gsm	ʒ e ɛ s ɛ m
guadeloupe	ɡ w a d l u p
guerre	ɡ ɛ ʁ
guerres	ɡ ɛ ʁ
guet	ɡ ɛ
gueule	ɡ œ l
gueules	ɡ œ l
guide	ɡ i d
guides	ɡ i d
guidé	ɡ i d e
guillaume	ɡ i j o m
guingamp	ɡ ɛ̃ ɡ ɑ̃
guinée	ɡ i n e
guinéen	ɡ i n e ɛ̃
guitare	ɡ i t a ʁ
gus	ɡ y s
guy	ɡ i
guère	ɡ ɛ ʁ
guérir	ɡ e ʁ i ʁ
guérison	ɡ e ʁ i z ɔ̃
guérisseur	ɡ e ʁ i s œ ʁ
guêtres	ɡ ɛ t ʁ
gâcher	ɡ ɑ ʃ e
gâchette	ɡ a ʃ ɛ t
gâteau	ɡ ɑ t o
gâteaux	ɡ ɑ t o
gène	ʒ ɛ n
géant	ʒ e ɑ̃
génial	ʒ e n j a l
génie	ʒ e n i
génital	ʒ e n i t a l
génitales	ʒ e n i t a l
génocide	ʒ e n ɔ s i d
génomique	ʒ e n ɔ m i k
général	ʒ e n e ʁ a l
générale	ʒ e n e ʁ a l
générales	ʒ e n e ʁ a l
génération	ʒ e n e ʁ a s j ɔ̃
généreux	ʒ e n e ʁ ø
générosité	ʒ e n e ʁ o z i t e
génétique	ʒ e n e t i k
génétiquement	ʒ e n e t i k m ɑ̃
génétiques	ʒ e n e t i k
géographie	ʒ e ɔ ɡ ʁ a f i
géographique	ʒ e ɔ ɡ ʁ a f i k
géologie	ʒ e ɔ l ɔ ʒ i
géologique	ʒ e ɔ l ɔ ʒ i k
géophysicien	ʒ e o f i z i s j ɛ̃
géophysique	ʒ e o f i z i k
géorgie	ʒ e ɔ ʁ ʒ i
géraldine	ʒ e ʁ a l d i n
gérant	ʒ e ʁ ɑ̃
gérard	ʒ e ʁ a ʁ
gérer	ʒ e ʁ e
habile	a b i l
habilement	a b i l m ɑ̃
habiletés	a b i l t e
habilité	a b i l i t e
habillage	a b i j a ʒ
habit	a b i
habitat	a b i t a
habits	a b i
habituelles	a b i t ɥ ɛ l
habitué	a b i t ɥ e
hache	a ʃ
haine	ɛ n
haleine	a l ɛ n
hall	o l
hallucinant	a l y s i n ɑ̃
hallucination	a l y s i n a s j ɔ̃
halte	a l t
haltère	a l t ɛ ʁ
hambourg	ɑ̃ b u ʁ
hanche	ɑ̃ ʃ
handball	ɑ̃ d b a l
handicap	ɑ̃ d i k a p
harassant	a ʁ a s ɑ̃
harcèlement	a ʁ s ɛ l m ɑ̃
harcèlements	a ʁ s ɛ l m ɑ̃
hargneux	a ʁ ɲ ø
harmonieuse	a ʁ m ɔ n j ø z
haro	a ʁ o
harper	a ʁ p e
hasard	a z a ʁ
hausse	o s
hausser	o s e
haussier	o s j e
haussé	o s e
haute	o t
havre	ɑ v ʁ
hawaï	a w a j
haïti	a i t i
hebdomadaire	ɛ b d ɔ m a d ɛ ʁ
henri	ɑ̃ ʁ i
henry	ɑ̃ ʁ i
herbe	ɛ ʁ b
hernie	ɛ ʁ n i
hervé	ɛ ʁ v e
heure	œ ʁ
heures	œ ʁ
hexagone	ɛ ɡ z a ɡ ɔ n
hic	i k
hidjab	i d ʒ a b
hilarant	i l a ʁ ɑ̃
hindou	ɛ̃ d u
hisser	i s e
historien	i s t ɔ ʁ j ɛ̃
historique	i s t ɔ ʁ i k
hiver	i v ɛ ʁ
hivernal	i v ɛ ʁ n a l
hiérarchique	j e ʁ a ʁ ʃ i k
hockey	ɔ k ɛ
hollandais	ɔ l ɑ̃ d ɛ
hollandaise	ɔ l ɑ̃ d ɛ z
hollande	ɔ l ɑ̃ d
homme	ɔ m
hommes	ɔ m
homonyme	ɔ m ɔ n i m
homosexualité	ɔ m ɔ s ɛ k s ɥ a l i t e
homosexuel	ɔ m ɔ s ɛ k s ɥ ɛ l
honduras	ɔ̃ d y ʁ a s
hongrie	ɔ̃ ɡ ʁ i
hongrois	ɔ̃ ɡ ʁ w a
honneur	ɔ n œ ʁ
honnête	ɔ n ɛ t
honnêtement	ɔ n ɛ t m ɑ̃
honte	ɔ̃ t
honteux	ɔ̃ t ø
hop	ɔ p
horaire	ɔ ʁ ɛ ʁ
horizon	ɔ ʁ i z ɔ̃
horizons	ɔ ʁ i z ɔ̃
horizontale	ɔ ʁ i z ɔ̃ t a l
horizontaliserons	ɔ ʁ i z ɔ̃ t a l i z ʁ ɔ̃
horizontalisons	ɔ ʁ i z ɔ̃ t a l i z ɔ̃
horloger	ɔ ʁ l ɔ ʒ e
hormis	ɔ ʁ m i
hormone	ɔ ʁ m ɔ n
horreur	ɔ ʁ œ ʁ
hors	ɔ ʁ
hortense	ɔ ʁ t ɑ̃ s
hospitalier	ɔ s p i t a l j e
hospitalité	ɔ s p i t a l i t e
houlette	u l ɛ t
houleux	u l ø
house	a w s
houspillerai	u s p i j ʁ e
hugo	y ɡ o
huguette	y ɡ ɛ t
hui	ɥ i
huile	ɥ i l
huis	ɥ i
huissier	ɥ i s j e
huitièmes	ɥ i t j ɛ m
hulotte	y l ɔ t
humain	y m ɛ̃
humaines	y m ɛ n
humains	y m ɛ̃
humanité	y m a n i t e
humanités	y m a n i t e
humbert	œ̃ b ɛ ʁ
humble	œ̃ b l
humer	y m e
humide	y m i d
humides	y m i d
humiliant	y m i l j ɑ̃
humiliante	y m i l j ɑ̃ t
humilier	y m i l j e
humilité	y m i l i t e
huppé	y p e
hurlant	y ʁ l ɑ̃
hurler	y ʁ l e
hybride	i b ʁ i d
hygiène	i ʒ j ɛ n
hypermarché	i p ɛ ʁ m a ʁ ʃ e
hypocondriaque	i p ɔ k ɔ̃ d ʁ i j a k
hypocrisie	i p ɔ k ʁ i z i
hypothèse	i p ɔ t ɛ z
hâte	ɑ t
hâter	ɑ t e
hâtive	ɑ t i v
hâtivement	ɑ t i v m ɑ̃
hébergement	e b ɛ ʁ ʒ ə m ɑ̃
héberger	e b ɛ ʁ ʒ e
hébert	e b ɛ ʁ
hébreu	e b ʁ ø
hélicoptère	e l i k ɔ p t ɛ ʁ
hémorragie	e m ɔ ʁ a ʒ i
hémorroïdes	e m ɔ ʁ ɔ i d
hérault	e ʁ o
héritiers	e ʁ i t j e
héroïne	e ʁ ɔ i n
hésite	e z i t
hésitent	e z i t
hésiter	e z i t e
hésitez	e z i t e
hôte	o t
hôtellerie	o t ɛ l ʁ i
hôtesse	o t ɛ s
ici	i s i
idem	i d ɛ m
identification	i d ɑ̃ t i f i k a s j ɔ̃
identifier	i d ɑ̃ t i f j e
identité	i d ɑ̃ t i t e
idiot	i d j o
idyllique	i d i l i k
idéal	i d e a l
idéaliste	i d e a l i s t
idée	i d e
idéologie	i d e ɔ l ɔ ʒ i
ignifuger	i ɡ n i f y ʒ e
ignorance	i ɲ ɔ ʁ ɑ̃ s
ignorer	i ɲ ɔ ʁ e
illicite	i l i s i t
illimité	i l i m i t e
illinois	i l i n w a
illusion	i l y z j ɔ̃
illustratif	i l y s t ʁ a t i f
illustration	i l y s t ʁ a s j ɔ̃
imaginant	i m a ʒ i n ɑ̃
imaginatifs	i m a ʒ i n a t i f
imagination	i m a ʒ i n a s j ɔ̃
imaginer	i m a ʒ i n e
imaginez	i m a ʒ i n e
imam	i m a m
imbécile	ɛ̃ b e s i l
imitation	i m i t a s j ɔ̃
immense	i m ɑ̃ s
immeuble	i m œ b l
immigré	i m i ɡ ʁ e
immisce	i m i s
immobile	i m ɔ b i l
immuable	i m ɥ a b l
immunité	i m y n i t e
immédiat	i m e d j a
immédiatement	i m e d j a t m ɑ̃
impact	ɛ̃ p a k t
imparable	ɛ̃ p a ʁ a b l
impardonnable	ɛ̃ p a ʁ d ɔ n a b l
impartial	ɛ̃ p a ʁ s j a l
impasse	ɛ̃ p ɑ s
impatiemment	ɛ̃ p a s j a m ɑ̃
impatient	ɛ̃ p a s j ɑ̃
impeccable	ɛ̃ p ɛ k a b l
impensable	ɛ̃ p ɑ̃ s a b l
impertinent	ɛ̃ p ɛ ʁ t i n ɑ̃
impitoyable	ɛ̃ p i t w a j a b l
implicitement	ɛ̃ p l i s i t m ɑ̃
impliquer	ɛ̃ p l i k e
implosai	ɛ̃ p l o z e
imploser	ɛ̃ p l o z e
impolitesse	ɛ̃ p ɔ l i t ɛ s
important	ɛ̃ p ɔ ʁ t ɑ̃
importateurs	ɛ̃ p ɔ ʁ t a t œ ʁ
importe	ɛ̃ p ɔ ʁ t
importer	ɛ̃ p ɔ ʁ t e
imposant	ɛ̃ p o z ɑ̃
imposer	ɛ̃ p o z e
impossible	ɛ̃ p ɔ s i b l
imprime	ɛ̃ p ʁ i m
imprimerie	ɛ̃ p ʁ i m ʁ i
improbable	ɛ̃ p ʁ ɔ b a b l
imprudent	ɛ̃ p ʁ y d ɑ̃
imprécis	ɛ̃ p ʁ e s i
imprévisible	ɛ̃ p ʁ e v i z i b l
imprévus	ɛ̃ p ʁ e v y
impuissance	ɛ̃ p ɥ i s ɑ̃ s
impédance	ɛ̃ p e d ɑ̃ s
impériale	ɛ̃ p ɛ ʁ j a l
impérieuse	ɛ̃ p e ʁ j ø z
impôt	ɛ̃ p o
inacceptable	i n a k s ɛ p t a b l
inaction	i n a k s j ɔ̃
inadmissible	i n a d m i s i b l
inaliénable	i n a l j e n a b l
inauguration	i n o ɡ y ʁ a s j ɔ̃
incapable	ɛ̃ k a p a b l
incarnation	ɛ̃ k a ʁ n a s j ɔ̃
incarner	ɛ̃ k a ʁ n e
incendiaire	ɛ̃ s ɑ̃ d j ɛ ʁ
incendiait	ɛ̃ s ɑ̃ d j ɛ
incendie	ɛ̃ s ɑ̃ d i
incendies	ɛ̃ s ɑ̃ d i
incendié	ɛ̃ s ɑ̃ d j e
incertain	ɛ̃ s ɛ ʁ t ɛ̃
incertitude	ɛ̃ s ɛ ʁ t i t y d
incessamment	ɛ̃ s ɛ s a m ɑ̃
incidence	ɛ̃ s i d ɑ̃ s
incident	ɛ̃ s i d ɑ̃
incitation	ɛ̃ s i t a s j ɔ̃
inciter	ɛ̃ s i t e
incliner	ɛ̃ k l i n e
inclure	ɛ̃ k l y ʁ
inclus	ɛ̃ k l y
incomplet	ɛ̃ k ɔ̃ p l ɛ
incompréhensible	ɛ̃ k ɔ̃ p ʁ e ɑ̃ s i b l
inconcevable	ɛ̃ k ɔ̃ s v a b l
inconditionnel	ɛ̃ k ɔ̃ d i s j ɔ n ɛ l
inconnu	ɛ̃ k ɔ n y
inconnue	ɛ̃ k ɔ n y
inconsciemment	ɛ̃ k ɔ̃ s j a m ɑ̃
incontestable	ɛ̃ k ɔ̃ t ɛ s t a b l
incontestablement	ɛ̃ k ɔ̃ t ɛ s t a b l ə m ɑ̃
incontournable	ɛ̃ k ɔ̃ t u ʁ n a b l
inculquer	ɛ̃ k y l k e
inde	ɛ̃ d
indemne	ɛ̃ d ɛ m n
index	ɛ̃ d ɛ k s
indicatif	ɛ̃ d i k a t i f
indication	ɛ̃ d i k a s j ɔ̃
indice	ɛ̃ d i s
indices	ɛ̃ d i s
indien	ɛ̃ d j ɛ̃
indifférent	ɛ̃ d i f e ʁ ɑ̃
indignation	ɛ̃ d i ɲ a s j ɔ̃
indigne	ɛ̃ d i ɲ
indignes	ɛ̃ d i ɲ
indique	ɛ̃ d i k
indiquer	ɛ̃ d i k e
indiscutable	ɛ̃ d i s k y t a b l
indispensable	ɛ̃ d i s p ɑ̃ s a b l
individuel	ɛ̃ d i v i d ɥ ɛ l
indonésie	ɛ̃ d o n e z i
indonésien	ɛ̃ d ɔ n e z j ɛ̃
indonésienne	ɛ̃ d ɔ n e z j ɛ n
induit	ɛ̃ d ɥ i
industrie	ɛ̃ d y s t ʁ i
industriel	ɛ̃ d y s t ʁ i j ɛ l
indéfinie	ɛ̃ d e f i n i
indéfiniment	ɛ̃ d e f i n i m ɑ̃
indépendance	ɛ̃ d e p ɑ̃ d ɑ̃ s
indépendantiste	ɛ̃ d e p ɑ̃ d ɑ̃ t i s t
inepties	i n ɛ p s i
inertie	i n ɛ ʁ s i
inexact	i n ɛ ɡ z a k t
infatigable	ɛ̃ f a t i ɡ a b l
infidélité	ɛ̃ f i d e l i t e
infiniment	ɛ̃ f i n i m ɑ̃
infirmer	ɛ̃ f i ʁ m e
infirmier	ɛ̃ f i ʁ m j e
infirmière	ɛ̃ f i ʁ m j ɛ ʁ
inflation	ɛ̃ f l a s j ɔ̃
infligea	ɛ̃ f l i ʒ a
infligent	ɛ̃ f l i ʒ
infligerions	ɛ̃ f l i ʒ ə ʁ j ɔ̃
infliges	ɛ̃ f l i ʒ
infligé	ɛ̃ f l i ʒ e
influence	ɛ̃ f l y ɑ̃ s
influencer	ɛ̃ f l y ɑ̃ s e
influentes	ɛ̃ f l y ɑ̃ t
influents	ɛ̃ f l y ɑ̃
influer	ɛ̃ f l y e
info	ɛ̃ f o
informelle	ɛ̃ f ɔ ʁ m ɛ l
informels	ɛ̃ f ɔ ʁ m ɛ l
informer	ɛ̃ f ɔ ʁ m e
informé	ɛ̃ f ɔ ʁ m e
infortune	ɛ̃ f ɔ ʁ t y n
infrarouge	ɛ̃ f ʁ a ʁ u ʒ
inféoder	ɛ̃ f e ɔ d e
inférieur	ɛ̃ f e ʁ j œ ʁ
ingrat	ɛ̃ ɡ ʁ a
ingrid	i ŋ ɡ ʁ i d
ingrédients	ɛ̃ ɡ ʁ e d j ɑ̃
inguérissable	ɛ̃ ɡ e ʁ i s a b l
ingénieur	ɛ̃ ʒ e n j œ ʁ
inhabituel	i n a b i t ɥ ɛ l
inhalation	i n a l a s j ɔ̃
initiatique	i n i s j a t i k
initier	i n i s j e
injection	ɛ̃ ʒ ɛ k s j ɔ̃
injure	ɛ̃ ʒ y ʁ
injustice	ɛ̃ ʒ y s t i s
innocence	i n ɔ s ɑ̃ s
innover	i n ɔ v e
inquiet	ɛ̃ k j ɛ
inquiets	ɛ̃ k j ɛ
inquiète	ɛ̃ k j ɛ t
inquiéter	ɛ̃ k j e t e
inquiétude	ɛ̃ k j e t y d
inscription	ɛ̃ s k ʁ i p s j ɔ̃
inscrire	ɛ̃ s k ʁ i ʁ
insecte	ɛ̃ s ɛ k t
insipide	ɛ̃ s i p i d
insolite	ɛ̃ s ɔ l i t
insouciance	ɛ̃ s u s j ɑ̃ s
inspecteur	ɛ̃ s p ɛ k t œ ʁ
inspiration	ɛ̃ s p i ʁ a s j ɔ̃
inspirer	ɛ̃ s p i ʁ e
installation	ɛ̃ s t a l a s j ɔ̃
installer	ɛ̃ s t a l e
instance	ɛ̃ s t ɑ̃ s
instantané	ɛ̃ s t ɑ̃ t a n e
instar	ɛ̃ s t a ʁ
instaurer	ɛ̃ s t ɔ ʁ e
instit	ɛ̃ s t i
instruction	ɛ̃ s t ʁ y k s j ɔ̃
instrument	ɛ̃ s t ʁ y m ɑ̃
instruments	ɛ̃ s t ʁ y m ɑ̃
insuffisance	ɛ̃ s y f i z ɑ̃ s
insuffler	ɛ̃ s y f l e
insultant	ɛ̃ s y l t ɑ̃
insulte	ɛ̃ s y l t
insulter	ɛ̃ s y l t e
insultes	ɛ̃ s y l t
insultât	ɛ̃ s y l t ɑ
insulté	ɛ̃ s y l t e
insupportable	ɛ̃ s y p ɔ ʁ t a b l
insurgé	ɛ̃ s y ʁ ʒ e
intelligemment	ɛ̃ t e l i ʒ a m ɑ̃
intempestive	ɛ̃ t ɑ̃ p ɛ s t i v
intense	ɛ̃ t ɑ̃ s
intensifier	ɛ̃ t ɑ̃ s i f j e
intensité	ɛ̃ t ɑ̃ s i t e
intention	ɛ̃ t ɑ̃ s j ɔ̃
inter	ɛ̃ t e
interactif	ɛ̃ t ɛ ʁ a k t i f
interaction	ɛ̃ t ɛ ʁ a k s j ɔ̃
interdire	ɛ̃ t ɛ ʁ d i ʁ
interdit	ɛ̃ t ɛ ʁ d i
interface	ɛ̃ t ɛ ʁ f a s
interjeter	ɛ̃ t ɛ ʁ ʒ ə t e
interlocuteur	ɛ̃ t ɛ ʁ l ɔ k y t œ ʁ
interminable	ɛ̃ t ɛ ʁ m i n a b l
intermunicipale	ɛ̃ t ɛ ʁ m y n i s i p a l
intermédiaire	ɛ̃ t ɛ ʁ m e d j ɛ ʁ
international	ɛ̃ t ɛ ʁ n a s j ɔ n a l
internationale	ɛ̃ t ɛ ʁ n a s j ɔ n a l
interne	ɛ̃ t ɛ ʁ n
internet	ɛ̃ t ɛ ʁ n ɛ t
interpellation	ɛ̃ t ɛ ʁ p e l a s j ɔ̃
interprète	ɛ̃ t ɛ ʁ p ʁ ɛ t
interprétation	ɛ̃ t ɛ ʁ p ʁ e t a s j ɔ̃
interrogatoire	ɛ̃ t ɛ ʁ ɔ ɡ a t w a ʁ
interrompre	ɛ̃ t ɛ ʁ ɔ̃ p ʁ
interrompu	ɛ̃ t ɛ ʁ ɔ̃ p y
interruption	ɛ̃ t ɛ ʁ y p s j ɔ̃
intervalle	ɛ̃ t ɛ ʁ v a l
intime	ɛ̃ t i m
intimes	ɛ̃ t i m
intimider	ɛ̃ t i m i d e
intimité	ɛ̃ t i m i t e
intimé	ɛ̃ t i m e
intouchable	ɛ̃ t u ʃ a b l
intox	ɛ̃ t ɔ k s
intraveineuse	ɛ̃ t ʁ a v e n ø z
intraveineux	ɛ̃ t ʁ a v e n ø
intrigue	ɛ̃ t ʁ i ɡ
introduction	ɛ̃ t ʁ ɔ d y k s j ɔ̃
intuition	ɛ̃ t ɥ i s j ɔ̃
intègre	ɛ̃ t ɛ ɡ ʁ
intégral	ɛ̃ t e ɡ ʁ a l
intégration	ɛ̃ t e ɡ ʁ a s j ɔ̃
intéressant	ɛ̃ t e ʁ ɛ s ɑ̃
intéresser	ɛ̃ t e ʁ ɛ s e
intérieur	ɛ̃ t e ʁ j œ ʁ
intérim	ɛ̃ t e ʁ i m
intérêt	ɛ̃ t e ʁ ɛ
intérêts	ɛ̃ t e ʁ ɛ
inusités	i n y z i t e
inutile	i n y t i l
inutiles	i n y t i l
inutilité	i n y t i l i t e
invasion	ɛ̃ v a z j ɔ̃
inventer	ɛ̃ v ɑ̃ t e
invention	ɛ̃ v ɑ̃ s j ɔ̃
inverse	ɛ̃ v ɛ ʁ s
investigation	ɛ̃ v ɛ s t i ɡ a s j ɔ̃
investir	ɛ̃ v ɛ s t i ʁ
investissement	ɛ̃ v ɛ s t i s m ɑ̃
investiture	ɛ̃ v ɛ s t i t y ʁ
invitation	ɛ̃ v i t a s j ɔ̃
inviter	ɛ̃ v i t e
invoquer	ɛ̃ v ɔ k e
inédit	i n e d i
inégale	i n e ɡ a l
inégalitaire	i n e ɡ a l i t ɛ ʁ
inégalité	i n e ɡ a l i t e
inénarrable	i n e n a ʁ a b l
inévitable	i n e v i t a b l
ioniques	j ɔ n i k
ionisation	j ɔ n i z a s j ɔ̃
ipod	a j p ɔ d
iqaluit	i k a l ɥ i t
ira	i ʁ a
irakien	i ʁ a k j ɛ̃
iran	i ʁ ɑ̃
ire	i ʁ
irez	i ʁ e
irlandais	i ʁ l ɑ̃ d ɛ
irlandaise	i ʁ l ɑ̃ d ɛ z
irlande	i ʁ l ɑ̃ d
irons	i ʁ ɔ̃
iront	i ʁ ɔ̃
irresponsable	i ʁ ɛ s p ɔ̃ s a b l
irruption	i ʁ y p s j ɔ̃
irréconciliable	i ʁ e k ɔ̃ s i l j a b l
irrémédiable	i ʁ e m e d j a b l
irrésistible	i ʁ e z i s t i b l
irréversible	i ʁ e v ɛ ʁ s i b l
isaac	i z a a k
islam	i s l a m
islamique	i s l a m i k
islamiste	i s l a m i s t
islandais	i s l ɑ̃ d ɛ
islande	i s l ɑ̃ d
isolation	i z ɔ l a s j ɔ̃
isolement	i z ɔ l m ɑ̃
isoler	i z ɔ l e
isolé	i z ɔ l e
israélien	i s ʁ a e l j ɛ̃
issu	i s y
istanbul	i s t ɑ̃ b u l
isère	i z ɛ ʁ
italie	i t a l i
italienne	i t a l j ɛ n
itinéraire	i t i n e ʁ ɛ ʁ
itou	i t u
ivrogne	i v ʁ ɔ ɲ
jacker	ʒ a k e
jacob	ʒ a k ɔ b
jalousie	ʒ a l u z i
jaloux	ʒ a l u
jamaïcain	ʒ a m a i k ɛ̃
jambage	ʒ ɑ̃ b a ʒ
jambon	ʒ ɑ̃ b ɔ̃
janine	ʒ a n i n
jante	ʒ ɑ̃ t
janvier	ʒ ɑ̃ v j e
japonais	ʒ a p ɔ n ɛ
japonaise	ʒ a p ɔ n ɛ z
jardin	ʒ a ʁ d ɛ̃
jardinage	ʒ a ʁ d i n a ʒ
jardiner	ʒ a ʁ d i n e
jardinier	ʒ a ʁ d i n j e
jaune	ʒ o n
jaunes	ʒ o n
java	ʒ a v a
jazz	d ʒ ɑ z
jeanne	ʒ a n
jennifer	ʒ ɛ n i f ɛ ʁ
jessica	ʒ ɛ s i k a
jetable	ʒ ə t a b l
jetables	ʒ ə t a b l
jette	ʒ ɛ t
jeté	ʒ ə t e
jetées	ʒ ə t e
jeu	ʒ ø
jeudi	ʒ ø d i
jeune	ʒ œ n
jeunes	ʒ œ n
jeunesse	ʒ œ n ɛ s
jeux	ʒ ø
jeûne	ʒ ø n
ji	ʒ i
jihad	d ʒ i a d
jocelyn	ʒ o s l ɛ̃
jockey	ʒ ɔ k ɛ
johnson	ʒ ɔ n s ɔ̃
joindre	ʒ w ɛ̃ d ʁ
joins	ʒ w ɛ̃
joint	ʒ w ɛ̃
joints	ʒ w ɛ̃
joli	ʒ ɔ l i
jonas	ʒ ɔ n ɑ
jonathan	ʒ ɔ n a t ɑ̃
jones	ʒ ɔ n
jongler	ʒ ɔ̃ ɡ l e
jordanie	ʒ ɔ ʁ d a n i
joseph	ʒ o z ɛ f
josselin	ʒ o s e l ɛ̃
josé	ʒ o z e
joséphine	ʒ o z e f i n
joue	ʒ u
jouet	ʒ w ɛ
joueur	ʒ w œ ʁ
jouit	ʒ w i
jour	ʒ u ʁ
journal	ʒ u ʁ n a l
journalisme	ʒ u ʁ n a l i z m
journaliste	ʒ u ʁ n a l i s t
journée	ʒ u ʁ n e
jours	ʒ u ʁ
joute	ʒ u t
joutes	ʒ u t
joué	ʒ w e
joyeux	ʒ w a j ø
joël	ʒ ɔ ɛ l
joëlle	ʒ ɔ ɛ l
jt	ʒ i t e
juge	ʒ y ʒ
jugeant	ʒ y ʒ ɑ̃
juger	ʒ y ʒ e
juges	ʒ y ʒ
jugé	ʒ y ʒ e
jujubier	ʒ y ʒ y b j e
julia	ʒ y l j a
julie	ʒ y l i
julien	ʒ y l j ɛ̃
jumeau	ʒ y m o
jumeler	ʒ y m l e
jument	ʒ y m ɑ̃
junte	ʒ œ̃ t
jupiter	ʒ y p i t ɛ ʁ
jura	ʒ y ʁ a
jurançon	ʒ y ʁ ɑ̃ s ɔ̃
jure	ʒ y ʁ
jurent	ʒ y ʁ
jurer	ʒ y ʁ e
juridique	ʒ y ʁ i d i k
jurisprudence	ʒ y ʁ i s p ʁ y d ɑ̃ s
jury	ʒ y ʁ i
juré	ʒ y ʁ e
jus	ʒ y
jusque	ʒ y s k
just	ʒ y s t
juste	ʒ y s t
justement	ʒ y s t ə m ɑ̃
justes	ʒ y s t
justice	ʒ y s t i s
justification	ʒ y s t i f i k a s j ɔ̃
justin	ʒ y s t ɛ̃
justine	ʒ y s t i n
jérémie	ʒ e ʁ e m i
jérémy	ʒ e ʁ e m i
jérôme	ʒ e ʁ o m
ka	k ɑ
kaboul	k a b u l
kangourou	k ɑ̃ ɡ u ʁ u
kaolinisas	k a ɔ l i n i z ɑ
kazakh	k a z a k
ken	k ɛ n
kenya	k e n j a
kenyane	k e n j a n
kenzo	k ɛ n z o
kevin	k e v i n
kiev	k j ɛ v
kif	k i f
kilo	k i l o
kiosque	k j ɔ s k
kirghizistan	k i ʁ ɡ i z i s t ɑ̃
kirghizstan	k i ʁ ɡ i s t ɑ̃
koala	k ɔ a l a
kurde	k y ʁ d
la	l a
label	l a b ɛ l
labeur	l a b œ ʁ
laboratoire	l a b ɔ ʁ a t w a ʁ
lac	l a k
lacrosse	l a k ʁ ɔ s
lacrymogène	l a k ʁ i m ɔ ʒ ɛ n
ladite	l a d i t
lafrenière	l a f ʁ ə n j ɛ ʁ
lahore	l a ɔ ʁ
lai	l ɛ
laideur	l ɛ d œ ʁ
laine	l ɛ n
laisse	l ɛ s
laissé	l ɛ s e
lait	l ɛ
lama	l a m a
lambert	l ɑ̃ b ɛ ʁ
lambris	l ɑ̃ b ʁ i
lamperais	l ɑ̃ p ʁ ɛ
lance	l ɑ̃ s
lancement	l ɑ̃ s m ɑ̃
lancent	l ɑ̃ s
lancer	l ɑ̃ s e
lancera	l ɑ̃ s ʁ a
lanceur	l ɑ̃ s œ ʁ
lancé	l ɑ̃ s e
landau	l ɑ̃ d o
landes	l ɑ̃ d
langage	l ɑ̃ ɡ a ʒ
lange	l ɑ̃ ʒ
langue	l ɑ̃ ɡ
lanterne	l ɑ̃ t ɛ ʁ n
lançait	l ɑ̃ s ɛ
lançons	l ɑ̃ s ɔ̃
laocoon	l a o k o ɔ̃
lapin	l a p ɛ̃
laps	l a p s y s
lapsus	l a p s y
laquelle	l a k ɛ l
large	l a ʁ ʒ
larges	l a ʁ ʒ
largeur	l a ʁ ʒ œ ʁ
larme	l a ʁ m
larmes	l a ʁ m
laser	l a z ɛ ʁ
latif	l a t i f
latin	l a t ɛ̃
latine	l a t i n
latitude	l a t i t y d
laurait	l o ʁ ɛ
laurence	l o ʁ ɑ̃ s
laurentienne	l ɔ ʁ ɑ̃ s j ɛ n
lauréat	l o ʁ e a
lausanne	l o z a n
laval	l a v a l
lave	l a v
laver	l a v e
lavoir	l a v w a ʁ
laxisme	l a k s i s m
laïc	l a i k
leader	l i d œ ʁ
lebel	l ə b ɛ l
leclerc	l ə k l ɛ ʁ
lecteur	l ɛ k t œ ʁ
lecture	l ɛ k t y ʁ
ledit	l ə d i
legrand	l ə ɡ ʁ ɑ̃
leitmotiv	l a j t m ɔ t i f
lens	l ɑ̃ s
lensois	l ɑ̃ s w a
lent	l ɑ̃
lentement	l ɑ̃ t m ɑ̃
les	l e
lesbienne	l ɛ s b j ɛ n
leslie	l ɛ s l i
lesquelles	l e k ɛ l
lesquels	l e k ɛ l
lest	l ɛ s t
lettre	l ɛ t ʁ
lettres	l ɛ t ʁ
leur	l œ ʁ
leurs	l œ ʁ
levant	l ə v ɑ̃
lever	l ə v e
levier	l ə v j e
levé	l ə v e
levée	l ə v e
leçon	l ə s ɔ̃
li	l i
liaison	l j ɛ z ɔ̃
liban	l i b ɑ̃
libanais	l i b a n ɛ
liberté	l i b ɛ ʁ t e
libidinale	l i b i d i n a l
libre	l i b ʁ
libye	l i b i
libyen	l i b j ɛ̃
libéral	l i b e ʁ a l
libération	l i b e ʁ a s j ɔ̃
libérer	l i b e ʁ e
libéria	l i b e ʁ j a
libéro	l i b e ʁ o
lice	l i s
licence	l i s ɑ̃ s
licences	l i s ɑ̃ s
licenciement	l i s ɑ̃ s i m ɑ̃
lien	l j ɛ̃
liens	l j ɛ̃
liesse	l j ɛ s
lieu	l j ø
lieutenant	l j ø t n ɑ̃
lieux	l j ø
ligne	l i ɲ
ligue	l i ɡ
lilian	l i l j ɑ̃
liliane	l i l j a n
lillois	l i l w a
lilloise	l i l w a z
limbourgeois	l ɛ̃ b u ʁ ʒ w a
lime	l i m
limitation	l i m i t a s j ɔ̃
limite	l i m i t
limiter	l i m i t e
limites	l i m i t
limoges	l i m ɔ ʒ
limogé	l i m ɔ ʒ e
limpide	l ɛ̃ p i d
lin	l ɛ̃
linguistiques	l ɛ̃ ɡ ɥ i s t i k
lion	l j ɔ̃
lionel	l j ɔ n ɛ l
liquidation	l i k i d a s j ɔ̃
lire	l i ʁ
lisbonne	l i z b ɔ n
lisibilité	l i z i b i l i t e
lisible	l i z i b l
lit	l i
lithium	l i t j ɔ m
litiges	l i t i ʒ
litote	l i t ɔ t
litre	l i t ʁ
littéraire	l i t e ʁ ɛ ʁ
littérature	l i t e ʁ a t y ʁ
lituanie	l i t ɥ a n i
livraison	l i v ʁ ɛ z ɔ̃
livre	l i v ʁ
livrer	l i v ʁ e
livres	l i v ʁ
livrée	l i v ʁ e
lièvre	l j ɛ v ʁ
liégeois	l j e ʒ w a
lloris	j ɔ ʁ i s
lnh	ɛ l ɛ n a ʃ
lob	l ɔ b
lobber	l ɔ b e
lobby	l ɔ b i
lobbying	l ɔ b i i ŋ
local	l ɔ k a l
locale	l ɔ k a l
localement	l ɔ k a l m ɑ̃
localisation	l ɔ k a l i z a s j ɔ̃
localité	l ɔ k a l i t e
location	l ɔ k a s j ɔ̃
logement	l ɔ ʒ m ɑ̃
logiciel	l ɔ ʒ i s j ɛ l
logique	l ɔ ʒ i k
logistique	l ɔ ʒ i s t i k
logistiquement	l ɔ ʒ i s t i k m ɑ̃
logo	l ɔ ɡ o
logue	l ɔ ɡ
loguâmes	l ɔ ɡ ɑ m
loi	l w a
loin	l w ɛ̃
loir	l w a ʁ
loisir	l w a z i ʁ
loisirs	l w a z i ʁ
lolement	l ɔ l m ɑ̃
londonien	l ɔ̃ d ɔ n j ɛ̃
londonienne	l ɔ̃ d ɔ n j ɛ n
londres	l ɔ̃ d ʁ
long	l ɔ̃
longuement	l ɔ̃ ɡ m ɑ̃
longueuil	l ɔ̃ ɡ œ j
longévité	l ɔ̃ ʒ e v i t e
look	l u k
lorient	l ɔ ʁ j ɑ̃
lorraine	l ɔ ʁ ɛ n
lors	l ɔ ʁ
lorsque	l ɔ ʁ s k
los	l o
losange	l o z ɑ̃ ʒ
lots	l o
lou	l u
loue	l u
louer	l w e
loueur	l w œ ʁ
louise	l w i z
louisiane	l w i z j a n
loup	l u
loupe	l u p
lourd	l u ʁ
lourdement	l u ʁ d ə m ɑ̃
lourds	l u ʁ
loyal	l w a j a l
loyauté	l w a j o t e
loyer	l w a j e
lozère	l ɔ z ɛ ʁ
loïc	l ɔ i k
lu	l y
lucarne	l y k a ʁ n
lucas	l y k ɑ
lucide	l y s i d
lucie	l y s i
lucien	l y s j ɛ̃
lucrèce	l y k ʁ ɛ s
ludovic	l y d ɔ v i k
lueur	l ɥ œ ʁ
luge	l y ʒ
luis	l ɥ i
lumineux	l y m i n ø
lumière	l y m j ɛ ʁ
lumières	l y m j ɛ ʁ
lump	l œ̃ p
lundi	l œ̃ d i
lune	l y n
lunettes	l y n ɛ t
lus	l y
lutte	l y t
lutter	l y t e
luxe	l y k s
luxembourgeois	l y k s ɑ̃ b u ʁ ʒ w a
luxes	l y k s
lycées	l i s e
lydia	l i d j a
lydie	l i d i
lyonnaise	l j ɔ n ɛ z
lys	l i s
lâche	l ɑ ʃ
lâcher	l ɑ ʃ e
lâcheté	l ɑ ʃ t e
lève	l ɛ v
lèvre	l ɛ v ʁ
léa	l e a
légal	l e ɡ a l
légendaire	l e ʒ ɑ̃ d ɛ ʁ
légendaires	l e ʒ ɑ̃ d ɛ ʁ
légende	l e ʒ ɑ̃ d
législatif	l e ʒ i s l a t i f
législation	l e ʒ i s l a s j ɔ̃
législatives	l e ʒ i s l a t i v
légitime	l e ʒ i t i m
légitimité	l e ʒ i t i m i t e
légume	l e ɡ y m
légère	l e ʒ ɛ ʁ
légèrement	l e ʒ ɛ ʁ m ɑ̃
légèreté	l e ʒ ɛ ʁ t e
léon	l e ɔ̃
léopold	l e ɔ p ɔ l d
lépreux	l e p ʁ ø
lésine	l e z i n
lésiner	l e z i n e
lévesque	l e v ɛ k
ma	m a
mac	m a k
macabre	m a k a b ʁ
macaroni	m a k a ʁ ɔ n i
machette	m a ʃ ɛ t
madame	m a d a m
madrid	m a d ʁ i d
madrigal	m a d ʁ i ɡ a l
magasin	m a ɡ a z ɛ̃
magazine	m a ɡ a z i n
maghrébin	m a ɡ ʁ e b ɛ̃
magie	m a ʒ i
magique	m a ʒ i k
magistrat	m a ʒ i s t ʁ a
magistrats	m a ʒ i s t ʁ a
magistrature	m a ʒ i s t ʁ a t y ʁ
magnifique	m a ɲ i f i k
magnifiquement	m a ɲ i f i k m ɑ̃
magnifiques	m a ɲ i f i k
magnétique	m a ɲ e t i k
magnétophone	m a ɲ e t ɔ f ɔ n
magnétoscope	m a ɲ e t ɔ s k ɔ p
mahomet	m a ɔ m ɛ
maigre	m ɛ ɡ ʁ
maillot	m a j o
main	m ɛ̃
mains	m ɛ̃
maintenance	m ɛ̃ t n ɑ̃ s
maintenant	m ɛ̃ t n ɑ̃
maintenir	m ɛ̃ t n i ʁ
maintes	m ɛ̃ t
maintien	m ɛ̃ t j ɛ̃
maire	m ɛ ʁ
maires	m ɛ ʁ
maison	m ɛ z ɔ̃
maisons	m ɛ z ɔ̃
majestueuse	m a ʒ ɛ s t ɥ ø z
majestueux	m a ʒ ɛ s t ɥ ø
majeur	m a ʒ œ ʁ
major	m a ʒ ɔ ʁ
majordome	m a ʒ ɔ ʁ d ɔ m
majoritaire	m a ʒ ɔ ʁ i t ɛ ʁ
majorité	m a ʒ ɔ ʁ i t e
majorque	m a ʒ ɔ ʁ k
mal	m a l
maladie	m a l a d i
maladif	m a l a d i f
maladresse	m a l a d ʁ ɛ s
maladroite	m a l a d ʁ w a t
maladroitement	m a l a d ʁ w a t m ɑ̃
malaise	m a l ɛ z
malaisien	m a l ɛ z j ɛ̃
malaria	m a l a ʁ j a
malchance	m a l ʃ ɑ̃ s
malentendants	m a l ɑ̃ t ɑ̃ d ɑ̃
malentendus	m a l ɑ̃ t ɑ̃ d y
malheur	m a l œ ʁ
malheureux	m a l œ ʁ ø
malhonnête	m a l ɔ n ɛ t
mali	m a l i
malice	m a l i s
malin	m a l ɛ̃
malle	m a l
malsain	m a l s ɛ̃
maltais	m a l t ɛ
malte	m a l t
maman	m a m ɑ̃
mammouth	m a m u t
manageur	m a n a ʒ œ ʁ
manche	m ɑ̃ ʃ
mandat	m ɑ̃ d a
mandé	m ɑ̃ d e
mangas	m ɑ̃ ɡ a
mangeait	m ɑ̃ ʒ ɛ
manger	m ɑ̃ ʒ e
mangrove	m ɑ̃ ɡ ʁ ɔ v
mangé	m ɑ̃ ʒ e
manicou	m a n i k u
manie	m a n i
manifestation	m a n i f ɛ s t a s j ɔ̃
manifeste	m a n i f ɛ s t
manifestement	m a n i f ɛ s t ə m ɑ̃
manifester	m a n i f ɛ s t e
manitoba	m a n i t ɔ b a
manière	m a n j ɛ ʁ
manne	m a n
mannequin	m a n k ɛ̃
manoir	m a n w a ʁ
manon	m a n ɔ̃
mansuétude	m ɑ̃ s ɥ e t y d
manteau	m ɑ̃ t o
manuel	m a n ɥ ɛ l
manutention	m a n y t ɑ̃ s j ɔ̃
manège	m a n ɛ ʒ
maquette	m a k ɛ t
maquignon	m a k i ɲ ɔ̃
maquis	m a k i
marais	m a ʁ ɛ
marathon	m a ʁ a t ɔ̃
marbre	m a ʁ b ʁ
marbrâmes	m a ʁ b ʁ ɑ m
marcel	m a ʁ s ɛ l
marchande	m a ʁ ʃ ɑ̃ d
marchandise	m a ʁ ʃ ɑ̃ d i z
marcher	m a ʁ ʃ e
marché	m a ʁ ʃ e
marge	m a ʁ ʒ
margeriez	m a ʁ ʒ ə ʁ j e
marginal	m a ʁ ʒ i n a l
marguerite	m a ʁ ɡ ə ʁ i t
mari	m a ʁ i
maria	m a ʁ j a
mariages	m a ʁ j a ʒ
marianne	m a ʁ j a n
marie	m a ʁ i
marier	m a ʁ j e
mariette	m a ʁ j ɛ t
marin	m a ʁ ɛ̃
marina	m a ʁ i n a
marine	m a ʁ i n
marins	m a ʁ ɛ̃
marion	m a ʁ j ɔ̃
marionnette	m a ʁ j ɔ n ɛ t
maritime	m a ʁ i t i m
marius	m a ʁ j y s
marié	m a ʁ j e
mariée	m a ʁ j e
mariées	m a ʁ j e
marjolaine	m a ʁ ʒ ɔ l ɛ n
mark	m a ʁ k
marmite	m a ʁ m i t
marmotte	m a ʁ m ɔ t
maroc	m a ʁ ɔ k
marocain	m a ʁ ɔ k ɛ̃
marquage	m a ʁ k a ʒ
marque	m a ʁ k
marquer	m a ʁ k e
marrant	m a ʁ ɑ̃
marron	m a ʁ ɔ̃
mars	m a ʁ s
marseillaise	m a ʁ s ɛ j ɛ z
marseille	m a ʁ s ɛ j
marteau	m a ʁ t o
martial	m a ʁ s j a l
martin	m a ʁ t ɛ̃
martine	m a ʁ t i n
martiniquais	m a ʁ t i n i k ɛ
martinique	m a ʁ t i n i k
martyre	m a ʁ t i ʁ
maréchal	m a ʁ e ʃ a l
marée	m a ʁ e
mascarade	m a s k a ʁ a d
masculin	m a s k y l ɛ̃
masculine	m a s k y l i n
massacre	m a s a k ʁ
massacres	m a s a k ʁ
massage	m a s a ʒ
massif	m a s i f
massivement	m a s i v m ɑ̃
massue	m a s y
match	m a t ʃ
matelots	m a t l o
mater	m a t e
mathieu	m a t j ø
mathis	m a t i s
maths	m a t
mathématique	m a t e m a t i k
mathématiques	m a t e m a t i k
mathématiserions	m a t e m a t i z ə ʁ j ɔ̃
mathématiseront	m a t e m a t i z ʁ ɔ̃
matin	m a t ɛ̃
matinée	m a t i n e
matière	m a t j ɛ ʁ
matthias	m a t j a s
matthieu	m a t j ø
maturation	m a t y ʁ a s j ɔ̃
matériau	m a t e ʁ j o
matériel	m a t e ʁ j ɛ l
maudit	m o d i
maurice	m o ʁ i s
mauritanie	m o ʁ i t a n i
mauvaise	m o v ɛ z
mauvaises	m o v ɛ z
maux	m o
max	m a k s
maxi	m a k s i
maxime	m a k s i m
maximum	m a k s i m ɔ m
maçonnerie	m a s ɔ n ʁ i
maîtres	m ɛ t ʁ
maîtresses	m ɛ t ʁ ɛ s
maîtrise	m ɛ t ʁ i z
maîtriser	m ɛ t ʁ i z e
maïs	m a i s
maïté	m a i t e
mec	m ɛ k
meeting	m i t i ŋ
meilleur	m ɛ j œ ʁ
meilleure	m ɛ j œ ʁ
meilleures	m ɛ j œ ʁ
meilleurs	m ɛ j œ ʁ
melon	m ə l ɔ̃
membre	m ɑ̃ b ʁ
menace	m ə n a s
mener	m ə n e
meneur	m ə n œ ʁ
mens	m ɑ̃
mensonge	m ɑ̃ s ɔ̃ ʒ
mensonger	m ɑ̃ s ɔ̃ ʒ e
mental	m ɑ̃ t a l
menthe	m ɑ̃ t
mentionner	m ɑ̃ s j ɔ n e
mentir	m ɑ̃ t i ʁ
menton	m ɑ̃ t ɔ̃
menu	m ə n y
menuiserie	m ə n ɥ i z ʁ i
mer	m ɛ ʁ
merci	m ɛ ʁ s i
mercier	m ɛ ʁ s j e
mercis	m ɛ ʁ s i
mercure	m ɛ ʁ k y ʁ
merde	m ɛ ʁ d
merlan	m ɛ ʁ l ɑ̃
merveille	m ɛ ʁ v ɛ j
merveilleusement	m ɛ ʁ v ɛ j ø z m ɑ̃
mes	m e
mesdames	m e d a m
messe	m ɛ s
messieurs	m e s j ø
mestre	m ɛ s t ʁ
mesure	m ə z y ʁ
mesurer	m ə z y ʁ e
mets	m ɛ
mettent	m ɛ t
metteurs	m ɛ t œ ʁ
mettre	m ɛ t ʁ
meuble	m œ b l
meubler	m œ b l e
meuleraient	m ø l ʁ ɛ
meurs	m œ ʁ
meurtris	m œ ʁ t ʁ i
meurtrière	m œ ʁ t ʁ i j ɛ ʁ
mexicain	m ɛ k s i k ɛ̃
mexico	m ɛ k s i k o
mexique	m ɛ k s i k
mi	m i
miami	m i j a m i
michaël	m i k a ɛ l
miche	m i ʃ
michel	m i ʃ ɛ l
michelin	m i ʃ l ɛ̃
micheline	m i ʃ l i n
michelle	m i ʃ ɛ l
michigan	m i ʃ i ɡ ɑ̃
michèle	m i ʃ ɛ l
mickaël	m i k a ɛ l
microfinance	m i k ʁ ɔ f i n ɑ̃ s
midi	m i d i
mielleux	m j e l ø
mieux	m j ø
mignon	m i ɲ ɔ̃
mika	m i k a
mike	m a j k
milan	m i l ɑ̃
milice	m i l i s
milieu	m i l j ø
militaire	m i l i t ɛ ʁ
militant	m i l i t ɑ̃
mille	m i l
miller	m i l œ ʁ
milliard	m i l j a ʁ
millier	m i l j e
millénaire	m i l e n ɛ ʁ
milo	m i l o
mina	m i n a
minable	m i n a b l
mine	m i n
mineras	m i n ʁ ɑ
mines	m i n
mineur	m i n œ ʁ
miniature	m i n j a t y ʁ
minimiser	m i n i m i z e
minimum	m i n i m ɔ m
ministre	m i n i s t ʁ
ministère	m i n i s t ɛ ʁ
ministériel	m i n i s t e ʁ j ɛ l
minorer	m i n ɔ ʁ e
minorité	m i n ɔ ʁ i t e
minsk	m ɛ̃ s k
minuit	m i n ɥ i
minuscule	m i n y s k y l
miné	m i n e
mirabeau	m i ʁ a b o
miracle	m i ʁ a k l
miraculeusement	m i ʁ a k y l ø z m ɑ̃
mirage	m i ʁ a ʒ
mire	m i ʁ
misaient	m i z ɛ
misant	m i z ɑ̃
mise	m i z
misent	m i z
miserions	m i z ə ʁ j ɔ̃
mission	m i s j ɔ̃
missionnaires	m i s j ɔ n ɛ ʁ
missions	m i s j ɔ̃
mistral	m i s t ʁ a l
misère	m i z ɛ ʁ
misé	m i z e
mit	m i
mitasses	m i t a s
miteux	m i t ø
mitigé	m i t i ʒ e
mix	m i k s
mob	m ɔ b
mobile	m ɔ b i l
mobilisation	m ɔ b i l i z a s j ɔ̃
mobylette	m ɔ b i l ɛ t
mode	m ɔ d
modem	m ɔ d ɛ m
moderne	m ɔ d ɛ ʁ n
modernes	m ɔ d ɛ ʁ n
modeste	m ɔ d ɛ s t
modestie	m ɔ d ɛ s t i
modification	m ɔ d i f i k a s j ɔ̃
modulaire	m ɔ d y l ɛ ʁ
module	m ɔ d y l
moduler	m ɔ d y l e
modèle	m ɔ d ɛ l
modèles	m ɔ d ɛ l
modérer	m ɔ d e ʁ e
modéré	m ɔ d e ʁ e
moindre	m w ɛ̃ d ʁ
moine	m w a n
moisson	m w a s ɔ̃
moite	m w a t
moitié	m w a t j e
mollet	m ɔ l ɛ
mollo	m ɔ l o
molécules	m ɔ l e k y l
moment	m ɔ m ɑ̃
mon	m ɔ̃
monarchie	m ɔ n a ʁ ʃ i
monde	m ɔ̃ d
mondialisation	m ɔ̃ d j a l i z a s j ɔ̃
mongolie	m ɔ̃ ɡ ɔ l i
mono	m ɔ n o
mons	m ɔ̃ s
monstre	m ɔ̃ s t ʁ
monstrueux	m ɔ̃ s t ʁ y ø
mont	m ɔ̃
montagne	m ɔ̃ t a ɲ
montagneux	m ɔ̃ t a ɲ ø
montant	m ɔ̃ t ɑ̃
monte	m ɔ̃ t
monter	m ɔ̃ t e
montgolfière	m ɔ̃ ɡ ɔ l f j ɛ ʁ
montréalais	m ɔ̃ ʁ e a l ɛ
montréalaises	m ɔ̃ ʁ e a l ɛ z
monté	m ɔ̃ t e
monument	m ɔ n y m ɑ̃
monégasques	m ɔ n e ɡ a s k
moquer	m ɔ k e
moqueur	m ɔ k œ ʁ
morale	m ɔ ʁ a l
moralement	m ɔ ʁ a l m ɑ̃
moratoire	m ɔ ʁ a t w a ʁ
morbihan	m ɔ ʁ b i ɑ̃
morceau	m ɔ ʁ s o
morgue	m ɔ ʁ ɡ
morose	m ɔ ʁ o z
morphine	m ɔ ʁ f i n
morphologies	m ɔ ʁ f ɔ l ɔ ʒ i
mort	m ɔ ʁ
mortel	m ɔ ʁ t ɛ l
mortier	m ɔ ʁ t j e
mosaïque	m o z a i k
moscou	m ɔ s k u
moscovite	m ɔ s k ɔ v i t
moselle	m ɔ z ɛ l
mosquée	m ɔ s k e
motif	m ɔ t i f
motion	m ɔ s j ɔ̃
motocyclette	m ɔ t ɔ s i k l ɛ t
mots	m o
mou	m u
mouais	m w ɛ
mouche	m u ʃ
mourad	m u ʁ a d
moussa	m u s a
mousser	m u s e
mousseux	m u s ø
mousson	m u s ɔ̃
moustaches	m u s t a ʃ
mouton	m u t ɔ̃
mouvement	m u v m ɑ̃
moyen	m w a j ɛ̃
moïse	m ɔ i z
muette	m ɥ ɛ t
multijoueur	m y l t i ʒ w œ ʁ
multimédia	m y l t i m e d j a
muni	m y n i
munich	m y n i k
municipalité	m y n i s i p a l i t e
munir	m y n i ʁ
munis	m y n i
munitions	m y n i s j ɔ̃
mur	m y ʁ
mure	m y ʁ
muriel	m y ʁ j ɛ l
murmurer	m y ʁ m y ʁ e
muscat	m y s k a
muscler	m y s k l e
musclé	m y s k l e
musclée	m y s k l e
musclés	m y s k l e
musicien	m y z i s j ɛ̃
musée	m y z e
musées	m y z e
mutation	m y t a s j ɔ̃
mutuel	m y t ɥ ɛ l
mylène	m i l ɛ n
myriam	m i ʁ j a m
myrtille	m i ʁ t i j
mystère	m i s t ɛ ʁ
mystérieuse	m i s t e ʁ j ø z
mystérieux	m i s t e ʁ j ø
mythique	m i t i k
mèche	m ɛ ʃ
mène	m ɛ n
mère	m ɛ ʁ
mètre	m ɛ t ʁ
mètres	m ɛ t ʁ
mécanicien	m e k a n i s j ɛ̃
méconnaissance	m e k ɔ n ɛ s ɑ̃ s
mécontent	m e k ɔ̃ t ɑ̃
médaille	m e d a j
médecine	m e d s i n
médiale	m e d j a l
médiateur	m e d j a t œ ʁ
médical	m e d i k a l
médicament	m e d i k a m ɑ̃
médicaments	m e d i k a m ɑ̃
médicaux	m e d i k o
médiocre	m e d j ɔ k ʁ
méditer	m e d i t e
méfiance	m e f j ɑ̃ s
méfier	m e f j e
mégalitre	m e ɡ a l i t ʁ
mégalux	m e ɡ a l y k s
mégavolt	m e ɡ a v ɔ l t
mégot	m e ɡ o
mélancolie	m e l ɑ̃ k ɔ l i
mélancolique	m e l ɑ̃ k ɔ l i k
mélanie	m e l a n i
mélissa	m e l i s a
mémoire	m e m w a ʁ
ménage	m e n a ʒ
ménager	m e n a ʒ e
ménagères	m e n a ʒ ɛ ʁ
méningite	m e n ɛ̃ ʒ i t
mépris	m e p ʁ i
mérite	m e ʁ i t
mériter	m e ʁ i t e
mésange	m e z ɑ̃ ʒ
métabolisme	m e t a b ɔ l i z m
métairie	m e t ɛ ʁ i
métal	m e t a l
métallique	m e t a l i k
métallurgie	m e t a l y ʁ ʒ i
métamorphose	m e t a m ɔ ʁ f o z
métaphorique	m e t a f ɔ ʁ i k
métaux	m e t o
méthane	m e t a n
méthanisation	m e t a n i z a s j ɔ̃
méthode	m e t ɔ d
méthodologie	m e t ɔ d ɔ l ɔ ʒ i
métier	m e t j e
métrage	m e t ʁ a ʒ
métrages	m e t ʁ a ʒ
même	m ɛ m
mûrier	m y ʁ j e
nacelle	n a s ɛ l
nage	n a ʒ
naissance	n ɛ s ɑ̃ s
naissances	n ɛ s ɑ̃ s
naissent	n ɛ s
namibie	n a m i b i
nancy	n ɑ̃ s i
nanterre	n ɑ̃ t ɛ ʁ
nantes	n ɑ̃ t
napoléon	n a p ɔ l e ɔ̃
nappe	n a p
narguilé	n a ʁ ɡ i l e
narquois	n a ʁ k w a
nasdaq	n a s d a k
natacha	n a t a ʃ a
natale	n a t a l
nathalie	n a t a l i
natif	n a t i f
nation	n a s j ɔ̃
national	n a s j ɔ n a l
nationale	n a s j ɔ n a l
nationalisme	n a s j ɔ n a l i s m
nationalité	n a s j ɔ n a l i t e
nationalités	n a s j ɔ n a l i t e
native	n a t i v
nature	n a t y ʁ
naturel	n a t y ʁ ɛ l
naturellement	n a t y ʁ ɛ l m ɑ̃
naufrage	n o f ʁ a ʒ
naufragés	n o f ʁ a ʒ e
navarre	n a v a ʁ
navette	n a v ɛ t
navigation	n a v i ɡ a s j ɔ̃
naviguer	n a v i ɡ e
navire	n a v i ʁ
nazifierait	n a z i f i ʁ ɛ
nazisme	n a z i s m
naître	n ɛ t ʁ
naïveté	n a i v t e
ne	n ə
neige	n ɛ ʒ
neptuneuse	n ɛ p t y n ø z
nerfs	n ɛ ʁ
nerveux	n ɛ ʁ v ø
nervosité	n ɛ ʁ v o z i t e
nettes	n ɛ t
nettoiement	n ɛ t w a m ɑ̃
nettoyer	n ɛ t w a j e
nettoyeur	n ɛ t w a j œ ʁ
neutre	n ø t ʁ
neuve	n œ v
neuvième	n œ v j ɛ m
nez	n e
ni	n i
niant	n j ɑ̃
nice	n i s
niche	n i ʃ
nickel	n i k ɛ l
nicodème	n i k ɔ d ɛ m
nicole	n i k ɔ l
nid	n i
nie	n i
niger	n i ʒ ɛ ʁ
nigeria	n i ʒ ɛ ʁ j a
nihilisme	n i i l i s m
nina	n i n a
niqab	n i k a b
niveau	n i v o
noble	n ɔ b l
nobles	n ɔ b l
noblesse	n ɔ b l ɛ s
noces	n ɔ s
noirci	n w a ʁ s i
noire	n w a ʁ
noires	n w a ʁ
noirs	n w a ʁ
noix	n w ɑ
nom	n ɔ̃
nomade	n ɔ m a d
nombre	n ɔ̃ b ʁ
nombreux	n ɔ̃ b ʁ ø
nominale	n ɔ m i n a l
nominer	n ɔ m i n e
non	n ɔ̃
nonchalance	n ɔ̃ ʃ a l ɑ̃ s
noria	n ɔ ʁ j a
normal	n ɔ ʁ m a l
normale	n ɔ ʁ m a l
normalement	n ɔ ʁ m a l m ɑ̃
normand	n ɔ ʁ m ɑ̃
normandie	n ɔ ʁ m ɑ̃ d i
norvège	n ɔ ʁ v ɛ ʒ
norvégien	n ɔ ʁ v e ʒ j ɛ̃
nos	n o
notable	n ɔ t a b l
notaire	n ɔ t ɛ ʁ
notamment	n ɔ t a m ɑ̃
notation	n ɔ t a s j ɔ̃
note	n ɔ t
noter	n ɔ t e
notera	n ɔ t ʁ a
notoire	n ɔ t w a ʁ
notre	n ɔ t ʁ
nouer	n w e
nougat	n u ɡ a
nouméa	n u m e a
nourrice	n u ʁ i s
nourrir	n u ʁ i ʁ
nourrisson	n u ʁ i s ɔ̃
nourriture	n u ʁ i t y ʁ
nourritures	n u ʁ i t y ʁ
nous	n u
nouveau	n u v o
nouveauté	n u v o t e
nouveaux	n u v o
nouvel	n u v ɛ l
nouvelle	n u v ɛ l
nouvelles	n u v ɛ l
novembre	n ɔ v ɑ̃ b ʁ
noyau	n w a j o
noël	n ɔ ɛ l
noëlle	n ɔ ɛ l
nu	n y
nuire	n ɥ i ʁ
nul	n y l
nulle	n y l
nullement	n y l m ɑ̃
nuls	n y l
numéraire	n y m e ʁ ɛ ʁ
numéro	n y m e ʁ o
nuremberg	n y ʁ ɛ̃ b ɛ ʁ
nus	n y
nutrition	n y t ʁ i s j ɔ̃
nymphes	n ɛ̃ f
né	n e
néanmoins	n e ɑ̃ m w ɛ̃
nébuleuse	n e b y l ø z
nébulisation	n e b y l i z a s j ɔ̃
nécessaire	n e s e s ɛ ʁ
nécessairement	n e s e s ɛ ʁ m ɑ̃
née	n e
nées	n e
néfaste	n e f a s t
négative	n e ɡ a t i v
négativement	n e ɡ a t i v m ɑ̃
négliger	n e ɡ l i ʒ e
négligée	n e ɡ l i ʒ e
négocier	n e ɡ ɔ s j e
néophyte	n e ɔ f i t
népal	n e p a l
nés	n e
nîmes	n i m
oasis	ɔ a z i s
objectif	ɔ b ʒ ɛ k t i f
objectifs	ɔ b ʒ ɛ k t i f
objectivité	ɔ b ʒ ɛ k t i v i t e
obligatoirement	ɔ b l i ɡ a t w a ʁ m ɑ̃
obligatoires	ɔ b l i ɡ a t w a ʁ
oblique	ɔ b l i k
obscur	ɔ p s k y ʁ
observateur	ɔ p s ɛ ʁ v a t œ ʁ
observation	ɔ p s ɛ ʁ v a s j ɔ̃
observer	ɔ p s ɛ ʁ v e
obsession	ɔ p s ɛ s j ɔ̃
obsolète	ɔ p s ɔ l ɛ t
obstacle	ɔ p s t a k l
obtempérer	ɔ p t ɑ̃ p e ʁ e
obtenir	ɔ p t ə n i ʁ
obéissant	ɔ b e i s ɑ̃
obésité	ɔ b e z i t e
occident	ɔ k s i d ɑ̃
occidental	ɔ k s i d ɑ̃ t a l
occidentales	ɔ k s i d ɑ̃ t a l
occidentaux	ɔ k s i d ɑ̃ t o
occupant	ɔ k y p ɑ̃
occupation	ɔ k y p a s j ɔ̃
occuper	ɔ k y p e
occupé	ɔ k y p e
occurrence	ɔ k y ʁ ɑ̃ s
och	ɔ ʃ
octogone	ɔ k t o ɡ o n
octroi	ɔ k t ʁ w a
oculaire	ɔ k y l ɛ ʁ
océan	ɔ s e ɑ̃
océanie	ɔ s e a n i
océanien	ɔ s e a n j ɛ̃
océans	ɔ s e ɑ̃
odette	ɔ d ɛ t
odeur	ɔ d œ ʁ
odieux	ɔ d j ø
offense	ɔ f ɑ̃ s
office	ɔ f i s
officier	ɔ f i s j e
officiers	ɔ f i s j e
offrande	ɔ f ʁ ɑ̃ d
offre	ɔ f ʁ
offres	ɔ f ʁ
offrir	ɔ f ʁ i ʁ
ogier	ɔ ʒ j e
oies	w a
oise	w a z
oiselet	w a z l ɛ
olive	ɔ l i v
olivia	ɔ l i v j a
olivier	ɔ l i v j e
oléoduc	ɔ l e ɔ d y k
ombre	ɔ̃ b ʁ
ombres	ɔ̃ b ʁ
omniprésente	ɔ m n i p ʁ e z ɑ̃ t
omniprésents	ɔ m n i p ʁ e z ɑ̃
omnium	ɔ m n j ɔ m
onagre	ɔ n a ɡ ʁ
once	ɔ̃ s
oncle	ɔ̃ k l
oncles	ɔ̃ k l
ondes	ɔ̃ d
ondoyant	ɔ̃ d w a j ɑ̃
ontario	ɔ̃ t a ʁ j o
onze	ɔ̃ z
open	ɔ p ɛ n
ophiure	ɔ f j y ʁ
ophélie	ɔ f e l i
opinion	ɔ p i n j ɔ̃
opium	ɔ p j ɔ m
opportun	ɔ p ɔ ʁ t œ̃
opportunité	ɔ p ɔ ʁ t y n i t e
opposition	ɔ p o z i s j ɔ̃
opter	ɔ p t e
optimisme	ɔ p t i m i z m
opération	ɔ p e ʁ a s j ɔ̃
oracle	ɔ ʁ a k l
oral	ɔ ʁ a l
orales	ɔ ʁ a l
orange	ɔ ʁ ɑ̃ ʒ
orateur	ɔ ʁ a t œ ʁ
orchestra	ɔ ʁ k ɛ s t ʁ a
orchestre	ɔ ʁ k ɛ s t ʁ
orchestrer	ɔ ʁ k ɛ s t ʁ e
ordinateur	ɔ ʁ d i n a t œ ʁ
ordonnance	ɔ ʁ d ɔ n ɑ̃ s
ordonnée	ɔ ʁ d ɔ n e
ordre	ɔ ʁ d ʁ
ordures	ɔ ʁ d y ʁ
oreille	ɔ ʁ ɛ j
ores	ɔ ʁ
organe	ɔ ʁ ɡ a n
organique	ɔ ʁ ɡ a n i k
organiques	ɔ ʁ ɡ a n i k
organiser	ɔ ʁ ɡ a n i z e
orge	ɔ ʁ ʒ
orgue	ɔ ʁ ɡ
orientale	ɔ ʁ j ɑ̃ t a l
orientation	ɔ ʁ j ɑ̃ t a s j ɔ̃
orienté	ɔ ʁ j ɑ̃ t e
originaires	ɔ ʁ i ʒ i n ɛ ʁ
original	ɔ ʁ i ʒ i n a l
originale	ɔ ʁ i ʒ i n a l
originales	ɔ ʁ i ʒ i n a l
origine	ɔ ʁ i ʒ i n
orléans	ɔ ʁ l e ɑ̃
orne	ɔ ʁ n
orphelin	ɔ ʁ f ə l ɛ̃
orsay	ɔ ʁ s ɛ
orteil	ɔ ʁ t ɛ j
orthodoxe	ɔ ʁ t ɔ d ɔ k s
orthodoxes	ɔ ʁ t ɔ d ɔ k s
orthodoxie	ɔ ʁ t o d ɔ k s i
osciller	ɔ s i l e
ose	o z
oser	o z e
ossature	ɔ s a t y ʁ
ossements	ɔ s m ɑ̃
ostendais	ɔ s t ɑ̃ d ɛ
ostende	ɔ s t ɑ̃ d
ostéopathe	ɔ s t e ɔ p a t
otage	ɔ t a ʒ
ottawa	ɔ t a w a
ottomane	ɔ t ɔ m a n
ouais	w ɛ
oublie	u b l i
oublier	u b l i j e
oublié	u b l i j e
ouch	u ʃ
oued	w ɛ d
ouellet	w ɛ l ɛ
ouganda	u ɡ ɑ̃ d a
ougandais	u ɡ ɑ̃ d ɛ
ougandaise	u ɡ ɑ̃ d ɛ z
oui	w i
ouragan	u ʁ a ɡ ɑ̃
ouragans	u ʁ a ɡ ɑ̃
outil	u t i
outiller	u t i j e
outre	u t ʁ
outremer	u t ʁ ə m e
ouvert	u v ɛ ʁ
ouverte	u v ɛ ʁ t
ouvertement	u v ɛ ʁ t ə m ɑ̃
ouvertes	u v ɛ ʁ t
ouverture	u v ɛ ʁ t y ʁ
ouvertures	u v ɛ ʁ t y ʁ
ouvrage	u v ʁ a ʒ
ouvre	u v ʁ
ouvrier	u v ʁ i j e
ouvrir	u v ʁ i ʁ
ovation	ɔ v a s j ɔ̃
ovni	ɔ v n i
paca	p a k a
pacifier	p a s i f j e
pacifique	p a s i f i k
pacifiques	p a s i f i k
pacte	p a k t
page	p a ʒ
paiement	p ɛ m ɑ̃
pain	p ɛ̃
pair	p ɛ ʁ
paire	p ɛ ʁ
paisible	p e z i b l
paisiblement	p e z i b l ə m ɑ̃
pakistan	p a k i s t ɑ̃
pakistanais	p a k i s t a n ɛ
pal	p a l
palace	p a l a s
palais	p a l ɛ
palan	p a l ɑ̃
palerme	p a l ɛ ʁ m
palestine	p a l ɛ s t i n
palier	p a l j e
palmarès	p a l m a ʁ ɛ s
palme	p a l m
palpable	p a l p a b l
palpitant	p a l p i t ɑ̃
pan	p ɑ̃
panel	p a n ɛ l
panier	p a n j e
panne	p a n
panneau	p a n o
panorama	p a n ɔ ʁ a m a
pans	p ɑ̃
panse	p ɑ̃ s
pantalon	p ɑ̃ t a l ɔ̃
panthère	p ɑ̃ t ɛ ʁ
papa	p a p a
pape	p a p
papetier	p a p ə t j e
papier	p a p j e
papillon	p a p i j ɔ̃
papy	p a p i
paquebot	p a k b o
paquet	p a k ɛ
parachever	p a ʁ a ʃ v e
paracétamol	p a ʁ a s e t a m ɔ l
paradigme	p a ʁ a d i ɡ m
paradis	p a ʁ a d i
paradoxes	p a ʁ a d ɔ k s
parages	p a ʁ a ʒ
paranoïa	p a ʁ a n ɔ j a
parapluies	p a ʁ a p l ɥ i
paraît	p a ʁ ɛ
paraître	p a ʁ ɛ t ʁ
parc	p a ʁ k
parce	p a ʁ s
parcelle	p a ʁ s ɛ l
parcourant	p a ʁ k u ʁ ɑ̃
parcourir	p a ʁ k u ʁ i ʁ
parcourront	p a ʁ k u ʁ ʁ ɔ̃
parcours	p a ʁ k u ʁ
parcourt	p a ʁ k u ʁ
parcouru	p a ʁ k u ʁ y
pardon	p a ʁ d ɔ̃
pardonner	p a ʁ d ɔ n e
parents	p a ʁ ɑ̃
paresseux	p a ʁ ɛ s ø
parfaire	p a ʁ f ɛ ʁ
parfait	p a ʁ f ɛ
parfaitement	p a ʁ f ɛ t m ɑ̃
parfois	p a ʁ f w a
pari	p a ʁ i
parier	p a ʁ j e
paris	p a ʁ i
parisien	p a ʁ i z j ɛ̃
parisienne	p a ʁ i z j ɛ n
parité	p a ʁ i t e
pariétales	p a ʁ j e t a l
parjurer	p a ʁ ʒ y ʁ e
parker	p a ʁ k e
parking	p a ʁ k i ŋ
parlait	p a ʁ l ɛ
parle	p a ʁ l
parlement	p a ʁ l ə m ɑ̃
parlementaire	p a ʁ l ə m ɑ̃ t ɛ ʁ
parlent	p a ʁ l
parler	p a ʁ l e
parlera	p a ʁ l ə ʁ a
parlerais	p a ʁ l ə ʁ ɛ
parlerait	p a ʁ l ə ʁ ɛ
parleront	p a ʁ l ə ʁ ɔ̃
parlez	p a ʁ l e
parlons	p a ʁ l ɔ̃
parlé	p a ʁ l e
parlée	p a ʁ l e
parmi	p a ʁ m i
paroisse	p a ʁ w a s
paroissiale	p a ʁ w a s j a l
paroxysme	p a ʁ ɔ k s i s m
parrain	p a ʁ ɛ̃
parrainage	p a ʁ ɛ n a ʒ
part	p a ʁ
partager	p a ʁ t a ʒ e
partagé	p a ʁ t a ʒ e
partant	p a ʁ t ɑ̃
partantes	p a ʁ t ɑ̃ t
partants	p a ʁ t ɑ̃
parte	p a ʁ t
partenaire	p a ʁ t ə n ɛ ʁ
partenariale	p a ʁ t ə n a ʁ j a l
parti	p a ʁ t i
participation	p a ʁ t i s i p a s j ɔ̃
participe	p a ʁ t i s i p
participer	p a ʁ t i s i p e
particulier	p a ʁ t i k y l j e
partie	p a ʁ t i
parties	p a ʁ t i
partir	p a ʁ t i ʁ
partira	p a ʁ t i ʁ a
partis	p a ʁ t i
partition	p a ʁ t i s j ɔ̃
paru	p a ʁ y
parvenir	p a ʁ v ə n i ʁ
parvenu	p a ʁ v ə n y
parvis	p a ʁ v i
paré	p a ʁ e
pascal	p a s k a l
pascale	p a s k a l
passablement	p ɑ s a b l ə m ɑ̃
passeport	p a s p ɔ ʁ
passerelle	p a s ʁ ɛ l
passes	p a s
passif	p a s i f
passionnant	p a s j ɔ n ɑ̃
passionnément	p a s j ɔ n e m ɑ̃
pasteur	p a s t œ ʁ
pastis	p a s t i s
pat	p a t
patatras	p a t a t ʁ a
patauger	p a t o ʒ e
patelin	p a t l ɛ̃
pathologie	p a t ɔ l ɔ ʒ i
patience	p a s j ɑ̃ s
patient	p a s j ɑ̃
patin	p a t ɛ̃
patinoire	p a t i n w a ʁ
patrice	p a t ʁ i s
patrick	p a t ʁ i k
patrie	p a t ʁ i
patrimoine	p a t ʁ i m w a n
patron	p a t ʁ ɔ̃
patronne	p a t ʁ ɔ n
patte	p a t
pau	p o
paul	p ɔ l
paule	p o l
pauline	p o l i n
pause	p o z
payant	p ɛ j ɑ̃
payants	p ɛ j ɑ̃
paye	p ɛ j
paysage	p ɛ i z a ʒ
peau	p o
peaufiner	p o f i n e
pec	p ɛ k
peigne	p ɛ ɲ
peindre	p ɛ̃ d ʁ
peine	p ɛ n
peint	p ɛ̃
peintre	p ɛ̃ t ʁ
peinture	p ɛ̃ t y ʁ
peinturons	p ɛ̃ t y ʁ ɔ̃
peler	p ə l e
pelle	p ɛ l
pelleter	p ɛ l t e
pelleteuse	p ɛ l t ø z
peloton	p ə l ɔ t ɔ̃
pelouse	p ə l u z
pelé	p ə l e
penalty	p e n a l t i
pendant	p ɑ̃ d ɑ̃
pendu	p ɑ̃ d y
pendue	p ɑ̃ d y
penser	p ɑ̃ s e
pensez	p ɑ̃ s e
pension	p ɑ̃ s j ɔ̃
pensionnat	p ɑ̃ s j ɔ n a
pensé	p ɑ̃ s e
pensée	p ɑ̃ s e
pente	p ɑ̃ t
people	p i p ɔ l
perception	p ɛ ʁ s ɛ p s j ɔ̃
percer	p ɛ ʁ s e
percevoir	p ɛ ʁ s ə v w a ʁ
percute	p ɛ ʁ k y t
percuter	p ɛ ʁ k y t e
perde	p ɛ ʁ d
perdre	p ɛ ʁ d ʁ
perdu	p ɛ ʁ d y
perfectible	p ɛ ʁ f ɛ k t i b l
perfection	p ɛ ʁ f ɛ k s j ɔ̃
perle	p ɛ ʁ l
permanence	p ɛ ʁ m a n ɑ̃ s
permanences	p ɛ ʁ m a n ɑ̃ s
permettre	p ɛ ʁ m ɛ t ʁ
permien	p ɛ ʁ m j ɛ̃
permis	p ɛ ʁ m i
pernicieux	p ɛ ʁ n i s j ø
perpendiculaire	p ɛ ʁ p ɑ̃ d i k y l ɛ ʁ
perpétuité	p ɛ ʁ p e t ɥ i t e
perroquet	p ɛ ʁ ɔ k ɛ
persan	p ɛ ʁ s ɑ̃
perso	p ɛ ʁ s o
personnages	p ɛ ʁ s ɔ n a ʒ
personnaliser	p ɛ ʁ s ɔ n a l i z e
personnalité	p ɛ ʁ s ɔ n a l i t e
personne	p ɛ ʁ s ɔ n
personnel	p ɛ ʁ s ɔ n ɛ l
personnelle	p ɛ ʁ s ɔ n ɛ l
personnes	p ɛ ʁ s ɔ n
perspective	p ɛ ʁ s p ɛ k t i v
persécuta	p ɛ ʁ s e k y t a
perte	p ɛ ʁ t
pertinence	p ɛ ʁ t i n ɑ̃ s
pertinent	p ɛ ʁ t i n ɑ̃
pertinentes	p ɛ ʁ t i n ɑ̃ t
perturber	p ɛ ʁ t y ʁ b e
pervers	p ɛ ʁ v ɛ ʁ
perversion	p ɛ ʁ v ɛ ʁ s j ɔ̃
pesant	p ə z ɑ̃
pesante	p ə z ɑ̃ t
peser	p ə z e
pessimisme	p e s i m i z m
pessimiste	p e s i m i s t
petite	p ə t i t
petits	p ə t i
peu	p ø
peugeot	p ø ʒ o
peuple	p œ p l
peur	p œ ʁ
peurs	p œ ʁ
peut	p ø
peux	p ø
phalange	f a l ɑ̃ ʒ
pharaon	f a ʁ a ɔ̃
phare	f a ʁ
pharmacie	f a ʁ m a s i
phase	f a z
philadelphie	f i l a d ɛ l f i
philibert	f i l i b ɛ ʁ
philippe	f i l i p
philosophe	f i l ɔ z ɔ f
philémon	f i l e m ɔ̃
phone	f ɔ n
phonétique	f ɔ n e t i k
phoque	f ɔ k
photographie	f ɔ t ɔ ɡ ʁ a f i
phrase	f ʁ ɑ z
phylactère	f i l a k t ɛ ʁ
physique	f i z i k
pianiste	p j a n i s t
piano	p j a n o
pic	p i k
picardie	p i k a ʁ d i
pieds	p j e
pierre	p j ɛ ʁ
pierrick	p j ɛ ʁ i k
pieux	p j ø
pif	p i f
pigeon	p i ʒ ɔ̃
pigeonnier	p i ʒ ɔ n j e
pignon	p i ɲ ɔ̃
pilier	p i l j e
pillage	p i j a ʒ
pilori	p i l ɔ ʁ i
pilote	p i l ɔ t
piloter	p i l ɔ t e
pilule	p i l y l
pilules	p i l y l
piment	p i m ɑ̃
pinard	p i n a ʁ
pinera	p i n ʁ a
pioche	p j ɔ ʃ
pionnier	p j ɔ n j e
pipeline	p i p l i n
pique	p i k
piquer	p i k e
piqûre	p i k y ʁ
pirate	p i ʁ a t
pire	p i ʁ
pis	p i
piscine	p i s i n
pise	p i z
pisse	p i s
piste	p i s t
pistes	p i s t
pistolet	p i s t ɔ l ɛ
pitié	p i t j e
piton	p i t ɔ̃
pivoter	p i v ɔ t e
pizza	p i d z a
pièce	p j ɛ s
piège	p j ɛ ʒ
piètre	p j ɛ t ʁ
piétinent	p j e t i n
placard	p l a k a ʁ
place	p l a s
placent	p l a s
placer	p l a s e
placera	p l a s ʁ a
places	p l a s
placé	p l a s e
plafond	p l a f ɔ̃
plaindre	p l ɛ̃ d ʁ
plaine	p l ɛ n
plaire	p l ɛ ʁ
plaisanciers	p l ɛ z ɑ̃ s j e
plan	p l ɑ̃
planche	p l ɑ̃ ʃ
planification	p l a n i f i k a s j ɔ̃
planning	p l a n i ŋ
plans	p l ɑ̃
plante	p l ɑ̃ t
planter	p l ɑ̃ t e
planète	p l a n ɛ t
plaquage	p l a k a ʒ
plaque	p l a k
plasma	p l a s m a
plastique	p l a s t i k
plastiques	p l a s t i k
plat	p l a
plate	p l a t
plateau	p l a t o
playlist	p l ɛ l i s t
plaça	p l a s a
plaçant	p l a s ɑ̃
plaît	p l ɛ
plein	p l ɛ̃
pleurer	p l œ ʁ e
pleuvent	p l œ v
plier	p l i j e
plomb	p l ɔ̃
plongeon	p l ɔ̃ ʒ ɔ̃
plonger	p l ɔ̃ ʒ e
plongée	p l ɔ̃ ʒ e
plq	p e ɛ l k y
plu	p l y
plug	p l œ ɡ
pluie	p l ɥ i
plume	p l y m
plupart	p l y p a ʁ
plural	p l y ʁ a l
plusieurs	p l y z j œ ʁ
plutôt	p l y t o
plâtre	p l ɑ t ʁ
pme	p e ɛ m ø
pneu	p n ø
pneumatiques	p n ø m a t i k
poche	p ɔ ʃ
poches	p ɔ ʃ
pochette	p ɔ ʃ ɛ t
podium	p ɔ d j ɔ m
pognon	p ɔ ɲ ɔ̃
poignet	p w a ɲ ɛ
poignée	p w a ɲ e
poil	p w a l
poindre	p w ɛ̃ d ʁ
poing	p w ɛ̃
point	p w ɛ̃
pointait	p w ɛ̃ t ɛ
pointe	p w ɛ̃ t
pointent	p w ɛ̃ t
pointera	p w ɛ̃ t ʁ a
points	p w ɛ̃
pointure	p w ɛ̃ t y ʁ
pointé	p w ɛ̃ t e
poison	p w a z ɔ̃
poisson	p w a s ɔ̃
poissons	p w a s ɔ̃
poker	p ɔ k ɛ ʁ
policier	p ɔ l i s j e
polir	p ɔ l i ʁ
politique	p ɔ l i t i k
pollen	p ɔ l ɛ n
polluer	p ɔ l ɥ e
pollution	p ɔ l y s j ɔ̃
pologne	p ɔ l ɔ ɲ
polonais	p ɔ l ɔ n ɛ
polygamie	p ɔ l i ɡ a m i
polynésien	p ɔ l i n e z j ɛ̃
polytechnique	p ɔ l i t ɛ k n i k
polyvalent	p ɔ l i v a l ɑ̃
pomme	p ɔ m
pompage	p ɔ̃ p a ʒ
pompe	p ɔ̃ p
pompier	p ɔ̃ p j e
ponctuation	p ɔ̃ k t ɥ a s j ɔ̃
pont	p ɔ̃
pontife	p ɔ̃ t i f
pontificat	p ɔ̃ t i f i k a
ponts	p ɔ̃
population	p ɔ p y l a s j ɔ̃
poquerait	p ɔ k ʁ ɛ
porc	p ɔ ʁ
porche	p ɔ ʁ ʃ
porcheries	p ɔ ʁ ʃ ə ʁ i
pornographie	p ɔ ʁ n ɔ ɡ ʁ a f i
port	p ɔ ʁ
portaient	p ɔ ʁ t ɛ
portails	p ɔ ʁ t a j
portant	p ɔ ʁ t ɑ̃
portefeuille	p ɔ ʁ t ə f œ j
portera	p ɔ ʁ t ə ʁ a
porteur	p ɔ ʁ t œ ʁ
portrait	p ɔ ʁ t ʁ ɛ
portugais	p ɔ ʁ t y ɡ ɛ
portugal	p ɔ ʁ t y ɡ a l
portée	p ɔ ʁ t e
positif	p o z i t i f
position	p o z i s j ɔ̃
positive	p o z i t i v
possession	p ɔ s ɛ s j ɔ̃
possible	p ɔ s i b l
posséder	p ɔ s e d e
post	p ɔ s t
poste	p ɔ s t
postier	p ɔ s t j e
postillonnant	p ɔ s t i j ɔ n ɑ̃
postulant	p ɔ s t y l ɑ̃
postule	p ɔ s t y l
postulé	p ɔ s t y l e
potable	p ɔ t a b l
potentiel	p ɔ t ɑ̃ s j ɛ l
potentiels	p ɔ t ɑ̃ s j ɛ l
pouces	p u s
poudre	p u d ʁ
poulaga	p u l a ɡ a
poulain	p u l ɛ̃
poule	p u l
pouliot	p u l j o
poumon	p u m ɔ̃
poupe	p u p
poupée	p u p e
pourcentage	p u ʁ s ɑ̃ t a ʒ
pourquoi	p u ʁ k w a
pourra	p u ʁ a
pourrait	p u ʁ ɛ
poursuite	p u ʁ s ɥ i t
poursuivre	p u ʁ s ɥ i v ʁ
pourtant	p u ʁ t ɑ̃
pourvoi	p u ʁ v w a
pourvoir	p u ʁ v w a ʁ
pourvu	p u ʁ v y
pousser	p u s e
poussette	p u s ɛ t
pousseur	p u s œ ʁ
poussif	p u s i f
poussin	p u s ɛ̃
poutraient	p u t ʁ ɛ
pouvait	p u v ɛ
pouvez	p u v e
pouvons	p u v ɔ̃
poux	p u
poème	p ɔ ɛ m
poète	p ɔ ɛ t
poésie	p ɔ e z i
poétique	p ɔ e t i k
pq	p e k y
pragmatique	p ʁ a ɡ m a t i k
pragmatisme	p ʁ a ɡ m a t i s m
prague	p ʁ a ɡ
pratiquait	p ʁ a t i k ɛ
pratiquant	p ʁ a t i k ɑ̃
pratique	p ʁ a t i k
pratiquent	p ʁ a t i k
pratiquer	p ʁ a t i k e
pratiques	p ʁ a t i k
pratiqué	p ʁ a t i k e
pratiquée	p ʁ a t i k e
pratiquées	p ʁ a t i k e
pratiqués	p ʁ a t i k e
premier	p ʁ ə m j e
première	p ʁ ə m j ɛ ʁ
prenais	p ʁ ə n ɛ
prenait	p ʁ ə n ɛ
prend	p ʁ ɑ̃
prendra	p ʁ ɑ̃ d ʁ a
prendrait	p ʁ ɑ̃ d ʁ ɛ
prendre	p ʁ ɑ̃ d ʁ
prendrons	p ʁ ɑ̃ d ʁ ɔ̃
prenez	p ʁ ə n e
prenne	p ʁ ɛ n
prennent	p ʁ ɛ n
prenons	p ʁ ə n ɔ̃
presque	p ʁ ɛ s k
prestation	p ʁ ɛ s t a s j ɔ̃
prestement	p ʁ ɛ s t ə m ɑ̃
prestige	p ʁ ɛ s t i ʒ
preums	p ʁ œ m s
preuve	p ʁ œ v
prient	p ʁ i
prier	p ʁ i j e
primauté	p ʁ i m o t e
primitive	p ʁ i m i t i v
primordial	p ʁ i m ɔ ʁ d j a l
princesse	p ʁ ɛ̃ s ɛ s
principal	p ʁ ɛ̃ s i p a l
principalement	p ʁ ɛ̃ s i p a l m ɑ̃
principe	p ʁ ɛ̃ s i p
printemps	p ʁ ɛ̃ t ɑ̃
pris	p ʁ i
prise	p ʁ i z
priser	p ʁ i z e
prison	p ʁ i z ɔ̃
prisonnier	p ʁ i z ɔ n j e
privatises	p ʁ i v a t i z
privative	p ʁ i v a t i v
privilège	p ʁ i v i l ɛ ʒ
privilégié	p ʁ i v i l e ʒ j e
prière	p ʁ i j ɛ ʁ
pro	p ʁ o
probable	p ʁ ɔ b a b l
probablement	p ʁ ɔ b a b l ə m ɑ̃
problème	p ʁ ɔ b l ɛ m
problématique	p ʁ ɔ b l e m a t i k
processeur	p ʁ ɔ s ɛ s œ ʁ
prochaine	p ʁ ɔ ʃ ɛ n
prochainement	p ʁ ɔ ʃ ɛ n m ɑ̃
proche	p ʁ ɔ ʃ
proches	p ʁ ɔ ʃ
procuration	p ʁ ɔ k y ʁ a s j ɔ̃
procurer	p ʁ ɔ k y ʁ e
procès	p ʁ ɔ s ɛ
procéder	p ʁ ɔ s e d e
procédure	p ʁ ɔ s e d y ʁ
procédures	p ʁ ɔ s e d y ʁ
procédé	p ʁ ɔ s e d e
prodiguer	p ʁ ɔ d i ɡ e
producteurs	p ʁ ɔ d y k t œ ʁ
produire	p ʁ ɔ d ɥ i ʁ
produise	p ʁ ɔ d ɥ i z
produisent	p ʁ ɔ d ɥ i z
produit	p ʁ ɔ d ɥ i
prof	p ʁ ɔ f
professeras	p ʁ ɔ f ɛ s ʁ ɑ
professeure	p ʁ ɔ f ɛ s œ ʁ
profession	p ʁ ɔ f ɛ s j ɔ̃
professionnalisme	p ʁ ɔ f e s j ɔ n a l i s m
professions	p ʁ ɔ f ɛ s j ɔ̃
profil	p ʁ ɔ f i l
profile	p ʁ ɔ f i l
profilent	p ʁ ɔ f i l
profit	p ʁ ɔ f i
profiter	p ʁ ɔ f i t e
profits	p ʁ ɔ f i
profond	p ʁ ɔ f ɔ̃
profondeur	p ʁ ɔ f ɔ̃ d œ ʁ
profondément	p ʁ ɔ f ɔ̃ d e m ɑ̃
proférer	p ʁ ɔ f e ʁ e
programme	p ʁ ɔ ɡ ʁ a m
progresser	p ʁ ɔ ɡ ʁ ɛ s e
progression	p ʁ ɔ ɡ ʁ ɛ s j ɔ̃
progrès	p ʁ ɔ ɡ ʁ ɛ
proie	p ʁ w ɑ
projecteur	p ʁ ɔ ʒ ɛ k t œ ʁ
projet	p ʁ ɔ ʒ ɛ
projeter	p ʁ ɔ ʒ t e
prolifique	p ʁ ɔ l i f i k
prolo	p ʁ ɔ l o
prolongation	p ʁ ɔ l ɔ̃ ɡ a s j ɔ̃
prolonge	p ʁ ɔ l ɔ̃ ʒ
prolonger	p ʁ ɔ l ɔ̃ ʒ e
promener	p ʁ ɔ m n e
promeneur	p ʁ ɔ m n œ ʁ
promesse	p ʁ ɔ m ɛ s
promettre	p ʁ ɔ m ɛ t ʁ
promoteur	p ʁ ɔ m ɔ t œ ʁ
promotion	p ʁ ɔ m ɔ s j ɔ̃
promouvoir	p ʁ ɔ m u v w a ʁ
prononce	p ʁ ɔ n ɔ̃ s
prononcent	p ʁ ɔ n ɔ̃ s
prononcer	p ʁ ɔ n ɔ̃ s e
prononcera	p ʁ ɔ n ɔ̃ s ʁ a
prononcez	p ʁ ɔ n ɔ̃ s e
prononcé	p ʁ ɔ n ɔ̃ s e
propagande	p ʁ ɔ p a ɡ ɑ̃ d
propice	p ʁ ɔ p i s
proportionnel	p ʁ ɔ p ɔ ʁ s j ɔ n ɛ l
propos	p ʁ ɔ p o
proposer	p ʁ ɔ p o z e
proposition	p ʁ ɔ p o z i s j ɔ̃
propre	p ʁ ɔ p ʁ
proprement	p ʁ ɔ p ʁ ə m ɑ̃
propriétaire	p ʁ ɔ p ʁ i j e t ɛ ʁ
propriété	p ʁ ɔ p ʁ i j e t e
prose	p ʁ o z
prospecter	p ʁ ɔ s p ɛ k t e
prostituée	p ʁ ɔ s t i t ɥ e
prosélytisme	p ʁ o z e l i t i s m
protecteur	p ʁ ɔ t ɛ k t œ ʁ
protection	p ʁ ɔ t ɛ k s j ɔ̃
protestation	p ʁ ɔ t ɛ s t a s j ɔ̃
protocolaire	p ʁ ɔ t ɔ k ɔ l ɛ ʁ
protocole	p ʁ ɔ t ɔ k ɔ l
prototype	p ʁ ɔ t ɔ t i p
protège	p ʁ ɔ t ɛ ʒ
protègent	p ʁ ɔ t ɛ ʒ
protégeant	p ʁ ɔ t e ʒ ɑ̃
protéger	p ʁ ɔ t e ʒ e
protégé	p ʁ ɔ t e ʒ e
protégée	p ʁ ɔ t e ʒ e
protéine	p ʁ ɔ t e i n
prouver	p ʁ u v e
provenance	p ʁ ɔ v n ɑ̃ s
provence	p ʁ ɔ v ɑ̃ s
provençales	p ʁ ɔ v ɑ̃ s a l
providence	p ʁ ɔ v i d ɑ̃ s
proviendra	p ʁ ɔ v j ɛ̃ d ʁ a
proviendront	p ʁ ɔ v j ɛ̃ d ʁ ɔ̃
proviennent	p ʁ ɔ v j ɛ n
provient	p ʁ ɔ v j ɑ̃
province	p ʁ ɔ v ɛ̃ s
provincial	p ʁ ɔ v ɛ̃ s j a l
provinciale	p ʁ ɔ v ɛ̃ s j a l
provisoire	p ʁ ɔ v i z w a ʁ
provoquer	p ʁ ɔ v ɔ k e
prudemment	p ʁ y d a m ɑ̃
prudence	p ʁ y d ɑ̃ s
prudent	p ʁ y d ɑ̃
prudente	p ʁ y d ɑ̃ t
prudentes	p ʁ y d ɑ̃ t
près	p ʁ ɛ
pré	p ʁ e
précaire	p ʁ e k ɛ ʁ
précieux	p ʁ e s j ø
précipice	p ʁ e s i p i s
précipitamment	p ʁ e s i p i t a m ɑ̃
précipitation	p ʁ e s i p i t a s j ɔ̃
précipite	p ʁ e s i p i t
précipitent	p ʁ e s i p i t
précipiter	p ʁ e s i p i t e
précipité	p ʁ e s i p i t e
précis	p ʁ e s i
précisément	p ʁ e s i z e m ɑ̃
précoce	p ʁ e k ɔ s
précurseur	p ʁ e k y ʁ s œ ʁ
précédemment	p ʁ e s e d a m ɑ̃
précédent	p ʁ e s e d ɑ̃
prédateur	p ʁ e d a t œ ʁ
prédicateur	p ʁ e d i k a t œ ʁ
prédire	p ʁ e d i ʁ
préexistant	p ʁ e ɛ ɡ z i s t ɑ̃
préfecture	p ʁ e f ɛ k t y ʁ
préfet	p ʁ e f ɛ
préfère	p ʁ e f ɛ ʁ
préfèrent	p ʁ e f ɛ ʁ
préférer	p ʁ e f e ʁ e
préféré	p ʁ e f e ʁ e
préjudiciable	p ʁ e ʒ y d i s j a b l
prélat	p ʁ e l a
prémunir	p ʁ e m y n i ʁ
préoccupation	p ʁ e ɔ k y p a s j ɔ̃
préoccupations	p ʁ e ɔ k y p a s j ɔ̃
préoccuper	p ʁ e ɔ k y p e
préparatifs	p ʁ e p a ʁ a t i f
préparation	p ʁ e p a ʁ a s j ɔ̃
préparer	p ʁ e p a ʁ e
présence	p ʁ e z ɑ̃ s
présent	p ʁ e z ɑ̃
présentation	p ʁ e z ɑ̃ t a s j ɔ̃
présente	p ʁ e z ɑ̃ t
présentement	p ʁ e z ɑ̃ t m ɑ̃
présenter	p ʁ e z ɑ̃ t e
présentes	p ʁ e z ɑ̃ t
présents	p ʁ e z ɑ̃
présenté	p ʁ e z ɑ̃ t e
présentée	p ʁ e z ɑ̃ t e
présentées	p ʁ e z ɑ̃ t e
préservatif	p ʁ e z ɛ ʁ v a t i f
préservatifs	p ʁ e z ɛ ʁ v a t i f
présidence	p ʁ e z i d ɑ̃ s
présidents	p ʁ e z i d ɑ̃
présupposez	p ʁ e s y p o z e
prétendument	p ʁ e t ɑ̃ d y m ɑ̃
prétentieux	p ʁ e t ɑ̃ t j ø
prétention	p ʁ e t ɑ̃ s j ɔ̃
prétexte	p ʁ e t ɛ k s t
préventif	p ʁ e v ɑ̃ t i f
prévisible	p ʁ e v i z i b l
prévision	p ʁ e v i z j ɔ̃
prévisions	p ʁ e v i z j ɔ̃
prévoir	p ʁ e v w a ʁ
prévoyant	p ʁ e v w a j ɑ̃
prévu	p ʁ e v y
prêche	p ʁ ɛ ʃ
prêt	p ʁ ɛ
prêtre	p ʁ ɛ t ʁ
pseudo	p s ø d o
pseudonyme	p s ø d ɔ n i m
psychiatre	p s i k j a t ʁ
psychiatrie	p s i k j a t ʁ i
psychologie	p s i k ɔ l ɔ ʒ i
psychologues	p s i k ɔ l ɔ ɡ
pu	p y
pubalgie	p y b a l ʒ i
publicitaire	p y b l i s i t ɛ ʁ
publicité	p y b l i s i t e
publier	p y b l i j e
puce	p y s
puceau	p y s o
puces	p y s
pudeur	p y d œ ʁ
pugilat	p y ʒ i l a
puis	p ɥ i
puiser	p ɥ i z e
puisque	p ɥ i s k
puissamment	p ɥ i s a m ɑ̃
puissant	p ɥ i s ɑ̃
puits	p ɥ i
pulsion	p y l s j ɔ̃
pulvériser	p y l v e ʁ i z e
punch	p ɔ̃ ʃ
punition	p y n i s j ɔ̃
punk	p œ ŋ k
pur	p y ʁ
purger	p y ʁ ʒ e
pus	p y
put	p y
putain	p y t ɛ̃
pyjama	p i ʒ a m a
pyramide	p i ʁ a m i d
pyromane	p i ʁ ɔ m a n
pyrénées	p i ʁ e n e
python	p i t ɔ̃
pâteusement	p ɑ t ø z m ɑ̃
pâtisserie	p ɑ t i s ʁ i
pâturer	p a t y ʁ e
pèlerinage	p ɛ l ʁ i n a ʒ
pèse	p ɛ z
pédagogique	p e d a ɡ ɔ ʒ i k
pédagogiques	p e d a ɡ ɔ ʒ i k
pédale	p e d a l
pédophiles	p e d ɔ f i l
pédérastie	p e d e ʁ a s t i
pékin	p e k ɛ̃
pénalisante	p e n a l i z ɑ̃ t
pénalité	p e n a l i t e
pénibilité	p e n i b i l i t e
pénis	p e n i s
pénitencier	p e n i t ɑ̃ s j e
pénitentiaire	p e n i t ɑ̃ s j ɛ ʁ
pénétrer	p e n e t ʁ e
pépin	p e p ɛ̃
péquiste	p e k i s t
pérenne	p e ʁ ɛ n
périclès	p e ʁ i k l ɛ s
péril	p e ʁ i l
périlleux	p e ʁ i j ø
périodes	p e ʁ j ɔ d
périodiquement	p e ʁ j ɔ d i k m ɑ̃
périphérie	p e ʁ i f e ʁ i
péritoine	p e ʁ i t w a n
pérou	p e ʁ u
pétition	p e t i s j ɔ̃
pétrole	p e t ʁ ɔ l
pétrolier	p e t ʁ ɔ l j e
pêcheur	p ɛ ʃ œ ʁ
pôles	p o l
pût	p y
qu	k y
qualificatif	k a l i f i k a t i f
qualification	k a l i f i k a s j ɔ̃
qualifie	k a l i f i
qualifier	k a l i f j e
qualifié	k a l i f j e
qualité	k a l i t e
quantitatif	k ɑ̃ t i t a t i f
quantité	k ɑ̃ t i t e
quarante	k a ʁ ɑ̃ t
quark	k w a ʁ k
quart	k a ʁ
quartette	k w a ʁ t ɛ t
quartier	k a ʁ t j e
quasi	k a z i
quasiment	k a z i m ɑ̃
quatorzième	k a t ɔ ʁ z j ɛ m
quatrième	k a t ʁ i j ɛ m
quatuor	k w a t ɥ ɔ ʁ
que	k ə
quel	k ɛ l
quelconque	k ɛ l k ɔ̃ k
quels	k ɛ l
quentin	k ɑ̃ t ɛ̃
question	k ɛ s t j ɔ̃
questionnaire	k ɛ s t j ɔ n ɛ ʁ
questions	k ɛ s t j ɔ̃
queue	k ø
quick	k w i k
quincaillerie	k ɛ̃ k ɑ j ʁ i
quinzaine	k ɛ̃ z ɛ n
quinze	k ɛ̃ z
quinzième	k ɛ̃ z j ɛ m
quitte	k i t
quitter	k i t e
quoi	k w a
quoique	k w a k ə
quotidien	k ɔ t i d j ɛ̃
quotidiennement	k ɔ t i d j ɛ n m ɑ̃
québec	k e b ɛ k
québécois	k e b e k w a
rabais	ʁ a b ɛ
rabaisser	ʁ a b ɛ s e
rabat	ʁ a b a
rabattre	ʁ a b a t ʁ
rabbinat	ʁ a b i n a
rabbinats	ʁ a b i n a
rabot	ʁ a b o
raccord	ʁ a k ɔ ʁ
raccordé	ʁ a k ɔ ʁ d e
raccourci	ʁ a k u ʁ s i
raccourcir	ʁ a k u ʁ s i ʁ
raccourcit	ʁ a k u ʁ s i
race	ʁ a s
racheter	ʁ a ʃ t e
racket	ʁ a k ɛ t
raconter	ʁ a k ɔ̃ t e
racornît	ʁ a k ɔ ʁ n i
radar	ʁ a d a ʁ
radical	ʁ a d i k a l
radicaux	ʁ a d i k o
radio	ʁ a d j o
radios	ʁ a d j o
radis	ʁ a d i
radoucis	ʁ a d u s i
radoucît	ʁ a d u s i
rafale	ʁ a f a l
rafraîchir	ʁ a f ʁ ɛ ʃ i ʁ
rafraîchira	ʁ a f ʁ ɛ ʃ i ʁ a
rage	ʁ a ʒ
rai	ʁ ɛ
raid	ʁ ɛ d
rail	ʁ a j
railway	ʁ ɛ l w ɛ
rainer	ʁ e n e
raison	ʁ ɛ z ɔ̃
raisonnable	ʁ ɛ z ɔ n a b l
rajeuni	ʁ a ʒ œ n i
rajouter	ʁ a ʒ u t e
rallier	ʁ a l j e
ramdam	ʁ a m d a m
rame	ʁ a m
ramener	ʁ a m n e
ramer	ʁ a m e
randomiserai	ʁ ɑ̃ d ɔ m i z ʁ e
randonnée	ʁ ɑ̃ d ɔ n e
rang	ʁ ɑ̃
rangé	ʁ ɑ̃ ʒ e
rangée	ʁ ɑ̃ ʒ e
ranima	ʁ a n i m a
ranimait	ʁ a n i m ɛ
rançon	ʁ ɑ̃ s ɔ̃
rapatrier	ʁ a p a t ʁ i j e
raphaël	ʁ a f a ɛ l
rapide	ʁ a p i d
rapidement	ʁ a p i d m ɑ̃
rapidité	ʁ a p i d i t e
rappeler	ʁ a p l e
rappeur	ʁ a p œ ʁ
rapport	ʁ a p ɔ ʁ
rapporter	ʁ a p ɔ ʁ t e
rapprochement	ʁ a p ʁ ɔ ʃ m ɑ̃
rapprocher	ʁ a p ʁ ɔ ʃ e
rapt	ʁ a p t
raquette	ʁ a k ɛ t
rare	ʁ ɑ ʁ
rarement	ʁ ɑ ʁ m ɑ̃
rareté	ʁ a ʁ t e
rasade	ʁ a z a d
rassasier	ʁ a s a z j e
rassemblement	ʁ a s ɑ̃ b l ə m ɑ̃
rassemblements	ʁ a s ɑ̃ b l ə m ɑ̃
rassure	ʁ a s y ʁ
rassurer	ʁ a s y ʁ e
ratatiner	ʁ a t a t i n e
rate	ʁ a t
rater	ʁ a t e
ratifier	ʁ a t i f j e
rationnement	ʁ a s j ɔ n m ɑ̃
ratissage	ʁ a t i s a ʒ
rats	ʁ a
rattrapage	ʁ a t ʁ a p a ʒ
rattraper	ʁ a t ʁ a p e
raté	ʁ a t e
ravaler	ʁ a v a l e
ravi	ʁ a v i
ravin	ʁ a v ɛ̃
ravir	ʁ a v i ʁ
raymond	ʁ ɛ m ɔ̃
rayon	ʁ ɛ j ɔ̃
rayonnement	ʁ ɛ j ɔ n m ɑ̃
rayonner	ʁ ɛ j ɔ n e
rayons	ʁ ɛ j ɔ̃
raï	ʁ a j
rc	ɛ ʁ s e
rebelle	ʁ ə b ɛ l
reboisement	ʁ ə b w a z m ɑ̃
rebouteux	ʁ ə b u t ø
recapitaliser	ʁ ə k a p i t a l i z e
recel	ʁ ə s ɛ l
recensais	ʁ ə s ɑ̃ s ɛ
recense	ʁ ə s ɑ̃ s
recensement	ʁ ə s ɑ̃ s m ɑ̃
recensé	ʁ ə s ɑ̃ s e
recette	ʁ ə s ɛ t
receveur	ʁ ə s ə v œ ʁ
recevoir	ʁ ə s ə v w a ʁ
recherche	ʁ ə ʃ ɛ ʁ ʃ
rechercher	ʁ ə ʃ ɛ ʁ ʃ e
recherches	ʁ ə ʃ ɛ ʁ ʃ
rechignent	ʁ ə ʃ i ɲ
rechigné	ʁ ə ʃ i ɲ e
rechute	ʁ ə ʃ y t
recommandation	ʁ ə k ɔ m ɑ̃ d a s j ɔ̃
recommencer	ʁ ə k ɔ m ɑ̃ s e
recomposition	ʁ ə k ɔ̃ p o z i s j ɔ̃
reconfigurer	ʁ ə k ɔ̃ f i ɡ y ʁ e
reconnaissance	ʁ ə k ɔ n ɛ s ɑ̃ s
reconnaissant	ʁ ə k ɔ n ɛ s ɑ̃
reconnaître	ʁ ə k ɔ n ɛ t ʁ
reconquête	ʁ ə k ɔ̃ k ɛ t
reconstituer	ʁ ə k ɔ̃ s t i t ɥ e
reconstruire	ʁ ə k ɔ̃ s t ʁ ɥ i ʁ
record	ʁ ə k ɔ ʁ
recordman	ʁ ə k ɔ ʁ d m a n
recourir	ʁ ə k u ʁ i ʁ
recours	ʁ ə k u ʁ
recrudescence	ʁ ə k ʁ y d ɛ s ɑ̃ s
recrue	ʁ ə k ʁ y
recruter	ʁ ə k ʁ y t e
rectal	ʁ ɛ k t a l
recul	ʁ ə k y l
reculait	ʁ ə k y l ɛ
recule	ʁ ə k y l
reculer	ʁ ə k y l e
reculerions	ʁ ə k y l ə ʁ j ɔ̃
recyclable	ʁ e s i k l a b l
recyclage	ʁ ə s i k l a ʒ
recycler	ʁ ə s i k l e
reddition	ʁ ɛ d i s j ɔ̃
redescendre	ʁ ə d e s ɑ̃ d ʁ
redevenir	ʁ ə d ə v ə n i ʁ
redire	ʁ ə d i ʁ
redirigerais	ʁ ə d i ʁ i ʒ ʁ ɛ
redirigerez	ʁ ə d i ʁ i ʒ ʁ e
rediscutaient	ʁ ə d i s k y t ɛ
redonner	ʁ ə d ɔ n e
redoubler	ʁ ə d u b l e
redoutable	ʁ ə d u t a b l
redoutables	ʁ ə d u t a b l
redouter	ʁ ə d u t e
refaire	ʁ ə f ɛ ʁ
refait	ʁ ə f ɛ
refinancer	ʁ ə f i n ɑ̃ s e
reflet	ʁ ə f l ɛ
refléter	ʁ ə f l e t e
reformassions	ʁ ə f ɔ ʁ m a s j ɔ̃
reformé	ʁ ə f ɔ ʁ m e
refrain	ʁ ə f ʁ ɛ̃
refuge	ʁ ə f y ʒ
refus	ʁ ə f y
refuser	ʁ ə f y z e
regagner	ʁ ə ɡ a ɲ e
regard	ʁ ə ɡ a ʁ
regarde	ʁ ə ɡ a ʁ d
regarder	ʁ ə ɡ a ʁ d e
regardé	ʁ ə ɡ a ʁ d e
registre	ʁ ə ʒ i s t ʁ
regret	ʁ ə ɡ ʁ ɛ
regrettable	ʁ ə ɡ ʁ ɛ t a b l
rehausser	ʁ ə o s e
rehaussé	ʁ ə o s e
reims	ʁ ɛ̃ s
rein	ʁ ɛ̃
reine	ʁ ɛ n
rejeter	ʁ ə ʒ ə t e
rejoindre	ʁ ə ʒ w ɛ̃ d ʁ
rejouerait	ʁ ə ʒ u ʁ ɛ
relais	ʁ ə l ɛ
relance	ʁ ə l ɑ̃ s
relancerait	ʁ ə l ɑ̃ s ʁ ɛ
relancé	ʁ ə l ɑ̃ s e
relatif	ʁ ə l a t i f
relation	ʁ ə l a s j ɔ̃
relationnel	ʁ ə l a s j ɔ n ɛ l
relative	ʁ ə l a t i v
relatives	ʁ ə l a t i v
relativiser	ʁ ə l a t i v i z e
relevant	ʁ ə l ə v ɑ̃
relever	ʁ ə l ə v e
relevez	ʁ ə l ə v e
relevé	ʁ ə l ə v e
reliant	ʁ ə l j ɑ̃
relie	ʁ ə l i
relief	ʁ ə l j ɛ f
relier	ʁ ə l j e
religieuse	ʁ ə l i ʒ j ø z
religieux	ʁ ə l i ʒ j ø
religion	ʁ ə l i ʒ j ɔ̃
relire	ʁ ə l i ʁ
relié	ʁ ə l j e
relogeaient	ʁ ə l ɔ ʒ ɛ
reluque	ʁ ə l y k
relâche	ʁ ə l ɑ ʃ
relâcher	ʁ ə l ɑ ʃ e
relève	ʁ ə l ɛ v
relèvent	ʁ ə l ɛ v
relèves	ʁ ə l ɛ v
relégable	ʁ ə l e ɡ a b l
relégation	ʁ ə l e ɡ a s j ɔ̃
remaniement	ʁ ə m a n i m ɑ̃
remanier	ʁ ə m a n j e
remarquable	ʁ ə m a ʁ k a b l
remarque	ʁ ə m a ʁ k
remarquer	ʁ ə m a ʁ k e
remblai	ʁ ɑ̃ b l ɛ
remboursement	ʁ ɑ̃ b u ʁ s ə m ɑ̃
rembourser	ʁ ɑ̃ b u ʁ s e
remerciement	ʁ ə m ɛ ʁ s i m ɑ̃
remercier	ʁ ə m ɛ ʁ s j e
remise	ʁ ə m i z
remiser	ʁ ə m i z e
remobiliser	ʁ ə m ɔ b i l i z e
remorque	ʁ ə m ɔ ʁ k
remous	ʁ ə m u
remplacement	ʁ ɑ̃ p l a s m ɑ̃
remplacer	ʁ ɑ̃ p l a s e
remplir	ʁ ɑ̃ p l i ʁ
remporter	ʁ ɑ̃ p ɔ ʁ t e
remugle	ʁ ə m y ɡ l
remédier	ʁ ə m e d j e
renaissance	ʁ ə n ɛ s ɑ̃ s
renard	ʁ ə n a ʁ
renaud	ʁ ə n o
renault	ʁ ə n o
renchérit	ʁ ɑ̃ ʃ e ʁ i
rencontre	ʁ ɑ̃ k ɔ̃ t ʁ
rencontrer	ʁ ɑ̃ k ɔ̃ t ʁ e
rend	ʁ ɑ̃
rendant	ʁ ɑ̃ d ɑ̃
rendez	ʁ ɑ̃ d e
rendit	ʁ ɑ̃ d i
rendre	ʁ ɑ̃ d ʁ
renforcement	ʁ ɑ̃ f ɔ ʁ s ə m ɑ̃
renforcer	ʁ ɑ̃ f ɔ ʁ s e
renfort	ʁ ɑ̃ f ɔ ʁ
renforçant	ʁ ɑ̃ f ɔ ʁ s ɑ̃
renifler	ʁ ə n i f l e
rennais	ʁ ɛ n ɛ
rennes	ʁ ɛ n
renommée	ʁ ə n ɔ m e
renouveau	ʁ ə n u v o
renouvellement	ʁ ə n u v ɛ l m ɑ̃
rente	ʁ ɑ̃ t
rentre	ʁ ɑ̃ t ʁ
rentrer	ʁ ɑ̃ t ʁ e
rentrée	ʁ ɑ̃ t ʁ e
renverser	ʁ ɑ̃ v ɛ ʁ s e
renvoi	ʁ ɑ̃ v w a
renvois	ʁ ɑ̃ v w a
renvoyer	ʁ ɑ̃ v w a j e
renâclait	ʁ ə n a k l ɛ
renâcleras	ʁ ə n a k l ə ʁ a
rené	ʁ ə n e
repaire	ʁ ə p ɛ ʁ
repartir	ʁ ə p a ʁ t i ʁ
repasser	ʁ ə p ɑ s e
report	ʁ ə p ɔ ʁ
reporting	ʁ ə p ɔ ʁ t i ŋ
repos	ʁ ə p o
repose	ʁ ə p o z
reposer	ʁ ə p o z e
repoussant	ʁ ə p u s ɑ̃
repousser	ʁ ə p u s e
repoussé	ʁ ə p u s e
reprise	ʁ ə p ʁ i z
reproduction	ʁ ə p ʁ ɔ d y k s j ɔ̃
reproduire	ʁ ə p ʁ ɔ d ɥ i ʁ
représentait	ʁ ə p ʁ e z ɑ̃ t ɛ
représentant	ʁ ə p ʁ e z ɑ̃ t ɑ̃
représentante	ʁ ə p ʁ e z ɑ̃ t ɑ̃ t
représenter	ʁ ə p ʁ e z ɑ̃ t e
repère	ʁ ə p ɛ ʁ
repérer	ʁ ə p e ʁ e
repêchage	ʁ ə p ɛ ʃ a ʒ
requin	ʁ ə k ɛ̃
requête	ʁ ə k ɛ t
rescousse	ʁ ɛ s k u s
respect	ʁ ɛ s p ɛ
respecter	ʁ ɛ s p ɛ k t e
respectif	ʁ ɛ s p ɛ k t i f
respectivement	ʁ ɛ s p ɛ k t i v m ɑ̃
respectueux	ʁ ɛ s p ɛ k t ɥ ø
respirer	ʁ ɛ s p i ʁ e
responsabilité	ʁ ɛ s p ɔ̃ s a b i l i t e
responsable	ʁ ɛ s p ɔ̃ s a b l
ressassant	ʁ ə s a s ɑ̃
ressassés	ʁ ə s a s e
resserrant	ʁ ə s e ʁ ɑ̃
resserre	ʁ ə s ɛ ʁ
resserré	ʁ ə s e ʁ e
ressort	ʁ ə s ɔ ʁ
ressorti	ʁ ə s ɔ ʁ t i
ressortir	ʁ ə s ɔ ʁ t i ʁ
ressortissaient	ʁ ə s ɔ ʁ t i s ɛ
ressortissant	ʁ ə s ɔ ʁ t i s ɑ̃
ressource	ʁ ə s u ʁ s
restaient	ʁ ɛ s t ɛ
restait	ʁ ɛ s t ɛ
restant	ʁ ɛ s t ɑ̃
restaurant	ʁ ɛ s t ɔ ʁ ɑ̃
restauration	ʁ ɛ s t o ʁ a s j ɔ̃
reste	ʁ ɛ s t
restent	ʁ ɛ s t
rester	ʁ ɛ s t e
restes	ʁ ɛ s t
restez	ʁ ɛ s t e
restiez	ʁ ɛ s t j e
resto	ʁ ɛ s t o
restos	ʁ ɛ s t o
restriction	ʁ ɛ s t ʁ i k s j ɔ̃
resté	ʁ ɛ s t e
retarder	ʁ ə t a ʁ d e
retenir	ʁ ə t ə n i ʁ
retirer	ʁ ə t i ʁ e
retomber	ʁ ə t ɔ̃ b e
retordre	ʁ ə t ɔ ʁ d ʁ
retour	ʁ ə t u ʁ
retourner	ʁ ə t u ʁ n e
retourné	ʁ ə t u ʁ n e
retrait	ʁ ə t ʁ ɛ
retrancher	ʁ ə t ʁ ɑ̃ ʃ e
retranscrire	ʁ ə t ʁ ɑ̃ s k ʁ i ʁ
retransmettre	ʁ ə t ʁ ɑ̃ s m ɛ t ʁ
retroussé	ʁ ə t ʁ u s e
retrouver	ʁ ə t ʁ u v e
revanche	ʁ ə v ɑ̃ ʃ
revenant	ʁ ə v ə n ɑ̃
revendication	ʁ ə v ɑ̃ d i k a s j ɔ̃
revenir	ʁ ə v ə n i ʁ
revenu	ʁ ə v ə n y
revenues	ʁ ə v ə n y
revers	ʁ ə v ɛ ʁ
reversant	ʁ ə v ɛ ʁ s ɑ̃
reverser	ʁ ə v ɛ ʁ s e
reverses	ʁ ə v ɛ ʁ s
reversèrent	ʁ ə v ɛ ʁ s ɛ ʁ
revisiter	ʁ ə v i z i t e
revivre	ʁ ə v i v ʁ
revoici	ʁ ə v w a s i
revoilà	ʁ ə v w a l a
revoir	ʁ ə v w a ʁ
revêt	ʁ ə v ɛ
revêtent	ʁ ə v ɛ t
revêtions	ʁ ə v ɛ t j ɔ̃
reçu	ʁ ə s y
reçues	ʁ ə s y
rhodanien	ʁ ɔ d a n j ɛ̃
rhodes	ʁ ɔ d
rhume	ʁ y m
rhétorique	ʁ e t ɔ ʁ i k
rhône	ʁ o n
riant	ʁ i j ɑ̃
ribambelle	ʁ i b ɑ̃ b ɛ l
ricard	ʁ i k a ʁ
riche	ʁ i ʃ
riches	ʁ i ʃ
rien	ʁ j ɛ̃
riga	ʁ i ɡ a
rigide	ʁ i ʒ i d
rigoureux	ʁ i ɡ u ʁ ø
rime	ʁ i m
rimerions	ʁ i m ə ʁ j ɔ̃
rimini	ʁ i m i n i
ring	ʁ i ŋ ɡ
rire	ʁ i ʁ
ris	ʁ i
risque	ʁ i s k
risquer	ʁ i s k e
rissoler	ʁ i s ɔ l e
risée	ʁ i z e
rivage	ʁ i v a ʒ
rivages	ʁ i v a ʒ
rival	ʁ i v a l
rivaliser	ʁ i v a l i z e
rive	ʁ i v
riyad	ʁ i j a d
robert	ʁ ɔ b ɛ ʁ
robin	ʁ ɔ b ɛ̃
robuste	ʁ ɔ b y s t
roc	ʁ ɔ k
roche	ʁ ɔ ʃ
rocher	ʁ ɔ ʃ e
roches	ʁ ɔ ʃ
rock	ʁ ɔ k
rodage	ʁ ɔ d a ʒ
rodin	ʁ ɔ d ɛ̃
rogne	ʁ ɔ ɲ
roi	ʁ w a
roland	ʁ ɔ l ɑ̃
romaine	ʁ ɔ m ɛ n
roman	ʁ ɔ m ɑ̃
romancier	ʁ ɔ m ɑ̃ s j e
romans	ʁ ɔ m ɑ̃
rome	ʁ ɔ m
rompre	ʁ ɔ̃ p ʁ
rond	ʁ ɔ̃
ronde	ʁ ɔ̃ d
rondelle	ʁ ɔ̃ d ɛ l
rondement	ʁ ɔ̃ d m ɑ̃
ronds	ʁ ɔ̃
ronronnement	ʁ ɔ̃ ʁ ɔ n m ɑ̃
roquette	ʁ ɔ k ɛ t
roseau	ʁ o z o
roselyne	ʁ o z l i n
rosette	ʁ o z ɛ t
rosser	ʁ ɔ s e
roubaix	ʁ u b ɛ
roue	ʁ u
rouge	ʁ u ʒ
rouleau	ʁ u l o
rouler	ʁ u l e
roumain	ʁ u m ɛ̃
roumaine	ʁ u m ɛ n
roumanie	ʁ u m a n i
round	ʁ u n d
routait	ʁ u t ɛ
route	ʁ u t
routine	ʁ u t i n
roux	ʁ u
royal	ʁ w a j a l
ruben	ʁ y b ɛ n
rubrique	ʁ y b ʁ i k
rudes	ʁ y d
rudesse	ʁ y d ɛ s
rudimentaire	ʁ y d i m ɑ̃ t ɛ ʁ
rue	ʁ y
ruer	ʁ ɥ e
ruine	ʁ ɥ i n
ruiner	ʁ ɥ i n e
ruines	ʁ ɥ i n
ruissellement	ʁ ɥ i s ɛ l m ɑ̃
rupture	ʁ y p t y ʁ
rural	ʁ y ʁ a l
ruse	ʁ y z
russes	ʁ y s
russie	ʁ y s i
ruth	ʁ y t
ruthène	ʁ y t ɛ n
rythme	ʁ i t m
rythmé	ʁ i t m e
règle	ʁ ɛ ɡ l
règlement	ʁ ɛ ɡ l ə m ɑ̃
règles	ʁ ɛ ɡ l
règne	ʁ ɛ ɲ
réactivé	ʁ e a k t i v e
réalisateur	ʁ e a l i z a t œ ʁ
réalisatrice	ʁ e a l i z a t ʁ i s
réaliser	ʁ e a l i z e
réaliste	ʁ e a l i s t
réalité	ʁ e a l i t e
réalités	ʁ e a l i t e
réaménagent	ʁ e a m e n a ʒ
réarmâmes	ʁ e a ʁ m ɑ m
récemment	ʁ e s a m ɑ̃
récent	ʁ e s ɑ̃
réception	ʁ e s ɛ p s j ɔ̃
récif	ʁ e s i f
réciproque	ʁ e s i p ʁ ɔ k
récit	ʁ e s i
récital	ʁ e s i t a l
réclame	ʁ e k l a m
réclamer	ʁ e k l a m e
récolte	ʁ e k ɔ l t
récolter	ʁ e k ɔ l t e
récupération	ʁ e k y p e ʁ a s j ɔ̃
récurant	ʁ e k y ʁ ɑ̃
récurrent	ʁ e k y ʁ ɑ̃
rédaction	ʁ e d a k s j ɔ̃
rédactrice	ʁ e d a k t ʁ i s
rédiger	ʁ e d i ʒ e
réduction	ʁ e d y k s j ɔ̃
réduire	ʁ e d ɥ i ʁ
réduit	ʁ e d ɥ i
réel	ʁ e ɛ l
réellement	ʁ e ɛ l m ɑ̃
réenchérissiez	ʁ e ɑ̃ ʃ e ʁ i s j e
réexaminé	ʁ e ɛ ɡ z a m i n e
réfection	ʁ e f ɛ k s j ɔ̃
réfectoire	ʁ e f ɛ k t w a ʁ
réflexion	ʁ e f l ɛ k s j ɔ̃
réfléchi	ʁ e f l e ʃ i
réfléchir	ʁ e f l e ʃ i ʁ
réfréner	ʁ e f ʁ e n e
réfugier	ʁ e f y ʒ j e
réfugié	ʁ e f y ʒ j e
régie	ʁ e ʒ i
régime	ʁ e ʒ i m
région	ʁ e ʒ j ɔ̃
régional	ʁ e ʒ j ɔ n a l
régionales	ʁ e ʒ j ɔ n a l
régionaux	ʁ e ʒ j ɔ n o
régis	ʁ e ʒ i s
réglementaire	ʁ ɛ ɡ l ə m ɑ̃ t ɛ ʁ
réglementer	ʁ ɛ ɡ l ə m ɑ̃ t e
régler	ʁ e ɡ l e
régner	ʁ e ɲ e
régresse	ʁ e ɡ ʁ ɛ s
réguler	ʁ e ɡ y l e
régulier	ʁ e ɡ y l j e
régulièrement	ʁ e ɡ y l j ɛ ʁ m ɑ̃
réinitialiser	ʁ e i n i s j a l i z e
réislamisas	ʁ e i s l a m i z ɑ
rémunération	ʁ e m y n e ʁ a s j ɔ̃
rémunérer	ʁ e m y n e ʁ e
rémy	ʁ e m i
réouverture	ʁ e u v ɛ ʁ t y ʁ
répandre	ʁ e p ɑ̃ d ʁ
répandu	ʁ e p ɑ̃ d y
répartie	ʁ e p a ʁ t i
répartir	ʁ e p a ʁ t i ʁ
répartition	ʁ e p a ʁ t i s j ɔ̃
répercussion	ʁ e p ɛ ʁ k y s j ɔ̃
répercuter	ʁ e p ɛ ʁ k y t e
répit	ʁ e p i
réplique	ʁ e p l i k
répliquer	ʁ e p l i k e
répondeur	ʁ e p ɔ̃ d œ ʁ
répondre	ʁ e p ɔ̃ d ʁ
réponse	ʁ e p ɔ̃ s
répression	ʁ e p ʁ ɛ s j ɔ̃
réprimandes	ʁ e p ʁ i m ɑ̃ d
réprimer	ʁ e p ʁ i m e
républicain	ʁ e p y b l i k ɛ̃
républicaine	ʁ e p y b l i k ɛ n
républicaines	ʁ e p y b l i k ɛ n
république	ʁ e p y b l i k
réputation	ʁ e p y t a s j ɔ̃
répéter	ʁ e p e t e
réquisitionnez	ʁ e k i z i s j ɔ n e
réseau	ʁ e z o
réserve	ʁ e z ɛ ʁ v
réserver	ʁ e z ɛ ʁ v e
réservoir	ʁ e z ɛ ʁ v w a ʁ
résidence	ʁ e z i d ɑ̃ s
résidente	ʁ e z i d ɑ̃ t
résigné	ʁ e z i ɲ e
résille	ʁ e z i j
résulter	ʁ e z y l t e
résumé	ʁ e z y m e
rétablissement	ʁ e t a b l i s m ɑ̃
rétention	ʁ e t ɑ̃ s j ɔ̃
réticence	ʁ e t i s ɑ̃ s
rétracter	ʁ e t ʁ a k t e
réunion	ʁ e y n j ɔ̃
réunir	ʁ e y n i ʁ
réussi	ʁ e y s i
réussir	ʁ e y s i ʁ
réussites	ʁ e y s i t
réutilisions	ʁ e y t i l i z j ɔ̃
réveil	ʁ e v ɛ j
réveille	ʁ e v ɛ j
réveiller	ʁ e v ɛ j e
réveillé	ʁ e v ɛ j e
réviser	ʁ e v i z e
révolte	ʁ e v ɔ l t
révolution	ʁ e v ɔ l y s j ɔ̃
révolutionnaire	ʁ e v ɔ l y s j ɔ n ɛ ʁ
révélation	ʁ e v e l a s j ɔ̃
révéler	ʁ e v e l e
réédition	ʁ e e d i s j ɔ̃
rêveur	ʁ ɛ v œ ʁ
sa	s a
sabbatisas	s a b a t i z ɑ
sabotage	s a b ɔ t a ʒ
sabrina	s a b ʁ i n a
sac	s a k
sacerdoce	s a s ɛ ʁ d ɔ s
sachant	s a ʃ ɑ̃
sache	s a ʃ
sachet	s a ʃ ɛ
sacrifice	s a k ʁ i f i s
sacrifier	s a k ʁ i f j e
sadienne	s a d j ɛ n
safari	s a f a ʁ i
saga	s a ɡ a
sage	s a ʒ
sagesse	s a ʒ ɛ s
sahara	s a a ʁ a
sahraoui	s a ʁ a w i
sahraouie	s a ʁ a w i
sain	s ɛ̃
saint	s ɛ̃
saintes	s ɛ̃ t
sais	s ɛ
saisie	s ɛ z i
saisine	s ɛ z i n
sait	s ɛ
sala	s a l a
salade	s a l a d
salaires	s a l ɛː ʁ
sale	s a l
salle	s a l
salon	s a l ɔ̃
salonique	s a l ɔ n i k
saluer	s a l ɥ e
salut	s a l y
salvador	s a l v a d ɔ ʁ
salve	s a l v
salé	s a l e
samba	s ɑ̃ b a
samedi	s a m d i
samuel	s a m ɥ ɛ l
san	s a n
sanction	s ɑ̃ k s j ɔ̃
sanctuaire	s ɑ̃ k t ɥ ɛ ʁ
sandrine	s ɑ̃ d ʁ i n
sanglant	s ɑ̃ ɡ l ɑ̃
santé	s ɑ̃ t e
saoudien	s a u d j ɛ̃
sapin	s a p ɛ̃
saragosse	s a ʁ a ɡ ɔ s
sarah	s a ʁ a
sardinières	s a ʁ d i n j ɛ ʁ
sarkozy	s a ʁ k ɔ z i
sarthe	s a ʁ t
saskatchewan	s a s k a t ʃ ə w a n
satisfaction	s a t i s f a k s j ɔ̃
satisfaire	s a t i s f ɛ ʁ
satisfaisant	s a t i s f ə z ɑ̃
satisfait	s a t i s f ɛ
saturasse	s a t y ʁ a s
saturation	s a t y ʁ a s j ɔ̃
saturé	s a t y ʁ e
saucisson	s o s i s ɔ̃
sauf	s o f
saumon	s o m ɔ̃
saut	s o
saute	s o t
sauter	s o t e
sauve	s o v
sauver	s o v e
sauvetage	s o v t a ʒ
sauveur	s o v œ ʁ
savait	s a v ɛ
savamment	s a v a m ɑ̃
save	s a v
savent	s a v
saveur	s a v œ ʁ
savez	s a v e
savoir	s a v w a ʁ
savoirs	s a v w a ʁ
savons	s a v ɔ̃
savoureux	s a v u ʁ ø
scandale	s k ɑ̃ d a l
scandaleux	s k ɑ̃ d a l ø
scandalisé	s k ɑ̃ d a l i z e
scandinave	s k ɑ̃ d i n a v
scandinavie	s k ɑ̃ d i n a v i
sceaux	s o
sceptique	s ɛ p t i k
schiste	ʃ i s t
schéma	ʃ e m a
scie	s i
sciemment	s j a m ɑ̃
scier	s j e
scinder	s ɛ̃ d e
score	s k ɔ ʁ
scrupule	s k ʁ y p y l
scrutin	s k ʁ y t ɛ̃
sculptrice	s k y l t ʁ i s
sculpture	s k y l t y ʁ
sculptures	s k y l t y ʁ
scène	s ɛ n
scénariste	s e n a ʁ i s t
sdf	ɛ s d e ɛ f
se	s ə
seau	s o
second	s ə ɡ ɔ̃
secondaire	s ə ɡ ɔ̃ d ɛ ʁ
secouer	s ə k w e
secourir	s ə k u ʁ i ʁ
secours	s ə k u ʁ
secousse	s ə k u s
secrets	s ə k ʁ ɛ
secteur	s ɛ k t œ ʁ
seguin	s ə ɡ ɛ̃
sein	s ɛ̃
seinassiez	s ɛ n a s j e
seine	s ɛ n
seins	s ɛ̃
seize	s ɛ z
seizième	s ɛ z j ɛ m
sel	s ɛ l
selle	s ɛ l
selon	s ə l ɔ̃
sels	s ɛ l
semblable	s ɑ̃ b l a b l
semence	s ə m ɑ̃ s
semer	s ə m e
semestre	s ə m ɛ s t ʁ
semis	s ə m i
senior	s e n j ɔ ʁ
sens	s ɑ̃ s
sensation	s ɑ̃ s a s j ɔ̃
sensible	s ɑ̃ s i b l
sentant	s ɑ̃ t ɑ̃
sentence	s ɑ̃ t ɑ̃ s
senti	s ɑ̃ t i
sentiers	s ɑ̃ t j e
sentiment	s ɑ̃ t i m ɑ̃
sentimentale	s ɑ̃ t i m ɑ̃ t a l
sentir	s ɑ̃ t i ʁ
septentrionale	s ɛ p t ɑ̃ t ʁ i j ɔ n a l
septique	s ɛ p t i k
serbie	s ɛ ʁ b i
serein	s ə ʁ ɛ̃
serge	s ɛ ʁ ʒ
sergent	s ɛ ʁ ʒ ɑ̃
serin	s ə ʁ ɛ̃
serment	s ɛ ʁ m ɑ̃
serpe	s ɛ ʁ p
serra	s ɛ ʁ a
serre	s ɛ ʁ
serrée	s e ʁ e
serrés	s e ʁ e
sert	s ɛ ʁ
serve	s ɛ ʁ v
servent	s ɛ ʁ v
serveur	s ɛ ʁ v œ ʁ
serveuse	s ɛ ʁ v ø z
service	s ɛ ʁ v i s
servir	s ɛ ʁ v i ʁ
session	s ɛ s j ɔ̃
seuil	s œ j
seul	s œ l
seule	s œ l
seulement	s œ l m ɑ̃
sevré	s ə v ʁ e
sexe	s ɛ k s
sexologie	s ɛ k s ɔ l ɔ ʒ i
sexuel	s ɛ k s ɥ ɛ l
sexuellement	s e k s ɥ ɛ l m ɑ̃
seyant	s ɛ j ɑ̃
sherbrooke	ʃ ɛ ʁ b ʁ u k
short	ʃ ɔ ʁ t
si	s i
sied	s j e
siemens	s i m ɛ n s
sien	s j ɛ̃
siens	s j ɛ̃
sieste	s j ɛ s t
sieur	s j œ ʁ
sifflet	s i f l ɛ
signal	s i ɲ a l
signalement	s i ɲ a l m ɑ̃
signaler	s i ɲ a l e
signalisation	s i ɲ a l i z a s j ɔ̃
signalé	s i ɲ a l e
signature	s i ɲ a t y ʁ
signe	s i ɲ
signent	s i ɲ
signer	s i ɲ e
signes	s i ɲ
signification	s i ɲ i f i k a s j ɔ̃
significations	s i ɲ i f i k a s j ɔ̃
silence	s i l ɑ̃ s
silences	s i l ɑ̃ s
silencieux	s i l ɑ̃ s j ø
silhouette	s i l w ɛ t
silice	s i l i s
sillage	s i j a ʒ
simon	s i m ɔ̃
simple	s ɛ̃ p l
simplement	s ɛ̃ p l ə m ɑ̃
simplicité	s ɛ̃ p l i s i t e
simultané	s i m y l t a n e
simultanément	s i m y l t a n e m ɑ̃
sincère	s ɛ̃ s ɛ ʁ
sincèrement	s ɛ̃ s ɛ ʁ m ɑ̃
sincérité	s ɛ̃ s e ʁ i t e
singapour	s ɛ̃ ɡ a p u ʁ
singer	s ɛ̃ ʒ e
sinistre	s i n i s t ʁ
sinistres	s i n i s t ʁ
sinon	s i n ɔ̃
sinécure	s i n e k y ʁ
sismique	s i s m i k
situer	s i t ɥ e
sitôt	s i t o
sixième	s i z j ɛ m
siècle	s j ɛ k l
siècles	s j ɛ k l
siège	s j ɛ ʒ
ski	s k i
skieur	s k i œ ʁ
slalom	s l a l ɔ m
slave	s l a v
slip	s l i p
slovaque	s l ɔ v a k
slovaquie	s l ɔ v a k i
slovène	s l ɔ v ɛ n
slovénie	s l ɔ v e n i
smartphone	s m a ʁ t f ɔ n
smashasse	s m a ʃ a s
smic	s m i k
smith	s m i t
sms	ɛ s ɛ m ɛ s
soccer	s ɔ k œ ʁ
social	s ɔ s j a l
sociale	s ɔ s j a l
sociales	s ɔ s j a l
socialisassent	s ɔ s j a l i z a s
socialise	s ɔ s j a l i z
socialisme	s ɔ s j a l i z m
sociaux	s ɔ s j o
sociologie	s ɔ s j ɔ l ɔ ʒ i
sociétaire	s ɔ s j e t ɛ ʁ
société	s ɔ s j e t e
sociétés	s ɔ s j e t e
socle	s ɔ k l
soda	s o d a
soeur	s œ ʁ
sofia	s ɔ f j a
soft	s ɔ f t
soie	s w a
soigner	s w a ɲ e
soigneux	s w a ɲ ø
soigné	s w a ɲ e
soin	s w ɛ̃
soixante	s w a s ɑ̃ t
sol	s ɔ l
solange	s ɔ l ɑ̃ ʒ
solde	s ɔ l d
soleil	s ɔ l ɛ j
solidaire	s ɔ l i d ɛ ʁ
solidarité	s ɔ l i d a ʁ i t e
solide	s ɔ l i d
solitude	s ɔ l i t y d
solliciter	s ɔ l i s i t e
solo	s ɔ l o
solutionner	s ɔ l y s j ɔ n e
solvabilité	s ɔ l v a b i l i t e
somalie	s ɔ m a l i
sombre	s ɔ̃ b ʁ
sombrer	s ɔ̃ b ʁ e
sommaire	s ɔ m ɛ ʁ
somme	s ɔ m
sommeil	s ɔ m ɛ j
sommes	s ɔ m
sommet	s ɔ m ɛ
somnolent	s ɔ m n ɔ l ɑ̃
son	s ɔ̃
sonde	s ɔ̃ d
songe	s ɔ̃ ʒ
sonia	s ɔ n j a
sonnette	s ɔ n ɛ t
sonore	s ɔ n ɔ ʁ
sons	s ɔ̃
sont	s ɔ̃
sophie	s ɔ f i
sorcière	s ɔ ʁ s j ɛ ʁ
sort	s ɔ ʁ
sorte	s ɔ ʁ t
sortilèges	s ɔ ʁ t i l ɛ ʒ
sortir	s ɔ ʁ t i ʁ
sou	s u
souche	s u ʃ
souci	s u s i
soucier	s u s j e
soudain	s u d ɛ̃
soudan	s u d ɑ̃
soudard	s u d a ʁ
soude	s u d
souder	s u d e
souffle	s u f l
souffler	s u f l e
soufflé	s u f l e
souffrir	s u f ʁ i ʁ
soufre	s u f ʁ
soulagement	s u l a ʒ m ɑ̃
soulever	s u l v e
soulier	s u l j e
souligner	s u l i ɲ e
soumission	s u m i s j ɔ̃
soupapes	s u p a p
soupe	s u p
souper	s u p e
soupir	s u p i ʁ
souplesse	s u p l ɛ s
soupçons	s u p s ɔ̃
source	s u ʁ s
sourd	s u ʁ
sourde	s u ʁ d
sous	s u
souscription	s u s k ʁ i p s j ɔ̃
soustraire	s u s t ʁ ɛ ʁ
soutenir	s u t n i ʁ
soutien	s u t j ɛ̃
souvent	s u v ɑ̃
souverain	s u v ʁ ɛ̃
souverainiste	s u v ʁ ɛ n i s t
spam	s p a m
spartiate	s p a ʁ s j a t
spectacle	s p ɛ k t a k l
spectaculaire	s p ɛ k t a k y l ɛ ʁ
spencer	s p ɛ n s ɛ ʁ
sperme	s p ɛ ʁ m
sphinx	s f ɛ̃ k s
spirale	s p i ʁ a l
spirituel	s p i ʁ i t ɥ ɛ l
spirituelles	s p i ʁ i t ɥ ɛ l
splendeur	s p l ɑ̃ d œ ʁ
splendides	s p l ɑ̃ d i d
sponsor	s p ɔ̃ s ɔ ʁ
sponsorisasse	s p ɔ̃ s ɔ ʁ i z a s
sport	s p ɔ ʁ
spot	s p ɔ t
spécial	s p e s j a l
spécialement	s p e s j a l m ɑ̃
spécialiste	s p e s j a l i s t
spécifique	s p e s i f i k
spécifiquement	s p e s i f i k m ɑ̃
spéculateurs	s p e k y l a t œ ʁ
square	s k w a ʁ
squattent	s k w a t
squelette	s k ə l ɛ t
stabiliser	s t a b i l i z e
stable	s t a b l
stade	s t a d
staff	s t a f
stage	s t a ʒ
stages	s t a ʒ
stagne	s t a ɡ n
stagner	s t a ɡ n e
stand	s t ɑ̃ d
standard	s t ɑ̃ d a ʁ
standing	s t ɑ̃ d i ŋ
stanislas	s t a n i s l a s
star	s t a ʁ
station	s t a s j ɔ̃
statistique	s t a t i s t i k
statistiques	s t a t i s t i k
statut	s t a t y
stigmatise	s t i ɡ m a t i z
stigmatiser	s t i ɡ m a t i z e
stigmatiserais	s t i ɡ m a t i z ʁ ɛ
stigmatisé	s t i ɡ m a t i z e
stimulation	s t i m y l a s j ɔ̃
stock	s t ɔ k
stockholm	s t ɔ k ɔ l m
stone	s t o n
stoppeur	s t ɔ p œ ʁ
store	s t ɔ ʁ
stress	s t ʁ ɛ s
structure	s t ʁ y k t y ʁ
structurer	s t ʁ y k t y ʁ e
structures	s t ʁ y k t y ʁ
structuré	s t ʁ y k t y ʁ e
stupide	s t y p i d
style	s t i l
stylet	s t i l ɛ
stéphane	s t e f a n
stéphanie	s t e f a n i
stœchiométrique	s t e k j o m e t ʁ i k
su	s y
subir	s y b i ʁ
subit	s y b i
subitement	s y b i t m ɑ̃
subjectif	s y b ʒ ɛ k t i f
subjectives	s y b ʒ ɛ k t i v
substance	s y p s t ɑ̃ s
substitut	s y p s t i t y
substrat	s y p s t ʁ a
subvention	s y b v ɑ̃ s j ɔ̃
successeur	s y k s ɛ s œ ʁ
successivement	s y k s ɛ s i v m ɑ̃
succinct	s y k s ɛ̃
succès	s y k s ɛ
sud	s y d
sueur	s ɥ œ ʁ
suffire	s y f i ʁ
suffisamment	s y f i z a m ɑ̃
suffisance	s y f i z ɑ̃ s
suffisant	s y f i z ɑ̃
suffixe	s y f i k s
suggestion	s y ɡ ʒ ɛ s t j ɔ̃
suggestions	s y ɡ ʒ ɛ s t j ɔ̃
suicide	s ɥ i s i d
suis	s ɥ i
suisse	s ɥ i s
suit	s ɥ i
suite	s ɥ i t
suites	s ɥ i t
suivant	s ɥ i v ɑ̃
suivi	s ɥ i v i
sujet	s y ʒ ɛ
superbe	s y p ɛ ʁ b
supercoupe	s y p ɛ ʁ k u p
superficie	s y p ɛ ʁ f i s i
superman	s y p ɛ ʁ m a n
supplice	s y p l i s
supplément	s y p l e m ɑ̃
supplémentaire	s y p l e m ɑ̃ t ɛ ʁ
supportable	s y p ɔ ʁ t a b l
supprimer	s y p ʁ i m e
suprématie	s y p ʁ e m a s i
suprême	s y p ʁ ɛ m
supérieur	s y p e ʁ j œ ʁ
supérieure	s y p e ʁ j œ ʁ
supérieurs	s y p e ʁ j œ ʁ
sur	s y ʁ
surcharge	s y ʁ ʃ a ʁ ʒ
surdoser	s y ʁ d o z e
surdouée	s y ʁ d w e
surexposition	s y ʁ ɛ k s p o z i s j ɔ̃
surface	s y ʁ f a s
surfer	s œ ʁ f e
surfeur	s œ ʁ f œ ʁ
surgit	s y ʁ ʒ i
surmonter	s y ʁ m ɔ̃ t e
surnaturel	s y ʁ n a t y ʁ ɛ l
surnommait	s y ʁ n ɔ m ɛ
surnomme	s y ʁ n ɔ m
surnommé	s y ʁ n ɔ m e
surpasser	s y ʁ p ɑ s e
surpayer	s y ʁ p ɛ j e
surplombe	s y ʁ p l ɔ̃ b
surpoids	s y ʁ p w a
surprenant	s y ʁ p ʁ ə n ɑ̃
surprendre	s y ʁ p ʁ ɑ̃ d ʁ
sursis	s y ʁ s i
surtout	s y ʁ t u
surveillance	s y ʁ v ɛ j ɑ̃ s
surveillant	s y ʁ v ɛ j ɑ̃
surveillent	s y ʁ v ɛ j
surveiller	s y ʁ v ɛ j e
surveilleraient	s y ʁ v ɛ j ʁ ɛ
surveillé	s y ʁ v ɛ j e
survenir	s y ʁ v ə n i ʁ
survenu	s y ʁ v ə n y
surviendraient	s y ʁ v j ɛ̃ d ʁ ɛ
surviennent	s y ʁ v j ɛ n
survient	s y ʁ v j ɛ̃
survivre	s y ʁ v i v ʁ
sus	s y
susceptible	s y s ɛ p t i b l
susciter	s y s i t e
suscité	s y s i t e
suspect	s y s p ɛ
suspendre	s y s p ɑ̃ d ʁ
suspens	s y s p ɑ̃
suspension	s y s p ɑ̃ s j ɔ̃
suspicion	s y s p i s j ɔ̃
suède	s ɥ ɛ d
suédois	s ɥ e d w a
swing	s w i ŋ
sydney	s i d n ɛ
symbole	s ɛ̃ b ɔ l
symboliquement	s ɛ̃ b ɔ l i k m ɑ̃
sympa	s ɛ̃ p a
sympathie	s ɛ̃ p a t i
sympathique	s ɛ̃ p a t i k
symphonie	s ɛ̃ f ɔ n i
symptôme	s ɛ̃ p t o m
symétrie	s i m e t ʁ i
synchronisation	s ɛ̃ k ʁ ɔ n i z a s j ɔ̃
syndical	s ɛ̃ d i k a l
syndicales	s ɛ̃ d i k a l
syndicat	s ɛ̃ d i k a
syndicaux	s ɛ̃ d i k o
syndrome	s ɛ̃ d ʁ o m
synergies	s i n ɛ ʁ ʒ i
synonyme	s i n ɔ n i m
synonymes	s i n ɔ n i m
synthèse	s ɛ̃ t ɛ z
syrien	s i ʁ j ɛ̃
system	s i s t ɛ m
système	s i s t ɛ m
systèmes	s i s t ɛ m
séance	s e ɑ̃ s
séances	s e ɑ̃ s
sébastien	s e b a s t j ɛ̃
sécher	s e ʃ e
sécrèterais	s e k ʁ ɛ t ʁ ɛ
séculaire	s e k y l ɛ ʁ
séduction	s e d y k s j ɔ̃
séfarade	s e f a ʁ a d
ségolène	s e ɡ ɔ l ɛ n
séisme	s e i s m
séjour	s e ʒ u ʁ
sélectif	s e l ɛ k t i f
sélection	s e l ɛ k s j ɔ̃
sémaphore	s e m a f ɔ ʁ
séminaire	s e m i n ɛ ʁ
sénat	s e n a
sénateur	s e n a t œ ʁ
sénégal	s e n e ɡ a l
séparer	s e p a ʁ e
sérieux	s e ʁ j ø
sérum	s e ʁ ɔ m
sévices	s e v i s
sévissiez	s e v i s j e
sévit	s e v i
sévère	s e v ɛ ʁ
sûr	s y ʁ
sûre	s y ʁ
sûreté	s y ʁ t e
ta	t a
tabac	t a b a
tabagisme	t a b a ʒ i s m
tabasserons	t a b a s ʁ ɔ̃
table	t a b l
tableau	t a b l o
tableaux	t a b l o
tabler	t a b l e
tablette	t a b l ɛ t
tablettes	t a b l ɛ t
tablier	t a b l i j e
tacher	t a ʃ e
tacle	t a k l
tactile	t a k t i l
tactique	t a k t i k
tag	t a ɡ
taille	t a j
taire	t ɛ ʁ
tait	t ɛ
talent	t a l ɑ̃
talentueux	t a l ɑ̃ t ɥ ø
talon	t a l ɔ̃
talonnade	t a l ɔ n a d
talus	t a l y
tampon	t ɑ̃ p ɔ̃
tancera	t ɑ̃ s ʁ a
tancé	t ɑ̃ s e
tandem	t ɑ̃ d ɛ m
tandis	t ɑ̃ d i
tangente	t ɑ̃ ʒ ɑ̃ t
tanger	t ɑ̃ ʒ e
tania	t a n j a
tank	t ɑ̃ k
tanna	t a n a
tannassiez	t a n a s j e
tanner	t a n e
tanné	t a n e
tant	t ɑ̃
tante	t ɑ̃ t
tanzanie	t ɑ̃ z a n i
tapage	t a p a ʒ
taper	t a p e
tapi	t a p i
tapis	t a p i
tard	t a ʁ
tarde	t a ʁ d
tarder	t a ʁ d e
tardif	t a ʁ d i f
targuer	t a ʁ ɡ e
tarif	t a ʁ i f
tarit	t a ʁ i
tarmac	t a ʁ m a k
tarterêts	t a ʁ t ə ʁ ɛ
taulard	t o l a ʁ
taux	t o
tavernier	t a v ɛ ʁ n j e
taxe	t a k s
taxer	t a k s e
taxes	t a k s
taxi	t a k s i
taylor	t ɛ j l ɔ ʁ
taïwan	t a j w a n
tchad	t ʃ a d
tchèque	t ʃ ɛ k
tchétchénie	t ʃ e t ʃ e n i
td	t e d e
technicien	t ɛ k n i s j ɛ̃
technique	t ɛ k n i k
technologie	t ɛ k n ɔ l ɔ ʒ i
technologique	t ɛ k n ɔ l ɔ ʒ i k
teindre	t ɛ̃ d ʁ
teint	t ɛ̃
teints	t ɛ̃
tel	t ɛ l
tellement	t ɛ l m ɑ̃
template	t ɑ̃ p l a t
temple	t ɑ̃ p l
temps	t ɑ̃
température	t ɑ̃ p e ʁ a t y ʁ
tenace	t ə n a s
tendinite	t ɑ̃ d i n i t
tendre	t ɑ̃ d ʁ
tendresse	t ɑ̃ d ʁ ɛ s
teneur	t ə n œ ʁ
tenir	t ə n i ʁ
tennis	t e n i s
tension	t ɑ̃ s j ɔ̃
tentant	t ɑ̃ t ɑ̃
tentation	t ɑ̃ t a s j ɔ̃
tentative	t ɑ̃ t a t i v
tentatives	t ɑ̃ t a t i v
tente	t ɑ̃ t
tenter	t ɑ̃ t e
tentes	t ɑ̃ t
tentez	t ɑ̃ t e
tenue	t ə n y
tequila	t e k i l a
ter	t e ø ɛ ʁ
terme	t ɛ ʁ m
terminateur	t ɛ ʁ m i n a t œ ʁ
terminaux	t ɛ ʁ m i n o
terminer	t ɛ ʁ m i n e
terminé	t ɛ ʁ m i n e
terne	t ɛ ʁ n
terrain	t ɛ ʁ ɛ̃
terre	t ɛ ʁ
terres	t ɛ ʁ
terrible	t ɛ ʁ i b l
terriblement	t ɛ ʁ i b l ə m ɑ̃
terrier	t ɛ ʁ j e
territoire	t ɛ ʁ i t w a ʁ
tes	t e
tesla	t e s l a
testament	t ɛ s t a m ɑ̃
testant	t ɛ s t ɑ̃
tester	t ɛ s t e
testostérone	t ɛ s t ɔ s t e ʁ ɔ n
texte	t ɛ k s t
textes	t ɛ k s t
textile	t ɛ k s t i l
tgv	t e ʒ e v e
thaïlandais	t a j l ɑ̃ d ɛ
thibault	t i b o
thierry	t j ɛ ʁ i
thomas	t ɔ m ɑ
thon	t ɔ̃
thème	t ɛ m
thèmes	t ɛ m
thèse	t ɛ z
thématique	t e m a t i k
thématiques	t e m a t i k
théo	t e o
théorie	t e ɔ ʁ i
thérapeutique	t e ʁ a p ø t i k
thérapie	t e ʁ a p i
thérèse	t e ʁ ɛ z
théâtrales	t e a t ʁ a l
théâtraux	t e a t ʁ o
théâtres	t e a t ʁ
tibia	t i b j a
ticket	t i k ɛ
tienne	t j ɛ n
tiens	t j ɛ̃
tierce	t j ɛ ʁ s
tige	t i ʒ
tigre	t i ɡ ʁ
timbale	t ɛ̃ b a l
timbre	t ɛ̃ b ʁ
tin	t ɛ̃
tinée	t i n e
tir	t i ʁ
tirade	t i ʁ a d
tirage	t i ʁ a ʒ
tiramisus	t i ʁ a m i z u
tirant	t i ʁ ɑ̃
tire	t i ʁ
tirer	t i ʁ e
tireur	t i ʁ œ ʁ
tiroir	t i ʁ w a ʁ
tiroirs	t i ʁ w a ʁ
tiré	t i ʁ e
titanesque	t i t a n ɛ s k
titi	t i t i
titre	t i t ʁ
tituber	t i t y b e
togo	t o ɡ o
toile	t w a l
toilettes	t w a l ɛ t
toilèrent	t w a l ɛ ʁ
toit	t w a
tokyo	t o k j o
tollé	t ɔ l e
tolérance	t ɔ l e ʁ ɑ̃ s
tolérante	t ɔ l e ʁ ɑ̃ t
tom	t ɔ m
tombeau	t ɔ̃ b o
tombeur	t ɔ̃ b œ ʁ
tombeurs	t ɔ̃ b œ ʁ
tombeuse	t ɔ̃ b ø z
tondre	t ɔ̃ d ʁ
tonitruante	t ɔ n i t ʁ y ɑ̃ t
tonne	t ɔ n
toque	t ɔ k
torche	t ɔ ʁ ʃ
torrent	t ɔ ʁ ɑ̃
torse	t ɔ ʁ s
tortue	t ɔ ʁ t y
torture	t ɔ ʁ t y ʁ
total	t ɔ t a l
totale	t ɔ t a l
totalement	t ɔ t a l m ɑ̃
totales	t ɔ t a l
totalitaire	t ɔ t a l i t ɛ ʁ
totalité	t ɔ t a l i t e
toucha	t u ʃ a
touche	t u ʃ
toucher	t u ʃ e
touché	t u ʃ e
touffe	t u f
toujours	t u ʒ u ʁ
toulon	t u l ɔ̃
toulouse	t u l u z
tour	t u ʁ
tourbe	t u ʁ b
tourbières	t u ʁ b j ɛ ʁ
tourisme	t u ʁ i z m
tourmentez	t u ʁ m ɑ̃ t e
tournant	t u ʁ n ɑ̃
tournante	t u ʁ n ɑ̃ t
tourner	t u ʁ n e
tournée	t u ʁ n e
tours	t u ʁ
tousser	t u s e
tout	t u
toute	t u t
toutefois	t u t ə f w a
toutes	t u t
toxicomanie	t ɔ k s i k ɔ m a n i
toxiques	t ɔ k s i k
tracteur	t ʁ a k t œ ʁ
traction	t ʁ a k s j ɔ̃
traditionnel	t ʁ a d i s j ɔ n ɛ l
traditions	t ʁ a d i s j ɔ̃
traduction	t ʁ a d y k s j ɔ̃
traduire	t ʁ a d ɥ i ʁ
trafic	t ʁ a f i k
trafics	t ʁ a f i k
tragique	t ʁ a ʒ i k
tragédie	t ʁ a ʒ e d i
tragédies	t ʁ a ʒ e d i
trahi	t ʁ a i
train	t ʁ ɛ̃
traine	t ʁ e n
trainent	t ʁ e n
traite	t ʁ ɛ t
traitement	t ʁ ɛ t m ɑ̃
traiter	t ʁ ɛ t e
trajet	t ʁ a ʒ ɛ
tram	t ʁ a m
tramway	t ʁ a m w ɛ
tranchant	t ʁ ɑ̃ ʃ ɑ̃
tranche	t ʁ ɑ̃ ʃ
tranchée	t ʁ ɑ̃ ʃ e
tranquille	t ʁ ɑ̃ k i l
tranquilles	t ʁ ɑ̃ k i l
transaction	t ʁ ɑ̃ z a k s j ɔ̃
transcender	t ʁ ɑ̃ s ɑ̃ d e
transcription	t ʁ ɑ̃ s k ʁ i p s j ɔ̃
transformateur	t ʁ ɑ̃ s f ɔ ʁ m a t œ ʁ
transformation	t ʁ ɑ̃ s f ɔ ʁ m a s j ɔ̃
transformer	t ʁ ɑ̃ s f ɔ ʁ m e
transférer	t ʁ ɑ̃ s f e ʁ e
transgenèse	t ʁ ɑ̃ s ʒ ə n ɛ z
transmettre	t ʁ ɑ̃ s m ɛ t ʁ
transmission	t ʁ ɑ̃ s m i s j ɔ̃
transmissions	t ʁ ɑ̃ s m i s j ɔ̃
transport	t ʁ ɑ̃ s p ɔ ʁ
transporter	t ʁ ɑ̃ s p ɔ ʁ t e
transposée	t ʁ ɑ̃ s p o z e
trappe	t ʁ a p
traumatisante	t ʁ o m a t i z ɑ̃ t
travail	t ʁ a v a j
travaillant	t ʁ a v a j ɑ̃
travailler	t ʁ a v a j e
travaux	t ʁ a v o
travers	t ʁ a v ɛ ʁ
traversait	t ʁ a v ɛ ʁ s ɛ
traverse	t ʁ a v ɛ ʁ s
traversent	t ʁ a v ɛ ʁ s
traverser	t ʁ a v ɛ ʁ s e
traversée	t ʁ a v ɛ ʁ s e
travestir	t ʁ a v ɛ s t i ʁ
traître	t ʁ ɛ t ʁ
tremblement	t ʁ ɑ̃ b l ə m ɑ̃
trempe	t ʁ ɑ̃ p
trempette	t ʁ ɑ̃ p ɛ t
tremplin	t ʁ ɑ̃ p l ɛ̃
trente	t ʁ ɑ̃ t
tri	t ʁ i
triangle	t ʁ i j ɑ̃ ɡ l
triangulaire	t ʁ i j ɑ̃ ɡ y l ɛ ʁ
tribale	t ʁ i b a l
tribun	t ʁ i b œ̃
tribunal	t ʁ i b y n a l
tribunaux	t ʁ i b y n o
tribune	t ʁ i b y n
tribut	t ʁ i b y
tricolore	t ʁ i k ɔ l ɔ ʁ
trimballer	t ʁ ɛ̃ b a l e
trimestre	t ʁ i m ɛ s t ʁ
trio	t ʁ i j o
triomphe	t ʁ i j ɔ̃ f
triompher	t ʁ i j ɔ̃ f e
tripartite	t ʁ i p a ʁ t i t
tripes	t ʁ i p
triple	t ʁ i p l
triplé	t ʁ i p l e
tristan	t ʁ i s t ɑ̃
triste	t ʁ i s t
tristesse	t ʁ i s t ɛ s
trombone	t ʁ ɔ̃ b ɔ n
trompe	t ʁ ɔ̃ p
tromper	t ʁ ɔ̃ p e
tronc	t ʁ ɔ̃
tronçonneuse	t ʁ ɔ̃ s ɔ n ø z
trop	t ʁ o
troquer	t ʁ ɔ k e
trottiner	t ʁ ɔ t i n e
trottoir	t ʁ ɔ t w a ʁ
trou	t ʁ u
trouble	t ʁ u b l
trouer	t ʁ u e
troupe	t ʁ u p
trousses	t ʁ u s
trouve	t ʁ u v
trouvent	t ʁ u v
trouver	t ʁ u v e
trouvons	t ʁ u v ɔ̃
trouvé	t ʁ u v e
trublion	t ʁ y b l i j ɔ̃
truchement	t ʁ y ʃ m ɑ̃
truffe	t ʁ y f
trust	t ʁ œ s t
très	t ʁ ɛ
trésor	t ʁ e z ɔ ʁ
trésorerie	t ʁ e z ɔ ʁ ə ʁ i
trésorier	t ʁ e z ɔ ʁ j e
trône	t ʁ o n
ttc	t e t e s e
tu	t y
tuba	t y b a
tube	t y b
tuberculose	t y b ɛ ʁ k y l o z
tue	t y
tuent	t y
tuer	t ɥ e
tueur	t ɥ œ ʁ
tueurs	t ɥ œ ʁ
tuile	t ɥ i l
tuiles	t ɥ i l
tumeur	t y m œ ʁ
tunis	t y n i s
tunisie	t y n i z i
tunnel	t y n ɛ l
tupperware	t y p ə ʁ w a ʁ
tuque	t y k
turc	t y ʁ k
turin	t y ʁ ɛ̃
turkménistan	t y ʁ k m e n i s t ɑ̃
turpin	t y ʁ p ɛ̃
turque	t y ʁ k
turquoise	t y ʁ k w a z
tutelle	t y t ɛ l
tutsie	t u t s i
tuyau	t ɥ i j o
tva	t e v e a
twist	t w i s t
twitter	t w i t e
type	t i p
tâches	t ɑ ʃ
télé	t e l e
téléchargement	t e l e ʃ a ʁ ʒ ə m ɑ̃
téléchargements	t e l e ʃ a ʁ ʒ ə m ɑ̃
télécharger	t e l e ʃ a ʁ ʒ e
télécommande	t e l e k ɔ m ɑ̃ d
téléjournal	t e l e ʒ u ʁ n a l
téléphone	t e l e f ɔ n
téléphoner	t e l e f ɔ n e
téléphones	t e l e f ɔ n
téléviseur	t e l e v i z œ ʁ
télévision	t e l e v i z j ɔ̃
témoigner	t e m w a ɲ e
témoin	t e m w ɛ̃
tôle	t o l
tôt	t o
ua	y a
ulcère	y l s ɛ ʁ
underground	œ̃ d ɛ ʁ ɡ ʁ a w n d
uni	y n i
unilatéral	y n i l a t e ʁ a l
union	y n j ɔ̃
unit	y n i
unité	y n i t e
unités	y n i t e
univers	y n i v ɛ ʁ
université	y n i v ɛ ʁ s i t e
universités	y n i v ɛ ʁ s i t e
uranie	y ʁ a n i
uranium	y ʁ a n j ɔ m
urbain	y ʁ b ɛ̃
urgence	y ʁ ʒ ɑ̃ s
urgences	y ʁ ʒ ɑ̃ s
urgent	y ʁ ʒ ɑ̃
urgente	y ʁ ʒ ɑ̃ t
urgentes	y ʁ ʒ ɑ̃ t
urgents	y ʁ ʒ ɑ̃
urne	y ʁ n
urnes	y ʁ n
urss	y ɛ ʁ ɛ s ɛ s
uruguay	y ʁ y ɡ w e
usa	y z a
usager	y z a ʒ e
usages	y z a ʒ
usassent	y z a s
use	y z
usent	y z
user	y z e
usine	y z i n
usité	y z i t e
usure	y z y ʁ
utah	y t ɑ
utile	y t i l
utilisateur	y t i l i z a t œ ʁ
utiliser	y t i l i z e
utilisé	y t i l i z e
utilité	y t i l i t e
va	v a
vacances	v a k ɑ̃ s
vacant	v a k ɑ̃
vacarme	v a k a ʁ m
vacciner	v a k s i n e
vacher	v a ʃ e
vacillante	v a s i j ɑ̃ t
vague	v a ɡ
vagues	v a ɡ
vaillancourt	v a j ɑ̃ k u ʁ
vaillant	v a j ɑ̃
vain	v ɛ̃
vainement	v ɛ n m ɑ̃
vainqueur	v ɛ̃ k œ ʁ
vais	v ɛ
vaisselle	v ɛ s ɛ l
val	v a l
valence	v a l ɑ̃ s
valeur	v a l œ ʁ
valeurs	v a l œ ʁ
valider	v a l i d e
valises	v a l i z
vallée	v a l e
valois	v a l w a
valoriser	v a l ɔ ʁ i z e
valve	v a l v
valérie	v a l e ʁ i
valéry	v a l e ʁ i
vampire	v ɑ̃ p i ʁ
vampires	v ɑ̃ p i ʁ
van	v ɑ̃
vapeur	v a p œ ʁ
variable	v a ʁ j a b l
variante	v a ʁ j ɑ̃ t
variation	v a ʁ j a s j ɔ̃
varsovie	v a ʁ s ɔ v i
vasculaire	v a s k y l ɛ ʁ
vaucluse	v o k l y z
vaud	v o
vautres	v o t ʁ
vecteur	v ɛ k t œ ʁ
vedette	v ə d ɛ t
veille	v ɛ j
veine	v ɛ n
velouté	v ə l u t e
venaient	v ə n ɛ
venais	v ə n ɛ
venait	v ə n ɛ
venant	v ə n ɑ̃
vend	v ɑ̃
vendent	v ɑ̃ d
vendons	v ɑ̃ d ɔ̃
vendre	v ɑ̃ d ʁ
vendredi	v ɑ̃ d ʁ ə d i
vends	v ɑ̃
vendu	v ɑ̃ d y
vendée	v ɑ̃ d e
venezuela	v e n e z ɥ e l a
vengeance	v ɑ̃ ʒ ɑ̃ s
venger	v ɑ̃ ʒ e
venise	v ə n i z
vent	v ɑ̃
vente	v ɑ̃ t
ventilateur	v ɑ̃ t i l a t œ ʁ
ventouse	v ɑ̃ t u z
ventre	v ɑ̃ t ʁ
venu	v ə n y
venue	v ə n y
ver	v ɛ ʁ
verbale	v ɛ ʁ b a l
verbaliser	v ɛ ʁ b a l i z e
verbaux	v ɛ ʁ b o
verdict	v ɛ ʁ d i k t
verdir	v ɛ ʁ d i ʁ
vergogne	v ɛ ʁ ɡ ɔ ɲ
vernis	v ɛ ʁ n i
vernissage	v ɛ ʁ n i s a ʒ
verra	v ɛ ʁ a
verrai	v ɛ ʁ e
verras	v ɛ ʁ ɑ
verre	v ɛ ʁ
verrière	v ɛ ʁ j ɛ ʁ
verrouiller	v ɛ ʁ u j e
versatilité	v ɛ ʁ s a t i l i t e
verset	v ɛ ʁ s ɛ
vert	v ɛ ʁ
verte	v ɛ ʁ t
vertement	v ɛ ʁ t ə m ɑ̃
vertige	v ɛ ʁ t i ʒ
vertu	v ɛ ʁ t y
verve	v ɛ ʁ v
vesce	v ɛ s
vestiaire	v ɛ s t j ɛ ʁ
veuillez	v œ j e
veuve	v œ v
via	v j a
viaduc	v j a d y k
viande	v j ɑ̃ d
vibration	v i b ʁ a s j ɔ̃
vibrer	v i b ʁ e
vice	v i s
vichy	v i ʃ i
vicieux	v i s j ø
victime	v i k t i m
victoire	v i k t w a ʁ
vidéo	v i d e o
vie	v i
vieil	v j ɛ j ‿
vieillard	v j ɛ j a ʁ
vieillir	v j ɛ j i ʁ
vieillissant	v j ɛ j i s ɑ̃
vieillissement	v j ɛ j i s m ɑ̃
viendra	v j ɛ̃ d ʁ a
viendront	v j ɛ̃ d ʁ ɔ̃
vienne	v j ɛ n
viennent	v j ɛ n
viens	v j ɛ̃
vient	v j ɛ̃
vierge	v j ɛ ʁ ʒ
vies	v i
vietnam	v j ɛ t n a m
vietnamien	v j ɛ t n a m j ɛ̃
vieux	v j ø
vif	v i f
vifs	v i f
vigilant	v i ʒ i l ɑ̃
vignoble	v i ɲ ɔ b l
vigoureusement	v i ɡ u ʁ ø z m ɑ̃
vigueur	v i ɡ œ ʁ
viguier	v i ɡ j e
vilain	v i l ɛ̃
vilaine	v i l ɛ n
vilains	v i l ɛ̃
vilebrequin	v i l b ʁ ə k ɛ̃
villa	v i l a
village	v i l a ʒ
villes	v i l
villette	v i l ɛ t
vin	v ɛ̃
vinaigre	v i n ɛ ɡ ʁ
vindicte	v ɛ̃ d i k t
vingtième	v ɛ̃ t j ɛ m
vins	v ɛ̃
viol	v j ɔ l
violaine	v j ɔ l ɛ n
viole	v j ɔ l
violemment	v j ɔ l a m ɑ̃
violence	v j ɔ l ɑ̃ s
violences	v j ɔ l ɑ̃ s
violet	v j ɔ l ɛ
violette	v j ɔ l ɛ t
violoncelle	v j ɔ l ɔ̃ s ɛ l
virement	v i ʁ m ɑ̃
virginie	v i ʁ ʒ i n i
virgule	v i ʁ ɡ y l
virtuel	v i ʁ t ɥ ɛ l
virtuose	v i ʁ t ɥ o z
virulent	v i ʁ y l ɑ̃
virus	v i ʁ y s
visa	v i z a
visage	v i z a ʒ
viser	v i z e
viseur	v i z œ ʁ
visibilité	v i z i b i l i t e
visible	v i z i b l
vision	v i z j ɔ̃
visitant	v i z i t ɑ̃
visite	v i z i t
visiter	v i z i t e
visites	v i z i t
vitale	v i t a l
vite	v i t
vitre	v i t ʁ
vivement	v i v m ɑ̃
viviane	v i v j a n
vivienne	v i v j ɛ n
vivier	v i v j e
vivoterez	v i v ɔ t ʁ e
vocale	v ɔ k a l
vocales	v ɔ k a l
vocaux	v ɔ k o
voici	v w a s i
voila	v w a l a
voile	v w a l
voiles	v w a l
voilier	v w a l j e
voilà	v w a l a
voire	v w a ʁ
voirie	v w a ʁ i
voisin	v w a z ɛ̃
voisinage	v w a z i n a ʒ
voisine	v w a z i n
voisines	v w a z i n
voiture	v w a t y ʁ
voitures	v w a t y ʁ
vol	v ɔ l
volatile	v ɔ l a t i l
volatilité	v ɔ l a t i l i t e
volcan	v ɔ l k ɑ̃
volcanique	v ɔ l k a n i k
volcaniques	v ɔ l k a n i k
voler	v ɔ l e
voleur	v ɔ l œ ʁ
volleyball	v ɔ l ɛ b o l
volontaire	v ɔ l ɔ̃ t ɛ ʁ
volontariat	v ɔ l ɔ̃ t a ʁ j a
volontiers	v ɔ l ɔ̃ t j e
voltigeur	v ɔ l t i ʒ œ ʁ
volume	v ɔ l y m
volée	v ɔ l e
vomi	v ɔ m i
vont	v ɔ̃
vos	v o
vosges	v o ʒ
votants	v ɔ t ɑ̃
votation	v ɔ t a s j ɔ̃
vous	v u
voyage	v w a j a ʒ
voyager	v w a j a ʒ e
voyages	v w a j a ʒ
voyageurs	v w a j a ʒ œ ʁ
voyant	v w a j ɑ̃
voyou	v w a j u
vrac	v ʁ a k
vrai	v ʁ ɛ
vraiment	v ʁ ɛ m ɑ̃
vrille	v ʁ i j
vtt	v e t e t e
vu	v y
vue	v y
vues	v y
végétal	v e ʒ e t a l
végétales	v e ʒ e t a l
véhicule	v e i k y l
vélocité	v e l ɔ s i t e
vélos	v e l o
vénus	v e n y s
vérifier	v e ʁ i f j e
véritable	v e ʁ i t a b l
véronique	v e ʁ ɔ n i k
vésuve	v e z y v
vétérinaire	v e t e ʁ i n ɛ ʁ
vêtement	v ɛ t m ɑ̃
vêtements	v ɛ t m ɑ̃
wallonie	w a l ɔ n i
washington	w a ʃ i ŋ t ɔ n
water	w a t ɛ ʁ
web	w ɛ b
webcam	w ɛ b k a m
weber	v e b ɛ ʁ
western	w ɛ s t ɛ ʁ n
whisky	w i s k i
wiki	w i k i
william	w i l j a m
wilson	w i l s ɔ̃
wolof	w ɔ l ɔ f
xénophobie	ɡ z e n ɔ f ɔ b i
yacht	j ɔ t
yang	j ɑ̃ ɡ
yannick	j a n i k
yard	j a ʁ d
yen	j ɛ n
yes	j ɛ s
yoga	j o ɡ a
youyou	j u j u
yvelines	i v l i n
yves	i v
yvon	i v ɔ̃
yéménite	j e m e n i t
yéménites	j e m e n i t
zagreb	z a ɡ ʁ ɛ b
zambie	z ɑ̃ b i
zaperaient	z a p ʁ ɛ
zapping	z a p i ŋ
zen	z ɛ n
zizi	z i z i
zombie	z ɔ̃ b i
zone	z o n
zonerais	z o n ʁ ɛ
zones	z o n
zoom	z u m
zou	z u
zoziau	z o z j o
zèle	z ɛ l
zénith	z e n i t
zéro	z e ʁ o
âge	ɑ ʒ
âgé	ɑ ʒ e
âpre	ɑ p ʁ
ère	ɛ ʁ
ébaubi	e b o b i
ébauche	e b o ʃ
ébouions	e b u j ɔ̃
écarter	e k a ʁ t e
échanger	e ʃ ɑ̃ ʒ e
échantillon	e ʃ ɑ̃ t i j ɔ̃
échapper	e ʃ a p e
écharpe	e ʃ a ʁ p
échauffer	e ʃ o f e
échec	e ʃ ɛ k
échecs	e ʃ ɛ k
échelle	e ʃ ɛ l
échelonnent	e ʃ l ɔ n
échelonner	e ʃ l ɔ n e
échelonnerait	e ʃ l ɔ n ʁ ɛ
échiquier	e ʃ i k j e
écho	e k o
échouer	e ʃ w e
échéance	e ʃ e ɑ̃ s
éclair	e k l ɛ ʁ
éclairage	e k l ɛ ʁ a ʒ
éclairages	e k l ɛ ʁ a ʒ
éclaircir	e k l ɛ ʁ s i ʁ
éclat	e k l a
éclatant	e k l a t ɑ̃
éclectique	e k l ɛ k t i k
éclipses	e k l i p s
école	e k ɔ l
écolier	e k ɔ l j e
écolo	e k ɔ l o
écologie	e k ɔ l ɔ ʒ i
écologiste	e k ɔ l ɔ ʒ i s t
économique	e k ɔ n ɔ m i k
économiquement	e k ɔ n ɔ m i k m ɑ̃
économiser	e k ɔ n ɔ m i z e
économiste	e k ɔ n ɔ m i s t
écoper	e k ɔ p e
écopé	e k ɔ p e
écorce	e k ɔ ʁ s
écorcher	e k ɔ ʁ ʃ e
écorché	e k ɔ ʁ ʃ e
écossais	e k ɔ s ɛ
écran	e k ʁ ɑ̃
écraser	e k ʁ a z e
écriaient	e k ʁ i j ɛ
écrire	e k ʁ i ʁ
écrit	e k ʁ i
écriture	e k ʁ i t y ʁ
écrivain	e k ʁ i v ɛ̃
écrivaine	e k ʁ i v ɛ n
écrié	e k ʁ i j e
écrouler	e k ʁ u l e
écueil	e k œ j
écumant	e k y m ɑ̃
écumer	e k y m e
écurie	e k y ʁ i
écusson	e k y s ɔ̃
édifice	e d i f i s
édith	e d i t
édition	e d i s j ɔ̃
éduquer	e d y k e
égale	e ɡ a l
également	e ɡ a l m ɑ̃
égales	e ɡ a l
égaliser	e ɡ a l i z e
égalitaire	e ɡ a l i t ɛ ʁ
égalité	e ɡ a l i t e
égard	e ɡ a ʁ
égards	e ɡ a ʁ
égide	e ʒ i d
église	e ɡ l i z
égratignait	e ɡ ʁ a t i ɲ ɛ
égratignerions	e ɡ ʁ a t i ɲ ə ʁ j ɔ̃
égypte	e ʒ i p t
égyptien	e ʒ i p s j ɛ̃
élan	e l ɑ̃
élargir	e l a ʁ ʒ i ʁ
élargissons	e l a ʁ ʒ i s ɔ̃
élargit	e l a ʁ ʒ i
électeurs	e l ɛ k t œ ʁ
élection	e l ɛ k s j ɔ̃
électorale	e l ɛ k t ɔ ʁ a l
électorales	e l ɛ k t ɔ ʁ a l
électorat	e l ɛ k t ɔ ʁ a
électoraux	e l ɛ k t ɔ ʁ o
électricité	e l ɛ k t ʁ i s i t e
électriques	e l ɛ k t ʁ i k
électro	e l ɛ k t ʁ o
élevage	e l v a ʒ
élevé	e l v e
élisabeth	e l i z a b ɛ t
élodie	e l ɔ d i
éloigner	e l w a ɲ e
éloigné	e l w a ɲ e
élu	e l y
élue	e l y
élus	e l y
élysée	e l i z e
élève	e l ɛ v
élégance	e l e ɡ ɑ̃ s
élégante	e l e ɡ ɑ̃ t
élégantes	e l e ɡ ɑ̃ t
élégants	e l e ɡ ɑ̃
émerger	e m ɛ ʁ ʒ e
émettre	e m ɛ t ʁ
éminemment	e m i n a m ɑ̃
éminent	e m i n ɑ̃
éminents	e m i n ɑ̃
émir	e m i ʁ
émission	e m i s j ɔ̃
émotion	e m o s j ɔ̃
émotionnel	e m o s j ɔ n ɛ l
émousser	e m u s e
ému	e m y
émue	e m y
émuler	e m y l e
énergie	e n ɛ ʁ ʒ i
énergique	e n ɛ ʁ ʒ i k
énergiquement	e n ɛ ʁ ʒ i k m ɑ̃
énonciatrice	e n ɔ̃ s j a t ʁ i s
énorme	e n ɔ ʁ m
énormes	e n ɔ ʁ m
énormément	e n ɔ ʁ m e m ɑ̃
éolien	e ɔ l j ɛ̃
épais	e p ɛ
épaisseur	e p ɛ s œ ʁ
épars	e p a ʁ
épaule	e p o l
épauler	e p o l e
épaules	e p o l
épave	e p a v
éperdument	e p ɛ ʁ d y m ɑ̃
épicerie	e p i s ʁ i
épidémie	e p i d e m i
épidémies	e p i d e m i
épilogue	e p i l ɔ ɡ
épineux	e p i n ø
épingle	e p ɛ̃ ɡ l
épisode	e p i z ɔ d
éponge	e p ɔ̃ ʒ
éponger	e p ɔ̃ ʒ e
éponyme	e p ɔ n i m
époque	e p ɔ k
épouse	e p u z
épouser	e p u z e
époustouflais	e p u s t u f l ɛ
époux	e p u
épreuve	e p ʁ œ v
épris	e p ʁ i
épuiser	e p ɥ i z e
épuisé	e p ɥ i z e
épuré	e p y ʁ e
équateur	e k w a t œ ʁ
équilibre	e k i l i b ʁ
équin	e k ɛ̃
équipage	e k i p a ʒ
équipier	e k i p j e
équitable	e k i t a b l
équité	e k i t e
équivalent	e k i v a l ɑ̃
érable	e ʁ a b l
éric	e ʁ i k
érigeant	e ʁ i ʒ ɑ̃
érigeât	e ʁ i ʒ ɑ
érigé	e ʁ i ʒ e
érotique	e ʁ ɔ t i k
éruption	e ʁ y p s j ɔ̃
ésotériques	e z ɔ t e ʁ i k
établi	e t a b l i
établir	e t a b l i ʁ
établissement	e t a b l i s m ɑ̃
étage	e t a ʒ
étais	e t ɛ
était	e t ɛ
étaler	e t a l e
étalon	e t a l ɔ̃
étant	e t ɑ̃
étape	e t a p
état	e t a
éteignez	e t ɛ ɲ e
éteindre	e t ɛ̃ d ʁ
éteint	e t ɛ̃
étendre	e t ɑ̃ d ʁ
étendu	e t ɑ̃ d y
étendue	e t ɑ̃ d y
éternel	e t ɛ ʁ n ɛ l
éthique	e t i k
éthiques	e t i k
étienne	e t j ɛ n
étincelant	e t ɛ̃ s l ɑ̃
étions	e t j ɔ̃
étiquette	e t i k ɛ t
étoffer	e t ɔ f e
étoile	e t w a l
étoiles	e t w a l
étoilé	e t w a l e
étonnant	e t ɔ n ɑ̃
étonnante	e t ɔ n ɑ̃ t
étonnement	e t ɔ n m ɑ̃
étonner	e t ɔ n e
étouffant	e t u f ɑ̃
étourdissant	e t u ʁ d i s ɑ̃
étrangement	e t ʁ ɑ̃ ʒ m ɑ̃
étranger	e t ʁ ɑ̃ ʒ e
étrangère	e t ʁ ɑ̃ ʒ ɛ ʁ
étroit	e t ʁ w a
étude	e t y d
études	e t y d
étudiant	e t y d j ɑ̃
étudiante	e t y d j ɑ̃ t
étudier	e t y d j e
étuis	e t ɥ i
évacuer	e v a k ɥ e
évaluer	e v a l ɥ e
évalué	e v a l ɥ e
évaluée	e v a l ɥ e
évaluées	e v a l ɥ e
évalués	e v a l ɥ e
évasion	e v a z j ɔ̃
éveiller	e v ɛ j e
éventail	e v ɑ̃ t a j
éventuellement	e v ɑ̃ t ɥ ɛ l m ɑ̃
évidence	e v i d ɑ̃ s
évidente	e v i d ɑ̃ t
évinçons	e v ɛ̃ s ɔ̃
évitables	e v i t a b l
éviter	e v i t e
évolue	e v ɔ l y
évoluer	e v ɔ l ɥ e
évolution	e v ɔ l y s j ɔ̃
évoquer	e v ɔ k e
évènement	e v ɛ n m ɑ̃
événement	e v ɛ n m ɑ̃
évêque	e v ɛ k
êtes	ɛ t
êtres	ɛ t ʁ
île	i l
îles	i l
œuf	œ f
œuvre	œ v ʁ
