abdest	ǎ b d e s t
abdikacija	a b d i k ǎː t͡s i j a
abdomen	a b d ǒː m e n
abeceda	a b e t͡s ěː d a
abnormalnost	a b n o r m ǎː l n oː s t
adaptirati	a d a p t ǐː r a t i
adekvatan	â d e k ʋ aː t a n
adekvatno	â d e k ʋ aː t n o
administracija	a d m i n i s t r ǎː t͡s i j a
administrator	a d m i n ǐ s t r aː t o r
admiral	a d m ǐ r aː l
adrenalin	a d r e n ǎ l iː n
adrenalinski	a d r e n ǎ l iː n s k iː
adresa	a d r ě s a
adresirati	a d r e s ǐː r a t i
adut	ǎ d uː t
advokat	a d ʋ ǒ k aː t
aerobik	a e r ǒ b i k
aerobika	a e r ǒ b i k a
aerodinamičan	a e r o d i n ǎ m i t͡ʃ a n
aerodromski	a e r ǒ d r o m s k iː
afera	a f ěː r a
afganistanski	a f ɡ a n ǐ s t aː n s k iː
afirmiran	a f ǐ r m iː r aː n
afrički	ǎ f r i t͡ʃ k iː
agencija	a ɡ ě n t͡s i j a
agent	ǎ ɡ e n t
agnostik	a ɡ n ǒ s t i k
agonija	a ɡ ǒ n i j a
agresivan	â ɡ r e s iː ʋ a n
agresivno	â ɡ r e s iː ʋ n o
agresor	ǎ ɡ r e s o r
ahiret	ǎː x i r e t
ajam	ǎː j a m
ajde	ǎ j d e
ajkula	â j k u l a
ajme	ǎ j m e
ajmo	ǎ j m o
akademija	a k a d ě m i j a
akademik	a k a d ě m i k
akcenat	ǎ k t͡s e n a t
akcent	ǎ k t͡s e n t
akcija	ǎ k t͡s i j a
akord	ǎ k o r d
akt	â k t
akter	ǎ k t eː r
aktiva	a k t ǐː ʋ a
aktivan	â k t iː ʋ a n
aktivirati	a k t i ʋ ǐː r a t i
aktivist	a k t ǐ ʋ i s t
aktivistkinja	a k t ǐ ʋ i s t k i ɲ a
aktivizam	a k t i ʋ ǐ z a m
aktivno	â k t iː ʋ n o
aktivnost	a k t ǐː ʋ n oː s t
aktualan	â k t u aː l a n
aktualizirati	a k t u a l i z ǐː r a t i
aktuelan	â k t u eː l a n
akumulacija	a k u m u l ǎː t͡s i j a
akumulator	a k u m ǔ l aː t o r
akupunktura	a k u p u n k t ǔː r a
akustički	a k ǔ s t i t͡ʃ k iː
akvizicija	a k ʋ i z ǐː t͡s i j a
alabama	a l a b ǎ m a
alarm	ǎ l a r m
alat	ǎ l aː t
albanac	a l b ǎː n a t͡s
albin	ǎ l b iː n
album	ǎ l b uː m
aleksandar	a l ě k s aː n d a r
alergičan	a l ě r ɡ i t͡ʃ a n
aleutski	a l ě u t s k iː
alfa	â l f a
alfabetizam	a l f a b e t ǐ z a m
algoritam	a l ɡ o r ǐ t a m
ali	â l i
alkohol	ǎ l k o x o l
alkoholiziran	a l k o x o l ǐ z iː r a n
alkoholičar	a l k o x ǒ l i t͡ʃ aː r
alkoholni	ǎ l k o x o l n iː
alpe	âː l p e
alpinist	a l p ǐ n i s t
alternativan	â l t e r n a t iː ʋ a n
aluzija	ǎ l uː z i j a
alžirski	ǎ l ʒ iː r s k iː
amajlija	a m ǎ j l i j a
aman	ǎ m aː n
amandman	a m ǎ n d m aː n
ambalaža	a m b a l ǎː ʒ a
ambasador	a m b ǎ s aː d o r
ambiciozno	â m b i t͡s i oː z n o
ambijent	a m b ǐ j e n t
ambis	ǎ m b i s
ambivalentnost	a m b i ʋ ǎ l e n t n oː s t
ambrozija	ǎ m b r oː z i j a
amer	â m e r
amerika	a m ě r i k a
amerikanac	a m e r i k ǎː n a t͡s
amerikanka	a m e r ǐ k aː n k a
ametist	a m ě t i s t
amfiteatralan	a m f i t ě a t r aː l a n
amfora	ǎ m f o r a
aminokiselina	a m i n o k i s e l ǐ n a
amplituda	a m p l i t ǔː d a
amputacija	a m p u t ǎː t͡s i j a
amputirati	a m p u t ǐː r a t i
anadolija	a n a d ǒː l i j a
analfabet	a n a l f ǎ b eː t
analitičar	a n a l ǐ t i t͡ʃ aː r
analiza	a n a l ǐː z a
analizator	a n a l ǐ z aː t o r
analni	ǎ n aː l n iː
analogno	â n a l o ɡ n o
anarhija	a n ǎ r x i j a
anason	a n ǎ s oː n
anastrofa	a n a s t r ǒː f a
anatom	a n ǎ t oː m
anatomija	a n a t ǒ m i j a
anda	a n d aː
andaluski	a n d ǎ l u s k iː
andaluzijski	a n d ǎ l u z i j s k iː
andora	a n d ôː r a
andrija	ǎ n d r i j a
anegdota	a n e ɡ d ǒ t a
angažiran	a n ɡ ǎ ʒ iː r a n
angažirati	a n ɡ a ʒ ǐː r a t i
anglosaski	a n ɡ l ǒ s a s k iː
animacija	a n i m ǎː t͡s i j a
animator	a n ǐ m aː t o r
animirati	a n i m ǐː r a t i
animizam	a n i m ǐ z a m
anka	âː n k a
anketa	a n k ě t a
anoda	a n ǒː d a
anodni	ǎ n oː d n iː
anomalija	a n o m ǎ l i j a
anoniman	â n o n iː m a n
anonimno	â n o n iː m n o
anorganski	â n o r ɡ aː n s k iː
antarktik	a n t ǎ r k t i k
antarktika	a n t ǎ r k t i k a
ante	ǎː n t e
antifašizam	a n t i f a ʃ ǐ z a m
antisemitizam	a n t i s e m i t ǐ z a m
antički	ǎ n t i t͡ʃ k iː
antologija	a n t o l ǒ ɡ i j a
antropologija	a n t r o p o l ǒ ɡ i j a
antun	ǎ n t uː n
anđelić	âː n d͡ʑ e l i t͡ɕ
anđeo	âː n d͡ʑ e o
aparthejd	â p a r t x e j d
apel	ǎ p e l
apetit	a p ě t iː t
aplicirati	a p l i t͡s ǐː r a t i
aplikacija	a p l i k ǎː t͡s i j a
apokalipsa	a p o k a l ǐ p s a
apostol	ǎ p o s t o l
april	ǎ p r iː l
aprilski	ǎ p r iː l s k iː
aproksimirati	a p r o k s i m ǐː r a t i
apsolutno	â p s o l uː t n o
apsorbirati	a p s o r b ǐː r a t i
apstinencija	a p s t i n ě n t͡s i j a
apstinirati	a p s t i n ǐː r a t i
apstrakt	ǎ p s t r a k t
apstraktan	ǎ p s t r a k t a n
apsurdno	ǎ p s u r d n o
arabeska	a r ǎ b e s k a
arabica	a r ǎ b i t͡s a
arabija	ǎ r aː b i j a
arabijski	a r ǎː b iː j s k iː
aranžman	a r ǎ n ʒ m aː n
arbitražni	â r b i t r aː ʒ n iː
arena	a r ěː n a
argentina	a r ɡ e n t ǐː n a
argentinac	a r ɡ e n t ǐː n a t͡s
argentinski	a r ɡ ě n t iː n s k iː
argument	a r ɡ ǔ m e n t
argumentacija	a r ɡ u m e n t ǎː t͡s i j a
arheolog	a r x e ǒ l o ɡ
arheologija	a r x e o l ǒ ɡ i j a
arheološki	a r x e ǒ l o ʃ k iː
arhipelag	a r x i p ě l aː ɡ
arhitekt	a r x ǐ t e k t
arhitektica	a r x ǐ t e k t i t͡s a
arhitektonski	a r x i t ě k t oː n s k iː
arhitektura	a r x i t e k t ǔː r a
aristokracija	a r i s t o k r ǎ t͡s i j a
armatura	a r m a t ǔː r a
armenac	a r m ěː n a t͡s
armenija	ǎ r m eː n i j a
arogancija	a r o ɡ ǎ n t͡s i j a
arogantan	a r o ɡ ǎ n t a n
arogantno	a r o ɡ ǎ n t n o
arsenal	a r s ě n aː l
artefakt	â r t e f a k t
arterija	ǎ r t eː r i j a
artikulirati	a r t i k u l ǐː r a t i
artiljerija	a r t i ʎ ě r i j a
artist	ǎ r t i s t
artičoka	a r t i t͡ʃ ǒː k a
artritis	a r t r ǐ t i s
as	â s
asfalt	ǎ s f a l t
asirski	ǎ s iː r s k iː
asistencija	a s i s t ě n t͡s i j a
asistent	a s ǐ s t e n t
asortiman	a s o r t ǐ m aː n
astma	ǎ s t m a
astrobiologija	a s t r o b i o l ǒ ɡ i j a
astronomija	a s t r o n ǒ m i j a
astronomski	a s t r ǒ n o m s k iː
ateist	a t ě i s t
ateizam	a t e ǐ z a m
atena	a t ěː n a
atentator	a t ě n t aː t o r
atina	a t ǐː n a
atlanta	a t l ǎ n t a
atlantida	a t l a n t ǐː d a
atlantik	a t l ǎ n t i k
atlantski	ǎ t l a n t s k iː
atletika	a t l ě t i k a
atletičar	a t l ě t i t͡ʃ aː r
atletičarka	a t l ě t i t͡ʃ aː r k a
atletski	ǎ t l eː t s k iː
atmosfera	a t m o s f ěː r a
atom	ǎ t oː m
atrakcija	a t r ǎ k t͡s i j a
atraktivan	â t r a k t iː ʋ a n
atribut	a t r ǐ b uː t
aukcija	a ǔ k t͡s i j a
australijanac	a u s t r a l i j ǎː n a t͡s
austrija	ǎ u s t r i j a
austrijanac	a u s t r i j ǎː n a t͡s
autentičan	a u t ě n t i t͡ʃ a n
autizam	a u t ǐ z a m
autobus	a u t ǒː b u s
autocesta	a u t o t͡s ě s t a
automat	a u t ǒ m aː t
automobilist	a u t o m o b ǐ l i s t
autonomija	a u t o n ǒ m i j a
autoportret	a u t o p ǒ r t r eː t
autoput	ǎ u t o p uː t
autoritativan	â u t o r i t a t iː ʋ a n
autoritet	a u t o r ǐ t eː t
avatar	a ʋ ǎ t aː r
avijacija	a ʋ i j ǎː t͡s i j a
aviokompanija	a ʋ i o k o m p ǎ n i j a
avion	a ʋ ǐ oː n
avioprijevoznik	a ʋ i o p r i j ěː ʋ o z n iː k
avlija	ǎ ʋ l i j a
avokado	a ʋ o k ǎː d o
azbest	ǎ z b e s t
azbuka	ǎ z b u k a
azerski	ǎ z e r s k iː
azijski	âː z iː j s k iː
azil	ǎ z iː l
azilant	a z ǐ l a n t
baba	b â b a
babo	b ǎː b o
bacanje	b ǎ t͡s aː ɲ e
bacati	b ǎ t͡s a t i
bacač	b ǎ t͡s aː t͡ʃ
badnjak	b â d ɲ aː k
bagdad	b ǎ ɡ d aː d
bager	b ǎː ɡ e r
bahatost	b ǎ x a t oː s t
bahrein	b ǎ x r e i n
bajka	b âː j k a
bajonet	b a j ǒ n eː t
bajram	b ǎ j r a m
baka	b ǎː k a
bakalar	b a k ǎ l aː r
bakar	b ǎ k a r
baklava	b a k l ǎ ʋ a
baklja	b â k ʎ a
bakterija	b ǎ k t eː r i j a
baku	b ǎ k u
balada	b a l ǎː d a
balansirati	b a l a n s ǐː r a t i
balavac	b â l a ʋ a t͡s
balerina	b a l e r ǐː n a
balet	b ǎ l eː t
balija	b ǎ l i j a
baljezgati	b a ʎ ě z ɡ a t i
balkon	b ǎ l k oː n
balon	b ǎ l oː n
balvan	b ǎ l ʋ a n
balzam	b ǎ l z a m
ban	b âː n
banana	b a n ǎː n a
bangkok	b ǎ n ɡ k o k
banja	b â ɲ a
bankar	b ǎ n k aː r
bankarski	b ǎ n k aː r s k iː
bankina	b a n k ǐː n a
bankrot	b ǎ n k r oː t
bankrotirati	b a n k r o t ǐː r a t i
bara	b â r a
baraka	b a r ǎ k a
baratati	b a r ǎ t a t i
barel	b ǎ r e l
barem	b ǎ r e m
barijera	b a r i j ěː r a
barjak	b ǎ r j aː k
barjaktar	b a r j ǎ k t aː r
baron	b ǎ r oː n
barun	b ǎ r uː n
baršun	b ǎ r ʃ uː n
bas	b â s
bataljun	b a t ǎ ʎ uː n
baterija	b ǎ t eː r i j a
baviti	b â ʋ i t i
baza	b ǎː z a
bazen	b ǎ z eː n
bazirati	b a z ǐː r a t i
bački	b âː t͡ʃ k iː
baš	b â ʃ
bašta	b ǎː ʃ t a
baština	b â ʃ t i n a
bašča	b ǎː ʃ t͡ʃ a
baščaršija	b â ʃ t͡ʃ a r ʃ i j a
bedem	b ě d e m
begunac	b e ɡ ǔː n a t͡s
behar	b ě x aː r
bejzbol	b ě j z b oː l
bekhend	b ê k x e n d
belaj	b ě l aː j
belance	b e l ǎː n t͡s e
belgija	b ěː l ɡ i j a
bend	b ê n d
benzen	b ě n z eː n
benzin	b ě n z iː n
beograđanin	b ê o ɡ r a d͡ʑ a n i n
beograđanka	b ê o ɡ r a d͡ʑ aː n k a
berba	b ě r b a
berlin	b ě r l iː n
berlinski	b ě r l iː n s k iː
berza	b ê r z a
beseda	b ě s e d a
beskompromisan	b ê s k o m p r o m i s a n
beskompromisno	b ê s k o m p r o m i s n o
beskonačno	b ê s k o n a t͡ʃ n o
beskonačnost	b ê s k o n a t͡ʃ n oː s t
beskoristan	b ê s k o r iː s t a n
beskraj	b ê s k r aː j
beskućnik	b ě s k u t͡ɕ n iː k
besmislen	b ě s m i s l e n
besmisleno	b ě s m i s l e n o
besmrtnost	b ě s m r t n oː s t
besparica	b ě s p a r i t͡s a
besplatan	b ě s p l a t a n
besplatno	b ě s p l a t n o
bespogovorno	b ê s p o ɡ o ʋ oː r n o
bespomoćno	b ê s p o m o t͡ɕ n o
bespomoćnost	b ê s p o m o t͡ɕ n oː s t
besposlenost	b ě s p o s l e n oː s t
besposličiti	b ě s p o s l i t͡ʃ i t i
bespravno	b ê s p r aː ʋ n o
besprijekoran	b e s p r j ěː k oː r a n
besprijekorno	b e s p r i j ěː k oː r n o
besprimeran	b e s p r ǐː m eː r a n
bespuće	b ě s p uː t͡ɕ e
besramno	b ê s r aː m n o
bestidno	b ê s t iː d n o
bestseler	b e s t s ě l e r
beta	b ê t a
beton	b ě t oː n
betonski	b ě t oː n s k iː
bevanda	b ě ʋ aː n d a
bezazlen	b e z ǎ z l e n
bezbednost	b ě z b e d n ôː s t
bezbrižno	b ě z b r i ʒ n o
bezbrižnost	b ě z b r i ʒ n oː s t
bezbroj	b ě z b r oː j
bezdušno	b ě z d u ʃ n o
bezgrešan	b ě z ɡ r e ʃ a n
bezidejno	b ê z i d eː j n o
bezmalo	b ě z m a l o
beznadno	b ě z n a d n o
beznađe	b ě z n aː d͡ʑ e
bezobrazan	b e z ǒ b r a z a n
bezobrazluk	b e z o b r ǎ z l u k
bezosjećajno	b ê z o s j e t͡ɕ aː j n o
bezočan	b ě z o t͡ʃ a n
bezumnik	b ě z uː m n iː k
bezuspješan	b e z ǔ s p j e ʃ a n
bezuspješno	b e z ǔ s p j e ʃ n o
bezvezno	b ě z ʋ e z n o
bezvoljan	b ê z ʋ oː ʎ a n
bezvrijedan	b ê z ʋ r i j e d a n
bezvrijedno	b ê z ʋ r j e d n o
bešćutnost	b ě ʃ t͡ɕ u t n oː s t
biber	b ǐ b e r
biblija	b ǐ b l i j a
biblioteka	b i b l i o t ěː k a
bibliotekarstvo	b i b l i o t e k ǎː r s t ʋ o
biceps	b ǐ t͡s e p s
biciklist	b i t͡s ǐ k l i s t
biciklizam	b i t͡s i k l ǐ z a m
bijedan	b i j êː d a n
bijedno	b j êː d n o
bijeg	b j êː ɡ
bijel	b j êː l
bijes	b j êː s
bijesan	b j ěː s a n
bijesno	b j êː s n o
bile	b ǐ l e
bilijun	b i l ǐ j uː n
biljar	b ǐ ʎ aː r
bilje	b îː ʎ e
biljeg	b ǐ ʎ e ɡ
bilježiti	b ǐ ʎ e ʒ i t i
bilježnica	b ǐ ʎ e ʒ n i t͡s a
bilježnik	b ǐ ʎ e ʒ n iː k
biljka	b îː ʎ k a
biljni	b îː ʎ n iː
biljojed	b î ʎ o j eː d
bilo	b î l o
bilten	b ǐ l t eː n
biokemija	b i o k ěː m i j a
biokemijski	b i o k ěː m iː j s k iː
biolog	b i ǒ l o ɡ
birati	b ǐː r a t i
birač	b ǐ r aː t͡ʃ
birački	b ǐ r aː t͡ʃ k iː
biskup	b î s k u p
biskvit	b ǐ s k ʋ iː t
bista	b î s t a
bistar	b î s t a r
bitan	b î t a n
biter	b ǐ t e r
biti	b î t i
bitka	b î t k a
bitno	b î t n o
bivši	b îː ʋ ʃ iː
bizantski	b ǐ z a n t s k iː
bizaran	b î z aː r a n
biće	b ǐː t͡ɕ e
bič	b î t͡ʃ
bičak	b î t͡ʃ aː k
bjegunac	b j e ɡ ǔː n a t͡s
bjelance	b j e l ǎː n t͡s e
bjelančevina	b j e l ǎː n t͡ʃ e ʋ i n a
bjelkinja	b j ê l k i ɲ a
bjelorusija	b j e l o r ǔ s i j a
bježati	b j ě ʒ a t i
blag	b l âː ɡ
blagdan	b l â ɡ d aː n
blagonaklon	b l a ɡ o n ǎː k l o n
blagoslov	b l â ɡ o s l oː ʋ
blagosloviti	b l a ɡ o s l ǒ ʋ i t i
blagostanje	b l a ɡ o s t ǎː ɲ e
blamaža	b l a m ǎː ʒ a
blatiti	b l â t i t i
blato	b l â t o
blef	b l ê f
blic	b l î t͡s
blijed	b l j êː d
blisko	b l î s k o
bliskost	b l î s k oː s t
blistav	b l î s t a ʋ
blizak	b l î z a k
blizina	b l i z ǐ n a
blizu	b l ǐː z u
blokada	b l o k ǎː d a
blud	b l ûː d
bob	b ô b
bod	b ôː d
bodriti	b ǒ d r i t i
bog	b ôː ɡ
bogat	b ǒ ɡ a t
bogato	b ǒ ɡ a t o
bogatstvo	b o ɡ ǎ t s t ʋ o
boginja	b ǒ ɡ i ɲ a
boj	b ôː j
boja	b ǒ j a
bojan	b ǒ j a n
bojati	b ǒ j a t i
bojažljivo	b o j ǎ ʒ ʎ i ʋ o
bojkot	b ǒ j k o t
bojnik	b ôː j n iː k
bojovnik	b ǒ j oː ʋ n iː k
boka	b ô k a
bokal	b ǒ k aː l
bol	b ôː l
bolan	b ôː l a n
bolesnik	b o l ě s n iː k
bolestan	b ô l e s t a n
bolivijski	b ǒ l iː ʋ iː j s k iː
bolje	b ô ʎ eː
boljeti	b ǒ ʎ e t i
boljitak	b o ʎ ǐː t a k
bolnica	b ǒː l n i t͡s a
bolno	b ôː l n o
bomba	b ôː m b a
bombarder	b o m b ǎ r d eː r
bombardirati	b o m b a r d ǐː r a t i
bor	b ôː r
borac	b ǒː r a t͡s
boravište	b ǒ r a ʋ iː ʃ t e
borba	b ǒ r b a
borbeno	b ô r b e n o
borbenost	b ô r b e n oː s t
boris	b ôː r i s
boriti	b ǒ r i t i
borovina	b ǒ r o ʋ i n a
bos	b ôː s
bosanac	b o s ǎː n a t͡s
bosna	b ô s n a
boston	b ô s t o n
botanika	b o t ǎ n i k a
botanički	b o t ǎ n i t͡ʃ k iː
bova	b ôː ʋ a
bozon	b ǒ z oː n
bočica	b ô t͡ʃ i t͡s a
bošnjak	b ǒ ʃ ɲ aː k
božanstvo	b o ʒ ǎ n s t ʋ o
božiji	b ô ʒ i j iː
božićni	b ǒ ʒ i t͡ɕ n iː
božji	b ô ʒ j iː
božur	b ǒ ʒ uː r
brada	b r ǎː d a
bradavica	b r ǎ d a ʋ i t͡s a
brak	b r âː k
brana	b r ǎː n a
branilac	b r ǎ n i l a t͡s
branitelj	b r ǎ n i t e ʎ
braniti	b r ǎː n i t i
branič	b r ǎ n iː t͡ʃ
brat	b r â t
brati	b r â t i
bratić	b r â t i t͡ɕ
bratstvo	b r ǎ t s t ʋ o
bravar	b r â ʋ aː r
bračni	b r âː t͡ʃ n iː
brašno	b r â ʃ n o
brdovit	b r d ǒ ʋ i t
brdski	b r̂ d s k iː
bregović	b r ě ɡ o ʋ i t͡ɕ
breme	b r ê m e
breskva	b r ê s k ʋ a
brezovica	b r ê z o ʋ i t͡s a
briga	b r î ɡ a
brijati	b r î j a t i
brinuti	b r î n u t i
bris	b r îː s
brisati	b r î s a t i
brisel	b r ǐ s e l
britanac	b r i t ǎː n a t͡s
britanija	b r ǐ t aː n i j a
britanski	b r ǐ t aː n s k iː
brko	b řː k o
brod	b r ôː d
brodica	b r ǒ d i t͡s a
brodić	b r ǒ d iː t͡ɕ
brodogradilište	b r o d o ɡ r ǎ d i l iː ʃ t e
brodski	b r ǒ d s k iː
broj	b r ôː j
brojati	b r ǒ j a t i
brojka	b r ôː j k a
brojčanik	b r o j t͡ʃ ǎ n iː k
brojčano	b r ǒ j t͡ʃ a n o
brom	b r ô m
broš	b r ô ʃ
bruka	b r û k a
brusiti	b r ǔː s i t i
brutalan	b r û t aː l a n
brz	b r̂ː z
brzo	b r̂ː z o
bubanj	b ûː b a ɲ
bubnjar	b ǔ b ɲ aː r
bubrežni	b ǔ b r e ʒ n iː
budala	b u d ǎ l a
budalaština	b u d a l ǎː ʃ t i n a
budaletina	b u d a l ě t i n a
budan	b ǔː d a n
budimpeštanski	b ǔ d i m p e ʃ t aː n s k iː
budnica	b ǔː d n i t͡s a
budno	b ûː d n o
budnost	b ǔː d n oː s t
budu	b û d u
budućnost	b u d ǔː t͡ɕ n oː s t
budzašto	b ǔ d z a ʃ t o
budžet	b ǔ d͡ʒ e t
budžetski	b ǔ d͡ʒ e t s k i
bugarin	b û ɡ a r i n
buha	b ǔ x a
bujno	b ûː j n o
bujnost	b ǔː j n oː s t
buka	b û k a
buket	b ǔ k eː t
buki	b ǔ k i
buking	b ǔ k i n ɡ
bukurešt	b û k u r e ʃ t
bukvalno	b û k ʋ aː l n o
bukvar	b ǔ k ʋ aː r
bulevar	b u l ě v aː r
buna	b ǔː n a
bunar	b ǔ n aː r
bundeva	b ǔ n d e ʋ a
buniti	b ǔː n i t i
bunkerirati	b u n k e r ǐː r a t i
buntovan	b û n t oː ʋ a n
buntovnik	b ǔ n t oː ʋ n iː k
bure	b û r e
burmanski	b ǔ r m a n s k iː
burza	b û r z a
butik	b ǔ t i k
buća	b û t͡ɕ a
buča	b û t͡ʃ a
bušotina	b ǔ ʃ o t i n a
car	t͡s â r
carica	t͡s â r i t͡s a
carigrad	t͡s ǎ r i ɡ r aː d
carigradski	t͡s ǎ r i ɡ r a d s k iː
carina	t͡s â r i n a
carstvo	t͡s âː r s t ʋ o
ceh	t s ê x
celer	t͡s ê l e r
celokupan	t͡s e l ǒ k u p a n
celuloza	t͡s e l u l ǒː z a
cement	t͡s ě m e n t
cena	t͡s ěː n a
centarfor	t͡s ê n t a r f oː r
centimetar	t͡s ě n t i m e t a r
centralni	t͡s ě n t r aː l n iː
centrifugalan	t͡s e n t r i f ǔ ɡ aː l a n
centurion	t͡s e n t u r ǐ oː n
cenzor	t͡s ê n z o r
cenzura	t͡s e n z ǔː r a
cepelin	t͡s e p ě l iː n
ceremonija	t͡s e r e m ǒ n i j a
ceremonijalno	t͡s ê r e m o n i j aː l n o
certifikat	t͡s e r t i f ǐ k aː t
cesar	t͡s ê s aː r
cestovni	t͡s ě s t oː ʋ n iː
cijel	t͡s i j êː l
cijena	t͡s i j ěː n a
cijeniti	t͡s i j ěː n i t i
cijenjen	t͡s i j êː ɲ e n
cijepiti	t͡s i j ěː p i t i
cijev	t͡s i j êː ʋ
cijevni	t͡s i j êː ʋ n iː
ciklama	t͡s i k l ǎː m a
ciklona	t͡s i k l ǒː n a
ciklus	t͡s ǐ k l u s
cilj	t͡s îː ʎ
ciljan	t͡s îː ʎ a n
cimati	t͡s î m a t i
cimer	t͡s î m e r
cimet	t͡s ǐ m e t
cinizam	t͡s i n ǐ z a m
cio	t͡s î o
cipar	t͡s î p a r
cipela	t͡s ǐ p e l a
cirkulacija	t͡s i r k u l ǎː t͡s i j a
cirkus	t͡s ǐ r k u s
cirkuski	t͡s ǐ r k u s k iː
cista	t͡s î s t a
cisterna	t͡s ǐ s t eː r n a
civilizacija	t͡s i ʋ i l i z ǎː t͡s i j a
civilizacijski	t͡s i ʋ i l i z ǎː t͡s iː j s k iː
civilni	t͡s ǐ ʋ iː l n iː
cjelina	t͡s j e l ǐ n a
cjelokupan	t͡s j e l ǒ k u p a n
cjelokupno	t͡s j e l ǒ k u p n o
cjelovit	t͡s j e l ǒ ʋ i t
cjepidlačiti	t͡s j e p ǐ d l a t͡ʃ i t i
cjevovod	t͡s j ê ʋ o ʋ oː d
cjevčica	t͡s j ě ʋ t͡ʃ i t͡s a
crkva	t͡s r̂ː k ʋ a
crnogorac	t͡s r n ǒ ɡ o r a t͡s
crnogorski	t͡s r n ǒ ɡ o r s k iː
cunami	t͡s u n ǎː m i
cura	t͡s û r a
cvat	t͡s ʋ âː t
cvetača	t͡s ʋ ě t a t͡ʃ a
cvijet	t͡s ʋ i j êː t
cvijeće	t͡s ʋ i j êː t͡ɕ e
cviliti	t͡s ʋ ǐː l i t i
cvjetni	t͡s ʋ j ě t n iː
dabogda	d ǎ b oː ɡ d a
dah	d â x
daidža	d ǎ i d͡ʒ a
dakle	d â k l eː
dalek	d ǎ l e k
daleko	d a l ě k o
dalekoistočni	d a l e k o ǐ s t o t͡ʃ n iː
dalekometni	d a l e k ǒ m e t n iː
dalekovidan	d a l e k ǒ ʋ i d a n
dalekovidno	d a l e k ǒ ʋ i d n o
dalekovidnost	d a l e k ǒ ʋ i d n oː s t
dalekovod	d a l e k ǒ ʋ o d
dalibor	d ǎ l i b o r
daljina	d a ʎ ǐ n a
daljnji	d âː ʎ ɲ iː
damask	d ǎ m a s k
dan	d âː n
danac	d ǎː n a t͡s
danas	d ǎ n a s
današnji	d ǎ n a ʃ ɲ iː
danica	d ǎ n i t͡s a
danima	d ǎː n i m a
danju	d ǎː ɲ u
danomice	d â n o m i t͡s eː
danska	d âː n s k aː
danski	d âː n s k iː
dapače	d a p ǎ t͡ʃ e
dar	d âː r
darežljiv	d a r ě ʒ ʎ i ʋ
darovit	d a r ǒ ʋ i t
darovitost	d a r ǒ ʋ i t oː s t
daska	d ǎ s k a
dati	d â t i
datoteka	d a t o t ěː k a
davalac	d ǎː ʋ a l a t͡s
davati	d ǎː ʋ a t i
daviti	d ǎː ʋ i t i
davnina	d a ʋ n ǐ n a
daščica	d ǎ ʃ t͡ʃ i t͡s a
debelo	d e b ě l o
debeo	d ě b e o
debi	d ě b iː
debljina	d e b ʎ ǐ n a
decembar	d ě t͡s eː m b a r
decenija	d ě t͡s eː n i j a
deda	d ê d a
dedukcija	d e d ǔ k t͡s i j a
defile	d e f ǐ l eː
definicija	d e f i n ǐː t͡s i j a
degradirati	d e ɡ r a d ǐː r a t i
dekan	d ě k aː n
dekorativan	d ê k o r a t iː ʋ a n
dekret	d ě k r eː t
delegacija	d e l e ɡ ǎː t͡s i j a
delikatesa	d e l i k a t ě s a
delimično	d ê l i m i t͡ʃ n o
delić	d ě l i t͡ɕ
delovati	d ê l o ʋ a t i
delta	d ê l t a
demagogija	d e m a ɡ ǒ ɡ i j a
demanti	d ě m a n t i
demokracija	d e m o k r ǎː t͡s i j a
demokratija	d e m o k r ǎː t i j a
demon	d ě m oː n
depo	d ě p oː
deponij	d ě p oː n i j
derbi	d ê r b i
derviš	d ě r ʋ iː ʃ
deset	d ê s e t
desetak	d e s ěː t a k
deseti	d ê s e t i
desetina	d e s ě t i n a
desetljeće	d ê s e t ʎ e t͡ɕ e
desetorica	d e s e t ǒ r i t͡s a
desetoro	d ê s e t o r o
desiti	d ê s i t i
desnica	d ě s n i t͡s a
desničar	d ě s n i t͡ʃ aː r
desno	d ê s n o
despot	d ě s p o t
destinacija	d e s t i n ǎː t͡s i j a
destrukcija	d e s t r ǔ k t͡s i j a
detektirati	d e t e k t ǐː r a t i
deva	d ěː ʋ a
devastacija	d e ʋ a s t ǎː t͡s i j a
devedeseti	d e ʋ e d ě s e t iː
devet	d ê ʋ e t
devetero	d ê ʋ e t e r o
deveti	d ê ʋ e t i
devetnaest	d e ʋ ě t n a eː s t
dezinfekcija	d e z i n f ě k t͡s i j a
dezinformacija	d e z i n f o r m ǎː t͡s i j a
dezinsekcija	d e z i n s ě k t͡s i j a
dečak	d ě t͡ʃ aː k
dečko	d ê t͡ʃ k o
digitalni	d î ɡ i t aː l n iː
dignuti	d î ɡ n u t i
dijagnostika	d i j a ɡ n ǒ s t i k a
dijagnoza	d i j a ɡ n ǒː z a
dijalog	d i j ǎ l o ɡ
dijamant	d i j ǎ m a n t
dijeliti	d j ěː l i t i
dijelom	d j ěː l o m
dikobraz	d î k o b r aː z
diktator	d ǐ k t aː t o r
diktatura	d i k t a t ǔː r a
dilema	d i l ěː m a
dim	d î m
dimnjačar	d î m ɲ a t͡ʃ aː r
dina	d ǐː n a
dinastija	d i n ǎ s t i j a
dinja	d î ɲ a
dinosaurus	d i n o s ǎ u r u s
dio	d î o
dioba	d i ǒ b a
dionica	d i ǒ n i t͡s a
diplomacija	d i p l o m ǎ t͡s i j a
dirati	d ǐː r a t i
direktan	d ǐ r e k t a n
direktno	d ǐ r e k t n o
direktor	d ǐ r e k t o r
direktorica	d i r e k t ǒ r i t͡s a
direktorij	d i r ě k t oː r i j
dirigent	d i r ǐ ɡ e n t
dirnuti	d ǐː r n u t i
diskreditirati	d i s k r e d i t ǐː r a t i
diskretan	d ǐ s k r e t a n
diskretno	d ǐ s k r e t n o
diskusija	d ǐ s k uː s i j a
diskutirati	d i s k u t ǐː r a t i
distribucija	d i s t r i b ǔː t͡s i j a
diverzitet	d i ʋ e r z ǐ t eː t
divlje	d ǐ ʋ ʎ eː
divlji	d ǐ ʋ ʎ iː
dizalo	d î z a l o
dizati	d î z a t i
dići	d î t͡ɕ i
djed	d j ê d
djelatnica	d j ê l aː t n i t͡s a
djelatnik	d j ě l aː t n iː k
djelatnost	d j e l ǎː t n oː s t
djelić	d j ě l i t͡ɕ
djelo	d j ê l o
djelokrug	d j ê l o k r uː ɡ
djelomice	d j ê l o m i t͡s eː
djelomično	d j ê l o m i t͡ʃ n o
djelotvoran	d j ê l o t ʋ oː r a n
djelotvorno	d j ê l o t ʋ oː r n o
djelovati	d j ê l o ʋ a t i
djetinjasto	d j ě t i ɲ a s t o
djeva	d j ěː ʋ a
djevojčica	d j e ʋ ǒː j t͡ʃ i t͡s a
dječji	d j ě t͡ʃ j iː
dlaka	d l â k a
dlačica	d l â t͡ʃ i t͡s a
doba	d ôː b a
dobaciti	d o b ǎː t͡s i t i
dobar	d ô b a r
dobavljač	d o b ǎ ʋ ʎ aː t͡ʃ
dobiti	d ǒ b i t i
dobivati	d o b ǐː ʋ a t i
dobiće	d o b ǐː t͡ɕ e
dobro	d ǒ b r o
dobrodošao	d o b r o d ǒ ʃ a o
dobrodošli	d o b r o d ǒ ʃ l i
dobrodošlica	d o b r o d ǒ ʃ l i t͡s a
dobrotvorka	d ô b r o t ʋ oː r k a
dobrovoljac	d o b r o ʋ ǒː ʎ a t͡s
dodatak	d o d ǎː t a k
dodatan	d ô d aː t a n
dodati	d ǒ d a t i
dodatno	d ô d aː t n o
dodavanje	d o d ǎː ʋ aː ɲ e
dodirivati	d o d i r ǐː ʋ a t i
dodjeljivati	d o d j e ʎ ǐː ʋ a t i
doduše	d o d ǔː ʃ eː
događaj	d ô ɡ a d͡ʑ aː j
događati	d o ɡ ǎː d͡ʑ a t i
dogovoriti	d o ɡ o ʋ ǒ r i t i
dohvat	d ô x ʋ aː t
dohvatiti	d ǒ x ʋ a t i t i
doista	d ô i s t a
dojilja	d ǒ j iː ʎ a
dojka	d ôː j k a
dok	d ô k
dokazati	d o k ǎː z a t i
dokle	d ǒː k l eː
doktor	d ô k t o r
doktorat	d o k t ǒ r aː t
doktrina	d o k t r ǐː n a
dol	d ôː l
dolazak	d ǒ l a z a k
dolaziti	d ǒ l a z i t i
dole	d ô l e
doli	d ǒ l i
dolina	d o l ǐ n a
dolje	d ô ʎ e
dom	d ôː m
doma	d ô m a
domaći	d ǒ m aː t͡ɕ iː
domaćica	d o m ǎ t͡ɕ i t͡s a
domaćin	d o m ǎ t͡ɕ i n
domaćinstvo	d o m a t͡ɕ ǐː n s t ʋ o
domet	d ǒː m e t
dominacija	d o m i n ǎː t͡s i j a
domovina	d ǒ m o ʋ i n a
domovinski	d ǒ m o ʋ i n s k iː
donator	d ǒ n aː t o r
doneti	d ǒ n eː t i
donijeti	d ǒ n j eː t i
donji	d ôː ɲ iː
donos	d ǒ n o s
donositi	d o n ǒ s i t i
dopasti	d ǒ p a s t i
dopisnik	d ǒ p i s n iː k
doprijeti	d ǒ p r j eː t i
doprineti	d o p r ǐ n eː t i
doprinijeti	d o p r ǐ n j eː t i
doprinositi	d o p r i n ǒ s i t i
dopuniti	d ǒ p u n i t i
dopunjavati	d o p u ɲ ǎː ʋ a t i
dopunski	d ǒ p u n s k iː
dopustiti	d o p ǔ s t i t i
dopuštati	d o p ǔː ʃ t a t i
dorađivati	d o r a d͡ʑ ǐː ʋ a t i
doručak	d ǒ r u t͡ʃ a k
dosad	d ǒ s a d
dosadan	d ô s aː d a n
dosađivati	d o s a d͡ʑ ǐː ʋ a t i
doseg	d ô s eː ɡ
dosegnuti	d o s ěː ɡ n u t i
dosetljivo	d o s ě t ʎ i ʋ o
dosezati	d o s ěː z a t i
doseći	d ǒ s eː t͡ɕ i
dosljedan	d ǒ s ʎ e d a n
dosljedno	d ǒ s ʎ e d n o
doslovan	d ǒː s l oː ʋ a n
doslovno	d ǒː s l oː ʋ n o
dospjeti	d ǒ s p j e t i
dosta	d ô s t a
dostava	d ô s t a ʋ a
dostaviti	d ǒ s t a ʋ i t i
dostavljati	d ǒ s t a ʋ ʎ a t i
dostići	d ǒ s t i t͡ɕ i
dostojan	d ǒː s t oː j a n
dostojno	d ǒː s t oː j n o
dostupan	d ǒ s t u p a n
dostupnost	d ǒ s t u p n oː s t
dotični	d ǒ t i t͡ʃ n iː
dovesti	d ǒ ʋ e s t i
dovoditi	d o ʋ ǒ d i t i
dovoljan	d ô ʋ oː ʎ a n
dovoljno	d ô ʋ oː ʎ n o
dovršetak	d o ʋ r ʃ ěː t a k
doza	d ǒː z a
doznati	d ǒ z n a t i
dozvati	d ǒ z ʋ a t i
dozvola	d ô z ʋ o l a
dozvoliti	d o z ʋ ǒ l i t i
dočasnik	d ǒ t͡ʃ aː s n iː k
doček	d ǒ t͡ʃ e k
dočekati	d ǒ t͡ʃ e k a t i
dočepati	d o t͡ʃ ě p a t i
doživjeti	d o ʒ ǐː ʋ j e t i
doživljaj	d ô ʒ i ʋ ʎ aː j
doživotno	d ô ʒ i ʋ o t n o
dramatičan	d r a m ǎ t i t͡ʃ a n
dramatično	d r a m ǎ t i t͡ʃ n o
drastičan	d r ǎ s t i t͡ʃ a n
drastično	d r ǎ s t i t͡ʃ n o
drava	d r ǎː ʋ a
drača	d r â t͡ʃ a
draž	d r âː ʒ
dreka	d r ê k a
dres	d r ê s
drhtaj	d r̂ x t aː j
drijen	d r i j êː n
drito	d r î t o
drogirati	d r o ɡ ǐː r a t i
drolja	d r ô ʎ a
drug	d r ûː ɡ
drugar	d r ǔ ɡ aː r
drugačije	d r u ɡ ǎ t͡ʃ i j eː
drugačiji	d r u ɡ ǎ t͡ʃ i j iː
drugdje	d r û ɡ d j e
drugi	d r û ɡ iː
drukčije	d r ǔ k t͡ʃ i j eː
drukčiji	d r ǔ k t͡ʃ i j iː
drvar	d ř ʋ aː r
drveno	d r̂ ʋ e n o
drvlje	d r̂ː ʋ ʎ e
drvo	d r̂ ʋ o
drvored	d r̂ ʋ o r eː d
drvorez	d r̂ ʋ o r eː z
držak	d r̂ ʒ a k
državljanka	d ř ʒ a ʋ ʎ aː n k a
državljanstvo	d r ʒ a ʋ ʎ ǎː n s t ʋ o
državni	d ř ʒ aː ʋ n iː
dubok	d ǔ b o k
duboko	d u b ǒ k o
dubrovački	d ǔ b r o ʋ a t͡ʃ k iː
dubrovnik	d ǔ b r oː ʋ n iː k
dugačak	d u ɡ ǎ t͡ʃ a k
dugoročan	d û ɡ o r o t͡ʃ a n
dugotrajan	d û ɡ o t r aː j a n
dugotrajno	d û ɡ o t r aː j n o
dugovati	d u ɡ ǒ ʋ a t i
duhan	d ǔ x aː n
duhovit	d u x ǒ ʋ i t
duhovni	d ǔ x oː ʋ n iː
duhovno	d ǔ x oː ʋ n o
dukat	d ǔ k aː t
dunav	d ǔ n a ʋ
dunjaluk	d u ɲ ǎː l u k
dupe	d û p e
dupence	d u p ěː n t͡s e
dupli	d û p l iː
duplikat	d u p l ǐ k aː t
duvati	d ǔː ʋ a t i
duša	d ǔː ʃ a
dužnik	d ǔ ʒ n iː k
dužnosnica	d ǔː ʒ n o s n i t͡s a
dužnosnik	d ǔː ʒ n o s n iː k
dužnost	d ǔː ʒ n oː s t
dva	d ʋ âː
dvadeset	d ʋ ǎː d e s e t
dvadesetak	d ʋ a d e s ěː t a k
dve	d ʋ êː
dvije	d ʋ î j e
dvjesto	d ʋ j ê s t o
dvoboj	d ʋ ǒ b o j
dvojba	d ʋ ǒ j b a
dvojica	d ʋ ǒ j i t͡s a
dvojnik	d ʋ ôː j n iː k
dvoličnost	d ʋ ǒ l i t͡ʃ n oː s t
dvorana	d ʋ o r ǎ n a
dvorište	d ʋ ǒ r iː ʃ t e
dvorski	d ʋ ǒ r s k iː
dvousneni	d ʋ ǒ u s n e n iː
džabe	d͡ʒ â b eː
džak	d͡ʒ âː k
džamija	d͡ʒ ǎː m i j a
džem	d͡ʒ ê m
džemat	d͡ʒ ě m aː t
dženaza	d͡ʒ e n ǎː z a
džep	d͡ʒ ê p
džihad	d͡ʒ ǐ x aː d
džin	d͡ʒ î n
džoker	d͡ʒ ǒ k e r
džudo	d͡ʒ û d o
efekat	ě f e k t
efekt	ě f e k t
efektno	ě f e k t n o
efendija	e f ě n d i j a
efikasan	ê f i k a s a n
efikasno	ê f i k a s n o
egipat	ě ɡ i p a t
ego	êː ɡ o
egzaktan	ě ɡ z a k t a n
egzodus	e ɡ z ǒː d u s
ekipa	e k ǐː p a
eklipsa	e k l ǐ p s a
ekonomičan	e k o n ǒ m i t͡ʃ a n
ekonomično	e k o n ǒ m i t͡ʃ n o
ekosistem	e k o s ǐ s t eː m
ekscentričnost	e k s t͡s ě n t r i t͡ʃ n oː s t
ekskluzivan	ê k s k l u z iː ʋ a n
ekskluzivno	ê k s k l u z iː ʋ n o
ekspert	ě k s p e r t
ekstremizam	e k s t r e m ǐ z a m
ekstremno	ě k s t r eː m n o
ekvadorski	ě k ʋ aː d o r s k iː
ekvator	ě k ʋ aː t o r
elaborat	e l a b ǒ r aː t
elegantan	e l e ɡ ǎ n t a n
elegantno	e l e ɡ ǎ n t n o
elektrana	e l e k t r ǎ n a
elektricitet	e l e k t r i t͡s ǐ t eː t
električar	e l ě k t r i t͡ʃ aː r
električni	e l ě k t r i t͡ʃ n iː
elektroda	e l e k t r ǒː d a
elektrolit	e l e k t r ǒ l iː t
elektronski	e l ě k t r oː n s k iː
elektrotehnika	e l e k t r o t ě x n i k a
elemenat	e l ě m e n a t
element	e l ě m e n t
eliksir	e l ǐ k s iː r
eliminacija	e l i m i n ǎː t͡s i j a
elitni	ě l iː t n iː
elokventan	e l o k ʋ ě n t a n
emigracija	e m i ɡ r ǎː t͡s i j a
emigrant	e m ǐ ɡ r a n t
emocija	e m ǒː t͡s i j a
emotivan	ê m o t iː ʋ a n
energetika	e n e r ɡ ě t i k a
energija	e n ě r ɡ i j a
energično	e n ě r ɡ i t͡ʃ n o
engleska	ě n ɡ l eː s k aː
engleskinja	ě n ɡ l e s k i ɲ a
entuzijazam	e n t u z i j ǎ z a m
eon	ě oː n
eparhija	e p ǎ r x i j a
epidemija	e p i d ě m i j a
epilog	e p ǐ l o ɡ
episkop	ě p i s k o p
epistemologija	e p i s t e m o l ǒ ɡ i j a
epitet	e p ǐ t eː t
epizoda	e p i z ǒː d a
epoha	e p ǒː x a
epruveta	e p r u ʋ ě t a
era	ěː r a
erekcija	e r ě k t͡s i j a
esej	ě s eː j
esperanto	e s p e r ǎ n t o
estonija	ě s t oː n i j a
estonski	ě s t oː n s k iː
etaža	e t ǎː ʒ a
etika	ě t i k a
etiologija	e t i o l ǒ ɡ i j a
etiopljanin	e t i ǒː p ʎ a n i n
euforija	e u f ǒ r i j a
europa	e u r ǒː p a
evakuacija	e ʋ a k u ǎː t͡s i j a
evanđelje	e ʋ ǎ n d͡ʑ eː ʎ e
eventualno	ê ʋ e n t u aː l n o
evidentan	e ʋ i d ě n t a n
evidentno	e ʋ i d ě n t n o
evolucija	e ʋ o l ǔː t͡s i j a
evolucijski	e ʋ o l ǔː t͡s iː j s k iː
evropa	e ʋ r ǒː p a
fabrika	f ǎ b r i k a
fabrički	f ǎ b r i t͡ʃ k iː
fajrunt	f ǎ j r u n t
fakat	f â k a t
faktički	f ǎ k t i t͡ʃ k i
fakultet	f a k ǔ l t eː t
faliti	f â l i t i
falsifikator	f a l s i f ǐ k aː t o r
fanatik	f a n ǎ t i k
fanatizam	f a n a t ǐ z a m
fantastičan	f a n t ǎ s t i t͡ʃ a n
fantastično	f a n t ǎ s t i t͡ʃ n o
fantazija	f ǎ n t aː z i j a
fantom	f ǎ n t oː m
faraon	f a r ǎ oː n
farba	f âː r b a
fasada	f a s ǎː d a
fatalno	f ǎ t aː l n o
favorit	f a ʋ ǒ r iː t
fašizam	f a ʃ ǐ z a m
federacija	f e d e r ǎː t͡s i j a
fekalije	f ě k aː l i j e
feminizam	f e m i n ǐ z a m
feniks	f ěː n i k s
fenički	f ě n iː t͡ʃ k iː
fenomenalan	f ê n o m e n aː l a n
feta	f ê t a
fetiš	f ě t i ʃ
feudalizam	f e u d a l ǐ z a m
fešta	f ê ʃ t a
figura	f i ɡ ǔː r a
figurica	f i ɡ ǔː r i t͡s a
fikcija	f ǐ k t͡s i j a
fildžan	f ǐ l d͡ʒ aː n
filogenija	f i l o ɡ ěː n i j a
filolog	f i l ǒ l o ɡ
filologija	f i l o l ǒ ɡ i j a
filtar	f ǐ l t a r
filter	f ǐ l t e r
fin	f îː n
finac	f ǐː n a t͡s
finalist	f i n ǎ l i s t
finalni	f ǐ n aː l n iː
financije	f i n ǎ n t͡s i j e
financirati	f i n a n t͡s ǐː r a t i
finansije	f i n ǎ n s i j e
finska	f îː n s k aː
finski	f îː n s k iː
firma	f îː r m a
fiskalni	f ǐ s k aː l n iː
fitilj	f ǐ t iː ʎ
fizika	f ǐ z i k a
fiziolog	f i z i ǒ l o ɡ
fizioterapeut	f i z i o t e r a p ě u t
fizički	f ǐ z i t͡ʃ k iː
fišek	f ǐ ʃ e k
fjaka	f j â k a
fleksibilno	f l ê k s i b iː l n o
flora	f l ôː r a
florida	f l ǒ r i d a
floskula	f l ô s k u l a
flota	f l ô t a
fluid	f l û iː d
fluorid	f l u ǒ r iː d
fokus	f ǒː k u s
fokusirati	f o k u s ǐː r a t i
folklor	f ǒ l k l oː r
fondacija	f o n d ǎː t͡s i j a
fontana	f ǒ n t aː n a
forinta	f o r ǐː n t a
forma	f ôː r m a
formalnost	f o r m ǎː l n oː s t
formirati	f o r m ǐː r a t i
formulacija	f o r m u l ǎː t͡s i j a
formulirati	f o r m u l ǐː r a t i
forum	f ǒː r u m
fosil	f ǒ s iː l
fotoaparat	f o t o a p ǎ r aː t
fotograf	f o t ǒ ɡ r a f
fotografija	f o t o ɡ r ǎ f i j a
fotosinteza	f o t o s i n t ěː z a
francuskinja	f r ǎ n t͡s u s k i ɲ a
fregata	f r e ɡ ǎ t a
frendica	f r ê n d i t͡s a
frižider	f r i ʒ ǐ d eː r
front	f r ô n t
frustracija	f r u s t r ǎː t͡s i j a
frustriran	f r ǔ s t r iː r a n
fudbal	f û d b aː l
fudbaler	f u d b ǎ l eː r
fuj	f u j
gabor	ɡ âː b o r
gadan	ɡ ǎ d a n
gaj	ɡ âː j
galaktika	ɡ a l ǎ k t i k a
galamiti	ɡ a l ǎː m i t i
galantnost	ɡ a l ǎ n t n oː s t
galeb	ɡ â l eː b
galop	ɡ ǎ l o p
gana	ɡ â n a
gangster	ɡ ǎ n ɡ s t e r
ganuti	ɡ ǎ n u t i
ganutljivo	ɡ a n ǔ t ʎ i ʋ o
garancija	ɡ a r ǎ n t͡s i j a
garant	ɡ ǎ r a n t
garantirati	ɡ a r a n t ǐː r a t i
garaža	ɡ a r ǎː ʒ a
garda	ɡ âː r d a
garderoba	ɡ a r d e r ǒː b a
garnitura	ɡ a r n i t ǔː r a
gas	ɡ âː s
gasiti	ɡ ǎː s i t i
gat	ɡ â t
gaza	ɡ ǎː z a
gaziti	ɡ â z i t i
gaćice	ɡ â t͡ɕ i t͡s e
gađenje	ɡ â d͡ʑ eː ɲ e
gde	ɡ d ê
gdje	ɡ d j ê
gej	ɡ êː j
generacija	ɡ e n e r ǎː t͡s i j a
generalica	ɡ e n e r ǎ l i t͡s a
genetički	ɡ e n ě t i t͡ʃ k iː
genij	ɡ êː n iː j
geografija	ɡ e o ɡ r ǎ f i j a
geomorfologija	ɡ e o m o r f o l ǒ ɡ i j a
germanski	ɡ ě r m aː n s k iː
geslo	ɡ ê s l o
gigant	ɡ ǐ ɡ a n t
gigantski	ɡ ǐ ɡ a n t s k iː
gimnastika	ɡ i m n ǎ s t i k a
gimnazija	ɡ ǐ m n aː z i j a
ginekolog	ɡ i n e k ǒ l o ɡ
gips	ɡ î p s
glad	ɡ l âː d
gladan	ɡ l ǎː d a n
glagoljica	ɡ l a ɡ ǒ ʎ i t͡s a
glagolski	ɡ l â ɡ o l s k iː
glamur	ɡ l ǎ m uː r
glancati	ɡ l âː n t͡s a t i
glas	ɡ l aː s
glasač	ɡ l ǎ s aː t͡ʃ
glasina	ɡ l ǎ s i n a
glasiti	ɡ l ǎː s i t i
glasnogovornik	ɡ l a s n o ɡ o ʋ ǒ r n iː k
glasonoša	ɡ l a s ǒ n o ʃ a
glavica	ɡ l ǎ ʋ i t͡s a
glavni	ɡ l ǎ ʋ n iː
glavnica	ɡ l ǎ ʋ n i t͡s a
glavnina	ɡ l a ʋ n ǐ n a
glavobolja	ɡ l a ʋ ǒ b o ʎ a
glazba	ɡ l ǎ z b a
glazbenica	ɡ l ǎ z b e n i t͡s a
glazbenik	ɡ l ǎ z b e n iː k
gle	ɡ l ê
gledatelj	ɡ l ě d a t e ʎ
gledati	ɡ l ê d a t i
glede	ɡ l ê d e
gledište	ɡ l ê d iː ʃ t e
glečer	ɡ l ê t͡ʃ e r
gležanj	ɡ l ê ʒ a ɲ
glina	ɡ l ǐː n a
glista	ɡ l ǐː s t a
globa	ɡ l ǒ b a
globalizacija	ɡ l o b a l i z ǎː t͡s i j a
globalno	ɡ l ǒ b aː l n o
glomazan	ɡ l ô m aː z a n
gluhoća	ɡ l u x ǒ t͡ɕ a
glup	ɡ l ûː p
glupost	ɡ l ǔː p oː s t
gnezdo	ɡ n ěː z d o
gnjida	ɡ ɲ î d a
go	ɡ ôː
god	ɡ ôː d
godina	ɡ ô d i n a
godinama	ɡ ô d i n a m a
godišnjica	ɡ ǒ d i ʃ ɲ i t͡s a
gol	ɡ ôː l
golem	ɡ ǒ l e m
golfer	ɡ ô l f e r
golgota	ɡ ǒ l ɡ o t a
golman	ɡ ô l m a n
golubić	ɡ o l ǔ b i t͡ɕ
goniti	ɡ ǒ n i t i
gonič	ɡ ǒ n iː t͡ʃ
gora	ɡ ǒ r a
gorivo	ɡ ô r iː ʋ o
gornji	ɡ ôː r ɲ iː
gorski	ɡ ǒ r s k iː
gorčina	ɡ o r t͡ʃ ǐ n a
gorštak	ɡ ǒ r ʃ t aː k
gospa	ɡ ǒː s p a
gospod	ɡ ô s p o d
gospoda	ɡ o s p ǒ d a
gospodar	ɡ o s p ǒ d aː r
gospodarica	ɡ o s p o d ǎ r i t͡s a
gospodariti	ɡ o s p o d ǎː r i t i
gospodarski	ɡ o s p ǒ d aː r s k iː
gospodarstvo	ɡ o s p o d ǎː r s t ʋ o
gospodin	ɡ o s p ǒ d i n
gospođa	ɡ ô s p o d͡ʑ a
gospođica	ɡ ô s p o d͡ʑ i t͡s a
gostoljubiv	ɡ o s t o ʎ ǔ b i ʋ
gostoljubivost	ɡ o s t o ʎ ǔ b i ʋ oː s t
gotički	ɡ ǒ t i t͡ʃ k iː
gotov	ɡ ǒ t o ʋ
gotovo	ɡ ǒ t o ʋ o
gotski	ɡ ô t s k iː
goveđi	ɡ ǒ ʋ e d͡ʑ iː
govor	ɡ ô v oː r
govoriti	ɡ o ʋ ǒ r i t i
gozba	ɡ ǒ z b a
gošća	ɡ ǒ ʃ t͡ɕ a
graditeljski	ɡ r ǎ d i t e ʎ s k iː
graditi	ɡ r ǎː d i t i
gradivo	ɡ r â d iː ʋ o
gradonačelnica	ɡ r a d o n ǎː t͡ʃ e l n i t͡s a
gradski	ɡ r ǎ d s k iː
grafit	ɡ r ǎ f iː t
gram	ɡ r â m
gramatika	ɡ r a m ǎ t i k a
gramofon	ɡ r a m ǒ f oː n
gramzivost	ɡ r ǎ m z i ʋ oː s t
granata	ɡ r a n ǎː t a
grandiozan	ɡ r â n d i oː z a n
granica	ɡ r ǎ n i t͡s a
gravitacija	ɡ r a ʋ i t ǎː t͡s i j a
gravitirati	ɡ r a ʋ i t ǐː r a t i
građa	ɡ r âː d͡ʑ a
građanin	ɡ r â d͡ʑ a n i n
građanski	ɡ r â d͡ʑ a n s k iː
građevinarstvo	ɡ r a d͡ʑ e ʋ i n ǎː r s t ʋ o
građevinski	ɡ r ǎ d͡ʑ e ʋ iː n s k iː
grba	ɡ r̂ b a
grdosija	ɡ r d ǒ s i j a
greben	ɡ r ê b eː n
grenland	ɡ r ě n l a n d
grešnik	ɡ r ê ʃ n iː k
griješan	ɡ r i j ê ʃ a n
grimasa	ɡ r i m ǎ s a
grinja	ɡ r î ɲ a
griz	ɡ r îː z
grkinja	ɡ r̂ k i ɲ a
grlo	ɡ r̂ l o
grob	ɡ r ô b
groblje	ɡ r ôː b ʎ e
grobnica	ɡ r ô b n i t͡s a
groteskno	ɡ r o t ě s k n o
groznica	ɡ r ǒ z n i t͡s a
grožđe	ɡ r ôː ʒ d͡ʑ e
grub	ɡ r ûː b
grubo	ɡ r ûː b o
gruda	ɡ r û d a
grudi	ɡ r ûː d i
grudnjak	ɡ r ûː d ɲ aː k
gruzija	ɡ r ûː z i j a
gubav	ɡ û b a ʋ
gubitak	ɡ u b ǐː t a k
gubiti	ɡ ǔ b i t i
gubitnik	ɡ ǔ b i t n iː k
guja	ɡ ǔː j a
guma	ɡ û m a
gumb	ɡ û m b
gundelj	ɡ ǔ n d e ʎ
gurati	ɡ ǔː r a t i
gurnuti	ɡ û r n u t i
gusjenica	ɡ û s j e n i t͡s a
gusle	ɡ û s l e
gust	ɡ ûː s t
gusto	ɡ ûː s t o
gutanje	ɡ ǔ t aː ɲ e
gutati	ɡ ǔ t a t i
guverner	ɡ u ʋ ě r n eː r
guzica	ɡ ǔ z i t͡s a
gušenje	ɡ ǔː ʃ eː ɲ e
gušterača	ɡ u ʃ t ě r a t͡ʃ a
gužva	ɡ ûː ʒ ʋ a
gužvati	ɡ û ʒ ʋ a t i
gvozden	ɡ ʋ ô z d e n
gvožđe	ɡ ʋ ôː ʒ d͡ʑ e
haber	x ǎ b e r
hag	x âː ɡ
hajde	x ǎ j d e
hajdemo	x ǎ j d e m o
hajduk	x ǎ j d uː k
hajka	x âː j k a
hakim	x ǎ k i m
haljina	x ǎ ʎ i n a
halka	x âː l k a
halucinacija	x a l u t͡s i n ǎː t͡s i j a
hamajlija	x a m ǎ j l i j a
han	x âː n
handanović	x a n d ǎː n o ʋ i t͡ɕ
handžar	x ǎ n d͡ʒ aː r
haos	x â o s
hapsiti	x â p s i t i
harač	x ǎ r aː t͡ʃ
harmonija	x ǎ r m oː n i j a
hartija	x ǎ r t i j a
haški	x âː ʃ k iː
hedonistkinja	x e d ǒ n i s t k i ɲ a
hektar	x ê k t aː r
helikopter	x e l i k ǒ p t e r
hemijski	x ěː m iː j s k iː
hemikalija	x e m i k ǎ l i j a
hercegovina	x ě r t͡s e ɡ o ʋ i n a
heroin	x e r ǒ iː n
heroina	x e r o ǐː n a
heroj	x ě r oː j
heterogenost	x e t e r o ɡ ěː n oː s t
hidrat	x ǐ d r aː t
hidžra	x î d͡ʒ r a
higijena	x i ɡ i j ěː n a
higijenski	x î ɡ i j eː n s k iː
hijerarhija	x i j e r ǎ r x i j a
hiljadu	x î ʎ a d u
himalaja	x i m a l ǎː j a
himben	x î m b e n
himen	x îː m e n
hipi	x î p i
hipodrom	x î p o d r o m
hipotenuza	x i p o t e n ǔː z a
hipoteza	x i p o t ěː z a
hirovitost	x i r ǒ ʋ i t oː s t
histerija	x i s t ě r i j a
historija	x ǐ s t oː r i j a
historijski	x i s t ǒ r iː j s k iː
historiografija	x i s t o r i o ɡ r ǎ f i j a
historičar	x i s t ǒ r i t͡ʃ aː r
hitan	x î t a n
hitlerovski	x ǐ t l e r o ʋ s k iː
hiža	x î ʒ a
hladan	x l ǎː d a n
hladnjak	x l âː d ɲ aː k
hladnjača	x l ǎː d ɲ a t͡ʃ a
hladno	x l ǎː d n o
hladnokrvno	x l â d n o k rː ʋ n o
hladnoća	x l a d n ǒ t͡ɕ a
hladovina	x l a d ǒ ʋ i n a
hlače	x l â t͡ʃ e
hleb	x l ê b
hlorofil	x l o r ǒ f iː l
hobi	x ô b i
hobotnica	x ǒ b o t n i t͡s a
hodajući	x ǒː d a j uː t͡ɕ iː
hodati	x ǒː d a t i
hodnik	x ô d n iː k
hodočasnik	x ô d o t͡ʃ a s n iː k
hodočašće	x ô d o t͡ʃ a ʃ t͡ɕ e
hokej	x ǒ k eː j
hokejaš	x o k ě j aː ʃ
holandija	x o l ǎ n d i j a
holandski	x ǒ l a n d s k iː
holanđanin	x o l ǎː n d͡ʑ a n i n
holokaust	x o l o k ǎ u s t
homoseksualnost	x o m o s e k s u ǎː l n oː s t
homozigotan	x o m o z ǐ ɡ o t a n
horizontalno	x ô r i z o n t aː l n o
hormon	x ǒ r m oː n
horoskop	x ô r o s k o p
horoskopski	x ô r o s k o p s k iː
horoz	x ô r oː z
hortikultura	x o r t i k u l t ǔː r a
hostesa	x o s t ě s a
hotel	x ǒ t e l
hotelski	x ǒ t e l s k iː
hrabar	x r ǎː b a r
hrabro	x r âː b r o
hrabrost	x r ǎː b r oː s t
hram	x r âː m
hrana	x r ǎː n a
hraniti	x r ǎː n i t i
hrast	x r âː s t
hrastov	x r ǎ s t o ʋ
hrbat	x r̂ b a t
hrenovka	x r ě n oː ʋ k a
hronika	x r ǒ n i k a
hrpa	x ř p a
hrvat	x ř ʋ aː t
hrvati	x r̂ ʋ a t i
hrvatica	x r ʋ ǎ t i t͡s a
htjeti	x t j ê t i
huk	x ûː k
hum	x ûː m
humak	x û m a k
human	x û m aː n
humano	x û m aː n o
humanost	x û m aː n oː s t
humor	x ǔ m o r
humus	x ǔː m u s
hunjavica	x ǔː ɲ a ʋ i t͡s a
hunta	x ûː n t a
hurija	x ûː r i j a
hvala	x ʋ ǎː l a
hvaliti	x ʋ ǎː l i t i
hvar	x ʋ âː r
hvatati	x ʋ â t a t i
iako	î a k o
ibrahimović	i b r a x ǐː m o ʋ i t ɕ
ideal	i d ě aː l
idealan	î d e aː l a n
idealizam	i d e a l ǐ z a m
idealno	î d e aː l n o
ideja	i d ěː j a
idejni	ǐ d eː j n iː
identificirati	i d e n t i f i t͡s ǐː r a t i
identifikacija	i d e n t i f i k ǎː t͡s i j a
identitet	i d e n t ǐ t eː t
identičan	i d ě n t i t͡ʃ a n
identično	i d ě n t i t͡ʃ n o
ideologija	i d e o l ǒ ɡ i j a
ideološki	i d e ǒ l o ʃ k iː
idiom	i d ǐ oː m
idiot	i d ǐ o t
idiotizam	i d i o t ǐ z a m
idol	ǐ d oː l
idući	ǐ d uː t͡ɕ iː
igdje	î ɡ d j e
igla	ǐ ɡ l a
igra	ǐ ɡ r a
igralište	ǐ ɡ r a l iː ʃ t e
igrač	ǐ ɡ r aː t͡ʃ
igračica	i ɡ r ǎ t͡ʃ i t͡s a
igračka	ǐ ɡ r a t͡ʃ k a
igrokaz	î ɡ r o k aː z
ih	i x
ijednom	i j ě d n oː m
ikad	î k a d
ikada	î k a d a
iko	î k o
ikoliko	î k o l i k o
ikona	ǐ k o n a
ikonostas	i k o n ǒ s t a s
ilegalno	î l e ɡ aː l n o
ilirija	ǐ l iː r i j a
ilirski	ǐ l iː r s k iː
ilustracija	i l u s t r ǎː t͡s i j a
ilustrator	i l ǔ s t r aː t o r
imanje	i m ǎː ɲ e
imati	ǐ m a t i
ime	î m e
imenik	î m e n iː k
imenjak	î m e ɲ aː k
imetak	i m ěː t a k
imigracija	i m i ɡ r ǎː t͡s i j a
imitacija	i m i t ǎː t͡s i j a
imitirati	i m i t ǐː r a t i
imperativ	î m p e r a t iː ʋ
imperija	ǐ m p eː r i j a
imperijalizam	i m p e r i j a l ǐ z a m
implikacija	i m p l i k ǎː t͡s i j a
implozija	ǐ m p l oː z i j a
impozantan	i m p o z ǎ n t a n
impresija	i m p r ě s i j a
impresioniran	i m p r e s i ǒ n i r a n
impresionirati	i m p r e s i o n ǐː r a t i
impresivan	î m p r e s iː ʋ a n
impresivno	î m p r e s iː ʋ n o
improvizirano	i m p r o ʋ ǐ z iː r a n o
impuls	ǐ m p u l s
imun	î m uː n
imunitet	i m u n ǐ t eː t
inat	ǐ n aː t
inauguracija	i n a u ɡ u r ǎː t͡s i j a
inaugurirati	i n a u ɡ u r ǐː r a t i
inače	î n aː t͡ʃ e
inačica	i n ǎ t͡ʃ i t͡s a
incident	i n t͡s ǐ d e n t
indicija	ǐ n d iː t͡s i j a
indikacija	i n d i k ǎː t͡s i j a
individualan	î n d i ʋ i d u aː l a n
individualizam	i n d i ʋ i d u a l ǐ z a m
individualno	î n d i ʋ i d u aː l n o
individualnost	i n d i ʋ i d u ǎː l n oː s t
indonezija	i n d ǒ n eː z i j a
industrija	i n d ǔ s t r i j a
inercija	i n ě r t͡s i j a
infaman	ǐ n f aː m a n
infarkt	ǐ n f a r k t
infekcija	i n f ě k t͡s i j a
inflacija	i n f l ǎː t͡s i j a
informacija	i n f o r m ǎː t͡s i j a
informatika	i n f o r m ǎ t i k a
informativno	î n f o r m a t iː ʋ n o
infrastruktura	i n f r a s t r u k t ǔː r a
infuzija	ǐ n f uː z i j a
inicijal	i n i t͡s ǐ j aː l
inicijalno	î n i t͡s i j aː l n o
inicijativa	i n i t͡s i j a t ǐː ʋ a
inicijator	i n i t͡s ǐ j aː t o r
injekcija	i ɲ ě k t͡s i j a
inkubator	i n k ǔ b aː t o r
inozemni	î n o z eː m n iː
inozemstvo	i n o z ěː m s t ʋ o
insekt	ǐ n s e k t
inspekcija	i n s p ě k t͡s i j a
inspekcijski	i n s p ě k t͡s iː j s k iː
instalacija	i n s t a l ǎː t͡s i j a
instinkt	ǐ n s t i n k t
instinktivno	î n s t i n k t iː ʋ n o
institucija	i n s t i t ǔː t͡s i j a
institut	i n s t ǐ t uː t
instrukcija	i n s t r ǔ k t͡s i j a
instruktor	ǐ n s t r u k t o r
integralno	î n t e ɡ r aː l n o
intelekt	i n t ě l e k t
intelektualka	i n t e l e k t ǔ aː l k a
intelektualno	î n t e l e k t u aː l n o
intenzitet	i n t e n z ǐ t eː t
intenzivan	î n t e n z iː ʋ a n
intenzivno	î n t e n z iː ʋ n o
interakcija	i n t e r ǎ k t͡s i j a
interes	î n t e r eː s
interesantan	i n t e r e s ǎ n t a n
interesantno	i n t e r e s ǎ n t n o
interijer	i n t e r ǐ j eː r
internet	î n t e r n e t
intervencija	i n t e r ʋ ě n t͡s i j a
intervju	i n t ě r ʋ j uː
intiman	î n t iː m a n
intimno	î n t iː m n o
intravenozno	i n t r a ʋ ě n oː z n o
intuicija	i n t u ǐː t͡s i j a
intuitivno	î n t u i t iː ʋ n o
invalid	i n ʋ ǎ l iː d
invaliditet	i n ʋ a l i d ǐ t eː t
investicija	i n ʋ e s t ǐː t͡s i j a
investicijski	i n ʋ e s t ǐː t͡s iː j s k iː
investirati	i n ʋ e s t ǐː r a t i
investitor	i n ʋ ě s t iː t o r
inzulin	i n z ǔ l iː n
inšallah	ǐ n ʃ a l aː x
inženjer	i n ʒ ě ɲ eː r
iole	î o l e
ionako	i o n ǎ k oː
ionosfera	i o n o s f ěː r a
ipak	î p aː k
iracionalan	î r a t͡s i o n aː l a n
irak	ǐ r aː k
iran	ǐ r aː n
iranski	ǐ r aː n s k iː
iritirati	i r i t ǐː r a t i
irska	îː r s k aː
irski	îː r s k iː
iscijediti	i s t͡s i j ěː d i t i
iscjelitelj	i s t͡s j ě l i t e ʎ
iscrpljivati	i s t͡s r p ʎ ǐː ʋ a t i
iscrpno	ǐ s t͡s r p n o
iscuriti	i s t͡s ǔː r i t i
iseliti	i s ě l i t i
ishod	ǐ s x o d
ishodište	ǐ s x o d iː ʃ t e
isjeći	ǐ s j e t͡ɕ i
iskazati	i s k ǎː z a t i
iskaznica	ǐ s k a z n i t͡s a
isključiti	i s k ʎ ǔː t͡ʃ i t i
isključivo	i s k ʎ ǔ t͡ʃ i ʋ o
iskon	ǐ s k o n
iskorak	î s k o r aː k
iskorijeniti	i s k o r j ěː n i t i
iskoristiti	i s k o r ǐ s t i t i
iskoristivost	i s k o r ǐ s t i ʋ oː s t
iskorištavati	i s k o r i ʃ t ǎː ʋ a t i
iskra	î s k r a
iskren	î s k r e n
iskreno	î s k r e n o
iskrenost	î s k r e n oː s t
iskusan	î s k uː s a n
iskusiti	i s k ǔː s i t i
iskustvo	i s k ǔː s t ʋ o
iskušati	ǐ s k u ʃ a t i
islam	ǐ s l aː m
island	ǐ s l a n d
islandski	ǐ s l a n d s k iː
ismijati	i s m ǐ j a t i
ispasti	ǐ s p a s t i
ispatiti	ǐ s p a t i t i
ispirati	ǐ s p i r a t i
ispisati	i s p ǐː s a t i
ispisivati	i s p i s ǐː ʋ a t i
ispit	ǐ s p i t
ispiti	ǐ s p i t i
ispitivati	i s p i t ǐː ʋ a t i
ispitivač	i s p i t ǐ ʋ aː t͡ʃ
isplata	î s p l a t a
isplatiti	i s p l ǎː t i t i
isplativ	i s p l ǎ t i ʋ
isplativost	i s p l ǎ t i ʋ oː s t
isplesti	ǐ s p l e s t i
isploviti	i s p l ǒ ʋ i t i
ispomoć	î s p o m oː t͡ɕ
isporuka	î s p o r u k a
isporučiti	i s p o r ǔː t͡ʃ i t i
isporučivati	i s p o r u t͡ʃ ǐː ʋ a t i
ispostaviti	i s p ǒ s t a ʋ i t i
ispovest	ǐ s p o ʋ eː s t
ispovijest	ǐ s p o ʋ j eː s t
isprava	î s p r a ʋ a
ispravan	î s p r aː ʋ a n
ispraviti	ǐ s p r a ʋ i t i
ispričati	i s p r ǐː t͡ʃ a t i
ispričavati	i s p r i t͡ʃ ǎː ʋ a t i
isprobati	i s p r ǒː b a t i
ispunjavati	i s p u ɲ ǎː ʋ a t i
ispunjiv	i s p ǔ ɲ i ʋ
ispustiti	i s p ǔ s t i t i
istaknut	ǐ s t a k n uː t
istaknuti	i s t ǎ k n u t i
istanbul	ǐ s t a n b u l
istaći	ǐ s t a t͡ɕ i
isti	î s t iː
isticati	ǐ s t i t͡s a t i
istina	î s t i n a
istinit	î s t i n i t
istodobno	i s t ǒ d o b n o
istopiti	i s t ǒ p i t i
istosmjerno	î s t o s m j eː r n o
istovjetan	i s t ǒ ʋ j e t a n
istočni	ǐ s t o t͡ʃ n iː
istočno	ǐ s t o t͡ʃ n o
istra	î s t r a
istraga	î s t r a ɡ a
istražitelj	i s t r ǎ ʒ i t e ʎ
istražiti	i s t r ǎː ʒ i t i
istraživanje	i s t r a ʒ ǐː ʋ aː ɲ e
istraživati	i s t r a ʒ ǐː ʋ a t i
istraživački	i s t r a ʒ ǐ ʋ aː t͡ʃ k iː
istrenirati	i s t r e n ǐː r a t i
istrijebiti	i s t r j ěː b i t i
isus	ǐ s u s
isušiti	i s ǔː ʃ i t i
italija	ǐ t aː l i j a
italijan	i t a l ǐ j aː n
itko	î t k o
iva	ǐː ʋ a
ivan	ǐ ʋ a n
ivana	ǐ ʋ a n a
ivica	î ʋ i t͡s a
iz	i z
izabran	î z a b r aː n
izabrati	i z ǎ b r a t i
izaslanik	i z a s l ǎ n iː k
izaslanstvo	i z a s l ǎ n s t ʋ o
izazivati	i z a z ǐː ʋ a t i
izazovan	î z a z oː ʋ a n
izazovno	î z a z oː ʋ n o
izazvati	i z ǎ z ʋ a t i
izaći	ǐ z aː t͡ɕ i
izbaciti	i z b ǎː t͡s i t i
izbalansirati	i z b a l a n s ǐː r a t i
izbeći	ǐ z b e t͡ɕ i
izbiti	ǐ z b i t i
izbjegavati	i z b j e ɡ ǎː ʋ a t i
izbjeći	ǐ z b j e t͡ɕ i
izbor	ǐ z b o r
izboriti	i z b ǒ r i t i
izborni	ǐ z b oː r n iː
izbornik	ǐ z b oː r n iː k
izbočina	ǐ z b o t͡ʃ i n a
izbrisati	ǐ z b r i s a t i
izdajica	ǐ z d a j i t͡s a
izdajnik	ǐ z d aː j n iː k
izdajstvo	ǐ z d aː j s t ʋ o
izdaleka	i z d a l ě k a
izdanje	i z d ǎː ɲ e
izdati	ǐ z d a t i
izdavač	i z d ǎ ʋ aː t͡ʃ
izdašno	î z d aː ʃ n o
izdržavati	i z d r ʒ ǎː ʋ a t i
izdržljiv	i z d ř ʒ ʎ i ʋ
izdržljivost	i z d ř ʒ ʎ i ʋ oː s t
izdvajati	i z d ʋ ǎː j a t i
izdvojiti	i z d ʋ ǒ j i t i
izganjati	i z ɡ ǎː ɲ a t i
izgarati	i z ɡ ǎː r a t i
izgled	î z ɡ l eː d
izgledati	i z ɡ l ěː d a t i
izgnanstvo	i z ɡ n ǎ n s t ʋ o
izgorjeti	i z ɡ ǒ r j e t i
izgovarati	i z ɡ o ʋ ǎː r a t i
izgraditi	i z ɡ r ǎː d i t i
izgradnja	i z ɡ r ǎː d ɲ a
izgrađivati	i z ɡ r a d͡ʑ ǐː ʋ a t i
izgubiti	i z ɡ ǔ b i t i
izgubljen	ǐ z ɡ u b ʎ e n
iziskivati	i z i s k ǐː ʋ a t i
izići	ǐ z iː t͡ɕ i
izjasniti	i z j ǎ s n i t i
izjava	î z j a ʋ a
izjavljivati	i z j a ʋ ʎ ǐː ʋ a t i
izjašnjavati	i z j a ʃ ɲ ǎː ʋ a t i
izlaz	î z l aː z
izlaziti	ǐ z l a z i t i
izlet	ǐ z l e t
izlječiv	i z ʎ ě t͡ʃ i ʋ
izlog	ǐ z l o ɡ
izložiti	i z l ǒ ʒ i t i
izmaknuti	i z m ǎ k n u t i
izmena	î z m e n a
između	î z m e d͡ʑ u
izmjena	î z m j e n a
izmjeriti	ǐ z m j e r i t i
iznad	î z n a d
iznajmiti	i z n ǎ j m i t i
iznajmljivati	i z n a j m ʎ ǐː ʋ a t i
iznenada	î z n e n aː d a
iznenadan	î z n e n aː d a n
iznenaditi	i z n e n ǎː d i t i
iznenađen	i z n ě n aː d͡ʑ e n
iznenađenje	i z n e n a d͡ʑ ěː ɲ e
iznenađujući	i z n e n ǎ d͡ʑ u j uː t͡ɕ i
iznijeti	ǐ z n j eː t i
izniman	ǐ z n iː m a n
iznimka	ǐ z n iː m k a
iznimno	ǐ z n iː m n o
iznos	ǐ z n o s
iznositi	i z n ǒ s i t i
iznova	î z n o ʋ a
iznuda	î z n u d a
iznuditi	ǐ z n u d i t i
iznutra	ǐ z n uː t r a
izobličiti	i z o b l ǐː t͡ʃ i t i
izolacija	i z o l ǎː t͡s i j a
izoliran	i z ǒ l iː r a n
izostaviti	i z ǒ s t a ʋ i t i
izoštriti	i z ǒ ʃ t r i t i
izraditi	i z r ǎː d i t i
izrael	ǐ z r a e l
izravan	î z r aː ʋ a n
izravnati	i z r ǎ ʋ n a t i
izravno	î z r aː ʋ n o
izraziti	i z r ǎː z i t i
izrazito	ǐ z r a z i t o
izračunati	i z r a t͡ʃ ǔ n a t i
izražavati	i z r a ʒ ǎː ʋ a t i
izreka	î z r e k a
izrezati	ǐ z r e z a t i
izreći	ǐ z r e t͡ɕ i
izricati	i z r ǐː t͡s a t i
izroditi	i z r ǒ d i t i
izručiti	i z r ǔː t͡ʃ i t i
izručivati	i z r u t͡ʃ ǐː ʋ a t i
izumitelj	i z ǔ m i t e ʎ
izumrijeti	i z ǔ m r j eː t i
izuzetan	î z u z eː t a n
izuzeti	i z ǔ z eː t i
izuzetno	î z u z eː t n o
izuzev	i z ǔ z eː ʋ
izuzevši	i z ǔ z eː ʋ ʃ i
izvaditi	ǐ z ʋ a d i t i
izvedba	ǐ z ʋ e d b a
izvedenica	i z ʋ e d ě n i t͡s a
izvediv	i z ʋ ě d i ʋ
izveštaj	î z ʋ e ʃ t aː j
izvešće	ǐ z ʋ eː ʃ t͡ɕ e
izvidjeti	ǐ z ʋ i d j e t i
izvinjenje	i z ʋ i ɲ ěː ɲ e
izvjesno	î z ʋ j e s n o
izvjestan	î z ʋ j e s t a n
izvještaj	î z ʋ j e ʃ t aː j
izvještavati	i z ʋ j e ʃ t ǎː ʋ a t i
izvješće	ǐ z ʋ j eː ʃ t͡ɕ e
izvješćivati	i z ʋ j e ʃ t͡ɕ ǐː ʋ a t i
izvoditi	i z ʋ ǒ d i t i
izvodljiv	i z ʋ ǒ d ʎ i ʋ
izvor	ǐ z ʋ o r
izvorište	ǐ z ʋ o r iː ʃ t e
izvorni	ǐ z ʋ oː r n iː
izvoz	ǐ z ʋ o z
izvoziti	i z ʋ ǒ z i t i
izvrstan	î z ʋ r s t a n
izvršavati	i z ʋ r ʃ ǎː ʋ a t i
izvršni	ǐ z ʋ r ʃ n iː
ići	ǐ t͡ɕ i
išta	î ʃ t a
ištvan	î ʃ t ʋ aː n
iščupati	i ʃ t͡ʃ ǔ p a t i
jadan	j â d a n
jadno	j â d n o
jadran	j â d r aː n
jadranski	j â d r aː n s k iː
jaganjac	j â ɡ a ɲ a t͡s
jagma	j ǎ ɡ m a
jagnje	j â ɡ ɲ e
jaguar	j â ɡ u aː r
jahanje	j â x aː ɲ e
jahve	j â x ʋ e
jaje	j ǎː j e
jajovod	j â j o ʋ oː d
jakna	j ǎ k n a
jako	j âː k o
jal	j âː l
jalija	j ǎ l i j a
jalovo	j â l o ʋ o
jamac	j ǎː m a t͡s
jamajka	j a m ǎ j k a
jamačno	j ǎ m a t͡ʃ n o
jamstvo	j ǎ m s t ʋ o
jamčevina	j ǎ m t͡ʃ e ʋ i n a
jamčiti	j â m t͡ʃ i t i
janje	j â ɲ e
janjičar	j ǎ ɲ i t͡ʃ aː r
januar	j â n u aː r
japan	j ǎ p aː n
japanac	j a p ǎː n a t͡s
japanski	j ǎ p aː n s k iː
jar	j âː r
jara	j â r a
jarac	j â r a t͡s
jarbol	j âː r b o l
jasan	j ǎ s a n
jasen	j â s eː n
jasle	j â s l e
jasno	j â s n o
jaspis	j ǎ s p i s
jato	j â t o
javiti	j ǎː ʋ i t i
javni	j âː ʋ n iː
javno	j âː ʋ n o
javnost	j ǎː ʋ n oː s t
javor	j â ʋ o r
jačati	j ǎ t͡ʃ a t i
je	j e
jebati	j ě b a t i
jecaj	j ê t͡s aː j
jed	j êː d
jedan	j ě d a n
jedanput	j e d ǎ m p uː t
jedinica	j e d ǐ n i t͡s a
jedino	j ě d iː n o
jedinstven	j e d ǐ n s t ʋ e n
jedinstveno	j e d ǐ n s t ʋ e n o
jednak	j ê d n aː k
jednako	j ê d n aː k o
jednoglasno	j e d n ǒ ɡ l a s n o
jednom	j ě d n oː m
jednostrano	j e d n ǒ s t r a n o
jednostranost	j e d n ǒ s t r a n oː s t
jedrenje	j ě d r eː ɲ e
jedrilo	j ě d r i l o
jedriti	j ě d r i t i
jedro	j ê d r o
jedva	j ê d ʋ a
jeftin	j ê f t i n
jeftino	j ê f t i n o
jeka	j ê k a
jela	j ěː l a
jelen	j ě l e n
jelo	j ê l o
jer	j ê r
jerbo	j ê r b o
jesen	j ê s eː n
jesenas	j e s ě n a s
jesenji	j ě s eː ɲ iː
jesenski	j ě s eː n s k iː
jesti	j ê s t i
jetra	j ê t r a
jevrejin	j ě ʋ r e j i n
jeza	j ěː z a
jezero	j ê z e r o
jezgra	j ěː z ɡ r a
jezgro	j ěː z ɡ r o
jeziv	j ě z i ʋ
jezivo	j ě z i ʋ o
jezički	j ě z i t͡ʃ k iː
jezični	j ě z i t͡ʃ n iː
ječam	j ě t͡ʃ a m
ježić	j ě ʒ i t͡ɕ
jidiš	j î d i ʃ
joga	j ǒː ɡ a
jordan	j ǒ r d a n
jorgan	j ǒ r ɡ a n
jorgovani	j o r ɡ o ʋ ǎː n iː
josip	j ǒ s i p
jovan	j ǒ ʋ a n
još	j ô ʃ
ju	j u
jubilej	j u b ǐ l e j
judaizam	j u d a ǐ z a m
jugoistočni	j u ɡ o ǐ s t o t͡ʃ n iː
jugoistočno	j u ɡ o ǐ s t o t͡ʃ n o
jugoslavenski	j u ɡ o s l ǎ ʋ eː n s k iː
jugozapad	j u ɡ o z ǎː p a d
jugozapadni	j u ɡ o z ǎː p a d n iː
jugozapadno	j u ɡ o z ǎː p a d n o
juha	j ǔː x a
junakinja	j u n ǎ k i ɲ a
junaštvo	j u n ǎː ʃ t ʋ o
juni	j ûː n i
junica	j ǔ n i t͡s a
jupiter	j ǔ p i t e r
jure	j û r e
juriš	j û r iː ʃ
jurišati	j u r ǐ ʃ a t i
jurnuti	j ǔː r n u t i
justin	j û s t i n
jutarnji	j û t aː r ɲ iː
jutro	j û t r o
jutrom	j û t r o m
jutros	j û t r oː s
juče	j ǔ t͡ʃ eː
jučer	j ǔ t͡ʃ eː r
južno	j û ʒ n o
kaba	k ǎː b a
kabao	k ǎ b a o
kabare	k a b a r êː
kabul	k ǎː b u l
kadet	k ǎ d eː t
kadikad	k a d i k a d
kafa	k ǎ f a
kafana	k a f ǎ n a
kairo	k ǎ i r o
kaiš	k ǎ i ʃ
kaj	k â j
kajak	k â j aː k
kajati	k â j a t i
kajgana	k â j ɡ a n a
kajiš	k ǎ j i ʃ
kaka	k ǎː k a
kakaovac	k ǎ k a o ʋ a t͡s
kakav	k ǎ k aː ʋ
kalež	k â l e ʒ
kalifat	k a l ǐ f aː t
kalkulacija	k a l k u l ǎː t͡s i j a
kalup	k ǎ l u p
kam	k âː m
kamata	k â m a t a
kambodža	k a m b ǒ d͡ʒ a
kameleon	k a m e l ě oː n
kamen	k â m eː n
kamenac	k a m ěː n a t͡s
kamenje	k ǎ m eː ɲ e
kamenovati	k â m e n o ʋ a t i
kamerun	k â m e r uː n
kamerunac	k a m e r ǔː n a t͡s
kamerunski	k â m e r uː n s k iː
kamion	k a m ǐ oː n
kamo	k â m o
kamoli	k â m o l i
kampanja	k a m p ǎ ɲ a
kampućija	k a m p ǔ t͡ɕ i j a
kan	k âː n
kanabis	k ǎ n a b i s
kanadski	k ǎ n a d s k iː
kanal	k ǎ n aː l
kanalizacija	k a n a l i z ǎː t͡s i j a
kanarinac	k a n a r ǐː n a t͡s
kancelarija	k a n t͡s e l ǎ r i j a
kandidat	k a n d ǐ d aː t
kandidatura	k a n d i d a t ǔː r a
kandidirati	k a n d i d ǐː r a t i
kanjon	k ǎ ɲ oː n
kanu	k ǎ n uː
kao	k â o
kaos	k â o s
kapa	k â p a
kapacitet	k a p a t͡s ǐ t eː t
kapela	k a p ěː l a
kapelan	k a p ě l aː n
kapelica	k a p ěː l i t͡s a
kapetan	k a p ě t aː n
kapija	k ǎ p i j a
kapilara	k a p i l ǎː r a
kapitalno	k â p i t aː l n o
kapljica	k â p ʎ i t͡s a
kaput	k ǎ p uː t
karakteristika	k a r a k t e r ǐ s t i k a
karakterističan	k a r a k t e r ǐ s t i t͡ʃ a n
karati	k ǎː r a t i
karavan	k a r ǎ ʋ aː n
karavana	k a r a ʋ ǎ n a
karavanski	k a r ǎ ʋ aː n s k iː
kardiolog	k a r d i ǒ l o ɡ
karijes	k âː r i j e s
karika	k ǎ r i k a
karikatura	k a r i k a t ǔː r a
karikaturistički	k a r i k a t u r ǐ s t i t͡ʃ k iː
karizma	k a r ǐ z m a
karlovac	k âː r l o ʋ a t͡s
karneval	k a r n ě ʋ aː l
karta	k âː r t a
kartica	k ǎ r t i t͡s a
karton	k ǎ r t oː n
kas	k âː s
kasaba	k a s ǎ b a
kaskada	k a s k ǎː d a
kasnije	k ǎ s n i j eː
kasniti	k ǎ s n i t i
kasno	k â s n o
katalonski	k a t ǎ l oː n s k iː
katanac	k ǎ t a n a t͡s
katar	k â t a r
katarza	k a t ǎ r z a
katastrofalan	k â t a s t r o f aː l a n
katastrofalno	k â t a s t r o f aː l n o
katedra	k ǎ t eː d r a
katedrala	k a t e d r ǎː l a
kategorija	k a t e ɡ ǒ r i j a
kategoričan	k a t e ɡ ǒ r i t͡ʃ a n
katkad	k a t k a d
katolicizam	k a t o l i t͡s ǐ z a m
katolik	k â t o l iː k
katolički	k â t o l i t͡ʃ k iː
kauč	k â uː t͡ʃ
kava	k ǎ ʋ a
kavana	k a ʋ ǎ n a
kavez	k ǎ ʋ e z
kavga	k âː ʋ ɡ a
kazališni	k ǎ z a l iː ʃ n iː
kazalište	k ǎ z a l iː ʃ t e
kazalo	k ǎ z a l o
kazan	k ǎ z a n
kazati	k ǎː z a t i
kazna	k â z n a
kazneni	k ǎ z n e n iː
kazneno	k ǎ z n e n o
kačket	k ǎ t͡ʃ k eː t
kda	ɡ d aː
kec	k êː t͡s
kelj	k ê ʎ
kelt	k ê l t
kemijski	k ěː m iː j s k iː
kemikalija	k e m i k ǎ l i j a
kemičar	k ě m i t͡ʃ aː r
kenija	k êː n i j a
kenijac	k e n ǐː j a t͡s
kenijski	k êː n iː j s k iː
kesa	k ê s a
kestenjast	k ê s t e ɲ a s t
kijev	k î j e ʋ
kiklop	k ǐ k l o p
kilogram	k î l o ɡ r a m
kime	k ǐː m e
kina	k ǐː n a
kirgistan	k î r ɡ i s t aː n
kirija	k ǐ r i j a
kiselina	k i s e l ǐ n a
kisik	k ǐ s iː k
kita	k î t a
kititi	k î t i t i
kitolov	k î t o l o ʋ
kič	k î t͡ʃ
kiša	k î ʃ a
kladiti	k l â d i t i
klanjati	k l â ɲ a t i
klaonica	k l a ǒː n i t͡s a
klarinet	k l a r ǐ n eː t
klasik	k l ǎ s i k
klasičan	k l ǎ s i t͡ʃ a n
klati	k l â t i
klavir	k l ǎ ʋ iː r
kleptomanka	k l e p t ǒ m aː n k a
kletva	k l êː t ʋ a
kleveta	k l ě ʋ e t a
klik	k l î k
kliknuti	k l î k n u t i
klima	k l ǐː m a
klin	k l î n
klinac	k l î n a t͡s
klitoris	k l ǐ t oː r i s
klizalište	k l ǐ z a l iː ʃ t e
klizati	k l ǐː z a t i
klizav	k l î z a ʋ
klizač	k l ǐ z aː t͡ʃ
kliziti	k l ǐː z i t i
kljova	k ʎ ôː ʋ a
ključ	k ʎ ûː t͡ʃ
ključan	k ʎ ûː t͡ʃ a n
klobučar	k l ǒ b u t͡ʃ aː r
kloniti	k l ǒ n i t i
klopka	k l ô p k a
klub	k l ûː b
klupa	k l ǔː p a
klupko	k l û p k o
klupski	k l ûː p s k iː
knez	k n êː z
knjiga	k ɲ î ɡ a
knjižara	k ɲ ǐ ʒ a r a
književni	k ɲ î ʒ eː ʋ n iː
književnik	k ɲ ǐ ʒ eː ʋ n iː k
književno	k ɲ î ʒ eː ʋ n o
književnost	k ɲ î ʒ eː ʋ n oː s t
knjižni	k ɲ î ʒ n iː
knjižnica	k ɲ ǐː ʒ n i t͡s a
knut	k n û t
koaksijalan	k ô a k s i j aː l a n
koalicija	k o a l ǐː t͡s i j a
koalicijski	k o a l ǐː t͡s iː j s k iː
koalirati	k o a l ǐː r a t i
koautor	k o ǎ u t o r
koautorstvo	k o a u t ǒː r s t ʋ o
kob	k ôː b
koban	k ôː b a n
kobasica	k o b ǎ s i t͡s a
kobilica	k ǒ b i l i t͡s a
kobno	k ôː b n o
kodeks	k ǒ d e k s
koeficijent	k o e f i t͡s ǐ j e n t
koegzistencija	k o e ɡ z i s t ě n t͡s i j a
kofein	k o f ě iː n
kog	k ô ɡ
koj	k ǒ j
koješta	k o j ě ʃ t a
koji	k ǒ j iː
koketan	k ǒ k e t a n
kokoška	k ǒ k oː ʃ k a
kolač	k ǒ l aː t͡ʃ
kolega	k o l ěː ɡ a
kolektiv	k ô l e k t iː ʋ
kolektivno	k ô l e k t iː ʋ n o
koliba	k ǒ l i b a
kolica	k o l ǐː t͡s a
koliko	k o l ǐ k o
kolodvor	k ô l o d ʋ oː r
kolona	k o l ǒː n a
kolonija	k ǒ l oː n i j a
kolonizacija	k o l o n i z ǎː t͡s i j a
kolosalan	k ô l o s aː l a n
kolosijek	k ô l o s i j eː k
kolovoz	k ô l o ʋ oː z
kolumbija	k o l ǔ m b i j a
kolumbijski	k o l ǔ m b iː j s k iː
komad	k ǒ m aː d
komadić	k o m ǎ d i t͡ɕ
komanda	k ǒ m aː n d a
komandant	k o m ǎ n d a n t
kombajn	k ǒ m b a j n
kome	k ǒ m e
komedija	k ǒ m eː d i j a
komemoracija	k o m e m o r ǎː t͡s i j a
komentator	k o m ě n t aː t o r
komentirati	k o m e n t ǐː r a t i
komercijalan	k ô m e r t͡s i j aː l a n
komercijalno	k ô m e r t͡s i j aː l n o
komesar	k o m ě s aː r
komfor	k ǒ m f oː r
komitet	k o m ǐ t eː t
komičan	k ǒ m i t͡ʃ a n
komičar	k ǒ m i t͡ʃ aː r
komora	k ǒ m o r a
komorač	k o m ǒ r aː t͡ʃ
kompa	k o m p ǎ
kompas	k ǒ m p a s
kompetencija	k o m p e t ě n t͡s i j a
kompjuter	k o m p j ǔ t e r
kompleks	k ǒ m p l e k s
komplet	k ǒ m p l e t
komponenta	k o m p ǒ n e n t a
kompozitor	k o m p ǒ z iː t o r
kompresor	k ǒ m p r e s o r
kompromis	k o m p r ǒ m i s
kompromisno	k o m p r ǒ m i s n o
kompromitirati	k o m p r o m i t ǐː r a t i
komu	k ǒ m u
komunicirati	k o m u n i t͡s ǐː r a t i
komšiluk	k o m ʃ ǐ l u k
konac	k ǒ n a t͡s
konak	k ǒ n a k
konačan	k ǒ n a t͡ʃ a n
konačno	k ǒ n a t͡ʃ n o
koncentrat	k o n t͡s ě n t r aː t
koncepcija	k o n t͡s ě p t͡s i j a
koncert	k ǒ n t͡s e r t
koncesija	k o n t͡s ě s i j a
kondukter	k o n d ǔ k t eː r
konfederacija	k o n f e d e r ǎː t͡s i j a
konferencija	k o n f e r ě n t͡s i j a
konfesija	k o n f ě s i j a
konfuzija	k ǒ n f uː z i j a
kongo	k ô n ɡ o
kongres	k ǒ n ɡ r e s
kongresmen	k ǒ n ɡ r e s m e n
konj	k ô ɲ
konjica	k ô ɲ iː t͡s a
konjušar	k o ɲ ǔ ʃ aː r
konkretan	k ǒ n k r e t a n
konkretno	k ǒ n k r e t n o
konkurent	k o n k ǔ r e n t
konoba	k ǒ n o b a
konobarica	k o n o b ǎ r i t͡s a
konopac	k ǒ n o p a t͡s
konotacija	k o n o t ǎː t͡s i j a
konsenzus	k o n s ě n z u s
konstanta	k o n s t ǎ n t a
konstitutivan	k ô n s t i t u t iː ʋ a n
konstruirati	k o n s t r u ǐː r a t i
konstruktivan	k ô n s t r u k t iː ʋ a n
kontakt	k ǒ n t a k t
kontaminacija	k o n t a m i n ǎː t͡s i j a
kontejner	k o n t ě j n e r
kontekst	k ǒ n t e k s t
kontemplacija	k o n t e m p l ǎː t͡s i j a
kontinent	k o n t ǐ n e n t
kontinuiran	k o n t i n ǔ iː r a n
kontinuirano	k o n t i n ǔ iː r a n o
kontinuitet	k o n t i n u ǐ t eː t
konto	k ô n t o
kontra	k ô n t r a
kontracepcija	k o n t r a t͡s ě p t͡s i j a
kontrakcija	k o n t r ǎ k t͡s i j a
kontrast	k ǒ n t r a s t
kontrola	k o n t r ǒː l a
kontroverzno	k o n t r o ʋ ě r z n o
konvencija	k o n ʋ ě n t͡s i j a
konverzacija	k o n ʋ e r z ǎː t͡s i j a
konvoj	k ǒ n ʋ o j
konzervativno	k ô n z e r ʋ a t iː ʋ n o
konzul	k ôː n z u l
konzumacija	k o n z u m ǎː t͡s i j a
kooperativan	k ô o p e r a t iː ʋ a n
koordinacija	k o o r d i n ǎː t͡s i j a
kopar	k ô p a r
kopati	k ǒ p a t i
kopenhagen	k o p e n x ǎː ɡ e n
koplje	k ô p ʎ e
kopriva	k ǒ p r i ʋ a
kopča	k ô p t͡ʃ a
korak	k ô r aː k
koreja	k o r ěː j a
korejski	k ǒ r eː j s k iː
korektan	k ǒ r e k t a n
korektno	k ǒ r e k t n o
korelacija	k o r e l ǎː t͡s i j a
koren	k ô r eː n
koreograf	k o r e ǒ ɡ r a f
korice	k ô r i t͡s e
korijen	k ô r j eː n
korisno	k ô r i s n o
korisnost	k ô r iː s n oː s t
koristan	k ô r iː s t a n
kormilo	k ǒ r m i l o
korner	k ô r n e r
kornjača	k ǒ r ɲ a t͡ʃ a
korov	k ǒː r o ʋ
korporacija	k o r p o r ǎː t͡s i j a
korpus	k ǒ r p u s
korupcija	k o r ǔ p t͡s i j a
korzika	k ǒ r z i k a
kos	k ôː s
kosa	k ǒ s a
kosijer	k ǒ s i j eː r
kosovo	k ô s o ʋ o
kotar	k ô t aː r
kotizacija	k o t i z ǎː t͡s i j a
kotlina	k ǒ t l i n a
kotlovnica	k ǒ t l oː ʋ n i t͡s a
kotor	k ô t o r
kotoriba	k o t ǒ r i b a
kovati	k ǒ ʋ a t i
kovač	k ǒ ʋ aː t͡ʃ
kovrdžav	k ǒ ʋ r d͡ʒ a ʋ
kovčežić	k ǒ ʋ t͡ʃ e ʒ i t͡ɕ
koza	k ǒ z a
kozice	k ǒ z i t͡s e
kozina	k ô z i n a
kozinščak	k o z ǐ n ʃ t͡ʃ aː k
kozlić	k ô z l i t͡ɕ
kozmetika	k o z m ě t i k a
kozmos	k ô z m o s
kočija	k ǒ t͡ʃ i j a
kočnica	k ô t͡ʃ n i t͡s a
košarkaš	k o ʃ ǎ r k aː ʃ
košarkašica	k o ʃ a r k ǎ ʃ i t͡s a
košarkaški	k o ʃ ǎ r k aː ʃ k iː
koštac	k ǒ ʃ t a t͡s
koštati	k ô ʃ t a t i
koštica	k ǒ ʃ t i t͡s a
koštunica	k o ʃ t ǔ n i t͡s a
košulja	k ǒ ʃ u ʎ a
košćan	k ǒ ʃ t͡ɕ a n
koščica	k ǒ ʃ t͡ʃ i t͡s a
kožni	k ô ʒ n iː
krah	k r â x
krajem	k r â j e m
krajina	k r â j i n a
krajišnik	k r ǎ j i ʃ n iː k
krajnje	k r âː j ɲ eː
krajnji	k r âː j ɲ iː
krajnost	k r ǎː j n oː s t
krajolik	k r â j o l i k
krak	k r âː k
kralj	k r âː ʎ
kraljević	k r ǎː ʎ e ʋ i t͡ɕ
kraljevski	k r ǎː ʎ e ʋ s k iː
kraljevstvo	k r ǎː ʎ e ʋ s t ʋ o
kralježak	k r ǎː ʎ e ʒ a k
kralježnica	k r ǎː ʎ e ʒ n i t͡s a
kraljica	k r ǎ ʎ i t͡s a
kran	k r âː n
kranj	k r âː ɲ
kras	k r a s
krasna	k r â s n a
krasopisno	k r â s o p iː s n o
krastavac	k r â s t a ʋ a t͡s
kratak	k r ǎ t a k
kratica	k r ǎ t i t͡s a
kratko	k r â t k o
kratkometražni	k r a t k o m ě t r aː ʒ n iː
kratkotrajan	k r â t k o t r aː j a n
kratkovidno	k r a t k ǒ ʋ i d n o
kratkovidnost	k r a t k o ʋ ǐː d n oː s t
kraul	k r ǎ u l
kravarica	k r â ʋ a r i t͡s a
kravlji	k r â ʋ ʎ iː
kraćenje	k r ǎː t͡ɕ eː ɲ e
krađa	k r â d͡ʑ a
krašićanac	k r a ʃ i t͡ɕ ǎː n a t͡s
kreacija	k r e ǎː t͡s i j a
kreativan	k r ê a t iː ʋ a n
kreditor	k r ě d iː t o r
kreirati	k r e ǐː r a t i
kremlj	k r ê m ʎ
kremšnita	k r ě m ʃ n i t a
krenuti	k r ěː n u t i
kreolski	k r ě oː l s k iː
kresta	k r ěː s t a
krestac	k r ě s t a t͡s
kreta	k r ěː t a
kreten	k r ě t eː n
kretenizam	k r e t e n ǐ z a m
krevet	k r ě ʋ e t
krevetić	k r ě ʋ e t i t͡ɕ
kreševo	k r ê ʃ e ʋ o
kreševski	k r ê ʃ e ʋ s k iː
krf	k r̂ f
kriještati	k r i j ěː ʃ t a t i
krik	k r î k
krilni	k r îː l n iː
krilo	k r ǐː l o
krimen	k r îː m e n
kriminal	k r i m ǐ n aː l
kriminalac	k r i m i n ǎː l a t͡s
kriminalitet	k r i m i n a l ǐ t eː t
kriminologija	k r i m i n o l ǒ ɡ i j a
krimić	k r î m i t͡ɕ
krin	k r îː n
krinka	k r îː n k a
kripta	k r î p t a
kris	k r îː s
kristadelfijanski	k r i s t a d e l f i j a n s k i
kristal	k r ǐ s t aː l
kristalni	k r ǐ s t a l n iː
kristalno	k r ǐ s t aː l n o
kriterij	k r ǐ t eː r i j
kriti	k r î t i
kriticizam	k r i t i t͡s ǐ z a m
kritika	k r ǐ t i k a
kritikant	k r i t ǐ k a n t
kritizirati	k r i t i z ǐː r a t i
kritičan	k r ǐ t i t͡ʃ a n
kritičar	k r ǐ t i t͡ʃ aː r
kritički	k r ǐ t i t͡ʃ k iː
kritično	k r ǐ t i t͡ʃ n o
kriv	k r îː ʋ
krivica	k r i ʋ ǐ t͡s a
kriviti	k r ǐː ʋ i t i
krivični	k r ǐ ʋ i t͡ʃ n iː
krivično	k r ǐ ʋ i t͡ʃ n o
krivo	k r îː ʋ o
krivodol	k r i ʋ ǒ d o l
krivotvorina	k r i ʋ o t ʋ ǒ r i n a
krivovjerje	k r i ʋ ǒ ʋ j eː r j e
krivudav	k r i ʋ ǔ d a ʋ
krivulja	k r ǐ ʋ u ʎ a
kriza	k r ǐː z a
krizni	k r îː z n iː
kričati	k r ǐ t͡ʃ a t i
kriška	k r î ʃ k a
križ	k r îː ʒ
križaljka	k r ǐː ʒ aː ʎ k a
križanac	k r i ʒ ǎː n a t͡s
križanje	k r ǐː ʒ aː ɲ e
križevački	k r ǐː ʒ e ʋ a t͡ʃ k iː
križevci	k r ǐː ʒ eː ʋ t͡s i
križevčanin	k r ǐː ʒ e ʋ t͡ʃ a n i n
krk	k r̂ k
krkan	k ř k a n
krkljanac	k r k ʎ ǎː n a t͡s
krmak	k řː m a k
krmelj	k ř m e ʎ
krnjak	k r̂ ɲ aː k
krnjav	k r̂ ɲ a ʋ
kroasan	k r o ǎ s aː n
krojiti	k r ǒ j i t i
kroki	k r ǒ k iː
krompir	k r ǒ m p iː r
kroničan	k r ǒ n i t͡ʃ a n
kronično	k r ǒ n i t͡ʃ n o
kronologija	k r o n o l ǒ ɡ i j a
krov	k r ô ʋ
kroz	k r ô z
kročiti	k r ǒ t͡ʃ i t i
krpa	k r̂ p a
krpica	k r̂ p i t͡s a
krsni	k ř s n iː
krstariti	k r s t ǎː r i t i
krstina	k ř s t i n a
krstiti	k ř s t i t i
krstokljun	k r̂ s t o k ʎ uː n
krucijalan	k r û t͡s i j aː l a n
kruh	k r û x
kruna	k r û n a
krupa	k r ǔː p a
krupan	k r ǔː p a n
kruška	k r û ʃ k a
kružiti	k r ǔː ʒ i t i
kružni	k r ûː ʒ n iː
krvariti	k r ʋ ǎː r i t i
krvni	k r̂ː ʋ n iː
krvnik	k r̂ː ʋ n iː k
krvotok	k r̂ ʋ o t oː k
krzno	k řː z n o
krčmariti	k r t͡ʃ m ǎː r i t i
kršiti	k ř ʃ i t i
krštenje	k r ʃ t ěː ɲ e
kuba	k ǔː b a
kubanac	k u b ǎː n a t͡s
kubura	k ǔ b u r a
kufer	k ǔ f e r
kuhar	k û x aː r
kuhati	k û x a t i
kuhinja	k û x i ɲ a
kuja	k û j a
kuk	k û k
kuka	k û k a
kukati	k û k a t i
kukavica	k û k a ʋ i t͡s a
kukavički	k û k a ʋ i t͡ʃ k i
kuknjava	k ǔ k ɲ a ʋ a
kuku	k û k uː
kukuruza	k u k u r ǔː z a
kul	k ûː l
kula	k ǔː l a
kulminacija	k u l m i n ǎː t͡s i j a
kult	k û l t
kultni	k û l t n iː
kuna	k ǔː n a
kunić	k ǔ n iː t͡ɕ
kupa	k û p a
kupaći	k ǔ p aː t͡ɕ iː
kupnja	k ǔː p ɲ a
kupola	k ǔ p o l a
kupovati	k u p ǒ ʋ a t i
kupovina	k u p ǒ ʋ i n a
kupus	k ǔ p u s
kurac	k û r a t͡s
kurban	k ǔ r b aː n
kuriozitet	k u r i o z ǐ t eː t
kurir	k ǔ r iː r
kurs	k û r s
kurva	k ûː r ʋ a
kurvica	k ûː r ʋ i t͡s a
kurziv	k ǔ r z iː ʋ
kustos	k û s t o s
kut	k ûː t
kutija	k ǔ t i j a
kuvajt	k û ʋ aː j t
kuvar	k û ʋ aː r
kuvati	k û ʋ a t i
kuća	k û t͡ɕ a
kući	k û t͡ɕ i
kućica	k û t͡ɕ i t͡s a
kućni	k û t͡ɕ n iː
kučka	k û t͡ʃ k a
kvadratni	k ʋ ǎ d r aː t n iː
kvaka	k ʋ â k a
kvaliteta	k ʋ a l i t ěː t a
kvalitetan	k ʋ â l i t eː t a n
kvantitativno	k ʋ â n t i t a t iː ʋ n o
kvantitet	k ʋ a n t ǐ t eː t
kvantiteta	k ʋ a n t i t ěː t a
kvar	k ʋ âː r
kvartal	k ʋ ǎ r t aː l
kvartalno	k ʋ ǎ r t aː l n o
kvartet	k ʋ ǎ r t eː t
kvasac	k ʋ ǎː s a t͡s
kvačilo	k ʋ â t͡ʃ i l o
kvintet	k ʋ ǐ n t eː t
kćer	k t͡ɕ êː r
kćerka	k t͡ɕ ěː r k a
kći	k t͡ɕ îː
labaviti	l â b a ʋ i t i
labavo	l â b a ʋ o
labirint	l a b ǐ r i n t
laboratorij	l a b o r a t oː r i j
labudica	l â b u d i t͡s a
lagan	l â ɡ a n
lagano	l â ɡ a n o
lagati	l ǎ ɡ a t i
lagodan	l â ɡ o d a n
lagodnost	l â ɡ o d n oː s t
lagumdžija	l a ɡ ǔ m d͡ʒ i j a
lajavo	l â j a ʋ o
lak	l â k
lako	l â k o
lakom	l â k o m
lakovjerno	l â k o ʋ j eː r n o
lanac	l ǎː n a t͡s
lanjski	l ǎ ɲ s k iː
lansirati	l a n s ǐː r a t i
lančani	l ǎ n t͡ʃ a n iː
laos	l â o s
larma	l âː r m a
lascivan	l ǎ s t͡s iː ʋ a n
laser	l â s e r
lastavica	l â s t a ʋ i t͡s a
latentno	l a t ě n t n o
lateralno	l â t e r aː l n o
latin	l ǎ t iː n
latinica	l a t ǐ n i t͡s a
latinski	l ǎ t iː n s k iː
lazar	l â z aː r
laž	l âː ʒ
lažan	l â ʒ a n
lažirati	l a ʒ ǐː r a t i
lažljivac	l ǎ ʒ ʎ i ʋ a t͡s
lažno	l â ʒ n o
lažov	l ǎ ʒ o ʋ
lebdjeti	l ě b d j e t i
led	l êː d
ledenica	l e d ě n i t͡s a
ledenjak	l e d ě ɲ aː k
ledina	l ě d i n a
ledolomac	l e d o l ǒː m a t͡s
legalan	l ě ɡ aː l a n
legalizacija	l e ɡ a l i z ǎː t͡s i j a
legalno	l ě ɡ aː l n o
legendaran	l ê ɡ e n d aː r a n
legitiman	l ê ɡ i t iː m a n
legitimno	l ê ɡ i t iː m n o
leja	l ěː j a
lekcija	l ě k t͡s i j a
leopard	l ê o p aː r d
lep	l êː p
lepeza	l e p ěː z a
lepo	l êː p o
lepojka	l ě p oː j k a
lepršati	l e p ř ʃ a t i
leptir	l ê p t iː r
leptirić	l e p t ǐ r i t͡ɕ
ler	l êː r
les	l êː s
let	l êː t
letak	l ê t a k
leteći	l ě t eː t͡ɕ iː
letjelica	l ě t j e l i t͡s a
letjeti	l ě t j e t i
leto	l ê t o
letva	l ê t ʋ a
leđa	l ěː d͡ʑ a
leš	l e ʃ
ležati	l ě ʒ a t i
ležeran	l ê ʒ eː r a n
li	l i
liberalan	l î b e r aː l a n
liberalizam	l i b e r a l ǐ z a m
liberalno	l î b e r aː l n o
libido	l ǐ b i d o
libija	l îː b i j a
libijski	l îː b iː j s k iː
lice	l ǐː t͡s e
licemjer	l î t͡s e m j e r
licemjeran	l î t͡s e m j eː r a n
licemjerje	l î t͡s e m j eː r j e
licemjerno	l î t͡s e m j eː r n o
licenca	l ǐ t͡s eː n t͡s a
licencija	l i t͡s ě n t͡s i j a
licitacija	l i t͡s i t ǎː t͡s i j a
lider	l ǐː d e r
lift	l î f t
liga	l ǐː ɡ a
lijen	l i j êː n
lijeno	l j êː n o
lijenost	l i j ěː n oː s t
lijep	l i j êː p
lijepo	l i j êː p o
lijes	l i j êː s
lijevi	l j êː ʋ iː
liječiti	l i j ěː t͡ʃ i t i
liječnik	l i j êː t͡ʃ n iː k
likvidacija	l i k ʋ i d ǎː t͡s i j a
lima	l î m a
limar	l î m aː r
limun	l î m uː n
limunada	l i m u n ǎː d a
limunov	l î m uː n o ʋ
limuzina	l i m u z ǐː n a
linearno	l î n e aː r n o
lingvista	l ǐ n ɡ ʋ i s t a
linija	l ǐː n i j a
lipa	l î p a
lipanj	l îː p a ɲ
lipov	l î p o ʋ
lira	l îː r a
lisa	l î s a
list	l îː s t
listić	l ǐ s t i t͡ɕ
listom	l îː s t o m
listopad	l î s t o p aː d
litanija	l i t ǎ n i j a
liturgija	l i t ǔ r ɡ i j a
litvanski	l ǐ t ʋ aː n s k iː
livada	l ǐ ʋ a d a
lizati	l ǐː z a t i
lično	l î t͡ʃ n o
ličnost	l î t͡ʃ n oː s t
lišaj	l î ʃ aː j
lišće	l îː ʃ t͡ɕ e
ljepljiv	ʎ ě p ʎ i ʋ
ljestve	ʎ ê s t ʋ e
ljeti	ʎ ê t i
ljeto	ʎ ê t o
ljetos	ʎ ê t oː s
ljevičar	ʎ ě ʋ i t͡ʃ aː r
lješnjak	ʎ ê ʃ ɲ aː k
ljubavni	ʎ ǔː b aː ʋ n iː
ljubavnica	ʎ ǔː b aː ʋ n i t͡s a
ljubavnik	ʎ ǔː b aː ʋ n iː k
ljubazan	ʎ û b a z a n
ljubazno	ʎ û b a z n o
ljubaznost	ʎ û b a z n oː s t
ljubica	ʎ û b i t͡s a
ljubitelj	ʎ ǔ b i t e ʎ
ljubiti	ʎ ǔː b i t i
ljubljana	ʎ u b ʎ ǎ n a
ljubomora	ʎ u b ǒ m o r a
ljubomoran	ʎ û b o m oː r a n
ljubomorno	ʎ û b o m oː r n o
ljudi	ʎ ûː d i
ljudski	ʎ ǔ d s k iː
ljudskost	ʎ û d s k oː s t
ljudstvo	ʎ ǔ d s t ʋ o
ljutiti	ʎ ǔː t i t i
ljutnja	ʎ ǔː t ɲ a
lobotomija	l o b o t ǒ m i j a
logičan	l ǒ ɡ i t͡ʃ a n
logički	l ǒ ɡ i t͡ʃ k iː
logično	l ǒ ɡ i t͡ʃ n o
logor	l ôː ɡ o r
logos	l ôː ɡ o s
lojalnost	l o j ǎː l n oː s t
lokal	l ǒ k aː l
lokativ	l ô k a t iː ʋ
lombardija	l o m b ǎ r d i j a
lomiti	l ǒ m i t i
lonac	l ǒ n a t͡s
london	l ǒ n d oː n
londonski	l ǒ n d oː n s k iː
longitudinalan	l ô n ɡ i t u d i n aː l a n
lončar	l ǒ n t͡ʃ aː r
lončić	l ǒ n t͡ʃ i t͡ɕ
lopata	l ǒ p a t a
lopov	l ǒː p o ʋ
lopta	l ô p t a
loptica	l ô p t i t͡s a
lord	l ô r d
los	l ô s
losion	l o s ǐ oː n
losos	l ô s o s
lov	l ôː ʋ
lova	l ǒː ʋ a
lovački	l ǒ ʋ a t͡ʃ k iː
loviti	l ǒ ʋ i t i
lovište	l ô ʋ iː ʃ t e
lovorov	l ô ʋ o r o ʋ
lovočuvar	l o ʋ o t͡ʃ ǔ ʋ aː r
loš	l ô ʃ
lubenica	l u b ě n i t͡s a
lucidno	l û t͡s iː d n o
lud	l ûː d
luda	l û d a
ludilo	l ǔ d i l o
ludnica	l ǔː d n i t͡s a
ludo	l ûː d o
ludorija	l u d ǒ r i j a
luka	l ǔː k a
lukavac	l û k a ʋ a t͡s
luksemburg	l û k s e m b u r ɡ
luksemburški	l ǔ k s e m b u r ʃ k iː
luksuzan	l ǔ k s u z a n
luksuzno	l ǔ k s u z n o
lumbrela	l ǔ m b r e l a
luna	l uː n a
lupanje	l ǔː p aː ɲ e
lupati	l ǔː p a t i
lutalica	l ǔː t a l i t͡s a
lutati	l ǔː t a t i
luteranski	l u t ě r aː n s k iː
lutnja	l ǔː t ɲ a
luđak	l ǔ d͡ʑ aː k
maca	m ǎː t͡s a
macan	m ǎ t͡s a n
madagaskar	m a d a ɡ ǎ s k aː r
madrid	m ǎ d r iː d
mafija	m ǎː f i j a
magarac	m ǎ ɡ a r a t͡s
magare	m ǎ ɡ a r e
magija	m ǎ ɡ i j a
magistar	m a ɡ ǐ s t a r
magla	m ǎ ɡ l a
maglica	m ǎ ɡ l i t͡s a
maglina	m ǎ ɡ l i n a
magličast	m ǎ ɡ l i t͡ʃ a s t
maglovit	m a ɡ l ǒ ʋ i t
magma	m ǎ ɡ m a
magnat	m ǎ ɡ n aː t
magnet	m ǎ ɡ n eː t
magnetit	m a ɡ n ě t iː t
magnetizam	m a ɡ n e t ǐ z a m
mahala	m ǎ x a l a
mahom	m âː x o m
mahovina	m ǎ x o ʋ i n a
maj	m â j
majka	m âː j k a
majkrosoft	m ǎ j k r o s o f t
majmun	m ǎ j m u n
majmunski	m ǎ j m u n s k iː
majoneza	m a j o n ěː z a
major	m ǎ j oː r
majčin	m âː j t͡ʃ iː n
mak	m â k
makadam	m ǎ k a d a m
makar	m ǎ k a r
makaze	m ǎ k a z e
makedonija	m a k ě d oː n i j a
makedonski	m a k ě d oː n s k iː
makljaža	m a k ʎ ǎː ʒ a
makljen	m â k ʎ e n
maknuti	m ǎ k n u t i
makro	m â k r o
maksi	m â k s i
maksimalan	m â k s i m aː l a n
maksimalno	m â k s i m aː l n o
mal	m âː l
malarija	m ǎ l aː r i j a
malezija	m ǎ l eː z i j a
mali	m âː l i
maliciozno	m â l i t͡s i oː z n o
malik	m ǎ l i k
malo	m â l o
maloljetnica	m â l o ʎ e t n i t͡s a
maloljetnik	m â l o ʎ e t n iː k
maloprije	m â l o p r i j e
maloprodajni	m a l o p r ǒ d aː j n iː
maločas	m â l o t͡ʃ a s
malta	m âː l t a
malter	m ǎ l t e r
mama	m â m a
mamica	m â m i t͡s a
mamiti	m ǎː m i t i
mamurluk	m a m ǔ r l u k
manastir	m â n a s t iː r
mandarina	m a n d a r ǐː n a
mandat	m ǎ n d aː t
manekenka	m a n ě k eː n k a
manijak	m ǎ n i j aː k
manipulacija	m a n i p u l ǎː t͡s i j a
manjina	m a ɲ ǐ n a
manjinski	m ǎ ɲ iː n s k iː
mapa	m â p a
maraka	m â r aː k aː
marama	m ǎ r a m a
maramica	m ǎ r a m i t͡s a
maraton	m â r a t oː n
marci	m ǎ r t͡s i
marcipan	m a r t͡s ǐ p aː n
marelica	m a r ě l i t͡s a
marihuana	m a r i x u ǎ n a
marija	m ǎ r i j a
marina	m a r ǐː n a
marke	m ǎ r k e
markiza	m a r k ǐː z a
marko	m âː r k o
marksizam	m a r k s ǐ z a m
marku	m ǎ r k u
marljivo	m ǎ r ʎ i ʋ o
marljivost	m ǎ r ʎ i ʋ oː s t
mars	m â r s
mart	m â r t
marva	m âː r ʋ a
marš	m â r ʃ
maršal	m ǎ r ʃ aː l
masakr	m a s ǎ k r
masaža	m a s ǎː ʒ a
maser	m ǎ s eː r
masiv	m ǎ s iː ʋ
maslina	m ǎ s l i n a
maslo	m â s l o
masnoća	m a s n ǒ t͡ɕ a
masovno	m â s oː ʋ n o
mast	m âː s t
mastan	m ǎː s t a n
materica	m â t e r i t͡s a
materijal	m a t e r ǐ j aː l
materinji	m â t e r i ɲ iː
maternica	m â t e r n i t͡s a
maternji	m ǎ t eː r ɲ iː
mati	m â t i
matrica	m a t r ǐ t͡s a
mauzolej	m a u z ǒ l e j
mazati	m â z a t i
mazohizam	m a z o x ǐ z a m
maćeha	m â t͡ɕ e x a
mač	m â t͡ʃ
mačka	m â t͡ʃ k a
mačor	m â t͡ʃ o r
mađar	m ǎ d͡ʑ aː r
mađarska	m â d͡ʑ a r s k aː
mašina	m a ʃ ǐː n a
mašinerija	m a ʃ i n ě r i j a
mašta	m ǎ ʃ t a
maštati	m ǎ ʃ t a t i
maštovito	m a ʃ t ǒ ʋ i t o
med	m êː d
medalja	m ě d a ʎ a
medicina	m e d i t͡s ǐː n a
medicinski	m ê d i t͡s iː n s k iː
medij	m êː d iː j
medijator	m e d ǐ j a t oː r
mediteran	m e d i t ě r aː n
medveđi	m ě d ʋ e d͡ʑ iː
medvjed	m ě d ʋ j e d
medvjedica	m ě d ʋ j e d i t͡s a
megdan	m ě ɡ d aː n
mehanizam	m e x a n ǐ z a m
meka	m ê k a
mekan	m ê k a n
meksički	m ě k s i t͡ʃ k iː
mekteb	m ě k t e b
melem	m ě l e m
melodija	m ě l oː d i j a
melodičan	m e l ǒ d i t͡ʃ a n
membrana	m e m b r ǎː n a
memorandum	m e m o r ǎ n d u m
memorija	m ě m oː r i j a
mena	m ěː n a
mene	m ê n e
menopauza	m e n o p ǎ u z a
mentalitet	m e n t a l ǐ t eː t
mera	m ê r a
merkur	m ě r k uː r
mesečno	m ê s e t͡ʃ n o
meso	m êː s o
mesto	m ê s t o
mestopis	m ê s t o p iː s
meta	m ěː t a
metabolizam	m e t a b o l ǐ z a m
metak	m ê t a k
meteor	m e t ě oː r
metež	m ěː t e ʒ
metla	m ě t l a
metodologija	m e t o d o l ǒ ɡ i j a
metropola	m e t r ǒ p o l a
metvica	m ě t ʋ i t͡s a
meze	m ě z e
mezopotamija	m e z o p o t âː m i j a
mećava	m ě t͡ɕ a ʋ a
mečka	m ê t͡ʃ k a
međa	m ě d͡ʑ a
među	m ê d͡ʑ u
međugorje	m ê d͡ʑ u ɡ oː r j e
međusoban	m ê d͡ʑ u s o b a n
međusobno	m ê d͡ʑ u s o b n o
mešati	m ěː ʃ a t i
meškoljiti	m e ʃ k ǒ ʎ i t i
mi	m îː
micati	m î t͡s a t i
microsoft	m ǎ j k r o s o f t
mijena	m i j ěː n a
mijenjati	m j ěː ɲ a t i
miješati	m j ěː ʃ a t i
mikrobiologija	m i k r o b i o l ǒ ɡ i j a
mikrofon	m î k r o f oː n
milano	m i l âː n o
mili	m î l iː
milijarda	m i l ǐ j aː r d a
milijun	m i l ǐ j uː n
milimetar	m ǐ l i m e t a r
milion	m i l ǐ oː n
militantan	m i l i t ǎ n t a n
militarizacija	m i l i t a r i z ǎː t͡s i j a
milja	m îː ʎ a
miljenik	m î ʎ e n iː k
milovati	m î l o ʋ a t i
mimo	m î m o
minaret	m i n ǎː r e t
mineral	m i n ě r aː l
minijaturni	m î n i j a t uː r n iː
minimalan	m î n i m aː l a n
minimalno	m î n i m aː l n o
minimum	m ǐ n i m u m
ministrica	m ǐ n i s t r i t͡s a
minut	m ǐ n uː t
minuta	m i n ǔː t a
minuti	m ǐː n u t i
mio	m î o
mir	m îː r
miran	m ǐː r a n
miris	m î r iː s
mirisan	m î r iː s a n
mirisati	m i r ǐ s a t i
mirno	m îː r n o
miroslav	m î r o s l a ʋ
mirovati	m i r ǒ ʋ a t i
mirovina	m i r ǒ ʋ i n a
mirovinski	m î r o ʋ iː n s k iː
misal	m ǐ s aː l
misao	m îː s a o
mislilac	m ǐ s l i l a t͡s
misliti	m î s l i t i
misterij	m ǐ s t eː r iː j
misteriozno	m î s t e r i oː z n o
mističan	m ǐ s t i t͡ʃ a n
mistično	m ǐ s t i t͡ʃ n o
miti	m î t i
mitologija	m i t o l ǒ ɡ i j a
miš	m î ʃ
mišar	m î ʃ aː r
mišica	m î ʃ i t͡s a
mišić	m ǐ ʃ iː t͡ɕ
mišićav	m ǐ ʃ i t͡ɕ a ʋ
mišji	m î ʃ j iː
mjehur	m j ê x uː r
mjenica	m j ê n i t͡s a
mjenjač	m j ě ɲ aː t͡ʃ
mjenjačnica	m j ě ɲ aː t͡ʃ n i t͡s a
mjera	m j ê r a
mjerač	m j ě r aː t͡ʃ
mjerilo	m j ê r i l o
mjeriti	m j ê r i t i
mjesecima	m j e s ěː t͡s i m a
mjesečina	m j ê s e t͡ʃ i n a
mjesečni	m j ê s e t͡ʃ n iː
mjesečno	m j ê s e t͡ʃ n o
mjesni	m j ê s n iː
mjesno	m j ê s n o
mjestimično	m j ě s t i m i t͡ʃ n o
mjesto	m j ê s t o
mješavina	m j ě ʃ a ʋ i n a
mještanin	m j ě ʃ t a n i n
mlad	m l âː d
mladež	m l â d e ʒ
mladić	m l ǎ d iː t͡ɕ
mladunče	m l a d ǔː n t͡ʃ e
mlak	m l âː k
mlatiti	m l ǎː t i t i
mleti	m l ê t i
mlijeko	m l i j ěː k o
mliječ	m l i j êː t͡ʃ
mliječni	m l i j êː t͡ʃ n iː
mliko	m l ǐː k o
mlin	m l î n
mnogi	m n ô ɡ iː
mnogo	m n ô ɡ o
mobilan	m ô b iː l a n
mobilnost	m o b ǐː l n oː s t
moda	m ǒː d a
model	m ǒ d e l
modem	m ǒ d eː m
moderan	m ô d eː r a n
modifikacija	m o d i f i k ǎː t͡s i j a
moguć	m ô ɡ uː t͡ɕ
moguće	m ô ɡ uː t͡ɕ e
mogućnost	m o ɡ ǔː t͡ɕ n oː s t
mohikanac	m o x i k ǎː n a t͡s
moj	m ôː j
mojsije	m ǒː j s i j e
mol	m ôː l
moldavija	m ǒ l d aː ʋ i j a
molekula	m o l ě k u l a
moliti	m ǒ l i t i
momak	m ǒ m a k
momčad	m ô m t͡ʃ aː d
monah	m ǒ n a x
monarh	m ǒ n a r x
monarhija	m o n ǎ r x i j a
monetarni	m ô n e t aː r n iː
mongolija	m ǒ n ɡ oː l i j a
monitor	m ǒ n i t o r
monizam	m o n ǐ z a m
monolog	m o n ǒ l o ɡ
monopol	m ô n o p o l
monotonija	m o n o t ǒ n i j a
monstruozan	m ô n s t r u oː z a n
moral	m ǒ r aː l
moram	m ôː r aː m
morati	m ǒː r a t i
more	m ôː r e
mormonizam	m o r m o n ǐ z a m
mornar	m ǒ r n aː r
morski	m ǒ r s k iː
mort	m ô r t
mortalitet	m o r t a l ǐ t eː t
moskovski	m ǒ s k o ʋ s k iː
moskva	m ô s k ʋ a
motel	m ǒ t eː l
motivacija	m o t i ʋ ǎː t͡s i j a
motivirati	m o t i ʋ ǐː r a t i
motocikl	m o t o t͡s ǐ k l
motriti	m ǒ t r i t i
moć	m ôː t͡ɕ
moći	m ô t͡ɕ i
močvara	m ǒ t͡ʃ ʋ a r a
možda	m ǒ ʒ d a
može	m o ʒ e
mramor	m r â m o r
mraz	m r â z
mrkva	m r̂ k ʋ a
mrlja	m r̂ ʎ a
mrtav	m ř t a ʋ
mrtvorođenče	m r t ʋ o r ǒ d͡ʑ eː n t͡ʃ e
mrziti	m řː z i t i
mršav	m r̂ ʃ a ʋ
mucanje	m û t͡s aː ɲ e
mudrac	m ǔ d r a t͡s
mudrost	m ǔː d r oː s t
mudžahedin	m u d͡ʒ a x ě d iː n
muftija	m ǔ f t i j a
muharem	m u x ǎ r e m
mukom	m ûː k o m
mukotrpan	m û k o t rː p a n
mukotrpno	m û k o t rː p n o
mula	m û l a
mulac	m ǔː l a t͡s
mulj	m ûː ʎ
mumija	m ûː m i j a
mumljati	m ǔ m ʎ a t i
muslimanski	m u s l ǐ m aː n s k iː
mutacija	m u t ǎː t͡s i j a
muva	m ǔ ʋ a
muzika	m ǔ z i k a
mučen	m û t͡ʃ e n
mučenica	m û t͡ʃ e n i t͡s a
mučiti	m û t͡ʃ i t i
mučno	m û t͡ʃ n o
mušica	m ǔ ʃ i t͡s a
muž	m ûː ʒ
muževnost	m u ʒ ěː ʋ n oː s t
mužjak	m û ʒ j aː k
na	n a
nabaviti	n ǎ b a ʋ i t i
nabavljati	n ǎ b a ʋ ʎ a t i
nabijati	n a b ǐː j a t i
naboj	n ǎː b o j
nabolje	n â b o ʎ eː
nabor	n ǎː b o r
nabrajati	n a b r ǎː j a t i
nabrojati	n a b r ǒ j a t i
nabrzo	n â b rː z o
nacija	n âː t͡s i j a
nacionalist	n a t͡s i o n ǎ l i s t
nacionalizam	n a t͡s i o n a l ǐ z a m
nacionalni	n â t͡s i o n aː l n iː
nacionalnost	n a t͡s i o n ǎː l n oː s t
nacrtati	n ǎ t͡s r t a t i
nad	n â d
nada	n ǎː d a
nadaren	n ǎ d aː r e n
nadati	n ǎː d a t i
nadimak	n ǎː d i m a k
nadjačati	n a d j ǎ t͡ʃ a t i
nadjenuti	n ǎ d j e n u t i
nadjev	n ǎː d j e ʋ
nadležan	n ǎː d l e ʒ a n
nadležnost	n ǎː d l e ʒ n oː s t
nadmašiti	n ǎ d m a ʃ i t i
nadničar	n â d n i t͡ʃ aː r
nadograđivati	n a d o ɡ r a d͡ʑ ǐː ʋ a t i
nadoknada	n â d o k n a d a
nadoknaditi	n a d ǒ k n a d i t i
nadoknađivati	n a d o k n a d͡ʑ ǐː ʋ a t i
nadomjestak	n a d ǒ m j e s t a k
nadvladati	n a d ʋ l ǎː d a t i
nadvojvoda	n â d ʋ o j ʋ o d a
nadzirati	n ǎ d z i r a t i
nadzor	n ǎː d z o r
nafta	n â f t a
naftovod	n â f t o ʋ oː d
nag	n âː ɡ
nagađati	n a ɡ ǎː d͡ʑ a t i
nagib	n ǎː ɡ i b
naglas	n â ɡ l aː s
naglasak	n ǎː ɡ l a s a k
naglavačke	n a ɡ l a ʋ ǎ t͡ʃ k eː
naglašavati	n a ɡ l a ʃ ǎː ʋ a t i
nagnuti	n ǎ ɡ n u t i
nagovijestiti	n a ɡ o ʋ i j ěː s t i t i
nagovor	n â ɡ o ʋ oː r
nagovoriti	n a ɡ o ʋ ǒ r i t i
nagrada	n âː ɡ r a d a
nagraditi	n a ɡ r ǎː d i t i
nagradni	n âː ɡ r a d n iː
nagrađivati	n a ɡ r a d͡ʑ ǐː ʋ a t i
nagristi	n ǎ ɡ r i s t i
nahraniti	n a x r ǎː n i t i
naime	n ǎ i m e
naivan	n â iː ʋ a n
naivnost	n a ǐː ʋ n oː s t
naići	n ǎ iː t͡ɕ i
najam	n ǎː j a m
najamnina	n a j a m n ǐ n a
najava	n âː j a ʋ a
najaviti	n a j ǎː ʋ i t i
najednom	n a j ě d n oː m
najezda	n â j e z d a
najlon	n ǎ j l oː n
najzad	n â j z a d
nakana	n âː k a n a
nakaza	n ǎː k a z a
nakit	n ǎː k i t
naklada	n âː k l a d a
naklanjati	n ǎ k l a ɲ a t i
naknada	n âː k n a d a
nakon	n ǎ k o n
nakot	n ǎ k o t
nakratko	n â k r a t k o
nakupljati	n a k ǔː p ʎ a t i
nalaz	n ǎː l a z
nalaziti	n ǎ l a z i t i
nalijevo	n â l j eː ʋ o
nalik	n ǎː l i k
nalikovati	n ǎː l i k o ʋ a t i
naljutiti	n a ʎ ǔː t i t i
nama	n â m a
namaknuti	n a m ǎ k n u t i
namamiti	n a m ǎː m i t i
namera	n âː m e r a
nametati	n a m ě t a t i
nametljiv	n a m ě t ʎ i ʋ
nametnuti	n ǎ m e t n u t i
namjenjivati	n a m j e ɲ ǐː ʋ a t i
namjera	n âː m j e r a
namjerno	n ǎː m j e r n o
namještaj	n â m j e ʃ t aː j
namočiti	n a m ǒ t͡ʃ i t i
nana	n ǎː n a
nanovo	n â n o ʋ o
naopako	n â o p aː k o
naopačke	n â o p a t͡ʃ k eː
naoružanje	n a o r u ʒ ǎː ɲ e
naočale	n â o t͡ʃ aː l e
naočare	n â o t͡ʃ aː r e
napamet	n â p a m eː t
napasti	n ǎ p a s t i
napisati	n a p ǐː s a t i
napitak	n ǎː p i t a k
napiti	n ǎ p i t i
naplata	n âː p l a t a
napokon	n â p o k o n
napola	n â p o l a
napolje	n â p o ʎ e
napolju	n â p o ʎ u
napomenuti	n a p o m ěː n u t i
napon	n ǎː p o n
naporan	n ǎː p oː r a n
naporno	n ǎː p oː r n o
naposletku	n a p o s l ěː t k u
naposljetku	n a p o s ʎ ěː t k u
naprava	n âː p r a ʋ a
napredak	n ǎ p r e d a k
napredan	n ǎ p r e d a n
napredovanje	n ǎ p r e d o ʋ aː ɲ e
napredovati	n ǎ p r e d o ʋ a t i
naprema	n ǎ p r e m a
naprijed	n â p r j eː d
naprosto	n â p r o s t o
naprotiv	n â p r o t iː ʋ
napustiti	n a p ǔ s t i t i
napuštati	n a p ǔː ʃ t a t i
narandža	n ǎ r aː n d͡ʒ a
naranča	n ǎ r aː n t͡ʃ a
naredba	n ǎː r e d b a
naredni	n ǎː r e d n iː
narednik	n ǎː r e d n iː k
naricati	n a r ǐː t͡s a t i
narod	n ǎː r o d
narodni	n ǎː r o d n iː
naročit	n ǎː r o t͡ʃ i t
naročito	n ǎː r o t͡ʃ i t o
narudžba	n ǎː r u d͡ʒ b a
narukvica	n ǎ r u k ʋ i t͡s a
naručiti	n a r ǔː t͡ʃ i t i
naručje	n ǎː r uː t͡ʃ j e
nas	n âː s
naseljen	n ǎ s e ʎ e n
naseobina	n ǎː s e o b i n a
nasilan	n ǎː s i l a n
nasilje	n ǎː s iː ʎ e
nasilnik	n ǎː s iː l n iː k
nasilno	n ǎː s i l n o
nasip	n ǎː s i p
naslaga	n âː s l a ɡ a
naslijediti	n a s l i j ěː d i t i
naslikati	n ǎ s l i k a t i
nasljednik	n ǎː s ʎ e d n iː k
nasljeđe	n ǎː s ʎ eː d͡ʑ e
naslon	n ǎː s l o n
naslonjač	n a s l ǒ ɲ aː t͡ʃ
naslov	n ǎː s l o ʋ
naslovnik	n ǎː s l oː ʋ n iː k
naslutiti	n a s l ǔː t i t i
nasmijati	n a s m ǐ j a t i
nasred	n â s r e d
nastati	n ǎ s t a t i
nastavak	n ǎː s t a ʋ a k
nastavljati	n ǎ s t a ʋ ʎ a t i
nastojati	n ǎː s t o j a t i
nastradati	n a s t r ǎː d a t i
nastupiti	n a s t ǔː p i t i
nasumce	n ǎ s u m t͡s eː
nasumice	n ǎ s u m i t͡s eː
nasuprot	n â s u p r o t
natječaj	n â t j e t͡ʃ aː j
natrag	n â t r aː ɡ
natrij	n âː t r iː j
nauditi	n ǎ u d i t i
nauka	n ǎ u k a
naum	n ǎ u m
nautički	n a ǔ t i t͡ʃ k iː
naučiti	n a ǔ t͡ʃ i t i
naučnik	n ǎ u t͡ʃ n iː k
naušnica	n ǎ u ʃ n i t͡s a
naveče	n â ʋ e t͡ʃ eː
navečer	n â ʋ e t͡ʃ eː r
navijač	n a ʋ ǐ j aː t͡ʃ
navika	n âː ʋ i k a
navići	n ǎ ʋ i t͡ɕ i
navlastito	n ǎ ʋ l a s t i t o
navlažiti	n ǎ ʋ l a ʒ i t i
navod	n ǎː ʋ o d
navoditi	n a ʋ ǒ d i t i
navodni	n ǎː ʋ o d n iː
navodno	n ǎː ʋ o d n o
navrat	n ǎː ʋ r a t
nazad	n â z aː d
nazalni	n ǎ z aː l n iː
naziv	n ǎː z i ʋ
nazivati	n a z ǐː ʋ a t i
nazivnik	n ǎː z iː ʋ n iː k
nazor	n ǎː z o r
nazvati	n ǎ z ʋ a t i
načelnik	n ǎː t͡ʃ e l n iː k
načelo	n a t͡ʃ ěː l o
način	n ǎː t͡ʃ i n
načiniti	n a t͡ʃ ǐ n i t i
naš	n â ʃ
nažalost	n â ʒ a l oː s t
ne	n e
neadekvatan	n ê a d e k ʋ aː t a n
nebeski	n e b ě s k iː
neboder	n ê b o d eː r
nedaleko	n ê d a l e k o
nedavno	n ê d aː ʋ n o
nedelja	n ě d e ʎ a
nedeljiv	n e d ě ʎ i ʋ
nedeljni	n ě d eː ʎ n iː
nedjelja	n ě d j e ʎ a
nedjeljni	n ě d j eː ʎ n iː
nedopustiv	n e d o p ǔ s t i ʋ
nedopustivo	n e d o p ǔ s t i ʋ o
nedostajati	n e d ǒ s t a j a t i
nedostajući	n e d ǒ s t a j uː t͡ɕ iː
nedostatak	n e d o s t ǎː t a k
nedostižan	n ê d o s t i ʒ a n
nedoumica	n e d ǒ u m i t͡s a
nedvojben	n e d ʋ ǒ j b e n
nedvojbeno	n e d ʋ ǒ j b e n o
neefikasan	n ê e f i k a s a n
negativac	n e ɡ a t ǐː ʋ a t͡s
negativan	n ê ɡ a t iː ʋ a n
negde	n ê ɡ d e
negdje	n ê ɡ d j e
negirati	n e ɡ ǐː r a t i
nego	n ê ɡ o
nehuman	n ê x u m aː n
neiskreno	n ě i s k r e n o
neiskusan	n ê i s k u s a n
neistina	n ě i s t i n a
neistinit	n ě i s t i n i t
neizbrisiv	n e i z b r ǐ s i ʋ
neizvjesno	n ê i z ʋ j e s n o
neizvjesnost	n ê i z ʋ j e s n oː s t
neizvjestan	n ê i z ʋ j e s t a n
nejasan	n ě j a s a n
nejasno	n ě j a s n o
nejasnoća	n e j a s n ǒ t͡ɕ a
nejednakost	n e j e d n ǎː k oː s t
nekad	n ê k a d
nekada	n ê k a d a
nekadašnji	n ê k a d a ʃ ɲ iː
nekakav	n ê k a k aː ʋ
nekako	n ê k aː k o
nekamo	n ê k a m o
nekidan	n ê k i d aː n
nekim	n ê k iː m
nekog	n ê k o ɡ
nekoga	n ê k o ɡ a
nekolicina	n e k o l i t͡s ǐ n a
nekoliko	n ê k o l i k o
nekom	n ê k o m
nekome	n ê k o m e
nekompetentan	n e k o m p e t ě n t a n
nekompetentnost	n e k o m p e t ě n t n oː s t
nekomu	n ê k o m u
nekoć	n ê k oː t͡ɕ
nekretnina	n e k r e t n ǐ n a
nektar	n ê k t a r
nekulturan	n ê k u l t uː r a n
nelagoda	n ê l a ɡ o d a
nelagodno	n ê l a ɡ o d n o
neljudski	n ê ʎ u d s k iː
nelojalno	n ê l o j aː l n o
nemalo	n ě m a l o
nemar	n ê m aː r
nemica	n ě m i t͡s a
nemilice	n ě m i l i t͡s eː
nemilosrdno	n ê m i l o s r d n o
neminovan	n ê m i n oː ʋ a n
neminovno	n ê m i n oː ʋ n o
nemio	n ě m i o
nemir	n ê m iː r
nemirno	n ê m iː r n o
nemjerljiv	n e m j ě r ʎ i ʋ
nemo	n êː m o
nemoguć	n ê m o ɡ uː t͡ɕ
nemoguće	n ê m o ɡ uː t͡ɕ e
nemogućnost	n e m o ɡ ǔː t͡ɕ n oː s t
nemoral	n ê m o r aː l
nemoralan	n ê m o r aː l a n
nemoć	n ê m oː t͡ɕ
nemoćan	n ê m o t͡ɕ a n
nemoćno	n ê m o t͡ɕ n o
nenadano	n ě n aː d a n o
nenadmašiv	n e n a d m ǎ ʃ i ʋ
nenamjerno	n e n ǎː m j e r n o
nenazočan	n e n ǎː z o t͡ʃ a n
neobičan	n ê o b i t͡ʃ a n
neobično	n ê o b i t͡ʃ n o
neobjašnjivo	n e o b j ǎ ʃ ɲ i ʋ o
neodgovoran	n ê o d ɡ o ʋ oː r a n
neodgovorno	n ê o d ɡ o ʋ oː r n o
neodlučno	n ê o d l uː t͡ʃ n o
neodoljiv	n e o d ǒ ʎ i ʋ
neodoljivo	n e o d ǒ ʎ i ʋ o
neodređen	n e ǒ d r eː d͡ʑ e n
neodređeno	n e ǒ d r eː d͡ʑ e n o
neograničen	n e o ɡ r ǎ n i t͡ʃ e n
neophodan	n ê o p x o d a n
neopravdan	n e ǒ p r aː ʋ d a n
neopravdano	n e ǒ p r aː ʋ d a n o
neosjetljivo	n e o s j ě t ʎ i ʋ o
neosporno	n ê o s p oː r n o
neosvojiv	n e o s ʋ ǒ j i ʋ
neovisan	n ê o ʋ i s a n
neovisno	n ê o ʋ i s n o
neočekivan	n e o t͡ʃ ě k iː ʋ aː n
neočekivano	n e o t͡ʃ ě k iː ʋ aː n o
nepal	n ě p aː l
neparan	n ê p aː r a n
nepažljiv	n e p ǎ ʒ ʎ i ʋ
nepažnja	n e p ǎ ʒ ɲ a
nepismenost	n ě p i s m e n oː s t
neplodno	n ě p l o d n o
neplodnost	n ě p l o d n oː s t
nepobitno	n ê p o b iː t n o
nepobjedivost	n e p o b j ě d i ʋ oː s t
nepokolebljiv	n e p o k o l ě b ʎ i ʋ
nepokretan	n ê p o k r eː t a n
neposredno	n ê p o s r e d n o
nepostojan	n e p ǒː s t o j aː n
nepostojanje	n e p ǒː s t o j aː ɲ e
nepostojeći	n e p ǒː s t o j eː t͡ɕ iː
nepotpun	n ê p o t p u n
nepotpuno	n ê p o t p u n o
nepotreban	n ê p o t r e b a n
nepotrebno	n ê p o t r e b n o
nepoverenje	n e p o ʋ e r ěː ɲ e
nepovoljan	n ê p o ʋ oː ʎ a n
nepoznanica	n ê p o z n a n i t͡s a
nepoznat	n ê p o z n a t
nepošteno	n ê p o ʃ t e n o
nepravedan	n ê p r a ʋ e d a n
nepravedno	n ê p r a ʋ e d n o
nepravilno	n ê p r a ʋ iː l n o
nepravilnost	n e p r a ʋ ǐː l n oː s t
neprecizan	n ê p r e t͡s iː z a n
neprecizno	n ê p r e t͡s iː z n o
nepredvidljiv	n e p r e d ʋ ǐ d ʎ i ʋ
nepredvidljivo	n e p r e d ʋ ǐ d ʎ i ʋ o
neprekidno	n ê p r e k iː d n o
neprekidnost	n e p r e k ǐː d n oː s t
neprestance	n ê p r e s t a n t͡s eː
neprestano	n e p r ě s t a n o
neprihvatljiv	n e p r i x ʋ ǎ t ʎ i ʋ
neprijatan	n ê p r i j aː t a n
neprijateljski	n e p r i j a t ě ʎ s k iː
neprijateljstvo	n e p r i j a t ě ʎ s t ʋ o
neprijatno	n ê p r i j aː t n o
neprilika	n e p r ǐː l i k a
neprimetno	n ê p r i m e t n o
neprimjeren	n e p r ǐ m j e r e n
neprimjereno	n e p r ǐ m j e r e n o
neprincipijelan	n ê p r i n t͡s i p i j eː l a n
nepripremljen	n e p r ǐ p r eː m ʎ e n
nepristojno	n e p r ǐː s t oː j n o
neproduktivan	n ê p r o d u k t iː ʋ a n
neprofesionalan	n ê p r o f e s i o n aː l a n
nepromišljeno	n e p r ǒ m i ʃ ʎ e n o
neprozirno	n ê p r o z iː r n o
nepušač	n e p ǔ ʃ aː t͡ʃ
nerado	n ê r a d o
nerazumljiv	n e r a z ǔ m ʎ i ʋ
nered	n ê r eː d
neretva	n ě r eː t ʋ a
neriješen	n ě r j eː ʃ e n
nerotkinja	n ě r o t k i ɲ a
nervirati	n e r ʋ ǐː r a t i
nervozan	n ê r ʋ oː z a n
nesanica	n ě s a n i t͡s a
nesavjestan	n e s ǎː ʋ j e s t a n
nesebičan	n ê s e b i t͡ʃ a n
nesebičnost	n ê s e b i t͡ʃ n oː s t
neshvaćen	n ě s x ʋ a t͡ɕ e n
nesigurno	n ê s i ɡ uː r n o
nesklad	n ê s k l a d
nesnosan	n ě s n o s a n
nesporazum	n ê s p o r a z u m
nesposoban	n ê s p o s o b a n
nespreman	n ě s p r e m a n
nesretan	n ě s r e t a n
nesreća	n ě s r e t͡ɕ a
nestabilan	n ê s t a b iː l a n
nestabilnost	n e s t a b ǐː l n oː s t
nestanak	n ě s t a n a k
nestati	n ě s t a t i
nestašica	n ě s t a ʃ i t͡s a
nestrpljiv	n e s t ř p ʎ i ʋ
nestrpljivo	n e s t ř p ʎ i ʋ o
nestvaran	n ê s t ʋ aː r a n
nesuglasica	n e s ǔ ɡ l a s i t͡s a
nesvakidašnji	n e s ʋ a k ǐ d a ʃ ɲ iː
nesvijest	n ê s ʋ j eː s t
nesvjesno	n ě s ʋ j e s n o
netko	n ê t k o
neukusno	n ê u k u s n o
neumorno	n ê u m oː r n o
neuobičajen	n e u o b ǐ t͡ʃ aː j e n
neuobičajeno	n e u o b ǐ t͡ʃ aː j e n o
neuron	n e ǔ r oː n
neuspelost	n ê u s p e l oː s t
neuspjeh	n ê u s p j e x
neuspješno	n ê u s p j e ʃ n o
neustrašiv	n e u s t r ǎ ʃ i ʋ
neutralan	n ê u t r aː l a n
nevažan	n ê ʋ aː ʒ a n
nevidljiv	n e ʋ ǐ d ʎ i ʋ
nevidljivo	n e ʋ ǐ d ʎ i ʋ o
nevin	n ê ʋ iː n
nevino	n ê ʋ iː n o
nevinost	n ê ʋ iː n oː s t
nevjeran	n ê ʋ j e r a n
nevjerica	n ě ʋ j e r i t͡s a
nevjernik	n ě ʋ j eː r n iː k
nevjerojatan	n e ʋ j e r ǒ j a t a n
nevolja	n ě ʋ o ʎ a
nevreme	n ê ʋ r eː m e
nevrijeme	n ê ʋ r j eː m e
nezaboravan	n ê z a b o r aː ʋ a n
nezadovoljan	n ê z a d o ʋ oː ʎ a n
nezahvalan	n ê z a x ʋ aː l a n
nezahvalno	n ê z a x ʋ aː l n o
nezakonit	n e z ǎː k o n i t
nezakonito	n e z ǎː k o n i t o
nezamisliv	n e z a m ǐ s l i ʋ
nezamislivo	n e z a m ǐ s l i ʋ o
nezamjenjiv	n e z a m j ě ɲ i ʋ
nezaposlenost	n e z ǎ p o s l e n oː s t
nezavidan	n e z ǎː ʋ i d a n
nezavisno	n e z ǎː ʋ i s n o
nezavisnost	n e z ǎː ʋ i s n oː s t
nezdrav	n ě z d r a ʋ
nezdravo	n ě z d r a ʋ o
nezgoda	n ě z ɡ o d a
neznalica	n ě z n a l i t͡s a
nećaka	n ê t͡ɕ a k a
nećemo	n êː t͡ɕ eː m o
nećete	n êː t͡ɕ eː t e
nećeš	n êː t͡ɕ eː ʃ
neću	n ěː t͡ɕ u
nečasno	n ê t͡ʃ a s n o
nečeg	n ê t͡ʃ e ɡ
nečega	n ê t͡ʃ e ɡ a
nečem	n ê t͡ʃ e m
nečiji	n ê t͡ʃ i j iː
nečim	n ê t͡ʃ i m
nečistoća	n e t͡ʃ i s t ǒ t͡ɕ a
nešto	n ê ʃ t o
niger	n î ɡ e r
nigerijac	n i ɡ e r ǐː j a t͡s
nigerijski	n ǐ ɡ eː r i j s k iː
nihilist	n i x ǐ l i s t
nijansa	n i j ǎ n s a
nijemac	n i j ěː m a t͡s
nijemo	n i j êː m o
nika	n ǐː k a
nikad	n î k a d
nikada	n î k a d a
nikal	n ǐ k a l
nikamo	n î k a m o
nikola	n ǐ k o l a
nikotin	n i k ǒ t iː n
nikuda	n î k u d a
nimalo	n ǐ m a l o
nimfomanka	n i m f ǒ m aː n k a
nisam	n ǐː s a m
nisko	n î s k o
niste	n ǐː s t e
nisu	n ǐː s u
nit	n îː t
niti	n î t i
nitko	n î t k o
nivo	n ǐ ʋ oː
nizak	n î z a k
nizina	n i z ǐ n a
nizinski	n ǐ z iː n s k iː
nizozemac	n i z o z ěː m a t͡s
nizvodno	n ǐ z ʋ o d n o
niš	n î ʃ
nišan	n ǐ ʃ a n
ništa	n î ʃ t a
ništavan	n î ʃ t aː ʋ a n
nje	ɲ êː
njedra	ɲ ê d r a
njegov	ɲ ě ɡ o ʋ
njem	ɲ ê m
njemačka	ɲ ě m a t͡ʃ k aː
njemica	ɲ ě m i t͡s a
njemu	ɲ ê m u
njen	ɲ êː n
nježan	ɲ ê ʒ a n
nježnost	ɲ ê ʒ n oː s t
njih	ɲ îː x
njihov	ɲ î x o ʋ
njim	ɲ îː m
njima	ɲ î m a
njime	ɲ ǐː m e
njiva	ɲ î ʋ a
njoj	ɲ ôː j
njome	ɲ ǒː m e
nju	ɲ ûː
njujorčanin	ɲ ǔ j o r t͡ʃ a n i n
njujorški	ɲ û j o r ʃ k iː
njuškalo	ɲ û ʃ k a l o
nogica	n ǒ ɡ i t͡s a
nogomet	n ô ɡ o m eː t
nogometni	n ô ɡ o m eː t n iː
nogostup	n ô ɡ o s t uː p
nokaut	n o k ǎ u t
nonšalantno	n o n ʃ a l ǎ n t n o
normalan	n ô r m aː l a n
normalizirati	n o r m a l i z ǐː r a t i
normalno	n ô r m aː l n o
normalnost	n o r m ǎː l n oː s t
norman	n ǒ r m aː n
norveška	n ǒ r ʋ e ʃ k aː
norvežanin	n o r ʋ ěː ʒ a n i n
nos	n ôː s
nosač	n ǒ s aː t͡ʃ
nosila	n ǒ s i l a
nosilac	n ǒ s i l a t͡s
nositi	n ǒ s i t i
nostalgija	n o s t ǎ l ɡ i j a
nov	n ô ʋ
nova	n ôː ʋ a
novajlija	n o ʋ ǎ j l i j a
novak	n ǒ ʋ aː k
novembar	n ǒ ʋ eː m b a r
novina	n o ʋ ǐ n a
novinar	n ô ʋ i n aː r
novinarstvo	n o ʋ i n ǎː r s t ʋ o
novine	n ǒ ʋ i n e
novonastali	n o ʋ o n ǎ s t a l iː
novorođenče	n o ʋ o r ǒ d͡ʑ eː n t͡ʃ e
novčani	n ǒ ʋ t͡ʃ a n iː
novčanica	n o ʋ t͡ʃ ǎ n i t͡s a
novčano	n ǒ ʋ t͡ʃ a n o
novčić	n ǒ ʋ t͡ʃ i t͡ɕ
noć	n ôː t͡ɕ
noćas	n ǒ t͡ɕ a s
noćenje	n ǒ t͡ɕ eː ɲ e
noćni	n ǒ t͡ɕ n iː
noću	n ô t͡ɕ u
nuditi	n û d i t i
nuklearka	n u k l ě aː r k a
nuklearni	n û k l e aː r n iː
nukleus	n û k l e u s
nula	n û l a
numerički	n u m ě r i t͡ʃ k iː
nužno	n û ʒ n o
nužnost	n û ʒ n oː s t
oba	ô b a
obad	ô b aː d
obala	ô b a l a
obamrlost	ô b a m rː l oː s t
obavezan	ô b a ʋ e z a n
obavezati	o b a ʋ ěː z a t i
obavijest	ô b a ʋ j eː s t
obavijestiti	o b a ʋ i j ěː s t i t i
obavještajni	ô b a ʋ j e ʃ t aː j n iː
obavještavati	o b a ʋ j e ʃ t ǎː ʋ a t i
obdukcija	o b d ǔ k t͡s i j a
obe	ô b e
obeshrabriti	o b e s x r ǎː b r i t i
obespraviti	o b e s p r ǎː ʋ i t i
obećanje	o b e t͡ɕ ǎː ɲ e
obećati	o b ě t͡ɕ a t i
obilan	ô b iː l a n
obilje	ǒ b iː ʎ e
obilježavati	o b i ʎ e ʒ ǎː ʋ a t i
obilježiti	o b ǐ ʎ e ʒ i t i
obilježje	ô b i ʎ eː ʒ j e
obiman	ô b iː m a n
obistiniti	ǒ b i s t i n i t i
obitelj	o b ǐː t e ʎ
obići	ǒ b iː t͡ɕ i
običan	ǒ b i t͡ʃ a n
obično	ǒ b i t͡ʃ n o
objasniti	o b j ǎ s n i t i
objava	ô b j a ʋ a
objaviti	o b j ǎː ʋ i t i
objavljivati	o b j a ʋ ʎ ǐː ʋ a t i
objašnjavati	o b j a ʃ ɲ ǎː ʋ a t i
objašnjenje	o b j a ʃ ɲ ěː ɲ e
obje	ô b j e
objektivan	ô b j e k t iː ʋ a n
objektivno	ô b j e k t iː ʋ n o
objektivnost	o b j e k t ǐː ʋ n oː s t
objeručke	o b j ě r u t͡ʃ k eː
oblak	ô b l aː k
oblačan	ô b l aː t͡ʃ a n
oblačiti	o b l ǎː t ʃ i t i
oblik	ô b l iː k
oblikovati	ǒ b l i k o ʋ a t i
oblizati	o b l ǐː z a t i
obljetnica	ǒ b ʎ e t n i t͡s a
obmana	ô b m a n a
obmanuti	o b m ǎ n u t i
obnavljati	o b n ǎː ʋ ʎ a t i
obnova	ô b n o ʋ a
obogatiti	o b ǒ ɡ a t i t i
obojen	ǒ b o j e n
obojica	o b ǒ j i t͡s a
obojiti	o b ǒ j i t i
oborine	ǒ b o r i n e
oboriti	o b ǒ r i t i
obostran	o b ǒ s t r a n
obostrano	o b ǒ s t r a n o
obožavatelj	o b o ʒ ǎ ʋ a t e ʎ
obožavateljica	o b o ʒ a ʋ a t ě ʎ i t͡s a
obožavati	o b o ʒ ǎː ʋ a t i
obrada	ô b r a d a
obraditi	o b r ǎː d i t i
obradovati	ǒ b r a d o ʋ a t i
obrambeni	ǒ b r a m b e n iː
obrana	ô b r a n a
obraniti	o b r ǎː n i t i
obrat	ô b r aː t
obrazložiti	o b r a z l ǒ ʒ i t i
obrazovan	ǒ b r a z o ʋ aː n
obrazovanje	o b r a z o ʋ ǎː ɲ e
obrazovati	ǒ b r a z o ʋ a t i
obrazovni	ǒ b r a z oː ʋ n iː
obraćati	ǒ b r a t͡ɕ a t i
obračun	ô b r a t͡ʃ uː n
obračunati	o b r a t͡ʃ ǔ n a t i
obrađivati	o b r a d͡ʑ ǐː ʋ a t i
obred	ǒ b r e d
obrezivati	o b r e z ǐː ʋ a t i
obrijati	ǒ b r i j a t i
obrisati	ǒ b r i s a t i
obrnuti	o b řː n u t i
obrnuto	ǒ b rː n uː t o
obrok	ǒ b r o k
obrt	ǒ b r t
obrtnik	ǒ b r t n iː k
obrva	ô b r ʋ a
obuhvaćati	o b ǔ x ʋ a t͡ɕ a t i
obujam	o b ǔː j a m
obuka	ô b u k a
obustava	ô b u s t a ʋ a
obuća	ǒ b u t͡ɕ a
obući	ǒ b uː t͡ɕ i
obučavati	o b u t͡ʃ ǎː ʋ a t i
obvezati	o b ʋ ěː z a t i
obveznik	ǒ b ʋ e z n iː k
obzir	ô b z iː r
ocat	ǒ t͡s a t
ocean	o t͡s ě aː n
ocijeniti	o t͡s i j ěː n i t i
od	ô d
oda	ǒː d a
odabir	ô d a b iː r
odabirati	o d ǎ b i r a t i
odabrati	o d ǎ b r a t i
odakle	ô d aː k l e
odan	ô d aː n
odande	ô d aː n d e
odati	ǒ d a t i
odavde	ô d aː ʋ d e
odavno	ô d aː ʋ n o
odaziv	ô d a z iː ʋ
odazivati	o d a z ǐː ʋ a t i
odazvati	o d ǎ z ʋ a t i
odbaciti	o d b ǎː t͡s i t i
odbacivati	o d b a t͡s ǐː ʋ a t i
odbijanje	o d b ǐː j aː ɲ e
odbiti	ǒ d b i t i
odbojan	ô d b oː j a n
odbojkaš	o d b ǒ j k aː ʃ
odbojno	ô d b oː j n o
odbojnost	o d b ǒː j n oː s t
odbor	ǒ d b o r
odbrambeni	ǒ d b r a m b e n iː
odbrana	ô d b r a n a
odbraniti	o d b r ǎː n i t i
odeljenje	o d e ʎ ěː ɲ e
odelo	o d ěː l o
odgađati	o d ɡ ǎː d͡ʑ a t i
odgoda	ô d ɡ o d a
odgoditi	o d ɡ ǒ d i t i
odgoj	ǒ d ɡ o j
odgovarati	o d ɡ o ʋ ǎː r a t i
odgovoran	ô d ɡ o ʋ oː r a n
odgovoriti	o d ɡ o ʋ ǒː r i t i
odgovorno	ô d ɡ o ʋ oː r n o
odgovornost	o d ɡ o ʋ ǒː r n oː s t
odijeliti	o d j ěː l i t i
odjedanput	o d j e d ǎ n p uː t
odjednom	o d j ě d n oː m
odjek	ô d j eː k
odjel	ǒ d j e l
odjeljenje	o d j e ʎ ěː ɲ e
odjenuti	ǒ d j e n u t i
odlazak	ǒ d l a z a k
odletjeti	o d l ě t j e t i
odlikovanje	o d l i k o ʋ ǎː ɲ e
odličan	ô d l i t͡ʃ a n
odličje	ǒ d l iː t͡ʃ j e
odlično	ô d l i t͡ʃ n o
odlomak	ǒ d l o m a k
odluka	ô d l u k a
odlutati	o d l ǔː t a t i
odlučnost	o d l ǔː t͡ʃ n oː s t
odmah	ô d m aː x
odmak	ô d m aː k
odmarati	o d m ǎː r a t i
odmjeriti	ǒ d m j e r i t i
odmor	ǒ d m o r
odmoriti	o d m ǒ r i t i
odmotavati	o d m o t ǎː ʋ a t i
odmoći	ǒ d m o t͡ɕ i
odnedavna	ǒ d n e d aː ʋ n a
odnedavno	ǒ d n e d aː ʋ n o
odnekud	ǒ d n e k u d
odneti	ǒ d n eː t i
odnijeti	ǒ d n j eː t i
odnos	ǒ d n o s
odobrenje	o d o b r ěː ɲ e
odobriti	o d ǒ b r i t i
odoljeti	o d ǒ ʎ e t i
odonda	ǒ d oː n d a
odrasti	ǒ d r aː s t i
odraz	ô d r aː z
odred	ô d r eː d
odredba	ǒ d r e d b a
odrediti	o d r ěː d i t i
odrezak	ǒ d r e z a k
odrezati	ǒ d r e z a t i
odreći	ǒ d r e t͡ɕ i
određivanje	o d r e d͡ʑ ǐː ʋ aː ɲ e
određivati	o d r e d͡ʑ ǐː ʋ a t i
održati	o d ř ʒ a t i
održavati	o d r ʒ ǎː ʋ a t i
održiv	o d ř ʒ i ʋ
odsad	ǒ d s a d
odsada	ǒ d s a d a
odstrel	ǒ d s t r e l
odstupiti	o d s t ǔː p i t i
odsustvo	ǒ d s u s t ʋ o
odugovlačiti	o d u ɡ o ʋ l ǎː t͡ʃ i t i
oduprijeti	o d ǔ p r j eː t i
oduvijek	ǒ d u ʋ j eː k
oduzeti	o d ǔ z eː t i
oduzimati	o d ǔ z i m a t i
oduševljenje	o d u ʃ e ʋ ʎ ěː ɲ e
odvajati	o d ʋ ǎː j a t i
odvajkada	o d ʋ ǎ j k a d a
odvesti	ǒ d ʋ e s t i
odveć	ô d ʋ e t͡ɕ
odvijati	o d ʋ ǐː j a t i
odvijač	o d ʋ ǐ j aː t͡ʃ
odviše	ô d ʋ i ʃ eː
odvjetnica	ǒ d ʋ j e t n i t͡s a
odvjetnik	ǒ d ʋ j e t n iː k
odvojenost	ǒ d ʋ o j e n oː s t
odziv	ô d z iː ʋ
odzvanjati	o d z ʋ ǎː ɲ a t i
odšteta	ô d ʃ t e t a
odžak	ǒ d͡ʒ a k
oficir	o f ǐ t͡s iː r
ofsajd	ô f s aː j d
oganj	ǒ ɡ a ɲ
ogledalo	o ɡ l ě d a l o
ogledati	o ɡ l ěː d a t i
oglodavati	o ɡ l o d ǎː ʋ a t i
ogorčenost	ǒ ɡ oː r t͡ʃ e n oː s t
ograda	ô ɡ r a d a
ograditi	o ɡ r ǎː d i t i
ogranak	ǒ ɡ r a n a k
ograničen	o ɡ r ǎ n i t͡ʃ e n
ograničenje	o ɡ r a n i t͡ʃ ěː ɲ e
ograničiti	o ɡ r ǎ n i t͡ʃ i t i
ogrebotina	o ɡ r e b ǒ t i n a
ogrlica	ǒ ɡ r l i t͡s a
ogroman	ô ɡ r oː m a n
ohladiti	o x l ǎː d i t i
oholost	ô x o l oː s t
ohrabriti	o x r ǎː b r i t i
ojačati	o j ǎ t͡ʃ a t i
oka	ǒ k a
okean	o k ě aː n
okititi	ǒ k i t i t i
oko	ô k o
okolni	ǒ k oː l n iː
okolnost	o k ǒː l n oː s t
okolo	ô k o l o
okončati	o k ǒ n t͡ʃ a t i
okret	ô k r eː t
okretan	ô k r eː t a n
okretati	o k r ěː t a t i
okriviti	o k r ǐː ʋ i t i
okrivljavati	o k r i ʋ ʎ ǎː ʋ a t i
okrugao	o k r ǔː ɡ a o
okrutan	ô k r uː t a n
okrutno	ô k r uː t n o
okruženje	o k r u ʒ ěː ɲ e
okružiti	o k r ǔː ʒ i t i
okršaj	ô k r ʃ aː j
oksid	ǒ k s iː d
oksidacija	o k s i d ǎː t͡s i j a
oktobar	ǒ k t oː b a r
okupiti	ǒ k u p i t i
okupljati	o k ǔː p ʎ a t i
okusiti	ǒ k u s i t i
okvir	ǒ k ʋ iː r
olabaviti	ǒ l a b a ʋ i t i
olakšavati	o l a k ʃ ǎː ʋ a t i
olib	ǒ l i b
olimpizam	o l i m p ǐ z a m
oličenje	o l i t͡ʃ ěː ɲ e
oljuštiti	o ʎ ǔː ʃ t i t i
oluja	o l ǔː j a
olupina	ǒ l u p i n a
omamiti	o m ǎː m i t i
oman	ǒ m a n
ombudsman	o m b ǔ d z m a n
omekšati	o m ě k ʃ a t i
omekšivač	o m e k ʃ ǐ ʋ aː t͡ʃ
omesti	ǒ m eː s t i
ometati	o m ěː t a t i
omiljen	ǒ m i ʎ e n
omladinac	o m l a d ǐː n a t͡s
omogućiti	o m o ɡ ǔː t͡ɕ i t i
omot	ǒ m o t
omotati	o m ǒ t a t i
on	ôː n
ona	ǒ n a
onako	o n ǎ k oː
onamo	ǒ n aː m o
onanirati	o n a n ǐː r a t i
ondje	ǒː n d j e
one	ǒ n e
onemogućavati	o n e m o ɡ u t͡ɕ ǎː ʋ a t i
onemogućiti	o n e m o ɡ ǔː t͡ɕ i t i
onečišćenje	o n e t͡ʃ i ʃ t͡ɕ ěː ɲ e
ono	ǒ n o
onoliko	o n o l ǐ k oː
onuda	ǒ n u d a
opadati	o p ǎː d a t i
opako	ô p aː k o
opanak	ǒ p a n a k
opasan	ô p aː s a n
opasno	ô p aː s n o
opasnost	o p ǎː s n oː s t
opat	ǒ p a t
opatica	o p ǎ t i t͡s a
opaziti	ǒ p a z i t i
opeka	ô p e k a
opekotina	o p e k ǒ t i n a
opet	ô p eː t
ophoditi	o p x ǒ d i t i
opipljiv	o p ǐ p ʎ i ʋ
opirati	o p i r a t i
opis	ǒ p i s
opisati	o p ǐː s a t i
oplemenjivati	o p l e m e ɲ ǐː ʋ a t i
oplodan	ǒ p l o d a n
opomena	ô p o m e n a
oponent	o p ǒ n e n t
oporavak	o p ǒ r a ʋ a k
oporaviti	o p ǒ r a ʋ i t i
oporba	ǒ p o r b a
oporezovati	o p ǒ r e z o ʋ a t i
opozicija	o p o z ǐː t͡s i j a
oprati	ǒ p r a t i
opravdan	ǒ p r aː ʋ d aː n
opravdanje	o p r a ʋ d ǎː ɲ e
opravdano	ǒ p r aː ʋ d a n o
opravdati	ǒ p r aː ʋ d a t i
opraštati	o p r ǎː ʃ t a t i
opredeliti	o p r e d ěː l i t i
oprema	ô p r e m a
opremati	o p r ěː m a t i
opremiti	o p r ěː m i t i
oprez	ô p r eː z
oprjeka	ô p r e k a
oprost	ǒ p r o s t
oprostite	o p r ǒ s t i t e
oprostiti	o p r ǒ s t i t i
opruga	ô p r u ɡ a
opsada	ô p s a d a
opseg	ô p s eː ɡ
opsesija	o p s ě s i j a
opsesivno	ô p s e s iː ʋ n o
opsežan	ô p s eː ʒ a n
opsežno	ô p s eː ʒ n o
opsjena	ô p s j e n a
opsjesti	ǒ p s j e s t i
opstati	ǒ p s t a t i
opstrukcija	o p s t r ǔ k t͡s i j a
opteretiti	o p t ě r e t i t i
opterećivati	o p t e r e t͡ɕ ǐː ʋ a t i
optika	ǒ p t i k a
optimalan	ô p t i m aː l a n
optimalno	ô p t i m aː l n o
optimizam	o p t i m ǐ z a m
optužba	ǒ p t u ʒ b a
optuženik	o p t u ʒ ě n iː k
optužiti	o p t ǔː ʒ i t i
optužnica	ǒ p t u ʒ n i t͡s a
općenito	o p t͡ɕ ě n i t o
opći	ô p t͡ɕ iː
općina	ô p t͡ɕ i n a
općinski	ô p t͡ɕ iː n s k iː
opčiniti	o p t͡ʃ ǐ n i t i
opširno	ô p ʃ iː r n o
opština	ô p ʃ t i n a
orah	ǒ r a x
orao	ǒ r a o
organ	ǒ r ɡ aː n
organizacija	o r ɡ a n i z ǎː t͡s i j a
organizam	o r ɡ a n ǐ z a m
organizator	o r ɡ a n ǐ z aː t o r
organizirati	o r ɡ a n i z ǐː r a t i
organski	ǒ r ɡ aː n s k iː
orgazam	o r ɡ ǎ z a m
orgulje	ǒ r ɡ u ʎ e
originalan	ô r i ɡ i n aː l a n
originalno	ô r i ɡ i n aː l n o
orkestar	ǒ r k e s t a r
orman	ǒ r m aː n
oronuo	o r ǒ n u o
oruđe	ǒ r uː d͡ʑ e
os	ôː s
osam	ô s a m
osamljen	ǒ s aː m ʎ e n
osedlati	ǒ s e d l a t i
oseka	ô s e k a
osećajnost	o s e t͡ɕ ǎː j n oː s t
osiguranje	o s i ɡ u r ǎː ɲ e
osigurati	o s i ɡ ǔ r a t i
osiguravati	o s i ɡ u r ǎː ʋ a t i
osijek	ô s i j eː k
osim	ô s iː m
osip	ǒ s i p
osjetljiv	o s j ě t ʎ i ʋ
osjetljivo	o s j ě t ʎ i ʋ o
osjetno	ǒ s j e t n o
osjećati	ǒ s j e t͡ɕ a t i
osječki	ô s j e t͡ʃ k iː
oskudica	ǒ s k u d i t͡s a
oslabiti	ǒ s l a b i t i
oslanjati	ǒ s l a ɲ a t i
oslo	ô s l o
osloboditi	o s l o b ǒ d i t i
oslobođenje	o s l o b o d͡ʑ ěː ɲ e
oslonac	ǒ s l o n a t͡s
osmi	ô s m iː
osmorica	o s m ǒ r i t͡s a
osmrtnica	ǒ s m r t n i t͡s a
osnovan	ô s n o ʋ aː n
osnovati	o s n ǒ ʋ a t i
osnovica	o s n o v i t͡s a
osnovni	ǒ s n oː ʋ n iː
osoba	ô s o b a
osoban	ǒ s o b a n
osobit	ǒ s o b i t
osobito	ǒ s o b i t o
osoblje	ǒ s oː b ʎ e
osobno	ǒ s o b n o
osovina	o s ǒ ʋ i n a
osporiti	o s p ǒ r i t i
ostali	ǒ s t aː l iː
ostanak	ǒ s t a n a k
ostatak	o s t ǎː t a k
ostati	ǒ s t a t i
ostava	ô s t a ʋ a
ostavka	ǒ s t aː ʋ k a
ostavljati	ǒ s t a ʋ ʎ a t i
ostrvo	ô s t r ʋ o
ostvariti	o s t ʋ ǎː r i t i
ostvarivati	o s t ʋ a r ǐː ʋ a t i
osuditi	o s ǔː d i t i
osuđenik	o s u d͡ʑ ě n iː k
osuđivati	o s u d͡ʑ ǐː ʋ a t i
osušiti	o s ǔː ʃ i t i
osvajanje	o s ʋ ǎː j aː ɲ e
osvajati	o s ʋ ǎː j a t i
osvajač	o s ʋ ǎ j aː t͡ʃ
osveta	ô s ʋ e t a
osvetiti	o s ʋ ěː t i t i
osvježiti	ǒ s ʋ j e ʒ i t i
osvojiti	o s ʋ ǒ j i t i
osvrt	ǒ s ʋ r t
otac	ǒ t a t͡s
oteti	ǒ t eː t i
otimati	ǒ t i m a t i
otisak	ǒ t i s a k
otići	ǒ t iː t͡ɕ i
otjecati	ǒ t j e t͡s a t i
otjerati	ǒ t j e r a t i
otkaz	ô t k aː z
otkazati	o t k ǎː z a t i
otkinuti	ǒ t k i n u t i
otkloniti	o t k l ǒ n i t i
otkopavati	o t k o p ǎː ʋ a t i
otkriti	ǒ t k r i t i
otkrivati	o t k r ǐː ʋ a t i
otkud	ǒ t k u d
otkuda	ǒ t k u d a
otkup	ǒ t k u p
otopiti	o t ǒ p i t i
otočić	ǒ t o t͡ʃ i t͡ɕ
otočje	ǒ t oː t͡ʃ j e
otpisati	o t p ǐː s a t i
otplivati	ǒ t p l i ʋ a t i
otploviti	o t p l ǒ ʋ i t i
otpor	ǒ t p o r
otpravnik	ǒ t p r aː ʋ n iː k
otprije	ǒ t p r i j e
otprilike	o t p r ǐː l i k eː
otpustiti	o t p ǔ s t i t i
otputovati	o t p u t ǒ ʋ a t i
otpuštati	o t p ǔː ʃ t a t i
otrov	ǒ t r o ʋ
otrovan	ǒ t r oː ʋ a n
otrovati	o t r ǒ ʋ a t i
otvoren	ǒ t ʋ o r e n
otvoreno	ǒ t ʋ o r e n o
otvoriti	o t ʋ ǒ r i t i
ovako	o ʋ ǎ k oː
ovca	ǒː ʋ t͡s a
ovdašnji	ǒ ʋ d a ʃ ɲ iː
ovde	ǒː ʋ d e
ovdje	ǒː ʋ d j e
ovisan	ǒ ʋ i s a n
ovisno	ǒ ʋ i s n o
ovladati	o ʋ l ǎː d a t i
ovoj	ǒ ʋ o j
ovrha	ô ʋ r x a
ovđe	ǒː ʋ d͡ʑ e
ozbiljan	ô z b iː ʎ a n
ozbiljno	ô z b iː ʎ n o
ozlijeđen	ǒ z l i j eː d͡ʑ e n
oznaka	ô z n a k a
označiti	o z n ǎː t͡ʃ i t i
ozonski	ǒ z oː n s k iː
očaj	ô t͡ʃ aː j
očekivanje	o t͡ʃ e k ǐː ʋ aː ɲ e
očekivano	o t͡ʃ ě k iː ʋ aː n o
očekivati	o t͡ʃ e k ǐː ʋ a t i
očevidac	o t͡ʃ e ʋ ǐː d a t͡s
očigledan	ô t͡ʃ i ɡ l eː d a n
očigledno	ô t͡ʃ i ɡ l eː d n o
očistiti	ǒ t͡ʃ i s t i t i
očito	ǒ t͡ʃ i t o
očuvati	o t͡ʃ ǔː ʋ a t i
ošamariti	o ʃ ǎ m a r i t i
oštar	ô ʃ t a r
oštetiti	ǒ ʃ t e t i t i
oštrina	o ʃ t r ǐ n a
oštro	ô ʃ t r o
oženiti	o ʒ ě n i t i
ožiljak	ǒ ʒ i ʎ a k
oživiti	o ʒ ǐː ʋ i t i
oživjeti	o ʒ ǐː ʋ j e t i
ožujak	ǒ ʒ u j a k
pa	p a
padaline	p â d a l i n e
padati	p â d a t i
padavine	p â d a ʋ i n e
padobran	p â d o b r aː n
pahulja	p ǎ x u ʎ a
pahuljica	p a x ǔ ʎ i t͡s a
pajser	p ǎ j s e r
pakao	p ǎ k a o
paket	p ǎ k eː t
paketić	p a k ě t i t͡ɕ
pakirati	p a k ǐː r a t i
pakistanski	p â k i s t aː n s k iː
paklen	p ǎ k l e n
palanka	p ǎ l aː n k a
pali	p âː l i
palica	p â l i t͡s a
palma	p âː l m a
paluba	p â l u b a
pamet	p â m eː t
pametan	p â m e t a n
pametno	p â m e t n o
pamtiti	p âː m t i t i
pamuk	p ǎ m u k
panama	p ǎ n a m a
pandža	p âː n d͡ʒ a
panično	p ǎ n i t͡ʃ n o
pansion	p a n s ǐ oː n
pantalone	p a n t a l ǒː n e
papa	p âː p a
papak	p ǎː p a k
papar	p â p a r
paperje	p ǎ p eː r j e
papir	p ǎ p iː r
paprika	p ǎ p r i k a
par	p âː r
parabola	p a r ǎ b o l a
parada	p a r ǎː d a
paradajz	p a r ǎ d a j z
paragraf	p a r ǎ ɡ r a f
paralelno	p a r a l ě l n o
paranoičan	p a r a n ǒ i t͡ʃ a n
paranoja	p a r a n ǒː j a
parazit	p a r ǎ z iː t
parfem	p ǎ r f eː m
pariz	p ǎ r iː z
parlament	p a r l ǎ m e n t
parodija	p ǎ r oː d i j a
partija	p ǎ r t i j a
partizan	p a r t ǐ z aː n
partner	p â r t n e r
partnerstvo	p â r t n e r s t ʋ o
parče	p ǎː r t͡ʃ e
pasivan	p â s iː ʋ a n
pasivno	p â s iː ʋ n o
pasmina	p â s m i n a
pasoš	p âː s o ʃ
pasta	p â s t a
pastir	p ǎ s t iː r
pastuh	p â s t uː x
pasulj	p ǎ s uː ʎ
patent	p ǎ t e n t
patetika	p a t ě t i k a
patetičan	p a t ě t i t͡ʃ a n
patetično	p a t ě t i t͡ʃ n o
patiti	p â t i t i
patka	p â t k a
patkica	p â t k i t͡s a
patlidžan	p a t l ǐ d͡ʒ aː n
patologija	p a t o l ǒ ɡ i j a
patrijarh	p a t r ǐ j a r x
patrijarhalan	p â t r i j a r x aː l a n
patrijarhalno	p â t r i j a r x aː l n o
patriot	p a t r ǐ o t
patriotizam	p a t r i o t ǐ z a m
patrola	p a t r ǒː l a
pauk	p â uː k
paun	p â uː n
paučina	p â u t͡ʃ i n a
paviljon	p a ʋ ǐ ʎ oː n
pazar	p ǎ z aː r
paziti	p â z i t i
pazuh	p â z uː x
paša	p â ʃ a
pašanac	p a ʃ ǎː n a t͡s
pažljiv	p ǎ ʒ ʎ i ʋ
pažljivo	p ǎ ʒ ʎ i ʋ o
pažnja	p ǎ ʒ ɲ a
pedagog	p e d ǎ ɡ o ɡ
pedantno	p ě d a n t n o
peder	p ěː d e r
pedeset	p e d ě s eː t
pedesetak	p e d e s ěː t a k
pedijatar	p e d ǐ j aː t a r
pedofil	p e d ǒ f iː l
pejzaž	p ě j z aː ʒ
peking	p ě k i n ɡ
pelena	p ê l e n a
pelivan	p e l ǐ ʋ aː n
pelud	p ě l u d
pendrek	p ě n d r e k
penetracija	p e n e t r ǎː t͡s i j a
penis	p ěː n i s
penzijski	p ěː n z iː j s k iː
penzioner	p e n z i ǒ n eː r
percepcija	p e r t͡s ě p t͡s i j a
perfekt	p ě r f e k t
perilica	p ě r i l i t͡s a
period	p e r ǐ o d
perjanica	p ě r j a n i t͡s a
perjanik	p ě r j a n iː k
perje	p êː r j e
permutacija	p e r m u t ǎː t͡s i j a
pero	p ě r o
personalan	p ê r s o n aː l a n
perspektiva	p e r s p e k t ǐː ʋ a
peru	p e r u
peruanski	p e r ǔ aː n s k iː
perun	p ê r u n
perut	p ê r uː t
perverzan	p ě r ʋ e r z a n
perzija	p ě r z i j a
perzijski	p ě r z iː j s k iː
pesma	p ê s m a
pesnik	p ê s n iː k
peta	p ěː t a
petak	p ěː t a k
petar	p ě t a r
petarda	p ě t aː r d a
peteljka	p ê t eː ʎ k a
petnaestak	p e t n a ěː s t a k
petorica	p e t ǒ r i t͡s a
petrograd	p ě t r o ɡ r aː d
pevac	p ěː ʋ a t͡s
pevač	p ě ʋ aː t͡ʃ
peći	p ê t͡ɕ i
pećina	p ě t͡ɕ i n a
pečalbar	p ě t͡ʃ a l b aː r
pečat	p ě t͡ʃ a t
pečen	p ě t͡ʃ e n
pečurka	p ě t͡ʃ uː r k a
pešice	p ê ʃ i t͡s eː
peškir	p ě ʃ k iː r
pi	p îː
pidžama	p i d͡ʒ ǎː m a
pigmentacija	p i ɡ m e n t ǎː t͡s i j a
pijaca	p ǐ j a t͡s a
pijan	p ǐ j a n
pijanac	p i j ǎː n a t͡s
pijanistica	p i j ǎ n i s t i t͡s a
pijesak	p i j ěː s a k
pijevac	p i j ěː ʋ a t͡s
pik	p î k
pila	p ǐː l a
pilav	p ǐ l aː ʋ
pile	p î l e
piletina	p ǐ l e t i n a
pipa	p î p a
pirat	p ǐ r aː t
pisati	p ǐː s a t i
pisme	p îː s m e
pismeno	p î s m e n o
pismenost	p î s m e n oː s t
pismo	p ǐː s m o
pista	p î s t a
pitanje	p ǐː t aː ɲ e
piti	p î t i
piva	p ǐː ʋ a
pivo	p îː ʋ o
pizda	p ǐː z d a
pizditi	p ǐː z d i t i
piće	p ǐː t͡ɕ e
pička	p î t͡ʃ k a
pjanić	p j âː n i t ɕ
pjesma	p j ê s m a
pjesnik	p j ê s n iː k
pjev	p j êː ʋ
pjevati	p j ê ʋ a t i
pjevač	p j ě ʋ aː t͡ʃ
pješadija	p j e ʃ ǎ d i j a
pješak	p j ě ʃ aː k
pješačiti	p j e ʃ ǎː t͡ʃ i t i
pješice	p j ê ʃ i t͡s eː
plakanje	p l â k aː ɲ e
plakati	p l â k a t i
plamenac	p l a m ěː n a t͡s
planer	p l ǎ n eː r
planet	p l ǎ n eː t
planinar	p l a n ǐ n aː r
planinski	p l ǎ n iː n s k iː
planirano	p l ǎ n iː r aː n o
planirati	p l a n ǐː r a t i
plankton	p l ǎ n k t oː n
plantaža	p l a n t ǎː ʒ a
plasirati	p l a s ǐː r a t i
plasman	p l ǎ s m aː n
plast	p l âː s t
plastika	p l ǎ s t i k a
plastično	p l ǎ s t i t͡ʃ n o
plata	p l ǎː t a
platforma	p l ǎ t f oː r m a
platina	p l ǎ t i n a
platiti	p l ǎː t i t i
platiša	p l ǎ t i ʃ a
platni	p l âː t n iː
platno	p l ǎː t n o
plato	p l ǎ t oː
plavetnilo	p l a ʋ ě t n i l o
plavuša	p l ǎ ʋ u ʃ a
plač	p l â t͡ʃ
plačljiv	p l ǎ t͡ʃ ʎ i ʋ
plašiti	p l â ʃ i t i
ples	p l êː s
plesati	p l ěː s a t i
plesač	p l ě s aː t͡ʃ
plesačica	p l e s ǎ t͡ʃ i t͡s a
pleso	p l ê s o
pleća	p l ě t͡ɕ a
plijen	p l i j êː n
plin	p l îː n
plinovod	p l î n o ʋ oː d
plitak	p l ǐː t a k
plitko	p l îː t k o
plivati	p l î ʋ a t i
plivaći	p l ǐ ʋ aː t͡ɕ iː
plivač	p l ǐ ʋ aː t͡ʃ
plišani	p l ǐ ʃ a n iː
pljačka	p ʎ â t͡ʃ k a
pljačkati	p ʎ â t͡ʃ k a t i
pljesak	p ʎ êː s a k
pljuštati	p ʎ ǔː ʃ t a t i
plod	p l ôː d
plodno	p l ô d n o
plodnost	p l ô d n oː s t
plodonosan	p l o d ǒ n o s a n
plovan	p l ôː ʋ a n
plovidba	p l ǒ ʋ i d b a
ploviti	p l ǒ ʋ i t i
ploča	p l ô t͡ʃ a
pločica	p l ô t͡ʃ i t͡s a
plug	p l û ɡ
pluralizam	p l u r a l ǐ z a m
pluton	p l ǔ t oː n
pluća	p l ǔː t͡ɕ a
pneumatski	p n e ǔ m a t s k iː
pobeda	p ô b e d a
pobednik	p ǒ b e d n iː k
pobjeda	p ô b j e d a
pobjednik	p ǒ b j e d n iː k
pobjeći	p ǒ b j e t͡ɕ i
pobliže	p ô b l i ʒ eː
poboljšanje	p o b o ʎ ʃ ǎː ɲ e
poboljšati	p o b ǒ ʎ ʃ a t i
poboljšavati	p o b o ʎ ʃ ǎː ʋ a t i
pobratim	p ǒ b r a t i m
pobuda	p ô b u d a
pobuna	p ô b u n a
pobuniti	p o b ǔː n i t i
pobunjenik	p o b u ɲ ě n iː k
pod	p ô d
podatak	p o d ǎː t a k
podela	p ô d e l a
podeliti	p o d ěː l i t i
poderati	p o d ě r a t i
podesan	p ô d e s a n
podesiti	p ǒ d e s i t i
podgorica	p ǒ d ɡ o r i t͡s a
podignuti	p ǒ d i ɡ n u t i
podijeliti	p o d j ěː l i t i
podizati	p ǒ d i z a t i
podičiti	p ǒ d i t͡ʃ i t i
podjela	p ô d j e l a
podmazati	p ǒ d m a z a t i
podmititi	p o d m ǐː t i t i
podmorje	p ǒ d m oː r j e
podmornica	p ǒ d m oː r n i t͡s a
podne	p ǒː d n eː
podneblje	p ǒː d n eː b ʎ e
podnijeti	p ǒ d n j eː t i
podnosilac	p o d n ǒ s i l a t͡s
podnositi	p o d n ǒ s i t i
podrezivati	p o d r e z ǐː ʋ a t i
podrijetlo	p o d r i j ěː t l o
podrobno	p ô d r o b n o
podrum	p ǒ d r u m
područje	p ǒ d r uː t͡ʃ j e
podrška	p ǒ d r ʃ k a
podržati	p o d ř ʒ a t i
podržavati	p o d r ʒ ǎː ʋ a t i
podsjetiti	p ǒ d s j e t i t i
podsjetnik	p ǒ d s j e t n iː k
podsjećati	p ǒ d s j e t͡ɕ a t i
podstaknuti	p o d s t ǎ k n u t i
podstaći	p ǒ d s t a t͡ɕ i
podsticati	p ǒ d s t i t͡s a t i
podstrek	p ô d s t r eː k
podstrekač	p o d s t r ě k aː t͡ʃ
podsvijest	p ô d s ʋ i j eː s t
podudarati	p o d ǔ d a r a t i
poduhvat	p ô d u x ʋ a t
poduzeti	p o d ǔ z eː t i
poduzetnik	p ô d u z eː t n iː k
poduzeće	p o d u z e t͡ɕ e
poduzimati	p o d ǔ z i m a t i
podučavati	p o d u t͡ʃ ǎː ʋ a t i
podučiti	p o d ǔ t͡ʃ i t i
podvala	p ô d ʋ a l a
podvaliti	p o d ʋ ǎː l i t i
podzemlje	p ǒː d z eː m ʎ e
poezija	p ǒ eː z i j a
pogača	p ǒ ɡ a t͡ʃ a
pogađati	p o ɡ ǎː d͡ʑ a t i
poglavar	p o ɡ l ǎ ʋ aː r
poglavlje	p ǒ ɡ l aː ʋ ʎ e
pogled	p ô ɡ l eː d
pogledati	p ǒ ɡ l e d a t i
pogodak	p ǒ ɡ o d a k
pogoditi	p o ɡ ǒ d i t i
pogotovo	p o ɡ ǒ t o ʋ o
pogrešan	p ǒ ɡ r e ʃ a n
pogreška	p ǒ ɡ r e ʃ k a
pogrešno	p ǒ ɡ r e ʃ n o
poguban	p ô ɡ uː b a n
pohlepan	p ô x l eː p a n
pohlepno	p ô x l eː p n o
pohlepnost	p ô x l eː p n oː s t
pohod	p ǒ x o d
pohvala	p ô x ʋ a l a
pohvaliti	p o x ʋ ǎː l i t i
pojam	p ǒː j a m
pojas	p ô j aː s
pojasniti	p o j ǎ s n i t i
pojaviti	p o j ǎː ʋ i t i
pojavljivati	p o j a ʋ ʎ ǐː ʋ a t i
pojačati	p o j ǎ t͡ʃ a t i
pojedinac	p o j e d ǐː n a t͡s
pojedini	p o j ě d iː n iː
pojednostaviti	p o j e d n o s t ǎː ʋ i t i
pojesti	p ǒ j e s t i
pojmiti	p ǒː j m i t i
pokazatelj	p o k ǎ z a t e ʎ
pokazati	p o k ǎː z a t i
pokazivati	p o k a z ǐː ʋ a t i
pokidati	p ǒ k i d a t i
poklon	p ǒ k l o n
pokloniti	p o k l ǒ n i t i
pokoji	p ǒ k o j iː
pokolj	p ǒ k o ʎ
pokoravati	p o k o r ǎː ʋ a t i
pokoriti	p o k ǒ r i t i
pokraj	p ô k r a j
pokrajina	p ǒ k r a j i n a
pokrajinski	p ǒ k r a j iː n s k iː
pokrenuti	p o k r ěː n u t i
pokret	p ô k r eː t
pokrivati	p o k r ǐː ʋ a t i
pokrštavati	p o k r ʃ t ǎː ʋ a t i
pokupiti	p o k û p i t i
pokušaj	p ô k u ʃ aː j
pokušati	p ǒ k u ʃ a t i
pokvaren	p ǒ k ʋ aː r e n
pokvariti	p o k ʋ ǎː r i t i
pol	p ôː l
polako	p o l ǎː k o
polazak	p ǒ l a z a k
polaziti	p ǒ l a z i t i
polen	p ǒ l e n
polet	p ǒ l e t
policija	p o l ǐ t͡s i j a
politika	p o l ǐ t i k a
politički	p o l ǐ t i t͡ʃ k iː
poljak	p ǒ ʎ aː k
polje	p ô ʎ e
poljodelstvo	p o ʎ o d ěː l s t ʋ o
poljska	p ô ʎ s k aː
polomiti	p o l ǒ m i t i
polovica	p o l ǒ ʋ i t͡s a
polovina	p o l ǒ ʋ i n a
položaj	p ô l o ʒ aː j
položiti	p o l ǒ ʒ i t i
polubrat	p o l ǔ b r a t
polumesec	p ô l u m e s eː t͡s
pomagati	p o m ǎː ɡ a t i
pomaknuti	p o m ǎ k n u t i
pomalo	p ǒ m a l o
pomicati	p ǒ m i t͡s a t i
pomiješati	p o m i ěː ʃ a t i
pomilovati	p ǒ m i l o ʋ a t i
pomisliti	p ǒ m i s l i t i
pomišljati	p o m ǐː ʃ ʎ a t i
pomoć	p ô m oː t͡ɕ
pomoći	p ǒ m o t͡ɕ i
pomoćnica	p o m ǒ t͡ɕ n i t͡s a
pomoću	p ô m o t͡ɕ u
ponajprije	p ǒ n aː j p r i j e
ponajviše	p ǒ n aː j ʋ i ʃ e
ponaosob	p o n a ǒ s o b
ponavljati	p o n ǎː ʋ ʎ a t i
ponašanje	p o n ǎː ʃ aː ɲ e
ponašati	p o n ǎː ʃ a t i
ponedeljak	p o n ě d e ʎ a k
ponedjeljak	p o n ě d j e ʎ a k
ponekad	p ǒ n e k a d
poniženje	p o n i ʒ ěː ɲ e
ponor	p ǒ n o r
ponos	p ǒ n o s
ponosan	p ǒ n o s a n
ponosit	p ǒ n o s i t
ponositi	p o n ǒ s i t i
ponosno	p ǒ n o s n o
ponoviti	p o n ǒ ʋ i t i
ponovno	p ô n oː ʋ n o
ponovo	p ô n o ʋ o
ponuditi	p ǒ n u d i t i
pop	p ô p
popis	p ǒ p i s
popisati	p o p ǐː s a t i
popisivati	p o p i s ǐː ʋ a t i
popiti	p ǒ p i t i
poplava	p ô p l a ʋ a
popodne	p o p ǒː d n e
popratni	p ǒ p r a t n iː
popravak	p ǒ p r a ʋ a k
popraviti	p ǒ p r a ʋ i t i
popravljati	p ǒ p r a ʋ ʎ a t i
poprečno	p ô p r e t͡ʃ n o
poprijeko	p ô p r i j eː k o
poprište	p ô p r iː ʃ t e
poprskati	p o p řː s k a t i
popularan	p ô p u l aː r a n
popularizacija	p o p u l a r i z ǎː t͡s i j a
popularno	p ô p u l aː r n o
popustiti	p o p ǔ s t i t i
poput	p ô p uː t
popuštati	p o p ǔː ʃ t a t i
poradi	p ô r a d i
poraditi	p o r ǎː d i t i
porasti	p ǒ r aː s t i
poravnati	p o r ǎ ʋ n a t i
poravnavati	p o r a ʋ n ǎː ʋ a t i
poraz	p ô r aː z
pored	p ô r e d
poredak	p ǒ r e d a k
poremetiti	p o r ě m e t i t i
poremećaj	p ô r e m e t͡ɕ aː j
poricati	p o r ǐː t͡s a t i
porijeklo	p o r i j ěː k l o
pornografija	p o r n o ɡ r ǎ f i j a
pornografski	p o r n ǒ ɡ r a f s k iː
porodica	p ǒ r o d i t͡s a
poroditi	p o r ǒ d i t i
porodični	p ǒ r o d i t͡ʃ n iː
porota	p ô r o t a
portal	p ǒ r t aː l
portfelj	p ǒ r t f e ʎ
portugal	p ô r t u ɡ a l
portugalac	p o r t u ɡ ǎː l a t͡s
portugalski	p ô r t u ɡ aː l s k iː
poručiti	p o r ǔː t͡ʃ i t i
poručnica	p ǒ r u t͡ʃ n i t͡s a
poručnik	p ǒ r u t͡ʃ n iː k
posada	p ô s a d a
posao	p ǒ s a o
poseban	p ǒː s e b a n
posebice	p ǒː s e b i t͡s eː
posebno	p ǒː s e b n o
posebnost	p ǒː s e b n oː s t
posetilac	p o s ě t i l a t͡s
poseći	p ǒ s e t͡ɕ i
posjekotina	p o s j e k ǒ t i n a
posjet	p ô s j e t
posjeta	p ô s j e t a
posjetilac	p o s j ě t i l a t͡s
posjetitelj	p o s j ě t i t e ʎ
posjetiti	p ǒ s j e t i t i
poslanik	p ǒ s l a n iː k
poslanstvo	p o s l ǎː n s t ʋ o
poslastica	p ǒ s l a s t i t͡s a
poslati	p ǒ s l a t i
posledica	p ǒ s l e d i t͡s a
poslednji	p ǒ s l e d ɲ iː
posljednji	p ǒ s ʎ e d ɲ iː
poslodavac	p o s l o d ǎː ʋ a t͡s
poslovanje	p o s l o ʋ ǎː ɲ e
poslovati	p o s l ǒ ʋ a t i
posluga	p ô s l u ɡ a
poslušan	p ô s l uː ʃ a n
poslušati	p ǒ s l u ʃ a t i
poslušno	p ô s l uː ʃ n o
poslužitelj	p o s l ǔ ʒ i t e ʎ
poslužiti	p o s l ǔː ʒ i t i
posoliti	p o s ǒ l i t i
posrednik	p ǒ s r e d n iː k
posredno	p ǒ s r e d n o
posredovati	p ǒ s r e d o ʋ a t i
post	p ôː s t
postajati	p ǒ s t a j a t i
postati	p ǒ s t a t i
postavljati	p ǒ s t a ʋ ʎ a t i
postelja	p ô s t e ʎ a
posteljina	p o s t e ʎ ǐ n a
postignuti	p ǒ s t i ɡ n u t i
postiti	p ǒ s t i t i
postizati	p ǒ s t i z a t i
postići	p ǒ s t i t͡ɕ i
postojan	p ǒː s t o j aː n
postojati	p ǒː s t o j a t i
postolje	p ǒː s t oː ʎ e
postotak	p ǒ s t o t a k
postupak	p ǒ s t u p a k
postupan	p ǒ s t u p a n
postupati	p o s t ǔː p a t i
postupiti	p o s t ǔː p i t i
postupno	p ǒ s t u p n o
posuda	p ô s u d a
posuditi	p o s ǔː d i t i
posustati	p o s ǔ s t a t i
posveta	p ô s ʋ e t a
posvećivati	p o s ʋ e t͡ɕ ǐː ʋ a t i
potaknuti	p o t ǎ k n u t i
potaći	p ǒ t a t͡ɕ i
potegnuti	p o t ěː ɡ n u t i
potencijal	p o t e n t͡s ǐ j aː l
potencijalno	p ô t e n t͡s i j aː l n o
potepuh	p o t ě p uː x
potezati	p o t ěː z a t i
potiho	p ô t i x o
potjernica	p ǒ t j eː r n i t͡s a
potkrijepiti	p o t k r j ěː p i t i
potok	p ǒ t o k
potom	p ǒ t oː m
potomak	p ǒ t o m a k
potomstvo	p ǒ t oː m s t ʋ o
potpis	p ǒ t p i s
potpisati	p o t p ǐː s a t i
potpisivati	p o t p i s ǐː ʋ a t i
potpora	p ô t p o r a
potpun	p ǒ t p u n
potpuno	p ǒ t p u n o
potraga	p ô t r a ɡ a
potrajati	p ǒ t r a j a t i
potreba	p ô t r e b a
potreban	p ô t r e b a n
potres	p ǒ t r e s
potrošiti	p o t r ǒ ʃ i t i
potrošnja	p o t r ǒ ʃ ɲ a
potvrditi	p o t ʋ řː d i t i
potvrđivati	p o t ʋ r d͡ʑ ǐː ʋ a t i
pouzdan	p ǒ u z d aː n
pouzdanje	p o u z d ǎː ɲ e
pouzdano	p ǒ u z d aː n o
povesti	p ǒ ʋ e s t i
povezati	p o ʋ ěː z a t i
povezivati	p o ʋ e z ǐː ʋ a t i
poveznica	p ǒ ʋ e z n i t͡s a
povećalo	p o ʋ ě t͡ɕ a l o
povećati	p o ʋ ě t͡ɕ a t i
povećavati	p o ʋ e t͡ɕ ǎː ʋ a t i
povijati	p o ʋ ǐː j a t i
povijest	p ô ʋ j eː s t
povisok	p ô ʋ i s o k
poviti	p ǒ ʋ i t i
povjerenik	p o ʋ j e r ě n iː k
povjerenstvo	p o ʋ j e r ě n s t ʋ o
povjeriti	p ǒ ʋ j e r i t i
povjerljiv	p o ʋ j ě r ʎ i ʋ
povjerovati	p ǒ ʋ j e r o ʋ a t i
povjesničar	p ô ʋ j e s n i t͡ʃ aː r
povlačiti	p o ʋ l ǎː t͡ʃ i t i
povod	p ǒ ʋ o d
povodom	p ǒ ʋ o d o m
povoljan	p ô ʋ oː ʎ a n
povoljno	p ô ʋ oː ʎ n o
povratak	p ǒ ʋ r a t a k
povratiti	p o v r ǎː t i t i
povraćati	p ǒ ʋ r a t͡ɕ a t i
povreda	p ô ʋ r e d a
povrijediti	p o ʋ r j ěː d i t i
povrće	p ǒ ʋ r t͡ɕ e
površan	p ǒ ʋ r ʃ a n
površina	p ô ʋ r ʃ i n a
povučen	p o ʋ ǔ t͡ʃ e n
pozadina	p ǒ z a d i n a
pozdrav	p ô z d r aː ʋ
pozdraviti	p ǒ z d r a ʋ i t i
pozicija	p ǒ z iː t͡s i j a
pozirati	p o z ǐː r a t i
pozitivan	p ô z i t iː ʋ a n
pozitivno	p ô z i t iː ʋ n o
poznanik	p ǒ z n a n iː k
poznanstvo	p o z n ǎː n s t ʋ o
poznat	p ô z n aː t
poznati	p ǒ z n a t i
poznavati	p o z n ǎː ʋ a t i
pozornik	p ǒː z oː r n iː k
pozornost	p o z ǒː r n oː s t
pozvati	p ǒ z ʋ a t i
poći	p ôː t͡ɕ i
počast	p ô t͡ʃ aː s t
počelo	p o t͡ʃ ěː l o
početak	p o t͡ʃ ěː t a k
početi	p ǒ t͡ʃ eː t i
početkom	p o t͡ʃ ěː t k o m
početni	p ǒ t͡ʃ e t n iː
početnik	p ǒ t͡ʃ e t n iː k
počinjati	p ǒ t͡ʃ i ɲ a t i
pošast	p ô ʃ aː s t
poštanski	p ô ʃ t a n s k iː
poštedjeti	p o ʃ t ěː d j e t i
pošten	p ǒ ʃ t e n
poštovalac	p o ʃ t ǒ ʋ a l a t͡s
poštovan	p ô ʃ t o ʋ aː n
poštovanje	p o ʃ t o ʋ ǎː ɲ e
požar	p ô ʒ aː r
poželjan	p ô ʒ eː ʎ a n
poželjeti	p o ʒ ě ʎ e t i
požuda	p ô ʒ u d a
prag	p r â ɡ
prah	p r âː x
praksa	p r â k s a
praktičan	p r ǎ k t i t͡ʃ a n
praktično	p r ǎ k t i t͡ʃ n o
pralja	p r âː ʎ a
pramen	p r â m eː n
pranje	p r ǎː ɲ e
praskati	p r â s k a t i
prati	p r â t i
pratilac	p r ǎ t i l a t͡s
pratiti	p r â t i t i
pratnja	p r ǎ t ɲ a
pravac	p r ǎː ʋ a t͡s
pravaš	p r ǎ ʋ aː ʃ
pravdati	p r âː ʋ d a t i
pravi	p r âː ʋ iː
pravilan	p r â ʋ iː l a n
pravilo	p r â ʋ i l o
praviti	p r â ʋ i t i
pravni	p r âː ʋ n iː
pravnica	p r âː ʋ n i t͡s a
pravno	p r âː ʋ n o
pravodoban	p r â ʋ o d o b a n
pravodobno	p r â ʋ o d o b n o
pravoslavlje	p r â ʋ o s l aː ʋ ʎ e
pravosudni	p r â ʋ o s uː d n iː
pravovaljan	p r a ʋ o ʋ ǎ ʎ aː n
pravovjernost	p r a ʋ o ʋ j ěː r n oː s t
pravovremenost	p r â ʋ o ʋ r e m e n oː s t
prazan	p r ǎː z a n
praznik	p r âː z n iː k
praznina	p r a z n ǐ n a
praznični	p r âː z n i t͡ʃ n iː
prazno	p r âː z n o
praznovjeran	p r â z n o ʋ j eː r a n
prašak	p r ǎː ʃ a k
prašina	p r ǎ ʃ i n a
prditi	p ř d i t i
pre	p r ê
prebaciti	p r e b ǎː t͡s i t i
precizan	p r ê t͡s iː z a n
precizno	p r ê t͡s iː z n o
pred	p r ê d
preda	p r ê d a
predaja	p r ê d a j a
predak	p r ê d a k
predati	p r ě d a t i
predator	p r ě d aː t o r
predavati	p r e d ǎː ʋ a t i
predavač	p r e d ǎ ʋ aː t͡ʃ
predgovor	p r ê d ɡ o ʋ oː r
predgrađe	p r ě d ɡ r aː d͡ʑ e
predizborni	p r ê d i z b oː r n iː
predlagati	p r e d l ǎː ɡ a t i
predlog	p r ěː d l o ɡ
predložiti	p r e d l ǒ ʒ i t i
predmet	p r ěː d m e t
predmetak	p r ěː d m e t a k
prednost	p r ê d n oː s t
predodžba	p r ě d o d͡ʒ b a
predomisliti	p r e d ǒ m i s l i t i
predočiti	p r e d ǒ t͡ʃ i t i
predrasuda	p r ě d r aː s u d a
predsednik	p r ěː d s e d n iː k
predsjednik	p r ěː d s j e d n iː k
predstava	p r ě d s t a ʋ a
predstaviti	p r ě d s t a ʋ i t i
predstavljati	p r ě d s t a ʋ ʎ a t i
predstavnica	p r ěː d s t aː ʋ n i t͡s a
predstavnik	p r ěː d s t aː ʋ n iː k
predstavnički	p r ěː d s t aː ʋ n i t͡ʃ k iː
preduzeće	p r e d u z e t͡ɕ e
predvideti	p r ě d ʋ i d e t i
predvidjeti	p r ě d ʋ i d j e t i
predvoditi	p r e d ʋ ǒ d i t i
predvodnica	p r ě d ʋ o d n i t͡s a
predvodnik	p r ě d ʋ o d n iː k
predznak	p r ê d z n aː k
predznanje	p r e d z n ǎː ɲ e
predśednik	p r e d ɕ e d n i k
prefekt	p r ě f e k t
prefiks	p r ě f i k s
pregled	p r ěː ɡ l e d
pregledan	p r ěː ɡ l e d a n
pregledno	p r ěː ɡ l e d n o
pregnantan	p r e ɡ n ǎ n t a n
pregrada	p r ê ɡ r a d a
pregristi	p r ě ɡ r i s t i
pregršt	p r ê ɡ rː ʃ t
prekasno	p r ê k a s n o
prekid	p r ěː k i d
prekidati	p r e k ǐː d a t i
prekjuče	p r ê k j u t͡ʃ eː
prekjučer	p r ê k j u t͡ʃ eː r
preklani	p r ê k l aː n i
preko	p r ê k o
prekosutra	p r e k ǒ s u t r a
prekrivati	p r e k r ǐː ʋ a t i
prekršiti	p r e k řː ʃ i t i
prelamati	p r e l ǎː m a t i
prelaziti	p r ě l a z i t i
preletati	p r e l ěː t a t i
preletjeti	p r e l ě t j e t i
prelistati	p r e l ǐ s t a t i
prelom	p r ěː l o m
prelomiti	p r e l ǒ m i t i
prema	p r ê m a
premalen	p r ê m a l e n
premalo	p r ê m a l o
premašiti	p r ě m a ʃ i t i
premda	p r ê m d a
premijera	p r e m i j ěː r a
prenijeti	p r ě n j eː t i
prenos	p r ěː n o s
prenositi	p r e n ǒ s i t i
prenoćiti	p r e n ǒ t͡ɕ i t i
preokret	p r ê o k r eː t
preplašiti	p r ě p l a ʃ i t i
preplivati	p r ě p l i ʋ a t i
preplivavati	p r e p l i ʋ ǎː ʋ a t i
prepoloviti	p r e p o l ǒ ʋ i t i
prepona	p r ê p o n a
preporod	p r ê p o r o d
preporučiti	p r e p o r ǔː t͡ʃ i t i
prepoznati	p r e p ǒ z n a t i
prepoznatljivost	p r e p o z n ǎ t ʎ i ʋ oː s t
prepričavati	p r e p r i t͡ʃ ǎː ʋ a t i
prepun	p r ě p u n
prepustiti	p r e p ǔ s t i t i
prepuštati	p r e p ǔː ʃ t a t i
preraditi	p r e r ǎː d i t i
prerezati	p r ě r e z a t i
prerezivati	p r e r e z ǐː ʋ a t i
pres	p r ê s
preseliti	p r e s ě l i t i
preseći	p r ě s e t͡ɕ i
preslica	p r ê s l i t͡s a
prestanak	p r ě s t a n a k
prestati	p r ě s t a t i
prestiž	p r ê s t iː ʒ
prestižni	p r ê s t i ʒ n iː
prestonica	p r ěː s t oː n i t͡s a
presuda	p r ê s u d a
presvući	p r ě s ʋ uː t͡ɕ i
pretenzija	p r e t ě n z i j a
preteča	p r ê t e t͡ʃ a
pretežno	p r ěː t e ʒ n o
prethodnica	p r ěː t x o d n i t͡s a
prethodno	p r ěː t x o d n o
pretinac	p r ě t i n a t͡s
pretisak	p r ě t i s aː k
pretplatnik	p r ě t p l a t n iː k
pretpostaviti	p r e t p ǒ s t a ʋ i t i
pretpostavka	p r ê t p o s t aː ʋ k a
pretpostavljati	p r e t p ǒ s t a ʋ ʎ a t i
pretraga	p r ê t r a ɡ a
pretraživati	p r e t r a ʒ ǐː ʋ a t i
pretrpjeti	p r e t řː p j e t i
pretući	p r ě t uː t͡ɕ i
pretvarati	p r e t ʋ ǎː r a t i
pretvarač	p r e t ʋ ǎ r aː t͡ʃ
pretvoriti	p r e t ʋ ǒ r i t i
preuzeti	p r e ǔ z eː t i
preuzimati	p r e ǔ z i m a t i
prevaga	p r ê ʋ a ɡ a
prevara	p r ê ʋ a r a
prevariti	p r ě ʋ a r i t i
prevashodan	p r e v ǎ s x o d a n
prevashodno	p r e v ǎ s x o d n o
prevelik	p r ě ʋ e l i k
preventivno	p r ê ʋ e n t iː ʋ n o
prevesti	p r ě ʋ e s t i
previše	p r ê ʋ i ʃ eː
prevladati	p r e ʋ l ǎː d a t i
prevod	p r ěː ʋ o d
prevodilac	p r e ʋ ǒ d i l a t͡s
prevoditelj	p r e ʋ ǒ d i t e ʎ
prevoditi	p r e ʋ ǒ d i t i
prevoz	p r ěː ʋ o z
prevoziti	p r e ʋ ǒ z i t i
prevrtati	p r ě ʋ r t a t i
prezalogajiti	p r e z a l o ɡ ǎː j i t i
prezervativ	p r e z e r ʋ ǎ t iː ʋ
prezir	p r ê z iː r
preći	p r êː t͡ɕ i
preštampavati	p r e ʃ t a m p ǎː ʋ a t i
prežderavati	p r e ʒ d ě r a v a t i
pri	p r î
pribadača	p r i b ǎ d a t͡ʃ a
pribaviti	p r ǐ b a ʋ i t i
približan	p r ǐː b l i ʒ a n
približavati	p r i b l i ʒ ǎː ʋ a t i
približiti	p r i b l ǐː ʒ i t i
približno	p r ǐː b l i ʒ n o
pridev	p r ǐː d e ʋ
pridobiti	p r i d ǒ b i t i
pridoneti	p r i d ǒ n eː t i
pridonijeti	p r i d ǒ n i j eː t i
pridošlica	p r ǐ d o ʃ l i t͡s a
pridružiti	p r i d r ǔː ʒ i t i
pridržavati	p r i d r ʒ ǎː ʋ a t i
prigodan	p r î ɡ o d a n
prigovor	p r î ɡ o ʋ oː r
prigovoriti	p r i ɡ o ʋ ǒ r i t i
prihod	p r ǐː x o d
prihvatiti	p r ǐ x ʋ a t i t i
prihvatljiv	p r i x ʋ ǎ t ʎ i ʋ
prihvatljivo	p r i x ʋ ǎ t ʎ i ʋ o
prihvaćati	p r ǐ x ʋ a t͡ɕ a t i
prijam	p r ǐ j a m
prijatan	p r î j aː t a n
prijatelj	p r î j a t e ʎ
prijateljica	p r i j a t ě ʎ i t͡s a
prijateljski	p r i j a t ě ʎ s k iː
prijateljstvo	p r i j a t ě ʎ s t ʋ o
prijati	p r ǐ j a t i
prijatno	p r î j aː t n o
prijava	p r î j a ʋ a
prijaviti	p r i j ǎː ʋ i t i
prije	p r î j e
prijekor	p r j ěː k o r
prijelom	p r j ěː l o m
prijem	p r ǐ j e m
prijemnik	p r ǐ j eː m n iː k
prijepis	p r j ěː p i s
prijepodne	p r i j e p ǒː d n e
prijesto	p r i j ěː s t oː
prijestolnica	p r i j ěː s t oː l n i t͡s a
prijestolonasljednik	p r j e s t o l o n ǎː s ʎ e d n iː k
prijestup	p r j ěː s t u p
prijetiti	p r j ěː t i t i
prijevod	p r j ěː ʋ o d
prijevoz	p r j ěː ʋ o z
prijeći	p r i j êː t͡ɕ i
prikloniti	p r i k l ǒ n i t i
prikrasti	p r ǐ k r a s t i
prikriti	p r ǐ k r i t i
prikupiti	p r ǐ k u p i t i
prikupljati	p r i k ǔː p ʎ a t i
prilagoditi	p r i l a ɡ ǒ d i t i
prilagodljivost	p r i l a ɡ ǒ d ʎ i ʋ oː s t
prilagođavati	p r i l a ɡ o d͡ʑ ǎː ʋ a t i
prilaz	p r ǐː l a z
prilika	p r ǐː l i k a
prilikom	p r ǐː l i k oː m
priličan	p r ǐː l i t͡ʃ a n
prilično	p r ǐː l i t͡ʃ n o
prilog	p r ǐː l o ɡ
primaran	p r î m aː r a n
primati	p r ǐː m a t i
primenjivati	p r i m e ɲ ǐː ʋ a t i
primer	p r ǐː m e r
primetiti	p r i m ěː t i t i
primijeniti	p r i m j ěː n i t i
primirje	p r ǐː m iː r j e
primiti	p r ǐː m i t i
primitivan	p r î m i t iː ʋ a n
primjena	p r î m j e n a
primjenjivati	p r i m j e ɲ ǐː ʋ a t i
primjer	p r ǐː m j e r
primjerak	p r ǐː m j e r a k
primjeren	p r ǐ m j e r e n
primjereno	p r ǐ m j e r e n o
primjerno	p r ǐː m j e r n o
primjetan	p r î m j e t a n
primjetno	p r î m j e t n o
primorati	p r i m ǒː r a t i
princ	p r î n t͡s
princeza	p r i n t͡s ěː z a
princip	p r ǐ n t͡s iː p
priopćenje	p r i o p t͡ɕ ěː ɲ e
pripadnica	p r ǐ p a d n i t͡s a
pripadnik	p r ǐ p a d n iː k
pripadnost	p r ǐ p a d n oː s t
pripasti	p r ǐ p a s t i
pripaziti	p r ǐ p a z i t i
pripisati	p r i p ǐː s a t i
pripovetka	p r î p o ʋ eː t k a
pripovijedati	p r i p o ʋ j ěː d a t i
pripovijest	p r î p o ʋ j eː s t
pripovijetka	p r î p o ʋ i j eː t k a
priredba	p r ǐː r e d b a
priroda	p r ǐː r o d a
prirodan	p r ǐː r o d a n
prirodno	p r ǐː r o d n o
priručnik	p r ǐː r u t͡ʃ n iː k
priseban	p r ǐː s e b a n
prisetiti	p r ǐ s e t i t i
prisiliti	p r ǐ s i l i t i
prisiljavati	p r i s i ʎ ǎː ʋ a t i
prisilno	p r ǐː s iː l n o
prisjetiti	p r ǐ s j e t i t i
prisloniti	p r i s l ǒ n i t i
prisluškivati	p r i s l u ʃ k ǐː ʋ a t i
prisno	p r î s n o
pristajati	p r ǐ s t a j a t i
pristanak	p r ǐ s t a n a k
pristati	p r ǐ s t a t i
pristaša	p r î s t a ʃ a
pristizati	p r ǐ s t i z a t i
pristojan	p r ǐː s t oː j a n
pristojno	p r ǐː s t oː j n o
pristojnost	p r i s t ǒː j n oː s t
pristup	p r ǐː s t u p
pristupati	p r i s t ǔː p a t i
pristupačan	p r î s t u p aː t͡ʃ a n
pristupačno	p r î s t u p aː t͡ʃ n o
pristupačnost	p r î s t u p aː t͡ʃ n oː s t
pristupiti	p r i s t ǔː p i t i
prisustvovati	p r ǐ s u s t ʋ o ʋ a t i
prisutnost	p r i s ǔː t n oː s t
pritisak	p r ǐ t i s a k
pritiskati	p r i t ǐː s k a t i
pritisnuti	p r ǐ t i s n u t i
pritužba	p r ǐː t u ʒ b a
priuštiti	p r i ǔ ʃ t i t i
privatizacija	p r i ʋ a t i z ǎː t͡s i j a
privatni	p r î ʋ aː t n iː
privatno	p r î ʋ aː t n o
privesti	p r ǐ ʋ e s t i
privezivati	p r i ʋ e z ǐː ʋ a t i
privjesak	p r ǐː ʋ j e s a k
privlačan	p r î ʋ l aː t͡ʃ a n
privlačiti	p r i ʋ l ǎː t͡ʃ i t i
privreda	p r î ʋ r e d a
privredni	p r î ʋ r e d n iː
privrednik	p r î ʋ r e d n iː k
privremen	p r ǐ ʋ r e m e n
privremeno	p r ǐ ʋ r e m e n o
privući	p r ǐ ʋ uː t͡ɕ i
prizemlje	p r ǐː z eː m ʎ e
priznanje	p r i z n ǎː ɲ e
prizor	p r ǐː z o r
prići	p r îː t͡ɕ i
pričest	p r ǐː t͡ʃ e s t
pričinjavati	p r i t͡ʃ i ɲ ǎː ʋ a t i
priština	p r ǐ ʃ t i n a
prištinski	p r ǐ ʃ t iː n s k iː
prkositi	p ř k o s i t i
prkosno	p ř k o s n o
prljav	p r̂ ʎ a ʋ
prljavo	p r̂ ʎ a ʋ o
prljavština	p r ʎ ǎː ʋ ʃ t i n a
proba	p r ǒː b a
probati	p r ǒː b a t i
probava	p r ô b a ʋ a
probavljiv	p r o b ǎ ʋ ʎ i ʋ
probavni	p r ô b aː ʋ n iː
probijati	p r o b ǐː j a t i
probiti	p r ǒ b i t i
problem	p r ǒ b l eː m
problematičan	p r o b l e m ǎ t i t͡ʃ a n
problematično	p r o b l e m ǎ t i t͡ʃ n o
probosti	p r ǒ b o s t i
probuditi	p r o b ǔː d i t i
procedura	p r o t͡s e d ǔː r a
procena	p r ô t͡s e n a
procesija	p r o t͡s ě s i j a
procijeniti	p r o t͡s i j ěː n i t i
procjena	p r ô t͡s j e n a
procjep	p r ǒː t͡s j e p
prodajni	p r ô d aː j n iː
prodan	p r ô d a n
prodati	p r ǒ d a t i
prodavaonica	p r o d a ʋ a ǒː n i t͡s a
prodavatelj	p r o d ǎ ʋ a t e ʎ
prodavač	p r o d ǎ ʋ aː t͡ʃ
prodavačica	p r o d a ʋ ǎ t͡ʃ i t͡s a
prodavnica	p r ǒ d a ʋ n i t͡s a
prodor	p r ǒː d o r
prodrijeti	p r ǒ d r j eː t i
produkcija	p r o d ǔ k t͡s i j a
produktivan	p r ô d u k t iː ʋ a n
profesionalac	p r o f e s i o n ǎː l a t͡s
profesionalan	p r ô f e s i o n aː l a n
profesionalizam	p r o f e s i o n a l ǐ z a m
profesionalno	p r ô f e s i o n aː l n o
profit	p r ǒ f iː t
profitabilan	p r ô f i t a b iː l a n
proglasiti	p r o ɡ l ǎː s i t i
prognanik	p r ǒ ɡ n a n iː k
prognozirati	p r o ɡ n o z ǐː r a t i
progon	p r ǒ ɡ o n
progonstvo	p r ǒ ɡ oː n s t ʋ o
progovoriti	p r o ɡ o ʋ ǒ r i t i
progres	p r ǒ ɡ r e s
progutati	p r o ɡ ǔ t a t i
proizvesti	p r o ǐ z ʋ e s t i
proizvoditi	p r o i z ʋ ǒ d i t i
proizvodni	p r ô i z ʋ o d n iː
proizvodnja	p r o i z ʋ ǒ d ɲ a
proizvođač	p r o i z ʋ ǒ d͡ʑ aː t͡ʃ
projekcija	p r o j ě k t͡s i j a
projekt	p r ǒ j e k t
projektil	p r o j ě k t iː l
projektor	p r ǒ j e k t o r
proklijati	p r o k l ǐ j a t i
proklinjati	p r ǒ k l i ɲ a t i
prolaz	p r ǒː l a z
prolazak	p r ǒ l a z a k
prolazan	p r ǒː l a z a n
prolaziti	p r ǒ l a z i t i
proleter	p r o l ě t eː r
proletos	p r ǒ l e t oː s
proljetni	p r ǒ ʎ e t n iː
promatrati	p r o m ǎː t r a t i
promašaj	p r ô m a ʃ aː j
promašiti	p r ǒ m a ʃ i t i
promena	p r ô m e n a
promet	p r ǒː m e t
promicati	p r ǒ m i t͡s a t i
promijeniti	p r o m j ěː n i t i
promisliti	p r ǒ m i s l i t i
promjer	p r ǒː m j e r
promocija	p r ǒ m oː t͡s i j a
promotriti	p r o m ǒ t r i t i
promrsivati	p r o m r s ǐː ʋ a t i
pronalazak	p r o n ǎ l a z a k
proniknuti	p r ǒ n i k n u t i
pronići	p r ǒ n i t͡ɕ i
propadati	p r ǒ p a d a t i
propaganda	p r o p ǎ ɡ aː n d a
propagandni	p r o p ǎ ɡ aː n d n iː
propan	p r ǒ p aː n
propasti	p r ǒ p a s t i
propatiti	p r ǒ p a t i t i
propis	p r ǒ p i s
propisati	p r o p ǐː s a t i
propisivati	p r o p i s ǐː ʋ a t i
proporcija	p r o p ǒ r t͡s i j a
proporcionalno	p r ô p o r t͡s i o n aː l n o
propovednik	p r o p o ʋ ě d n iː k
propovijedati	p r o p o ʋ j ěː d a t i
propovjednik	p r o p o ʋ j ě d n iː k
proprati	p r ǒ p r a t i
propušiti	p r ǒ p u ʃ i t i
proraditi	p r o r ǎː d i t i
proračunati	p r o r a t͡ʃ ǔ n a t i
proročište	p r ǒ r o t͡ʃ iː ʃ t e
prosečno	p r ô s e t͡ʃ n o
prosinac	p r ǒ s i n a t͡s
prositi	p r ǒ s i t i
prosjak	p r ô s j aː k
prosječno	p r ô s j e t͡ʃ n o
proso	p r ô s o
prosperirati	p r o s p e r ǐː r a t i
prost	p r ô s t
prostitucija	p r o s t i t ǔː t͡s i j a
prostitutka	p r ǒ s t i t uː t k a
prosto	p r ô s t o
prostor	p r ǒː s t o r
prostorija	p r o s t ǒ r i j a
prostorni	p r ǒː s t oː r n iː
prostorno	p r ǒː s t o r n o
prostran	p r ǒ s t r a n
prosvjed	p r ǒ s ʋ j e d
prosvjedovati	p r ǒ s ʋ j e d o ʋ a t i
protektorat	p r o t e k t ǒ r aː t
protiv	p r ô t i ʋ
protivan	p r ô t iː ʋ a n
protivnik	p r ǒ t iː ʋ n iː k
prouzrokovati	p r o ǔː z r o k o ʋ a t i
proučavanje	p r o u t͡ʃ ǎː ʋ aː ɲ e
proučavati	p r o u t͡ʃ ǎː ʋ a t i
proučiti	p r o ǔ t͡ʃ i t i
proveriti	p r ǒ ʋ e r i t i
provesti	p r ǒ ʋ e s t i
provjeravati	p r o ʋ j e r ǎː ʋ a t i
provoditi	p r o ʋ ǒ d i t i
provokativan	p r ô ʋ o k a t iː ʋ a n
proza	p r ǒː z a
proziran	p r ô z iː r a n
prozivati	p r o z ǐː ʋ a t i
prozni	p r ôː z n iː
prozor	p r ǒː z o r
proširiti	p r o ʃ ǐː r i t i
prošli	p r ô ʃ l iː
prošlogodišnji	p r o ʃ l o ɡ ǒ d i ʃ ɲ iː
prožeti	p r ǒ ʒ eː t i
prsa	p r̂ s a
prtljaga	p r t ʎ ǎː ɡ a
pruga	p r ǔː ɡ a
prus	p r û s
pruski	p r û s k iː
pružati	p r ǔː ʒ a t i
pružiti	p r û ʒ i t i
prvenstveno	p r ʋ ě n s t ʋ e n o
prvorazredan	p r ʋ o r ǎː z r e d a n
prvotno	p ř ʋ o t n o
pršut	p ř ʃ u t
psalam	p s ǎ l a m
psiha	p s î x a
psihijatar	p s i x ǐ j aː t a r
psihijatrijski	p s i x i j ǎ t r iː j s k iː
psiholog	p s i x ǒ l o ɡ
psihologija	p s i x o l ǒ ɡ i j a
psihoterapija	p s i x o t e r ǎ p i j a
psihoza	p s i x ǒː z a
psina	p s î n a
psić	p s î t͡ɕ
psovati	p s ǒ ʋ a t i
ptica	p t î t͡s a
ptičar	p t î t͡ʃ aː r
ptičica	p t î t͡ʃ i t͡s a
ptičji	p t î t͡ʃ j iː
ptičurina	p t i t͡ʃ ǔ r i n a
pubertet	p u b ě r t eː t
publicitet	p u b l i t͡s ǐ t eː t
publika	p ǔ b l i k a
pucanj	p ûː t͡s a ɲ
pucati	p û t s a t i
pucnjava	p ǔ t͡s ɲ a ʋ a
puhati	p ǔː x a t i
puk	p ûː k
puknuti	p û k n u t i
pukotina	p ǔ k o t i n a
pukovnija	p u k ǒ ʋ n i j a
pukovnik	p ǔ k oː ʋ n iː k
puma	p û m a
pun	p û n
punkt	p û n k t
puno	p û n o
punomoć	p û n o m oː t͡ɕ
pupak	p û p a k
pupati	p ǔ p a t i
pustinja	p ǔː s t i ɲ a
pustinjski	p ǔː s t iː ɲ s k iː
pustiti	p ǔ s t i t i
pustolovina	p u s t o l ǒ ʋ i n a
putanja	p ǔ t a ɲ a
puteljak	p u t ěː ʎ a k
putem	p ǔː t e m
putnik	p ûː t n iː k
putovati	p u t ǒ ʋ a t i
putovnica	p u t ǒː ʋ n i t͡s a
pučanin	p ǔː t͡ʃ a n i n
pučist	p ǔ t͡ʃ i s t
pušač	p ǔ ʃ aː t͡ʃ
pušiti	p û ʃ i t i
puštati	p ǔː ʃ t a t i
pužić	p ǔ ʒ i t͡ɕ
pčela	p t͡ʃ ě l a
pčelar	p t͡ʃ ě l aː r
pčelica	p t͡ʃ ě l i t͡s a
pčelinjak	p t͡ʃ ě l i ɲ aː k
pšenica	p ʃ ě n i t͡s a
rabiti	r ǎː b i t i
rabota	r ǎ b o t a
racionalan	r â t͡s i o n aː l a n
radar	r â d aː r
radijus	r âː d i j u s
radikal	r a d ǐ k aː l
radikalan	r â d i k aː l a n
radikalizam	r a d i k a l ǐ z a m
radikalno	r â d i k aː l n o
radioaktivno	r a d i o ǎ k t iː ʋ n o
radioaktivnost	r a d i o a k t ǐː ʋ n oː s t
radionica	r a d i ǒː n i t͡s a
radiostanica	r a d i o s t ǎ n i t͡s a
radni	r âː d n iː
radnica	r âː d n i t͡s a
radnik	r âː d n iː k
radnja	r ǎː d ɲ a
rado	r â d o
radosno	r â d o s n o
radost	r â d oː s t
radostan	r â d o s t a n
radovati	r â d o ʋ a t i
rafinerija	r a f i n ě r i j a
ragbi	r â ɡ b i
raja	r ǎː j a
rajna	r âː j n a
rajsferšlus	r ǎ j s f e r ʃ l u s
raketa	r a k ě t a
rana	r â n a
rani	r â n i
rapidno	r â p iː d n o
rasa	r â s a
rascjep	r ǎː s t͡s j e p
raseliti	r a s ě l i t i
raseljavati	r a s e ʎ ǎː ʋ a t i
rashod	r ǎː s x o d
rasipati	r ǎ s i p a t i
rasizam	r a s ǐ z a m
raskinuti	r ǎ s k i n u t i
raskol	r ǎː s k o l
raskoš	r ǎː s k o ʃ
raskrsnica	r ǎː s k r s n i t͡s a
raslinje	r ǎː s l iː ɲ e
raspisati	r a s p ǐː s a t i
rasplakati	r ǎ s p l a k a t i
raspodela	r â s p o d e l a
raspodjela	r â s p o d j e l a
raspolagati	r a s p o l ǎː ɡ a t i
raspoloživ	r a s p o l ǒ ʒ i ʋ
raspon	r ǎː s p o n
raspored	r â s p o r eː d
rasporediti	r a s p o r ěː d i t i
raspoređivati	r a s p o r e d͡ʑ ǐː ʋ a t i
raspoznati	r a s p ǒ z n a t i
rasprava	r âː s p r a ʋ a
raspraviti	r ǎ s p r a ʋ i t i
raspravljati	r ǎ s p r a ʋ ʎ a t i
rasprodaja	r â s p r o d a j a
raspust	r ǎː s p u s t
raspustiti	r a s p ǔ s t i t i
rast	r âː s t
rastaviti	r ǎ s t a ʋ i t i
rasteretiti	r a s t ě r e t i t i
rasti	r âː s t i
rastopiti	r a s t ǒ p i t i
rastužiti	r a s t ǔː ʒ i t i
rastvoriti	r a s t ʋ ǒ r i t i
rasuti	r ǎ s uː t i
rata	r ǎː t a
ratifikacija	r a t i f i k ǎː t͡s i j a
ratni	r â t n iː
ratnik	r â t n iː k
ratovati	r â t o ʋ a t i
ravnatelj	r ǎ ʋ n a t e ʎ
ravnateljica	r a ʋ n a t ě ʎ i t͡s a
ravnica	r a ʋ n ǐ t͡s a
ravno	r âː ʋ n o
ravnodušan	r a ʋ n ǒ d u ʃ a n
ravnodušnost	r a ʋ n ǒ d u ʃ n oː s t
ravnomeran	r â ʋ n o m eː r a n
ravnomjerno	r â ʋ n o m j eː r n o
ravnopravnost	r a ʋ n o p r ǎː ʋ n oː s t
ravnoteža	r a ʋ n o t ěː ʒ a
razabrati	r a z ǎ b r a t i
razblaživati	r a z b l a ʒ ǐː ʋ a t i
razbojnik	r ǎː z b oː j n iː k
razbor	r ǎː z b o r
razborit	r ǎː z b o r i t
razborito	r ǎː z b o r i t o
razboritost	r ǎː z b o r i t oː s t
razdoblje	r ǎː z d oː b ʎ e
razdor	r ǎː z d o r
razdvojeno	r ǎ z d ʋ o j e n o
razdvojenost	r ǎ z d ʋ oː j e n oː s t
razdvojiti	r a z d ʋ ǒ j i t i
razdvojivost	r a z d ʋ ǒ j i ʋ oː s t
razgovarati	r a z ɡ o ʋ ǎː r a t i
razgovor	r â z ɡ o ʋ oː r
razlikovati	r ǎː z l i k o ʋ a t i
različit	r ǎː z l i t͡ʃ i t
različito	r ǎː z l i t͡ʃ i t o
različitost	r ǎː z l i t͡ʃ i t oː s t
razlog	r ǎː z l o ɡ
razlučivati	r a z l u t͡ʃ ǐː ʋ a t i
razmak	r ǎː z m a k
razmatrati	r a z m ǎː t r a t i
razmijeniti	r a z m j ěː n i t i
razmisliti	r ǎ z m i s l i t i
razmišljati	r a z m ǐː ʃ ʎ a t i
razmjenjivati	r a z m j e ɲ ǐː ʋ a t i
razmnožavati	r a z m n o ʒ ǎː ʋ a t i
razni	r âː z n iː
raznijeti	r ǎ z n i j eː t i
raznježivati	r a z ɲ e ʒ ǐː ʋ a t i
raznolik	r a z n ǒ l i k
raznolikost	r a z n ǒ l i k oː s t
raznovrstan	r a z n ǒ ʋ r s t a n
razoran	r ǎː z oː r a n
razoriti	r a z ǒ r i t i
razoružati	r a z o r ǔ ʒ a t i
razotkriti	r a z ǒ t k r i t i
razočaranje	r a z o t͡ʃ a r ǎː ɲ e
razočarenje	r a z o t͡ʃ a r ěː ɲ e
razrada	r âː z r a d a
razraditi	r a z r ǎː d i t i
razred	r ǎː z r e d
razredbeni	r ǎː z r e d b e n iː
razroko	r ǎ z r o k o
razularenost	r a z ǔ l aː r e n oː s t
razum	r â z uː m
razuman	r â z uː m a n
razumjeti	r a z ǔ m j e t i
razumno	r â z uː m n o
razvaliti	r a z ʋ ǎː l i t i
razveden	r a z ʋ ě d e n
razveseliti	r a z ʋ e s ě l i t i
razvidan	r ǎː z ʋ i d a n
razvijati	r a z ʋ ǐː j a t i
razvitak	r a z ʋ ǐː t a k
razviti	r ǎ z ʋ i t i
razvoj	r ǎː z ʋ o j
razvojni	r ǎː z ʋ oː j n iː
račić	r ǎ t͡ʃ i t͡ɕ
računaljka	r a t͡ʃ ǔ n aː ʎ k a
računalo	r a t͡ʃ ǔ n a l o
računar	r a t͡ʃ ǔ n aː r
računati	r a t͡ʃ ǔ n a t i
računovodstvo	r a t͡ʃ u n o ʋ ǒ d s t ʋ o
računovođa	r a t͡ʃ u n ǒ ʋ o d͡ʑ a
rađati	r ǎː d͡ʑ a t i
raširiti	r a ʃ ǐː r i t i
raž	r âː ʒ
reagirati	r e a ɡ ǐː r a t i
reakcija	r e ǎ k t͡s i j a
realan	r ê aː l a n
realizirati	r e a l i z ǐː r a t i
realno	r ê aː l n o
rebalans	r ê b a l a n s
rebro	r ě b r o
recept	r ě t͡s e p t
recesija	r e t͡s ě s i j a
recikliranje	r e t͡s i k l ǐː r aː ɲ e
reciklirati	r e t͡s i k l ǐː r a t i
redak	r ěː d a k
redakcija	r e d ǎ k t͡s i j a
redatelj	r ě d a t e ʎ
redikul	r ě d iː k u l
redom	r êː d o m
redoslijed	r ê d o s l j eː d
redovan	r ê d oː ʋ a n
redovito	r e d ǒ ʋ i t o
redovno	r ê d oː ʋ n o
redžep	r ě d͡ʒ e p
reformator	r e f ǒ r m aː t o r
refren	r ě f r eː n
regulacija	r e ɡ u l ǎː t͡s i j a
regularnost	r e ɡ u l ǎː r n oː s t
regulativa	r e ɡ u l a t ǐː ʋ a
regulirati	r e ɡ u l ǐː r a t i
rehabilitirati	r e x a b i l i t ǐː r a t i
rekonstrukcija	r e k o n s t r ǔ k t͡s i j a
relativno	r ê l a t iː ʋ n o
relevantan	r e l e ʋ ǎ n t a n
relevantno	r e l e ʋ ǎ n t n o
relevantnost	r e l e ʋ ǎ n t n oː s t
religiozno	r ê l i ɡ i oː z n o
reljef	r ě ʎ e f
remetiti	r ě m e t i t i
ren	r ê n
renesansa	r e n e s ǎ n s a
renome	r e n ǒ m eː
rep	r êː p
reparacija	r e p a r ǎː t͡s i j a
repertoar	r e p e r t ǒ aː r
replika	r ě p l i k a
reportaža	r e p o r t ǎː ʒ a
reporter	r e p ǒ r t eː r
reporterka	r e p ǒ r t eː r k a
reprezentacija	r e p r e z e n t ǎː t͡s i j a
reprezentativac	r e p r e z e n t a t ǐː ʋ a t͡s
reprezentativka	r e p r e z e n t ǎ t iː ʋ k a
reprodukcija	r e p r o d ǔ k t͡s i j a
republika	r e p ǔ b l i k a
republikanac	r e p u b l i k ǎː n a t͡s
republički	r e p ǔ b l i t͡ʃ k iː
reputacija	r e p u t ǎː t͡s i j a
resor	r ě s oː r
restrikcija	r e s t r ǐ k t͡s i j a
resurs	r ě s u r s
retorika	r e t ǒ r i k a
retroaktivno	r e t r o ǎ k t iː ʋ n o
revolucija	r e ʋ o l ǔː t͡s i j a
revolucionaran	r ê ʋ o l u t͡s i o n aː r a n
revolver	r e ʋ ǒ l ʋ e r
rez	r êː z
rezati	r ê z a t i
rezident	r e z ǐ d e n t
rezime	r e z ǐ m eː
rezistentan	r e z i s t ě n t a n
rezolucija	r e z o l ǔː t͡s i j a
rezultat	r e z ǔ l t aː t
rezultirati	r e z u l t ǐː r a t i
reći	r ê t͡ɕ i
reč	r êː t͡ʃ
rešavati	r e ʃ ǎː ʋ a t i
rešenje	r e ʃ ěː ɲ e
rešeto	r e ʃ ě t o
rešiti	r ěː ʃ i t i
režim	r ě ʒ iː m
režiser	r e ʒ ǐ s eː r
riba	r î b a
ribarstvo	r i b ǎː r s t ʋ o
riblji	r î b ʎ iː
riboflavin	r i b o f l ǎ ʋ iː n
riga	r îː ɡ a
rigorozan	r î ɡ o r oː z a n
rijedak	r j ěː d a k
rijetko	r j êː t k o
rijetkost	r i j ěː t k oː s t
riječni	r i j êː t͡ʃ n iː
riješiti	r i j ěː ʃ i t i
rim	r îː m
rima	r ǐː m a
rimljanin	r ǐː m ʎ a n i n
riskantan	r i s k ǎ n t a n
ritam	r ǐ t a m
ritual	r i t ǔ aː l
ritualno	r î t u aː l n o
rival	r ǐ ʋ aː l
riza	r ǐː z a
rizično	r î z i t͡ʃ n o
riznica	r ǐ z n i t͡s a
riđobrad	r i d͡ʑ ǒ b r a d
rječit	r j ě t͡ʃ i t
rječito	r j ě t͡ʃ i t o
rječnik	r j êː t͡ʃ n iː k
rječoslovje	r j e t͡ʃ o s l o v j e
rješavati	r j e ʃ ǎː ʋ a t i
rješenje	r j e ʃ ěː ɲ e
rob	r ô b
roba	r ô b a
roda	r ǒː d a
roditeljski	r ǒ d i t e ʎ s k iː
roditi	r ǒ d i t i
rodjen	r ô d j e n
rodni	r ô d n iː
rodom	r ô d o m
rodoslovlje	r ô d o s l oː ʋ ʎ e
rogoz	r ô ɡ oː z
roman	r ǒ m aː n
romkinja	r ô m k i ɲ a
ropstvo	r ǒ p s t ʋ o
rosa	r ǒ s a
rotacija	r o t ǎː t͡s i j a
rotor	r ôː t o r
rođak	r ô d͡ʑ aː k
rođendan	r ô d͡ʑ e n d aː n
rođenje	r o d͡ʑ ěː ɲ e
roštilj	r ǒ ʃ t iː ʎ
rtanj	r̂ t a ɲ
ruanda	r ǔ aː n d a
rubac	r ǔː b a t͡s
ruben	r ǔ b e n
rubeški	r ǔ b e ʃ k iː
rubin	r ǔ b iː n
rubinet	r u b ǐ n e t
rublje	r ûː b ʎ e
rubrika	r ǔ b r i k a
rud	r ûː d
ruda	r ǔː d a
rudar	r ǔ d aː r
rudarstvo	r u d ǎː r s t ʋ o
rudina	r ǔ d i n a
rudnik	r ûː d n iː k
rudnički	r ûː d n i t͡ʃ k iː
rugati	r ǔː ɡ a t i
ruglo	r ǔː ɡ l o
ruho	r û x o
ruj	r ûː j
rujan	r ûː j a n
ruka	r ǔː k a
rukav	r ǔ k aː ʋ
rukomet	r û k o m eː t
rukometaš	r u k o m ě t aː ʃ
rukotvorina	r u k o t ʋ ǒ r i n a
rukovodeći	r u k o ʋ ǒ d eː t͡ɕ iː
rukovodilac	r u k o ʋ ǒ d i l a t͡s
rukovoditi	r u k o ʋ ǒ d i t i
rukovodstvo	r u k o ʋ ǒ d s t ʋ o
ruksak	r û k s aː k
rumenilo	r u m ě n i l o
rumunija	r ǔ m uː n i j a
rumunjska	r ǔ m uː ɲ s k aː
runda	r û n d a
rupa	r û p a
rupetina	r u p ě t i n a
rupija	r ǔ p i j a
rupčić	r ǔ p t͡ʃ i t͡ɕ
rusija	r ǔ s i j a
ruski	r û s k iː
ruskinja	r û s k i ɲ a
ruter	r ǔ t e r
rutina	r u t ǐ n a
rutinski	r ǔ t iː n s k iː
ruzmarin	r û z m a r iː n
ručak	r ǔː t͡ʃ a k
ručnik	r ǔ t͡ʃ n iː k
rušiti	r û ʃ i t i
ružan	r ǔː ʒ a n
ružica	r û ʒ i t͡s a
ružno	r ûː ʒ n o
sabor	s ǎː b o r
saborski	s ǎː b o r s k iː
sabranost	s â b r aː n oː s t
sabrati	s ǎ b r a t i
sada	s â d a
sadašnji	s ǎ d a ʃ ɲ iː
saditi	s ǎː d i t i
sadnja	s ǎː d ɲ a
sadra	s â d r a
sadržajno	s â d r ʒ aː j n o
sadžak	s â d͡ʒ aː k
sag	s âː ɡ
sagrešenje	s a ɡ r e ʃ ěː ɲ e
sahrana	s ǎ x r a n a
sajam	s ǎː j a m
sajla	s âː j l a
sajmišni	s â j m iː ʃ n iː
sajmište	s â j m iː ʃ t e
sakatost	s ǎ k a t oː s t
sako	s ǎ k oː
sakrament	s a k r ǎ m e n t
sakristija	s a k r ǐ s t i j a
sakriti	s ǎ k r i t i
salata	s a l ǎː t a
salaš	s ǎ l aː ʃ
salo	s â l o
salon	s ǎ l oː n
salona	s a l ôː n a
salvador	s ǎ l ʋ aː d o r
samac	s ǎː m a t͡s
samit	s ǎ m i t
samljeti	s ǎ m ʎ e t i
samo	s â m o
samoobrana	s a m o ǒ b r a n a
samopouzdanje	s a m o p o u z d ǎː ɲ e
samostalan	s â m o s t aː l a n
samostalno	s â m o s t aː l n o
samoubojica	s a m o ǔ b o j i t͡s a
samoubojstvo	s a m o ǔ b oː j s t ʋ o
samouništenje	s a m o u n i ʃ t ěː ɲ e
samouprava	s a m o ǔ p r a ʋ a
samouvjeren	s a m o ǔ ʋ j e r e n
samouvjereno	s a m o ǔ ʋ j e r e n o
samovolja	s a m ǒ ʋ o ʎ a
samovoljno	s â m o ʋ oː ʎ n o
san	s â n
sanja	s â ɲ a
sanjati	s ǎː ɲ a t i
saobraćaj	s â o b r a t͡ɕ aː j
saopćenje	s a o p t͡ɕ ěː ɲ e
saopćiti	s a ǒ p t͡ɕ i t i
sapun	s ǎ p uː n
saradnja	s a r ǎ d ɲ a
sarajevo	s ǎ r a j e ʋ o
sarajevski	s ǎ r a j e ʋ s k iː
sarajka	s ǎ r aː j k a
sarajlija	s a r ǎ j l i j a
sardina	s a r d ǐː n a
sardinija	s ǎ r d iː n i j a
sarkastično	s a r k ǎ s t i t͡ʃ n o
sarkofag	s a r k ǒ f aː ɡ
sastanak	s ǎ s t a n a k
sastati	s ǎ s t a t i
sastav	s ǎː s t a ʋ
sastavak	s ǎː s t a ʋ a k
sastaviti	s ǎ s t a ʋ i t i
sastavljač	s a s t ǎ ʋ ʎ aː t͡ʃ
sastavni	s ǎː s t a ʋ n iː
sastojak	s ǎː s t o j a k
sastojati	s ǎː s t o j a t i
sasvim	s ǎ s ʋ iː m
sat	s âː t
satelit	s a t ě l iː t
satima	s ǎː t i m a
satiričar	s a t ǐ r i t͡ʃ aː r
satnica	s â t n i t͡s a
satrap	s ǎ t r a p
saturn	s ǎ t u r n
saudijski	s a ǔ d iː j s k iː
saučešće	s ǎ u t͡ʃ e ʃ t͡ɕ e
sav	s â ʋ
savana	s a ʋ ǎ n a
savet	s ǎː ʋ e t
savetnik	s ǎː ʋ e t n iː k
savez	s ǎː ʋ e z
saveznik	s ǎː ʋ e z n iː k
saveznički	s ǎː ʋ e z n i t͡ʃ k iː
savezništvo	s ǎː ʋ e z n iː ʃ t ʋ o
savijati	s a ʋ ǐː j a t i
savjest	s ǎː ʋ j e s t
savjet	s ǎː ʋ j e t
savjetnik	s ǎː ʋ j e t n iː k
savjetodavac	s a ʋ j e t o d ǎː ʋ a t͡s
savjetovati	s ǎː ʋ j e t o ʋ a t i
savladati	s a ʋ l ǎː d a t i
savršen	s ǎ ʋ rː ʃ e n
savršeno	s ǎ ʋ rː ʃ e n o
savršenost	s ǎ ʋ rː ʃ e n oː s t
saznati	s ǎ z n a t i
sazvati	s ǎ z ʋ a t i
saće	s ǎ t͡ɕ e
sačekati	s ǎ t͡ʃ e k a t i
sačiniti	s a t͡ʃ ǐ n i t i
sačinjavati	s a t͡ʃ i ɲ ǎː ʋ a t i
sačuvati	s a t͡ʃ ǔː ʋ a t i
sažetak	s a ʒ ěː t a k
scenarij	s t͡s ě n aː r iː j
sebe	s ê b e
sebi	s ê b i
sebičan	s ě b i t͡ʃ a n
sed	s êː d
sedam	s ê d a m
sedište	s ê d iː ʃ t e
sedlar	s ě d l aː r
sedmi	s ê d m iː
sedmica	s ě d m i t͡s a
sedmorica	s e d m ǒ r i t͡s a
segment	s ě ɡ m e n t
seka	s ěː k a
sekretarijat	s e k r e t a r ǐ j aː t
seks	s ê k s
seksizam	s e k s ǐ z a m
sekunda	s e k ǔ n d a
selektivno	s ê l e k t iː ʋ n o
selektor	s ě l e k t o r
selica	s ě l i t͡s a
seljak	s ě ʎ aː k
seljakinja	s e ʎ ǎ k i ɲ a
selotejp	s ê l o t e j p
semenka	s ě m eː n k a
seminar	s e m ǐ n aː r
semitski	s ě m iː t s k iː
sena	s ê n a
senator	s ě n aː t o r
sendvič	s ê n d ʋ i t͡ʃ
senf	s ê n f
senka	s êː n k a
sentimentalan	s ê n t i m e n t aː l a n
senzacija	s e n z ǎː t͡s i j a
senzacionalan	s ê n z a t͡s i o n aː l a n
senzacionalno	s ê n z a t͡s i o n aː l n o
senzualan	s ê n z uː a l a n
seoba	s e ǒ b a
seoce	s e ǒ t͡s e
seoski	s ě o s k iː
septembar	s ě p t eː m b a r
serum	s ěː r u m
servis	s ě r ʋ iː s
sesija	s ě s i j a
sestra	s ě s t r a
sestrica	s ě s t r i t͡s a
seta	s ê t a
sevastopolj	s e ʋ a s t ǒ p o ʎ
sevdalija	s e ʋ d ǎ l i j a
sevdalinka	s e ʋ d ǎ l iː n k a
severnjača	s e ʋ ěː r ɲ a t͡ʃ a
sezona	s e z ǒː n a
sezonski	s ě z oː n s k iː
shema	s x ěː m a
shodno	s x ô d n o
shvatljiv	s x ʋ ǎ t ʎ i ʋ
shvaćati	s x ʋ â t͡ɕ a t i
si	s i
sibir	s ǐ b iː r
sicilija	s ǐ t͡s iː l i j a
sigurnost	s i ɡ ǔː r n oː s t
sijalica	s î j a l i t͡s a
sijam	s ǐ j aː m
sijaset	s i j ǎː s e t
sijeno	s i j êː n o
siječanj	s i j êː t͡ʃ a ɲ
sila	s î l a
silan	s îː l a n
silazak	s ǐ l a z a k
silaziti	s ǐ l a z i t i
siledžija	s i l ě d͡ʒ i j a
silno	s îː l n o
silom	s î l oː m
silovanje	s î l o ʋ aː ɲ e
silovati	s î l o ʋ a t i
silovit	s i l ǒ ʋ i t
simboličan	s i m b ǒ l i t͡ʃ a n
simbolički	s i m b ǒ l i t͡ʃ k i
simbolično	s i m b ǒ l i t͡ʃ n o
simetričan	s i m ě t r i t͡ʃ a n
simetrično	s i m ě t r i t͡ʃ n o
simfonija	s ǐ m f oː n i j a
simo	s î m o
simpa	s i m p ǎ
simpatičan	s i m p ǎ t i t͡ʃ a n
simpatično	s i m p ǎ t i t͡ʃ n o
simptomatično	s i m p t o m ǎ t i t͡ʃ n o
simulacija	s i m u l ǎː t͡s i j a
simulator	s i m ǔ l aː t o r
sinagoga	s i n a ɡ ǒː ɡ a
sindikat	s i n d ǐ k aː t
sinergija	s i n ě r ɡ i j a
singl	s ǐ n ɡ l
sinkretizam	s i n k r e t ǐ z a m
sinoć	s î n oː t͡ɕ
sinoćnji	s î n o t͡ɕ ɲ iː
sintagma	s ǐ n t a ɡ m a
sintetizirati	s i n t e t i z ǐː r a t i
sinteza	s i n t ěː z a
sinčić	s ǐ n t͡ʃ i t͡ɕ
sipa	s î p a
sir	s î r
sirena	s i r ěː n a
sirija	s îː r i j a
sirijski	s îː r iː j s k iː
sirni	s îː r n iː
siromašan	s i r ǒ m a ʃ a n
siromaštvo	s i r o m ǎː ʃ t ʋ o
sirota	s i r ǒ t a
sirovo	s ǐ r o ʋ o
sisavac	s î s a ʋ a t͡s
sistem	s ǐ s t eː m
sitan	s ǐ t a n
sitnica	s i t n ǐ t͡s a
sitničav	s ǐ t n i t͡ʃ a ʋ
sitno	s î t n o
sito	s î t o
situacija	s i t u ǎː t͡s i j a
sivac	s ǐː ʋ a t͡s
sivilo	s ǐ ʋ i l o
sivonja	s ǐː ʋ o ɲ a
sjaj	s j âː j
sjajan	s j ǎː j a n
sjajno	s j âː j n o
sjati	s j â t i
sjebati	s j ě b a t i
sjedalo	s j ê d a l o
sjediniti	s j e d ǐː n i t i
sjediti	s j ě d i t i
sjedište	s j ê d iː ʃ t e
sjedjeti	s j ě d j e t i
sjednica	s j ê d n i t͡s a
sjeme	s j ê m e
sjena	s j ê n a
sjenka	s j êː n k a
sjenovit	s j e n ǒ ʋ i t
sjesti	s j ê s t i
sjeta	s j ê t a
sjever	s j ê ʋ e r
sjeverac	s j e ʋ ěː r a t͡s
sjeverni	s j ê ʋ eː r n iː
sjeverno	s j ê ʋ eː r n o
sjevernokorejski	s j e ʋ e r n o k ǒ r eː j s k iː
sjeveroistok	s j e ʋ e r o ǐ s t o k
sjeveroistočno	s j e ʋ e r o ǐ s t o t͡ʃ n o
sjeverozapadni	s j e ʋ e r o z ǎː p a d n iː
sjeverozapadno	s j e ʋ e r o z ǎː p a d n o
sjećati	s j ê t͡ɕ a t i
sjeći	s j ê t͡ɕ i
sjutra	s j û t r a
skakati	s k ǎː k a t i
skakač	s k ǎ k aː t͡ʃ
skandalozno	s k â n d a l oː z n o
skaut	s k ǎ u t
skener	s k ê n e r
skica	s k î t͡s a
skidati	s k ǐː d a t i
skijati	s k î j a t i
skinuti	s k î n u t i
sklad	s k l â d
skladatelj	s k l ǎ d a t e ʎ
skladba	s k l ǎ d b a
skladište	s k l â d iː ʃ t e
skladno	s k l â d n o
sklon	s k l ô n
skloniti	s k l ǒ n i t i
sklonište	s k l ô n iː ʃ t e
sklonost	s k l ô n oː s t
sklopiti	s k l ǒ p i t i
skok	s k ô k
skolastika	s k o l ǎ s t i k a
skoplje	s k ô p ʎ e
skoro	s k ǒ r o
skočiti	s k ǒ t͡ʃ i t i
skraćenica	s k r âː t͡ɕ e n i t͡s a
skrenuti	s k r ěː n u t i
skresati	s k r ě s a t i
skrivati	s k r ǐː ʋ a t i
skrob	s k r ô b
skroman	s k r ô m a n
skromno	s k r ô m n o
skromnost	s k r ô m n oː s t
skrovište	s k r ô ʋ iː ʃ t e
skroz	s k r ôː z
skrupula	s k r û p u l a
skulptura	s k u l p t ǔː r a
skupa	s k û p a
skupina	s k û p i n a
skupiti	s k û p i t i
skupljati	s k ǔː p ʎ a t i
skupno	s k û p n o
skupština	s k û p ʃ t i n a
skuter	s k û t e r
slabašan	s l â b aː ʃ a n
slabokrvnost	s l a b o k řː ʋ n oː s t
slabost	s l â b oː s t
slad	s l âː d
sladak	s l â d a k
sladić	s l ǎ d i t͡ɕ
sladoled	s l â d o l eː d
slador	s l âː d o r
slaganje	s l ǎː ɡ aː ɲ e
slama	s l â m a
slamati	s l ǎː m a t i
slamka	s l âː m k a
slamnjača	s l ǎ m ɲ a t͡ʃ a
slana	s l ǎː n a
slanina	s l ǎ n i n a
slanost	s l ǎː n oː s t
slap	s l âː p
slast	s l âː s t
slastica	s l ǎ s t i t͡s a
slati	s l â t i
slatko	s l ǎ t k oː
slava	s l â ʋ a
slavan	s l âː ʋ a n
slavina	s l ǎ ʋ i n a
slaviti	s l â ʋ i t i
slavonija	s l ǎ ʋ oː n i j a
slavonski	s l ǎ ʋ oː n s k iː
sledeći	s l ě d eː t͡ɕ iː
slep	s l êː p
slijediti	s l j ěː d i t i
slikar	s l î k aː r
slikati	s l î k a t i
slina	s l î n a
sliv	s l îː ʋ
sličan	s l î t͡ʃ a n
sličiti	s l ǐ t͡ʃ i t i
slično	s l ǐ t͡ʃ n o
slišati	s l î ʃ a t i
sljedbenik	s ʎ ê d b e n iː k
sljedeći	s ʎ ě d eː t͡ɕ iː
sljeme	s ʎ ê m e
sloga	s l ô ɡ a
slogan	s l ǒ ɡ aː n
slomiti	s l ǒ m i t i
slon	s l ô n
slonovača	s l ǒ n o ʋ a t͡ʃ a
slovakinja	s l o ʋ ǎ k i ɲ a
slovačka	s l ǒ ʋ aː t͡ʃ k aː
slovački	s l ǒ ʋ aː t͡ʃ k iː
slovenac	s l o ʋ ěː n a t͡s
slovenački	s l ǒ ʋ e n a t͡ʃ k iː
slovenija	s l ǒ ʋ eː n i j a
slovenka	s l ǒ ʋ eː n k a
slovo	s l ô ʋ o
složen	s l ô ʒ e n
složiti	s l ǒ ʒ i t i
sluh	s l ûː x
sluti	s l û t i
slutiti	s l ǔː t i t i
slučaj	s l û t͡ʃ aː j
slušalica	s l û ʃ a l i t͡s a
slušati	s l û ʃ a t i
sluškinja	s l û ʃ k i ɲ a
služba	s l ǔ ʒ b a
službenik	s l û ʒ b e n iː k
smaknuće	s m a k n ǔː t͡ɕ e
smanjiti	s m ǎː ɲ i t i
smanjivati	s m a ɲ ǐː ʋ a t i
smejati	s m ě j a t i
smena	s m ê n a
smeo	s m ě o
smesta	s m ê s t a
smetati	s m ěː t a t i
smeće	s m ě t͡ɕ e
smeštaj	s m ê ʃ t aː j
smijeniti	s m j ěː n i t i
smiješak	s m j ěː ʃ a k
smiješan	s m j ěː ʃ a n
smiješno	s m j ěː ʃ n o
smilovati	s m î l o ʋ a t i
smio	s m ǐ o
smiren	s m îː r e n
smireno	s m îː r e n o
smiriti	s m ǐː r i t i
smirivati	s m i r ǐː ʋ a t i
smisao	s m îː s a o
smisliti	s m î s l i t i
smjena	s m j ê n a
smjesa	s m j ê s a
smjesta	s m j ê s t a
smjeti	s m j ê t i
smještaj	s m j ê ʃ t aː j
smještajni	s m j ê ʃ t aː j n iː
smoking	s m ǒ k i n ɡ
smokva	s m ô k ʋ a
smotati	s m ǒ t a t i
smoći	s m ô t͡ɕ i
smrad	s m r âː d
smrditi	s m ř d i t i
smrdjeti	s m ř d j e t i
smrtnost	s m r̂ t n oː s t
smrtonosan	s m r t ǒ n o s a n
smrtonosno	s m r t ǒ n o s n o
smrznuti	s m r̂ z n u t i
smuda	s m u d a
snaga	s n ǎː ɡ a
snaha	s n ǎ x a
snalaziti	s n ǎ l a z i t i
snalažljivost	s n a l ǎ ʒ ʎ i ʋ oː s t
snaći	s n âː t͡ɕ i
snažan	s n ǎː ʒ a n
snažno	s n âː ʒ n o
snežan	s n ê ʒ a n
snimak	s n î m a k
snimati	s n ǐː m a t i
snimiti	s n ǐː m i t i
snimka	s n îː m k a
snivati	s n ǐː ʋ a t i
sniziti	s n ǐː z i t i
sniženje	s n i ʒ ěː ɲ e
snop	s n ô p
sobica	s ô b i t͡s a
socijalizam	s o t͡s i j a l ǐ z a m
socijalno	s ô t͡s i j aː l n o
sociolog	s o t͡s i ǒ l o ɡ
sociologija	s o t͡s i o l ǒ ɡ i j a
sofija	s ǒ f i j a
softver	s ô f t ʋ eː r
soj	s ô j
sokol	s ô k o l
solidan	s ô l iː d a n
solidarno	s ô l i d aː r n o
solidarnost	s o l i d ǎː r n oː s t
soliti	s ǒ l i t i
solsticij	s ǒ l s t iː t͡s iː j
solun	s ǒ l uː n
som	s ô m
somun	s ǒ m uː n
sopran	s ǒ p r aː n
sopranistica	s o p r a n ǐ s t i t͡s a
sos	s ôː s
sotona	s o t ǒ n a
sovjetski	s ǒ ʋ j e t s k iː
spada	s p âː d a
spajati	s p ǎː j a t i
spaliti	s p ǎː l i t i
spaljivati	s p a ʎ ǐː ʋ a t i
sparta	s p âː r t a
spas	s p âː s
spasiti	s p ǎː s i t i
spavaonica	s p a ʋ a ǒː n i t͡s a
spavati	s p ǎː ʋ a t i
spašavati	s p a ʃ ǎː ʋ a t i
specificirati	s p e t͡s i f i t͡s ǐː r a t i
specifikacija	s p e t͡s i f i k ǎː t͡s i j a
specifičan	s p e t͡s ǐ f i t͡ʃ a n
specifično	s p e t͡s ǐ f i t͡ʃ n o
specijalan	s p ê t͡s i j aː l a n
specijalitet	s p e t͡s i j a l ǐ t eː t
specijalizacija	s p e t͡s i j a l i z ǎː t͡s i j a
specijalna	s p ê t͡s i j aː l n a
specijalno	s p ê t͡s i j aː l n o
spektakl	s p e k t ǎ k l
spektakularan	s p ê k t a k u l aː r a n
spektakularno	s p ê k t a k u l aː r n o
spekulativan	s p ê k u l a t iː ʋ a n
speleolog	s p e l e ǒ l o ɡ
spev	s p êː ʋ
spilja	s p î ʎ a
spirala	s p i r ǎː l a
spis	s p î s
spisatelj	s p ǐ s a t e ʎ
spiza	s p îː z a
splavar	s p l ǎ ʋ aː r
split	s p l î t
splitski	s p l î t s k iː
spljošten	s p ʎ ô ʃ t e n
spoj	s p ôː j
spokoj	s p ǒ k o j
spol	s p ôː l
spolja	s p ô ʎ a
spomenar	s p o m ě n aː r
spomenuti	s p o m ěː n u t i
spominjati	s p ǒ m i ɲ a t i
spontano	s p ô n t aː n o
sponzor	s p ô n z o r
spor	s p ô r
sporadično	s p o r ǎ d i t͡ʃ n o
sporan	s p ôː r a n
sporazum	s p ô r a z uː m
sporazumijevati	s p o r a z u m j ěː ʋ a t i
sporno	s p ôː r n o
sport	s p ô r t
sportaš	s p ǒ r t aː ʃ
sposobnost	s p o s ǒː b n oː s t
spoznati	s p ǒ z n a t i
spoznavati	s p o z n ǎː ʋ a t i
sprat	s p r â t
sprava	s p r â ʋ a
sprdati	s p řː d a t i
spremiti	s p r ěː m i t i
spremno	s p r ê m n o
spretan	s p r ê t a n
sprečiti	s p r ěː t͡ʃ i t i
sprijateljiti	s p r i j a t ě ʎ i t i
sprijeda	s p r j ěː d a
spriječiti	s p r i j ěː t͡ʃ i t i
sprovesti	s p r ǒ ʋ e s t i
spustiti	s p ǔ s t i t i
spuštati	s p ǔː ʃ t a t i
sram	s r âː m
sramiti	s r ǎː m i t i
sramota	s r a m ǒ t a
sramotno	s r â m o t n o
sranje	s r ǎː ɲ e
srati	s r â t i
sraz	s r âː z
srbijanac	s r b i j ǎː n a t͡s
srbijanski	s r b ǐ j aː n s k iː
srditi	s řː d i t i
srebrenica	s r ê b r e n i t͡s a
sredina	s r e d ǐ n a
sredinom	s r e d ǐ n oː m
srediti	s r ěː d i t i
središnji	s r ě d i ʃ ɲ iː
središte	s r ê d iː ʃ t e
srednji	s r ê d ɲ iː
srednjovjekovni	s r e d ɲ o ʋ j ě k oː ʋ n iː
srednjoškolac	s r e d ɲ o ʃ k ǒː l a t͡s
sredstvo	s r ě d s t ʋ o
sretan	s r ê t a n
sretati	s r ê t a t i
sreća	s r ê t͡ɕ a
srećan	s r ê t͡ɕ a n
srećom	s r ê t͡ɕ oː m
srkati	s řː k a t i
srljati	s ř ʎ a t i
srpanj	s r̂ː p a ɲ
srušiti	s r û ʃ i t i
srž	s r̂ː ʒ
stabilan	s t â b iː l a n
stabilizacija	s t a b i l i z ǎː t͡s i j a
stabilno	s t â b iː l n o
stabilnost	s t a b ǐː l n oː s t
stabljika	s t ǎ b ʎ i k a
stablo	s t ǎː b l o
staklenik	s t a k l ě n iː k
staklo	s t ǎ k l o
stalan	s t ǎː l a n
stalno	s t âː l n o
stambeni	s t ǎ m b e n iː
stampedo	s t a m p êː d o
stan	s t âː n
stanarka	s t ǎ n aː r k a
standard	s t ǎ n d a r d
stanica	s t ǎ n i t͡s a
stanište	s t â n iː ʃ t e
stanje	s t ǎː ɲ e
stanka	s t âː n k a
stanovati	s t a n ǒ ʋ a t i
stanovništvo	s t a n o ʋ n ǐː ʃ t ʋ o
star	s t â r
starački	s t â r a t͡ʃ k iː
starenje	s t â r eː ɲ e
starinski	s t a r ǐ n s k iː
stariti	s t â r i t i
starost	s t â r oː s t
statika	s t ǎ t i k a
statistika	s t a t ǐ s t i k a
status	s t ǎː t u s
statusni	s t ǎː t u s n iː
statut	s t ǎ t uː t
stavak	s t â ʋ a k
staviti	s t â ʋ i t i
stavka	s t âː ʋ k a
stavljati	s t ǎː ʋ ʎ a t i
staž	s t âː ʒ
stepa	s t ê p a
stepen	s t ê p eː n
stevan	s t ê ʋ aː n
steći	s t êː t͡ɕ i
stečajni	s t ê t͡ʃ aː j n iː
sticati	s t i t͡s a t i
stidljivo	s t ǐ d ʎ i ʋ o
stih	s t î x
stil	s t î l
stilski	s t î l s k iː
stipendija	s t i p ě n d i j a
stiskati	s t ǐː s k a t i
stisnuti	s t î s n u t i
stizati	s t î z a t i
stići	s t î t͡ɕ i
stišati	s t ǐ ʃ a t i
sto	s t ôː
stoga	s t ô ɡ aː
stopa	s t ǒ p a
stotinjak	s t o t ǐː ɲ aː k
stradati	s t r ǎː d a t i
strah	s t r âː x
strahota	s t r a x ǒ t a
strahovati	s t r a x ǒ ʋ a t i
strahovit	s t r a x ǒ ʋ i t
stran	s t r âː n
strana	s t r ǎː n a
stranac	s t r ǎː n a t͡s
stranka	s t r â n k a
strast	s t r âː s t
strategija	s t r ǎ t eː ɡ i j a
strateški	s t r ǎ t eː ʃ k iː
stratopauza	s t r a t o p â u z a
strašan	s t r ǎː ʃ a n
strašno	s t r ǎː ʃ n o
straža	s t r âː ʒ a
strip	s t r î p
striptiz	s t r ǐ p t iː z
strogo	s t r ô ɡ o
stroj	s t r ôː j
strpljenje	s t r p ʎ ěː ɲ e
struk	s t r ûː k
struka	s t r û k a
struktura	s t r u k t ǔː r a
stručan	s t r û t͡ʃ a n
stručnjak	s t r û t͡ʃ ɲ aː k
stručno	s t r û t͡ʃ n o
stub	s t ûː b
studeni	s t ǔ d e n iː
student	s t ǔ d e n t
studij	s t ûː d iː j
studirati	s t u d ǐː r a t i
stup	s t ûː p
stupa	s t û p a
stupac	s t ǔː p a t͡s
stupiti	s t ǔː p i t i
stvarno	s t ʋ âː r n o
stvorenje	s t ʋ o r ěː ɲ e
stvoriti	s t ʋ ǒ r i t i
subota	s ǔ b o t a
subotnji	s ǔ b o t ɲ iː
sudac	s ǔː d a t͡s
sudanac	s u d ǎː n a t͡s
sudar	s û d aː r
sudbina	s û d b i n a
sudbonosno	s u d b ǒ n o s n o
sudionica	s u d i ǒ n i t͡s a
sudionik	s u d i ǒ n iː k
suditi	s ǔː d i t i
sudjelovati	s ǔ d j e l o ʋ a t i
sudstvo	s ǔ d s t ʋ o
sugestivan	s û ɡ e s t iː ʋ a n
suglasnik	s ǔ ɡ l a s n iː k
sugrađanka	s ǔ ɡ r a d͡ʑ aː n k a
suh	s ûː x
suhoća	s u x ǒ t͡ɕ a
suicid	s u ǐ t͡s iː d
suigrač	s u ǐ ɡ r aː t͡ʃ
sujetan	s ǔ j e t a n
sujeverje	s û j e ʋ eː r j e
sujevjerje	s û j e ʋ j eː r j e
sukladno	s ǔ k l a d n o
sukob	s ǔː k o b
sukobiti	s u k ǒ b i t i
sukobljavati	s u k o b ʎ ǎː ʋ a t i
suma	s û m a
sumanut	s ǔ m aː n uː t
sumnja	s ǔː m ɲ a
sumnjati	s ǔː m ɲ a t i
sumnjiv	s ǔ m ɲ i ʋ
sumnjičavost	s ǔ m ɲ i t͡ʃ a ʋ oː s t
sumorno	s û m oː r n o
sumpor	s ûː m p o r
sunce	s ûː n t͡s e
sunčanik	s u n t͡ʃ ǎ n iː k
suparnik	s ǔ p aː r n iː k
superiorno	s û p e r i oː r n o
supervizor	s û p e r ʋ iː z o r
suprotan	s ǔ p r o t a n
suprug	s û p r u ɡ
supstanca	s u p s t ǎ n t͡s a
supstrat	s ǔ p s t r aː t
suptilan	s û p t iː l a n
suptilno	s û p t iː l n o
surogat	s û r o ɡ aː t
surov	s ǔ r o ʋ
surovo	s ǔ r o ʋ o
susjed	s ǔː s j e d
suspenzija	s u s p ě n z i j a
susresti	s ǔ s r e s t i
susret	s ǔ s r e t
sustav	s ǔː s t a ʋ
sustavno	s ǔː s t aː ʋ n o
sustignuti	s ǔ s t i ɡ n u t i
sutkinja	s û t k i ɲ a
suton	s ǔː t o n
sutra	s û t r a
sutrašnji	s ǔ t r a ʃ ɲ iː
suv	s ûː ʋ
suvenir	s u ʋ ě n iː r
suverenitet	s u ʋ e r e n ǐ t eː t
suvereno	s ǔ ʋ e r e n o
suvisao	s ǔ ʋ i s a o
suvislo	s ǔ ʋ i s l o
suvišan	s û ʋ iː ʃ a n
suviše	s û ʋ i ʃ eː
suvišno	s û ʋ iː ʃ n o
suvlasnik	s ǔ ʋ l aː s n iː k
suvozač	s û ʋ o z aː t͡ʃ
suvremen	s ǔ ʋ r e m e n
suzavac	s û z a ʋ a t͡s
suzbiti	s ǔ z b i t i
sućut	s û t͡ɕ uː t
suđenje	s ǔː d͡ʑ eː ɲ e
suša	s ûː ʃ a
suši	s û ʃ i
sušica	s ǔ ʃ i t͡s a
sušiti	s ǔː ʃ i t i
suština	s u ʃ t ǐ n a
sužanjstvo	s ûː ʒ a ɲ s t ʋ o
sužen	s ûː ʒ e n
suživot	s û ʒ i ʋ o t
svadba	s ʋ ǎ d b a
svagdje	s ʋ â ɡ d j e
svakakav	s ʋ â k a k a ʋ
svakako	s ʋ â k aː k o
svaki	s ʋ â k iː
svakidašnji	s ʋ â k i d a ʃ ɲ iː
svakidašnjica	s ʋ â k i d a ʃ ɲ i t͡s a
svako	s ʋ â k o
svakodnevica	s ʋ â k o d n eː ʋ i t͡s a
svatko	s ʋ â t k o
svađa	s ʋ â d͡ʑ a
svađati	s ʋ â d͡ʑ a t i
sve	s ʋ ê
svejedno	s ʋ e j ě d n o
svemir	s ʋ ê m iː r
svemirski	s ʋ ê m iː r s k iː
svemoćan	s ʋ ê m o t͡ɕ a n
svesti	s ʋ ê s t i
svet	s ʋ êː t
svetac	s ʋ ěː t a t͡s
svetinja	s ʋ ěː t i ɲ a
svetkovina	s ʋ ě t k o ʋ i n a
svetlo	s ʋ ê t l o
sveukupan	s ʋ e ǔ k u p a n
svečan	s ʋ ě t͡ʃ a n
svečano	s ʋ ě t͡ʃ a n o
svečanost	s ʋ ě t͡ʃ a n oː s t
svežina	s ʋ e ʒ ǐ n a
svidjeti	s ʋ î d j e t i
svijest	s ʋ i j êː s t
svijet	s ʋ j êː t
svijetao	s ʋ j ěː t a o
svijeća	s ʋ i j ěː t͡ɕ a
svinja	s ʋ ǐː ɲ a
svinjarija	s ʋ i ɲ ǎ r i j a
svirepo	s ʋ ǐ r e p o
svirka	s ʋ îː r k a
svjedočanstvo	s ʋ j e d o t͡ʃ ǎː n s t ʋ o
svjedočiti	s ʋ j e d ǒ t͡ʃ i t i
svjesno	s ʋ j ê s n o
svjestan	s ʋ j ê s t a n
svjetionik	s ʋ j e t i ǒ n iː k
svjetlo	s ʋ j ê t l o
svjetlucav	s ʋ j e t l ǔ t͡s a ʋ
svjež	s ʋ j ê ʒ
svježe	s ʋ j ê ʒ e
svladati	s ʋ l ǎː d a t i
svlačionica	s ʋ l a t͡ʃ i ǒː n i t͡s a
svodnik	s ʋ ô d n iː k
svojedobno	s ʋ ô j e d o b n o
svojevoljno	s ʋ ô j e ʋ oː ʎ n o
svojstven	s ʋ ǒ j s t ʋ e n
svojstvo	s ʋ ǒː j s t ʋ o
svota	s ʋ ô t a
svrab	s ʋ r âː b
svrbež	s ʋ řː b e ʒ
svrha	s ʋ ř x a
svrsishodno	s ʋ r̂ s i s x o d n o
svrstati	s ʋ ř s t a t i
svrstavati	s ʋ r s t ǎː ʋ a t i
svršiti	s ʋ řː ʃ i t i
svuda	s ʋ ǔ d a
svugde	s ʋ û ɡ d e
svugdje	s ʋ û ɡ d j e
svući	s ʋ ûː t͡ɕ i
tabela	t a b ě l a
tableta	t a b l ě t a
tablica	t ǎ b l i t͡s a
tad	t â d
tada	t ǎ d aː
tadanji	t ǎ d a ɲ iː
tadašnji	t ǎ d a ʃ ɲ iː
taj	t âː j
tajanstveno	t a j ǎ n s t ʋ e n o
tajfun	t ǎ j f uː n
tajga	t âː j ɡ a
tajiti	t ǎː j i t i
tajkun	t ǎ j k uː n
tajland	t â j l a n d
tajna	t âː j n a
tajni	t âː j n iː
tajnica	t âː j n i t͡s a
tajnik	t âː j n iː k
tajno	t âː j n o
tajnost	t ǎː j n oː s t
tajnovito	t a j n ǒ ʋ i t o
tajvanski	t â j ʋ aː n s k iː
takav	t ǎ k aː ʋ
takmičiti	t ǎ k m i t͡ʃ i t i
tako	t ǎ k oː
takozvani	t a k ǒ z ʋ aː n iː
takođe	t a k ǒː d͡ʑ e
također	t a k ǒː d͡ʑ e r
taksi	t ǎ k s i
taktika	t ǎ k t i k a
talac	t ǎː l a t͡s
talas	t â l aː s
talenat	t ǎ l e n a t
talent	t ǎ l e n t
talentiran	t a l ě n t iː r a n
talijan	t a l ǐ j aː n
talijanka	t a l ǐ j aː n k a
tama	t ǎː m a
tamno	t âː m n o
tamo	t â m o
tamošnji	t â m o ʃ ɲ iː
tanak	t â n a k
tanker	t ǎ n k e r
tapeta	t a p ěː t a
taraba	t ǎ r a b a
tarifa	t a r ǐː f a
tarifni	t ǎ r iː f n iː
tastatura	t a s t a t ǔː r a
tata	t â t a
tatarski	t â t a r s k iː
tačan	t â t͡ʃ a n
tačka	t â t͡ʃ k a
tačno	t â t͡ʃ n o
tašt	t â ʃ t
taština	t a ʃ t ǐ n a
tebe	t ê b e
tebi	t ê b i
tegliti	t ê ɡ l i t i
tegoba	t e ɡ ǒ b a
teheran	t ê x e r aː n
tehnika	t ě x n i k a
tehničar	t ě x n i t͡ʃ aː r
tehnologija	t e x n o l ǒ ɡ i j a
teist	t ě i s t
teka	t ěː k a
teksas	t ê k s a s
tekstil	t ě k s t iː l
tekstopisac	t e k s t o p ǐː s a t͡s
tekstura	t e k s t ǔː r a
tekući	t ě k uː t͡ɕ iː
tel	t ê l
tele	t ě l e
telefonija	t e l e f ǒ n i j a
telegraf	t e l ě ɡ r a f
telegram	t ê l e ɡ r a m
telekomunikacija	t e l e k o m u n i k ǎː t͡s i j a
telekomunikacijski	t e l e k o m u n i k ǎː t͡s iː j s k iː
televizija	t e l e ʋ ǐː z i j a
televizor	t e l ě ʋ iː z o r
telovežba	t ě l o ʋ e ʒ b a
tema	t ěː m a
teme	t ê m e
temelj	t ě m e ʎ
temeljac	t e m ěː ʎ a t͡s
temeljit	t e m ě ʎ i t
temeljiti	t e m ě ʎ i t i
temeljito	t e m ě ʎ i t o
temeljni	t ê m eː ʎ n iː
temperatura	t e m p e r a t ǔː r a
templar	t ě m p l aː r
templarski	t ě m p l aː r s k iː
ten	t ê n
tendencija	t e n d ě n t͡s i j a
tendenciozan	t ê n d e n t͡s i oː z a n
tenisač	t e n ǐ s aː t͡ʃ
teniski	t ěː n i s k iː
tenk	t ê n k
tenkovski	t ě n k o ʋ s k iː
tenzija	t ě n z i j a
teologija	t e o l ǒ ɡ i j a
teološki	t e ǒ l o ʃ k iː
teoretičar	t e o r ě t i t͡ʃ aː r
teorija	t e ǒː r i j a
tepih	t ě p i x
terapija	t e r ǎ p i j a
tere	t e r e
teret	t ě r e t
teritorij	t e r ǐ t oː r iː j
teritorijalni	t ê r i t o r i j aː l n iː
terminologija	t e r m i n o l ǒ ɡ i j a
teror	t ě r oː r
terorizam	t e r o r ǐ z a m
test	t ê s t
testirati	t e s t ǐː r a t i
testis	t ê s t i s
tetiva	t ě t i ʋ a
tetka	t ê t k a
tezga	t ě z ɡ a
teći	t ê t͡ɕ i
teško	t êː ʃ k o
težiti	t ěː ʒ i t i
težište	t ê ʒ iː ʃ t e
tibetanski	t i b ě t aː n s k iː
tih	t î x
tiho	t î x o
tikva	t î k ʋ a
tinejdžer	t ǐ n e j d͡ʒ e r
tip	t îː p
tipičan	t ǐ p i t͡ʃ a n
tipično	t ǐ p i t͡ʃ n o
tipičnost	t ǐ p i t͡ʃ n oː s t
tipka	t î p k a
tipkati	t î p k a t i
tirana	t i r ǎ n a
tiranosaur	t i r a n o s ǎ u r
tiskara	t ǐ s k a r a
tiskati	t î s k a t i
tisućljeće	t ǐ s u t͡ɕ ʎ e t͡ɕ e
tisuću	t ǐ s u t͡ɕ u
titula	t î t u l a
tjedni	t j ê d n iː
tjedno	t j ê d n o
tjelesni	t j ê l e s n iː
tjelohranitelj	t j e l o x r ǎ n i t e ʎ
tjelovježba	t j ě l o ʋ j e ʒ b a
tjeme	t j ê m e
tjestenina	t j e s t e n ǐ n a
tko	t k ô
tlak	t l âː k
tlo	t l ô
tmuran	t m ǔː r a n
tobdžija	t ǒ b d͡ʒ i j a
tobom	t ô b oː m
tobože	t ǒ b o ʒ e
toga	t ǒː ɡ a
tok	t ôː k
tokijski	t ǒ k iː j s k iː
tokom	t ôː k o m
toksin	t ǒ k s iː n
tolerancija	t o l e r ǎ n t͡s i j a
ton	t ôː n
tona	t ô n a
tonuti	t ǒ n u t i
topao	t ô p a o
toplana	t o p l ǎ n a
toplice	t ǒ p l i t͡s e
toplina	t o p l ǐ n a
topljiv	t ǒ p ʎ i ʋ
toplo	t ô p l o
toplomjer	t ô p l o m j eː r
toplota	t o p l ǒ t a
topništvo	t ô p n i ʃ t ʋ o
topčić	t ǒ p t͡ʃ i t͡ɕ
toranj	t ǒː r a ɲ
torba	t ǒː r b a
tornjati	t ǒ r ɲ a t i
torta	t ôː r t a
tortura	t o r t ǔː r a
totalitarizam	t o t a l i t a r ǐ z a m
totalno	t ô t aː l n o
točak	t ǒ t͡ʃ a k
točan	t ô t͡ʃ a n
točiti	t ǒ t͡ʃ i t i
točka	t ô t͡ʃ k a
točno	t ô t͡ʃ n o
tradicija	t r ǎ d iː t͡s i j a
tradicionalan	t r â d i t͡s i o n aː l a n
tradicionalno	t r â d i t͡s i o n aː l n o
trag	t r âː ɡ
tragati	t r ǎ ɡ a t i
tragedija	t r ǎ ɡ eː d i j a
tragičan	t r ǎ ɡ i t͡ʃ a n
tragičar	t r ǎ ɡ i t͡ʃ aː r
tragično	t r ǎ ɡ i t͡ʃ n o
trahtur	t r ǎ x t uː r
trajati	t r â j a t i
trajekt	t r ǎ j e k t
trajnost	t r ǎː j n oː s t
traktat	t r ǎ k t aː t
traljav	t r â ʎ a ʋ
traljavo	t r â ʎ a ʋ o
transakcijski	t r a n s ǎ k t͡s iː j s k iː
transcendencija	t r a n s t͡s e n d ě n t͡s i j a
transformacija	t r a n s f o r m ǎː t͡s i j a
transformacijski	t r a n s f o r m ǎː t͡s iː j s k iː
transformator	t r a n s f ǒ r m aː t o r
transformirati	t r a n s f o r m ǐː r a t i
transparentan	t r a n s p ǎ r e n t a n
transparentno	t r a n s p ǎ r e n t n o
transparentnost	t r a n s p ǎ r e n t n oː s t
transporter	t r a n s p ǒ r t eː r
transportni	t r ǎ n s p o r t n iː
transverzala	t r a n s ʋ e r z ǎː l a
tranzicija	t r ǎ n z iː t͡s i j a
tranzit	t r ǎ n z iː t
tranzitni	t r ǎ n z iː t n iː
tranša	t r âː n ʃ a
trapavo	t r â p a ʋ o
traperice	t r â p e r i t͡s e
trasa	t r â s a
tratinčica	t r ǎ t iː n t͡ʃ i t͡s a
trauma	t r ǎ u m a
traumatičan	t r a u m ǎ t i t͡ʃ a n
travanj	t r âː ʋ a ɲ
travar	t r ǎ ʋ aː r
travestija	t r a ʋ ě s t i j a
travnjak	t r âː ʋ ɲ aː k
trač	t r â t͡ʃ
tračnica	t r â t͡ʃ n i t͡s a
tražilo	t r ǎ ʒ i l o
tražiti	t r ǎː ʒ i t i
trbušni	t ř b u ʃ n iː
treba	t r ěː b a
trebati	t r ê b a t i
tref	t r ê f
trem	t r êː m
trend	t r ê n d
trener	t r ěː n e r
trenerski	t r ěː n e r s k iː
trening	t r ěː n i n ɡ
trenirati	t r e n ǐː r a t i
trenje	t r ěː ɲ e
trenutak	t r e n ǔː t a k
trenutan	t r ê n uː t a n
trenutačno	t r ê n u t aː t͡ʃ n o
trenutno	t r ê n uː t n o
trepavica	t r ê p a ʋ i t͡s a
treptaj	t r ê p t aː j
tresti	t r êː s t i
tretirati	t r e t ǐː r a t i
tretman	t r ě t m aː n
trezor	t r ě z oː r
trezvenjak	t r e z ʋ ě ɲ aː k
trezveno	t r ê z ʋ e n o
treći	t r ê t͡ɕ iː
treš	t r ê ʃ
trgati	t r̂ ɡ a t i
trgnuti	t r̂ ɡ n u t i
trgovati	t r ɡ ǒ ʋ a t i
trgovina	t r ɡ ǒ ʋ i n a
trgovkinja	t ř ɡ oː ʋ k i ɲ a
tri	t r îː
tribun	t r ǐ b uː n
trica	t r î t s a
trijem	t r i j êː m
trik	t r î k
trilogija	t r i l ǒ ɡ i j a
trn	t r̂ː n
trnovit	t r n ǒ ʋ i t
trodnevni	t r ǒ d n eː ʋ n iː
trofej	t r ǒ f eː j
troglav	t r ǒ ɡ l a ʋ
trogodišnjak	t r o ɡ ǒ d i ʃ ɲ aː k
troja	t r ǒː j a
trojica	t r ǒ j i t͡s a
trojka	t r ǒː j k a
trojstvo	t r ǒː j s t ʋ o
trolejbus	t r o l ěː j b u s
tromeđa	t r ǒ m e d͡ʑ a
tromjesečje	t r ǒ m j e s eː t͡ʃ j e
trotoar	t r o t ǒ aː r
trovač	t r ǒ ʋ aː t͡ʃ
trošak	t r ô ʃ a k
trpezarija	t r p e z ǎ r i j a
trpjeti	t řː p j e t i
trst	t r̂ s t
trti	t r̂ t i
trudan	t r ǔː d a n
truditi	t r ǔː d i t i
trudnoća	t r u d n ǒ t͡ɕ a
truliti	t r û l i t i
trunak	t r ǔː n a k
trunka	t r ûː n k a
trupa	t r û p a
trzaj	t r̂ z aː j
tržišni	t r̂ ʒ iː ʃ n iː
tuberkuloza	t u b e r k u l ǒː z a
tuda	t ǔ d aː
tuga	t ǔː ɡ a
tuka	t û k a
tumač	t ǔ m aː t͡ʃ
tumačiti	t u m ǎː t͡ʃ i t i
tumor	t ûː m o r
tunel	t ǔ n eː l
tunika	t ǔ n i k a
tunis	t ǔ n i s
tup	t ûː p
tupo	t ûː p o
tur	t ûː r
turbina	t u r b ǐː n a
turbulencija	t u r b u l ě n t͡s i j a
turci	t ûː r t͡s i
turizam	t u r ǐ z a m
turkinja	t û r k i ɲ a
turnir	t ǔ r n iː r
turobno	t û r oː b n o
turska	t ǔ r s k aː
turski	t ǔ r s k iː
turčin	t ǔ r t͡ʃ iː n
tući	t ûː t͡ɕ i
tuđman	t û d͡ʑ m a n
tužan	t ǔː ʒ a n
tužilac	t ǔ ʒ i l a t͡s
tužitelj	t ǔ ʒ i t e ʎ
tužiti	t ǔː ʒ i t i
tužno	t ûː ʒ n o
tvoj	t ʋ ôː j
tvorac	t ʋ ǒː r a t͡s
tvorevina	t ʋ ǒ r e ʋ i n a
tvornica	t ʋ ǒː r n i t͡s a
tvrd	t ʋ r̂ː d
tvrditi	t ʋ řː d i t i
tvrdnja	t ʋ řː d ɲ a
tvrdoća	t ʋ r d ǒ t͡ɕ a
ubaciti	u b ǎː t͡s i t i
ubadati	u b ǎː d a t i
ubijati	u b ǐː j a t i
ubiti	ǔ b i t i
ublažiti	u b l ǎː ʒ i t i
ubod	ǔː b o d
ubojica	ǔ b o j i t͡s a
ubosti	ǔ b o s t i
ubrati	ǔ b r a t i
ubrizgavati	u b r i z ɡ ǎː ʋ a t i
ubrzanje	u b r z ǎː ɲ e
ubrzati	u b ř z a t i
ubrzo	û b rː z o
ubuduće	u b ǔ d uː t͡ɕ e
ucenjivati	u t͡s e ɲ ǐː ʋ a t i
ucjena	û t͡s j e n a
ucjenjivati	u t͡s j e ɲ ǐː ʋ a t i
udahnuti	u d ǎ x n u t i
udaja	û d a j a
udaljen	ǔ d aː ʎ e n
udaljenost	ǔ d aː ʎ e n oː s t
udaljiti	u d ǎː ʎ i t i
udar	û d aː r
udarac	ǔ d a r a t͡s
udarati	ǔ d a r a t i
udariti	ǔ d a r i t i
udat	u d aː t
udati	ǔ d a t i
udavača	u d ǎ ʋ a t͡ʃ a
udeo	ǔː d e o
udio	ǔː d i o
udisati	ǔ d i s a t i
udova	ǔ d o ʋ a
udovica	u d ǒ ʋ i t͡s a
udruga	û d r u ɡ a
udruženje	u d r u ʒ ěː ɲ e
udružiti	u d r ǔː ʒ i t i
udruživati	u d r u ʒ ǐː ʋ a t i
udvostručiti	u d ʋ ǒ s t r u t͡ʃ i t i
udžbenik	û d͡ʒ b e n iː k
ugalj	û ɡ a ʎ
ugao	û ɡ a o
ugasiti	u ɡ ǎː s i t i
ugađati	u ɡ ǎː d͡ʑ a t i
uglavnom	u ɡ l ǎ ʋ n oː m
ugled	û ɡ l eː d
ugledan	û ɡ l eː d a n
ugledati	ǔ ɡ l e d a t i
ugljen	û ɡ ʎ eː n
ugljik	ǔ ɡ ʎ iː k
ugoditi	u ɡ ǒ d i t i
ugostiti	u ɡ ǒ s t i t i
ugovarati	u ɡ o ʋ ǎː r a t i
ugovor	û ɡ o ʋ oː r
ugovoriti	u ɡ o ʋ ǒ r i t i
ugođaj	û ɡ o d͡ʑ aː j
ugraditi	u ɡ r ǎː d i t i
ugrijati	ǔ ɡ r i j a t i
ugristi	ǔ ɡ r i s t i
ugroziti	u ɡ r ǒ z i t i
uhapsiti	ǔ x a p s i t i
uhititi	ǔ x i t i t i
uho	û x o
uistinu	ǔ i s t i n u
ujak	û j aː k
ujediniti	u j e d ǐː n i t i
ujedno	û j e d n o
ujutru	û j u t r u
ukazati	u k ǎː z a t i
ukazivati	u k a z ǐː ʋ a t i
uključenost	ǔ k ʎ uː t͡ʃ e n oː s t
uključiti	u k ʎ ǔː t͡ʃ i t i
uključivati	u k ʎ u t͡ʃ ǐː ʋ a t i
ukloniti	u k l ǒ n i t i
ukoliko	u k o l ǐ k oː
ukopati	u k ǒ p a t i
ukoriti	u k ǒ r i t i
ukraj	ǔ k r aː j
ukrajina	ǔ k r a j i n a
ukrajinski	ǔ k r a j iː n s k iː
ukras	û k r aː s
ukrasiti	u k r ǎː s i t i
ukratko	û k r a t k o
ukupan	ǔ k u p a n
ukupno	ǔ k u p n o
ukus	ǔ k u s
ukusan	ǔ k u s a n
ukusno	ǔ k u s n o
ulagati	u l ǎː ɡ a t i
ulaz	ǔ l a z
ulaznica	ǔ l a z n i t͡s a
ulcinj	ǔ l t͡s i ɲ
ulepšati	u l ě p ʃ a t i
uljepšati	u ʎ ě p ʃ a t i
ulog	ǔː l o ɡ
ulomak	ǔ l o m a k
uloviti	u l ǒ ʋ i t i
uložiti	u l ǒ ʒ i t i
ultimatum	u l t i m ǎː t u m
ultrazvuk	û l t r a z ʋ uː k
um	ûː m
umak	û m aː k
umerenost	ǔ m e r e n oː s t
umesto	ǔ m e s t o
umetnik	ǔ m e t n iː k
umiroviti	u m i r ǒ ʋ i t i
umirovljenik	u m i r o ʋ ʎ ě n iː k
umisliti	ǔ m i s l i t i
umivati	u m ǐː ʋ a t i
umišljen	ǔ m i ʃ ʎ e n
umjeren	ǔ m j e r e n
umjereno	ǔ m j e r e n o
umjesto	ǔ m j e s t o
umjeti	ǔ m j e t i
umjetnica	ǔ m j e t n i t͡s a
umjetnik	ǔ m j e t n iː k
umjetnički	ǔ m j e t n i t͡ʃ k iː
umoran	û m oː r a n
umoriti	u m ǒ r i t i
umorno	û m oː r n o
umreti	ǔ m r eː t i
umrijeti	ǔ m r j eː t i
unaprijed	ǔ n a p r j eː d
unatoč	u n ǎː t o t͡ʃ
unatrag	ǔ n a t r aː ɡ
uneti	ǔ n eː t i
unija	ûː n i j a
unijeti	ǔ n j eː t i
univerzum	u n i ʋ ě r z u m
uništiti	ǔ n i ʃ t i t i
unositi	u n ǒ s i t i
unovčiti	ǔ n oː ʋ t͡ʃ i t i
unuk	ǔ n u k
unutar	ǔ n u t a r
unutarnji	ǔ n u t aː r ɲ iː
unutrašnjost	ǔ n u t r a ʃ ɲ oː s t
uobičajen	u o b ǐ t͡ʃ aː j e n
uobičajeno	u o b ǐ t͡ʃ aː j e n o
uobraziti	u o b r ǎː z i t i
uokviriti	u o k ʋ ǐː r i t i
uopće	ǔ o p t͡ɕ e
uopšte	ǔ o p ʃ t e
uostalom	u ǒ s t aː l o m
uozbiljiti	u o z b ǐː ʎ i t i
uočljiv	u ǒ t͡ʃ ʎ i ʋ
uočljivo	u ǒ t͡ʃ ʎ i ʋ o
upad	ǔ p a d
upecati	ǔ p e t͡s a t i
upijati	u p ǐː j a t i
upisati	u p ǐː s a t i
upisivati	u p i s ǐː ʋ a t i
upit	ǔ p i t
upitati	u p ǐː t a t i
upiti	ǔ p i t i
upitnik	ǔ p i t n iː k
uplašiti	ǔ p l a ʃ i t i
uporan	û p oː r a n
uporište	ǔ p o r iː ʃ t e
uporno	û p oː r n o
upornost	u p ǒː r n oː s t
uposlenik	u p o s l ě n iː k
uposliti	u p ǒ s l i t i
upotreba	û p o t r e b a
upotrijebiti	u p o t r j ěː b i t i
upoznati	u p ǒ z n a t i
upoznavati	u p o z n ǎː ʋ a t i
upozoriti	u p o z ǒ r i t i
uprava	û p r a ʋ a
upravljanje	ǔ p r a ʋ ʎ aː ɲ e
upravljati	ǔ p r a ʋ ʎ a t i
upravni	û p r aː ʋ n iː
upravo	u p r a ʋ o
upriličiti	u p r ǐː l i t͡ʃ i t i
uprkos	û p r k o s
uprljati	u p řː ʎ a t i
uputa	û p u t a
uputiti	u p ǔː t i t i
upućivati	u p u t͡ɕ ǐː ʋ a t i
ura	û r a
uraditi	u r ǎː d i t i
uragan	û r a ɡ aː n
uran	ǔ r aː n
uračunati	u r a t͡ʃ ǔ n a t i
urban	û r b aː n
uredan	û r e d a n
urediti	u r ěː d i t i
uredno	û r e d n o
uređaj	û r e d͡ʑ aː j
urod	ǔː r o d
urota	ǔ r o t a
urugvaj	û r u ɡ ʋ a j
urugvajac	u r u ɡ ʋ ǎː j a t͡s
urugvajski	û r u ɡ ʋ aː j s k iː
uručiti	u r ǔː t͡ʃ i t i
usaditi	u s ǎː d i t i
usamljen	ǔ s aː m ʎ e n
usavršiti	u s a ʋ řː ʃ i t i
useljenik	u s ě ʎ e n iː k
ushićeno	ǔ s x iː t͡ɕ e n o
usisati	ǔ s i s a t i
uskoro	û s k o r o
uskratiti	u s k r ǎː t i t i
uskrs	ǔ s k r s
usled	û s l e d
uslov	ǔː s l o ʋ
usmeriti	ǔ s m e r i t i
usmjeravati	u s m j e r ǎː ʋ a t i
usmjeriti	ǔ s m j e r i t i
uspavanka	u s p ǎ ʋ aː n k a
uspeh	ǔ s p e x
uspešno	ǔ s p e ʃ n o
uspinjača	u s p ǐ ɲ a t͡ʃ a
uspjeh	ǔ s p j e x
uspjeti	ǔ s p j e t i
uspješan	ǔ s p j e ʃ a n
uspješno	ǔ s p j e ʃ n o
uspomena	û s p o m e n a
usporedba	û s p o r e d b a
uspostaviti	u s p ǒ s t a ʋ i t i
uspravan	û s p r aː ʋ a n
usprkos	û s p r k o s
usput	ǔ s p uː t
usred	ǔ s r e d
usredotočiti	u s r e d o t ǒ t͡ʃ i t i
usta	ǔː s t a
ustanak	ǔ s t a n a k
ustanova	û s t a n o ʋ a
ustati	ǔ s t a t i
ustav	û s t aː ʋ
ustavan	û s t aː ʋ a n
ustavno	ǔ s t aː ʋ n o
ustaša	û s t a ʃ a
usto	ǔ s t oː
ustrajan	û s t r aː j a n
ustroj	ǔː s t r o j
ustrojiti	u s t r ǒ j i t i
ustvrditi	u s t ʋ řː d i t i
usud	ǔ s u d
usvajati	u s ʋ ǎː j a t i
usvojiti	u s ʋ ǒ j i t i
utajivati	u t a j ǐː ʋ a t i
utakmica	ǔ t a k m i t͡s a
uteg	ǔː t e ɡ
utisak	ǔ t i s a k
utičnica	ǔ t i t͡ʃ n i t͡s a
utješiti	ǔ t j e ʃ i t i
utješno	ǔ t j e ʃ n o
utok	ǔː t o k
utonuti	u t ǒ n u t i
utopija	u t ǒ p i j a
utopiti	u t ǒ p i t i
utočište	ǔ t o t͡ʃ iː ʃ t e
utrka	û t r k a
utroba	û t r o b a
utrostručiti	u t r ǒ s t r u t͡ʃ i t i
utrošiti	u t r ǒ ʃ i t i
uturati	u t ǔː r a t i
utvrda	û t ʋ r d a
utvrditi	u t ʋ řː d i t i
uvaliti	u ʋ ǎː l i t i
uvažiti	u ʋ ǎː ʒ i t i
uvesti	ǔ ʋ e s t i
uvećati	u ʋ ě t͡ɕ a t i
uvid	ǔ ʋ i d
uvidjeti	ǔ ʋ i d j e t i
uvjeravati	u ʋ j e r ǎː ʋ a t i
uvjeren	ǔ ʋ j e r e n
uvjerenje	u ʋ j e r ěː ɲ e
uvjeriti	ǔ ʋ j e r i t i
uvjerljivost	u ʋ j ě r ʎ i ʋ oː s t
uvjet	ǔː ʋ j e t
uvod	ǔː ʋ o d
uvoditi	u ʋ ǒ d i t i
uvodni	ǔː ʋ o d n iː
uvoz	ǔː ʋ o z
uvreda	û ʋ r e d a
uvrijediti	u ʋ r j ěː d i t i
uvrijeđen	ǔ ʋ r i j eː d͡ʑ e n
uvrstiti	u ʋ řː s t i t i
uz	u z
uzajamno	û z a j aː m n o
uzalud	û z a l uː d
uzaludan	û z a l uː d a n
uzaludno	û z a l uː d n o
uzastopno	û z a s t o p n o
uzbrdo	û z b r d o
uzbuditi	u z b ǔː d i t i
uzbuna	û z b u n a
uzbuđen	ǔ z b uː d͡ʑ eː n
uzbuđenje	u z b u d͡ʑ ěː ɲ e
uzdržavanje	u z d r ʒ ǎː ʋ aː ɲ e
uzdržavati	u z d r ʒ ǎː ʋ a t i
uzdržljiv	u z d ř ʒ ʎ i ʋ
uzduž	û z d uː ʒ
uzet	û z eː t
uzeti	ǔ z eː t i
uzgajati	u z ɡ ǎː j a t i
uzgojiti	u z ɡ ǒ j i t i
uzgred	û z ɡ r eː d
uzica	û z i t͡s a
uzimati	ǔ z i m a t i
uzor	ǔː z o r
uzorak	ǔː z o r a k
uzrok	ǔ z r o k
uzrokovati	ǔː z r o k o ʋ a t i
uzvik	û z ʋ iː k
uzvikivati	u z ʋ i k ǐː ʋ a t i
uzvišeno	ǔ z ʋ iː ʃ e n o
uzvodno	ǔ z ʋ o d n o
uzvrat	û z ʋ r aː t
ući	ûː t͡ɕ i
učen	û t͡ʃ e n
učenica	û t͡ʃ e n i t͡s a
učenjak	u t͡ʃ ě ɲ aː k
učesnica	ǔ t͡ʃ e s n i t͡s a
učesnik	ǔ t͡ʃ e s n iː k
učestvovati	ǔ t͡ʃ e s t ʋ o ʋ a t i
učešće	ǔ t͡ʃ eː ʃ t͡ɕ e
učilište	ǔ t͡ʃ i l iː ʃ t e
učinak	ǔ t͡ʃ i n a k
učiniti	u t͡ʃ ǐ n i t i
učionica	u t͡ʃ i ǒː n i t͡s a
učitelj	ǔ t͡ʃ i t e ʎ
učiti	ǔ t͡ʃ i t i
učlaniti	u t͡ʃ l ǎː n i t i
ušica	ǔ ʃ i t͡s a
ušteda	û ʃ t e d a
uštedjeti	u ʃ t ěː d j e t i
ušće	ûː ʃ t͡ɕ e
užas	û ʒ aː s
užasan	û ʒ aː s a n
užasno	û ʒ aː s n o
užitak	u ʒ ǐː t a k
uživati	u ʒ ǐː ʋ a t i
vaditi	ʋ â d i t i
vaga	ʋ ǎː ɡ a
vagina	ʋ a ɡ ǐː n a
vagon	ʋ ǎ ɡ oː n
vakuf	ʋ â k u f
val	ʋ âː l
vala	ʋ ǎ l aː
valjak	ʋ ǎː ʎ a k
valjda	ʋ ǎ ʎ d a
vama	ʋ â m a
vampir	ʋ ǎ m p iː r
vandalizam	ʋ a n d a l ǐ z a m
vani	ʋ ǎ n i
vanjski	ʋ ǎ ɲ s k iː
vanzemaljac	ʋ a n z e m ǎː ʎ a t͡s
var	ʋ âː r
varga	ʋ âː r ɡ a
varka	ʋ âː r k a
varoš	v aː r o ʃ
vas	ʋ âː s
vatikan	ʋ â t i k aː n
vatra	ʋ â t r a
vatren	ʋ â t r e n
vatrogasac	ʋ a t r o ɡ ǎː s a t͡s
vatromet	ʋ â t r o m eː t
vaza	ʋ ǎː z a
važan	ʋ ǎː ʒ a n
važiti	ʋ ǎː ʒ i t i
važno	ʋ âː ʒ n o
važnost	ʋ ǎː ʒ n oː s t
vedrina	ʋ e d r ǐ n a
vedro	ʋ e d r̩ o
vegetacija	ʋ e ɡ e t ǎː t͡s i j a
vegetarijanac	ʋ e ɡ e t a r i j ǎː n a t͡s
vejati	ʋ ê j a t i
veleposlanica	ʋ e l e p ǒ s l a n i t͡s a
veleposlanik	ʋ e l e p o s l ǎ n iː k
veleposlanstvo	ʋ e l e p o s l ǎː n s t ʋ o
velik	ʋ ě l i k
velikaš	ʋ e l ǐ k aː ʃ
velikodušno	ʋ e l i k ǒ d u ʃ n o
velikodušnost	ʋ e l i k ǒ d u ʃ n oː s t
velim	ʋ ě l iː m
veljača	ʋ ě ʎ a t͡ʃ a
velški	ʋ ê l ʃ k iː
vena	ʋ ěː n a
venac	ʋ ěː n a t͡s
venera	ʋ ě n e r a
ventil	ʋ ě n t iː l
veo	ʋ ê o
veoma	ʋ ě o m a
vergl	ʋ ě r ɡ l
verižast	ʋ ě r i ʒ a s t
verojatno	ʋ ê r o j aː t n o
verovati	ʋ ê r o ʋ a t i
verovatno	ʋ ê r o ʋ aː t n o
versificirati	ʋ e r s i f i t͡s ǐː r a t i
verski	ʋ ě r s k iː
verzija	ʋ ě r z i j a
veselje	ʋ e s ěː ʎ e
veselo	ʋ ê s e l o
veslanje	ʋ ě s l aː ɲ e
veslač	ʋ ě s l aː t͡ʃ
veslačica	ʋ e s l ǎ t͡ʃ i t͡s a
vesna	ʋ ê s n a
vesta	ʋ ê s t a
vesti	ʋ êː s t i
vetar	ʋ ê t a r
veteran	ʋ e t ě r aː n
veterinar	ʋ e t e r ǐ n aː r
veterinarski	ʋ e t e r ǐ n aː r s k iː
veterinarstvo	ʋ e t e r i n ǎː r s t ʋ o
vetreuška	ʋ e t r ě u ʃ k a
vez	ʋ êː z
veza	ʋ ê z a
vezati	ʋ ěː z a t i
vezir	ʋ ě z iː r
već	ʋ ê t͡ɕ
veće	ʋ ěː t͡ɕ e
većina	ʋ e t͡ɕ ǐ n a
većinom	ʋ e t͡ɕ ǐ n oː m
veče	ʋ ê t͡ʃ eː
večer	ʋ ê t͡ʃ eː r
večera	ʋ ě t͡ʃ e r a
večeras	ʋ e t͡ʃ ě r a s
večerati	ʋ ě t͡ʃ e r a t i
večerašnji	ʋ e t͡ʃ ě r a ʃ ɲ iː
večernji	ʋ ě t͡ʃ eː r ɲ iː
veš	ʋ ê ʃ
vešati	ʋ ê ʃ a t i
veština	ʋ e ʃ t ǐ n a
vežba	ʋ ê ʒ b a
vid	ʋ îː d
videokaseta	ʋ i d e o k a s ě t a
videti	ʋ î d e t i
vidjelo	ʋ î d j e l o
vidjeti	ʋ î d j e t i
vidljiv	ʋ ǐ d ʎ i ʋ
vidljivo	ʋ ǐ d ʎ i ʋ o
vijenac	ʋ i j ěː n a t͡s
vijeće	ʋ i j ěː t͡ɕ e
vijuga	ʋ ǐ j u ɡ a
vika	ʋ î k a
vikati	ʋ ǐː k a t i
vikend	ʋ ǐ k e n d
viktorija	ʋ ǐ k t oː r i j a
vinograd	ʋ ǐ n o ɡ r aː d
violina	ʋ i o l ǐː n a
viski	ʋ î s k i
visok	ʋ ǐ s o k
visoko	ʋ i s ǒ k o
visoravan	ʋ î s o r aː ʋ a n
vitalno	ʋ î t aː l n o
vitraž	ʋ ǐ t r aː ʒ
vitrina	ʋ i t r ǐː n a
viza	ʋ ǐː z a
vizija	ʋ îː z i j a
viđati	ʋ ǐː d͡ʑ a t i
višak	ʋ ǐː ʃ a k
višnja	ʋ î ʃ ɲ a
vjenčanica	ʋ j e n t͡ʃ ǎ n i t͡s a
vjenčanje	ʋ j e n t͡ʃ ǎː ɲ e
vjeran	ʋ j ěː r a n
vjerenički	ʋ j ê r e n i t͡ʃ k iː
vjernik	ʋ j êː r n iː k
vjerno	ʋ j êː r n o
vjernost	ʋ j ěː r n oː s t
vjeroispovijest	ʋ j e r o ǐ s p o ʋ j eː s t
vjerojatno	ʋ j ê r o j aː t n o
vjerovati	ʋ j ê r o ʋ a t i
vjerski	ʋ j ě r s k iː
vjeverica	ʋ j ê ʋ e r i t͡s a
vječno	ʋ j ê t͡ʃ n o
vještak	ʋ j ě ʃ t aː k
vještica	ʋ j ě ʃ t i t͡s a
vještina	ʋ j e ʃ t ǐ n a
vježba	ʋ j ê ʒ b a
vježbati	ʋ j ê ʒ b a t i
vladajući	ʋ l ǎː d a j uː t͡ɕ iː
vladar	ʋ l ǎ d aː r
vladati	ʋ l ǎː d a t i
vlaga	ʋ l â ɡ a
vlah	ʋ l â x
vlak	ʋ l âː k
vlakno	ʋ l ǎː k n o
vlasnica	ʋ l âː s n i t͡s a
vlasnik	ʋ l âː s n iː k
vlasništvo	ʋ l âː s n iː ʃ t ʋ o
vlast	ʋ l âː s t
vlastela	ʋ l a s t ě l a
vlašić	ʋ l â ʃ i t͡ɕ
vlažnost	ʋ l â ʒ n oː s t
vod	ʋ ôː d
voda	ʋ ǒ d a
vodeći	ʋ ǒ d eː t͡ɕ iː
voditelj	ʋ ǒ d i t e ʎ
voditeljica	ʋ o d i t ě ʎ i t͡s a
voditi	ʋ ǒ d i t i
vodič	ʋ ǒ d iː t͡ʃ
vodomar	ʋ ô d o m aː r
vodomjer	ʋ ô d o m j eː r
vodopad	ʋ ô d o p aː d
vodoravan	ʋ ô d o r aː ʋ a n
vodoravno	ʋ ô d o r aː ʋ n o
vodovod	ʋ ô d o ʋ oː d
vojnik	ʋ ǒ j n iː k
vojska	ʋ ǒː j s k a
vojskovođa	ʋ ô j s k o ʋ o d͡ʑ a
vojvoda	ʋ ǒ j ʋ o d a
vojvodina	ʋ ǒ j ʋ o d i n a
vojvodstvo	ʋ ǒ j ʋ o d s t ʋ o
vojvotkinja	ʋ ǒ j ʋ o t k i ɲ a
volga	ʋ ôː l ɡ a
volja	ʋ ô ʎ a
voljan	ʋ ǒː ʎ a n
voljeti	ʋ ǒ ʎ e t i
voljno	ʋ ôː ʎ n o
vosak	ʋ ô s a k
voskar	ʋ ô s k aː r
voz	ʋ ôː z
vozač	ʋ ǒ z aː t͡ʃ
vozačica	ʋ o z ǎ t͡ʃ i t͡s a
vozilo	ʋ ǒ z i l o
voziti	ʋ ǒ z i t i
voće	ʋ ǒ t͡ɕ e
voćnjak	ʋ ô t͡ɕ ɲ aː k
vožnja	ʋ ǒ ʒ ɲ a
vrabac	ʋ r ǎː b a t͡s
vrag	ʋ r âː ɡ
vrana	ʋ r â n a
vrapčić	ʋ r ǎ p t͡ʃ i t͡ɕ
vrat	ʋ r âː t
vrata	ʋ r ǎː t a
vratar	ʋ r ǎ t aː r
vratiti	ʋ r ǎː t i t i
vratni	ʋ r âː t n iː
vratnica	ʋ r â t n i t͡s a
vraćati	ʋ r â t͡ɕ a t i
vračati	ʋ r ǎː t͡ʃ a t i
vrebati	ʋ r ěː b a t i
vrednost	ʋ r ěː d n oː s t
vrednovati	ʋ r ê d n o ʋ a t i
vrelište	ʋ r ê l iː ʃ t e
vrelo	ʋ r ê l o
vreme	ʋ r ěː m e
vrenje	ʋ r ěː ɲ e
vreteno	ʋ r e t ě n o
vreća	ʋ r ê t͡ɕ a
vrhnje	ʋ r̂ x ɲ e
vrhovni	ʋ ř x oː ʋ n iː
vrhunac	ʋ r x ǔː n a t͡s
vrijedan	ʋ r j ěː d a n
vrijediti	ʋ r i j ěː d i t i
vrijednost	ʋ r j ěː d n oː s t
vrijeme	ʋ r i j ěː m e
vrijeđati	ʋ r i j ěː d͡ʑ a t i
vrilo	ʋ r i l o
vrisak	ʋ r îː s a k
vrištati	ʋ r ǐː ʃ t a t i
vrli	ʋ r̂ l iː
vrlina	ʋ r l ǐ n a
vrlo	ʋ r̂ l o
vrstan	ʋ r̂ s t a n
vrtjeti	ʋ ř t j e t i
vrtlar	ʋ r̂ t l aː r
vrtlog	ʋ ř t l o ɡ
vrtoglavica	ʋ r t ǒ ɡ l a ʋ i t͡s a
vrutak	ʋ r ǔː t a k
vrčina	ʋ ř t͡ʃ i n a
vuk	v ûː k
vulkan	ʋ ǔ l k aː n
vuna	ʋ û n a
vučica	ʋ ǔ t͡ʃ i t͡s a
vučić	ʋ ǔ t͡ʃ i t͡ɕ
vučji	ʋ û t͡ʃ j iː
za	z a
zabavište	z ǎ b a ʋ iː ʃ t e
zabavljati	z ǎ b a ʋ ʎ a t i
zabijati	z a b ǐː j a t i
zabilježiti	z a b ǐ ʎ e ʒ i t i
zabiti	z ǎ b i t i
zablistati	z a b l ǐ s t a t i
zabluda	z âː b l u d a
zaboravljati	z a b ǒ r a ʋ ʎ a t i
zaboravno	z â b o r aː ʋ n o
zabrana	z âː b r a n a
zabraniti	z a b r ǎː n i t i
zabrinutost	z ǎ b r i n uː t oː s t
zacijelo	z â t͡s i j eː l o
zadarski	z â d a r s k iː
zadaća	z ǎ d a t͡ɕ a
zadirkivati	z a d i r k ǐː ʋ a t i
zadnjica	z â d ɲ i t͡s a
zadovoljan	z â d o ʋ oː ʎ a n
zadovoljavati	z a d o ʋ o ʎ ǎː ʋ a t i
zadovoljiti	z a d o ʋ ǒ ʎ i t i
zadovoljno	z â d o ʋ oː ʎ n o
zadovoljstvo	z a d o ʋ ǒ ʎ s t ʋ o
zadruga	z âː d r u ɡ a
zadrugar	z âː d r u ɡ aː r
zadržati	z a d ř ʒ a t i
zadugo	z ǎ d u ɡ o
zadužiti	z a d ǔː ʒ i t i
zaduživati	z a d u ʒ ǐː ʋ a t i
zaglavljivati	z a ɡ l a ʋ ʎ ǐː ʋ a t i
zagorčati	z a ɡ ǒ r t͡ʃ a t i
zagrebački	z ǎː ɡ r e b a t͡ʃ k iː
zagrepčanin	z ǎː ɡ r e p t͡ʃ a n i n
zagrijati	z ǎ ɡ r i j a t i
zagristi	z ǎ ɡ r i s t i
zagrliti	z ǎ ɡ r l i t i
zagrljaj	z â ɡ r ʎ aː j
zahoditi	z a x ǒ d i t i
zahtev	z ǎː x t e ʋ
zahtijevati	z a x t j ěː ʋ a t i
zahtjev	z ǎː x t j e ʋ
zahvala	z â x ʋ a l a
zahvalan	z ǎː x ʋ aː l a n
zahvaljujući	z a x ʋ ǎ ʎ u j uː t͡ɕ i
zahvalnost	z a x ʋ ǎː l n oː s t
zajebavati	z a j e b ǎː ʋ a t i
zajednica	z â j e d n i t͡s a
zajedništvo	z â j e d n iː ʃ t ʋ o
zajedno	z â j e d n o
zakasniti	z a k ǎ s n i t i
zakazati	z a k ǎː z a t i
zakinuti	z ǎ k i n u t i
zakleti	z ǎ k l eː t i
zaključiti	z a k ʎ ǔː t͡ʃ i t i
zaključivati	z a k ʎ u t͡ʃ ǐː ʋ a t i
zakon	z ǎː k o n
zakonik	z ǎː k o n iː k
zakonodavstvo	z a k o n o d ǎː ʋ s t ʋ o
zakočiti	z a k ǒː t͡ʃ i t i
zalagati	z a l ǎː ɡ a t i
zalazak	z ǎ l a z a k
zaliha	z âː l i x a
zalijevati	z a l i j ěː ʋ a t i
zaljubiti	z a ʎ ǔː b i t i
zalog	z ǎː l o ɡ
zalutati	z a l ǔː t a t i
zamaman	z â m aː m a n
zamenica	z âː m e n i t͡s a
zameniti	z a m ěː n i t i
zamenjiv	z a m ě ɲ i ʋ
zamijeniti	z a m j ěː n i t i
zamišljati	z a m ǐː ʃ ʎ a t i
zamjena	z âː m j e n a
zamjenica	z âː m j e n i t͡s a
zamjenik	z âː m j e n iː k
zamjeriti	z ǎː m j e r i t i
zamjerka	z ǎː m j eː r k a
zamka	z âː m k a
zamrznuti	z ǎ m r z n u t i
zanemariti	z a n e m ǎː r i t i
zanemarivati	z a n e m a r ǐː ʋ a t i
zaneseno	z a n ě s e n o
zanimanje	z a n ǐː m aː ɲ e
zanimati	z a n ǐː m a t i
zanimljiv	z a n ǐ m ʎ i ʋ
zanimljivo	z a n ǐ m ʎ i ʋ o
zaokružiti	z a o k r ǔː ʒ i t i
zaokruživati	z a o k r u ʒ ǐː ʋ a t i
zaostajati	z a ǒ s t a j a t i
zapad	z âː p a d
zapadnjački	z âː p a d ɲ a t͡ʃ k iː
zapaliti	z a p ǎː l i t i
zapamtiti	z ǎ p aː m t i t i
zapitati	z a p ǐː t a t i
zaposlenik	z a p o s l ě n iː k
zaposlenje	z a p o s l ěː ɲ e
zapovijedati	z a p o ʋ j ěː d a t i
zapovjednik	z a p o ʋ j ě d n iː k
zapošljavati	z a p o ʃ ʎ ǎː ʋ a t i
zaprijeti	z ǎ p r j eː t i
zaprositi	z a p r ǒ s i t i
zapustiti	z a p ǔ s t i t i
zarad	z â r a d
zaradi	z â r a d i
zaraditi	z a r ǎː d i t i
zaraza	z âː r a z a
zarobljenik	z a r o b ʎ ě n iː k
zaručnik	z ǎː r u t͡ʃ n iː k
zasad	z ǎ s a d
zasigurno	z â s i ɡ uː r n o
zasjeda	z âː s j e d a
zasjedanje	z a s j ěː d aː ɲ e
zasjeniti	z ǎ s j e n i t i
zasjenjivati	z a s j e ɲ ǐː ʋ a t i
zaslon	z ǎː s l o n
zasluga	z âː s l u ɡ a
zaslužan	z ǎː s l u ʒ a n
zasluženo	z ǎ s l uː ʒ e n o
zaslužiti	z a s l ǔː ʒ i t i
zasmetati	z a s m ěː t a t i
zastati	z ǎ s t a t i
zastoj	z ǎː s t o j
zastor	z ǎː s t o r
zastupati	z a s t ǔː p a t i
zastupnica	z ǎː s t u p n i t͡s a
zatiljak	z ǎː t i ʎ a k
zatim	z ǎ t iː m
zatišje	z ǎː t iː ʃ j e
zato	z ǎ t oː
zaton	z ǎː t o n
zatražiti	z a t r ǎː ʒ i t i
zatvor	z ǎː t ʋ o r
zatvoren	z ǎ t ʋ o r e n
zatvorenik	z a t ʋ o r ě n iː k
zatvoriti	z a t ʋ ǒ r i t i
zaustaviti	z a ǔ s t a ʋ i t i
zauvijek	z ǎ u ʋ j eː k
zauzeti	z a ǔ z eː t i
zauzimati	z a ǔ z i m a t i
zauzvrat	z â u z ʋ r aː t
zavarati	z ǎ ʋ a r a t i
zavaravati	z a ʋ a r ǎː ʋ a t i
zavezati	z a ʋ ěː z a t i
zavidan	z ǎː ʋ i d a n
zavidno	z ǎː ʋ i d n o
zaviriti	z a ʋ ǐː r i t i
zavirivati	z a ʋ i r ǐː ʋ a t i
zavisno	z ǎː ʋ i s n o
zavjesa	z âː ʋ j e s a
zavjet	z ǎː ʋ j e t
zavod	z ǎː ʋ o d
zavodnica	z ǎː ʋ o d n i t͡s a
zavodnik	z ǎː ʋ o d n iː k
zavodnički	z ǎː ʋ o d n i t͡ʃ k iː
zavojnica	z ǎː ʋ oː j n i t͡s a
zavoleti	z a ʋ ǒ l e t i
zavoljeti	z a ʋ ǒ ʎ e t i
zavrijediti	z a ʋ r j ěː d i t i
završavati	z a ʋ r ʃ ǎː ʋ a t i
završiti	z a ʋ řː ʃ i t i
završni	z ǎː ʋ r ʃ n iː
zač	z a t ʃ
začas	z ǎ t͡ʃ a s
začeti	z ǎ t͡ʃ eː t i
začetnik	z ǎː t͡ʃ e t n iː k
začin	z ǎː t͡ʃ i n
začiniti	z a t͡ʃ ǐ n i t i
začuditi	z ǎ t͡ʃ u d i t i
zašiljiti	z a ʃ ǐː ʎ i t i
zaštititi	z a ʃ t ǐː t i t i
zaštitnica	z ǎː ʃ t i t n i t͡s a
zašto	z â ʃ t o
zaželjeti	z a ʒ ě ʎ e t i
zbir	z b îː r
zbirka	z b îː r k a
zbiti	z b î t i
zbogom	z b ô ɡ o m
zbor	z b ô r
zbornik	z b ôː r n iː k
zbrinuti	z b r î n u t i
zbrka	z b r̂ k a
zbroj	z b r ôː j
zbrojiti	z b r ǒ j i t i
zbuniti	z b ǔː n i t i
zbunjen	z b ûː ɲ e n
zbunjeno	z b ûː ɲ e n o
zbunjivati	z b u ɲ ǐː ʋ a t i
zdenac	z d ěː n a t͡s
zdepast	z d ê p a s t
zdrav	z d r â ʋ
zdravlje	z d r âː ʋ ʎ e
zdravo	z d r â ʋ o
zdravstveni	z d r ǎ ʋ s t ʋ e n iː
zdravstveno	z d r ǎ ʋ s t ʋ e n o
zdravstvo	z d r ǎ ʋ s t ʋ o
zeba	z ěː b a
zec	z êː t͡s
zeko	z ěː k o
zelenilo	z e l ě n i l o
zelje	z êː ʎ e
zemaljski	z e m ǎ ʎ s k iː
zemlja	z ě m ʎ a
zemljin	z ě m ʎ i n
zemljište	z ê m ʎ iː ʃ t e
zemljopis	z ê m ʎ o p iː s
zemljoradnik	z e m ʎ ǒ r aː d n iː k
zemljoradnja	z e m ʎ o r ǎː d ɲ a
zemljotres	z ê m ʎ o t r eː s
zemljovid	z ê m ʎ o ʋ iː d
zenica	z ě n i t͡s a
zenit	z ě n iː t
zglob	z ɡ l ô b
zgoda	z ɡ ô d a
zgodan	z ɡ ô d a n
zguriti	z ɡ û r i t i
zgužvati	z ɡ ǔ ʒ ʋ a t i
zid	z îː d
zidina	z ǐ d i n a
zima	z ǐː m a
zimovanje	z i m ǒ ʋ aː ɲ e
zimski	z îː m s k iː
zimus	z ǐ m uː s
zimzelen	z î m z e l eː n
zlato	z l âː t o
zlatom	z l âː t o m
zlikovac	z l î k o ʋ a t͡s
zlo	z l ô
zloba	z l ǒ b a
zlonamjeran	z l o n ǎː m j eː r a n
zlostavljati	z l ǒ s t a ʋ ʎ a t i
zlouporaba	z l o ǔ p o r a b a
zloupotreba	z l ô u p o t r e b a
zloupotrijebiti	z l o u p o t r j ěː b i t i
zločinac	z l ǒ t͡ʃ i n a t͡s
zmaj	z m â j
znakovit	z n a k ǒ ʋ i t
znalac	z n ǎː l a t͡s
znan	z n âː n
znanje	z n ǎː ɲ e
znanost	z n â n oː s t
znanstveno	z n ǎ n s t ʋ e n o
znatan	z n â t a n
znati	z n â t i
znatiželja	z n â t i ʒ e ʎ a
znatno	z n â t n o
značajan	z n â t͡ʃ aː j a n
značajka	z n â t͡ʃ aː j k a
značajno	z n â t͡ʃ aː j n o
značenje	z n ǎː t͡ʃ eː ɲ e
značiti	z n ǎː t͡ʃ i t i
znoj	z n ôː j
znojiti	z n ǒ j i t i
zob	z ôː b
zoolog	z o ǒ l o ɡ
zoološki	z o ǒ l o ʃ k iː
zor	z ôː r
zora	z ǒ r a
zorom	z ǒ r oː m
zov	z ôː ʋ
zovem	z ǒ ʋ e m
zovemo	z ǒ ʋ e m o
zovete	z ǒ ʋ e t e
zoveš	z ǒ ʋ e ʃ
zrak	z r âː k
zraka	z r â k a
zrakoplov	z r â k o p l oː ʋ
zrakoplovni	z r â k o p l oː ʋ n iː
zrakoplovstvo	z r a k o p l ǒ ʋ s t ʋ o
zračenje	z r ǎː t͡ʃ eː ɲ e
zrno	z r̂ n o
zub	z ûː b
zuba	z ǔː b aː
zubac	z ǔː b a t͡s
zubar	z ǔ b aː r
zulum	z ǔ l u m
zvaničan	z ʋ ǎ n i t͡ʃ a n
zvanično	z ʋ ǎ n i t͡ʃ n o
zvanje	z ʋ ǎː ɲ e
zvati	z ʋ â t i
zvezda	z ʋ ěː z d a
zvezdan	z ʋ ě z d a n
zvijezda	z ʋ j ěː z d a
zvjezdan	z ʋ j ě z d a n
zvjezdica	z ʋ j ě z d i t͡s a
zvocati	z ʋ ô t͡s a t i
zvonik	z ʋ ǒ n iː k
zvoniti	z ʋ ǒ n i t i
zvono	z ʋ ô n o
zvuk	z ʋ ûː k
zvučati	z ʋ ǔː t͡ʃ a t i
zvučno	z ʋ ûː t͡ʃ n o
ćao	t͡ɕ âː o
ćef	t͡ɕ ê f
ćeif	t͡ɕ ě i f
ćelavost	t͡ɕ ê l a ʋ oː s t
ćer	t͡ɕ êː r
ćerka	t͡ɕ ěː r k a
ćilim	t͡ɕ ǐ l i m
ćirilica	t͡ɕ i r ǐ l i t͡s a
ćud	t͡ɕ ûː d
ćup	t͡ɕ û p
ča	t͡ʃ â
čador	t ʃ â d o r
čahura	t͡ʃ ǎ x u r a
čaj	t͡ʃ â j
čak	t͡ʃ â k
čamac	t͡ʃ ǎː m a t͡s
čar	t͡ʃ âː r
čarapa	t͡ʃ ǎ r a p a
čardaš	t͡ʃ â r d aː ʃ
čaroban	t͡ʃ â r o b a n
čarobno	t͡ʃ â r o b n o
čarolija	t͡ʃ a r ǒ l i j a
čaršija	t͡ʃ ǎ r ʃ i j a
časnik	t͡ʃ âː s n iː k
časno	t͡ʃ â s n o
časopis	t͡ʃ â s o p iː s
častan	t͡ʃ â s t a n
čađa	t͡ʃ â d͡ʑ a
čaša	t͡ʃ â ʃ a
čednost	t͡ʃ ê d n oː s t
čeh	t͡ʃ ê x
ček	t͡ʃ ê k
čekaonica	t͡ʃ e k a ǒː n i t͡s a
čekati	t͡ʃ ê k a t i
čekić	t͡ʃ ě k i t͡ɕ
čelik	t͡ʃ ě l i k
čelični	t͡ʃ ě l i t͡ʃ n iː
čelnik	t͡ʃ êː l n iː k
čempres	t͡ʃ ě m p r e s
čemu	t͡ʃ ě m u
čeoni	t͡ʃ ê o n iː
čep	t͡ʃ ê p
čest	t͡ʃ êː s t
čestica	t͡ʃ ě s t i t͡s a
čestit	t͡ʃ ě s t i t
čestito	t͡ʃ ě s t i t o
često	t͡ʃ êː s t o
četa	t͡ʃ ê t a
četnik	t͡ʃ e t n i k
četverokut	t͡ʃ ê t ʋ e r o k uː t
četveronoške	t͡ʃ e t ʋ e r ǒ n o ʃ k eː
četvrtfinale	t͡ʃ e t ʋ r t f i n ǎː l e
čeznuti	t͡ʃ ê z n u t i
češka	t͡ʃ ê ʃ k aː
češki	t͡ʃ ê ʃ k iː
češnjak	t͡ʃ ě ʃ ɲ aː k
či	t ʃ i
čiji	t͡ʃ ǐ j iː
čile	t͡ʃ î l e
čileanac	t͡ʃ i l e ǎː n a t͡s
čileanski	t͡ʃ i l ě aː n s k iː
čim	t͡ʃ i m
čime	t͡ʃ ǐː m e
čin	t͡ʃ îː n
činilac	t͡ʃ ǐ n i l a t͡s
činiti	t͡ʃ ǐ n i t i
činjenica	t͡ʃ î ɲ e n i t͡s a
činovnik	t͡ʃ i n ǒ ʋ n iː k
čip	t͡ʃ î p
čist	t͡ʃ î s t
čistiti	t͡ʃ î s t i t i
čistka	t͡ʃ î s t k a
čisto	t͡ʃ î s t o
čistota	t͡ʃ i s t ǒ t a
čistoća	t͡ʃ i s t ǒ t͡ɕ a
čitanje	t͡ʃ ǐ t aː ɲ e
čitaonica	t͡ʃ i t a ǒː n i t͡s a
čitateljica	t͡ʃ i t a t ě ʎ i t͡s a
čitav	t͡ʃ î t a ʋ
član	t͡ʃ l âː n
članak	t͡ʃ l ǎː n a k
članica	t͡ʃ l ǎ n i t͡s a
članstvo	t͡ʃ l ǎ n s t ʋ o
čopor	t͡ʃ ô p o r
čorba	t͡ʃ ǒː r b a
čovek	t͡ʃ ô ʋ e k
čovečanstvo	t͡ʃ o ʋ e t͡ʃ ǎ n s t ʋ o
čovjek	t͡ʃ ô ʋ j e k
čovječanstvo	t͡ʃ o ʋ j e t͡ʃ ǎ n s t ʋ o
čovječnost	t͡ʃ ô ʋ j e t͡ʃ n oː s t
čudak	t͡ʃ ǔ d aː k
čudan	t͡ʃ û d a n
čudesan	t͡ʃ û d e s a n
čudesno	t͡ʃ û d e s n o
čudno	t͡ʃ û d n o
čudo	t͡ʃ û d o
čudovište	t͡ʃ û d o ʋ iː ʃ t e
čulo	t͡ʃ ǔː l o
čuti	t͡ʃ û t i
čutura	t͡ʃ ǔ t u r a
čuvar	t͡ʃ ǔ ʋ aː r
čuvati	t͡ʃ ǔː ʋ a t i
čuven	t͡ʃ ǔ ʋ e n
čučanj	t͡ʃ ûː t͡ʃ a ɲ
čuđenje	t͡ʃ û d͡ʑ eː ɲ e
čvor	t͡ʃ ʋ ôː r
đak	d͡ʑ âː k
đavo	d͡ʑ â ʋ oː
đubre	d͡ʑ û b r e
šaban	ʃ ǎ b aː n
šah	ʃ â x
šahin	ʃ ǎː x i n
šahovski	ʃ ǎ x o ʋ s k iː
šaka	ʃ â k a
šala	ʃ ǎː l a
šalica	ʃ â l i t͡s a
šaljiv	ʃ ǎ ʎ i ʋ
šaljivdžija	ʃ a ʎ ǐ ʋ d͡ʒ i j a
šaman	ʃ ǎ m aː n
šamarati	ʃ a m ǎ r a t i
šamija	ʃ ǎː m i j a
šampanjac	ʃ a m p ǎː ɲ a t͡s
šampion	ʃ a m p ǐ oː n
šaptati	ʃ ǎ p t a t i
šara	ʃ ǎː r a
šaraf	ʃ ǎ r aː f
šaren	ʃ ǎ r e n
šarenica	ʃ a r ě n i t͡s a
šarlah	ʃ ǎ r l a x
šarmantan	ʃ a r m ǎ n t a n
šarolik	ʃ a r ǒ l i k
šaržer	ʃ ǎ r ʒ eː r
šator	ʃ â t o r
šašav	ʃ â ʃ a ʋ
šef	ʃ ê f
šeher	ʃ ê x e r
šejtan	ʃ ěː j t aː n
šema	ʃ ěː m a
šenkati	ʃ ê n k a t i
šerijat	ʃ e r ǐ j a t
šesti	ʃ ê s t iː
šestica	ʃ ě s t i t͡s a
šetač	ʃ ě t aː t͡ʃ
ševa	ʃ ěː ʋ a
šezdeset	ʃ e z d ě s eː t
šećer	ʃ ě t͡ɕ e r
šešir	ʃ ě ʃ iː r
šibica	ʃ î b i t͡s a
šifra	ʃ î f r a
šija	ʃ î j a
šiljak	ʃ ǐː ʎ a k
šiljka	ʃ îː ʎ k a
šilterica	ʃ î l t e r i t͡s a
šiltkapa	ʃ î l t k a p a
šina	ʃ î n a
šipka	ʃ î p k a
šira	ʃ ǐ r a
širenje	ʃ ǐː r eː ɲ e
širina	ʃ i r ǐ n a
širiti	ʃ ǐː r i t i
širok	ʃ ǐ r o k
široko	ʃ i r ǒ k o
širokogrudnost	ʃ i r o k ǒ ɡ r u d n oː s t
širom	ʃ ǐː r o m
škare	ʃ k â r e
škoda	ʃ k ô d a
škola	ʃ k ôː l a
školarina	ʃ k o l ǎ r i n a
školjka	ʃ k ôː ʎ k a
školovanje	ʃ k ô l o ʋ aː ɲ e
školovati	ʃ k ô l o ʋ a t i
školstvo	ʃ k ǒ l s t ʋ o
škorpion	ʃ k o r p ǐ oː n
škot	ʃ k ô t
škotska	ʃ k ô t s k aː
škotski	ʃ k ô t s k iː
škripa	ʃ k r î p a
škrob	ʃ k r ô b
škrtost	ʃ k r̂ t oː s t
škver	ʃ k ʋ êː r
šlag	ʃ l âː ɡ
šlager	ʃ l ǎː ɡ e r
šlep	ʃ l ê p
šleper	ʃ l ê p e r
šljaka	ʃ ʎ â k a
šljem	ʃ ʎ ê m
šljiva	ʃ ʎ î ʋ a
šljunak	ʃ ʎ ǔː n a k
šloser	ʃ l ô s e r
šnajder	ʃ n â j d e r
šoder	ʃ ǒː d e r
šofer	ʃ ǒ f eː r
šok	ʃ ô k
šokantan	ʃ o k ǎ n t a n
šokantno	ʃ o k ǎ n t n o
šolja	ʃ ǒː ʎ a
šos	ʃ ô s
šou	ʃ ô u
špajskarta	ʃ p â j s k a r t a
špajza	ʃ p â j z a
špalir	ʃ p ǎ l iː r
španac	ʃ p ǎː n a t͡s
španija	ʃ p âː n i j a
španjolac	ʃ p a ɲ ǒː l a t͡s
španski	ʃ p âː n s k iː
špekulacija	ʃ p e k u l ǎː t͡s i j a
špic	ʃ p î t͡s
špijun	ʃ p ǐ j uː n
špil	ʃ p î l
špilja	ʃ p î ʎ a
špinat	ʃ p ǐ n aː t
šport	ʃ p ô r t
šrot	ʃ r ô t
šta	ʃ t â
štab	ʃ t âː b
štafeta	ʃ t a f ěː t a
štakor	ʃ t â k o r
štampati	ʃ t âː m p a t i
štand	ʃ t â n d
štap	ʃ t âː p
štaviše	ʃ t ǎ ʋ i ʃ e
štedjeti	ʃ t ěː d j e t i
štedljivo	ʃ t ě d ʎ i ʋ o
štednja	ʃ t ěː d ɲ a
štednjak	ʃ t êː d ɲ aː k
šteka	ʃ t ê k a
štene	ʃ t ě n e
šteta	ʃ t ê t a
štetiti	ʃ t ê t i t i
štetnost	ʃ t ê t n oː s t
štih	ʃ t î x
štikla	ʃ t ǐ k l a
štimung	ʃ t ǐ m u n ɡ
štit	ʃ t îː t
štitnjača	ʃ t ǐː t ɲ a t͡ʃ a
štićenica	ʃ t î t͡ɕ e n i t͡s a
štićenik	ʃ t î t͡ɕ e n iː k
štoperica	ʃ t ô p e r i t͡s a
štoviše	ʃ t ǒ ʋ i ʃ e
štrajk	ʃ t r â j k
štrajkati	ʃ t r â j k a t i
štram	ʃ t r â m
šubara	ʃ ǔ b a r a
šum	ʃ ûː m
šuma	ʃ û m a
šutjeti	ʃ ǔː t j e t i
švabo	ʃ ʋ ǎː b o
šverc	ʃ ʋ ê r t͡s
šveđanin	ʃ ʋ ěː d͡ʑ a n i n
ščepati	ʃ t͡ʃ ě p a t i
žaba	ʒ â b a
žaga	ʒ ǎː ɡ a
žal	ʒ âː l
žalba	ʒ ǎ l b a
žalfija	ʒ ǎ l f i j a
žalilac	ʒ ǎ l i l a t͡s
žaliti	ʒ â l i t i
žaljenje	ʒ â ʎ eː ɲ e
žalosno	ʒ â l o s n o
žalost	ʒ â l oː s t
žalostan	ʒ â l o s t a n
žamor	ʒ âː m o r
žao	ʒ â o
žargon	ʒ ǎ r ɡ oː n
žbunje	ʒ b ûː ɲ e
ždrijeb	ʒ d r i j êː b
žedan	ʒ ěː d a n
želeti	ʒ ě l e t i
železnica	ʒ ě l e z n i t͡s a
želja	ʒ ê ʎ a
željan	ʒ ê ʎ a n
željeti	ʒ ě ʎ e t i
željeznica	ʒ ě ʎ e z n i t͡s a
željezo	ʒ ě ʎ e z o
željko	ʒ êː ʎ k o
željno	ʒ ěː ʎ n o
želudac	ʒ ě l u d a t͡s
žena	ʒ ě n a
ženeva	ʒ e n ěː ʋ a
ženevski	ʒ ě n e ʋ s k iː
ženka	ʒ êː n k a
ženskar	ʒ ě n s k aː r
ženstvenost	ʒ ě n s t ʋ e n oː s t
žestok	ʒ ě s t o k
žestoko	ʒ e s t ǒ k o
žeđ	ʒ êː d͡ʑ
žgaravica	ʒ ɡ â r a ʋ i t͡s a
žica	ʒ î t s a
židovski	ʒ ǐ d o ʋ s k iː
žig	ʒ îː ɡ
žila	ʒ î l a
žitarica	ʒ i t ǎ r i t͡s a
živ	ʒ îː ʋ
živahan	ʒ î ʋ aː x a n
živahno	ʒ î ʋ aː x n o
živahnost	ʒ î ʋ aː x n oː s t
živica	ʒ ǐ ʋ i t͡s a
živopisan	ʒ î ʋ o p iː s a n
živopisno	ʒ î ʋ o p iː s n o
živost	ʒ î ʋ oː s t
život	ʒ ǐ ʋ o t
životinja	ʒ i ʋ ǒ t i ɲ a
žlezda	ʒ l ěː z d a
žlijezda	ʒ l j ěː z d a
žrtva	ʒ r̂ t ʋ a
žulj	ʒ ûː ʎ
žumance	ʒ u m ǎː n t͡s e
župa	ʒ ǔː p a
županija	ʒ u p ǎ n i j a
županijski	ʒ u p ǎ n iː j s k iː
žvakati	ʒ ʋ ǎː k a t i
