abba	ɒ bː ɒ
abban	ɒ bː ɒ n
abból	ɒ bː oː l
ablak	ɒ b l ɒ k
ablakai	ɒ b l ɒ k ɒ j i
ablakból	ɒ b l ɒ ɡ b oː l
ablakok	ɒ b l ɒ k o k
ablakon	ɒ b l ɒ k o n
ablakot	ɒ b l ɒ k o t
absztrakt	ɒ p s t r ɒ k t
acéllemez	ɒ t͡s eː lː ɛ m ɛ z
ad	ɒ d
adat	ɒ d ɒ t
adatai	ɒ d ɒ t ɒ j i
adatainak	ɒ d ɒ t ɒ j i n ɒ k
adatait	ɒ d ɒ t ɒ j i t
adathoz	ɒ d ɒ t h o z
adatok	ɒ d ɒ t o k
adatokat	ɒ d ɒ t o k ɒ t
adatokból	ɒ d ɒ t o ɡ b oː l
adatokkal	ɒ d ɒ t o kː ɒ l
adatokra	ɒ d ɒ t o k r ɒ
adatokról	ɒ d ɒ t o k r oː l
adatot	ɒ d ɒ t o t
adattal	ɒ d ɒ tː ɒ l
addig	ɒ dː i ɡ
adhat	ɒ t h ɒ t
adjanak	ɒ ɟː ɒ n ɒ k
adják	ɒ ɟː aː k
adminisztratív	ɒ d m i n i s t r ɒ t iː v
adnak	ɒ d n ɒ k
adni	ɒ d n i
adományokat	ɒ d o m aː ɲ o k ɒ t
adott	ɒ d o tː
adottak	ɒ d o tː ɒ k
adta	ɒ tː ɒ
adtak	ɒ tː ɒ k
adtunk	ɒ tː u ŋ k
adtál	ɒ tː aː l
adunk	ɒ d u ŋ k
adva	ɒ d v ɒ
adás	ɒ d aː ʃ
adások	ɒ d aː ʃ o k
adóhatóság	ɒ d oː ɦ ɒ t oː ʃ aː ɡ
adósok	ɒ d oː ʃ o k
adósság	ɒ d oː ʃː aː ɡ
adózik	ɒ d oː z i k
adózás	ɒ d oː z aː ʃ
aeroszol	ɒ ɛ r o s o l
afféle	ɒ fː eː l ɛ
agancsokban	ɒ ɡ ɒ n t͡ʃ o ɡ b ɒ n
aggódó	ɒ ɡː oː d oː
agresszív	ɒ ɡ r ɛ sː iː v
agyag	ɒ ɟ ɒ ɡ
ahelyett	ɒ ɦ ɛ j ɛ tː
ahhoz	ɒ ɦ o z
ahogy	ɒ ɦ o ɟ
ahogyan	ɒ ɦ o ɟ ɒ n
ajak	ɒ j ɒ k
ajka	ɒ j k ɒ
ajándék	ɒ j aː n d eː k
ajándéka	ɒ j aː n d eː k ɒ
ajándékba	ɒ j aː n d eː ɡ b ɒ
ajándékkal	ɒ j aː n d eː kː ɒ l
ajándékokat	ɒ j aː n d eː k o k ɒ t
ajándékot	ɒ j aː n d eː k o t
ajánlani	ɒ j aː n l ɒ n i
ajánlati	ɒ j aː n l ɒ t i
ajánlatkérő	ɒ j aː n l ɒ t k eː r øː
ajánlattevő	ɒ j aː n l ɒ tː ɛ v øː
ajánlható	ɒ j aː n l ɦ ɒ t oː
ajánlom	ɒ j aː n l o m
akad	ɒ k ɒ d
akadály	ɒ k ɒ d aː j
akadálya	ɒ k ɒ d aː j ɒ
akadályokat	ɒ k ɒ d aː j o k ɒ t
akadályozta	ɒ k ɒ d aː j o s t ɒ
akadályt	ɒ k ɒ d aː j t
akadémia	ɒ k ɒ d eː m i j ɒ
akadémikus	ɒ k ɒ d eː m i k u ʃ
akar	ɒ k ɒ r
akarattal	ɒ k ɒ r ɒ tː ɒ l
akard	ɒ k ɒ r d
akarja	ɒ k ɒ r j ɒ
akarnak	ɒ k ɒ r n ɒ k
akarnám	ɒ k ɒ r n aː m
akarom	ɒ k ɒ r o m
akarsz	ɒ k ɒ r s
akart	ɒ k ɒ r t
akarta	ɒ k ɒ r t ɒ
akartak	ɒ k ɒ r t ɒ k
akarták	ɒ k ɒ r t aː k
akarunk	ɒ k ɒ r u ŋ k
akció	ɒ k t͡s i j oː
akciók	ɒ k t͡s i j oː k
akciós	ɒ k t͡s i j oː ʃ
akiben	ɒ k i b ɛ n
akihez	ɒ k i ɦ ɛ z
akik	ɒ k i k
akiket	ɒ k i k ɛ t
akikkel	ɒ k i kː ɛ l
akiknek	ɒ k i k n ɛ k
akiknél	ɒ k i k n eː l
akikre	ɒ k i k r ɛ
akikről	ɒ k i k r øː l
akinek	ɒ k i n ɛ k
akiről	ɒ k i r øː l
akitől	ɒ k i t øː l
akivel	ɒ k i v ɛ l
akkordokat	ɒ kː o r d o k ɒ t
akkori	ɒ kː o r i
aktuális	ɒ k t u aː l i ʃ
akár	ɒ k aː r
akárcsak	ɒ k aː r t͡ʃ ɒ k
akármilyen	ɒ k aː r m i j ɛ n
alacsonyabb	ɒ l ɒ t͡ʃ o ɲ ɒ bː
alak	ɒ l ɒ k
alakja	ɒ l ɒ k j ɒ
alakját	ɒ l ɒ k j aː t
alakra	ɒ l ɒ k r ɒ
alakul	ɒ l ɒ k u l
alakult	ɒ l ɒ k u l t
alakulása	ɒ l ɒ k u l aː ʃ ɒ
alakulását	ɒ l ɒ k u l aː ʃ aː t
alakítható	ɒ l ɒ k iː t h ɒ t oː
alakú	ɒ l ɒ k uː
alany	ɒ l ɒ ɲ
alanya	ɒ l ɒ ɲ ɒ
alap	ɒ l ɒ p
alapfokú	ɒ l ɒ p f o k uː
alapjául	ɒ l ɒ p j aː u l
alapkamat	ɒ l ɒ p k ɒ m ɒ t
alaplap	ɒ l ɒ p l ɒ p
alapok	ɒ l ɒ p o k
alapon	ɒ l ɒ p o n
alapos	ɒ l ɒ p o ʃ
alaposabban	ɒ l ɒ p o ʃ ɒ bː ɒ n
alapozva	ɒ l ɒ p o z v ɒ
alapterület	ɒ l ɒ p t ɛ r y l ɛ t
alapul	ɒ l ɒ p u l
alapvető	ɒ l ɒ p v ɛ t øː
alapvetően	ɒ l ɒ p v ɛ t øː ɛ n
alapítvány	ɒ l ɒ p iː t v aː ɲ
alapítványi	ɒ l ɒ p iː t v aː ɲ i
alapú	ɒ l ɒ p uː
alatt	ɒ l ɒ tː
albert	ɒ l b ɛ r t
album	ɒ l b u m
albumon	ɒ l b u m o n
albániai	ɒ l b aː n i j ɒ j i
alfa	ɒ l f ɒ
alföldi	ɒ l f ø l d i
alhat	ɒ l ɦ ɒ t
aligha	ɒ l i k h ɒ
alja	ɒ jː ɒ
alján	ɒ jː aː n
alka	ɒ l k ɒ
alkalmak	ɒ l k ɒ l m ɒ k
alkalmas	ɒ l k ɒ l m ɒ ʃ
alkalmasnak	ɒ l k ɒ l m ɒ ʃ n ɒ k
alkalmassá	ɒ l k ɒ l m ɒ ʃː aː
alkalmat	ɒ l k ɒ l m ɒ t
alkalmazható	ɒ l k ɒ l m ɒ s h ɒ t oː
alkalmazni	ɒ l k ɒ l m ɒ z n i
alkalmazása	ɒ l k ɒ l m ɒ z aː ʃ ɒ
alkalmazásának	ɒ l k ɒ l m ɒ z aː ʃ aː n ɒ k
alkalmazásával	ɒ l k ɒ l m ɒ z aː ʃ aː v ɒ l
alkalom	ɒ l k ɒ l o m
alkalomhoz	ɒ l k ɒ l o m ɦ o z
alkalommal	ɒ l k ɒ l o mː ɒ l
alkat	ɒ l k ɒ t
alkatrész	ɒ l k ɒ t r eː s
alkohol	ɒ l k o h o l
alkoholista	ɒ l k o h o l i ʃ t ɒ
alkonyataink	ɒ l k o ɲ ɒ t ɒ j i ŋ k
alkotmánybíróság	ɒ l k o t m aː ɲ b iː r oː ʃ aː ɡ
alkotmányos	ɒ l k o t m aː ɲ o ʃ
alkotása	ɒ l k o t aː ʃ ɒ
alkotó	ɒ l k o t oː
allen	ɛ l ɛ n
alpesi	ɒ l p ɛ ʃ i
alpolgármester	ɒ l p o l ɡ aː r m ɛ ʃ t ɛ r
alszik	ɒ l s i k
alsó	ɒ l ʃ oː
alternatív	ɒ l t ɛ r n ɒ t iː v
aluli	ɒ l u l i
alumínium	ɒ l u m iː n i j u m
alá	ɒ l aː
alább	ɒ l aː bː
alábbi	ɒ l aː bː i
alábbiak	ɒ l aː bː i j ɒ k
alám	ɒ l aː m
alánk	ɒ l aː ŋ k
alázat	ɒ l aː z ɒ t
aláírta	ɒ l aː j iː r t ɒ
aláírást	ɒ l aː j iː r aː ʃ t
alól	ɒ l oː l
ama	ɒ m ɒ
amatőr	ɒ m ɒ t øː r
amcsik	ɒ m t͡ʃ i k
ameddig	ɒ m ɛ dː i ɡ
amellett	ɒ m ɛ lː ɛ tː
amely	ɒ m ɛ j
amelyben	ɒ m ɛ j b ɛ n
amelyek	ɒ m ɛ j ɛ k
amelyekben	ɒ m ɛ j ɛ ɡ b ɛ n
amelyeken	ɒ m ɛ j ɛ k ɛ n
amelyekhez	ɒ m ɛ j ɛ k h ɛ z
amelyekkel	ɒ m ɛ j ɛ kː ɛ l
amelyekre	ɒ m ɛ j ɛ k r ɛ
amelyen	ɒ m ɛ j ɛ n
amelyet	ɒ m ɛ j ɛ t
amelynek	ɒ m ɛ j n ɛ k
amelynél	ɒ m ɛ j n eː l
amelyről	ɒ m ɛ j r øː l
amennyi	ɒ m ɛ ɲː i
amennyiben	ɒ m ɛ ɲː i b ɛ n
amennyire	ɒ m ɛ ɲː i r ɛ
amerikai	ɒ m ɛ r i k ɒ j i
ami	ɒ m i
amiben	ɒ m i b ɛ n
amiből	ɒ m i b øː l
amihez	ɒ m i ɦ ɛ z
amiket	ɒ m i k ɛ t
amikkel	ɒ m i kː ɛ l
amikor	ɒ m i k o r
amilyen	ɒ m i j ɛ n
amin	ɒ m i n
aminek	ɒ m i n ɛ k
amire	ɒ m i r ɛ
amiről	ɒ m i r øː l
amit	ɒ m i t
amivel	ɒ m i v ɛ l
amióta	ɒ m i j oː t ɒ
amnesztia	ɒ m n ɛ s t i j ɒ
amolyan	ɒ m o j ɒ n
amúgy	ɒ m uː ɟ
analfabéták	ɒ n ɒ l f ɒ b eː t aː k
analóg	ɒ n ɒ l oː ɡ
analógia	ɒ n ɒ l oː ɡ i j ɒ
andrás	ɒ n d r aː ʃ
anesztézia	ɒ n ɛ s t eː z i j ɒ
angliában	ɒ ŋ ɡ l i j aː b ɒ n
angol	ɒ ŋ ɡ o l
angolok	ɒ ŋ ɡ o l o k
anikó	ɒ n i k oː
animizmus	ɒ n i m i z m u ʃ
animációs	ɒ n i m aː t͡s i j oː ʃ
anna	ɒ nː ɒ
annak	ɒ nː ɒ k
annyi	ɒ ɲː i
annyira	ɒ ɲː i r ɒ
annácska	ɒ nː aː t͡ʃ k ɒ
annál	ɒ nː aː l
antal	ɒ n t ɒ l
anti	ɒ n t i
antidemokratikus	ɒ n t i d ɛ m o k r ɒ t i k u ʃ
anyag	ɒ ɲ ɒ ɡ
anyaga	ɒ ɲ ɒ ɡ ɒ
anyagai	ɒ ɲ ɒ ɡ ɒ j i
anyagban	ɒ ɲ ɒ ɡ b ɒ n
anyagból	ɒ ɲ ɒ ɡ b oː l
anyagi	ɒ ɲ ɒ ɡ i
anyagilag	ɒ ɲ ɒ ɡ i l ɒ ɡ
anyagok	ɒ ɲ ɒ ɡ o k
anyagokat	ɒ ɲ ɒ ɡ o k ɒ t
anyagokból	ɒ ɲ ɒ ɡ o ɡ b oː l
anyagot	ɒ ɲ ɒ ɡ o t
anyanyelvű	ɒ ɲ ɒ ɲ ɛ l v yː
anyja	ɒ ɲː ɒ
anyuka	ɒ ɲ u k ɒ
anyós	ɒ ɲ oː ʃ
anélkül	ɒ n eː l k y l
apa	ɒ p ɒ
apad	ɒ p ɒ d
apeh	ɒ p ɛ x
apja	ɒ p j ɒ
apró	ɒ p r oː
apám	ɒ p aː m
apát	ɒ p aː t
aranka	ɒ r ɒ ŋ k ɒ
arany	ɒ r ɒ ɲ
aranyos	ɒ r ɒ ɲ o ʃ
arca	ɒ r t͡s ɒ
arcán	ɒ r t͡s aː n
arcú	ɒ r t͡s uː
argentína	ɒ r ɡ ɛ n t iː n ɒ
argonod	ɒ r ɡ o n o d
arisztokrácia	ɒ r i s t o k r aː t͡s i j ɒ
arrafelé	ɒ rː ɒ f ɛ l eː
arról	ɒ rː oː l
artériás	ɒ r t eː r i j aː ʃ
aránya	ɒ r aː ɲ ɒ
aránylag	ɒ r aː ɲ l ɒ ɡ
arányos	ɒ r aː ɲ o ʃ
asszem	ɒ sː ɛ m
asszociációs	ɒ sː o t͡s i j aː t͡s i j oː ʃ
asszony	ɒ sː o ɲ
asszonyt	ɒ sː o ɲ t
aszerint	ɒ s ɛ r i n t
asztalé	ɒ s t ɒ l eː
asztrológia	ɒ s t r o l oː ɡ i j ɒ
ateizmus	ɒ t ɛ j i z m u ʃ
atom	ɒ t o m
atomerőmű	ɒ t o m ɛ r øː m yː
attila	ɒ t i lː ɒ
attribútum	ɒ t r i b uː t u m
audiokommentár	ɒ u d i j o k o mː ɛ n t aː r
ausztria	ɒ u s t r i j ɒ
ausztriai	ɒ u s t r i j ɒ j i
ausztriában	ɒ u s t r i j aː b ɒ n
ausztrál	ɒ u s t r aː l
ausztráliában	ɒ u s t r aː l i j aː b ɒ n
autizmus	ɒ u t i z m u ʃ
autonómia	ɒ u t o n oː m i j ɒ
autonómiák	ɒ u t o n oː m i j aː k
autója	ɒ u t oː j ɒ
autók	ɒ u t oː k
autókat	ɒ u t oː k ɒ t
autóknál	ɒ u t oː k n aː l
autónk	ɒ u t oː ŋ k
autópályán	ɒ u t oː p aː j aː n
autót	ɒ u t oː t
autóval	ɒ u t oː v ɒ l
avagy	ɒ v ɒ ɟ
avar	ɒ v ɒ r
azaz	ɒ z ɒ z
azeri	ɒ z ɛ r i
aznap	ɒ z n ɒ p
azok	ɒ z o k
azokat	ɒ z o k ɒ t
azokban	ɒ z o ɡ b ɒ n
azokból	ɒ z o ɡ b oː l
azoknak	ɒ z o k n ɒ k
azokon	ɒ z o k o n
azokra	ɒ z o k r ɒ
azoktól	ɒ z o k t oː l
azokért	ɒ z o k eː r t
azon	ɒ z o n
azonban	ɒ z o m b ɒ n
azonnal	ɒ z o nː ɒ l
azonnali	ɒ z o nː ɒ l i
azonos	ɒ z o n o ʃ
azonosak	ɒ z o n o ʃ ɒ k
azonosító	ɒ z o n o ʃ iː t oː
azt	ɒ s t
aztán	ɒ s t aː n
azután	ɒ z u t aː n
azzal	ɒ zː ɒ l
azért	ɒ z eː r t
azóta	ɒ z oː t ɒ
baj	b ɒ j
bajnok	b ɒ j n o k
bajnoki	b ɒ j n o k i
bajnokok	b ɒ j n o k o k
bajnokság	b ɒ j n o k ʃ aː ɡ
bajod	b ɒ j o d
bajok	b ɒ j o k
bajom	b ɒ j o m
bajor	b ɒ j o r
bajuk	b ɒ j u k
baki	b ɒ k i
bakteriológiai	b ɒ k t ɛ r i j o l oː ɡ i j ɒ j i
bal	b ɒ l
balaton	b ɒ l ɒ t o n
balatoni	b ɒ l ɒ t o n i
baleset	b ɒ l ɛ ʃ ɛ t
balesetek	b ɒ l ɛ ʃ ɛ t ɛ k
balesetet	b ɒ l ɛ ʃ ɛ t ɛ t
baleseti	b ɒ l ɛ ʃ ɛ t i
ballépés	b ɒ lː eː p eː ʃ
balra	b ɒ rː ɒ
balázs	b ɒ l aː ʒ
barack	b ɒ r ɒ t͡s k
barlang	b ɒ r l ɒ ŋ ɡ
barlangász	b ɒ r l ɒ ŋ ɡ aː s
barna	b ɒ r n ɒ
barnállik	b ɒ r n aː lː i k
barokk	b ɒ r o kː
baromfi	b ɒ r o ɱ f i
baromfitenyésztés	b ɒ r o ɱ f i t ɛ ɲ eː s t eː ʃ
baromság	b ɒ r o m ʃ aː ɡ
baross	b ɒ r o ʃ
bartók	b ɒ r t oː k
barátai	b ɒ r aː t ɒ j i
barátaim	b ɒ r aː t ɒ j i m
baráti	b ɒ r aː t i
barátja	b ɒ r aː cː ɒ
barátnő	b ɒ r aː t n øː
barátnője	b ɒ r aː t n øː j ɛ
barátom	b ɒ r aː t o m
barázda	b ɒ r aː z d ɒ
basszusgitár	b ɒ sː u ʒ ɡ i t aː r
batthyány	b ɒ cː aː ɲ i
be	b ɛ
bead	b ɛ ɒ d
beadja	b ɛ ɒ ɟː ɒ
beavatkozások	b ɛ ɒ v ɒ t k o z aː ʃ o k
beavatottak	b ɛ ɒ v ɒ t o tː ɒ k
becses	b ɛ t͡ʃ ɛ ʃ
beethoven	b eː t oː v ɛ n
befejezetlen	b ɛ f ɛ j ɛ z ɛ t l ɛ n
befejezett	b ɛ f ɛ j ɛ z ɛ tː
befejezés	b ɛ f ɛ j ɛ z eː ʃ
befejezése	b ɛ f ɛ j ɛ z eː ʃ ɛ
befektetés	b ɛ f ɛ k t ɛ t eː ʃ
befektetők	b ɛ f ɛ k t ɛ t øː k
befelé	b ɛ f ɛ l eː
befogadó	b ɛ f o ɡ ɒ d oː
befolyásolni	b ɛ f o j aː ʃ o l n i
befolyásoló	b ɛ f o j aː ʃ o l oː
befolyásos	b ɛ f o j aː ʃ o ʃ
beindul	b ɛ j i n d u l
beismerte	b ɛ j i ʃ m ɛ r t ɛ
bejelenteni	b ɛ j ɛ l ɛ n t ɛ n i
bejelentette	b ɛ j ɛ l ɛ n t ɛ tː ɛ
bejelentés	b ɛ j ɛ l ɛ n t eː ʃ
bejelentése	b ɛ j ɛ l ɛ n t eː ʃ ɛ
bejárat	b ɛ j aː r ɒ t
bejárati	b ɛ j aː r ɒ t i
bele	b ɛ l ɛ
beleegyezés	b ɛ l ɛ ɛ ɟː ɛ z eː ʃ
beleszeret	b ɛ l ɛ s ɛ r ɛ t
beleért	b ɛ l ɛ j eː r t
belga	b ɛ l ɡ ɒ
belgium	b ɛ l ɡ i j u m
belső	b ɛ l ʃ øː
beltéri	b ɛ l t eː r i
belváros	b ɛ l v aː r o ʃ
belvárosi	b ɛ l v aː r o ʃ i
belé	b ɛ l eː
beléd	b ɛ l eː d
beléjük	b ɛ l eː j y k
belépni	b ɛ l eː p n i
belépődíj	b ɛ l eː p øː d iː j
belügyminiszter	b ɛ l y ɟ m i n i s t ɛ r
belügyminisztérium	b ɛ l y ɟ m i n i s t eː r i j u m
belül	b ɛ l y l
belüli	b ɛ l y l i
belőle	b ɛ l øː l ɛ
belőlük	b ɛ l øː l y k
belőlünk	b ɛ l øː l y ŋ k
bemutatja	b ɛ m u t ɒ cː ɒ
bemutatni	b ɛ m u t ɒ t n i
bemutatott	b ɛ m u t ɒ t o tː
bemutatása	b ɛ m u t ɒ t aː ʃ ɒ
bemutatásra	b ɛ m u t ɒ t aː ʃ r ɒ
bemutatásával	b ɛ m u t ɒ t aː ʃ aː v ɒ l
bencés	b ɛ n t͡s eː ʃ
benkő	b ɛ ŋ k øː
benn	b ɛ nː
benne	b ɛ nː ɛ
benned	b ɛ nː ɛ d
bennetek	b ɛ nː ɛ t ɛ k
bennszülött	b ɛ n s y l ø tː
bennük	b ɛ nː y k
bennünket	b ɛ nː y ŋ k ɛ t
bent	b ɛ n t
benyomni	b ɛ ɲ o m n i
benyújtani	b ɛ ɲ uː j t ɒ n i
benzin	b ɛ n z i n
berci	b ɛ r t͡s i
berendezett	b ɛ r ɛ n d ɛ z ɛ tː
berendezés	b ɛ r ɛ n d ɛ z eː ʃ
berendezések	b ɛ r ɛ n d ɛ z eː ʃ ɛ k
berlini	b ɛ r l i n i
bernstein	b ɛ r n ʃ t ɛ j n
berta	b ɛ r t ɒ
beruházás	b ɛ r u ɦ aː z aː ʃ
beruházási	b ɛ r u ɦ aː z aː ʃ i
beruházások	b ɛ r u ɦ aː z aː ʃ o k
beszerezni	b ɛ s ɛ r ɛ z n i
beszerzés	b ɛ s ɛ r z eː ʃ
beszerzése	b ɛ s ɛ r z eː ʃ ɛ
beszámoló	b ɛ s aː m o l oː
beszéd	b ɛ s eː d
beszédes	b ɛ s eː d ɛ ʃ
beszédet	b ɛ s eː d ɛ t
beszédében	b ɛ s eː d eː b ɛ n
beszédét	b ɛ s eː d eː t
beszél	b ɛ s eː l
beszélek	b ɛ s eː l ɛ k
beszélget	b ɛ s eː l ɡ ɛ t
beszélgetés	b ɛ s eː l ɡ ɛ t eː ʃ
beszélgetések	b ɛ s eː l ɡ ɛ t eː ʃ ɛ k
beszélgetésre	b ɛ s eː l ɡ ɛ t eː ʃ r ɛ
beszélgetést	b ɛ s eː l ɡ ɛ t eː ʃ t
beszéljen	b ɛ s eː jː ɛ n
beszélni	b ɛ s eː l n i
beszélsz	b ɛ s eː l s
beszélt	b ɛ s eː l t
beszéltem	b ɛ s eː l t ɛ m
beszéltünk	b ɛ s eː l t y ŋ k
beszélünk	b ɛ s eː l y ŋ k
beszélő	b ɛ s eː l øː
betartása	b ɛ t ɒ r t aː ʃ ɒ
beteg	b ɛ t ɛ ɡ
betegek	b ɛ t ɛ ɡ ɛ k
betegség	b ɛ t ɛ k ʃ eː ɡ
betegségek	b ɛ t ɛ k ʃ eː ɡ ɛ k
betegséget	b ɛ t ɛ k ʃ eː ɡ ɛ t
betegágy	b ɛ t ɛ ɡ aː ɟ
betekintést	b ɛ t ɛ k i n t eː ʃ t
beton	b ɛ t o n
betyárok	b ɛ c aː r o k
betöltött	b ɛ t ø l t ø tː
betű	b ɛ t yː
betűket	b ɛ t yː k ɛ t
betűméret	b ɛ t yː m eː r ɛ t
bevett	b ɛ v ɛ tː
bevette	b ɛ v ɛ tː ɛ
bevezetett	b ɛ v ɛ z ɛ t ɛ tː
bevezetni	b ɛ v ɛ z ɛ t n i
bevezetés	b ɛ v ɛ z ɛ t eː ʃ
bevezetését	b ɛ v ɛ z ɛ t eː ʃ eː t
bevált	b ɛ v aː l t
bevétel	b ɛ v eː t ɛ l
bevételek	b ɛ v eː t ɛ l ɛ k
bevételi	b ɛ v eː t ɛ l i
bezzeg	b ɛ zː ɛ ɡ
beáta	b ɛ aː t ɒ
beérkezett	b ɛ j eː r k ɛ z ɛ tː
beérkező	b ɛ j eː r k ɛ z øː
bianka	b i j ɒ ŋ k ɒ
bibliai	b i b l i j ɒ j i
billió	b i l i j oː
biológiai	b i j o l oː ɡ i j ɒ j i
biológus	b i j o l oː ɡ u ʃ
birtoka	b i r t o k ɒ
birtokba	b i r t o ɡ b ɒ
birtokában	b i r t o k aː b ɒ n
bizalmát	b i z ɒ l m aː t
bizalom	b i z ɒ l o m
bizonnyal	b i z o ɲː ɒ l
bizonyos	b i z o ɲ o ʃ
bizonytalan	b i z o ɲ t ɒ l ɒ n
bizonytalanság	b i z o ɲ t ɒ l ɒ n ʃ aː ɡ
bizonytalanságok	b i z o ɲ t ɒ l ɒ n ʃ aː ɡ o k
bizonyára	b i z o ɲ aː r ɒ
bizonyítvány	b i z o ɲ iː t v aː ɲ
bizonyítványok	b i z o ɲ iː t v aː ɲ o k
bizonyítványt	b i z o ɲ iː t v aː ɲ t
bizonyíték	b i z o ɲ iː t eː k
bizonyítékok	b i z o ɲ iː t eː k o k
bizottság	b i z o t͡ʃː aː ɡ
bizottsága	b i z o t͡ʃː aː ɡ ɒ
bizottságot	b i z o t͡ʃː aː ɡ o t
bizottságának	b i z o t͡ʃː aː ɡ aː n ɒ k
biztató	b i s t ɒ t oː
bizton	b i s t o n
biztonság	b i s t o n ʃ aː ɡ
biztonsága	b i s t o n ʃ aː ɡ ɒ
biztonságban	b i s t o n ʃ aː ɡ b ɒ n
biztonsági	b i s t o n ʃ aː ɡ i
biztonságos	b i s t o n ʃ aː ɡ o ʃ
biztonságosabb	b i s t o n ʃ aː ɡ o ʃ ɒ bː
biztonságát	b i s t o n ʃ aː ɡ aː t
biztos	b i s t o ʃ
biztosan	b i s t o ʃ ɒ n
biztosra	b i s t o ʃ r ɒ
biztosít	b i s t o ʃ iː t
biztosítani	b i s t o ʃ iː t ɒ n i
biztosítja	b i s t o ʃ iː cː ɒ
biztosított	b i s t o ʃ iː t o tː
bizánci	b i z aː n t͡s i
bkv	b eː k aː v eː
blog	b l o ɡ
blokád	b l o k aː d
blues	b l u ɛ ʃ
bmw	b eː j ɛ ɱ v eː
bocsássanak	b o t͡ʃ aː ʃː ɒ n ɒ k
bocsát	b o t͡ʃ aː t
bocsátanunk	b o t͡ʃ aː t ɒ n u ŋ k
bocsátjuk	b o t͡ʃ aː cː u k
bocsátotta	b o t͡ʃ aː t o tː ɒ
bocsátottak	b o t͡ʃ aː t o tː ɒ k
bocsátás	b o t͡ʃ aː t aː ʃ
bogarak	b o ɡ ɒ r ɒ k
bokszutca	b o k s u t͡sː ɒ
bokszzsák	b o ɡ z ʒ aː k
boldog	b o l d o ɡ
boldogok	b o l d o ɡ o k
boldogság	b o l d o k ʃ aː ɡ
bolond	b o l o n d
boltok	b o l t o k
bomba	b o m b ɒ
boncolások	b o n t͡s o l aː ʃ o k
bonyodalom	b o ɲ o d ɒ l o m
bonyolult	b o ɲ o l u l t
bornak	b o r n ɒ k
borok	b o r o k
borongós	b o r o ŋ ɡ oː ʃ
borsmenta	b o r ʃ m ɛ n t ɒ
borzok	b o r z o k
borító	b o r iː t oː
borúsan	b o r uː ʃ ɒ n
bosszút	b o sː uː t
bot	b o t
botlik	b o t l i k
brazil	b r ɒ z i l
bruttó	b r u tː oː
brüsszel	b r y sː ɛ l
buborékok	b u b o r eː k o k
buda	b u d ɒ
budapest	b u d ɒ p ɛ ʃ t
budapesten	b u d ɒ p ɛ ʃ t ɛ n
budapesti	b u d ɒ p ɛ ʃ t i
budapestre	b u d ɒ p ɛ ʃ t r ɛ
bukott	b u k o tː
bulgária	b u l ɡ aː r i j ɒ
buli	b u l i
burkolat	b u r k o l ɒ t
burkolatok	b u r k o l ɒ t o k
busz	b u s
buszok	b u s o k
buszon	b u s o n
buszra	b u s r ɒ
buta	b u t ɒ
bácsi	b aː t͡ʃ i
bája	b aː j ɒ
bájos	b aː j o ʃ
bán	b aː n
bár	b aː r
bárban	b aː r b ɒ n
bárhol	b aː r ɦ o l
bárki	b aː r k i
bárkit	b aː r k i t
bármelyik	b aː r m ɛ j i k
bármi	b aː r m i
bármik	b aː r m i k
bármikor	b aː r m i k o r
bármilyen	b aː r m i j ɛ n
bármit	b aː r m i t
bátor	b aː t o r
bátorság	b aː t o r ʃ aː ɡ
bátorsága	b aː t o r ʃ aː ɡ ɒ
bázisok	b aː z i ʃ o k
bécsben	b eː d͡ʒ b ɛ n
béke	b eː k ɛ
békés	b eː k eː ʃ
béla	b eː l ɒ
bérelt	b eː r ɛ l t
béren	b eː r ɛ n
bérleti	b eː r l ɛ t i
bért	b eː r t
bíboros	b iː b o r o ʃ
bír	b iː r
bírság	b iː r ʃ aː ɡ
bírta	b iː r t ɒ
bíró	b iː r oː
bírói	b iː r oː j i
bírósági	b iː r oː ʃ aː ɡ i
bízik	b iː z i k
bízva	b iː z v ɒ
bóvli	b oː v l i
bögölynél	b ø ɡ ø j n eː l
bölcs	b ø l t͡ʃ
bölcsebb	b ø l t͡ʃ ɛ bː
bölcsek	b ø l t͡ʃ ɛ k
böngésző	b ø ŋ ɡ eː s øː
böngészők	b ø ŋ ɡ eː s øː k
börtönből	b ø r t ø m b øː l
börtönök	b ø r t ø n ø k
búcsúcsók	b uː t͡ʃ uː t͡ʃ oː k
bútor	b uː t o r
bútorok	b uː t o r o k
bútorokat	b uː t o r o k ɒ t
búvár	b uː v aː r
búvárok	b uː v aː r o k
búza	b uː z ɒ
büfé	b y f eː
büntetés	b y n t ɛ t eː ʃ
büntetések	b y n t ɛ t eː ʃ ɛ k
büntetést	b y n t ɛ t eː ʃ t
bürokratikus	b y r o k r ɒ t i k u ʃ
büszke	b y s k ɛ
büszkeség	b y s k ɛ ʃ eː ɡ
büszkén	b y s k eː n
bő	b øː
bőr	b øː r
bőrgyár	b øː r ɟ aː r
bőrt	b øː r t
bőséges	b øː ʃ eː ɡ ɛ ʃ
bővebb	b øː v ɛ bː
bőven	b øː v ɛ n
bővítés	b øː v iː t eː ʃ
bővül	b øː v y l
bővülő	b øː v y l øː
bűn	b yː n
bűnbak	b yː m b ɒ k
bűncselekménnyel	b yː n t͡ʃ ɛ l ɛ k m eː ɲː ɛ l
bűncselekmény	b yː n t͡ʃ ɛ l ɛ k m eː ɲ
bűncselekmények	b yː n t͡ʃ ɛ l ɛ k m eː ɲ ɛ k
bűnt	b yː n t
bűntett	b yː n t ɛ tː
bűnös	b yː n ø ʃ
bűnözők	b yː n ø z øː k
cd	t͡s eː d eː
centi	t͡s ɛ n t i
centiméter	t͡s ɛ n t i m eː t ɛ r
centis	t͡s ɛ n t i ʃ
centrum	t͡s ɛ n t r u m
ceremónia	t͡s ɛ r ɛ m oː n i j ɒ
chicago	t͡ʃ i k aː ɡ oː
cicáik	t͡s i t͡s aː j i k
cigány	t͡s i ɡ aː ɲ
ciki	t͡s i k i
cikk	t͡s i kː
cikkben	t͡s i ɡ b ɛ n
cikke	t͡s i kː ɛ
cikkek	t͡s i kː ɛ k
cikkeket	t͡s i kː ɛ k ɛ t
cikket	t͡s i kː ɛ t
cikkében	t͡s i kː eː b ɛ n
ciklon	t͡s i k l o n
cinterem	t͡s i n t ɛ r ɛ m
cipel	t͡s i p ɛ l
cipzár	t͡s i b z aː r
citromsav	t͡s i t r o m ʃ ɒ v
civilizált	t͡s i v i l i z aː l t
combok	t͡s o m b o k
csaba	t͡ʃ ɒ b ɒ
csajkáid	t͡ʃ ɒ j k aː j i d
csak	t͡ʃ ɒ k
csakhogy	t͡ʃ ɒ k h o ɟ
csakis	t͡ʃ ɒ k i ʃ
csaknem	t͡ʃ ɒ k n ɛ m
család	t͡ʃ ɒ l aː d
családbarát	t͡ʃ ɒ l aː d b ɒ r aː t
családfő	t͡ʃ ɒ l aː t f øː
családi	t͡ʃ ɒ l aː d i
családja	t͡ʃ ɒ l aː ɟː ɒ
családnak	t͡ʃ ɒ l aː d n ɒ k
családok	t͡ʃ ɒ l aː d o k
családokat	t͡ʃ ɒ l aː d o k ɒ t
családot	t͡ʃ ɒ l aː d o t
csalán	t͡ʃ ɒ l aː n
csalás	t͡ʃ ɒ l aː ʃ
csalódott	t͡ʃ ɒ l oː d o tː
csap	t͡ʃ ɒ p
csapadék	t͡ʃ ɒ p ɒ d eː k
csapadékok	t͡ʃ ɒ p ɒ d eː k o k
csapat	t͡ʃ ɒ p ɒ t
csapata	t͡ʃ ɒ p ɒ t ɒ
csapatban	t͡ʃ ɒ p ɒ d b ɒ n
csapatnak	t͡ʃ ɒ p ɒ t n ɒ k
csapatok	t͡ʃ ɒ p ɒ t o k
csapatoknak	t͡ʃ ɒ p ɒ t o k n ɒ k
csapatot	t͡ʃ ɒ p ɒ t o t
csapattal	t͡ʃ ɒ p ɒ tː ɒ l
csapatunk	t͡ʃ ɒ p ɒ t u ŋ k
csapongó	t͡ʃ ɒ p o ŋ ɡ oː
csapás	t͡ʃ ɒ p aː ʃ
csatlakozik	t͡ʃ ɒ t l ɒ k o z i k
csatlakozni	t͡ʃ ɒ t l ɒ k o z n i
csatlakozási	t͡ʃ ɒ t l ɒ k o z aː ʃ i
csatlakozó	t͡ʃ ɒ t l ɒ k o z oː
csatorna	t͡ʃ ɒ t o r n ɒ
csatornák	t͡ʃ ɒ t o r n aː k
csattan	t͡ʃ ɒ tː ɒ n
csavar	t͡ʃ ɒ v ɒ r
csecsemő	t͡ʃ ɛ t͡ʃ ɛ m øː
csehek	t͡ʃ ɛ h ɛ k
csehország	t͡ʃ ɛ o r s aː ɡ
csekkek	t͡ʃ ɛ kː ɛ k
csekély	t͡ʃ ɛ k eː j
cselekedetek	t͡ʃ ɛ l ɛ k ɛ d ɛ t ɛ k
cselekmény	t͡ʃ ɛ l ɛ k m eː ɲ
cselekvési	t͡ʃ ɛ l ɛ k v eː ʃ i
csemeték	t͡ʃ ɛ m ɛ t eː k
csempézés	t͡ʃ ɛ m p eː z eː ʃ
csendes	t͡ʃ ɛ n d ɛ ʃ
csendesen	t͡ʃ ɛ n d ɛ ʃ ɛ n
csendélet	t͡ʃ ɛ n d eː l ɛ t
cseppekben	t͡ʃ ɛ pː ɛ ɡ b ɛ n
cseppet	t͡ʃ ɛ pː ɛ t
cserben	t͡ʃ ɛ r b ɛ n
cseresznyefa	t͡ʃ ɛ r ɛ s ɲ ɛ f ɒ
cserébe	t͡ʃ ɛ r eː b ɛ
cserél	t͡ʃ ɛ r eː l
cserélni	t͡ʃ ɛ r eː l n i
csiga	t͡ʃ i ɡ ɒ
csigalépcső	t͡ʃ i ɡ ɒ l eː p t͡ʃ øː
csillag	t͡ʃ i lː ɒ ɡ
csillagkép	t͡ʃ i lː ɒ kː eː p
csillagok	t͡ʃ i lː ɒ ɡ o k
csillagászati	t͡ʃ i lː ɒ ɡ aː s ɒ t i
csinos	t͡ʃ i n o ʃ
csintalan	t͡ʃ i n t ɒ l ɒ n
csinálhat	t͡ʃ i n aː l ɦ ɒ t
csoda	t͡ʃ o d ɒ
csodaszép	t͡ʃ o d ɒ s eː p
csodálatos	t͡ʃ o d aː l ɒ t o ʃ
csodát	t͡ʃ o d aː t
csoki	t͡ʃ o k i
csokoládébarna	t͡ʃ o k o l aː d eː b ɒ r n ɒ
csokonai	t͡ʃ o k o n ɒ j i
csomag	t͡ʃ o m ɒ ɡ
csomagot	t͡ʃ o m ɒ ɡ o t
csomópont	t͡ʃ o m oː p o n t
csongrád	t͡ʃ o ŋ ɡ r aː d
csont	t͡ʃ o n t
csontos	t͡ʃ o n t o ʃ
csoportja	t͡ʃ o p o r c ɒ
csoportját	t͡ʃ o p o r c aː t
csoportos	t͡ʃ o p o r t o ʃ
csupa	t͡ʃ u p ɒ
csupasz	t͡ʃ u p ɒ s
csupán	t͡ʃ u p aː n
csábítás	t͡ʃ aː b iː t aː ʃ
csápok	t͡ʃ aː p o k
csárda	t͡ʃ aː r d ɒ
császár	t͡ʃ aː s aː r
császári	t͡ʃ aː s aː r i
csépel	t͡ʃ eː p ɛ l
csésze	t͡ʃ eː s ɛ
csírájában	t͡ʃ iː r aː j aː b ɒ n
csökkent	t͡ʃ ø kː ɛ n t
csökkenteni	t͡ʃ ø kː ɛ n t ɛ n i
csökkentette	t͡ʃ ø kː ɛ n t ɛ tː ɛ
csökkentése	t͡ʃ ø kː ɛ n t eː ʃ ɛ
csökkentését	t͡ʃ ø kː ɛ n t eː ʃ eː t
csúcs	t͡ʃ uː t͡ʃ
csúf	t͡ʃ uː f
csúnya	t͡ʃ uː ɲ ɒ
csúnyán	t͡ʃ uː ɲ aː n
csúszda	t͡ʃ uː z d ɒ
csütörtök	t͡ʃ y t ø r t ø k
csütörtöki	t͡ʃ y t ø r t ø k i
csütörtökön	t͡ʃ y t ø r t ø k ø n
cukor	t͡s u k o r
cáfolat	t͡s aː f o l ɒ t
cég	t͡s eː ɡ
cége	t͡s eː ɡ ɛ
cégek	t͡s eː ɡ ɛ k
cégeknek	t͡s eː ɡ ɛ k n ɛ k
cégen	t͡s eː ɡ ɛ n
céges	t͡s eː ɡ ɛ ʃ
céget	t͡s eː ɡ ɛ t
cégnek	t͡s eː ɡ n ɛ k
cégnél	t͡s eː ɡ n eː l
cégük	t͡s eː ɡ y k
cégünk	t͡s eː ɡ y ŋ k
céhek	t͡s eː ɦ ɛ k
cél	t͡s eː l
célba	t͡s eː l b ɒ
célból	t͡s eː l b oː l
célja	t͡s eː jː ɒ
céljait	t͡s eː jː ɒ j i t
céljából	t͡s eː jː aː b oː l
céljára	t͡s eː jː aː r ɒ
célját	t͡s eː jː aː t
célkitűzés	t͡s eː l k i t yː z eː ʃ
céllal	t͡s eː lː ɒ l
célnak	t͡s eː l n ɒ k
célok	t͡s eː l o k
célokat	t͡s eː l o k ɒ t
célpontok	t͡s eː l p o n t o k
célra	t͡s eː rː ɒ
célszerű	t͡s eː l s ɛ r yː
célt	t͡s eː l t
céltudatos	t͡s eː l t u d ɒ t o ʃ
célul	t͡s eː l u l
célunk	t͡s eː l u ŋ k
célú	t͡s eː l uː
címe	t͡s iː m ɛ
címedet	t͡s iː m ɛ d ɛ t
címkék	t͡s iː m k eː k
címzett	t͡s iː m z ɛ tː
címén	t͡s iː m eː n
címére	t͡s iː m eː r ɛ
címét	t͡s iː m eː t
című	t͡s iː m yː
dac	d ɒ t͡s
daganatos	d ɒ ɡ ɒ n ɒ t o ʃ
dala	d ɒ l ɒ
dalol	d ɒ l o l
darab	d ɒ r ɒ b
darabja	d ɒ r ɒ b j ɒ
darabot	d ɒ r ɒ b o t
darazsak	d ɒ r ɒ ʒ ɒ k
david	d eː v i d
db	d ɒ r ɒ b
debrecen	d ɛ b r ɛ t͡s ɛ n
debrecenben	d ɛ b r ɛ t͡s ɛ m b ɛ n
debreceni	d ɛ b r ɛ t͡s ɛ n i
december	d ɛ t͡s ɛ m b ɛ r
decemberben	d ɛ t͡s ɛ m b ɛ r b ɛ n
definíció	d ɛ f i n iː t͡s i j oː
deklináció	d ɛ k l i n aː t͡s i j oː
demokrata	d ɛ m o k r ɒ t ɒ
demokratikus	d ɛ m o k r ɒ t i k u ʃ
demokraták	d ɛ m o k r ɒ t aː k
demokrácia	d ɛ m o k r aː t͡s i j ɒ
derül	d ɛ r y l
derült	d ɛ r y l t
derűlátó	d ɛ r yː l aː t oː
design	d i z aː j n
dezső	d ɛ ʒ øː
diabétesz	d i j ɒ b eː t ɛ s
diagnosztikai	d i j ɒ ɡ n o s t i k ɒ j i
diagnózis	d i j ɒ ɡ n oː z i ʃ
dicséretnek	d i t͡ʃ eː r ɛ t n ɛ k
dicsérte	d i t͡ʃ eː r t ɛ
dicsőség	d i t͡ʃ øː ʃ eː ɡ
digitális	d i ɡ i t aː l i ʃ
diktatúra	d i k t ɒ t uː r ɒ
diktátor	d i k t aː t o r
dimenziók	d i m ɛ n z i j oː k
dinamika	d i n ɒ m i k ɒ
dinamikusan	d i n ɒ m i k u ʃ ɒ n
diplomáciai	d i p l o m aː t͡s i j ɒ j i
diplomások	d i p l o m aː ʃ o k
direkt	d i r ɛ k t
diszkriminatív	d i s k r i m i n ɒ t iː v
divat	d i v ɒ t
diákok	d i j aː k o k
diétás	d i j eː t aː ʃ
dió	d i j oː
dob	d o b
dobják	d o b j aː k
dobogó	d o b o ɡ oː
dobott	d o b o tː
dobozos	d o b o z o ʃ
dobó	d o b oː
dokk	d o kː
doktor	d o k t o r
doktoranduszok	d o k t o r ɒ n d u s o k
doktornő	d o k t o r n øː
dokumentumfilm	d o k u m ɛ n t u ɱ f i l m
dokumentumfilmek	d o k u m ɛ n t u ɱ f i l m ɛ k
dokumentációk	d o k u m ɛ n t aː t͡s i j oː k
dokumentál	d o k u m ɛ n t aː l
dolga	d o l ɡ ɒ
dolgotok	d o l ɡ o t o k
dolgozatok	d o l ɡ o z ɒ t o k
dolgozhat	d o l ɡ o s h ɒ t
dolgozik	d o l ɡ o z i k
dolgoznak	d o l ɡ o z n ɒ k
dolgozni	d o l ɡ o z n i
dolgozott	d o l ɡ o z o tː
dolgozunk	d o l ɡ o z u ŋ k
dolgozó	d o l ɡ o z oː
dolgozói	d o l ɡ o z oː j i
dolgozók	d o l ɡ o z oː k
dolguk	d o l ɡ u k
dolgát	d o l ɡ aː t
dollár	d o lː aː r
dollárok	d o lː aː r o k
dollárral	d o lː aː rː ɒ l
dominika	d o m i n i k ɒ
drasztikus	d r ɒ s t i k u ʃ
drasztikusan	d r ɒ s t i k u ʃ ɒ n
drog	d r o ɡ
drága	d r aː ɡ ɒ
drágult	d r aː ɡ u l t
drágább	d r aː ɡ aː bː
drágák	d r aː ɡ aː k
drágám	d r aː ɡ aː m
drámai	d r aː m ɒ j i
duda	d u d ɒ
duna	d u n ɒ
dupla	d u p l ɒ
durva	d u r v ɒ
duó	d u oː
dzsudzsák	d͡ʒ u d͡ʒ aː k
dán	d aː n
dánia	d aː n i j ɒ
dávid	d aː v i d
délben	d eː l b ɛ n
délelőtt	d eː l ɛ l øː tː
déli	d eː l i
délnyugati	d eː l ɲ u ɡ ɒ t i
délre	d eː rː ɛ
délről	d eː rː øː l
délután	d eː l u t aː n
délutáni	d eː l u t aː n i
démonok	d eː m o n o k
dísz	d iː s
díszes	d iː s ɛ ʃ
dízel	d iː z ɛ l
dóm	d oː m
dönt	d ø n t
dönteni	d ø n t ɛ n i
döntés	d ø n t eː ʃ
döntéshozó	d ø n t eː ʃ h o z oː
döntési	d ø n t eː ʃ i
döntést	d ø n t eː ʃ t
döntött	d ø n t ø tː
döntő	d ø n t øː
dús	d uː ʃ
dőlt	d øː l t
ebbe	ɛ bː ɛ
ebben	ɛ bː ɛ n
ebből	ɛ bː øː l
ebek	ɛ b ɛ k
ebéd	ɛ b eː d
ebédet	ɛ b eː d ɛ t
eddig	ɛ dː i ɡ
eddigi	ɛ dː i ɡ i
eddiginél	ɛ dː i ɡ i n eː l
edző	ɛ d͡zː øː
efféle	ɛ f eː l ɛ
egerek	ɛ ɡ ɛ r ɛ k
egeret	ɛ ɡ ɛ r ɛ t
egy	ɛ ɟː
egyaránt	ɛ ɟː ɒ r aː n t
egyben	ɛ ɟ b ɛ n
egyből	ɛ ɟ b øː l
egyedi	ɛ ɟ ɛ d i
egyedüli	ɛ ɟ ɛ d y l i
egyedülálló	ɛ ɟ ɛ d y l aː lː oː
egyenes	ɛ ɟ ɛ n ɛ ʃ
egyenesek	ɛ ɟ ɛ n ɛ ʃ ɛ k
egyenesen	ɛ ɟ ɛ n ɛ ʃ ɛ n
egyenlőség	ɛ ɟː ɛ n l øː ʃ eː ɡ
egyesek	ɛ ɟː ɛ ʃ ɛ k
egyesülete	ɛ ɟː ɛ ʃ y l ɛ t ɛ
egyesült	ɛ ɟː ɛ ʃ y l t
egyesülés	ɛ ɟː ɛ ʃ y l eː ʃ
egyet	ɛ ɟː ɛ t
egyetemes	ɛ ɟ ɛ t ɛ m ɛ ʃ
egyetemi	ɛ ɟ ɛ t ɛ m i
egyetemisták	ɛ ɟ ɛ t ɛ m i ʃ t aː k
egyetlen	ɛ ɟː ɛ t l ɛ n
egyetért	ɛ ɟː ɛ t eː r t
egyetértés	ɛ ɟː ɛ t eː r t eː ʃ
egyezmény	ɛ ɟː ɛ z m eː ɲ
egyezmények	ɛ ɟː ɛ z m eː ɲ ɛ k
egyezség	ɛ ɟː ɛ ʃː eː ɡ
egyeztetés	ɛ ɟː ɛ s t ɛ t eː ʃ
egyfajta	ɛ c f ɒ j t ɒ
egyfelől	ɛ c f ɛ l øː l
egyház	ɛ c h aː z
egyházak	ɛ c h aː z ɒ k
egyházi	ɛ c h aː z i
egyik	ɛ ɟː i k
egyikben	ɛ ɟː i ɡ b ɛ n
egyike	ɛ ɟː i k ɛ
egyikről	ɛ ɟː i k r øː l
egyikük	ɛ ɟː i k y k
egyiptomi	ɛ ɟ i p t o m i
egyirányú	ɛ ɟː i r aː ɲ uː
egykor	ɛ c k o r
egymilliárd	ɛ ɟ m i lː i j aː r d
egymás	ɛ ɟ m aː ʃ
egymásba	ɛ ɟ m aː ʒ b ɒ
egymásban	ɛ ɟ m aː ʒ b ɒ n
egymáshoz	ɛ ɟ m aː ʃ h o z
egymásnak	ɛ ɟ m aː ʃ n ɒ k
egymásra	ɛ ɟ m aː ʃ r ɒ
egymással	ɛ ɟ m aː ʃː ɒ l
egymást	ɛ ɟ m aː ʃ t
egymástól	ɛ ɟ m aː ʃ t oː l
egymásért	ɛ ɟ m aː ʃ eː r t
egyre	ɛ ɟ r ɛ
egyrészt	ɛ ɟ r eː s t
egyszemélyes	ɛ c s ɛ m eː j ɛ ʃ
egyszerre	ɛ c s ɛ rː ɛ
egyszersmind	ɛ c s ɛ r ʃ m i n d
egyszerű	ɛ c s ɛ r yː
egyszerűen	ɛ c s ɛ r yː ɛ n
egységes	ɛ c ʃ eː ɡ ɛ ʃ
egyáltalán	ɛ ɟː aː l t ɒ l aː n
egyéb	ɛ ɟ eː b
egyébként	ɛ ɟ eː p k eː n t
egyél	ɛ ɟ eː l
egyén	ɛ ɟ eː n
egyének	ɛ ɟ eː n ɛ k
egyéni	ɛ ɟ eː n i
egyénileg	ɛ ɟ eː n i l ɛ ɡ
egyéves	ɛ ɟː eː v ɛ ʃ
egyúttal	ɛ ɟː uː tː ɒ l
együtt	ɛ ɟː y tː
együttes	ɛ ɟː y tː ɛ ʃ
együttese	ɛ ɟː y tː ɛ ʃ ɛ
együttműködve	ɛ ɟː y t m yː k ø d v ɛ
együttműködés	ɛ ɟː y t m yː k ø d eː ʃ
együttműködése	ɛ ɟː y t m yː k ø d eː ʃ ɛ
egész	ɛ ɡ eː s
egészen	ɛ ɡ eː s ɛ n
egészet	ɛ ɡ eː s ɛ t
egészség	ɛ ɡ eː ʃː eː ɡ
egészségbiztosítási	ɛ ɡ eː ʃː eː ɡ b i s t o ʃ iː t aː ʃ i
egészsége	ɛ ɡ eː ʃː eː ɡ ɛ
egészségem	ɛ ɡ eː ʃː eː ɡ ɛ m
egészségesebben	ɛ ɡ eː ʃː eː ɡ ɛ ʃ ɛ bː ɛ n
egészséget	ɛ ɡ eː ʃː eː ɡ ɛ t
egészségünk	ɛ ɡ eː ʃː eː ɡ y ŋ k
egészében	ɛ ɡ eː s eː b ɛ n
egészért	ɛ ɡ eː s eː r t
egészét	ɛ ɡ eː s eː t
egészít	ɛ ɡ eː s iː t
ehetetlen	ɛ h ɛ t ɛ t l ɛ n
ehhez	ɛ h ɛ z
ejt	ɛ j t
ejtsd	ɛ j d͡ʒ d
ekkor	ɛ kː o r
ekék	ɛ k eː k
eközben	ɛ k ø z b ɛ n
el	ɛ l
eladni	ɛ l ɒ d n i
eladás	ɛ l ɒ d aː ʃ
eladási	ɛ l ɒ d aː ʃ i
eladások	ɛ l ɒ d aː ʃ o k
elefánt	ɛ l ɛ f aː n t
elege	ɛ l ɛ ɡ ɛ
elegendő	ɛ l ɛ ɡ ɛ n d øː
eleget	ɛ l ɛ ɡ ɛ t
elegáns	ɛ l ɛ ɡ aː n ʃ
elek	ɛ l ɛ k
elektromos	ɛ l ɛ k t r o m o ʃ
elektromágneses	ɛ l ɛ k t r o m aː ɡ n ɛ ʃ ɛ ʃ
elektronika	ɛ l ɛ k t r o n i k ɒ
elektronikai	ɛ l ɛ k t r o n i k ɒ j i
elektronikus	ɛ l ɛ k t r o n i k u ʃ
elektronok	ɛ l ɛ k t r o n o k
elem	ɛ l ɛ m
eleme	ɛ l ɛ m ɛ
elemek	ɛ l ɛ m ɛ k
elemi	ɛ l ɛ m i
elemzés	ɛ l ɛ m z eː ʃ
elemzése	ɛ l ɛ m z eː ʃ ɛ
elemzések	ɛ l ɛ m z eː ʃ ɛ k
elemző	ɛ l ɛ m z øː
elemzők	ɛ l ɛ m z øː k
elemét	ɛ l ɛ m eː t
elengedhetetlen	ɛ l ɛ ŋ ɡ ɛ t h ɛ t ɛ t l ɛ n
elenyésző	ɛ l ɛ ɲ eː s øː
eleve	ɛ l ɛ v ɛ
elfelejteni	ɛ l f ɛ l ɛ j t ɛ n i
elfogadhatatlan	ɛ l f o ɡ ɒ t h ɒ t ɒ t l ɒ n
elfogadható	ɛ l f o ɡ ɒ t h ɒ t oː
elfogadni	ɛ l f o ɡ ɒ d n i
elfogadta	ɛ l f o ɡ ɒ tː ɒ
elfogadták	ɛ l f o ɡ ɒ tː aː k
elfogatóparancs	ɛ l f o ɡ ɒ t oː p ɒ r ɒ n t͡ʃ
elgondolkodtató	ɛ l ɡ o n d o l k o tː ɒ t oː
elhagyja	ɛ l ɦ ɒ ɟː ɒ
elhanyagolható	ɛ l ɦ ɒ ɲ ɒ ɡ o l ɦ ɒ t oː
elhanyagolt	ɛ l ɦ ɒ ɲ ɒ ɡ o l t
elhelyezni	ɛ l ɦ ɛ j ɛ z n i
elhunyt	ɛ l ɦ u ɲ t
elindulnak	ɛ l i n d u l n ɒ k
elismert	ɛ l i ʃ m ɛ r t
elismerés	ɛ l i ʃ m ɛ r eː ʃ
elismerést	ɛ l i ʃ m ɛ r eː ʃ t
eljuttatni	ɛ jː u tː ɒ t n i
eljárásban	ɛ jː aː r aː ʒ b ɒ n
eljárások	ɛ jː aː r aː ʃ o k
eljárással	ɛ jː aː r aː ʃː ɒ l
eljárást	ɛ jː aː r aː ʃ t
eljáró	ɛ jː aː r oː
elkerülhetetlen	ɛ l k ɛ r y l ɦ ɛ t ɛ t l ɛ n
elkerülhetetlenül	ɛ l k ɛ r y l ɦ ɛ t ɛ t l ɛ n y l
elkerülése	ɛ l k ɛ r y l eː ʃ ɛ
elkezdődik	ɛ l k ɛ z d øː d i k
elképzeltem	ɛ l k eː b z ɛ l t ɛ m
elképzelés	ɛ l k eː b z ɛ l eː ʃ
elképzelések	ɛ l k eː b z ɛ l eː ʃ ɛ k
elkészítése	ɛ l k eː s iː t eː ʃ ɛ
elkészítéséhez	ɛ l k eː s iː t eː ʃ eː ɦ ɛ z
elkészül	ɛ l k eː s y l
elkötelezett	ɛ l k ø t ɛ l ɛ z ɛ tː
elkövetkező	ɛ l k ø v ɛ t k ɛ z øː
elkövető	ɛ l k ø v ɛ t øː
elküldeni	ɛ l k y l d ɛ n i
elkülönített	ɛ l k y l ø n iː t ɛ tː
ellen	ɛ lː ɛ n
ellenben	ɛ lː ɛ m b ɛ n
ellene	ɛ lː ɛ n ɛ
ellenfele	ɛ lː ɛ ɱ f ɛ l ɛ
ellenkezik	ɛ lː ɛ ŋ k ɛ z i k
ellenkező	ɛ lː ɛ ŋ k ɛ z øː
ellent	ɛ lː ɛ n t
ellentmond	ɛ lː ɛ n t m o n d
ellentmondásos	ɛ lː ɛ n t m o n d aː ʃ o ʃ
ellentétben	ɛ lː ɛ n t eː d b ɛ n
ellentétes	ɛ lː ɛ n t eː t ɛ ʃ
ellenállás	ɛ lː ɛ n aː lː aː ʃ
ellenére	ɛ lː ɛ n eː r ɛ
ellenőrizni	ɛ lː ɛ n øː r i z n i
ellenőrzi	ɛ lː ɛ n øː r z i
ellenőrzés	ɛ lː ɛ n øː r z eː ʃ
ellenőrzése	ɛ lː ɛ n øː r z eː ʃ ɛ
ellenőrzések	ɛ lː ɛ n øː r z eː ʃ ɛ k
ellenőrzést	ɛ lː ɛ n øː r z eː ʃ t
ellenőrző	ɛ lː ɛ n øː r z øː
ellátni	ɛ lː aː t n i
ellátott	ɛ lː aː t o tː
ellátás	ɛ lː aː t aː ʃ
ellátását	ɛ lː aː t aː ʃ aː t
elmarad	ɛ l m ɒ r ɒ d
elmaradt	ɛ l m ɒ r ɒ tː
elmegy	ɛ l m ɛ ɟ
elment	ɛ l m ɛ n t
elmondani	ɛ l m o n d ɒ n i
elmondom	ɛ l m o n d o m
elmondása	ɛ l m o n d aː ʃ ɒ
elméleti	ɛ l m eː l ɛ t i
elméletileg	ɛ l m eː l ɛ t i l ɛ ɡ
elmélkedés	ɛ l m eː l k ɛ d eː ʃ
elmúlt	ɛ l m uː l t
elnevezés	ɛ l n ɛ v ɛ z eː ʃ
elnyeri	ɛ l ɲ ɛ r i
elnyomó	ɛ l ɲ o m oː
elnyomók	ɛ l ɲ o m oː k
elnézést	ɛ l n eː z eː ʃ t
elnéző	ɛ l n eː z øː
elnök	ɛ l n ø k
elnöke	ɛ l n ø k ɛ
elnöki	ɛ l n ø k i
elnöksége	ɛ l n ø k ʃ eː ɡ ɛ
elnökségi	ɛ l n ø k ʃ eː ɡ i
elnökének	ɛ l n ø k eː n ɛ k
elnökét	ɛ l n ø k eː t
elnökével	ɛ l n ø k eː v ɛ l
elnököt	ɛ l n ø k ø t
elolvasni	ɛ l o l v ɒ ʃ n i
elrendel	ɛ rː ɛ n d ɛ l
elsajátítása	ɛ l ʃ ɒ j aː t iː t aː ʃ ɒ
elsején	ɛ l ʃ ɛ j eː n
első	ɛ l ʃ øː
elsőbbséget	ɛ l ʃ øː p ʃ eː ɡ ɛ t
elsőben	ɛ l ʃ øː b ɛ n
elsődleges	ɛ l ʃ øː d l ɛ ɡ ɛ ʃ
elsődlegesen	ɛ l ʃ øː d l ɛ ɡ ɛ ʃ ɛ n
elsők	ɛ l ʃ øː k
elsőként	ɛ l ʃ øː k eː n t
elsőnek	ɛ l ʃ øː n ɛ k
elsőre	ɛ l ʃ øː r ɛ
elsősorban	ɛ l ʃ øː ʃ o r b ɒ n
elsőt	ɛ l ʃ øː t
elte	ɛ l t ɛ
elterjedt	ɛ l t ɛ r j ɛ tː
elterjedés	ɛ l t ɛ r j ɛ d eː ʃ
eltér	ɛ l t eː r
eltérés	ɛ l t eː r eː ʃ
eltérő	ɛ l t eː r øː
eltéved	ɛ l t eː v ɛ d
eltűnik	ɛ l t yː n i k
eltűnt	ɛ l t yː n t
elutasító	ɛ l u t ɒ ʃ iː t oː
elv	ɛ l v
elve	ɛ l v ɛ
elven	ɛ l v ɛ n
elveszett	ɛ l v ɛ s ɛ tː
elveszti	ɛ l v ɛ s t i
elvet	ɛ l v ɛ t
elvi	ɛ l v i
elvileg	ɛ l v i l ɛ ɡ
elvtárs	ɛ l f t aː r ʃ
elvtársak	ɛ l f t aː r ʃ ɒ k
elvár	ɛ l v aː r
elvárásai	ɛ l v aː r aː ʃ ɒ j i
elvégezhető	ɛ l v eː ɡ ɛ s h ɛ t øː
elvégre	ɛ l v eː ɡ r ɛ
elvész	ɛ l v eː s
elvétve	ɛ l v eː t v ɛ
elé	ɛ l eː
elég	ɛ l eː ɡ
elégedetlen	ɛ l eː ɡ ɛ d ɛ t l ɛ n
elégedetlenség	ɛ l eː ɡ ɛ d ɛ t l ɛ n ʃ eː ɡ
elégedett	ɛ l eː ɡ ɛ d ɛ tː
eléggé	ɛ l eː ɡː eː
elégséges	ɛ l eː k ʃ eː ɡ ɛ ʃ
elém	ɛ l eː m
elénk	ɛ l eː ŋ k
elér	ɛ l eː r
elérhető	ɛ l eː r ɦ ɛ t øː
elérhetővé	ɛ l eː r ɦ ɛ t øː v eː
elérni	ɛ l eː r n i
elérése	ɛ l eː r eː ʃ ɛ
eléréséhez	ɛ l eː r eː ʃ eː ɦ ɛ z
elöl	ɛ l ø l
elő	ɛ l øː
előadás	ɛ l øː ɒ d aː ʃ
előadása	ɛ l øː ɒ d aː ʃ ɒ
előadásban	ɛ l øː ɒ d aː ʒ b ɒ n
előadások	ɛ l øː ɒ d aː ʃ o k
előadást	ɛ l øː ɒ d aː ʃ t
előadásában	ɛ l øː ɒ d aː ʃ aː b ɒ n
előbb	ɛ l øː bː
előbbi	ɛ l øː bː i
előfizetői	ɛ l øː f i z ɛ t øː j i
előkelő	ɛ l øː k ɛ l øː
előkészítése	ɛ l øː k eː s iː t eː ʃ ɛ
előkészítő	ɛ l øː k eː s iː t øː
elől	ɛ l øː l
előle	ɛ l øː l ɛ
előleg	ɛ l øː l ɛ ɡ
előnye	ɛ l øː ɲ ɛ
előnyeit	ɛ l øː ɲ ɛ j i t
előnytelen	ɛ l øː ɲ t ɛ l ɛ n
előnyös	ɛ l øː ɲ ø ʃ
előnyösebb	ɛ l øː ɲ ø ʃ ɛ bː
előre	ɛ l øː r ɛ
előreláthatólag	ɛ l øː r ɛ l aː t h ɒ t oː l ɒ ɡ
elősegítése	ɛ l øː ʃ ɛ ɡ iː t eː ʃ ɛ
előszeretettel	ɛ l øː s ɛ r ɛ t ɛ tː ɛ l
először	ɛ l øː s ø r
előtte	ɛ l øː tː ɛ
előtti	ɛ l øː tː i
előző	ɛ l øː z øː
előírás	ɛ l øː j iː r aː ʃ
előírások	ɛ l øː j iː r aː ʃ o k
előírásoknak	ɛ l øː j iː r aː ʃ o k n ɒ k
előítélet	ɛ l øː j iː t eː l ɛ t
ember	ɛ m b ɛ r
embere	ɛ m b ɛ r ɛ
emberei	ɛ m b ɛ r ɛ j i
emberi	ɛ m b ɛ r i
emberileg	ɛ m b ɛ r i l ɛ ɡ
eme	ɛ m ɛ
emeleti	ɛ m ɛ l ɛ t i
emeletnyi	ɛ m ɛ l ɛ t ɲ i
emelkedett	ɛ m ɛ l k ɛ d ɛ tː
emelkedik	ɛ m ɛ l k ɛ d i k
emelkedő	ɛ m ɛ l k ɛ d øː
emellett	ɛ m ɛ lː ɛ tː
emelni	ɛ m ɛ l n i
emiatt	ɛ m i j ɒ tː
emigráns	ɛ m i ɡ r aː n ʃ
emil	ɛ m i l
emlék	ɛ m l eː k
emlékek	ɛ m l eː k ɛ k
emléket	ɛ m l eː k ɛ t
emlékezetes	ɛ m l eː k ɛ z ɛ t ɛ ʃ
emlékeztet	ɛ m l eː k ɛ s t ɛ t
emlékeztető	ɛ m l eː k ɛ s t ɛ t øː
emlékezés	ɛ m l eː k ɛ z eː ʃ
emlékszem	ɛ m l eː k s ɛ m
emlékszik	ɛ m l eː k s i k
említést	ɛ m l iː t eː ʃ t
emlő	ɛ m l øː
emésztés	ɛ m eː s t eː ʃ
endre	ɛ n d r ɛ
energia	ɛ n ɛ r ɡ i j ɒ
energiák	ɛ n ɛ r ɡ i j aː k
energiát	ɛ n ɛ r ɡ i j aː t
engedéllyel	ɛ ŋ ɡ ɛ d eː jː ɛ l
engedély	ɛ ŋ ɡ ɛ d eː j
engedélyek	ɛ ŋ ɡ ɛ d eː j ɛ k
engedélyeket	ɛ ŋ ɡ ɛ d eː j ɛ k ɛ t
engedélyével	ɛ ŋ ɡ ɛ d eː j eː v ɛ l
engem	ɛ ŋ ɡ ɛ m
ennek	ɛ nː ɛ k
ennyi	ɛ ɲː i
ennyire	ɛ ɲː i r ɛ
ennyit	ɛ ɲː i t
enné	ɛ nː eː
ennél	ɛ nː eː l
entrópia	ɛ n t r oː p i j ɒ
enyhén	ɛ ɲ ɦ eː n
enyém	ɛ ɲ eː m
epilepsziás	ɛ p i l ɛ p s i j aː ʃ
erdélyi	ɛ r d eː j i
erdészeti	ɛ r d eː s ɛ t i
erdő	ɛ r d øː
erdőbe	ɛ r d øː b ɛ
erdőben	ɛ r d øː b ɛ n
erdők	ɛ r d øː k
erdőkben	ɛ r d øː ɡ b ɛ n
ered	ɛ r ɛ d
eredeti	ɛ r ɛ d ɛ t i
eredetileg	ɛ r ɛ d ɛ t i l ɛ ɡ
eredetű	ɛ r ɛ d ɛ t yː
eredmény	ɛ r ɛ d m eː ɲ
eredménye	ɛ r ɛ d m eː ɲ ɛ
eredmények	ɛ r ɛ d m eː ɲ ɛ k
eredményeket	ɛ r ɛ d m eː ɲ ɛ k ɛ t
eredményeként	ɛ r ɛ d m eː ɲ ɛ k eː n t
eredményes	ɛ r ɛ d m eː ɲ ɛ ʃ
eredményesen	ɛ r ɛ d m eː ɲ ɛ ʃ ɛ n
eredményez	ɛ r ɛ d m eː ɲ ɛ z
eredményre	ɛ r ɛ d m eː ɲ r ɛ
eredményt	ɛ r ɛ d m eː ɲ t
ereklye	ɛ r ɛ k j ɛ
erika	ɛ r i k ɒ
erkel	ɛ r k ɛ l
erkölcsi	ɛ r k ø l t͡ʃ i
erkölcsös	ɛ r k ø l t͡ʃ ø ʃ
erről	ɛ rː øː l
erzsébet	ɛ r ʒ eː b ɛ t
erő	ɛ r øː
erőforrás	ɛ r øː f o rː aː ʃ
erők	ɛ r øː k
erőkkel	ɛ r øː kː ɛ l
erőmű	ɛ r øː m yː
erősebb	ɛ r øː ʃ ɛ bː
erősen	ɛ r øː ʃ ɛ n
erőszak	ɛ r øː s ɒ k
erősíteni	ɛ r øː ʃ iː t ɛ n i
erősítése	ɛ r øː ʃ iː t eː ʃ ɛ
erőt	ɛ r øː t
erőteljes	ɛ r øː t ɛ jː ɛ ʃ
erőteljesen	ɛ r øː t ɛ jː ɛ ʃ ɛ n
erővel	ɛ r øː v ɛ l
esedékes	ɛ ʃ ɛ d eː k ɛ ʃ
esemény	ɛ ʃ ɛ m eː ɲ
események	ɛ ʃ ɛ m eː ɲ ɛ k
eseményt	ɛ ʃ ɛ m eː ɲ t
esetleg	ɛ ʃ ɛ t l ɛ ɡ
esetleges	ɛ ʃ ɛ t l ɛ ɡ ɛ ʃ
esetlegesen	ɛ ʃ ɛ t l ɛ ɡ ɛ ʃ ɛ n
esett	ɛ ʃ ɛ tː
esetében	ɛ ʃ ɛ t eː b ɛ n
esetén	ɛ ʃ ɛ t eː n
eshet	ɛ ʃ h ɛ t
esik	ɛ ʃ i k
esküvői	ɛ ʃ k y v øː j i
esni	ɛ ʃ n i
estek	ɛ ʃ t ɛ k
esten	ɛ ʃ t ɛ n
esterházy	ɛ s t ɛ r ɦ aː z i
esti	ɛ ʃ t i
estig	ɛ ʃ t i ɡ
eszembe	ɛ s ɛ m b ɛ
eszerint	ɛ s ɛ r i n t
eszik	ɛ s i k
eszköz	ɛ s k ø z
eszközeivel	ɛ s k ø z ɛ j i v ɛ l
eszközt	ɛ s k ø s t
eszközzel	ɛ s k ø zː ɛ l
eszközök	ɛ s k ø z ø k
eszközöket	ɛ s k ø z ø k ɛ t
eszmények	ɛ s m eː ɲ ɛ k
esztek	ɛ s t ɛ k
esztendő	ɛ s t ɛ n d øː
esztendős	ɛ s t ɛ n d øː ʃ
eszter	ɛ s t ɛ r
esztergomi	ɛ s t ɛ r ɡ o m i
esztétikus	ɛ s t eː t i k u ʃ
eszébe	ɛ s eː b ɛ
eszünk	ɛ s y ŋ k
eséllyel	ɛ ʃ eː jː ɛ l
esély	ɛ ʃ eː j
esélye	ɛ ʃ eː j ɛ
esélyekkel	ɛ ʃ eː j ɛ kː ɛ l
esélyes	ɛ ʃ eː j ɛ ʃ
esélyt	ɛ ʃ eː j t
eső	ɛ ʃ øː
esős	ɛ ʃ øː ʃ
etnikai	ɛ t n i k ɒ j i
eu	ɛ u
euró	ɛ u r oː
európa	ɛ u r oː p ɒ
európai	ɛ u r oː p ɒ j i
eurót	ɛ u r oː t
evangélikus	ɛ v ɒ ŋ ɡ eː l i k u ʃ
evangélista	ɛ v ɒ ŋ ɡ eː l i ʃ t ɒ
evangélium	ɛ v ɒ ŋ ɡ eː l i j u m
evangéliumok	ɛ v ɒ ŋ ɡ eː l i j u m o k
evezős	ɛ v ɛ z øː ʃ
expedíció	ɛ k s p ɛ d iː t͡s i j oː
export	ɛ k s p o r t
extra	ɛ k s t r ɒ
extrák	ɛ k s t r aː k
ez	ɛ z
ezek	ɛ z ɛ k
ezekbe	ɛ z ɛ ɡ b ɛ
ezekből	ɛ z ɛ ɡ b øː l
ezeken	ɛ z ɛ k ɛ n
ezeket	ɛ z ɛ k ɛ t
ezekkel	ɛ z ɛ kː ɛ l
ezeknek	ɛ z ɛ k n ɛ k
ezeknél	ɛ z ɛ k n eː l
ezektől	ɛ z ɛ k t øː l
ezelőtt	ɛ z ɛ l øː tː
ezen	ɛ z ɛ n
ezenkívül	ɛ z ɛ ŋ k iː v y l
ezentúl	ɛ z ɛ n t uː l
ezer	ɛ z ɛ r
ezernyi	ɛ z ɛ r ɲ i
ezerszer	ɛ z ɛ r s ɛ r
ezoterikus	ɛ z o t ɛ r i k u ʃ
ezred	ɛ z r ɛ d
ezredes	ɛ z r ɛ d ɛ ʃ
ezren	ɛ z r ɛ n
ezres	ɛ z r ɛ ʃ
ezt	ɛ s t
ezzel	ɛ zː ɛ l
ezáltal	ɛ z aː l t ɒ l
ezúttal	ɛ z uː tː ɒ l
ezüst	ɛ z y ʃ t
ezüstérmes	ɛ z y ʃ t eː r m ɛ ʃ
eötvös	ø t v ø ʃ
fa	f ɒ
fajta	f ɒ j t ɒ
fakad	f ɒ k ɒ d
fal	f ɒ l
falat	f ɒ l ɒ t
falevelek	f ɒ l ɛ v ɛ l ɛ k
falra	f ɒ rː ɒ
falu	f ɒ l u
falunk	f ɒ l u ŋ k
falusi	f ɒ l u ʃ i
falvak	f ɒ l v ɒ k
fanatikus	f ɒ n ɒ t i k u ʃ
fantasztikus	f ɒ n t ɒ s t i k u ʃ
fantázia	f ɒ n t aː z i j ɒ
farag	f ɒ r ɒ ɡ
farkát	f ɒ r k aː t
farmerben	f ɒ r m ɛ r b ɛ n
farmon	f ɒ r m o n
fart	f ɒ r t
fasiszta	f ɒ ʃ i s t ɒ
faxon	f ɒ k s o n
fazekas	f ɒ z ɛ k ɒ ʃ
februárban	f ɛ b r u aː r b ɒ n
februártól	f ɛ b r u aː r t oː l
fedél	f ɛ d eː l
fedélzeti	f ɛ d eː l z ɛ t i
fegyver	f ɛ ɟ v ɛ r
fegyverek	f ɛ ɟ v ɛ r ɛ k
fegyvereket	f ɛ ɟ v ɛ r ɛ k ɛ t
fegyveres	f ɛ ɟ v ɛ r ɛ ʃ
fegyvert	f ɛ ɟ v ɛ r t
fehér	f ɛ ɦ eː r
fehérek	f ɛ ɦ eː r ɛ k
fehérjék	f ɛ ɦ eː r j eː k
fej	f ɛ j
fejből	f ɛ j b øː l
feje	f ɛ j ɛ
fejezet	f ɛ j ɛ z ɛ t
fejjel	f ɛ jː ɛ l
fejlemény	f ɛ j l ɛ m eː ɲ
fejleményeket	f ɛ j l ɛ m eː ɲ ɛ k ɛ t
fejleszteni	f ɛ j l ɛ s t ɛ n i
fejlesztés	f ɛ j l ɛ s t eː ʃ
fejlesztése	f ɛ j l ɛ s t eː ʃ ɛ
fejlesztési	f ɛ j l ɛ s t eː ʃ i
fejlesztést	f ɛ j l ɛ s t eː ʃ t
fejlesztésének	f ɛ j l ɛ s t eː ʃ eː n ɛ k
fejlesztői	f ɛ j l ɛ s t øː j i
fejlesztők	f ɛ j l ɛ s t øː k
fejlett	f ɛ j l ɛ tː
fejlődik	f ɛ j l øː d i k
fejlődés	f ɛ j l øː d eː ʃ
fejlődése	f ɛ j l øː d eː ʃ ɛ
fejlődési	f ɛ j l øː d eː ʃ i
fejlődésnek	f ɛ j l øː d eː ʃ n ɛ k
fejlődő	f ɛ j l øː d øː
fejtsék	f ɛ j t͡ʃ eː k
fejébe	f ɛ j eː b ɛ
fejében	f ɛ j eː b ɛ n
fejér	f ɛ j eː r
fejét	f ɛ j eː t
fejünk	f ɛ j y ŋ k
fekete	f ɛ k ɛ t ɛ
fekszik	f ɛ k s i k
fekvés	f ɛ k v eː ʃ
fekvő	f ɛ k v øː
fel	f ɛ l
feladat	f ɛ l ɒ d ɒ t
feladata	f ɛ l ɒ d ɒ t ɒ
feladatai	f ɛ l ɒ d ɒ t ɒ j i
feladatnak	f ɛ l ɒ d ɒ t n ɒ k
feladatok	f ɛ l ɒ d ɒ t o k
feladatokat	f ɛ l ɒ d ɒ t o k ɒ t
feladatot	f ɛ l ɒ d ɒ t o t
feladatát	f ɛ l ɒ d ɒ t aː t
feladók	f ɛ l ɒ d oː k
felbontás	f ɛ l b o n t aː ʃ
felbukkanó	f ɛ l b u kː ɒ n oː
feldobja	f ɛ l d o b j ɒ
feldolgozása	f ɛ l d o l ɡ o z aː ʃ ɒ
feldolgozó	f ɛ l d o l ɡ o z oː
fele	f ɛ l ɛ
feledjük	f ɛ l ɛ ɟː y k
felejthető	f ɛ l ɛ j t h ɛ t øː
felek	f ɛ l ɛ k
felelős	f ɛ l ɛ l øː ʃ
felelősek	f ɛ l ɛ l øː ʃ ɛ k
felelősség	f ɛ l ɛ l øː ʃː eː ɡ
felelősséget	f ɛ l ɛ l øː ʃː eː ɡ ɛ t
felelősséggel	f ɛ l ɛ l øː ʃː eː ɡː ɛ l
felelősségre	f ɛ l ɛ l øː ʃː eː ɡ r ɛ
felelősségtudat	f ɛ l ɛ l øː ʃː eː k t u d ɒ t
felelősségét	f ɛ l ɛ l øː ʃː eː ɡ eː t
felesleges	f ɛ l ɛ ʃ l ɛ ɡ ɛ ʃ
feleség	f ɛ l ɛ ʃ eː ɡ
feleségem	f ɛ l ɛ ʃ eː ɡ ɛ m
felet	f ɛ l ɛ t
felett	f ɛ l ɛ tː
feletti	f ɛ l ɛ tː i
felfedezni	f ɛ l f ɛ d ɛ z n i
felfedezés	f ɛ l f ɛ d ɛ z eː ʃ
felfedezők	f ɛ l f ɛ d ɛ z øː k
felhasználható	f ɛ l ɦ ɒ s n aː l ɦ ɒ t oː
felhasználni	f ɛ l ɦ ɒ s n aː l n i
felhasználva	f ɛ l ɦ ɒ s n aː l v ɒ
felhasználás	f ɛ l ɦ ɒ s n aː l aː ʃ
felhasználásra	f ɛ l ɦ ɒ s n aː l aː ʃ r ɒ
felhasználó	f ɛ l ɦ ɒ s n aː l oː
felhasználók	f ɛ l ɦ ɒ s n aː l oː k
felhasználóknak	f ɛ l ɦ ɒ s n aː l oː k n ɒ k
felhők	f ɛ l ɦ øː k
felhőszakadás	f ɛ l ɦ øː s ɒ k ɒ d aː ʃ
felirat	f ɛ l i r ɒ t
feliratok	f ɛ l i r ɒ t o k
felismerhető	f ɛ l i ʃ m ɛ r ɦ ɛ t øː
felismerés	f ɛ l i ʃ m ɛ r eː ʃ
felkavaró	f ɛ l k ɒ v ɒ r oː
felkelés	f ɛ l k ɛ l eː ʃ
felkészült	f ɛ l k eː s y l t
felkészülés	f ɛ l k eː s y l eː ʃ
felkészülést	f ɛ l k eː s y l eː ʃ t
fellépés	f ɛ lː eː p eː ʃ
felmelegedés	f ɛ l m ɛ l ɛ ɡ ɛ d eː ʃ
felmérés	f ɛ l m eː r eː ʃ
felmérések	f ɛ l m eː r eː ʃ ɛ k
felnőtt	f ɛ l n øː tː
felosztás	f ɛ l o s t aː ʃ
felszerelve	f ɛ l s ɛ r ɛ l v ɛ
felszerelés	f ɛ l s ɛ r ɛ l eː ʃ
felszállás	f ɛ l s aː lː aː ʃ
felszálló	f ɛ l s aː lː oː
felszíne	f ɛ l s iː n ɛ
felszínes	f ɛ l s iː n ɛ ʃ
felszíni	f ɛ l s iː n i
felszínén	f ɛ l s iː n eː n
felső	f ɛ l ʃ øː
felsőbb	f ɛ l ʃ øː bː
felsőoktatás	f ɛ l ʃ øː o k t ɒ t aː ʃ
felsőoktatási	f ɛ l ʃ øː o k t ɒ t aː ʃ i
feltalálja	f ɛ l t ɒ l aː jː ɒ
feltárt	f ɛ l t aː r t
feltárás	f ɛ l t aː r aː ʃ
feltárása	f ɛ l t aː r aː ʃ ɒ
feltétele	f ɛ l t eː t ɛ l ɛ
feltételek	f ɛ l t eː t ɛ l ɛ k
feltételeknek	f ɛ l t eː t ɛ l ɛ k n ɛ k
feltételez	f ɛ l t eː t ɛ l ɛ z
feltételezések	f ɛ l t eː t ɛ l ɛ z eː ʃ ɛ k
feltétlenül	f ɛ l t eː t l ɛ n y l
feltüntetett	f ɛ l t y n t ɛ t ɛ tː
feltüntetni	f ɛ l t y n t ɛ t n i
feltüntetésével	f ɛ l t y n t ɛ t eː ʃ eː v ɛ l
felvenni	f ɛ l v ɛ nː i
felvesz	f ɛ l v ɛ s
felvilágosítást	f ɛ l v i l aː ɡ o ʃ iː t aː ʃ t
felváltva	f ɛ l v aː l t v ɒ
felvétele	f ɛ l v eː t ɛ l ɛ
felvételek	f ɛ l v eː t ɛ l ɛ k
felvételeket	f ɛ l v eː t ɛ l ɛ k ɛ t
felvételi	f ɛ l v eː t ɛ l i
felvételt	f ɛ l v eː t ɛ l t
felállított	f ɛ l aː lː iː t o tː
felé	f ɛ l eː
felére	f ɛ l eː r ɛ
felét	f ɛ l eː t
felújított	f ɛ l uː j iː t o tː
felül	f ɛ l y l
felület	f ɛ l y l ɛ t
felületen	f ɛ l y l ɛ t ɛ n
felületet	f ɛ l y l ɛ t ɛ t
felületi	f ɛ l y l ɛ t i
felüli	f ɛ l y l i
felüljáró	f ɛ l y jː aː r oː
felülvizsgálat	f ɛ l y l v i ʒ ɡ aː l ɒ t
felől	f ɛ l øː l
fenn	f ɛ nː
fennhangon	f ɛ n ɦ ɒ ŋ ɡ o n
fenntartani	f ɛ n t ɒ r t ɒ n i
fenntartható	f ɛ n t ɒ r t h ɒ t oː
fenntartva	f ɛ n t ɒ r t v ɒ
fenségesebb	f ɛ n ʃ eː ɡ ɛ ʃ ɛ bː
fent	f ɛ n t
fentebb	f ɛ n t ɛ bː
fenyegető	f ɛ ɲ ɛ ɡ ɛ t øː
ferenc	f ɛ r ɛ n t͡s
feri	f ɛ r i
fertő	f ɛ r t øː
fest	f ɛ ʃ t
festetek	f ɛ ʃ t ɛ t ɛ k
festett	f ɛ ʃ t ɛ tː
festmény	f ɛ ʃ t m eː ɲ
festő	f ɛ ʃ t øː
feszes	f ɛ s ɛ ʃ
fesztivál	f ɛ s t i v aː l
fesztiválok	f ɛ s t i v aː l o k
fesztiválon	f ɛ s t i v aː l o n
fesztivált	f ɛ s t i v aː l t
feszült	f ɛ s y l t
fia	f i j ɒ
fiam	f i j ɒ m
fiatal	f i j ɒ t ɒ l
fiatalok	f i j ɒ t ɒ l o k
fiatalokat	f i j ɒ t ɒ l o k ɒ t
fiataloknak	f i j ɒ t ɒ l o k n ɒ k
fidesz	f i d ɛ s
fideszes	f i d ɛ s ɛ ʃ
figurát	f i ɡ u r aː t
figyelem	f i ɟ ɛ l ɛ m
figyelembe	f i ɟ ɛ l ɛ m b ɛ
figyelemmel	f i ɟ ɛ l ɛ mː ɛ l
figyelemre	f i ɟ ɛ l ɛ m r ɛ
figyelj	f i ɟ ɛ jː
figyelmet	f i ɟ ɛ l m ɛ t
figyelmeztet	f i ɟ ɛ l m ɛ s t ɛ t
figyelmébe	f i ɟ ɛ l m eː b ɛ
figyelmét	f i ɟ ɛ l m eː t
fikció	f i k t͡s i j oː
filiszteus	f i l i s t ɛ u ʃ
film	f i l m
filmben	f i l m b ɛ n
filmek	f i l m ɛ k
filmeket	f i l m ɛ k ɛ t
filmekre	f i l m ɛ k r ɛ
filmen	f i l m ɛ n
filmgyártás	f i l m ɟ aː r t aː ʃ
filmje	f i l m j ɛ
filmmel	f i l m ɛ l
filmnek	f i l m n ɛ k
filmrendező	f i l m r ɛ n d ɛ z øː
filmről	f i l m r øː l
filozófiai	f i l o z oː f i j ɒ j i
finanszírozott	f i n ɒ n s iː r o z o tː
finn	f i nː
finnek	f i nː ɛ k
finom	f i n o m
finomabb	f i n o m ɒ bː
finoman	f i n o m ɒ n
fischer	f i ʃ ɛ r
fix	f i k s
fizetett	f i z ɛ t ɛ tː
fizetni	f i z ɛ t n i
fizetési	f i z ɛ t eː ʃ i
fizető	f i z ɛ t øː
fizikai	f i z i k ɒ j i
fizikailag	f i z i k ɒ j i l ɒ ɡ
fiának	f i j aː n ɒ k
fiók	f i j oː k
fiókok	f i j oː k o k
foci	f o t͡s i
fodor	f o d o r
fog	f o ɡ
fogadó	f o ɡ ɒ d oː
fogakat	f o ɡ ɒ k ɒ t
fogalma	f o ɡ ɒ l m ɒ
fogalmaink	f o ɡ ɒ l m ɒ j i ŋ k
fogalmam	f o ɡ ɒ l m ɒ m
fogalmaz	f o ɡ ɒ l m ɒ z
fogalmának	f o ɡ ɒ l m aː n ɒ k
fogalmát	f o ɡ ɒ l m aː t
fogható	f o k h ɒ t oː
fogja	f o ɡ j ɒ
fogják	f o ɡ j aː k
foglalkozik	f o ɡ l ɒ l k o z i k
foglalkozni	f o ɡ l ɒ l k o z n i
foglalkoztató	f o ɡ l ɒ l k o s t ɒ t oː
foglalkozás	f o ɡ l ɒ l k o z aː ʃ
foglalkozó	f o ɡ l ɒ l k o z oː
foglaltak	f o ɡ l ɒ l t ɒ k
foglalás	f o ɡ l ɒ l aː ʃ
fogna	f o ɡ n ɒ
fognak	f o ɡ n ɒ k
fogni	f o ɡ n i
fogok	f o ɡ o k
fogoly	f o ɡ o j
fogom	f o ɡ o m
fogsz	f o k s
fogtam	f o k t ɒ m
fogunk	f o ɡ u ŋ k
fogva	f o ɡ v ɒ
fogvatartott	f o ɡ v ɒ t ɒ r t o tː
fogyasztási	f o ɟ ɒ s t aː ʃ i
fogyasztók	f o ɟ ɒ s t oː k
fogyasztóvédelem	f o ɟ ɒ s t oː v eː d ɛ l ɛ m
fogyatékos	f o ɟ ɒ t eː k o ʃ
fogyó	f o ɟ oː
fogások	f o ɡ aː ʃ o k
fogászat	f o ɡ aː s ɒ t
fok	f o k
fokkal	f o kː ɒ l
fokon	f o k o n
fokozatosan	f o k o z ɒ t o ʃ ɒ n
fokozott	f o k o z o tː
fokozottan	f o k o z o tː ɒ n
foltok	f o l t o k
folyadék	f o j ɒ d eː k
folyamat	f o j ɒ m ɒ t
folyamatban	f o j ɒ m ɒ d b ɒ n
folyamatnak	f o j ɒ m ɒ t n ɒ k
folyamatok	f o j ɒ m ɒ t o k
folyamaton	f o j ɒ m ɒ t o n
folyamatosan	f o j ɒ m ɒ t o ʃ ɒ n
folyamatot	f o j ɒ m ɒ t o t
folyik	f o j i k
folyosón	f o j o ʃ oː n
folyt	f o j t
folytat	f o j t ɒ t
folytatni	f o j t ɒ t n i
folytatás	f o j t ɒ t aː ʃ
folytatása	f o j t ɒ t aː ʃ ɒ
folytató	f o j t ɒ t oː
folytatódik	f o j t ɒ t oː d i k
folytonos	f o j t o n o ʃ
folytán	f o j t aː n
folyóirat	f o j oː j i r ɒ t
font	f o n t
fontos	f o n t o ʃ
fontosabb	f o n t o ʃ ɒ bː
fontosnak	f o n t o ʃ n ɒ k
fontosságát	f o n t o ʃː aː ɡ aː t
fordulat	f o r d u l ɒ t
fordulhat	f o r d u l ɦ ɒ t
forduló	f o r d u l oː
fordulóban	f o r d u l oː b ɒ n
fordítani	f o r d iː t ɒ n i
fordítható	f o r d iː t h ɒ t oː
fordítja	f o r d iː cː ɒ
fordított	f o r d iː t o tː
fordítva	f o r d iː t v ɒ
fordítást	f o r d iː t aː ʃ t
forgalmas	f o r ɡ ɒ l m ɒ ʃ
forgalmat	f o r ɡ ɒ l m ɒ t
forgalmi	f o r ɡ ɒ l m i
forgalom	f o r ɡ ɒ l o m
forint	f o r i n t
forintba	f o r i n d b ɒ
forintos	f o r i n t o ʃ
forintot	f o r i n t o t
forintra	f o r i n t r ɒ
forinttal	f o r i n t ɒ l
forintért	f o r i n t eː r t
forma	f o r m ɒ
formai	f o r m ɒ j i
formába	f o r m aː b ɒ
formában	f o r m aː b ɒ n
formális	f o r m aː l i ʃ
forog	f o r o ɡ
forradalmi	f o rː ɒ d ɒ l m i
forradalmár	f o rː ɒ d ɒ l m aː r
forradalom	f o rː ɒ d ɒ l o m
forrás	f o rː aː ʃ
forráskódú	f o rː aː ʃ k oː d uː
források	f o rː aː ʃ o k
forrásokat	f o rː aː ʃ o k ɒ t
forrásokból	f o rː aː ʃ o ɡ b oː l
fotó	f o t oː
fotók	f o t oː k
fotós	f o t oː ʃ
fotót	f o t oː t
frakció	f r ɒ k t͡s i j oː
frakciók	f r ɒ k t͡s i j oː k
francia	f r ɒ n t͡s i j ɒ
franciaország	f r ɒ n t͡s i j ɒ o r s aː ɡ
franciaországban	f r ɒ n t͡s i j ɒ o r s aː ɡ b ɒ n
franciák	f r ɒ n t͡s i j aː k
friss	f r i ʃː
front	f r o n t
fronton	f r o n t o n
ft	f o r i n t
fundamentális	f u n d ɒ m ɛ n t aː l i ʃ
funkció	f u ŋ k t͡s i j oː
funkciója	f u ŋ k t͡s i j oː j ɒ
funkciók	f u ŋ k t͡s i j oː k
fura	f u r ɒ
furcsa	f u r t͡ʃ ɒ
fut	f u t
futnak	f u t n ɒ k
futás	f u t aː ʃ
futótűzként	f u t oː t yː s k eː n t
fából	f aː b oː l
fáitok	f aː j i t o k
fájdalmas	f aː j d ɒ l m ɒ ʃ
fájó	f aː j oː
fáradt	f aː r ɒ tː
fáraó	f aː r ɒ oː
fázisban	f aː z i ʒ b ɒ n
fél	f eː l
félelem	f eː l ɛ l ɛ m
félidő	f eː l i d øː
félig	f eː l i ɡ
félnek	f eː l n ɛ k
féltékenység	f eː l t eː k ɛ ɲ ʃ eː ɡ
félvér	f eː l v eː r
félév	f eː l eː v
félévben	f eː l eː v b ɛ n
féléves	f eː l eː v ɛ ʃ
félévében	f eː l eː v eː b ɛ n
fényes	f eː ɲ ɛ ʃ
fényforrások	f eː ɲ f o rː aː ʃ o k
fénykép	f eː ɲ k eː p
fényképek	f eː ɲ k eː p ɛ k
fényképezőgép	f eː ɲ k eː p ɛ z øː ɡ eː p
fényképezőgépek	f eː ɲ k eː p ɛ z øː ɡ eː p ɛ k
fényképész	f eː ɲ k eː p eː s
fér	f eː r
féreg	f eː r ɛ ɡ
férfi	f eː r f i
férfiak	f eː r f i j ɒ k
férfinak	f eː r f i n ɒ k
férfit	f eː r f i t
férgek	f eː r ɡ ɛ k
férjem	f eː r j ɛ m
fórum	f oː r u m
fóruma	f oː r u m ɒ
fórumok	f oː r u m o k
fórumokat	f oː r u m o k ɒ t
fórumon	f oː r u m o n
fórumot	f oː r u m o t
föl	f ø l
föld	f ø l d
földek	f ø l d ɛ k
földes	f ø l d ɛ ʃ
földet	f ø l d ɛ t
földi	f ø l d i
földművelésügyi	f ø l d m yː v ɛ l eː ʃ y ɟ i
földre	f ø l d r ɛ
földrengés	f ø l d r ɛ ŋ ɡ eː ʃ
földterület	f ø l t ɛ r y l ɛ t
földtől	f ø l t øː l
földön	f ø l d ø n
fölé	f ø l eː
fölösleges	f ø l ø ʃ l ɛ ɡ ɛ ʃ
fölött	f ø l ø tː
fölötte	f ø l ø tː ɛ
fölötti	f ø l ø tː i
fú	f uː
független	f y ɡː ɛ t l ɛ n
függetlenség	f y ɡː ɛ t l ɛ n ʃ eː ɡ
függetlenül	f y ɡː ɛ t l ɛ n y l
függvénye	f y ɡ v eː ɲ ɛ
függvényében	f y ɡ v eː ɲ eː b ɛ n
függő	f y ɡː øː
függően	f y ɡː øː ɛ n
függőleges	f y ɡː øː l ɛ ɡ ɛ ʃ
függőlegesen	f y ɡː øː l ɛ ɡ ɛ ʃ ɛ n
fülekre	f y l ɛ k r ɛ
fürdés	f y r d eː ʃ
fürdőruha	f y r d øː r u ɦ ɒ
fürdőszoba	f y r d øː s o b ɒ
fürj	f y r ʝ
füttyel	f y cː ɛ l
füves	f y v ɛ ʃ
fő	f øː
főbb	f øː bː
főigazgató	f øː j i ɡ ɒ z ɡ ɒ t oː
főiskolai	f øː j i ʃ k o l ɒ j i
főként	f øː k eː n t
főleg	f øː l ɛ ɡ
főn	f øː n
főnél	f øː n eː l
főpolgármester	f øː p o l ɡ aː r m ɛ ʃ t ɛ r
főszerep	f øː s ɛ r ɛ p
főszerkesztő	f øː s ɛ r k ɛ s t øː
főszerkesztője	f øː s ɛ r k ɛ s t øː j ɛ
főt	f øː t
főtitkár	f øː t i t k aː r
főtér	f øː t eː r
fővel	f øː v ɛ l
főváros	f øː v aː r o ʃ
fővárosban	f øː v aː r o ʒ b ɒ n
fővárosi	f øː v aː r o ʃ i
főzni	f øː z n i
főút	f øː uː t
fű	f yː
fűnek	f yː n ɛ k
fűszer	f yː s ɛ r
fűz	f yː z
fűződik	f yː z øː d i k
galéria	ɡ ɒ l eː r i j ɒ
galériában	ɡ ɒ l eː r i j aː b ɒ n
gamma	ɡ ɒ mː ɒ
garázsban	ɡ ɒ r aː ʒ b ɒ n
gazda	ɡ ɒ z d ɒ
gazdag	ɡ ɒ z d ɒ ɡ
gazdagabb	ɡ ɒ z d ɒ ɡ ɒ bː
gazdagság	ɡ ɒ z d ɒ k ʃ aː ɡ
gazdaság	ɡ ɒ z d ɒ ʃ aː ɡ
gazdasági	ɡ ɒ z d ɒ ʃ aː ɡ i
gazdaságos	ɡ ɒ z d ɒ ʃ aː ɡ o ʃ
gazdaságot	ɡ ɒ z d ɒ ʃ aː ɡ o t
gazdák	ɡ ɒ z d aː k
gazdálkodás	ɡ ɒ z d aː l k o d aː ʃ
gazember	ɡ ɒ z ɛ m b ɛ r
generáció	ɡ ɛ n ɛ r aː t͡s i j oː
generációk	ɡ ɛ n ɛ r aː t͡s i j oː k
generációs	ɡ ɛ n ɛ r aː t͡s i j oː ʃ
geometria	ɡ ɛ o m ɛ t r i j ɒ
gergely	ɡ ɛ r ɡ ɛ j
gida	ɡ i d ɒ
gimnázium	ɡ i m n aː z i j u m
gimnáziumi	ɡ i m n aː z i j u m i
gimnáziumok	ɡ i m n aː z i j u m o k
gitár	ɡ i t aː r
gitáros	ɡ i t aː r o ʃ
golyó	ɡ o j oː
golyók	ɡ o j oː k
gomb	ɡ o m b
gond	ɡ o n d
gonddal	ɡ o n d ɒ l
gondok	ɡ o n d o k
gondokat	ɡ o n d o k ɒ t
gondol	ɡ o n d o l
gondolat	ɡ o n d o l ɒ t
gondolata	ɡ o n d o l ɒ t ɒ
gondolatait	ɡ o n d o l ɒ t ɒ j i t
gondolati	ɡ o n d o l ɒ t i
gondolatok	ɡ o n d o l ɒ t o k
gondolatokat	ɡ o n d o l ɒ t o k ɒ t
gondolatot	ɡ o n d o l ɒ t o t
gondolattal	ɡ o n d o l ɒ tː ɒ l
gondolja	ɡ o n d o jː ɒ
gondolják	ɡ o n d o jː aː k
gondolkodó	ɡ o n d o l k o d oː
gondolni	ɡ o n d o l n i
gondolod	ɡ o n d o l o d
gondolok	ɡ o n d o l o k
gondolom	ɡ o n d o l o m
gondoltam	ɡ o n d o l t ɒ m
gondolunk	ɡ o n d o l u ŋ k
gondos	ɡ o n d o ʃ
gondosan	ɡ o n d o ʃ ɒ n
gondoskodik	ɡ o n d o ʃ k o d i k
gondoskodni	ɡ o n d o ʃ k o d n i
gondot	ɡ o n d o t
gondozott	ɡ o n d o z o tː
gondterhelt	ɡ o n t ɛ r ɦ ɛ l t
gonosz	ɡ o n o s
grafikai	ɡ r ɒ f i k ɒ j i
grafikus	ɡ r ɒ f i k u ʃ
gratulálok	ɡ r ɒ t u l aː l o k
gravitációs	ɡ r ɒ v i t aː t͡s i j oː ʃ
gráf	ɡ r aː f
gróf	ɡ r oː f
grófnő	ɡ r oː f n øː
grúz	ɡ r uː z
gulyás	ɡ u j aː ʃ
gumik	ɡ u m i k
gusztustalan	ɡ u s t u ʃ t ɒ l ɒ n
guta	ɡ u t ɒ
gyakori	ɟ ɒ k o r i
gyakoribb	ɟ ɒ k o r i bː
gyakorlata	ɟ ɒ k o r l ɒ t ɒ
gyakorlati	ɟ ɒ k o r l ɒ t i
gyakorlatilag	ɟ ɒ k o r l ɒ t i l ɒ ɡ
gyakorlása	ɟ ɒ k o r l aː ʃ ɒ
gyakorol	ɟ ɒ k o r o l
gyakorolni	ɟ ɒ k o r o l n i
gyakrabban	ɟ ɒ k r ɒ bː ɒ n
gyanúja	ɟ ɒ n uː j ɒ
gyanús	ɟ ɒ n uː ʃ
gyanúsított	ɟ ɒ n uː ʃ iː t o tː
gyenge	ɟ ɛ ŋ ɡ ɛ
gyengébb	ɟ ɛ ŋ ɡ eː bː
gyengül	ɟ ɛ ŋ ɡ y l
gyerek	ɟ ɛ r ɛ k
gyerekcipőben	ɟ ɛ r ɛ k t͡s i p øː b ɛ n
gyereke	ɟ ɛ r ɛ k ɛ
gyerekek	ɟ ɛ r ɛ k ɛ k
gyerekekkel	ɟ ɛ r ɛ k ɛ kː ɛ l
gyereket	ɟ ɛ r ɛ k ɛ t
gyermek	ɟ ɛ r m ɛ k
gyermeke	ɟ ɛ r m ɛ k ɛ
gyermekek	ɟ ɛ r m ɛ k ɛ k
gyermekeket	ɟ ɛ r m ɛ k ɛ k ɛ t
gyermeket	ɟ ɛ r m ɛ k ɛ t
gyermeki	ɟ ɛ r m ɛ k i
gyermekkori	ɟ ɛ r m ɛ kː o r i
gyermekorvos	ɟ ɛ r m ɛ k o r v o ʃ
gyermekotthon	ɟ ɛ r m ɛ k o t h o n
gyermekvédelem	ɟ ɛ r m ɛ k v eː d ɛ l ɛ m
gyermekvédelmi	ɟ ɛ r m ɛ k v eː d ɛ l m i
gyermekét	ɟ ɛ r m ɛ k eː t
gyilkos	ɟ i l k o ʃ
gyors	ɟ o r ʃ
gyorsabb	ɟ o r ʃ ɒ bː
gyorsabban	ɟ o r ʃ ɒ bː ɒ n
gyorsan	ɟ o r ʃ ɒ n
gyorshajtás	ɟ o r ʃ h ɒ j t aː ʃ
gyula	ɟ u l ɒ
gyár	ɟ aː r
gyártás	ɟ aː r t aː ʃ
gyártó	ɟ aː r t oː
gyártók	ɟ aː r t oː k
gyász	ɟ aː s
gyógyszeres	ɟ oː c s ɛ r ɛ ʃ
gyógyszeripar	ɟ oː c s ɛ r i p ɒ r
gyógyszerész	ɟ oː c s ɛ r eː s
gyógyászati	ɟ oː ɟ aː s ɒ t i
gyönge	ɟ ø ŋ ɡ ɛ
gyönyörű	ɟ ø ɲ ø r yː
györgy	ɟ ø r ɟ
gyülekezet	ɟ y l ɛ k ɛ z ɛ t
gyülekezeti	ɟ y l ɛ k ɛ z ɛ t i
gyümölcsök	ɟ y m ø l t͡ʃ ø k
gyümölcsöt	ɟ y m ø l t͡ʃ ø t
győr	ɟ øː r
győrben	ɟ øː r b ɛ n
győztes	ɟ øː s t ɛ ʃ
győzött	ɟ øː z ø tː
gyűjteményben	ɟ yː j t ɛ m eː ɲ b ɛ n
gyűjteménye	ɟ yː j t ɛ m eː ɲ ɛ
gyűjtő	ɟ yː j t øː
gyűlt	ɟ yː l t
gyűlölködő	ɟ yː l ø l k ø d øː
gyűlölködőbb	ɟ yː l ø l k ø d øː bː
gyűrűs	ɟ yː r yː ʃ
gágog	ɡ aː ɡ o ɡ
gárda	ɡ aː r d ɒ
gáspár	ɡ aː ʃ p aː r
gátló	ɡ aː t l oː
gép	ɡ eː p
gépek	ɡ eː p ɛ k
gépen	ɡ eː p ɛ n
gépi	ɡ eː p i
gépkocsi	ɡ eː p k o t͡ʃ i
gésák	ɡ eː ʃ aː k
géza	ɡ eː z ɒ
gól	ɡ oː l
góllal	ɡ oː lː ɒ l
gólt	ɡ oː l t
görcs	ɡ ø r t͡ʃ
görcsök	ɡ ø r t͡ʃ ø k
görög	ɡ ø r ø ɡ
görögök	ɡ ø r ø ɡ ø k
ha	h ɒ
habár	h ɒ b aː r
hada	h ɒ d ɒ
hadjárat	h ɒ d j aː r ɒ t
hadsereg	h ɒ t͡ʃː ɛ r ɛ ɡ
hadseregek	h ɒ t͡ʃː ɛ r ɛ ɡ ɛ k
hagyhat	h ɒ c h ɒ t
hagyja	h ɒ ɟː ɒ
hagyjuk	h ɒ ɟː u k
hagyják	h ɒ ɟː aː k
hagyjátok	h ɒ ɟː aː t o k
hagyma	h ɒ ɟ m ɒ
hagyni	h ɒ ɟ n i
hagynia	h ɒ ɟ n i j ɒ
hagynom	h ɒ ɟ n o m
hagynák	h ɒ ɟ n aː k
hagyom	h ɒ ɟ o m
hagyomány	h ɒ ɟ o m aː ɲ
hagyománya	h ɒ ɟ o m aː ɲ ɒ
hagyományai	h ɒ ɟ o m aː ɲ ɒ j i
hagyományokkal	h ɒ ɟ o m aː ɲ o kː ɒ l
hagyott	h ɒ ɟ o tː
hagyta	h ɒ c t ɒ
hagytak	h ɒ c t ɒ k
hagyták	h ɒ c t aː k
hajdani	h ɒ j d ɒ n i
hajlam	h ɒ j l ɒ m
hajlamos	h ɒ j l ɒ m o ʃ
hajlandó	h ɒ j l ɒ n d oː
hajléktalanok	h ɒ j l eː k t ɒ l ɒ n o k
hajnalban	h ɒ j n ɒ l b ɒ n
hajnali	h ɒ j n ɒ l i
hajszálak	h ɒ j s aː l ɒ k
hajt	h ɒ j t
hajó	h ɒ j oː
hajón	h ɒ j oː n
hajóra	h ɒ j oː r ɒ
hajótörést	h ɒ j oː t ø r eː ʃ t
halad	h ɒ l ɒ d
haladnak	h ɒ l ɒ d n ɒ k
halak	h ɒ l ɒ k
halhat	h ɒ l ɦ ɒ t
halk	h ɒ l k
hallgat	h ɒ l ɡ ɒ t
hallgató	h ɒ l ɡ ɒ t oː
hallgatók	h ɒ l ɡ ɒ t oː k
hallható	h ɒ l ɦ ɒ t oː
hallja	h ɒ jː ɒ
halljuk	h ɒ jː u k
hallják	h ɒ jː aː k
hallom	h ɒ lː o m
hallott	h ɒ lː o tː
hallottam	h ɒ lː o tː ɒ m
halott	h ɒ l o tː
halottak	h ɒ l o tː ɒ k
halotti	h ɒ l o tː i
halt	h ɒ l t
haltak	h ɒ l t ɒ k
halál	h ɒ l aː l
halála	h ɒ l aː l ɒ
halállal	h ɒ l aː lː ɒ l
halálos	h ɒ l aː l o ʃ
halálra	h ɒ l aː rː ɒ
halálát	h ɒ l aː l aː t
hamar	h ɒ m ɒ r
hamarosan	h ɒ m ɒ r o ʃ ɒ n
hamis	h ɒ m i ʃ
hamisan	h ɒ m i ʃ ɒ n
hamisítás	h ɒ m i ʃ iː t aː ʃ
hamupipőke	h ɒ m u p i p øː k ɛ
hanem	h ɒ n ɛ m
hang	h ɒ ŋ ɡ
hanggal	h ɒ ŋ ɡ ɒ l
hangja	h ɒ ŋ ɡ j ɒ
hangok	h ɒ ŋ ɡ o k
hangokat	h ɒ ŋ ɡ o k ɒ t
hangos	h ɒ ŋ ɡ o ʃ
hangosabb	h ɒ ŋ ɡ o ʃ ɒ bː
hangot	h ɒ ŋ ɡ o t
hangszer	h ɒ ŋ k s ɛ r
hangszerek	h ɒ ŋ k s ɛ r ɛ k
hangsúlyt	h ɒ ŋ k ʃ uː j t
hangzik	h ɒ ŋ ɡ z i k
hanyatlás	h ɒ ɲ ɒ t l aː ʃ
harang	h ɒ r ɒ ŋ ɡ
harangok	h ɒ r ɒ ŋ ɡ o k
harcos	h ɒ r t͡s o ʃ
harcot	h ɒ r t͡s o t
hardver	h ɒ r d v ɛ r
hargita	h ɒ r ɡ i t ɒ
harmadik	h ɒ r m ɒ d i k
harminc	h ɒ r m i n t͡s
harmonikus	h ɒ r m o n i k u ʃ
hasa	h ɒ ʃ ɒ
hasadék	h ɒ ʃ ɒ d eː k
hasonlít	h ɒ ʃ o n l iː t
hasonló	h ɒ ʃ o n l oː
hasonlóan	h ɒ ʃ o n l oː ɒ n
hasznos	h ɒ s n o ʃ
hasznosítás	h ɒ s n o ʃ iː t aː ʃ
használ	h ɒ s n aː l
használat	h ɒ s n aː l ɒ t
használhat	h ɒ s n aː l ɦ ɒ t
használható	h ɒ s n aː l ɦ ɒ t oː
használhatóak	h ɒ s n aː l ɦ ɒ t oː ɒ k
használja	h ɒ s n aː jː ɒ
használják	h ɒ s n aː jː aː k
használni	h ɒ s n aː l n i
használom	h ɒ s n aː l o m
használt	h ɒ s n aː l t
használták	h ɒ s n aː l t aː k
hasznára	h ɒ s n aː r ɒ
haszon	h ɒ s o n
haszontalan	h ɒ s o n t ɒ l ɒ n
hasábköz	h ɒ ʃ aː p k ø z
hat	h ɒ t
hatalmas	h ɒ t ɒ l m ɒ ʃ
hatni	h ɒ t n i
hatodik	h ɒ t o d i k
hatottak	h ɒ t o tː ɒ k
hatra	h ɒ t r ɒ
hatályon	h ɒ t aː j o n
hatályos	h ɒ t aː j o ʃ
határ	h ɒ t aː r
határidők	h ɒ t aː r i d øː k
határidőt	h ɒ t aː r i d øː t
határok	h ɒ t aː r o k
határokon	h ɒ t aː r o k o n
határon	h ɒ t aː r o n
határoz	h ɒ t aː r o z
határozat	h ɒ t aː r o z ɒ t
határozatot	h ɒ t aː r o z ɒ t o t
határozni	h ɒ t aː r o z n i
határozott	h ɒ t aː r o z o tː
határozottabb	h ɒ t aː r o z o tː ɒ bː
határozzák	h ɒ t aː r o zː aː k
határt	h ɒ t aː r t
határőr	h ɒ t aː r øː r
hatás	h ɒ t aː ʃ
hatása	h ɒ t aː ʃ ɒ
hatásai	h ɒ t aː ʃ ɒ j i
hatásokat	h ɒ t aː ʃ o k ɒ t
hatással	h ɒ t aː ʃː ɒ l
hatást	h ɒ t aː ʃ t
hatására	h ɒ t aː ʃ aː r ɒ
hatását	h ɒ t aː ʃ aː t
hatékony	h ɒ t eː k o ɲ
hatékonyabb	h ɒ t eː k o ɲ ɒ bː
hatékonyan	h ɒ t eː k o ɲ ɒ n
hatékonyság	h ɒ t eː k o ɲ ʃ aː ɡ
hatékonysága	h ɒ t eː k o ɲ ʃ aː ɡ ɒ
ható	h ɒ t oː
hatóság	h ɒ t oː ʃ aː ɡ
hatósági	h ɒ t oː ʃ aː ɡ i
hatóságok	h ɒ t oː ʃ aː ɡ o k
havas	h ɒ v ɒ ʃ
havonta	h ɒ v o n t ɒ
haza	h ɒ z ɒ
hazai	h ɒ z ɒ j i
hazaiak	h ɒ z ɒ j i j ɒ k
hazám	h ɒ z aː m
hazánk	h ɒ z aː ŋ k
hazánkban	h ɒ z aː ŋ ɡ b ɒ n
hegedűk	h ɛ ɡ ɛ d yː k
hegy	h ɛ ɟ
hektár	h ɛ k t aː r
helikopter	h ɛ l i k o p t ɛ r
hely	h ɛ j
helybeli	h ɛ j b ɛ l i
helyben	h ɛ j b ɛ n
helye	h ɛ j ɛ
helyek	h ɛ j ɛ k
helyeken	h ɛ j ɛ k ɛ n
helyeket	h ɛ j ɛ k ɛ t
helyeknek	h ɛ j ɛ k n ɛ k
helyekről	h ɛ j ɛ k r øː l
helyen	h ɛ j ɛ n
helyes	h ɛ j ɛ ʃ
helyesen	h ɛ j ɛ ʃ ɛ n
helyesírási	h ɛ j ɛ ʃ iː r aː ʃ i
helyet	h ɛ j ɛ t
helyett	h ɛ j ɛ tː
helyette	h ɛ j ɛ tː ɛ
helyetted	h ɛ j ɛ tː ɛ d
helyettes	h ɛ j ɛ tː ɛ ʃ
helyez	h ɛ j ɛ z
helyezett	h ɛ j ɛ z ɛ tː
helyezkedik	h ɛ j ɛ s k ɛ d i k
helyezni	h ɛ j ɛ z n i
helyezés	h ɛ j ɛ z eː ʃ
helyi	h ɛ j i
helyig	h ɛ j i ɡ
helyiségek	h ɛ j i ʃ eː ɡ ɛ k
helynek	h ɛ j n ɛ k
helyre	h ɛ j r ɛ
helyről	h ɛ j r øː l
helyszín	h ɛ j s iː n
helyszíne	h ɛ j s iː n ɛ
helyszínen	h ɛ j s iː n ɛ n
helyszíni	h ɛ j s iː n i
helyszínre	h ɛ j s iː n r ɛ
helyszínt	h ɛ j s iː n t
helyszínén	h ɛ j s iː n eː n
helytelen	h ɛ j t ɛ l ɛ n
helyzet	h ɛ j z ɛ t
helyzetbe	h ɛ j z ɛ d b ɛ
helyzetben	h ɛ j z ɛ d b ɛ n
helyzetből	h ɛ j z ɛ d b øː l
helyzetek	h ɛ j z ɛ t ɛ k
helyzetet	h ɛ j z ɛ t ɛ t
helyén	h ɛ j eː n
helyére	h ɛ j eː r ɛ
helyét	h ɛ j eː t
henrik	h ɛ n r i k
herceg	h ɛ r t͡s ɛ ɡ
hercegnőnek	h ɛ r t͡s ɛ ɡ n øː n ɛ k
hete	h ɛ t ɛ
hetek	h ɛ t ɛ k
hetekben	h ɛ t ɛ ɡ b ɛ n
hetekig	h ɛ t ɛ k i ɡ
heterogén	h ɛ t ɛ r o ɡ eː n
hetes	h ɛ t ɛ ʃ
hetet	h ɛ t ɛ t
heti	h ɛ t i
hetilap	h ɛ t i l ɒ p
hetvenhét	h ɛ t v ɛ n ɦ eː t
hetvennégy	h ɛ t v ɛ nː eː ɟ
hetvenöt	h ɛ t v ɛ n ø t
hiba	h i b ɒ
hibája	h i b aː j ɒ
hibák	h i b aː k
hibákat	h i b aː k ɒ t
hibásan	h i b aː ʃ ɒ n
hibát	h i b aː t
hibátlanul	h i b aː t l ɒ n u l
hidat	h i d ɒ t
hidd	h i dː
hideg	h i d ɛ ɡ
higgye	h i ɟː ɛ
hihetetlen	h i ɦ ɛ t ɛ t l ɛ n
himalája	h i m ɒ l aː j ɒ
hinni	h i nː i
hinné	h i nː eː
hinnénk	h i nː eː ŋ k
hirtelen	h i r t ɛ l ɛ n
hisszük	h i sː y k
hisz	h i s
hiszem	h i s ɛ m
hiszi	h i s i
hiszik	h i s i k
hisznek	h i s n ɛ k
hisztéria	h i s t eː r i j ɒ
hitel	h i t ɛ l
hitelek	h i t ɛ l ɛ k
hiteles	h i t ɛ l ɛ ʃ
hitelesebb	h i t ɛ l ɛ ʃ ɛ bː
hitelesség	h i t ɛ l ɛ ʃː eː ɡ
hitelkártyát	h i t ɛ l k aː r c aː t
hitelt	h i t ɛ l t
hitt	h i tː
hittem	h i tː ɛ m
hittünk	h i tː y ŋ k
hivatal	h i v ɒ t ɒ l
hivatalok	h i v ɒ t ɒ l o k
hivatalos	h i v ɒ t ɒ l o ʃ
hivatkozik	h i v ɒ t k o z i k
hiába	h i j aː b ɒ
hiány	h i j aː ɲ
hiánya	h i j aː ɲ ɒ
hiányos	h i j aː ɲ o ʃ
hiányosságok	h i j aː ɲ o ʃː aː ɡ o k
hiányt	h i j aː ɲ t
hiányzik	h i j aː ɲ z i k
hogy	h o ɟ
hogyan	h o ɟ ɒ n
hogyha	h o c h ɒ
hogyhogy	h o c h o ɟ
hold	h o l d
holland	h o lː ɒ n d
hollandia	h o lː ɒ n d i j ɒ
holnap	h o l n ɒ p
holott	h o l o tː
homokos	h o m o k o ʃ
homályos	h o m aː j o ʃ
honda	h o n d ɒ
honlapja	h o n l ɒ p j ɒ
honlapján	h o n l ɒ p j aː n
honlapjára	h o n l ɒ p j aː r ɒ
honvédelmi	h o ɱ v eː d ɛ l m i
honvédség	h o ɱ v eː t͡ʃː eː ɡ
hord	h o r d
hordozható	h o r d o s h ɒ t oː
hordozó	h o r d o z oː
hordók	h o r d oː k
horgász	h o r ɡ aː s
hormonok	h o r m o n o k
horn	h o r n
horthy	h o r t i
horvát	h o r v aː t
horváth	h o r v aː t
horvátország	h o r v aː t o r s aː ɡ
horvátországi	h o r v aː t o r s aː ɡ i
hosszabb	h o sː ɒ bː
hosszan	h o sː ɒ n
hosszú	h o sː uː
hotel	h o t ɛ l
hotelben	h o t ɛ l b ɛ n
hová	h o v aː
hoz	h o z
hozamok	h o z ɒ m o k
hozd	h o z d
hozhat	h o s h ɒ t
hoznak	h o z n ɒ k
hozni	h o z n i
hozott	h o z o tː
hozta	h o s t ɒ
hozták	h o s t aː k
hozza	h o zː ɒ
hozzá	h o zː aː
hozzáférhető	h o zː aː f eː r ɦ ɛ t øː
hozzájuk	h o zː aː j u k
hozzájárul	h o zː aː j aː r u l
hozzájárulás	h o zː aː j aː r u l aː ʃ
hozzájárulások	h o zː aː j aː r u l aː ʃ o k
hozzánk	h o zː aː ŋ k
hozzászólás	h o zː aː s oː l aː ʃ
hozzászólások	h o zː aː s oː l aː ʃ o k
hozzátartozók	h o zː aː t ɒ r t o z oː k
hozzátok	h o zː aː t o k
hozó	h o z oː
huligán	h u l i ɡ aː n
hulla	h u lː ɒ
hulladékok	h u lː ɒ d eː k o k
hullámzik	h u lː aː m z i k
humoros	h u m o r o ʃ
hun	h u n
hunyadi	h u ɲ ɒ d i
hunyt	h u ɲ t
huszonegyedik	h u s o n ɛ ɟː ɛ d i k
huszonhat	h u s o n ɦ ɒ t
huszonhárom	h u s o n ɦ aː r o m
huszonnégy	h u s o nː eː ɟ
huszonöt	h u s o n ø t
háború	h aː b o r uː
háborúban	h aː b o r uː b ɒ n
háborúja	h aː b o r uː j ɒ
háborúk	h aː b o r uː k
háborút	h aː b o r uː t
hág	h aː ɡ
hálás	h aː l aː ʃ
hálát	h aː l aː t
háló	h aː l oː
hálózat	h aː l oː z ɒ t
hálózatba	h aː l oː z ɒ d b ɒ
hálózati	h aː l oː z ɒ t i
hálózatok	h aː l oː z ɒ t o k
hálózatokon	h aː l oː z ɒ t o k o n
hálózaton	h aː l oː z ɒ t o n
hány	h aː ɲ
hányan	h aː ɲ ɒ n
hármas	h aː r m ɒ ʃ
hármat	h aː r m ɒ t
három	h aː r o m
háromszor	h aː r o m s o r
háromszoros	h aː r o m s o r o ʃ
hát	h aː t
háta	h aː t ɒ
hátat	h aː t ɒ t
hátha	h aː t h ɒ
hátralevő	h aː t r ɒ l ɛ v øː
hátrányos	h aː t r aː ɲ o ʃ
hátteret	h aː tː ɛ r ɛ t
háttér	h aː tː eː r
háttérbe	h aː tː eː r b ɛ
háttérben	h aː tː eː r b ɛ n
hátul	h aː t u l
hátulsó	h aː t u l ʃ oː
ház	h aː z
házai	h aː z ɒ j i
házak	h aː z ɒ k
házaspár	h aː z ɒ ʃ p aː r
házat	h aː z ɒ t
házba	h aː z b ɒ
házban	h aː z b ɒ n
házból	h aː z b oː l
házhoz	h aː s h o z
házi	h aː z i
házigazda	h aː z i ɡ ɒ z d ɒ
háznak	h aː z n ɒ k
házon	h aː z o n
háztartás	h aː s t ɒ r t aː ʃ
héj	h eː j
héja	h eː j ɒ
hétben	h eː d b ɛ n
héten	h eː t ɛ n
hétfő	h eː t f øː
hétfői	h eː t f øː j i
hétfőn	h eː t f øː n
hétig	h eː t i ɡ
hétköznapi	h eː t k ø z n ɒ p i
hétnél	h eː t n eː l
héttel	h eː tː ɛ l
hétvége	h eː t v eː ɡ ɛ
hétvégenként	h eː t v eː ɡ ɛ ŋ k eː n t
hétvégi	h eː t v eː ɡ i
hétvégén	h eː t v eː ɡ eː n
híd	h iː d
hídon	h iː d o n
hímek	h iː m ɛ k
hír	h iː r
hírek	h iː r ɛ k
híreket	h iː r ɛ k ɛ t
híres	h iː r ɛ ʃ
híresség	h iː r ɛ ʃː eː ɡ
hírességek	h iː r ɛ ʃː eː ɡ ɛ k
hírlap	h iː r l ɒ p
hírrel	h iː rː ɛ l
hírt	h iː r t
hírtelevízió	h iː r t ɛ l ɛ v iː z i j oː
hírül	h iː r y l
híve	h iː v ɛ
hívja	h iː v j ɒ
hívnak	h iː v n ɒ k
hívni	h iː v n i
hívás	h iː v aː ʃ
hívő	h iː v øː
hívők	h iː v øː k
hó	h oː
hócipője	h oː t͡s i p øː j ɛ
hód	h oː d
hódmezővásárhely	h oː d m ɛ z øː v aː ʃ aː r ɦ ɛ j
hódít	h oː d iː t
hódító	h oː d iː t oː
hófehérke	h oː f ɛ ɦ eː r k ɛ
hónap	h oː n ɒ p
hónapja	h oː n ɒ p j ɒ
hónapok	h oː n ɒ p o k
hónapos	h oː n ɒ p o ʃ
hónapra	h oː n ɒ p r ɒ
hölgy	h ø l ɟ
hú	h uː
hús	h uː ʃ
húsok	h uː ʃ o k
húst	h uː ʃ t
húsvét	h uː ʃ v eː t
húsvéti	h uː ʃ v eː t i
húzni	h uː z n i
húzza	h uː zː ɒ
húzódik	h uː z oː d i k
húzódó	h uː z oː d oː
hüllő	h y lː øː
hülye	h y j ɛ
hő	h øː
hőmérséklet	h øː m eː r ʃ eː k l ɛ t
hős	h øː ʃ
hőség	h øː ʃ eː ɡ
hősök	h øː ʃ ø k
hű	h yː
hűséges	h yː ʃ eː ɡ ɛ ʃ
hűtlenség	h yː t l ɛ n ʃ eː ɡ
hűvösebb	h yː v ø ʃ ɛ bː
idegen	i d ɛ ɡ ɛ n
idegenforgalmi	i d ɛ ɡ ɛ ɱ f o r ɡ ɒ l m i
idegenlégiósok	i d ɛ ɡ ɛ n l eː ɡ i j oː ʃ o k
idei	i d ɛ j i
ideig	i d ɛ j i ɡ
ideiglenes	i d ɛ j i ɡ l ɛ n ɛ ʃ
ideiglenesen	i d ɛ j i ɡ l ɛ n ɛ ʃ ɛ n
ideje	i d ɛ j ɛ
idején	i d ɛ j eː n
idejére	i d ɛ j eː r ɛ
idejét	i d ɛ j eː t
identitás	i d ɛ n t i t aː ʃ
ideológiai	i d ɛ o l oː ɡ i j ɒ j i
ideális	i d ɛ aː l i ʃ
idén	i d eː n
idény	i d eː ɲ
idézettel	i d eː z ɛ tː ɛ l
idő	i d øː
időbeli	i d øː b ɛ l i
időben	i d øː b ɛ n
időbeosztás	i d øː b ɛ o s t aː ʃ
időgép	i d øː ɡ eː p
idők	i d øː k
időkben	i d øː ɡ b ɛ n
időktől	i d øː k t øː l
időközben	i d øː k ø z b ɛ n
időközi	i d øː k ø z i
időn	i d øː n
időnként	i d øː ŋ k eː n t
időnkénti	i d øː ŋ k eː n t i
időpont	i d øː p o n t
időpontban	i d øː p o n d b ɒ n
időpontja	i d øː p o ɲ c ɒ
időpontjában	i d øː p o ɲ c aː b ɒ n
időpontok	i d øː p o n t o k
időpontra	i d øː p o n t r ɒ
időre	i d øː r ɛ
időrendi	i d øː r ɛ n d i
idős	i d øː ʃ
idősebb	i d øː ʃ ɛ bː
idősek	i d øː ʃ ɛ k
időszak	i d øː s ɒ k
időszakban	i d øː s ɒ ɡ b ɒ n
időszaki	i d øː s ɒ k i
időszakokban	i d øː s ɒ k o ɡ b ɒ n
időszakot	i d øː s ɒ k o t
időszámítás	i d øː s aː m iː t aː ʃ
időt	i d øː t
időtartamra	i d øː t ɒ r t ɒ m r ɒ
idővel	i d øː v ɛ l
időzítés	i d øː z iː t eː ʃ
időzítések	i d øː z iː t eː ʃ ɛ k
ifjabb	i f j ɒ bː
ifjúsági	i f j uː ʃ aː ɡ i
igaza	i ɡ ɒ z ɒ
igazam	i ɡ ɒ z ɒ m
igazgató	i ɡ ɒ z ɡ ɒ t oː
igazgatója	i ɡ ɒ z ɡ ɒ t oː j ɒ
igazgatók	i ɡ ɒ z ɡ ɒ t oː k
igazgatóság	i ɡ ɒ z ɡ ɒ t oː ʃ aː ɡ
igazi	i ɡ ɒ z i
igazolvány	i ɡ ɒ z o l v aː ɲ
igazság	i ɡ ɒ ʃː aː ɡ
igazságosság	i ɡ ɒ ʃː aː ɡ o ʃː aː ɡ
igazságosságok	i ɡ ɒ ʃː aː ɡ o ʃː aː ɡ o k
igazságot	i ɡ ɒ ʃː aː ɡ o t
igazságszolgáltatás	i ɡ ɒ ʃː aː k s o l ɡ aː l t ɒ t aː ʃ
igazságügyi	i ɡ ɒ ʃː aː ɡ y ɟ i
igazából	i ɡ ɒ z aː b oː l
igazán	i ɡ ɒ z aː n
ige	i ɡ ɛ
igen	i ɡ ɛ n
igencsak	i ɡ ɛ n t͡ʃ ɒ k
igennel	i ɡ ɛ nː ɛ l
igyekezett	i ɟ ɛ k ɛ z ɛ tː
igyekszik	i ɟ ɛ k s i k
igék	i ɡ eː k
igényei	i ɡ eː ɲ ɛ j i
igényeihez	i ɡ eː ɲ ɛ j i ɦ ɛ z
igényeinek	i ɡ eː ɲ ɛ j i n ɛ k
igényel	i ɡ eː ɲ ɛ l
igényes	i ɡ eː ɲ ɛ ʃ
ihat	i ɦ ɒ t
illegális	i lː ɛ ɡ aː l i ʃ
illeszkedik	i lː ɛ s k ɛ d i k
illeti	i lː ɛ t i
illetékes	i lː ɛ t eː k ɛ ʃ
illetéktelen	i lː ɛ t eː k t ɛ l ɛ n
illető	i lː ɛ t øː
illetőleg	i lː ɛ t øː l ɛ ɡ
illik	i lː i k
illékony	i lː eː k o ɲ
illékonyabb	i lː eː k o ɲ ɒ bː
illúziók	i lː uː z i j oː k
ilona	i l o n ɒ
ilyen	i j ɛ n
ilyenek	i j ɛ n ɛ k
ilyenkor	i j ɛ ŋ k o r
ilyenként	i j ɛ ŋ k eː n t
ilyennel	i j ɛ nː ɛ l
ilyesmi	i j ɛ ʃ m i
ilyesmit	i j ɛ ʃ m i t
ilyet	i j ɛ t
immunrendszer	i mː u n r ɛ n t͡s ɛ r
immár	i mː aː r
immáron	i mː aː r o n
impozáns	i m p o z aː n ʃ
imre	i m r ɛ
ind	i n d
index	i n d ɛ k s
indexe	i n d ɛ k s ɛ
indexek	i n d ɛ k s ɛ k
indexen	i n d ɛ k s ɛ n
indiai	i n d i j ɒ j i
indokolta	i n d o k o l t ɒ
indul	i n d u l
indulat	i n d u l ɒ t
indulnak	i n d u l n ɒ k
indulni	i n d u l n i
indult	i n d u l t
indítvány	i n d iː t v aː ɲ
indítás	i n d iː t aː ʃ
infláció	i ɱ f l aː t͡s i j oː
inflációs	i ɱ f l aː t͡s i j oː ʃ
informatika	i ɱ f o r m ɒ t i k ɒ
informatikai	i ɱ f o r m ɒ t i k ɒ j i
információs	i ɱ f o r m aː t͡s i j oː ʃ
informális	i ɱ f o r m aː l i ʃ
infrastrukturális	i ɱ f r ɒ ʃ t r u k t u r aː l i ʃ
infrastruktúra	i ɱ f r ɒ ʃ t r u k t uː r ɒ
infó	i ɱ f oː
ingatag	i ŋ ɡ ɒ t ɒ ɡ
ingatlan	i ŋ ɡ ɒ t l ɒ n
ingatlanok	i ŋ ɡ ɒ t l ɒ n o k
ingatlant	i ŋ ɡ ɒ t l ɒ n t
inget	i ŋ ɡ ɛ t
ingyen	i ɲ ɟ ɛ n
ingyenes	i ɲ ɟ ɛ n ɛ ʃ
ingyenesen	i ɲ ɟ ɛ n ɛ ʃ ɛ n
inkább	i ŋ k aː bː
innen	i nː ɛ n
inni	i nː i
innovációs	i nː o v aː t͡s i j oː ʃ
integráció	i n t ɛ ɡ r aː t͡s i j oː
integrált	i n t ɛ ɡ r aː l t
intellektuális	i n t ɛ lː ɛ k t u aː l i ʃ
intenzív	i n t ɛ n z iː v
intenzíven	i n t ɛ n z iː v ɛ n
interaktív	i n t ɛ r ɒ k t iː v
interjú	i n t ɛ r j uː
interjúk	i n t ɛ r j uː k
interjút	i n t ɛ r j uː t
internetes	i n t ɛ r n ɛ t ɛ ʃ
intervallumok	i n t ɛ r v ɒ lː u m o k
intik	i n t i k
intim	i n t i m
intézet	i n t eː z ɛ t
intézetek	i n t eː z ɛ t ɛ k
intézkedés	i n t eː s k ɛ d eː ʃ
intézkedések	i n t eː s k ɛ d eː ʃ ɛ k
intézkedést	i n t eː s k ɛ d eː ʃ t
intézmény	i n t eː z m eː ɲ
intézményben	i n t eː z m eː ɲ b ɛ n
intézmények	i n t eː z m eː ɲ ɛ k
intézményeknek	i n t eː z m eː ɲ ɛ k n ɛ k
intézményi	i n t eː z m eː ɲ i
intézményrendszer	i n t eː z m eː ɲ r ɛ n t͡s ɛ r
intézményt	i n t eː z m eː ɲ t
intő	i n t øː
ipar	i p ɒ r
iparban	i p ɒ r b ɒ n
ipari	i p ɒ r i
ipart	i p ɒ r t
iparág	i p ɒ r aː ɡ
irat	i r ɒ t
iratok	i r ɒ t o k
irigykedik	i r i c k ɛ d i k
irigység	i r i c ʃ eː ɡ
irodalmi	i r o d ɒ l m i
irodája	i r o d aː j ɒ
irtják	i r c aː k
iránti	i r aː n t i
irány	i r aː ɲ
irányadó	i r aː ɲ ɒ d oː
irányelv	i r aː ɲ ɛ l v
irányul	i r aː ɲ u l
irányuló	i r aː ɲ u l oː
irányzat	i r aː ɲ z ɒ t
irányít	i r aː ɲ iː t
irányítani	i r aː ɲ iː t ɒ n i
irányítja	i r aː ɲ iː cː ɒ
irányítás	i r aː ɲ iː t aː ʃ
irányú	i r aː ɲ uː
irén	i r eː n
is	i ʃ
iskolai	i ʃ k o l ɒ j i
ismer	i ʃ m ɛ r
ismered	i ʃ m ɛ r ɛ d
ismerek	i ʃ m ɛ r ɛ k
ismeretek	i ʃ m ɛ r ɛ t ɛ k
ismereteket	i ʃ m ɛ r ɛ t ɛ k ɛ t
ismeretes	i ʃ m ɛ r ɛ t ɛ ʃ
ismeretet	i ʃ m ɛ r ɛ t ɛ t
ismeretlen	i ʃ m ɛ r ɛ t l ɛ n
ismeretlenek	i ʃ m ɛ r ɛ t l ɛ n ɛ k
ismeri	i ʃ m ɛ r i
ismerik	i ʃ m ɛ r i k
ismerni	i ʃ m ɛ r n i
ismert	i ʃ m ɛ r t
ismerte	i ʃ m ɛ r t ɛ
ismertebb	i ʃ m ɛ r t ɛ bː
ismertek	i ʃ m ɛ r t ɛ k
ismertető	i ʃ m ɛ r t ɛ t øː
ismertté	i ʃ m ɛ r t eː
ismerték	i ʃ m ɛ r t eː k
ismerőse	i ʃ m ɛ r øː ʃ ɛ
ismerősök	i ʃ m ɛ r øː ʃ ø k
iso	i z oː
ispán	i ʃ p aː n
isteni	i ʃ t ɛ n i
istván	i ʃ t v aː n
iszonyú	i s o ɲ uː
isztambul	i s t ɒ m b u l
iszunk	i s u ŋ k
italt	i t ɒ l t
itt	i tː
itthon	i t h o n
itthoni	i t h o n i
itália	i t aː l i j ɒ
izgalmas	i z ɡ ɒ l m ɒ ʃ
izland	i z l ɒ n d
izlandi	i z l ɒ n d i
izmai	i z m ɒ j i
izmot	i z m o t
izrael	i z r ɒ ɛ l
izraeli	i z r ɒ ɛ l i
izraelita	i z r ɒ ɛ l i t ɒ
izzok	i zː o k
izzó	i zː oː
jaj	j ɒ j
jakab	j ɒ k ɒ b
jakobinus	j ɒ k o b i n u ʃ
január	j ɒ n u aː r
januártól	j ɒ n u aː r t oː l
japán	j ɒ p aː n
japánban	j ɒ p aː m b ɒ n
javaslat	j ɒ v ɒ ʃ l ɒ t
javaslatok	j ɒ v ɒ ʃ l ɒ t o k
javaslatot	j ɒ v ɒ ʃ l ɒ t o t
javaslatára	j ɒ v ɒ ʃ l ɒ t aː r ɒ
javasolja	j ɒ v ɒ ʃ o jː ɒ
javasolt	j ɒ v ɒ ʃ o l t
javasolta	j ɒ v ɒ ʃ o l t ɒ
javából	j ɒ v aː b oː l
javítani	j ɒ v iː t ɒ n i
javítása	j ɒ v iː t aː ʃ ɒ
javítására	j ɒ v iː t aː ʃ aː r ɒ
jegy	j ɛ ɟ
jegybank	j ɛ ɟ b ɒ ŋ k
jegyek	j ɛ ɟ ɛ k
jegyzet	j ɛ ɟ z ɛ t
jegyzetek	j ɛ ɟ z ɛ t ɛ k
jegyzékek	j ɛ ɟ z eː k ɛ k
jegyzőkönyvek	j ɛ ɟ z øː k ø ɲ v ɛ k
jegyzőkönyvet	j ɛ ɟ z øː k ø ɲ v ɛ t
jel	j ɛ l
jelei	j ɛ l ɛ j i
jelen	j ɛ l ɛ n
jelenet	j ɛ l ɛ n ɛ t
jelenettel	j ɛ l ɛ n ɛ tː ɛ l
jelenik	j ɛ l ɛ n i k
jelenlegi	j ɛ l ɛ n l ɛ ɡ i
jelenlévő	j ɛ l ɛ n l eː v øː
jelenlévők	j ɛ l ɛ n l eː v øː k
jelenség	j ɛ l ɛ n ʃ eː ɡ
jelenségek	j ɛ l ɛ n ʃ eː ɡ ɛ k
jelenségeket	j ɛ l ɛ n ʃ eː ɡ ɛ k ɛ t
jelentette	j ɛ l ɛ n t ɛ tː ɛ
jelentkezni	j ɛ l ɛ n t k ɛ z n i
jelentkeztek	j ɛ l ɛ n t k ɛ s t ɛ k
jelentkezések	j ɛ l ɛ n t k ɛ z eː ʃ ɛ k
jelentés	j ɛ l ɛ n t eː ʃ
jelentések	j ɛ l ɛ n t eː ʃ ɛ k
jelentést	j ɛ l ɛ n t eː ʃ t
jelentősebb	j ɛ l ɛ n t øː ʃ ɛ bː
jelentősen	j ɛ l ɛ n t øː ʃ ɛ n
jelkép	j ɛ l k eː p
jellegzetes	j ɛ lː ɛ ɡ z ɛ t ɛ ʃ
jellegű	j ɛ lː ɛ ɡ yː
jellemző	j ɛ lː ɛ m z øː
jellemzően	j ɛ lː ɛ m z øː ɛ n
jellemzője	j ɛ lː ɛ m z øː j ɛ
jellemzők	j ɛ lː ɛ m z øː k
jelszó	j ɛ l s oː
jelző	j ɛ l z øː
jelölt	j ɛ l ø l t
jelöltek	j ɛ l ø l t ɛ k
jelölték	j ɛ l ø l t eː k
jenő	j ɛ n øː
jobb	j o bː
jobbak	j o bː ɒ k
jobban	j o bː ɒ n
jobboldal	j o bː o l d ɒ l
jobboldali	j o bː o l d ɒ l i
jobbra	j o b r ɒ
jobbágy	j o bː aː ɟ
jobbára	j o bː aː r ɒ
jog	j o ɡ
joga	j o ɡ ɒ
jogai	j o ɡ ɒ j i
joggal	j o ɡː ɒ l
jogok	j o ɡ o k
jogos	j o ɡ o ʃ
jogosult	j o ɡ o ʃ u l t
jogosultak	j o ɡ o ʃ u l t ɒ k
jogot	j o ɡ o t
jogszabály	j o k s ɒ b aː j
jogszabályi	j o k s ɒ b aː j i
jogszabályok	j o k s ɒ b aː j o k
jogszabályokat	j o k s ɒ b aː j o k ɒ t
jogsértések	j o k ʃ eː r t eː ʃ ɛ k
jogtalan	j o k t ɒ l ɒ n
jogtalanul	j o k t ɒ l ɒ n u l
jogász	j o ɡ aː s
jogászok	j o ɡ aː s o k
jogát	j o ɡ aː t
jogú	j o ɡ uː
jordán	j o r d aː n
jubileumi	j u b i l ɛ u m i
judit	j u d i t
jugoszláv	j u ɡ o s l aː v
juhász	j u ɦ aː s
juliska	j u l i ʃ k ɒ
junior	j u n i j o r
jupiter	j u p i t ɛ r
jussanak	j u ʃː ɒ n ɒ k
jusson	j u ʃː o n
jut	j u t
juthat	j u t h ɒ t
jutna	j u t n ɒ
jutnak	j u t n ɒ k
jutni	j u t n i
jutott	j u t o tː
jutottak	j u t o tː ɒ k
jutottam	j u t o tː ɒ m
jutottunk	j u t o tː u ŋ k
juttatás	j u tː ɒ t aː ʃ
jutunk	j u t u ŋ k
jános	j aː n o ʃ
járat	j aː r ɒ t
járnak	j aː r n ɒ k
járni	j aː r n i
járok	j aː r o k
járt	j aː r t
jártak	j aː r t ɒ k
jártunk	j aː r t u ŋ k
járták	j aː r t aː k
járul	j aː r u l
járunk	j aː r u ŋ k
járvány	j aː r v aː ɲ
járványok	j aː r v aː ɲ o k
járó	j aː r oː
játszanak	j aː t͡sː ɒ n ɒ k
játszani	j aː t͡sː ɒ n i
játszom	j aː t͡sː o m
játszottak	j aː t͡sː o tː ɒ k
játszottunk	j aː t͡sː o tː u ŋ k
játszódik	j aː t͡sː oː d i k
játszótér	j aː t͡sː oː t eː r
játék	j aː t eː k
játéka	j aː t eː k ɒ
játékban	j aː t eː ɡ b ɒ n
játékhoz	j aː t eː k h o z
játékkal	j aː t eː kː ɒ l
játékok	j aː t eː k o k
játékokat	j aː t eː k o k ɒ t
játékos	j aː t eː k o ʃ
játékosok	j aː t eː k o ʃ o k
játékot	j aː t eː k o t
jéghideg	j eː k h i d ɛ ɡ
jézus	j eː z u ʃ
jó	j oː
jócskán	j oː t͡ʃ k aː n
jógi	j oː ɡ i
jóindulatú	j oː j i n d u l ɒ t uː
jók	j oː k
jókai	j oː k ɒ j i
jókat	j oː k ɒ t
jókra	j oː k r ɒ
jóképű	j oː k eː p yː
jól	j oː l
jóllehet	j oː lː ɛ h ɛ t
jólét	j oː l eː t
jónéhány	j oː n eː ɦ aː ɲ
jóska	j oː ʃ k ɒ
jósol	j oː ʃ o l
jót	j oː t
jótékony	j oː t eː k o ɲ
jótékonysági	j oː t eː k o ɲ ʃ aː ɡ i
jóval	j oː v ɒ l
jóvá	j oː v aː
jóváhagyott	j oː v aː ɦ ɒ ɟ o tː
józsef	j oː ʒ ɛ f
józsi	j oː ʒ i
jöhet	j ø ɦ ɛ t
jöjjenek	j ø jː ɛ n ɛ k
jöjjön	j ø jː ø n
jön	j ø n
jönnek	j ø nː ɛ k
jönni	j ø nː i
jött	j ø tː
jöttek	j ø tː ɛ k
jövedelem	j ø v ɛ d ɛ l ɛ m
jövedelemadó	j ø v ɛ d ɛ l ɛ m ɒ d oː
jövedelme	j ø v ɛ d ɛ l m ɛ
jövedelmező	j ø v ɛ d ɛ l m ɛ z øː
jövedelmi	j ø v ɛ d ɛ l m i
jövendőbeli	j ø v ɛ n d øː b ɛ l i
jövő	j ø v øː
jövőbe	j ø v øː b ɛ
jövőbeli	j ø v øː b ɛ l i
jövőben	j ø v øː b ɛ n
jövőbeni	j ø v øː b ɛ n i
jövője	j ø v øː j ɛ
jövőjét	j ø v øː j eː t
jövőre	j ø v øː r ɛ
július	j uː l i j u ʃ
június	j uː n i j u ʃ
júniusban	j uː n i j u ʒ b ɒ n
júniusában	j uː n i j u ʃ aː b ɒ n
kabinet	k ɒ b i n ɛ t
kacag	k ɒ t͡s ɒ ɡ
kacsát	k ɒ t͡ʃ aː t
kaja	k ɒ j ɒ
kalamajka	k ɒ l ɒ m ɒ j k ɒ
kalandok	k ɒ l ɒ n d o k
kalandor	k ɒ l ɒ n d o r
kalapácsvetés	k ɒ l ɒ p aː t͡ʃ v ɛ t eː ʃ
kaliforniában	k ɒ l i f o r n i j aː b ɒ n
kamaszként	k ɒ m ɒ s k eː n t
kamion	k ɒ m i j o n
kampány	k ɒ m p aː ɲ
kanadai	k ɒ n ɒ d ɒ j i
kandalló	k ɒ n d ɒ lː oː
kandúr	k ɒ n d uː r
kankalin	k ɒ ŋ k ɒ l i n
kap	k ɒ p
kapacitás	k ɒ p ɒ t͡s i t aː ʃ
kapcsolat	k ɒ p t͡ʃ o l ɒ t
kapcsolata	k ɒ p t͡ʃ o l ɒ t ɒ
kapcsolatai	k ɒ p t͡ʃ o l ɒ t ɒ j i
kapcsolatba	k ɒ p t͡ʃ o l ɒ d b ɒ
kapcsolatban	k ɒ p t͡ʃ o l ɒ d b ɒ n
kapcsolatok	k ɒ p t͡ʃ o l ɒ t o k
kapcsolatokat	k ɒ p t͡ʃ o l ɒ t o k ɒ t
kapcsolatokban	k ɒ p t͡ʃ o l ɒ t o ɡ b ɒ n
kapcsolatos	k ɒ p t͡ʃ o l ɒ t o ʃ
kapcsolatot	k ɒ p t͡ʃ o l ɒ t o t
kapcsolattartás	k ɒ p t͡ʃ o l ɒ tː ɒ r t aː ʃ
kapcsolatát	k ɒ p t͡ʃ o l ɒ t aː t
kapcsolható	k ɒ p t͡ʃ o l ɦ ɒ t oː
kapcsolódik	k ɒ p t͡ʃ o l oː d i k
kapcsolódó	k ɒ p t͡ʃ o l oː d oː
kapcsolódóan	k ɒ p t͡ʃ o l oː d oː ɒ n
kapcsolók	k ɒ p t͡ʃ o l oː k
kapható	k ɒ p h ɒ t oː
kapitány	k ɒ p i t aː ɲ
kapja	k ɒ p j ɒ
kapjanak	k ɒ p j ɒ n ɒ k
kapjon	k ɒ p j o n
kapjuk	k ɒ p j u k
kapjunk	k ɒ p j u ŋ k
kapják	k ɒ p j aː k
kapna	k ɒ p n ɒ
kapnak	k ɒ p n ɒ k
kapni	k ɒ p n i
kapok	k ɒ p o k
kaposvár	k ɒ p o ʃ v aː r
kaposvári	k ɒ p o ʃ v aː r i
kapott	k ɒ p o tː
kapsz	k ɒ p s
kapta	k ɒ p t ɒ
kaptak	k ɒ p t ɒ k
kaptam	k ɒ p t ɒ m
kaptuk	k ɒ p t u k
kaptunk	k ɒ p t u ŋ k
kapu	k ɒ p u
kapukon	k ɒ p u k o n
kapunk	k ɒ p u ŋ k
kapura	k ɒ p u r ɒ
kapus	k ɒ p u ʃ
kapusuk	k ɒ p u ʃ u k
kaput	k ɒ p u t
kar	k ɒ r
karbantartások	k ɒ r b ɒ n t ɒ r t aː ʃ o k
karcsú	k ɒ r t͡ʃ uː
kard	k ɒ r d
kari	k ɒ r i
karikatúra	k ɒ r i k ɒ t uː r ɒ
karitatív	k ɒ r i t ɒ t iː v
karját	k ɒ r j aː t
karnis	k ɒ r n i ʃ
karton	k ɒ r t o n
karácsonyi	k ɒ r aː t͡ʃ o ɲ i
karácsonyt	k ɒ r aː t͡ʃ o ɲ t
karán	k ɒ r aː n
karó	k ɒ r oː
karú	k ɒ r uː
kastély	k ɒ ʃ t eː j
kaszinó	k ɒ s i n oː
kata	k ɒ t ɒ
katasztrofális	k ɒ t ɒ s t r o f aː l i ʃ
katasztrófa	k ɒ t ɒ s t r oː f ɒ
kategória	k ɒ t ɛ ɡ oː r i j ɒ
kategóriába	k ɒ t ɛ ɡ oː r i j aː b ɒ
kategóriában	k ɒ t ɛ ɡ oː r i j aː b ɒ n
kategóriákat	k ɒ t ɛ ɡ oː r i j aː k ɒ t
kategóriákban	k ɒ t ɛ ɡ oː r i j aː ɡ b ɒ n
kategóriát	k ɒ t ɛ ɡ oː r i j aː t
kati	k ɒ t i
katolikus	k ɒ t o l i k u ʃ
katona	k ɒ t o n ɒ
katonák	k ɒ t o n aː k
katonákat	k ɒ t o n aː k ɒ t
kattints	k ɒ tː i n t͡ʃ
kattintás	k ɒ tː i n t aː ʃ
kecske	k ɛ t͡ʃ k ɛ
kedden	k ɛ dː ɛ n
keddi	k ɛ dː i
kedvenc	k ɛ d v ɛ n t͡s
kedves	k ɛ d v ɛ ʃ
kedvezmények	k ɛ d v ɛ z m eː ɲ ɛ k
kedvezményeket	k ɛ d v ɛ z m eː ɲ ɛ k ɛ t
kedvezményes	k ɛ d v ɛ z m eː ɲ ɛ ʃ
kedvezményt	k ɛ d v ɛ z m eː ɲ t
kedvező	k ɛ d v ɛ z øː
kedvezőbb	k ɛ d v ɛ z øː bː
kedvezőtlen	k ɛ d v ɛ z øː t l ɛ n
kedvvel	k ɛ d v ɛ l
kegyelem	k ɛ ɟ ɛ l ɛ m
kegyetlen	k ɛ ɟ ɛ t l ɛ n
kekszeid	k ɛ k s ɛ j i d
kelemen	k ɛ l ɛ m ɛ n
kelenföld	k ɛ l ɛ ɱ f ø l d
kelet	k ɛ l ɛ t
keleti	k ɛ l ɛ t i
keletre	k ɛ l ɛ t r ɛ
kell	k ɛ lː
kellemes	k ɛ lː ɛ m ɛ ʃ
kellemetlen	k ɛ lː ɛ m ɛ t l ɛ n
kellene	k ɛ lː ɛ n ɛ
kellett	k ɛ lː ɛ tː
kelljen	k ɛ jː ɛ n
kellék	k ɛ lː eː k
kellő	k ɛ lː øː
kemping	k ɛ m p i ŋ ɡ
kemény	k ɛ m eː ɲ
keményen	k ɛ m eː ɲ ɛ n
keni	k ɛ n i
kerek	k ɛ r ɛ k
kerekded	k ɛ r ɛ ɡ d ɛ d
kereke	k ɛ r ɛ k ɛ
kerekes	k ɛ r ɛ k ɛ ʃ
keres	k ɛ r ɛ ʃ
keresem	k ɛ r ɛ ʃ ɛ m
keresett	k ɛ r ɛ ʃ ɛ tː
keresi	k ɛ r ɛ ʃ i
kereskedelem	k ɛ r ɛ ʃ k ɛ d ɛ l ɛ m
kereskedelmi	k ɛ r ɛ ʃ k ɛ d ɛ l m i
kereskedik	k ɛ r ɛ ʃ k ɛ d i k
kereskedés	k ɛ r ɛ ʃ k ɛ d eː ʃ
kereskedők	k ɛ r ɛ ʃ k ɛ d øː k
kereslet	k ɛ r ɛ ʃ l ɛ t
keresnek	k ɛ r ɛ ʃ n ɛ k
keresni	k ɛ r ɛ ʃ n i
keress	k ɛ r ɛ ʃː
keressük	k ɛ r ɛ ʃː y k
kereste	k ɛ r ɛ ʃ t ɛ
keresve	k ɛ r ɛ ʃ v ɛ
kereszt	k ɛ r ɛ s t
keresztcsont	k ɛ r ɛ s t t͡ʃ o n t
keresztelő	k ɛ r ɛ s t ɛ l øː
keresztre	k ɛ r ɛ s t r ɛ
keresztrejtvény	k ɛ r ɛ s t r ɛ j t v eː ɲ
keresztény	k ɛ r ɛ s t eː ɲ
keresztül	k ɛ r ɛ s t y l
keresztüli	k ɛ r ɛ s t y l i
keresés	k ɛ r ɛ ʃ eː ʃ
keresése	k ɛ r ɛ ʃ eː ʃ ɛ
kereső	k ɛ r ɛ ʃ øː
keresők	k ɛ r ɛ ʃ øː k
keret	k ɛ r ɛ t
keretek	k ɛ r ɛ t ɛ k
keretet	k ɛ r ɛ t ɛ t
keretében	k ɛ r ɛ t eː b ɛ n
kertel	k ɛ r t ɛ l
kertészet	k ɛ r t eː s ɛ t
kerámia	k ɛ r aː m i j ɒ
kerékpáros	k ɛ r eː k p aː r o ʃ
kerítés	k ɛ r iː t eː ʃ
kerület	k ɛ r y l ɛ t
kerületben	k ɛ r y l ɛ d b ɛ n
kerületek	k ɛ r y l ɛ t ɛ k
kerülhet	k ɛ r y l ɦ ɛ t
kerülni	k ɛ r y l n i
került	k ɛ r y l t
kerültek	k ɛ r y l t ɛ k
kerülték	k ɛ r y l t eː k
kerülő	k ɛ r y l øː
ketten	k ɛ tː ɛ n
kettes	k ɛ tː ɛ ʃ
kettévág	k ɛ tː eː v aː ɡ
kettő	k ɛ tː øː
kettős	k ɛ tː øː ʃ
keverék	k ɛ v ɛ r eː k
kevesebb	k ɛ v ɛ ʃ ɛ bː
kevesebbet	k ɛ v ɛ ʃ ɛ bː ɛ t
kevesen	k ɛ v ɛ ʃ ɛ n
keveset	k ɛ v ɛ ʃ ɛ t
kevés	k ɛ v eː ʃ
kevéssé	k ɛ v eː ʃː eː
kezd	k ɛ z d
kezdeményezés	k ɛ z d ɛ m eː ɲ ɛ z eː ʃ
kezdesz	k ɛ z d ɛ s
kezdett	k ɛ z d ɛ tː
kezdetén	k ɛ z d ɛ t eː n
kezdik	k ɛ z d i k
kezdte	k ɛ s t ɛ
kezdtek	k ɛ s t ɛ k
kezdték	k ɛ s t eː k
kezdve	k ɛ z d v ɛ
kezdünk	k ɛ z d y ŋ k
kezdődik	k ɛ z d øː d i k
kezdődött	k ɛ z d øː d ø tː
kezdődő	k ɛ z d øː d øː
keze	k ɛ z ɛ
kezei	k ɛ z ɛ j i
kezel	k ɛ z ɛ l
kezelhető	k ɛ z ɛ l ɦ ɛ t øː
kezelik	k ɛ z ɛ l i k
kezelni	k ɛ z ɛ l n i
kezelés	k ɛ z ɛ l eː ʃ
kezelése	k ɛ z ɛ l eː ʃ ɛ
kezelések	k ɛ z ɛ l eː ʃ ɛ k
kezelést	k ɛ z ɛ l eː ʃ t
kezelésében	k ɛ z ɛ l eː ʃ eː b ɛ n
kezelésére	k ɛ z ɛ l eː ʃ eː r ɛ
kezelő	k ɛ z ɛ l øː
kezem	k ɛ z ɛ m
kezemben	k ɛ z ɛ m b ɛ n
kezes	k ɛ z ɛ ʃ
kezébe	k ɛ z eː b ɛ
kezében	k ɛ z eː b ɛ n
kezét	k ɛ z eː t
kiabálnak	k i j ɒ b aː l n ɒ k
kiadja	k i j ɒ ɟː ɒ
kiadni	k i j ɒ d n i
kiadott	k i j ɒ d o tː
kiadványok	k i j ɒ d v aː ɲ o k
kiadás	k i j ɒ d aː ʃ
kiadások	k i j ɒ d aː ʃ o k
kiadó	k i j ɒ d oː
kialakult	k i j ɒ l ɒ k u l t
kialakulása	k i j ɒ l ɒ k u l aː ʃ ɒ
kialakulásának	k i j ɒ l ɒ k u l aː ʃ aː n ɒ k
kialakítani	k i j ɒ l ɒ k iː t ɒ n i
kialakítása	k i j ɒ l ɒ k iː t aː ʃ ɒ
kialakításában	k i j ɒ l ɒ k iː t aː ʃ aː b ɒ n
kialakításához	k i j ɒ l ɒ k iː t aː ʃ aː ɦ o z
kialakításának	k i j ɒ l ɒ k iː t aː ʃ aː n ɒ k
kialakítására	k i j ɒ l ɒ k iː t aː ʃ aː r ɒ
kicsi	k i t͡ʃ i
kicsik	k i t͡ʃ i k
kicsit	k i t͡ʃ i t
kicsivel	k i t͡ʃ i v ɛ l
kicsoda	k i t͡ʃ o d ɒ
kiderül	k i d ɛ r y l
kiderült	k i d ɛ r y l t
kidolgozott	k i d o l ɡ o z o tː
kidolgozása	k i d o l ɡ o z aː ʃ ɒ
kiegészítve	k i j ɛ ɡ eː s iː t v ɛ
kiegészítés	k i j ɛ ɡ eː s iː t eː ʃ
kiegészítő	k i j ɛ ɡ eː s iː t øː
kiegészítők	k i j ɛ ɡ eː s iː t øː k
kielégítő	k i j ɛ l eː ɡ iː t øː
kiemelkedő	k i j ɛ m ɛ l k ɛ d øː
kiemelt	k i j ɛ m ɛ l t
kiemelten	k i j ɛ m ɛ l t ɛ n
kifejezetten	k i f ɛ j ɛ z ɛ tː ɛ n
kifejező	k i f ɛ j ɛ z øː
kifizetni	k i f i z ɛ t n i
kifogástalan	k i f o ɡ aː ʃ t ɒ l ɒ n
kihasználni	k i ɦ ɒ s n aː l n i
kihívás	k i ɦ iː v aː ʃ
kihívást	k i ɦ iː v aː ʃ t
kihúzok	k i ɦ uː z o k
kijelentette	k i j ɛ l ɛ n t ɛ tː ɛ
kijelölt	k i j ɛ l ø l t
kijev	k i j ɛ v
kijött	k i j ø tː
kikre	k i k r ɛ
kilenc	k i l ɛ n t͡s
kilencven	k i l ɛ n t͡s v ɛ n
kilencvenes	k i l ɛ n t͡s v ɛ n ɛ ʃ
kilométer	k i l o m eː t ɛ r
kilométeres	k i l o m eː t ɛ r ɛ ʃ
kilométerre	k i l o m eː t ɛ rː ɛ
kilátás	k i l aː t aː ʃ
kilátások	k i l aː t aː ʃ o k
kilót	k i l oː t
kim	k i m
kimegy	k i m ɛ ɟ
kiment	k i m ɛ n t
kimenő	k i m ɛ n øː
kimondottan	k i m o n d o tː ɒ n
kint	k i n t
király	k i r aː j
királyné	k i r aː j n eː
királynő	k i r aː j n øː
királyok	k i r aː j o k
királyság	k i r aː j ʃ aː ɡ
kirándulás	k i r aː n d u l aː ʃ
kis	k i ʃ
kisbaba	k i ʒ b ɒ b ɒ
kisbolygó	k i ʒ b o j ɡ oː
kisebb	k i ʃː ɛ bː
kisebbségi	k i ʃː ɛ p ʃ eː ɡ i
kisfiú	k i ʃ f i j uː
kiskereskedelmi	k i ʃ k ɛ r ɛ ʃ k ɛ d ɛ l m i
kislány	k i ʃ l aː ɲ
kismama	k i ʃ m ɒ m ɒ
kiss	k i ʃ
kisváros	k i ʃ v aː r o ʃ
kiszáll	k i s aː lː
kitalált	k i t ɒ l aː l t
kitartott	k i t ɒ r t o tː
kiterjed	k i t ɛ r j ɛ d
kiterjedt	k i t ɛ r j ɛ tː
kiterjedő	k i t ɛ r j ɛ d øː
kitevő	k i t ɛ v øː
kitöltve	k i t ø l t v ɛ
kitört	k i t ø r t
kitűnő	k i t yː n øː
kitűnően	k i t yː n øː ɛ n
kitűzött	k i t yː z ø tː
kivitelben	k i v i t ɛ l b ɛ n
kiválasztani	k i v aː l ɒ s t ɒ n i
kiválasztott	k i v aː l ɒ s t o tː
kiválasztása	k i v aː l ɒ s t aː ʃ ɒ
kiváltság	k i v aː l t͡ʃ aː ɡ
kiváló	k i v aː l oː
kiválóan	k i v aː l oː ɒ n
kivétel	k i v eː t ɛ l
kivételek	k i v eː t ɛ l ɛ k
kivételes	k i v eː t ɛ l ɛ ʃ
kivételével	k i v eː t ɛ l eː v ɛ l
kivéve	k i v eː v ɛ
kizárt	k i z aː r t
kizárólag	k i z aː r oː l ɒ ɡ
kiállt	k i j aː l t
kiállítás	k i j aː lː iː t aː ʃ
kiállítása	k i j aː lː iː t aː ʃ ɒ
kiállítást	k i j aː lː iː t aː ʃ t
kiépítése	k i j eː p iː t eː ʃ ɛ
kkv	k aː k aː v eː
klasszikus	k l ɒ sː i k u ʃ
klasszikusok	k l ɒ sː i k u ʃ o k
klinikai	k l i n i k ɒ j i
klán	k l aː n
klíma	k l iː m ɒ
koalíció	k o ɒ l iː t͡s i j oː
koalíciós	k o ɒ l iː t͡s i j oː ʃ
kockázati	k o t͡s k aː z ɒ t i
kockázatot	k o t͡s k aː z ɒ t o t
kocsi	k o t͡ʃ i
kocsiban	k o t͡ʃ i b ɒ n
kocsik	k o t͡ʃ i k
kocsis	k o t͡ʃ i ʃ
kocsival	k o t͡ʃ i v ɒ l
kodály	k o d aː j
kognitív	k o ɡ n i t iː v
kohászok	k o ɦ aː s o k
koleszterin	k o l ɛ s t ɛ r i n
kollokvium	k o lː o k v i j u m
kollégium	k o lː eː ɡ i j u m
kolozsvári	k o l o ʒ v aː r i
koma	k o m ɒ
kombi	k o m b i
kombinált	k o m b i n aː l t
kommersz	k o mː ɛ r s
kommunikáció	k o mː u n i k aː t͡s i j oː
kommunista	k o mː u n i ʃ t ɒ
kommunizmus	k o mː u n i z m u ʃ
kommunális	k o mː u n aː l i ʃ
komolyan	k o m o j ɒ n
komondor	k o m o n d o r
komor	k o m o r
kompatibilis	k o m p ɒ t i b i l i ʃ
kompatibilitás	k o m p ɒ t i b i l i t aː ʃ
komplett	k o m p l ɛ tː
komplex	k o m p l ɛ k s
komplexitás	k o m p l ɛ k s i t aː ʃ
kompresszor	k o m p r ɛ sː o r
koncentrációs	k o n t͡s ɛ n t r aː t͡s i j oː ʃ
koncentrált	k o n t͡s ɛ n t r aː l t
koncert	k o n t͡s ɛ r t
koncertek	k o n t͡s ɛ r t ɛ k
koncerten	k o n t͡s ɛ r t ɛ n
kondor	k o n d o r
konferencián	k o ɱ f ɛ r ɛ n t͡s i j aː n
konferenciát	k o ɱ f ɛ r ɛ n t͡s i j aː t
kongresszus	k o ŋ ɡ r ɛ sː u ʃ
kongói	k o ŋ ɡ oː j i
konkrét	k o ŋ k r eː t
konstrukció	k o n ʃ t r u k t͡s i j oː
konszenzus	k o n s ɛ n z u ʃ
konszern	k o n s ɛ r n
konszolidáció	k o n s o l i d aː t͡s i j oː
kontroll	k o n t r o lː
konténerek	k o n t eː n ɛ r ɛ k
konyha	k o ɲ ɦ ɒ
konzervatív	k o n z ɛ r v ɒ t iː v
konzervál	k o n z ɛ r v aː l
konzol	k o n z o l
konzorcium	k o n z o r t͡s i j u m
konzultáció	k o n z u l t aː t͡s i j oː
kora	k o r ɒ
korai	k o r ɒ j i
korea	k o r ɛ ɒ
kori	k o r i
korlátlan	k o r l aː t l ɒ n
korlátok	k o r l aː t o k
korlátozás	k o r l aː t o z aː ʃ
kormányfő	k o r m aː ɲ f øː
kormánypárti	k o r m aː ɲ p aː r t i
kormányzat	k o r m aː ɲ z ɒ t
kormányzati	k o r m aː ɲ z ɒ t i
kormányzás	k o r m aː ɲ z aː ʃ
kormányzó	k o r m aː ɲ z oː
koronát	k o r o n aː t
korrupció	k o rː u p t͡s i j oː
korszerű	k o r s ɛ r yː
kortárs	k o r t aː r ʃ
korában	k o r aː b ɒ n
korábban	k o r aː bː ɒ n
korán	k o r aː n
koszovó	k o s o v oː
kovács	k o v aː t͡ʃ
kozma	k o z m ɒ
kozmopolita	k o z m o p o l i t ɒ
kreatív	k r ɛ ɒ t iː v
krisztus	k r i s t u ʃ
kritikai	k r i t i k ɒ j i
kritikus	k r i t i k u ʃ
kritikusok	k r i t i k u ʃ o k
kritérium	k r i t eː r i j u m
krém	k r eː m
krémes	k r eː m ɛ ʃ
krízis	k r iː z i ʃ
ksh	k aː ɛ ʃ h aː
kubai	k u b ɒ j i
kulcs	k u l t͡ʃ
kulcsszavak	k u l t͡ʃ s ɒ v ɒ k
kulturális	k u l t u r aː l i ʃ
kulturált	k u l t u r aː l t
kultúra	k u l t uː r ɒ
kupa	k u p ɒ
kupleráj	k u p l ɛ r aː j
kuratórium	k u r ɒ t oː r i j u m
kusza	k u s ɒ
kutas	k u t ɒ ʃ
kutatás	k u t ɒ t aː ʃ
kutatása	k u t ɒ t aː ʃ ɒ
kutatási	k u t ɒ t aː ʃ i
kutatások	k u t ɒ t aː ʃ o k
kutatást	k u t ɒ t aː ʃ t
kutató	k u t ɒ t oː
kutatócsoport	k u t ɒ t oː t͡ʃ o p o r t
kutatói	k u t ɒ t oː j i
kutatók	k u t ɒ t oː k
kutatómunka	k u t ɒ t oː m u ŋ k ɒ
kutya	k u c ɒ
kutyák	k u c aː k
kvantummechanika	k v ɒ n t u mː ɛ ɦ ɒ n i k ɒ
ká	k aː
kálmán	k aː l m aː n
kár	k aː r
kára	k aː r ɒ
károkat	k aː r o k ɒ t
károly	k aː r o j
károlyi	k aː r o j i
káros	k aː r o ʃ
kárt	k aː r t
kártya	k aː r c ɒ
kártérítés	k aː r t eː r iː t eː ʃ
kávé	k aː v eː
kávéfőző	k aː v eː f øː z øː
kék	k eː k
kémia	k eː m i j ɒ
kéne	k eː n ɛ
kényelem	k eː ɲ ɛ l ɛ m
kényelmes	k eː ɲ ɛ l m ɛ ʃ
kényelmesebb	k eː ɲ ɛ l m ɛ ʃ ɛ bː
kényelmesen	k eː ɲ ɛ l m ɛ ʃ ɛ n
kényelmetlenség	k eː ɲ ɛ l m ɛ t l ɛ n ʃ eː ɡ
kényszer	k eː ɲ s ɛ r
kényszerít	k eː ɲ s ɛ r iː t
kényszerű	k eː ɲ s ɛ r yː
kényszerűség	k eː ɲ s ɛ r yː ʃ eː ɡ
képe	k eː p ɛ
képei	k eː p ɛ j i
képeit	k eː p ɛ j i t
képernyőn	k eː p ɛ r ɲ øː n
képessége	k eː p ɛ ʃː eː ɡ ɛ
képességei	k eː p ɛ ʃː eː ɡ ɛ j i
képezik	k eː p ɛ z i k
képtelen	k eː p t ɛ l ɛ n
képtelenek	k eː p t ɛ l ɛ n ɛ k
képtelenség	k eː p t ɛ l ɛ n ʃ eː ɡ
képvisel	k eː p v i ʃ ɛ l
képviselete	k eː p v i ʃ ɛ l ɛ t ɛ
képviseleti	k eː p v i ʃ ɛ l ɛ t i
képviseletében	k eː p v i ʃ ɛ l ɛ t eː b ɛ n
képviselő	k eː p v i ʃ ɛ l øː
képviselőház	k eː p v i ʃ ɛ l øː ɦ aː z
képviselői	k eː p v i ʃ ɛ l øː j i
képviselőinek	k eː p v i ʃ ɛ l øː j i n ɛ k
képviselője	k eː p v i ʃ ɛ l øː j ɛ
képviselők	k eː p v i ʃ ɛ l øː k
képviselőket	k eː p v i ʃ ɛ l øː k ɛ t
képviselőt	k eː p v i ʃ ɛ l øː t
képzelem	k eː b z ɛ l ɛ m
képzelet	k eː b z ɛ l ɛ t
képzeletbeli	k eː b z ɛ l ɛ d b ɛ l i
képzelni	k eː b z ɛ l n i
képzett	k eː b z ɛ tː
képzettebb	k eː b z ɛ tː ɛ bː
képzés	k eː b z eː ʃ
képzése	k eː b z eː ʃ ɛ
képzésen	k eː b z eː ʃ ɛ n
képzésre	k eː b z eː ʃ r ɛ
képzőművészet	k eː b z øː m yː v eː s ɛ t
képében	k eː p eː b ɛ n
képét	k eː p eː t
kér	k eː r
kérd	k eː r d
kérdezett	k eː r d ɛ z ɛ tː
kérdezte	k eː r d ɛ s t ɛ
kérdező	k eː r d ɛ z øː
kérdés	k eː r d eː ʃ
kérdésben	k eː r d eː ʒ b ɛ n
kérdéseire	k eː r d eː ʃ ɛ j i r ɛ
kérdéseit	k eː r d eː ʃ ɛ j i t
kérdéseivel	k eː r d eː ʃ ɛ j i v ɛ l
kérdések	k eː r d eː ʃ ɛ k
kérdéseket	k eː r d eː ʃ ɛ k ɛ t
kérdésekkel	k eː r d eː ʃ ɛ kː ɛ l
kérdésekre	k eː r d eː ʃ ɛ k r ɛ
kérdésekről	k eː r d eː ʃ ɛ k r øː l
kérdésem	k eː r d eː ʃ ɛ m
kérdéses	k eː r d eː ʃ ɛ ʃ
kérdésnek	k eː r d eː ʃ n ɛ k
kérdésre	k eː r d eː ʃ r ɛ
kérdéssel	k eː r d eː ʃː ɛ l
kérdést	k eː r d eː ʃ t
kérem	k eː r ɛ m
kérhet	k eː r ɦ ɛ t
kéri	k eː r i
kérje	k eː r j ɛ
kérjem	k eː r j ɛ m
kérjen	k eː r j ɛ n
kérjék	k eː r j eː k
kérjük	k eː r j y k
kérlek	k eː r l ɛ k
kérnek	k eː r n ɛ k
kérni	k eː r n i
kért	k eː r t
kérte	k eː r t ɛ
kértek	k eː r t ɛ k
kértem	k eː r t ɛ m
kérése	k eː r eː ʃ ɛ
kérését	k eː r eː ʃ eː t
kérő	k eː r øː
késett	k eː ʃ ɛ tː
készített	k eː s iː t ɛ tː
készítettek	k eː s iː t ɛ tː ɛ k
készítették	k eː s iː t ɛ tː eː k
készítik	k eː s iː t i k
készítmények	k eː s iː t m eː ɲ ɛ k
készítése	k eː s iː t eː ʃ ɛ
készítésére	k eː s iː t eː ʃ eː r ɛ
készül	k eː s y l
készülék	k eː s y l eː k
készülékek	k eː s y l eː k ɛ k
készülünk	k eː s y l y ŋ k
készülő	k eː s y l øː
késés	k eː ʃ eː ʃ
késő	k eː ʃ øː
később	k eː ʃ øː bː
későbbi	k eː ʃ øː bː i
későbbiekben	k eː ʃ øː bː i j ɛ ɡ b ɛ n
késői	k eː ʃ øː j i
két	k eː t
kételyek	k eː t ɛ j ɛ k
kétezer	k eː t ɛ z ɛ r
kétfejű	k eː t f ɛ j yː
kétféle	k eː t f eː l ɛ
kétség	k eː t͡ʃː eː ɡ
kétségbe	k eː t͡ʃː eː ɡ b ɛ
kétségbeesett	k eː t͡ʃː eː ɡ b ɛ ɛ ʃ ɛ tː
kétségtelen	k eː t͡ʃː eː k t ɛ l ɛ n
kétéves	k eː t eː v ɛ ʃ
kéz	k eː z
kézben	k eː z b ɛ n
kézből	k eː z b øː l
kézfogás	k eː s f o ɡ aː ʃ
kézhez	k eː s h ɛ z
kézi	k eː z i
kézilabda	k eː z i l ɒ b d ɒ
kéznél	k eː z n eː l
kézre	k eː z r ɛ
kézzel	k eː zː ɛ l
kína	k iː n ɒ
kínos	k iː n o ʃ
kínál	k iː n aː l
kínálta	k iː n aː l t ɒ
kísérete	k iː ʃ eː r ɛ t ɛ
kíséretében	k iː ʃ eː r ɛ t eː b ɛ n
kísérlet	k iː ʃ eː r l ɛ t
kísérletek	k iː ʃ eː r l ɛ t ɛ k
kísérleteket	k iː ʃ eː r l ɛ t ɛ k ɛ t
kísérletet	k iː ʃ eː r l ɛ t ɛ t
kísértés	k iː ʃ eː r t eː ʃ
kívánatos	k iː v aː n ɒ t o ʃ
kíváncsi	k iː v aː n t͡ʃ i
kíváncsiak	k iː v aː n t͡ʃ i j ɒ k
kíváncsiság	k iː v aː n t͡ʃ i ʃ aː ɡ
kívánjuk	k iː v aː ɲː u k
kívánt	k iː v aː n t
kívánunk	k iː v aː n u ŋ k
kívül	k iː v y l
kívüli	k iː v y l i
kócos	k oː t͡s o ʃ
kórokozók	k oː r o k o z oː k
kóros	k oː r o ʃ
kórt	k oː r t
kórus	k oː r u ʃ
ködös	k ø d ø ʃ
kölcsön	k ø l t͡ʃ ø n
kölcsönhatások	k ø l t͡ʃ ø n ɦ ɒ t aː ʃ o k
kölcsönt	k ø l t͡ʃ ø n t
kölcsönök	k ø l t͡ʃ ø n ø k
kölcsönösen	k ø l t͡ʃ ø n ø ʃ ɛ n
költség	k ø l t͡ʃ eː ɡ
költsége	k ø l t͡ʃ eː ɡ ɛ
költségeit	k ø l t͡ʃ eː ɡ ɛ j i t
költségek	k ø l t͡ʃ eː ɡ ɛ k
költségeket	k ø l t͡ʃ eː ɡ ɛ k ɛ t
költséget	k ø l t͡ʃ eː ɡ ɛ t
költséghatékony	k ø l t͡ʃ eː k h ɒ t eː k o ɲ
költségvetés	k ø l t͡ʃ eː ɡ v ɛ t eː ʃ
költségvetési	k ø l t͡ʃ eː ɡ v ɛ t eː ʃ i
költő	k ø l t øː
költői	k ø l t øː j i
költők	k ø l t øː k
könnycsepp	k ø ɲ t͡ʃ ɛ pː
könnyed	k ø ɲː ɛ d
könnyen	k ø ɲː ɛ n
könnyű	k ø ɲː yː
könyv	k ø ɲ v
könyvbe	k ø ɲ v b ɛ
könyvben	k ø ɲ v b ɛ n
könyve	k ø ɲ v ɛ
könyvek	k ø ɲ v ɛ k
könyveket	k ø ɲ v ɛ k ɛ t
könyvesbolt	k ø ɲ v ɛ ʒ b o l t
könyvet	k ø ɲ v ɛ t
könyvtári	k ø ɲ f t aː r i
könyvtáros	k ø ɲ f t aː r o ʃ
könyvvel	k ø ɲ v ɛ l
könyvét	k ø ɲ v eː t
kör	k ø r
körben	k ø r b ɛ n
köre	k ø r ɛ
köreink	k ø r ɛ j i ŋ k
környezet	k ø r ɲ ɛ z ɛ t
környezetbarát	k ø r ɲ ɛ z ɛ d b ɒ r aː t
környezetben	k ø r ɲ ɛ z ɛ d b ɛ n
környezete	k ø r ɲ ɛ z ɛ t ɛ
környezetet	k ø r ɲ ɛ z ɛ t ɛ t
környezetre	k ø r ɲ ɛ z ɛ t r ɛ
környezetvédelem	k ø r ɲ ɛ z ɛ t v eː d ɛ l ɛ m
környezetvédelmi	k ø r ɲ ɛ z ɛ t v eː d ɛ l m i
környezetében	k ø r ɲ ɛ z ɛ t eː b ɛ n
környék	k ø r ɲ eː k
környékbeli	k ø r ɲ eː ɡ b ɛ l i
környéken	k ø r ɲ eː k ɛ n
környékén	k ø r ɲ eː k eː n
kört	k ø r t
köré	k ø r eː
körében	k ø r eː b ɛ n
köröcske	k ø r ø t͡ʃ k ɛ
körök	k ø r ø k
körökben	k ø r ø ɡ b ɛ n
körül	k ø r y l
körülbelül	k ø r y l b ɛ l y l
körüli	k ø r y l i
körülmény	k ø r y l m eː ɲ
körülmények	k ø r y l m eː ɲ ɛ k
körülményeket	k ø r y l m eː ɲ ɛ k ɛ t
körülötte	k ø r y l ø tː ɛ
körű	k ø r yː
köszönet	k ø s ø n ɛ t
köszönhet	k ø s ø n ɦ ɛ t
köszönhető	k ø s ø n ɦ ɛ t øː
köszönhetően	k ø s ø n ɦ ɛ t øː ɛ n
köszönjük	k ø s ø ɲː y k
köteles	k ø t ɛ l ɛ ʃ
kötelessége	k ø t ɛ l ɛ ʃː eː ɡ ɛ
kötelez	k ø t ɛ l ɛ z
kötelezett	k ø t ɛ l ɛ z ɛ tː
kötelezettség	k ø t ɛ l ɛ z ɛ t͡ʃː eː ɡ
kötelezettsége	k ø t ɛ l ɛ z ɛ t͡ʃː eː ɡ ɛ
kötelezettségek	k ø t ɛ l ɛ z ɛ t͡ʃː eː ɡ ɛ k
kötelezettséget	k ø t ɛ l ɛ z ɛ t͡ʃː eː ɡ ɛ t
kötelező	k ø t ɛ l ɛ z øː
kötelezően	k ø t ɛ l ɛ z øː ɛ n
kötet	k ø t ɛ t
kötetes	k ø t ɛ t ɛ ʃ
kötni	k ø t n i
kötött	k ø t ø tː
kövek	k ø v ɛ k
követ	k ø v ɛ t
követelményeit	k ø v ɛ t ɛ l m eː ɲ ɛ j i t
követi	k ø v ɛ t i
következetes	k ø v ɛ t k ɛ z ɛ t ɛ ʃ
következményei	k ø v ɛ t k ɛ z m eː ɲ ɛ j i
következmények	k ø v ɛ t k ɛ z m eː ɲ ɛ k
következményekkel	k ø v ɛ t k ɛ z m eː ɲ ɛ kː ɛ l
következtetni	k ø v ɛ t k ɛ s t ɛ t n i
következtében	k ø v ɛ t k ɛ s t eː b ɛ n
következésképpen	k ø v ɛ t k ɛ z eː ʃ k eː pː ɛ n
következő	k ø v ɛ t k ɛ z øː
következően	k ø v ɛ t k ɛ z øː ɛ n
követni	k ø v ɛ t n i
követte	k ø v ɛ tː ɛ
követő	k ø v ɛ t øː
követően	k ø v ɛ t øː ɛ n
követők	k ø v ɛ t øː k
köze	k ø z ɛ
közeledik	k ø z ɛ l ɛ d i k
közeleg	k ø z ɛ l ɛ ɡ
közeli	k ø z ɛ l i
közeljövőben	k ø z ɛ jː ø v øː b ɛ n
közelmúltban	k ø z ɛ l m uː l d b ɒ n
közelébe	k ø z ɛ l eː b ɛ
közelében	k ø z ɛ l eː b ɛ n
közelít	k ø z ɛ l iː t
közepes	k ø z ɛ p ɛ ʃ
közepette	k ø z ɛ p ɛ tː ɛ
közepén	k ø z ɛ p eː n
közepére	k ø z ɛ p eː r ɛ
közepétől	k ø z ɛ p eː t øː l
közgazdasági	k ø z ɡ ɒ z d ɒ ʃ aː ɡ i
közgazdász	k ø z ɡ ɒ z d aː s
közgazdászok	k ø z ɡ ɒ z d aː s o k
közgyűlési	k ø z ɟ yː l eː ʃ i
közigazgatás	k ø z i ɡ ɒ z ɡ ɒ t aː ʃ
közismert	k ø z i ʃ m ɛ r t
közkedvelt	k ø s k ɛ d v ɛ l t
közkívánatra	k ø s k iː v aː n ɒ t r ɒ
közlekedik	k ø z l ɛ k ɛ d i k
közlekedés	k ø z l ɛ k ɛ d eː ʃ
közlekedési	k ø z l ɛ k ɛ d eː ʃ i
közlemény	k ø z l ɛ m eː ɲ
közleménye	k ø z l ɛ m eː ɲ ɛ
közleményében	k ø z l ɛ m eː ɲ eː b ɛ n
közlöny	k ø z l ø ɲ
központ	k ø s p o n t
központban	k ø s p o n d b ɒ n
központi	k ø s p o n t i
központja	k ø s p o ɲ c ɒ
központok	k ø s p o n t o k
központosított	k ø s p o n t o ʃ iː t o tː
közreműködésével	k ø z r ɛ m yː k ø d eː ʃ eː v ɛ l
községi	k ø ʃː eː ɡ i
köztisztviselő	k ø s t i s t v i ʃ ɛ l øː
köztisztviselői	k ø s t i s t v i ʃ ɛ l øː j i
köztisztviselők	k ø s t i s t v i ʃ ɛ l øː k
köztudott	k ø s t u d o tː
köztársaság	k ø s t aː r ʃ ɒ ʃ aː ɡ
közvetlen	k ø z v ɛ t l ɛ n
közvetlenül	k ø z v ɛ t l ɛ n y l
közé	k ø z eː
közélet	k ø z eː l ɛ t
középiskolai	k ø z eː p i ʃ k o l ɒ j i
középkor	k ø z eː p k o r
középpontja	k ø z eː pː o ɲ c ɒ
középpontjában	k ø z eː pː o ɲ c aː b ɒ n
középpályás	k ø z eː pː aː j aː ʃ
középvállalkozások	k ø z eː p v aː lː ɒ l k o z aː ʃ o k
közérdekű	k ø z eː r d ɛ k yː
közöl	k ø z ø l
közölte	k ø z ø l t ɛ
közönség	k ø z ø n ʃ eː ɡ
közönséget	k ø z ø n ʃ eː ɡ ɛ t
közönségnek	k ø z ø n ʃ eː ɡ n ɛ k
közös	k ø z ø ʃ
közösen	k ø z ø ʃ ɛ n
közösség	k ø z ø ʃː eː ɡ
közösségben	k ø z ø ʃː eː ɡ b ɛ n
közösségek	k ø z ø ʃː eː ɡ ɛ k
közösséget	k ø z ø ʃː eː ɡ ɛ t
közösségi	k ø z ø ʃː eː ɡ i
között	k ø z ø tː
közötti	k ø z ø tː i
közöttünk	k ø z ø tː y ŋ k
közül	k ø z y l
küld	k y l d
küldeni	k y l d ɛ n i
küldetés	k y l d ɛ t eː ʃ
küldje	k y l ɟ ɛ
küldés	k y l d eː ʃ
küldött	k y l d ø tː
küldöttek	k y l d ø tː ɛ k
külseje	k y l ʃ ɛ j ɛ
külsejű	k y l ʃ ɛ j yː
külső	k y l ʃ øː
külön	k y l ø n
különbség	k y l ø m p ʃ eː ɡ
különbségek	k y l ø m p ʃ eː ɡ ɛ k
különbségeket	k y l ø m p ʃ eː ɡ ɛ k ɛ t
különbözik	k y l ø m b ø z i k
különböznek	k y l ø m b ø z n ɛ k
különböző	k y l ø m b ø z øː
különféle	k y l ø ɱ f eː l ɛ
küszöbe	k y s ø b ɛ
küzdelem	k y z d ɛ l ɛ m
küzdelemben	k y z d ɛ l ɛ m b ɛ n
kő	k øː
labda	l ɒ b d ɒ
labdarúgás	l ɒ b d ɒ r uː ɡ aː ʃ
labdarúgó	l ɒ b d ɒ r uː ɡ oː
laboratórium	l ɒ b o r ɒ t oː r i j u m
laboratóriumi	l ɒ b o r ɒ t oː r i j u m i
lagymatag	l ɒ ɟ m ɒ t ɒ ɡ
laikusok	l ɒ j i k u ʃ o k
lajos	l ɒ j o ʃ
lakos	l ɒ k o ʃ
lakosság	l ɒ k o ʃː aː ɡ
lakossági	l ɒ k o ʃː aː ɡ i
lakosságot	l ɒ k o ʃː aː ɡ o t
lakosságának	l ɒ k o ʃː aː ɡ aː n ɒ k
lakói	l ɒ k oː j i
lakóinak	l ɒ k oː j i n ɒ k
lakók	l ɒ k oː k
lap	l ɒ p
lapban	l ɒ bː ɒ n
lapnak	l ɒ p n ɒ k
lapok	l ɒ p o k
lapokat	l ɒ p o k ɒ t
lapon	l ɒ p o n
lapot	l ɒ p o t
lappal	l ɒ pː ɒ l
laptop	l ɛ p t o p
lassabban	l ɒ ʃː ɒ bː ɒ n
lassan	l ɒ ʃː ɒ n
lassú	l ɒ ʃː uː
latin	l ɒ t i n
lefelé	l ɛ f ɛ l eː
legalkalmasabb	l ɛ ɡ ɒ l k ɒ l m ɒ ʃ ɒ bː
legalább	l ɛ ɡ ɒ l aː bː
legalábbis	l ɛ ɡ ɒ l aː bː i ʃ
legbensőségesebb	l ɛ ɡ b ɛ n ʃ øː ʃ eː ɡ ɛ ʃ ɛ bː
legbüszkébb	l ɛ ɡ b y s k eː bː
legdinamikusabb	l ɛ ɡ d i n ɒ m i k u ʃ ɒ bː
legdrágább	l ɛ ɡ d r aː ɡ aː bː
legegyszerűbben	l ɛ ɡ ɛ c s ɛ r yː bː ɛ n
legelemibb	l ɛ ɡ ɛ l ɛ m i bː
legelőkelőbb	l ɛ ɡ ɛ l øː k ɛ l øː bː
legendás	l ɛ ɡ ɛ n d aː ʃ
legendásan	l ɛ ɡ ɛ n d aː ʃ ɒ n
legeredményesebb	l ɛ ɡ ɛ r ɛ d m eː ɲ ɛ ʃ ɛ bː
legesélyesebb	l ɛ ɡ ɛ ʃ eː j ɛ ʃ ɛ bː
legfeljebb	l ɛ k f ɛ jː ɛ bː
legfelső	l ɛ k f ɛ l ʃ øː
legfelsőbb	l ɛ k f ɛ l ʃ øː bː
legfinomabb	l ɛ k f i n o m ɒ bː
legfontosabb	l ɛ k f o n t o ʃ ɒ bː
legfrissebb	l ɛ k f r i ʃː ɛ bː
legfürgébb	l ɛ k f y r ɡ eː bː
legfőbb	l ɛ k f øː bː
leggazdagabb	l ɛ ɡː ɒ z d ɒ ɡ ɒ bː
leggondosabb	l ɛ ɡː o n d o ʃ ɒ bː
leggyakrabban	l ɛ ɡ ɟ ɒ k r ɒ bː ɒ n
leggyönyörűbb	l ɛ ɡ ɟ ø ɲ ø r yː bː
leghidegebb	l ɛ k h i d ɛ ɡ ɛ bː
leghosszabb	l ɛ k h o sː ɒ bː
leginkább	l ɛ ɡ i ŋ k aː bː
legismertebb	l ɛ ɡ i ʃ m ɛ r t ɛ bː
legizgalmasabb	l ɛ ɡ i z ɡ ɒ l m ɒ ʃ ɒ bː
legjellemzőbb	l ɛ ɡ j ɛ lː ɛ m z øː bː
legjobb	l ɛ ɡ j o bː
legjobbak	l ɛ ɡ j o bː ɒ k
legjobban	l ɛ ɡ j o bː ɒ n
legjobbnak	l ɛ ɡ j o b n ɒ k
legkevesebb	l ɛ kː ɛ v ɛ ʃ ɛ bː
legkiegyensúlyozottabb	l ɛ kː i j ɛ ɟ ɛ n ʃ uː j o z o tː ɒ bː
legkiemeltebb	l ɛ kː i j ɛ m ɛ l t ɛ bː
legkisebb	l ɛ kː i ʃː ɛ bː
legkésőbb	l ɛ kː eː ʃ øː bː
legkönnyebb	l ɛ kː ø ɲː ɛ bː
legközelebb	l ɛ kː ø z ɛ l ɛ bː
legközelebbi	l ɛ kː ø z ɛ l ɛ bː i
legkülönfélébb	l ɛ kː y l ø ɱ f eː l eː bː
legkülönösebb	l ɛ kː y l ø n ø ʃ ɛ bː
legmélyebb	l ɛ ɡ m eː j ɛ bː
legnehezebb	l ɛ ɡ n ɛ h ɛ z ɛ bː
legnépszerűbb	l ɛ ɡ n eː p s ɛ r yː bː
legparányibb	l ɛ k p ɒ r aː ɲ i bː
legragyogóbb	l ɛ ɡ r ɒ ɟ o ɡ oː bː
legritkább	l ɛ ɡ r i t k aː bː
legrosszabb	l ɛ ɡ r o sː ɒ bː
legsikeresebb	l ɛ k ʃ i k ɛ r ɛ ʃ ɛ bː
legszegényebb	l ɛ k s ɛ ɡ eː ɲ ɛ bː
legsúlyosabb	l ɛ k ʃ uː j o ʃ ɒ bː
legtöbb	l ɛ k t ø bː
legtöbben	l ɛ k t ø bː ɛ n
legtöbbször	l ɛ k t ø p s ø r
legutolsó	l ɛ ɡ u t o l ʃ oː
legutóbb	l ɛ ɡ u t oː bː
legutóbbi	l ɛ ɡ u t oː bː i
legyek	l ɛ ɟ ɛ k
legyen	l ɛ ɟ ɛ n
legyenek	l ɛ ɟ ɛ n ɛ k
legújabb	l ɛ ɡ uː j ɒ bː
lehessen	l ɛ h ɛ ʃː ɛ n
lehet	l ɛ h ɛ t
lehetek	l ɛ h ɛ t ɛ k
lehetetlen	l ɛ h ɛ t ɛ t l ɛ n
lehetetlenné	l ɛ h ɛ t ɛ t l ɛ nː eː
lehetett	l ɛ h ɛ t ɛ tː
lehetnek	l ɛ h ɛ t n ɛ k
lehetnék	l ɛ h ɛ t n eː k
lehetséges	l ɛ h ɛ t͡ʃː eː ɡ ɛ ʃ
lehetünk	l ɛ h ɛ t y ŋ k
lehető	l ɛ h ɛ t øː
lehetőség	l ɛ h ɛ t øː ʃ eː ɡ
lehetősége	l ɛ h ɛ t øː ʃ eː ɡ ɛ
lehetőségeinek	l ɛ h ɛ t øː ʃ eː ɡ ɛ j i n ɛ k
lehetőségek	l ɛ h ɛ t øː ʃ eː ɡ ɛ k
lehetőségeket	l ɛ h ɛ t øː ʃ eː ɡ ɛ k ɛ t
lehetőséget	l ɛ h ɛ t øː ʃ eː ɡ ɛ t
lehetőségét	l ɛ h ɛ t øː ʃ eː ɡ eː t
lehetővé	l ɛ h ɛ t øː v eː
lej	l ɛ j
lejre	l ɛ j r ɛ
lejt	l ɛ j t
lejár	l ɛ j aː r
lejátszó	l ɛ j aː t͡sː oː
lejért	l ɛ j eː r t
lelke	l ɛ l k ɛ
lelkes	l ɛ l k ɛ ʃ
lelkesen	l ɛ l k ɛ ʃ ɛ n
lelket	l ɛ l k ɛ t
lelki	l ɛ l k i
lelkileg	l ɛ l k i l ɛ ɡ
lelkészek	l ɛ l k eː s ɛ k
lemezen	l ɛ m ɛ z ɛ n
lemondott	l ɛ m o n d o tː
lendület	l ɛ n d y l ɛ t
lengyel	l ɛ ɲ ɟ ɛ l
lengyelországban	l ɛ ɲ ɟ ɛ l o r s aː ɡ b ɒ n
lenne	l ɛ nː ɛ
lenni	l ɛ nː i
lennie	l ɛ nː i j ɛ
lennék	l ɛ nː eː k
lennénk	l ɛ nː eː ŋ k
lent	l ɛ n t
lenyűgöző	l ɛ ɲ yː ɡ ø z øː
lepke	l ɛ p k ɛ
leszálló	l ɛ s aː lː oː
leszámítva	l ɛ s aː m iː t v ɒ
leszünk	l ɛ s y ŋ k
lett	l ɛ tː
lettem	l ɛ tː ɛ m
levegő	l ɛ v ɛ ɡ øː
levegőben	l ɛ v ɛ ɡ øː b ɛ n
levelek	l ɛ v ɛ l ɛ k
leveleket	l ɛ v ɛ l ɛ k ɛ t
levelet	l ɛ v ɛ l ɛ t
levelező	l ɛ v ɛ l ɛ z øː
levelét	l ɛ v ɛ l eː t
levente	l ɛ v ɛ n t ɛ
levesek	l ɛ v ɛ ʃ ɛ k
levél	l ɛ v eː l
levélben	l ɛ v eː l b ɛ n
levő	l ɛ v øː
lezárt	l ɛ z aː r t
leányok	l ɛ aː ɲ o k
leépítés	l ɛ j eː p iː t eː ʃ
leírtam	l ɛ j iː r t ɒ m
leírás	l ɛ j iː r aː ʃ
leírást	l ɛ j iː r aː ʃ t
liberális	l i b ɛ r aː l i ʃ
liga	l i ɡ ɒ
ligában	l i ɡ aː b ɒ n
lila	l i l ɒ
lineáris	l i n ɛ aː r i ʃ
link	l i ŋ k
linkek	l i ŋ k ɛ k
linkekre	l i ŋ k ɛ k r ɛ
linket	l i ŋ k ɛ t
linkre	l i ŋ k r ɛ
listákra	l i ʃ t aː k r ɒ
listára	l i ʃ t aː r ɒ
listát	l i ʃ t aː t
liter	l i t ɛ r
liturgia	l i t u r ɡ i j ɒ
litván	l i t v aː n
litvánia	l i t v aː n i j ɒ
lobog	l o b o ɡ
lobogó	l o b o ɡ oː
logika	l o ɡ i k ɒ
logikus	l o ɡ i k u ʃ
logisztikai	l o ɡ i s t i k ɒ j i
london	l o n d o n
lord	l o r d
lotti	l o tː i
lovas	l o v ɒ ʃ
lyukra	j u k r ɒ
láb	l aː b
lábad	l aː b ɒ d
lábak	l aː b ɒ k
lábam	l aː b ɒ m
lábbeli	l aː bː ɛ l i
lábán	l aː b aː n
lábáról	l aː b aː r oː l
lábát	l aː b aː t
ládák	l aː d aː k
lágy	l aː ɟ
lám	l aː m
láma	l aː m ɒ
lány	l aː ɲ
lánya	l aː ɲ ɒ
lányok	l aː ɲ o k
lányt	l aː ɲ t
lárvák	l aː r v aː k
lásd	l aː ʒ d
láss	l aː ʃː
lássad	l aː ʃː ɒ d
lássam	l aː ʃː ɒ m
lászló	l aː s l oː
lát	l aː t
láthat	l aː t h ɒ t
látható	l aː t h ɒ t oː
láthatóan	l aː t h ɒ t oː ɒ n
látja	l aː cː ɒ
látják	l aː cː aː k
látni	l aː t n i
látnék	l aː t n eː k
látogatták	l aː t o ɡ ɒ tː aː k
látogatás	l aː t o ɡ ɒ t aː ʃ
látogató	l aː t o ɡ ɒ t oː
látogatók	l aː t o ɡ ɒ t oː k
látom	l aː t o m
látott	l aː t o tː
látsz	l aː t͡sː
látszólag	l aː t͡sː oː l ɒ ɡ
láttak	l aː tː ɒ k
láttam	l aː tː ɒ m
láttuk	l aː tː u k
láttunk	l aː tː u ŋ k
látunk	l aː t u ŋ k
látvány	l aː t v aː ɲ
látványos	l aː t v aː ɲ o ʃ
lázad	l aː z ɒ d
lázadó	l aː z ɒ d oː
láztalan	l aː s t ɒ l ɒ n
lécci	l eː t͡sː i
légi	l eː ɡ i
légitársaság	l eː ɡ i t aː r ʃ ɒ ʃ aː ɡ
légköri	l eː kː ø r i
légy	l eː ɟ
légzsák	l eː ɡ ʒ aː k
lélegzik	l eː l ɛ ɡ z i k
lélek	l eː l ɛ k
lélekben	l eː l ɛ ɡ b ɛ n
lélekkel	l eː l ɛ kː ɛ l
lélektani	l eː l ɛ k t ɒ n i
lény	l eː ɲ
lényege	l eː ɲ ɛ ɡ ɛ
lényeges	l eː ɲ ɛ ɡ ɛ ʃ
lényegesen	l eː ɲ ɛ ɡ ɛ ʃ ɛ n
lényegében	l eː ɲ ɛ ɡ eː b ɛ n
lényegét	l eː ɲ ɛ ɡ eː t
lények	l eː ɲ ɛ k
lép	l eː p
lépcsőház	l eː p t͡ʃ øː ɦ aː z
lépcsősor	l eː p t͡ʃ øː ʃ o r
lépni	l eː p n i
léptek	l eː p t ɛ k
léptünk	l eː p t y ŋ k
lépése	l eː p eː ʃ ɛ
lépő	l eː p øː
lét	l eː t
létesítmény	l eː t ɛ ʃ iː t m eː ɲ
létezik	l eː t ɛ z i k
létező	l eː t ɛ z øː
létfontosságú	l eː t f o n t o ʃː aː ɡ uː
létre	l eː t r ɛ
létrejött	l eː t r ɛ j ø tː
létszám	l eː t s aː m
lévén	l eː v eː n
lévő	l eː v øː
lóerős	l oː ɛ r øː ʃ
lőrinc	l øː r i n t͡s
ma	m ɒ
macska	m ɒ t͡ʃ k ɒ
macskabagoly	m ɒ t͡ʃ k ɒ b ɒ ɡ o j
macskák	m ɒ t͡ʃ k aː k
macskákig	m ɒ t͡ʃ k aː k i ɡ
madrid	m ɒ d r i d
mag	m ɒ ɡ
maga	m ɒ ɡ ɒ
magad	m ɒ ɡ ɒ d
magadhoz	m ɒ ɡ ɒ t h o z
magadért	m ɒ ɡ ɒ d eː r t
magam	m ɒ ɡ ɒ m
magamhoz	m ɒ ɡ ɒ m ɦ o z
magammal	m ɒ ɡ ɒ mː ɒ l
magamnak	m ɒ ɡ ɒ m n ɒ k
magamért	m ɒ ɡ ɒ m eː r t
magas	m ɒ ɡ ɒ ʃ
magasak	m ɒ ɡ ɒ ʃ ɒ k
magasra	m ɒ ɡ ɒ ʃ r ɒ
magatartás	m ɒ ɡ ɒ t ɒ r t aː ʃ
magazin	m ɒ ɡ ɒ z i n
magazinunk	m ɒ ɡ ɒ z i n u ŋ k
magda	m ɒ ɡ d ɒ
magdolna	m ɒ ɡ d o l n ɒ
maguk	m ɒ ɡ u k
magukat	m ɒ ɡ u k ɒ t
magukban	m ɒ ɡ u ɡ b ɒ n
magukkal	m ɒ ɡ u kː ɒ l
maguknak	m ɒ ɡ u k n ɒ k
magukra	m ɒ ɡ u k r ɒ
magunkat	m ɒ ɡ u ŋ k ɒ t
magunkhoz	m ɒ ɡ u ŋ k h o z
magunkkal	m ɒ ɡ u ŋ k ɒ l
magunknak	m ɒ ɡ u ŋ k n ɒ k
magyarország	m ɒ ɟ ɒ r o r s aː ɡ
magyarországi	m ɒ ɟ ɒ r o r s aː ɡ i
magyarországnak	m ɒ ɟ ɒ r o r s aː ɡ n ɒ k
magyarországon	m ɒ ɟ ɒ r o r s aː ɡ o n
magyarországot	m ɒ ɟ ɒ r o r s aː ɡ o t
magyarországra	m ɒ ɟ ɒ r o r s aː ɡ r ɒ
magyarországról	m ɒ ɟ ɒ r o r s aː ɡ r oː l
magyaros	m ɒ ɟ ɒ r o ʃ
magyarság	m ɒ ɟ ɒ r ʃ aː ɡ
magyarul	m ɒ ɟ ɒ r u l
magyarázat	m ɒ ɟ ɒ r aː z ɒ t
magyarázata	m ɒ ɟ ɒ r aː z ɒ t ɒ
magyarázatot	m ɒ ɟ ɒ r aː z ɒ t o t
magyarázható	m ɒ ɟ ɒ r aː s h ɒ t oː
magyarázni	m ɒ ɟ ɒ r aː z n i
magyarázza	m ɒ ɟ ɒ r aː zː ɒ
magzatok	m ɒ ɡ z ɒ t o k
magában	m ɒ ɡ aː b ɒ n
magához	m ɒ ɡ aː ɦ o z
magán	m ɒ ɡ aː n
magánszemély	m ɒ ɡ aː n s ɛ m eː j
magányos	m ɒ ɡ aː ɲ o ʃ
magánál	m ɒ ɡ aː n aː l
magára	m ɒ ɡ aː r ɒ
magát	m ɒ ɡ aː t
magától	m ɒ ɡ aː t oː l
magával	m ɒ ɡ aː v ɒ l
mai	m ɒ j i
majd	m ɒ j d
majdani	m ɒ j d ɒ n i
major	m ɒ j o r
makedón	m ɒ k ɛ d oː n
makó	m ɒ k oː
malmai	m ɒ l m ɒ j i
mama	m ɒ m ɒ
manapság	m ɒ n ɒ p ʃ aː ɡ
manchester	m ɛ n t͡ʃ ɛ s t ɛ r
mancsok	m ɒ n t͡ʃ o k
mancson	m ɒ n t͡ʃ o n
manipuláció	m ɒ n i p u l aː t͡s i j oː
manó	m ɒ n oː
maradhat	m ɒ r ɒ t h ɒ t
maradjon	m ɒ r ɒ ɟː o n
maradt	m ɒ r ɒ tː
maradék	m ɒ r ɒ d eː k
maradéktalanul	m ɒ r ɒ d eː k t ɒ l ɒ n u l
margarin	m ɒ r ɡ ɒ r i n
marginális	m ɒ r ɡ i n aː l i ʃ
margit	m ɒ r ɡ i t
mari	m ɒ r i
marihuána	m ɒ r i ɦ u aː n ɒ
mariska	m ɒ r i ʃ k ɒ
maros	m ɒ r o ʃ
mars	m ɒ r ʃ
marsi	m ɒ r ʃ i
masina	m ɒ ʃ i n ɒ
matematika	m ɒ t ɛ m ɒ t i k ɒ
matematikai	m ɒ t ɛ m ɒ t i k ɒ j i
maximálisan	m ɒ k s i m aː l i ʃ ɒ n
meccs	m ɛ t͡ʃː
meccsen	m ɛ t͡ʃː ɛ n
meccset	m ɛ t͡ʃː ɛ t
mechanika	m ɛ ɦ ɒ n i k ɒ
mechanikai	m ɛ ɦ ɒ n i k ɒ j i
medence	m ɛ d ɛ n t͡s ɛ
medgyessy	m ɛ ɟː ɛ ʃ i
medvék	m ɛ d v eː k
meg	m ɛ ɡ
megadja	m ɛ ɡ ɒ ɟː ɒ
megadott	m ɛ ɡ ɒ d o tː
megalakult	m ɛ ɡ ɒ l ɒ k u l t
megalakulás	m ɛ ɡ ɒ l ɒ k u l aː ʃ
megalapozott	m ɛ ɡ ɒ l ɒ p o z o tː
megbeszélés	m ɛ ɡ b ɛ s eː l eː ʃ
megbeszélések	m ɛ ɡ b ɛ s eː l eː ʃ ɛ k
megbeszélést	m ɛ ɡ b ɛ s eː l eː ʃ t
megbetegedés	m ɛ ɡ b ɛ t ɛ ɡ ɛ d eː ʃ
megbetegedések	m ɛ ɡ b ɛ t ɛ ɡ ɛ d eː ʃ ɛ k
megbízhatatlan	m ɛ ɡ b iː s h ɒ t ɒ t l ɒ n
megbízható	m ɛ ɡ b iː s h ɒ t oː
megbízhatóan	m ɛ ɡ b iː s h ɒ t oː ɒ n
megbízott	m ɛ ɡ b iː z o tː
megcsinálni	m ɛ k t͡ʃ i n aː l n i
megegyezés	m ɛ ɡ ɛ ɟː ɛ z eː ʃ
megelőzése	m ɛ ɡ ɛ l øː z eː ʃ ɛ
megelőző	m ɛ ɡ ɛ l øː z øː
megerősítése	m ɛ ɡ ɛ r øː ʃ iː t eː ʃ ɛ
megfelel	m ɛ k f ɛ l ɛ l
megfelelni	m ɛ k f ɛ l ɛ l n i
megfelelően	m ɛ k f ɛ l ɛ l øː ɛ n
megfigyelő	m ɛ k f i ɟ ɛ l øː
megfigyelőrendszer	m ɛ k f i ɟ ɛ l øː r ɛ n t͡s ɛ r
megfogalmaz	m ɛ k f o ɡ ɒ l m ɒ z
megfogalmazni	m ɛ k f o ɡ ɒ l m ɒ z n i
megfoghatatlan	m ɛ k f o k h ɒ t ɒ t l ɒ n
meggyőző	m ɛ ɡ ɟ øː z øː
meggyőződve	m ɛ ɡ ɟ øː z øː d v ɛ
meghajol	m ɛ k h ɒ j o l
meghalt	m ɛ k h ɒ l t
meghaltak	m ɛ k h ɒ l t ɒ k
meghatározható	m ɛ k h ɒ t aː r o s h ɒ t oː
meghatározott	m ɛ k h ɒ t aː r o z o tː
meghatározás	m ɛ k h ɒ t aː r o z aː ʃ
meghatározása	m ɛ k h ɒ t aː r o z aː ʃ ɒ
meghatározását	m ɛ k h ɒ t aː r o z aː ʃ aː t
meghatározó	m ɛ k h ɒ t aː r o z oː
megható	m ɛ k h ɒ t oː
meghitt	m ɛ k h i tː
meghosszabbított	m ɛ k h o sː ɒ bː iː t o tː
meghívást	m ɛ k h iː v aː ʃ t
meghívó	m ɛ k h iː v oː
megijed	m ɛ ɡ i j ɛ d
megint	m ɛ ɡ i n t
megjegyezni	m ɛ ɡ j ɛ ɟ ɛ z n i
megjegyzés	m ɛ ɡ j ɛ ɟ z eː ʃ
megjegyzést	m ɛ ɡ j ɛ ɟ z eː ʃ t
megjelenik	m ɛ ɡ j ɛ l ɛ n i k
megjelent	m ɛ ɡ j ɛ l ɛ n t
megjelenés	m ɛ ɡ j ɛ l ɛ n eː ʃ
megjelenése	m ɛ ɡ j ɛ l ɛ n eː ʃ ɛ
megjelenési	m ɛ ɡ j ɛ l ɛ n eː ʃ i
megjelenést	m ɛ ɡ j ɛ l ɛ n eː ʃ t
megjelenésű	m ɛ ɡ j ɛ l ɛ n eː ʃ yː
megjelenít	m ɛ ɡ j ɛ l ɛ n iː t
megjelenő	m ɛ ɡ j ɛ l ɛ n øː
megkezdte	m ɛ kː ɛ s t ɛ
megkezdése	m ɛ kː ɛ z d eː ʃ ɛ
megkezdődik	m ɛ kː ɛ z d øː d i k
megkérdezte	m ɛ kː eː r d ɛ s t ɛ
megköszönni	m ɛ kː ø s ø nː i
meglehetősen	m ɛ ɡ l ɛ h ɛ t øː ʃ ɛ n
meglepetés	m ɛ ɡ l ɛ p ɛ t eː ʃ
meglepetést	m ɛ ɡ l ɛ p ɛ t eː ʃ t
meglepő	m ɛ ɡ l ɛ p øː
meglepőbb	m ɛ ɡ l ɛ p øː bː
meglepően	m ɛ ɡ l ɛ p øː ɛ n
meglévő	m ɛ ɡ l eː v øː
megmarad	m ɛ ɡ m ɒ r ɒ d
megmaradó	m ɛ ɡ m ɒ r ɒ d oː
megnevezés	m ɛ ɡ n ɛ v ɛ z eː ʃ
megnyerte	m ɛ ɡ ɲ ɛ r t ɛ
megnyugtató	m ɛ ɡ ɲ u k t ɒ t oː
megnövekedett	m ɛ ɡ n ø v ɛ k ɛ d ɛ tː
megold	m ɛ ɡ o l d
megoldani	m ɛ ɡ o l d ɒ n i
megoldhatatlan	m ɛ ɡ o l t h ɒ t ɒ t l ɒ n
megoldás	m ɛ ɡ o l d aː ʃ
megoldások	m ɛ ɡ o l d aː ʃ o k
megoldásokat	m ɛ ɡ o l d aː ʃ o k ɒ t
megoldással	m ɛ ɡ o l d aː ʃː ɒ l
megoldást	m ɛ ɡ o l d aː ʃ t
megoldására	m ɛ ɡ o l d aː ʃ aː r ɒ
megoldását	m ɛ ɡ o l d aː ʃ aː t
megpróbáltatás	m ɛ k p r oː b aː l t ɒ t aː ʃ
megrendelés	m ɛ ɡ r ɛ n d ɛ l eː ʃ
megrendelést	m ɛ ɡ r ɛ n d ɛ l eː ʃ t
megrendezésre	m ɛ ɡ r ɛ n d ɛ z eː ʃ r ɛ
megrázó	m ɛ ɡ r aː z oː
megszerzése	m ɛ k s ɛ r z eː ʃ ɛ
megszerzésére	m ɛ k s ɛ r z eː ʃ eː r ɛ
megszokott	m ɛ k s o k o tː
megszállás	m ɛ k s aː lː aː ʃ
megszüntetése	m ɛ k s y n t ɛ t eː ʃ ɛ
megtalál	m ɛ k t ɒ l aː l
megtalálni	m ɛ k t ɒ l aː l n i
megtalálta	m ɛ k t ɒ l aː l t ɒ
megtartani	m ɛ k t ɒ r t ɒ n i
megtartása	m ɛ k t ɒ r t aː ʃ ɒ
megtekintéséhez	m ɛ k t ɛ k i n t eː ʃ eː ɦ ɛ z
megtelik	m ɛ k t ɛ l i k
megteremtése	m ɛ k t ɛ r ɛ m t eː ʃ ɛ
megtermékenyítés	m ɛ k t ɛ r m eː k ɛ ɲ iː t eː ʃ
megtesz	m ɛ k t ɛ s
megtette	m ɛ k t ɛ tː ɛ
megtud	m ɛ k t u d
megtudni	m ɛ k t u d n i
megtudta	m ɛ k t u tː ɒ
megtudtam	m ɛ k t u tː ɒ m
megvenni	m ɛ ɡ v ɛ nː i
megvizsgál	m ɛ ɡ v i ʒ ɡ aː l
megválasztott	m ɛ ɡ v aː l ɒ s t o tː
megváltozik	m ɛ ɡ v aː l t o z i k
megvásárolni	m ɛ ɡ v aː ʃ aː r o l n i
megy	m ɛ ɟ
megyei	m ɛ ɟ ɛ j i
megáldott	m ɛ ɡ aː l d o tː
megállapodás	m ɛ ɡ aː lː ɒ p o d aː ʃ
megállapított	m ɛ ɡ aː lː ɒ p iː t o tː
megállás	m ɛ ɡ aː lː aː ʃ
megérteni	m ɛ ɡ eː r t ɛ n i
megértés	m ɛ ɡ eː r t eː ʃ
megítélése	m ɛ ɡ iː t eː l eː ʃ ɛ
megölte	m ɛ ɡ ø l t ɛ
megújuló	m ɛ ɡ uː j u l oː
megőrizni	m ɛ ɡ øː r i z n i
mekkora	m ɛ kː o r ɒ
meleg	m ɛ l ɛ ɡ
melegebb	m ɛ l ɛ ɡ ɛ bː
mellem	m ɛ lː ɛ m
mellett	m ɛ lː ɛ tː
mellette	m ɛ lː ɛ tː ɛ
melletti	m ɛ lː ɛ tː i
mellettünk	m ɛ lː ɛ tː y ŋ k
mellső	m ɛ l ʃ øː
mellyel	m ɛ jː ɛ l
mellékes	m ɛ lː eː k ɛ ʃ
mellékhatás	m ɛ lː eː k h ɒ t aː ʃ
melléklet	m ɛ lː eː k l ɛ t
mellőle	m ɛ lː øː l ɛ
mely	m ɛ j
melyből	m ɛ j b øː l
melyek	m ɛ j ɛ k
melyekben	m ɛ j ɛ ɡ b ɛ n
melyeken	m ɛ j ɛ k ɛ n
melyeket	m ɛ j ɛ k ɛ t
melyekkel	m ɛ j ɛ kː ɛ l
melyeknek	m ɛ j ɛ k n ɛ k
melyekre	m ɛ j ɛ k r ɛ
melyen	m ɛ j ɛ n
melyet	m ɛ j ɛ t
melyhez	m ɛ j h ɛ z
melynek	m ɛ j n ɛ k
melyre	m ɛ j r ɛ
memória	m ɛ m oː r i j ɒ
memóriát	m ɛ m oː r i j aː t
menedzser	m ɛ n ɛ d͡ʒː ɛ r
menedzserek	m ɛ n ɛ d͡ʒː ɛ r ɛ k
menedzsment	m ɛ n ɛ d͡ʒ m ɛ n t
menedék	m ɛ n ɛ d eː k
menekült	m ɛ n ɛ k y l t
menekültek	m ɛ n ɛ k y l t ɛ k
menet	m ɛ n ɛ t
menete	m ɛ n ɛ t ɛ
menetrend	m ɛ n ɛ t r ɛ n d
menj	m ɛ ɲː
menjünk	m ɛ ɲː y ŋ k
menne	m ɛ nː ɛ
mennek	m ɛ nː ɛ k
menni	m ɛ nː i
mennyből	m ɛ ɲ b øː l
mennyei	m ɛ ɲː ɛ j i
mennyi	m ɛ ɲː i
mennyire	m ɛ ɲː i r ɛ
mennyiség	m ɛ ɲː i ʃ eː ɡ
mennyisége	m ɛ ɲː i ʃ eː ɡ ɛ
mennyiségek	m ɛ ɲː i ʃ eː ɡ ɛ k
mennyiségi	m ɛ ɲː i ʃ eː ɡ i
mennyiségét	m ɛ ɲː i ʃ eː ɡ eː t
mennyiségű	m ɛ ɲː i ʃ eː ɡ yː
mennyit	m ɛ ɲː i t
mennyivel	m ɛ ɲː i v ɛ l
ment	m ɛ n t
mentek	m ɛ n t ɛ k
mentem	m ɛ n t ɛ m
mentes	m ɛ n t ɛ ʃ
menti	m ɛ n t i
mentél	m ɛ n t eː l
mentén	m ɛ n t eː n
mentünk	m ɛ n t y ŋ k
mentők	m ɛ n t øː k
menyasszony	m ɛ ɲ ɒ sː o ɲ
menük	m ɛ n y k
menüpont	m ɛ n y p o n t
merek	m ɛ r ɛ k
merem	m ɛ r ɛ m
merev	m ɛ r ɛ v
merevlemez	m ɛ r ɛ v l ɛ m ɛ z
meri	m ɛ r i
meritek	m ɛ r i t ɛ k
mert	m ɛ r t
merte	m ɛ r t ɛ
merényletek	m ɛ r eː ɲ l ɛ t ɛ k
merénylő	m ɛ r eː ɲ l øː
merészel	m ɛ r eː s ɛ l
merőleges	m ɛ r øː l ɛ ɡ ɛ ʃ
messze	m ɛ sː ɛ
messzebb	m ɛ sː ɛ bː
messzi	m ɛ sː i
messzire	m ɛ sː i r ɛ
messziről	m ɛ sː i r øː l
mester	m ɛ ʃ t ɛ r
mestere	m ɛ ʃ t ɛ r ɛ
mestereket	m ɛ ʃ t ɛ r ɛ k ɛ t
mesék	m ɛ ʃ eː k
mesél	m ɛ ʃ eː l
mesét	m ɛ ʃ eː t
meteorológiai	m ɛ t ɛ o r o l oː ɡ i j ɒ j i
metró	m ɛ t r oː
mezei	m ɛ z ɛ j i
mezítláb	m ɛ z iː t l aː b
mezőgazdasági	m ɛ z øː ɡ ɒ z d ɒ ʃ aː ɡ i
mezők	m ɛ z øː k
mezőn	m ɛ z øː n
mezőny	m ɛ z øː ɲ
mi	m i
mibe	m i b ɛ
miből	m i b øː l
micsoda	m i t͡ʃ o d ɒ
mieink	m i j ɛ j i ŋ k
mielőbbi	m i j ɛ l øː bː i
mielőtt	m i j ɛ l øː tː
mihez	m i ɦ ɛ z
mihály	m i ɦ aː j
mik	m i k
mikor	m i k o r
mikorra	m i k o rː ɒ
mikszáth	m i k s aː t
mikulás	m i k u l aː ʃ
miként	m i k eː n t
millenniumi	m i lː ɛ nː i j u m i
milliomos	m i l i j o m o ʃ
milliárd	m i lː i j aː r d
milliárdos	m i l i j aː r d o ʃ
milliárdosok	m i lː i j aː r d o ʃ o k
milyen	m i j ɛ n
milyennek	m i j ɛ nː ɛ k
minap	m i n ɒ p
mind	m i n d
mindaddig	m i n d ɒ dː i ɡ
mindannyian	m i n d ɒ ɲː i j ɒ n
mindazok	m i n d ɒ z o k
mindeddig	m i n d ɛ dː i ɡ
mindegy	m i n d ɛ ɟː
mindegyik	m i n d ɛ ɟː i k
mindegyikük	m i n d ɛ ɟː i k y k
mindenben	m i n d ɛ m b ɛ n
mindenek	m i n d ɛ n ɛ k
mindenfelé	m i n d ɛ ɱ f ɛ l eː
mindenféle	m i n d ɛ ɱ f eː l ɛ
mindenható	m i n d ɛ n ɦ ɒ t oː
mindenhol	m i n d ɛ n ɦ o l
mindenki	m i n d ɛ ŋ k i
mindenkinek	m i n d ɛ ŋ k i n ɛ k
mindenkire	m i n d ɛ ŋ k i r ɛ
mindenkit	m i n d ɛ ŋ k i t
mindenkivel	m i n d ɛ ŋ k i v ɛ l
mindenkor	m i n d ɛ ŋ k o r
mindenkori	m i n d ɛ ŋ k o r i
mindenképpen	m i n d ɛ ŋ k eː pː ɛ n
mindennap	m i n d ɛ nː ɒ p
mindennapi	m i n d ɛ nː ɒ p i
mindennek	m i n d ɛ nː ɛ k
mindennel	m i n d ɛ nː ɛ l
mindenütt	m i n d ɛ n y tː
mindez	m i n d ɛ z
mindezek	m i n d ɛ z ɛ k
mindezt	m i n d ɛ s t
mindhárom	m i n t h aː r o m
mindjárt	m i ɲ ɟ aː r t
mindkettő	m i n t k ɛ tː øː
mindkét	m i n t k eː t
mindmáig	m i n d m aː j i ɡ
mindössze	m i n d ø sː ɛ
minek	m i n ɛ k
miniatűr	m i n i j ɒ t yː r
minimális	m i n i m aː l i ʃ
minimálisan	m i n i m aː l i ʃ ɒ n
miniszter	m i n i s t ɛ r
miniszterek	m i n i s t ɛ r ɛ k
miniszterelnök	m i n i s t ɛ r ɛ l n ø k
miniszteri	m i n i s t ɛ r i
minisztérium	m i n i s t eː r i j u m
minisztériumi	m i n i s t eː r i j u m i
mint	m i n t
mintegy	m i n t ɛ ɟː
minőség	m i n øː ʃ eː ɡ
minőségben	m i n øː ʃ eː ɡ b ɛ n
minősége	m i n øː ʃ eː ɡ ɛ
minőségileg	m i n øː ʃ eː ɡ i l ɛ ɡ
minőségű	m i n øː ʃ eː ɡ yː
minősítés	m i n øː ʃ iː t eː ʃ
minősül	m i n øː ʃ y l
miskolc	m i ʃ k o l t͡s
miskolci	m i ʃ k o l t͡s i
miskolcon	m i ʃ k o l t͡s o n
misszió	m i sː i j oː
mit	m i t
mivel	m i v ɛ l
miénk	m i j eː ŋ k
miért	m i j eː r t
mióta	m i j oː t ɒ
mobil	m o b i l
mobiltelefon	m o b i l t ɛ l ɛ f o n
mocsarat	m o t͡ʃ ɒ r ɒ t
mocskos	m o t͡ʃ k o ʃ
modell	m o d ɛ lː
modellek	m o d ɛ lː ɛ k
modelleket	m o d ɛ lː ɛ k ɛ t
modellje	m o d ɛ jː ɛ
modellt	m o d ɛ l t
modul	m o d u l
mohar	m o ɦ ɒ r
molnár	m o l n aː r
mond	m o n d
mondanak	m o n d ɒ n ɒ k
mondaná	m o n d ɒ n aː
mondat	m o n d ɒ t
mondata	m o n d ɒ t ɒ
mondj	m o ɲ ɟ
mondja	m o ɲ ɟ ɒ
mondjak	m o ɲ ɟ ɒ k
mondjam	m o ɲ ɟ ɒ m
mondjuk	m o ɲ ɟ u k
mondják	m o ɲ ɟ aː k
mondom	m o n d o m
mondott	m o n d o tː
mondta	m o n t ɒ
mondták	m o n t aː k
mondás	m o n d aː ʃ
mondó	m o n d oː
monetáris	m o n ɛ t aː r i ʃ
monitor	m o n i t o r
monitorok	m o n i t o r o k
monostor	m o n o ʃ t o r
moratórium	m o r ɒ t oː r i j u m
morális	m o r aː l i ʃ
mosdóállvány	m o ʒ d oː aː l v aː ɲ
most	m o ʃ t
mostani	m o ʃ t ɒ n i
mostanra	m o ʃ t ɒ n r ɒ
mostanában	m o ʃ t ɒ n aː b ɒ n
moszkva	m o s k v ɒ
mosópor	m o ʃ oː p o r
mosószer	m o ʃ oː s ɛ r
motor	m o t o r
motorcsónak	m o t o r t͡ʃ oː n ɒ k
motorháztető	m o t o r ɦ aː s t ɛ t øː
motorja	m o t o r j ɒ
motorkerékpárok	m o t o r k ɛ r eː k p aː r o k
motorokon	m o t o r o k o n
motorral	m o t o rː ɒ l
mozaik	m o z ɒ j i k
mozart	m oː t͡s aː r t
mozdulatlanul	m o z d u l ɒ t l ɒ n u l
mozgalmas	m o z ɡ ɒ l m ɒ ʃ
mozgalom	m o z ɡ ɒ l o m
mozgás	m o z ɡ aː ʃ
mozgása	m o z ɡ aː ʃ ɒ
mozgásban	m o z ɡ aː ʒ b ɒ n
mozgássérült	m o z ɡ aː ʃː eː r y l t
mozgó	m o z ɡ oː
mozi	m o z i
mozira	m o z i r ɒ
mozog	m o z o ɡ
mp	m aː ʃ o t p ɛ r t͡s
mszp	ɛ m ɛ s p eː
mti	ɛ m t eː j i
mulat	m u l ɒ t
multi	m u l t i
munkaadó	m u ŋ k ɒ ɒ d oː
munkaadók	m u ŋ k ɒ ɒ d oː k
munkabérek	m u ŋ k ɒ b eː r ɛ k
munkacsoport	m u ŋ k ɒ t͡ʃ o p o r t
munkacsoportok	m u ŋ k ɒ t͡ʃ o p o r t o k
munkahely	m u ŋ k ɒ ɦ ɛ j
munkahelyen	m u ŋ k ɒ ɦ ɛ j ɛ n
munkaidő	m u ŋ k ɒ j i d øː
munkanélküli	m u ŋ k ɒ n eː l k y l i
munkanélküliek	m u ŋ k ɒ n eː l k y l i j ɛ k
munkaszüneti	m u ŋ k ɒ s y n ɛ t i
munkatárs	m u ŋ k ɒ t aː r ʃ
munkatársa	m u ŋ k ɒ t aː r ʃ ɒ
munkatársai	m u ŋ k ɒ t aː r ʃ ɒ j i
munkáik	m u ŋ k aː j i k
munkáim	m u ŋ k aː j i m
munkájuk	m u ŋ k aː j u k
munkálat	m u ŋ k aː l ɒ t
munkáltató	m u ŋ k aː l t ɒ t oː
munkám	m u ŋ k aː m
munkás	m u ŋ k aː ʃ
munkások	m u ŋ k aː ʃ o k
munkásokat	m u ŋ k aː ʃ o k ɒ t
munkássága	m u ŋ k aː ʃː aː ɡ ɒ
musical	m j u z i k ɛ l
must	m u ʃ t
muszlim	m u s l i m
mutatjuk	m u t ɒ cː u k
mutatják	m u t ɒ cː aː k
mutatkozik	m u t ɒ t k o z i k
mutatni	m u t ɒ t n i
muzsikál	m u ʒ i k aː l
máig	m aː j i ɡ
május	m aː j u ʃ
májusban	m aː j u ʒ b ɒ n
májusi	m aː j u ʃ i
májusában	m aː j u ʃ aː b ɒ n
mák	m aː k
mámor	m aː m o r
már	m aː r
mára	m aː r ɒ
március	m aː r t͡s i j u ʃ
márciusban	m aː r t͡s i j u ʒ b ɒ n
márciusi	m aː r t͡s i j u ʃ i
márciusában	m aː r t͡s i j u ʃ aː b ɒ n
máris	m aː r i ʃ
márka	m aː r k ɒ
márkák	m aː r k aː k
márpedig	m aː r p ɛ d i ɡ
mártás	m aː r t aː ʃ
márvány	m aː r v aː ɲ
más	m aː ʃ
másban	m aː ʒ b ɒ n
másfelől	m aː ʃ f ɛ l øː l
másfél	m aː ʃ f eː l
máshogy	m aː ʃ h o ɟ
máshol	m aː ʃ h o l
máshonnan	m aː ʃ h o nː ɒ n
másik	m aː ʃ i k
másikat	m aː ʃ i k ɒ t
másiknak	m aː ʃ i k n ɒ k
másikról	m aː ʃ i k r oː l
másiktól	m aː ʃ i k t oː l
másként	m aː ʃ k eː n t
másképp	m aː ʃ k eː pː
másképpen	m aː ʃ k eː pː ɛ n
másnak	m aː ʃ n ɒ k
másnap	m aː ʃ n ɒ p
másodfokú	m aː ʃ o t f o k uː
második	m aː ʃ o d i k
másodpercig	m aː ʃ o t p ɛ r t͡s i ɡ
másodszor	m aː ʃ o t͡sː o r
mások	m aː ʃ o k
másokat	m aː ʃ o k ɒ t
másokhoz	m aː ʃ o k h o z
másokkal	m aː ʃ o kː ɒ l
másokra	m aː ʃ o k r ɒ
másoké	m aː ʃ o k eː
másolata	m aː ʃ o l ɒ t ɒ
másolás	m aː ʃ o l aː ʃ
másra	m aː ʃ r ɒ
másrészt	m aː ʃ r eː s t
másról	m aː ʃ r oː l
mást	m aː ʃ t
másutt	m aː ʃ u tː
mászik	m aː s i k
mátyás	m aː c aː ʃ
máté	m aː t eː
mától	m aː t oː l
média	m eː d i j ɒ
médiában	m eː d i j aː b ɒ n
mégis	m eː ɡ i ʃ
mégsem	m eː k ʃ ɛ m
méhek	m eː ɦ ɛ k
méhen	m eː ɦ ɛ n
méltán	m eː l t aː n
méltánytalan	m eː l t aː ɲ t ɒ l ɒ n
méltó	m eː l t oː
méltóságteljes	m eː l t oː ʃ aː k t ɛ jː ɛ ʃ
mély	m eː j
mélybe	m eː j b ɛ
mélyebb	m eː j ɛ bː
mélyen	m eː j ɛ n
mélyre	m eː j r ɛ
mélyén	m eː j eː n
mérd	m eː r d
méretben	m eː r ɛ d b ɛ n
méretű	m eː r ɛ t yː
mérföld	m eː r f ø l d
mérföldre	m eː r f ø l d r ɛ
mérgező	m eː r ɡ ɛ z øː
mérni	m eː r n i
mérsékelt	m eː r ʃ eː k ɛ l t
mért	m eː r t
mérte	m eː r t ɛ
mérten	m eː r t ɛ n
mérték	m eː r t eː k
mértékben	m eː r t eː ɡ b ɛ n
mértékű	m eː r t eː k yː
mértük	m eː r t y k
mérők	m eː r øː k
mész	m eː s
mészkő	m eː s k øː
méter	m eː t ɛ r
méteres	m eː t ɛ r ɛ ʃ
méterre	m eː t ɛ rː ɛ
méterről	m eː t ɛ rː øː l
míg	m iː ɡ
mód	m oː d
módja	m oː ɟː ɒ
módokat	m oː d o k ɒ t
módon	m oː d o n
módosítani	m oː d o ʃ iː t ɒ n i
módosított	m oː d o ʃ iː t o tː
módosítására	m oː d o ʃ iː t aː ʃ aː r ɒ
módosításáról	m oː d o ʃ iː t aː ʃ aː r oː l
módosítását	m oː d o ʃ iː t aː ʃ aː t
módosító	m oː d o ʃ iː t oː
módot	m oː d o t
módszer	m oː t s ɛ r
módszerek	m oː t s ɛ r ɛ k
módszerekkel	m oː t s ɛ r ɛ kː ɛ l
módszert	m oː t s ɛ r t
módszertani	m oː t s ɛ r t ɒ n i
mókásan	m oː k aː ʃ ɒ n
móni	m oː n i
mózes	m oː z ɛ ʃ
mögé	m ø ɡ eː
mögött	m ø ɡ ø tː
mögötte	m ø ɡ ø tː ɛ
mögöttünk	m ø ɡ ø tː y ŋ k
mögül	m ø ɡ y l
múlt	m uː l t
múltat	m uː l t ɒ t
múltán	m uː l t aː n
múzeum	m uː z ɛ u m
múzeumban	m uː z ɛ u m b ɒ n
múzeumi	m uː z ɛ u m i
müller	m y lː ɛ r
müncheni	m y ɲ c h ɛ n i
mű	m yː
műanyag	m yː ɒ ɲ ɒ ɡ
műfaj	m yː f ɒ j
műhely	m yː ɦ ɛ j
műhelyek	m yː ɦ ɛ j ɛ k
működik	m yː k ø d i k
működtet	m yː k ø tː ɛ t
működés	m yː k ø d eː ʃ
működésbe	m yː k ø d eː ʒ b ɛ
működési	m yː k ø d eː ʃ i
működő	m yː k ø d øː
műsor	m yː ʃ o r
műsora	m yː ʃ o r ɒ
műsorban	m yː ʃ o r b ɒ n
műsorok	m yː ʃ o r o k
műszaki	m yː s ɒ k i
műszer	m yː s ɛ r
műterme	m yː t ɛ r m ɛ
műtéti	m yː t eː t i
műve	m yː v ɛ
művei	m yː v ɛ j i
műveit	m yː v ɛ j i t
művelt	m yː v ɛ l t
műveltségi	m yː v ɛ l t͡ʃ eː ɡ i
művész	m yː v eː s
művészek	m yː v eː s ɛ k
művészet	m yː v eː s ɛ t
művészetek	m yː v eː s ɛ t ɛ k
művészeti	m yː v eː s ɛ t i
művészi	m yː v eː s i
művésznő	m yː v eː s n øː
művét	m yː v eː t
nadrág	n ɒ d r aː ɡ
nadrágban	n ɒ d r aː ɡ b ɒ n
nagy	n ɒ ɟ
nagyarányú	n ɒ ɟ ɒ r aː ɲ uː
nagyban	n ɒ ɟ b ɒ n
nagybetűs	n ɒ ɟ b ɛ t yː ʃ
nagyjából	n ɒ ɟː aː b oː l
nagykereskedelem	n ɒ c k ɛ r ɛ ʃ k ɛ d ɛ l ɛ m
nagykereskedelmi	n ɒ c k ɛ r ɛ ʃ k ɛ d ɛ l m i
nagyközség	n ɒ c k ø ʃː eː ɡ
nagylelkű	n ɒ ɟ l ɛ l k yː
nagymama	n ɒ ɟ m ɒ m ɒ
nagyméretű	n ɒ ɟ m eː r ɛ t yː
nagymértékben	n ɒ ɟ m eː r t eː ɡ b ɛ n
nagyobb	n ɒ ɟ o bː
nagyon	n ɒ ɟ o n
nagyot	n ɒ ɟ o t
nagypapák	n ɒ c p ɒ p aː k
nagyra	n ɒ ɟ r ɒ
nagyrészt	n ɒ ɟ r eː s t
nagyszámú	n ɒ c s aː m uː
nagysága	n ɒ c ʃ aː ɡ ɒ
nagyságú	n ɒ c ʃ aː ɡ uː
nagyvonalú	n ɒ ɟ v o n ɒ l uː
nagyvállalatok	n ɒ ɟ v aː lː ɒ l ɒ t o k
nagyérdemű	n ɒ ɟ eː r d ɛ m yː
nap	n ɒ p
napból	n ɒ bː oː l
napi	n ɒ p i
napig	n ɒ p i ɡ
napilapok	n ɒ p i l ɒ p o k
napirend	n ɒ p i r ɛ n d
napja	n ɒ p j ɒ
napjai	n ɒ p j ɒ j i
napján	n ɒ p j aː n
napjától	n ɒ p j aː t oː l
napló	n ɒ p l oː
napok	n ɒ p o k
napokban	n ɒ p o ɡ b ɒ n
napokon	n ɒ p o k o n
napon	n ɒ p o n
naponta	n ɒ p o n t ɒ
napot	n ɒ p o t
nappal	n ɒ pː ɒ l
nappali	n ɒ pː ɒ l i
napra	n ɒ p r ɒ
napsugár	n ɒ p ʃ u ɡ aː r
naptól	n ɒ p t oː l
napvilágot	n ɒ p v i l aː ɡ o t
narancs	n ɒ r ɒ n t͡ʃ
narancssárga	n ɒ r ɒ n t͡ʃ ʃ aː r ɡ ɒ
navigáció	n ɒ v i ɡ aː t͡s i j oː
nb	ɛ m b eː
ne	n ɛ
nedves	n ɛ d v ɛ ʃ
negatív	n ɛ ɡ ɒ t iː v
negyed	n ɛ ɟ ɛ d
negyedik	n ɛ ɟ ɛ d i k
negyedszer	n ɛ ɟ ɛ t͡sː ɛ r
negyven	n ɛ ɟ v ɛ n
nehezen	n ɛ h ɛ z ɛ n
nehogy	n ɛ ɦ o ɟ
nehézség	n ɛ ɦ eː ʃː eː ɡ
nehézségek	n ɛ ɦ eː ʃː eː ɡ ɛ k
nehézsúlyú	n ɛ ɦ eː ʃː uː j uː
neked	n ɛ k ɛ d
nekem	n ɛ k ɛ m
neki	n ɛ k i
nekik	n ɛ k i k
nekimegy	n ɛ k i m ɛ ɟ
nemcsak	n ɛ m t͡ʃ ɒ k
nemesi	n ɛ m ɛ ʃ i
nemi	n ɛ m i
nemigen	n ɛ m i ɡ ɛ n
nemmel	n ɛ mː ɛ l
nemrég	n ɛ m r eː ɡ
nemrégiben	n ɛ m r eː ɡ i b ɛ n
nemsokára	n ɛ m ʃ o k aː r ɒ
nemzet	n ɛ m z ɛ t
nemzetek	n ɛ m z ɛ t ɛ k
nemzeti	n ɛ m z ɛ t i
nemzetközi	n ɛ m z ɛ t k ø z i
nemzetség	n ɛ m z ɛ t͡ʃː eː ɡ
net	n ɛ t
neten	n ɛ t ɛ n
neve	n ɛ v ɛ
neved	n ɛ v ɛ d
nevek	n ɛ v ɛ k
neveket	n ɛ v ɛ k ɛ t
nevelik	n ɛ v ɛ l i k
nevelni	n ɛ v ɛ l n i
nevelés	n ɛ v ɛ l eː ʃ
nevelési	n ɛ v ɛ l eː ʃ i
nevet	n ɛ v ɛ t
nevetni	n ɛ v ɛ t n i
nevetséges	n ɛ v ɛ t͡ʃː eː ɡ ɛ ʃ
nevez	n ɛ v ɛ z
nevezetesen	n ɛ v ɛ z ɛ t ɛ ʃ ɛ n
nevezik	n ɛ v ɛ z i k
nevezni	n ɛ v ɛ z n i
nevezés	n ɛ v ɛ z eː ʃ
nevében	n ɛ v eː b ɛ n
nevéhez	n ɛ v eː ɦ ɛ z
nevének	n ɛ v eː n ɛ k
nevére	n ɛ v eː r ɛ
nevét	n ɛ v eː t
ni	n i
nikolett	n i k o l ɛ tː
nincs	n i n t͡ʃ
nincsen	n i n t͡ʃ ɛ n
nincsenek	n i n t͡ʃ ɛ n ɛ k
nitrogén	n i t r o ɡ eː n
noha	n o ɦ ɒ
normál	n o r m aː l
normális	n o r m aː l i ʃ
nos	n o ʃ
notórius	n o t oː r i j u ʃ
november	n o v ɛ m b ɛ r
novemberben	n o v ɛ m b ɛ r b ɛ n
novemberi	n o v ɛ m b ɛ r i
noé	n o j eː
nulla	n u lː ɒ
nyakkendő	ɲ ɒ kː ɛ n d øː
nyakába	ɲ ɒ k aː b ɒ
nyaralás	ɲ ɒ r ɒ l aː ʃ
nyelek	ɲ ɛ l ɛ k
nyelvetek	ɲ ɛ l v ɛ t ɛ k
nyelvi	ɲ ɛ l v i
nyelvészek	ɲ ɛ l v eː s ɛ k
nyelvünk	ɲ ɛ l v y ŋ k
nyelvű	ɲ ɛ l v yː
nyereg	ɲ ɛ r ɛ ɡ
nyeremény	ɲ ɛ r ɛ m eː ɲ
nyerni	ɲ ɛ r n i
nyers	ɲ ɛ r ʃ
nyert	ɲ ɛ r t
nyertes	ɲ ɛ r t ɛ ʃ
nyilatkozatok	ɲ i l ɒ t k o z ɒ t o k
nyilatkozatát	ɲ i l ɒ t k o z ɒ t aː t
nyilatkozik	ɲ i l ɒ t k o z i k
nyilatkozni	ɲ i l ɒ t k o z n i
nyilván	ɲ i l v aː n
nyilvános	ɲ i l v aː n o ʃ
nyilvánosság	ɲ i l v aː n o ʃː aː ɡ
nyilvánosságra	ɲ i l v aː n o ʃː aː ɡ r ɒ
nyilvántartás	ɲ i l v aː n t ɒ r t aː ʃ
nyilvántartása	ɲ i l v aː n t ɒ r t aː ʃ ɒ
nyilvántartásba	ɲ i l v aː n t ɒ r t aː ʒ b ɒ
nyilvántartási	ɲ i l v aː n t ɒ r t aː ʃ i
nyilvánvaló	ɲ i l v aː ɱ v ɒ l oː
nyilvánvalóan	ɲ i l v aː ɱ v ɒ l oː ɒ n
nyilvánvalóvá	ɲ i l v aː ɱ v ɒ l oː v aː
nyit	ɲ i t
nyitott	ɲ i t o tː
nyitottak	ɲ i t o tː ɒ k
nyitva	ɲ i t v ɒ
nyitó	ɲ i t oː
nyolcadik	ɲ o l t͡s ɒ d i k
nyolcvanas	ɲ o l t͡s v ɒ n ɒ ʃ
nyolcvankettő	ɲ o l t͡s v ɒ ŋ k ɛ tː øː
nyoma	ɲ o m ɒ
nyomai	ɲ o m ɒ j i
nyomaték	ɲ o m ɒ t eː k
nyomni	ɲ o m n i
nyomon	ɲ o m o n
nyomor	ɲ o m o r
nyomott	ɲ o m o tː
nyomozás	ɲ o m o z aː ʃ
nyomozó	ɲ o m o z oː
nyomozóiroda	ɲ o m o z oː j i r o d ɒ
nyomozók	ɲ o m o z oː k
nyomtatványok	ɲ o m t ɒ t v aː ɲ o k
nyomtatás	ɲ o m t ɒ t aː ʃ
nyomtatási	ɲ o m t ɒ t aː ʃ i
nyomtató	ɲ o m t ɒ t oː
nyomában	ɲ o m aː b ɒ n
nyomán	ɲ o m aː n
nyomás	ɲ o m aː ʃ
nyugat	ɲ u ɡ ɒ t
nyugati	ɲ u ɡ ɒ t i
nyugatra	ɲ u ɡ ɒ t r ɒ
nyugdíj	ɲ u ɡ d iː j
nyugdíjak	ɲ u ɡ d iː j ɒ k
nyugdíjba	ɲ u ɡ d iː j b ɒ
nyuggerek	ɲ u ɡː ɛ r ɛ k
nyugodtan	ɲ u ɡ o tː ɒ n
nyugszik	ɲ u k s i k
nyugtalanság	ɲ u k t ɒ l ɒ n ʃ aː ɡ
nyugtalanító	ɲ u k t ɒ l ɒ n iː t oː
nyulak	ɲ u l ɒ k
nyuszi	ɲ u s i
nyár	ɲ aː r
nyári	ɲ aː r i
nyáron	ɲ aː r o n
nyílik	ɲ iː l i k
nyílt	ɲ iː l t
nyílás	ɲ iː l aː ʃ
nyíregyházi	ɲ iː r ɛ c h aː z i
nyög	ɲ ø ɡ
nyújt	ɲ uː j t
nyúl	ɲ uː l
náci	n aː t͡s i
nádor	n aː d o r
nála	n aː l ɒ
nálad	n aː l ɒ d
nálam	n aː l ɒ m
náluk	n aː l u k
nálunk	n aː l u ŋ k
négy	n eː ɟ
négyes	n eː ɟ ɛ ʃ
négyszemközt	n eː c s ɛ m k ø s t
négyszer	n eː c s ɛ r
négyzetméter	n eː ɟ z ɛ t m eː t ɛ r
néha	n eː ɦ ɒ
néhanapján	n eː ɦ ɒ n ɒ p j aː n
néhányan	n eː ɦ aː ɲ ɒ n
néktek	n eː k t ɛ k
nélkül	n eː l k y l
nélkülözhetetlen	n eː l k y l ø s h ɛ t ɛ t l ɛ n
némely	n eː m ɛ j
német	n eː m ɛ t
németek	n eː m ɛ t ɛ k
németh	n eː m ɛ t
némileg	n eː m i l ɛ ɡ
néni	n eː n i
nép	n eː p
népek	n eː p ɛ k
népet	n eː p ɛ t
népi	n eː p i
népirtás	n eː p i r t aː ʃ
néprajzi	n eː p r ɒ j z i
népszavazás	n eː p s ɒ v ɒ z aː ʃ
népszerű	n eː p s ɛ r yː
népét	n eː p eː t
név	n eː v
néven	n eː v ɛ n
névtelen	n eː f t ɛ l ɛ n
névvel	n eː vː ɛ l
néz	n eː z
nézd	n eː z d
nézek	n eː z ɛ k
nézem	n eː z ɛ m
nézet	n eː z ɛ t
nézetek	n eː z ɛ t ɛ k
nézett	n eː z ɛ tː
nézettség	n eː z ɛ t͡ʃː eː ɡ
nézte	n eː s t ɛ
néztem	n eː s t ɛ m
nézve	n eː z v ɛ
nézzenek	n eː zː ɛ n ɛ k
nézzétek	n eː zː eː t ɛ k
nézzük	n eː zː y k
nézünk	n eː z y ŋ k
növekedés	n ø v ɛ k ɛ d eː ʃ
növekedése	n ø v ɛ k ɛ d eː ʃ ɛ
növekedési	n ø v ɛ k ɛ d eː ʃ i
növekedést	n ø v ɛ k ɛ d eː ʃ t
növekedését	n ø v ɛ k ɛ d eː ʃ eː t
növekedésével	n ø v ɛ k ɛ d eː ʃ eː v ɛ l
növelte	n ø v ɛ l t ɛ
növelése	n ø v ɛ l eː ʃ ɛ
növelésére	n ø v ɛ l eː ʃ eː r ɛ
növelését	n ø v ɛ l eː ʃ eː t
növény	n ø v eː ɲ
növények	n ø v eː ɲ ɛ k
növényi	n ø v eː ɲ i
növényzet	n ø v eː ɲ z ɛ t
nő	n øː
nőhet	n øː ɦ ɛ t
női	n øː j i
nőies	n øː j i j ɛ ʃ
nők	n øː k
nőnek	n øː n ɛ k
nőstény	n øː ʃ t eː ɲ
nőt	n øː t
nőtt	n øː tː
nővér	n øː v eː r
objektumok	o b j ɛ k t u m o k
objektív	o b j ɛ k t iː v
oda	o d ɒ
odafigyel	o d ɒ f i ɟ ɛ l
ok	o k
oka	o k ɒ
okai	o k ɒ j i
okból	o ɡ b oː l
okirat	o k i r ɒ t
oklevelek	o k l ɛ v ɛ l ɛ k
oklevelet	o k l ɛ v ɛ l ɛ t
oklevél	o k l ɛ v eː l
okmány	o k m aː ɲ
okmányok	o k m aː ɲ o k
okok	o k o k
okokat	o k o k ɒ t
okokra	o k o k r ɒ
okos	o k o ʃ
okot	o k o t
okoz	o k o z
okozhat	o k o s h ɒ t
okoznak	o k o z n ɒ k
okozott	o k o z o tː
okozta	o k o s t ɒ
okozó	o k o z oː
okra	o k r ɒ
oktatás	o k t ɒ t aː ʃ
oktatása	o k t ɒ t aː ʃ ɒ
oktatásban	o k t ɒ t aː ʒ b ɒ n
oktatói	o k t ɒ t oː j i
október	o k t oː b ɛ r
októberben	o k t oː b ɛ r b ɛ n
októberi	o k t oː b ɛ r i
okát	o k aː t
olaj	o l ɒ j
olajos	o l ɒ j o ʃ
olasz	o l ɒ s
olaszok	o l ɒ s o k
olaszország	o l ɒ s o r s aː ɡ
olaszországban	o l ɒ s o r s aː ɡ b ɒ n
olcsó	o l t͡ʃ oː
olcsóbb	o l t͡ʃ oː bː
olcsóbban	o l t͡ʃ oː bː ɒ n
oldal	o l d ɒ l
oldalak	o l d ɒ l ɒ k
oldalakon	o l d ɒ l ɒ k o n
oldali	o l d ɒ l i
oldalon	o l d ɒ l o n
oldalra	o l d ɒ rː ɒ
oldalról	o l d ɒ rː oː l
oldalsó	o l d ɒ l ʃ oː
oldalt	o l d ɒ l t
oldalunkon	o l d ɒ l u ŋ k o n
oldalán	o l d ɒ l aː n
oldalát	o l d ɒ l aː t
oldható	o l t h ɒ t oː
olimpia	o l i m p i j ɒ
olvadás	o l v ɒ d aː ʃ
olvas	o l v ɒ ʃ
olvasható	o l v ɒ ʃ h ɒ t oː
olvasni	o l v ɒ ʃ n i
olvasom	o l v ɒ ʃ o m
olvassa	o l v ɒ ʃː ɒ
olvasási	o l v ɒ ʃ aː ʃ i
olvasó	o l v ɒ ʃ oː
olvasók	o l v ɒ ʃ oː k
olvasót	o l v ɒ ʃ oː t
olyan	o j ɒ n
olyanok	o j ɒ n o k
olyanokat	o j ɒ n o k ɒ t
olyasmi	o j ɒ ʃ m i
olykor	o j k o r
ominózus	o m i n oː z u ʃ
online	o n l aː j n
onnan	o nː ɒ n
operatív	o p ɛ r ɒ t iː v
optikai	o p t i k ɒ j i
optimista	o p t i m i ʃ t ɒ
optimális	o p t i m aː l i ʃ
orbán	o r b aː n
orosz	o r o s
oroszok	o r o s o k
oroszország	o r o s o r s aː ɡ
orrsövény	o r ʃ ø v eː ɲ
orsolya	o r ʃ o j ɒ
országgyűlés	o r s aː ɡ ɟ yː l eː ʃ
országos	o r s aː ɡ o ʃ
országosan	o r s aː ɡ o ʃ ɒ n
országút	o r s aː ɡ uː t
orvos	o r v o ʃ
orvoshoz	o r v o ʃ h o z
orvosok	o r v o ʃ o k
orvosolható	o r v o ʃ o l ɦ ɒ t oː
orvost	o r v o ʃ t
orvostanhallgatók	o r v o ʃ t ɒ n ɦ ɒ l ɡ ɒ t oː k
ossza	o sː ɒ
osszák	o sː aː k
ostya	o ʃ c ɒ
oszd	o z d
osztanak	o s t ɒ n ɒ k
osztható	o s t h ɒ t oː
osztják	o s c aː k
osztottak	o s t o tː ɒ k
osztották	o s t o tː aː k
osztrák	o s t r aː k
osztály	o s t aː j
osztályban	o s t aː j b ɒ n
osztályos	o s t aː j o ʃ
osztályozás	o s t aː j o z aː ʃ
osztályú	o s t aː j uː
oszét	o s eː t
ottani	o tː ɒ n i
otthon	o t h o n
otthoni	o t h o n i
otthonok	o t h o n o k
otthonról	o t h o n r oː l
padlón	p ɒ d l oː n
padon	p ɒ d o n
pajzs	p ɒ j ʒ
pakisztáni	p ɒ k i s t aː n i
paksi	p ɒ k ʃ i
palesztin	p ɒ l ɛ s t i n
palota	p ɒ l o t ɒ
panasz	p ɒ n ɒ s
panaszokat	p ɒ n ɒ s o k ɒ t
panaszos	p ɒ n ɒ s o ʃ
panziók	p ɒ n z i j oː k
pap	p ɒ p
papa	p ɒ p ɒ
papi	p ɒ p i
papp	p ɒ p
paradigmaváltás	p ɒ r ɒ d i ɡ m ɒ v aː l t aː ʃ
paraméterek	p ɒ r ɒ m eː t ɛ r ɛ k
paraszt	p ɒ r ɒ s t
parasztház	p ɒ r ɒ s t h aː z
paripa	p ɒ r i p ɒ
park	p ɒ r k
parkok	p ɒ r k o k
parkoló	p ɒ r k o l oː
parlament	p ɒ r l ɒ m ɛ n t
parlamentben	p ɒ r l ɒ m ɛ n d b ɛ n
parlamenti	p ɒ r l ɒ m ɛ n t i
parti	p ɒ r t i
partján	p ɒ r c aː n
partnere	p ɒ r t n ɛ r ɛ
partnereink	p ɒ r t n ɛ r ɛ j i ŋ k
parton	p ɒ r t o n
partra	p ɒ r t r ɒ
passzol	p ɒ sː o l
passzív	p ɒ sː iː v
pataki	p ɒ t ɒ k i
patika	p ɒ t i k ɒ
patkány	p ɒ t k aː ɲ
pedig	p ɛ d i ɡ
pelenkák	p ɛ l ɛ ŋ k aː k
pelikán	p ɛ l i k aː n
pengő	p ɛ ŋ ɡ øː
per	p ɛ r
perc	p ɛ r t͡s
perccel	p ɛ r t͡s ɛ l
percek	p ɛ r t͡s ɛ k
percen	p ɛ r t͡s ɛ n
percenként	p ɛ r t͡s ɛ ŋ k eː n t
perces	p ɛ r t͡s ɛ ʃ
percre	p ɛ r t͡s r ɛ
perek	p ɛ r ɛ k
peres	p ɛ r ɛ ʃ
persze	p ɛ r s ɛ
pert	p ɛ r t
perverz	p ɛ r v ɛ r z
perzsa	p ɛ r ʒ ɒ
pest	p ɛ ʃ t
pesti	p ɛ ʃ t i
petőfi	p ɛ t øː f i
piac	p i j ɒ t͡s
piacok	p i j ɒ t͡s o k
piacon	p i j ɒ t͡s o n
piacot	p i j ɒ t͡s o t
piacra	p i j ɒ t͡s r ɒ
piacvezető	p i j ɒ t͡s v ɛ z ɛ t øː
pierre	p i j ɛ r
pihenés	p i ɦ ɛ n eː ʃ
piknik	p i k n i k
pillanat	p i lː ɒ n ɒ t
pillanatban	p i lː ɒ n ɒ d b ɒ n
pillanatig	p i lː ɒ n ɒ t i ɡ
pillanatok	p i lː ɒ n ɒ t o k
pillanatot	p i lː ɒ n ɒ t o t
pillanatra	p i lː ɒ n ɒ t r ɒ
pillant	p i lː ɒ n t
pilóta	p i l oː t ɒ
pince	p i n t͡s ɛ
pincében	p i n t͡s eː b ɛ n
pincérek	p i n t͡s eː r ɛ k
pirit	p i r i t
piros	p i r o ʃ
pirulájuk	p i r u l aː j u k
pisti	p i ʃ t i
plakát	p l ɒ k aː t
plakátok	p l ɒ k aː t o k
platform	p l ɒ t f o r m
platón	p l ɒ t oː n
plenáris	p l ɛ n aː r i ʃ
pletykák	p l ɛ c k aː k
plébánia	p l eː b aː n i j ɒ
pm	p eː j ɛ m
pofon	p o f o n
pogány	p o ɡ aː ɲ
polgárháború	p o l ɡ aː r ɦ aː b o r uː
polgári	p o l ɡ aː r i
polgármestere	p o l ɡ aː r m ɛ ʃ t ɛ r ɛ
polgármesteri	p o l ɡ aː r m ɛ ʃ t ɛ r i
polgárság	p o l ɡ aː r ʃ aː ɡ
polisztirol	p o l i s t i r o l
politika	p o l i t i k ɒ
politikai	p o l i t i k ɒ j i
politikus	p o l i t i k u ʃ
politikusok	p o l i t i k u ʃ o k
politikában	p o l i t i k aː b ɒ n
politikája	p o l i t i k aː j ɒ
politikát	p o l i t i k aː t
pontos	p o n t o ʃ
pontosabban	p o n t o ʃ ɒ bː ɒ n
pontosan	p o n t o ʃ ɒ n
populista	p o p u l i ʃ t ɒ
popzene	p o b z ɛ n ɛ
por	p o r
porcelán	p o r t͡s ɛ l aː n
portugália	p o r t u ɡ aː l i j ɒ
portál	p o r t aː l
portán	p o r t aː n
portás	p o r t aː ʃ
posta	p o ʃ t ɒ
postások	p o ʃ t aː ʃ o k
pozitív	p o z i t iː v
pozsonyi	p o ʒ o ɲ i
pozíció	p o z iː t͡s i j oː
pozícióban	p o z iː t͡s i j oː b ɒ n
pozíciója	p o z iː t͡s i j oː j ɒ
prezentációk	p r ɛ z ɛ n t aː t͡s i j oː k
privatizációs	p r i v ɒ t i z aː t͡s i j oː ʃ
probléma	p r o b l eː m ɒ
problémái	p r o b l eː m aː j i
problémáit	p r o b l eː m aː j i t
problémája	p r o b l eː m aː j ɒ
problémák	p r o b l eː m aː k
problémákat	p r o b l eː m aː k ɒ t
problémákkal	p r o b l eː m aː kː ɒ l
problémát	p r o b l eː m aː t
processzor	p r o t͡s ɛ sː o r
produkció	p r o d u k t͡s i j oː
produkál	p r o d u k aː l
professzora	p r o f ɛ sː o r ɒ
profi	p r o f i
profik	p r o f i k
profil	p r o f i l
prognózis	p r o ɡ n oː z i ʃ
program	p r o ɡ r ɒ m
programba	p r o ɡ r ɒ m b ɒ
programjai	p r o ɡ r ɒ m j ɒ j i
programjaink	p r o ɡ r ɒ m j ɒ j i ŋ k
programmal	p r o ɡ r ɒ mː ɒ l
programnak	p r o ɡ r ɒ m n ɒ k
programnál	p r o ɡ r ɒ m n aː l
programok	p r o ɡ r ɒ m o k
programokat	p r o ɡ r ɒ m o k ɒ t
programokhoz	p r o ɡ r ɒ m o k h o z
programot	p r o ɡ r ɒ m o t
programra	p r o ɡ r ɒ m r ɒ
projekt	p r o j ɛ k t
projektek	p r o j ɛ k t ɛ k
projektet	p r o j ɛ k t ɛ t
propaganda	p r o p ɒ ɡ ɒ n d ɒ
protein	p r o t ɛ j i n
provokatív	p r o v o k ɒ t iː v
prémium	p r eː m i j u m
próbája	p r oː b aː j ɒ
próbál	p r oː b aː l
próbálja	p r oː b aː jː ɒ
próbálkozik	p r oː b aː l k o z i k
próbálkozás	p r oː b aː l k o z aː ʃ
pszichiátriai	p s i h i j aː t r i j ɒ j i
pszichológia	p s i ɦ o l oː ɡ i j ɒ
pszichológiai	p s i ɦ o l oː ɡ i j ɒ j i
publikus	p u b l i k u ʃ
puha	p u ɦ ɒ
pult	p u l t
pupilla	p u p i lː ɒ
puszi	p u s i
pusztul	p u s t u l
pusztító	p u s t iː t oː
putyin	p u c i n
páciens	p aː t͡s i j ɛ n ʃ
páholy	p aː ɦ o j
pál	p aː l
pálinkák	p aː l i ŋ k aː k
pályafutása	p aː j ɒ f u t aː ʃ ɒ
pályázati	p aː j aː z ɒ t i
pályázók	p aː j aː z oː k
pánik	p aː n i k
pápa	p aː p ɒ
pápai	p aː p ɒ j i
pár	p aː r
páratlan	p aː r ɒ t l ɒ n
párduc	p aː r d u t͡s
párhuzamos	p aː r ɦ u z ɒ m o ʃ
párizsban	p aː r i ʒ b ɒ n
párizsi	p aː r i ʒ i
páros	p aː r o ʃ
párt	p aː r t
pártja	p aː r c ɒ
pártok	p aː r t o k
pásztor	p aː s t o r
pátens	p aː t ɛ n ʃ
páva	p aː v ɒ
pécs	p eː t͡ʃ
pécsi	p eː t͡ʃ i
példa	p eː l d ɒ
példaként	p eː l d ɒ k eː n t
példája	p eː l d aː j ɒ
példányok	p eː l d aː ɲ o k
példányt	p eː l d aː ɲ t
példátlan	p eː l d aː t l ɒ n
például	p eː l d aː u l
pénteken	p eː n t ɛ k ɛ n
pénz	p eː n z
pénzbe	p eː n z b ɛ
pénzben	p eː n z b ɛ n
pénzből	p eː n z b øː l
pénze	p eː n z ɛ
pénzeket	p eː n z ɛ k ɛ t
pénzem	p eː n z ɛ m
pénzhiány	p eː n s h i j aː ɲ
pénzt	p eː n s t
pénztár	p eː n s t aː r
pénzért	p eː n z eː r t
pénzügyi	p eː n z y ɟ i
pénzügyminiszter	p eː n z y ɟ m i n i s t ɛ r
pénzügyminisztérium	p eː n z y ɟ m i n i s t eː r i j u m
péter	p eː t ɛ r
póló	p oː l oː
pótlása	p oː t l aː ʃ ɒ
pótolni	p oː t o l n i
rabbi	r ɒ bː i
rabbik	r ɒ bː i k
rablás	r ɒ b l aː ʃ
rabok	r ɒ b o k
radikálisan	r ɒ d i k aː l i ʃ ɒ n
ragadozó	r ɒ ɡ ɒ d o z oː
ragasztani	r ɒ ɡ ɒ s t ɒ n i
rajongói	r ɒ j o ŋ ɡ oː j i
rajongók	r ɒ j o ŋ ɡ oː k
rajta	r ɒ j t ɒ
rajtam	r ɒ j t ɒ m
rajzoló	r ɒ j z o l oː
rakni	r ɒ k n i
raktáron	r ɒ k t aː r o n
rangját	r ɒ ŋ ɡ j aː t
rangos	r ɒ ŋ ɡ o ʃ
rangot	r ɒ ŋ ɡ o t
rangú	r ɒ ŋ ɡ uː
rasszizmus	r ɒ sː i z m u ʃ
reagálni	r ɛ ɒ ɡ aː l n i
realisztikus	r ɛ ɒ l i s t i k u ʃ
reform	r ɛ f o r m
református	r ɛ f o r m aː t u ʃ
reggel	r ɛ ɡː ɛ l
reggeli	r ɛ ɡː ɛ l i
reggelire	r ɛ ɡː ɛ l i r ɛ
reggelre	r ɛ ɡː ɛ rː ɛ
regény	r ɛ ɡ eː ɲ
rejlik	r ɛ j l i k
rejti	r ɛ j t i
rejtély	r ɛ j t eː j
reklám	r ɛ k l aː m
reklámok	r ɛ k l aː m o k
reklámszoftver	r ɛ k l aː m s o f t v ɛ r
rekord	r ɛ k o r d
rekordok	r ɛ k o r d o k
remek	r ɛ m ɛ k
remekmű	r ɛ m ɛ k m yː
remélem	r ɛ m eː l ɛ m
remélhetőleg	r ɛ m eː l ɦ ɛ t øː l ɛ ɡ
reméli	r ɛ m eː l i
reméljük	r ɛ m eː jː y k
rend	r ɛ n d
rendbe	r ɛ n d b ɛ
rendben	r ɛ n d b ɛ n
rendelkezik	r ɛ n d ɛ l k ɛ z i k
rendelkeznek	r ɛ n d ɛ l k ɛ z n ɛ k
rendelkezés	r ɛ n d ɛ l k ɛ z eː ʃ
rendelkezéseket	r ɛ n d ɛ l k ɛ z eː ʃ ɛ k ɛ t
rendelkezésre	r ɛ n d ɛ l k ɛ z eː ʃ r ɛ
rendelkezésére	r ɛ n d ɛ l k ɛ z eː ʃ eː r ɛ
rendelkezésünkre	r ɛ n d ɛ l k ɛ z eː ʃ y ŋ k r ɛ
rendelkező	r ɛ n d ɛ l k ɛ z øː
rendelkezők	r ɛ n d ɛ l k ɛ z øː k
rendelni	r ɛ n d ɛ l n i
rendelés	r ɛ n d ɛ l eː ʃ
rendelések	r ɛ n d ɛ l eː ʃ ɛ k
rendes	r ɛ n d ɛ ʃ
rendesen	r ɛ n d ɛ ʃ ɛ n
rendet	r ɛ n d ɛ t
rendezvény	r ɛ n d ɛ z v eː ɲ
rendezvények	r ɛ n d ɛ z v eː ɲ ɛ k
rendezvényeken	r ɛ n d ɛ z v eː ɲ ɛ k ɛ n
rendezvényen	r ɛ n d ɛ z v eː ɲ ɛ n
rendezvényt	r ɛ n d ɛ z v eː ɲ t
rendezésében	r ɛ n d ɛ z eː ʃ eː b ɛ n
rendező	r ɛ n d ɛ z øː
rendezőt	r ɛ n d ɛ z øː t
rendje	r ɛ ɲ ɟ ɛ
rendkívül	r ɛ n t k iː v y l
rendkívüli	r ɛ n t k iː v y l i
rendre	r ɛ n d r ɛ
rendszerben	r ɛ n t s ɛ r b ɛ n
rendszere	r ɛ n t s ɛ r ɛ
rendszerek	r ɛ n t s ɛ r ɛ k
rendszerekben	r ɛ n t s ɛ r ɛ ɡ b ɛ n
rendszereket	r ɛ n t s ɛ r ɛ k ɛ t
rendszerekre	r ɛ n t s ɛ r ɛ k r ɛ
rendszerhez	r ɛ n t s ɛ r ɦ ɛ z
rendszerint	r ɛ n t͡s ɛ r i n t
rendszernek	r ɛ n t s ɛ r n ɛ k
rendszerre	r ɛ n t s ɛ rː ɛ
rendszerrel	r ɛ n t s ɛ rː ɛ l
rendszert	r ɛ n t s ɛ r t
rendszertől	r ɛ n t s ɛ r t øː l
rendszerváltás	r ɛ n t s ɛ r v aː l t aː ʃ
rendszerét	r ɛ n t s ɛ r eː t
rendőr	r ɛ n d øː r
rendőri	r ɛ n d øː r i
rendőrség	r ɛ n d øː r ʃ eː ɡ
rendőrségi	r ɛ n d øː r ʃ eː ɡ i
reneszánsz	r ɛ n ɛ s aː n s
repülőtér	r ɛ p y l øː t eː r
rezsim	r ɛ ʒ i m
reá	r ɛ aː
reád	r ɛ aː d
riga	r i ɡ ɒ
rigó	r i ɡ oː
riporter	r i p o r t ɛ r
ritkaság	r i t k ɒ ʃ aː ɡ
ritkábban	r i t k aː bː ɒ n
rituális	r i t u aː l i ʃ
robban	r o bː ɒ n
robbanás	r o bː ɒ n aː ʃ
rohan	r o ɦ ɒ n
rokona	r o k o n ɒ
rokonai	r o k o n ɒ j i
rokonság	r o k o n ʃ aː ɡ
roma	r o m ɒ
romantika	r o m ɒ n t i k ɒ
román	r o m aː n
romániai	r o m aː n i j ɒ j i
ront	r o n t
rossz	r o sː
rosszabb	r o sː ɒ bː
rosszat	r o sː ɒ t
rosszban	r o z b ɒ n
rovarok	r o v ɒ r o k
rovatban	r o v ɒ d b ɒ n
rugalmasan	r u ɡ ɒ l m ɒ ʃ ɒ n
ruhában	r u ɦ aː b ɒ n
ruhája	r u ɦ aː j ɒ
ruhák	r u ɦ aː k
ruhánk	r u ɦ aː ŋ k
ruhát	r u ɦ aː t
rá	r aː
rába	r aː b ɒ
ráchel	r aː ɦ ɛ l
rácz	r aː t͡s
rád	r aː d
rádió	r aː d i j oː
rágógumi	r aː ɡ oː ɡ u m i
rájuk	r aː j u k
rák	r aː k
rákóczi	r aː k oː t͡s i
rám	r aː m
rámutat	r aː m u t ɒ t
ránk	r aː ŋ k
rántotta	r aː n t o tː ɒ
ráta	r aː t ɒ
rázza	r aː zː ɒ
rég	r eː ɡ
régóta	r eː ɡ oː t ɒ
réka	r eː k ɒ
rész	r eː s
részben	r eː z b ɛ n
részből	r eː z b øː l
részecske	r eː s ɛ t͡ʃ k ɛ
részecskék	r eː s ɛ t͡ʃ k eː k
részei	r eː s ɛ j i
részeit	r eː s ɛ j i t
részek	r eː s ɛ k
részeken	r eː s ɛ k ɛ n
részeket	r eː s ɛ k ɛ t
részekre	r eː s ɛ k r ɛ
részes	r eː s ɛ ʃ
részesít	r eː s ɛ ʃ iː t
részleteit	r eː s l ɛ t ɛ j i t
részletek	r eː s l ɛ t ɛ k
részleteket	r eː s l ɛ t ɛ k ɛ t
részletes	r eː s l ɛ t ɛ ʃ
részletesebb	r eː s l ɛ t ɛ ʃ ɛ bː
részletesen	r eː s l ɛ t ɛ ʃ ɛ n
részletét	r eː s l ɛ t eː t
részre	r eː s r ɛ
részről	r eː s r øː l
részt	r eː s t
részvétel	r eː s v eː t ɛ l
részük	r eː s y k
részükre	r eː s y k r ɛ
részünkre	r eː s y ŋ k r ɛ
réteg	r eː t ɛ ɡ
rétegek	r eː t ɛ ɡ ɛ k
rétek	r eː t ɛ k
réti	r eː t i
révén	r eː v eː n
rímek	r iː m ɛ k
róbert	r oː b ɛ r t
róka	r oː k ɒ
rólad	r oː l ɒ d
rólam	r oː l ɒ m
róluk	r oː l u k
róma	r oː m ɒ
római	r oː m ɒ j i
róna	r oː n ɒ
rózsa	r oː ʒ ɒ
rózsaszín	r oː ʒ ɒ s iː n
rögtön	r ø k t ø n
rögzíteni	r ø ɡ z iː t ɛ n i
röhög	r ø h ø ɡ
röplabda	r ø p l ɒ b d ɒ
rövid	r ø v i d
rövidebb	r ø v i d ɛ bː
röviden	r ø v i d ɛ n
rövidesen	r ø v i d ɛ ʃ ɛ n
rúd	r uː d
rőzse	r øː ʒ ɛ
sablon	ʃ ɒ b l o n
sajna	ʃ ɒ j n ɒ
sajnálatos	ʃ ɒ j n aː l ɒ t o ʃ
sajtó	ʃ ɒ j t oː
sajtóban	ʃ ɒ j t oː b ɒ n
sajtótájékoztató	ʃ ɒ j t oː t aː j eː k o s t ɒ t oː
sajtótájékoztatón	ʃ ɒ j t oː t aː j eː k o s t ɒ t oː n
saját	ʃ ɒ j aː t
sajátos	ʃ ɒ j aː t o ʃ
sajátosság	ʃ ɒ j aː t o ʃː aː ɡ
salamon	ʃ ɒ l ɒ m o n
sarkad	ʃ ɒ r k ɒ d
sarkallt	ʃ ɒ r k ɒ l t
sarkon	ʃ ɒ r k o n
sarkán	ʃ ɒ r k aː n
sarlók	ʃ ɒ r l oː k
sas	ʃ ɒ ʃ
sav	ʃ ɒ v
sava	ʃ ɒ v ɒ
se	ʃ ɛ
sebaj	ʃ ɛ b ɒ j
sebesség	ʃ ɛ b ɛ ʃː eː ɡ
sebességet	ʃ ɛ b ɛ ʃː eː ɡ ɛ t
sebességét	ʃ ɛ b ɛ ʃː eː ɡ eː t
sebészeti	ʃ ɛ b eː s ɛ t i
segge	ʃ ɛ ɡː ɛ
segély	ʃ ɛ ɡ eː j
segít	ʃ ɛ ɡ iː t
segítenek	ʃ ɛ ɡ iː t ɛ n ɛ k
segíteni	ʃ ɛ ɡ iː t ɛ n i
segítettem	ʃ ɛ ɡ iː t ɛ tː ɛ m
segítség	ʃ ɛ ɡ iː t͡ʃː eː ɡ
segítséget	ʃ ɛ ɡ iː t͡ʃː eː ɡ ɛ t
segítséggel	ʃ ɛ ɡ iː t͡ʃː eː ɡː ɛ l
segítségnyújtás	ʃ ɛ ɡ iː t͡ʃː eː ɡ ɲ uː j t aː ʃ
segítségére	ʃ ɛ ɡ iː t͡ʃː eː ɡ eː r ɛ
segítségért	ʃ ɛ ɡ iː t͡ʃː eː ɡ eː r t
segítségével	ʃ ɛ ɡ iː t͡ʃː eː ɡ eː v ɛ l
segítése	ʃ ɛ ɡ iː t eː ʃ ɛ
segítő	ʃ ɛ ɡ iː t øː
segítők	ʃ ɛ ɡ iː t øː k
selyem	ʃ ɛ j ɛ m
sem	ʃ ɛ m
semleges	ʃ ɛ m l ɛ ɡ ɛ ʃ
semlegesek	ʃ ɛ m l ɛ ɡ ɛ ʃ ɛ k
semlegesnem	ʃ ɛ m l ɛ ɡ ɛ ʃ n ɛ m
semmi	ʃ ɛ mː i
semmibe	ʃ ɛ mː i b ɛ
semmiféle	ʃ ɛ mː i f eː l ɛ
semmihez	ʃ ɛ mː i ɦ ɛ z
semmiképp	ʃ ɛ mː i k eː pː
semmilyen	ʃ ɛ mː i j ɛ n
semmire	ʃ ɛ mː i r ɛ
semmit	ʃ ɛ mː i t
senki	ʃ ɛ ŋ k i
senkinek	ʃ ɛ ŋ k i n ɛ k
senkit	ʃ ɛ ŋ k i t
sereg	ʃ ɛ r ɛ ɡ
siess	ʃ i j ɛ ʃː
siker	ʃ i k ɛ r
sikerek	ʃ i k ɛ r ɛ k
sikereket	ʃ i k ɛ r ɛ k ɛ t
sikerre	ʃ i k ɛ rː ɛ
sikerrel	ʃ i k ɛ rː ɛ l
sikert	ʃ i k ɛ r t
sikertelen	ʃ i k ɛ r t ɛ l ɛ n
sikerül	ʃ i k ɛ r y l
sikerült	ʃ i k ɛ r y l t
simon	ʃ i m o n
simán	ʃ i m aː n
sincs	ʃ i n t͡ʃ
sitten	ʃ i tː ɛ n
sivatagi	ʃ i v ɒ t ɒ ɡ i
sofőr	ʃ o f øː r
soha	ʃ o ɦ ɒ
sohase	ʃ o ɦ ɒ ʃ ɛ
sokan	ʃ o k ɒ n
sokféle	ʃ o k f eː l ɛ
sokkal	ʃ o kː ɒ l
sokoldalú	ʃ o k o l d ɒ l uː
sokszor	ʃ o k s o r
somogy	ʃ o m o ɟ
sopron	ʃ o p r o n
soproni	ʃ o p r o n i
sor	ʃ o r
sora	ʃ o r ɒ
sorban	ʃ o r b ɒ n
sorból	ʃ o r b oː l
soron	ʃ o r o n
soros	ʃ o r o ʃ
sorozat	ʃ o r o z ɒ t
sorozatban	ʃ o r o z ɒ d b ɒ n
sorozatokat	ʃ o r o z ɒ t o k ɒ t
sorozatokban	ʃ o r o z ɒ t o ɡ b ɒ n
sorozatot	ʃ o r o z ɒ t o t
sorra	ʃ o rː ɒ
sorrend	ʃ o rː ɛ n d
sors	ʃ o r ʃ
sorsa	ʃ o r ʃ ɒ
sorsuk	ʃ o r ʃ u k
sorsán	ʃ o r ʃ aː n
sorsának	ʃ o r ʃ aː n ɒ k
sorsát	ʃ o r ʃ aː t
sorsával	ʃ o r ʃ aː v ɒ l
során	ʃ o r aː n
sorát	ʃ o r aː t
sosem	ʃ o ʃ ɛ m
sovinizmus	ʃ o v i n i z m u ʃ
sovány	ʃ o v aː ɲ
spanyol	ʃ p ɒ ɲ o l
spanyolország	ʃ p ɒ ɲ o l o r s aː ɡ
speciális	ʃ p ɛ t͡s i j aː l i ʃ
spermium	ʃ p ɛ r m i j u m
spirituális	ʃ p i r i t u aː l i ʃ
spontán	ʃ p o n t aː n
sport	ʃ p o r t
sportolók	ʃ p o r t o l oː k
sportszerű	ʃ p o r t s ɛ r yː
spárga	ʃ p aː r ɡ ɒ
stabil	ʃ t ɒ b i l
statikus	ʃ t ɒ t i k u ʃ
statisztikai	ʃ t ɒ t i s t i k ɒ j i
statisztikák	ʃ t ɒ t i s t i k aː k
stockholm	ʃ t o k h o l m
strand	ʃ t r ɒ n d
strandon	ʃ t r ɒ n d o n
stratégia	ʃ t r ɒ t eː ɡ i j ɒ
stratégiai	ʃ t r ɒ t eː ɡ i j ɒ j i
stressz	ʃ t r ɛ sː
strukturális	ʃ t r u k t u r aː l i ʃ
struktúra	ʃ t r u k t uː r ɒ
stáb	ʃ t aː b
stílusa	ʃ t iː l u ʃ ɒ
stílusos	ʃ t iː l u ʃ o ʃ
stúdió	ʃ t uː d i j oː
stúdióban	ʃ t uː d i j oː b ɒ n
sugárzás	ʃ u ɡ aː r z aː ʃ
suli	ʃ u l i
suliban	ʃ u l i b ɒ n
svájci	ʃ v aː j t͡s i
svéd	ʃ v eː d
svédek	ʃ v eː d ɛ k
szabad	s ɒ b ɒ d
szabadcsapat	s ɒ b ɒ t t͡ʃ ɒ p ɒ t
szabadidős	s ɒ b ɒ d i d øː ʃ
szabadlábon	s ɒ b ɒ d l aː b o n
szabadna	s ɒ b ɒ d n ɒ
szabadnak	s ɒ b ɒ d n ɒ k
szabadok	s ɒ b ɒ d o k
szabadon	s ɒ b ɒ d o n
szabadság	s ɒ b ɒ t͡ʃː aː ɡ
szabadságharc	s ɒ b ɒ t͡ʃː aː k h ɒ r t͡s
szabadságot	s ɒ b ɒ t͡ʃː aː ɡ o t
szabadulni	s ɒ b ɒ d u l n i
szabja	s ɒ b j ɒ
szabolcs	s ɒ b o l t͡ʃ
szabály	s ɒ b aː j
szabályai	s ɒ b aː j ɒ j i
szabályok	s ɒ b aː j o k
szabályosan	s ɒ b aː j o ʃ ɒ n
szabályozás	s ɒ b aː j o z aː ʃ
szabályozása	s ɒ b aː j o z aː ʃ ɒ
szabályozási	s ɒ b aː j o z aː ʃ i
szabályozások	s ɒ b aː j o z aː ʃ o k
szabályozó	s ɒ b aː j o z oː
szabálytalan	s ɒ b aː j t ɒ l ɒ n
szabályzat	s ɒ b aː j z ɒ t
szakadt	s ɒ k ɒ tː
szakasz	s ɒ k ɒ s
szakaszok	s ɒ k ɒ s o k
szakaszon	s ɒ k ɒ s o n
szakaszában	s ɒ k ɒ s aː b ɒ n
szakember	s ɒ k ɛ m b ɛ r
szakemberei	s ɒ k ɛ m b ɛ r ɛ j i
szakemberek	s ɒ k ɛ m b ɛ r ɛ k
szakemberekkel	s ɒ k ɛ m b ɛ r ɛ kː ɛ l
szakirány	s ɒ k i r aː ɲ
szakirányú	s ɒ k i r aː ɲ uː
szakképzés	s ɒ kː eː b z eː ʃ
szakközépiskola	s ɒ kː ø z eː p i ʃ k o l ɒ
szakon	s ɒ k o n
szakrális	s ɒ k r aː l i ʃ
szakszervezeti	s ɒ k s ɛ r v ɛ z ɛ t i
szakszerű	s ɒ k s ɛ r yː
szakterület	s ɒ k t ɛ r y l ɛ t
szakterülete	s ɒ k t ɛ r y l ɛ t ɛ
szakáll	s ɒ k aː lː
szakértő	s ɒ k eː r t øː
szakértői	s ɒ k eː r t øː j i
szakértők	s ɒ k eː r t øː k
szalon	s ɒ l o n
szappan	s ɒ pː ɒ n
szarka	s ɒ r k ɒ
szavai	s ɒ v ɒ j i
szavaival	s ɒ v ɒ j i v ɒ l
szavak	s ɒ v ɒ k
szavakon	s ɒ v ɒ k o n
szavaz	s ɒ v ɒ z
szavazatot	s ɒ v ɒ z ɒ t o t
szavazattal	s ɒ v ɒ z ɒ tː ɒ l
szavazni	s ɒ v ɒ z n i
szavazás	s ɒ v ɒ z aː ʃ
szavazásra	s ɒ v ɒ z aː ʃ r ɒ
szavát	s ɒ v aː t
szdsz	ɛ z d eː j ɛ s
szebb	s ɛ bː
szeged	s ɛ ɡ ɛ d
szegeden	s ɛ ɡ ɛ d ɛ n
szegedi	s ɛ ɡ ɛ d i
szegényes	s ɛ ɡ eː ɲ ɛ ʃ
szekció	s ɛ k t͡s i j oː
szekeres	s ɛ k ɛ r ɛ ʃ
szekrényt	s ɛ k r eː ɲ t
szekta	s ɛ k t ɒ
szektor	s ɛ k t o r
szekér	s ɛ k eː r
szelektív	s ɛ l ɛ k t iː v
szelleme	s ɛ lː ɛ m ɛ
szellemes	s ɛ lː ɛ m ɛ ʃ
szellemi	s ɛ lː ɛ m i
szellemű	s ɛ lː ɛ m yː
szellő	s ɛ lː øː
szellős	s ɛ lː øː ʃ
szelíd	s ɛ l iː d
szeme	s ɛ m ɛ
szemed	s ɛ m ɛ d
szemelvény	s ɛ m ɛ l v eː ɲ
szememre	s ɛ m ɛ m r ɛ
szemetet	s ɛ m ɛ t ɛ t
szemlélet	s ɛ m l eː l ɛ t
szempontból	s ɛ m p o n d b oː l
szempontok	s ɛ m p o n t o k
szempontokat	s ɛ m p o n t o k ɒ t
szemrehányást	s ɛ m r ɛ ɦ aː ɲ aː ʃ t
szemébe	s ɛ m eː b ɛ
személy	s ɛ m eː j
személyek	s ɛ m eː j ɛ k
személyeket	s ɛ m eː j ɛ k ɛ t
személyes	s ɛ m eː j ɛ ʃ
személygépkocsi	s ɛ m eː j ɡ eː p k o t͡ʃ i
személyi	s ɛ m eː j i
személyiségek	s ɛ m eː j i ʃ eː ɡ ɛ k
személynek	s ɛ m eː j n ɛ k
személyre	s ɛ m eː j r ɛ
személyt	s ɛ m eː j t
személytől	s ɛ m eː j t øː l
személyzettel	s ɛ m eː j z ɛ tː ɛ l
szemén	s ɛ m eː n
szemére	s ɛ m eː r ɛ
szemét	s ɛ m eː t
szemével	s ɛ m eː v ɛ l
szemük	s ɛ m y k
szennyezés	s ɛ ɲː ɛ z eː ʃ
szentelt	s ɛ n t ɛ l t
szentes	s ɛ n t ɛ ʃ
szentháromság	s ɛ n t h aː r o m ʃ aː ɡ
szentség	s ɛ n t͡ʃ eː ɡ
szenvedő	s ɛ ɱ v ɛ d øː
szeptember	s ɛ p t ɛ m b ɛ r
szeptemberben	s ɛ p t ɛ m b ɛ r b ɛ n
szerbek	s ɛ r b ɛ k
szerda	s ɛ r d ɒ
szerdai	s ɛ r d ɒ j i
szerdán	s ɛ r d aː n
szerek	s ɛ r ɛ k
szerelem	s ɛ r ɛ l ɛ m
szerelmes	s ɛ r ɛ l m ɛ ʃ
szerelmi	s ɛ r ɛ l m i
szerelés	s ɛ r ɛ l eː ʃ
szerencsétlen	s ɛ r ɛ n t͡ʃ eː t l ɛ n
szerep	s ɛ r ɛ p
szerepek	s ɛ r ɛ p ɛ k
szerepelnek	s ɛ r ɛ p ɛ l n ɛ k
szerepelt	s ɛ r ɛ p ɛ l t
szerepeltek	s ɛ r ɛ p ɛ l t ɛ k
szerepet	s ɛ r ɛ p ɛ t
szereplő	s ɛ r ɛ p l øː
szereplői	s ɛ r ɛ p l øː j i
szereplője	s ɛ r ɛ p l øː j ɛ
szereplők	s ɛ r ɛ p l øː k
szeresd	s ɛ r ɛ ʒ d
szeret	s ɛ r ɛ t
szeretek	s ɛ r ɛ t ɛ k
szeretem	s ɛ r ɛ t ɛ m
szeretet	s ɛ r ɛ t ɛ t
szeretete	s ɛ r ɛ t ɛ t ɛ
szeretetet	s ɛ r ɛ t ɛ t ɛ t
szeretetre	s ɛ r ɛ t ɛ t r ɛ
szeretett	s ɛ r ɛ t ɛ tː
szeretettel	s ɛ r ɛ t ɛ tː ɛ l
szeretetét	s ɛ r ɛ t ɛ t eː t
szereti	s ɛ r ɛ t i
szeretik	s ɛ r ɛ t i k
szeretjük	s ɛ r ɛ cː y k
szeretne	s ɛ r ɛ t n ɛ
szeretnék	s ɛ r ɛ t n eː k
szeretnélek	s ɛ r ɛ t n eː l ɛ k
szeretném	s ɛ r ɛ t n eː m
szeretnénk	s ɛ r ɛ t n eː ŋ k
szerettem	s ɛ r ɛ tː ɛ m
szerettük	s ɛ r ɛ tː y k
szerez	s ɛ r ɛ z
szerezni	s ɛ r ɛ z n i
szerezte	s ɛ r ɛ s t ɛ
szerint	s ɛ r i n t
szerinte	s ɛ r i n t ɛ
szerinted	s ɛ r i n t ɛ d
szerintem	s ɛ r i n t ɛ m
szerinti	s ɛ r i n t i
szerintük	s ɛ r i n t y k
szerintünk	s ɛ r i n t y ŋ k
szerkesztett	s ɛ r k ɛ s t ɛ tː
szerkesztő	s ɛ r k ɛ s t øː
szerkesztőségek	s ɛ r k ɛ s t øː ʃ eː ɡ ɛ k
szerkezet	s ɛ r k ɛ z ɛ t
szerkezeti	s ɛ r k ɛ z ɛ t i
szerkezetű	s ɛ r k ɛ z ɛ t yː
szerszám	s ɛ r s aː m
szert	s ɛ r t
szertartások	s ɛ r t ɒ r t aː ʃ o k
szerv	s ɛ r v
szerve	s ɛ r v ɛ
szervek	s ɛ r v ɛ k
szerves	s ɛ r v ɛ ʃ
szervesen	s ɛ r v ɛ ʃ ɛ n
szervez	s ɛ r v ɛ z
szervezet	s ɛ r v ɛ z ɛ t
szervezetbe	s ɛ r v ɛ z ɛ d b ɛ
szervezete	s ɛ r v ɛ z ɛ t ɛ
szervezetek	s ɛ r v ɛ z ɛ t ɛ k
szervezeteket	s ɛ r v ɛ z ɛ t ɛ k ɛ t
szervezeteknek	s ɛ r v ɛ z ɛ t ɛ k n ɛ k
szervezetektől	s ɛ r v ɛ z ɛ t ɛ k t øː l
szervezetet	s ɛ r v ɛ z ɛ t ɛ t
szervezetként	s ɛ r v ɛ z ɛ t k eː n t
szervezetre	s ɛ r v ɛ z ɛ t r ɛ
szervezett	s ɛ r v ɛ z ɛ tː
szervezettől	s ɛ r v ɛ z ɛ tː øː l
szervezetük	s ɛ r v ɛ z ɛ t y k
szervezetünk	s ɛ r v ɛ z ɛ t y ŋ k
szervezni	s ɛ r v ɛ z n i
szervezési	s ɛ r v ɛ z eː ʃ i
szervező	s ɛ r v ɛ z øː
szervezők	s ɛ r v ɛ z øː k
szerzetes	s ɛ r z ɛ t ɛ ʃ
szerzett	s ɛ r z ɛ tː
szerző	s ɛ r z øː
szerződése	s ɛ r z øː d eː ʃ ɛ
szerződő	s ɛ r z øː d øː
szerzők	s ɛ r z øː k
szex	s ɛ k s
szexualitás	s ɛ k s u ɒ l i t aː ʃ
szexuális	s ɛ k s u aː l i ʃ
szibéria	s i b eː r i j ɒ
szicília	s i t͡s iː l i j ɒ
szicíliai	s i t͡s iː l i j ɒ j i
szigete	s i ɡ ɛ t ɛ
szignifikáns	s i ɡ n i f i k aː n ʃ
szigony	s i ɡ o ɲ
szigonyt	s i ɡ o ɲ t
szigor	s i ɡ o r
szigorú	s i ɡ o r uː
szigorúan	s i ɡ o r uː ɒ n
szilágyi	s i l aː ɟ i
szimbolikus	s i m b o l i k u ʃ
szingapúri	s i ŋ ɡ ɒ p uː r i
szinte	s i n t ɛ
szintje	s i ɲ c ɛ
szintjén	s i ɲ c eː n
szintén	s i n t eː n
szintézis	s i n t eː z i ʃ
szintű	s i n t yː
szinódus	s i n oː d u ʃ
szlogen	s l o ɡ ɛ n
szlovák	s l o v aː k
szlovákiai	s l o v aː k i j ɒ j i
szlovénia	s l o v eː n i j ɒ
szláv	s l aː v
szoba	s o b ɒ
szobor	s o b o r
szobra	s o b r ɒ
szobrok	s o b r o k
szobája	s o b aː j ɒ
szobákban	s o b aː ɡ b ɒ n
szobát	s o b aː t
szocialista	s o t͡s i j ɒ l i ʃ t ɒ
szocialisták	s o t͡s i j ɒ l i ʃ t aː k
szociológiai	s o t͡s i j o l oː ɡ i j ɒ j i
szociáldemokrata	s o t͡s i j aː l d ɛ m o k r ɒ t ɒ
szociális	s o t͡s i j aː l i ʃ
szociálisan	s o t͡s i j aː l i ʃ ɒ n
szoftver	s o f t v ɛ r
szoftverrel	s o f t v ɛ rː ɛ l
szoftvert	s o f t v ɛ r t
szokatlan	s o k ɒ t l ɒ n
szokatlanul	s o k ɒ t l ɒ n u l
szoknya	s o k ɲ ɒ
szokott	s o k o tː
szoktam	s o k t ɒ m
szokták	s o k t aː k
szokás	s o k aː ʃ
szokások	s o k aː ʃ o k
szokásos	s o k aː ʃ o ʃ
szolgál	s o l ɡ aː l
szolgálata	s o l ɡ aː l ɒ t ɒ
szolgálatok	s o l ɡ aː l ɒ t o k
szolgálatot	s o l ɡ aː l ɒ t o t
szolgálatába	s o l ɡ aː l ɒ t aː b ɒ
szolgálatában	s o l ɡ aː l ɒ t aː b ɒ n
szolgálhat	s o l ɡ aː l ɦ ɒ t
szolgálja	s o l ɡ aː jː ɒ
szolgálnak	s o l ɡ aː l n ɒ k
szolgáltat	s o l ɡ aː l t ɒ t
szolgáltatás	s o l ɡ aː l t ɒ t aː ʃ
szolgáltatása	s o l ɡ aː l t ɒ t aː ʃ ɒ
szolgáltatások	s o l ɡ aː l t ɒ t aː ʃ o k
szolgáltatásokat	s o l ɡ aː l t ɒ t aː ʃ o k ɒ t
szolgáltatásokkal	s o l ɡ aː l t ɒ t aː ʃ o kː ɒ l
szolgáltatást	s o l ɡ aː l t ɒ t aː ʃ t
szolgáltató	s o l ɡ aː l t ɒ t oː
szolgáltatók	s o l ɡ aː l t ɒ t oː k
szolgáló	s o l ɡ aː l oː
szolnok	s o l n o k
szolnoki	s o l n o k i
szombat	s o m b ɒ t
szombathelyi	s o m b ɒ t h ɛ j i
szombati	s o m b ɒ t i
szombaton	s o m b ɒ t o n
szomorú	s o m o r uː
szomszédos	s o m s eː d o ʃ
szorgalom	s o r ɡ ɒ l o m
szorít	s o r iː t
szovjet	s o v j ɛ t
szovjetunió	s o v j ɛ t u n i j oː
szponzorok	s p o n z o r o k
szubjektív	s u b j ɛ k t iː v
szultán	s u l t aː n
szurkolók	s u r k o l oː k
szurok	s u r o k
szája	s aː j ɒ
szájába	s aː j aː b ɒ
száját	s aː j aː t
száll	s aː lː
szállni	s aː l n i
szálloda	s aː lː o d ɒ
szállodák	s aː lː o d aː k
szállt	s aː l t
szállítás	s aː lː iː t aː ʃ
szállítások	s aː lː iː t aː ʃ o k
szállító	s aː lː iː t oː
szám	s aː m
száma	s aː m ɒ
számba	s aː m b ɒ
számban	s aː m b ɒ n
számok	s aː m o k
számol	s aː m o l
számolja	s aː m o jː ɒ
számolnak	s aː m o l n ɒ k
számoltak	s aː m o l t ɒ k
számomra	s aː m o m r ɒ
számon	s aː m o n
számos	s aː m o ʃ
számot	s aː m o t
számotok	s aː m o t o k
számottevő	s aː m o tː ɛ v øː
számtalan	s aː m t ɒ l ɒ n
számuk	s aː m u k
számukra	s aː m u k r ɒ
számviteli	s aː ɱ v i t ɛ l i
számának	s aː m aː n ɒ k
számára	s aː m aː r ɒ
számát	s aː m aː t
számít	s aː m iː t
számítani	s aː m iː t ɒ n i
számíthat	s aː m iː t h ɒ t
számítottam	s aː m iː t o tː ɒ m
számítás	s aː m iː t aː ʃ
számítások	s aː m iː t aː ʃ o k
számítástechnika	s aː m iː t aː ʃ t ɛ x n i k ɒ
számítástechnikai	s aː m iː t aː ʃ t ɛ x n i k ɒ j i
számító	s aː m iː t oː
számítógép	s aː m iː t oː ɡ eː p
számítógépen	s aː m iː t oː ɡ eː p ɛ n
számítógépes	s aː m iː t oː ɡ eː p ɛ ʃ
számítógéppel	s aː m iː t oː ɡ eː pː ɛ l
számú	s aː m uː
szándék	s aː n d eː k
szándéka	s aː n d eː k ɒ
szándékosan	s aː n d eː k o ʃ ɒ n
szándékot	s aː n d eː k o t
szándékát	s aː n d eː k aː t
szánt	s aː n t
száraz	s aː r ɒ z
származik	s aː r m ɒ z i k
származó	s aː r m ɒ z oː
szárnyak	s aː r ɲ ɒ k
szárnyas	s aː r ɲ ɒ ʃ
szárra	s aː rː ɒ
szárító	s aː r iː t oː
száz	s aː z
század	s aː z ɒ d
században	s aː z ɒ d b ɒ n
századi	s aː z ɒ d i
századig	s aː z ɒ d i ɡ
századok	s aː z ɒ d o k
százados	s aː z ɒ d o ʃ
századtól	s aː z ɒ tː oː l
százalék	s aː z ɒ l eː k
százaléka	s aː z ɒ l eː k ɒ
százalékkal	s aː z ɒ l eː kː ɒ l
százalékos	s aː z ɒ l eː k o ʃ
százalékot	s aː z ɒ l eː k o t
százalékra	s aː z ɒ l eː k r ɒ
százalékában	s aː z ɒ l eː k aː b ɒ n
százalékát	s aː z ɒ l eː k aː t
százszorszépek	s aː sː o r s eː p ɛ k
széchenyi	s eː t͡ʃ eː ɲ i
széchényi	s eː t͡ʃ eː ɲ i
széf	s eː f
székel	s eː k ɛ l
székelyek	s eː k ɛ j ɛ k
székesfehérvár	s eː k ɛ ʃ f ɛ ɦ eː r v aː r
székhelye	s eː k h ɛ j ɛ
székhelyű	s eː k h ɛ j yː
szél	s eː l
széles	s eː l ɛ ʃ
szélesebb	s eː l ɛ ʃ ɛ bː
széllel	s eː lː ɛ l
széna	s eː n ɒ
szénhidrát	s eː n ɦ i d r aː t
szép	s eː p
szépen	s eː p ɛ n
szépségkirálynő	s eː p ʃ eː kː i r aː j n øː
szét	s eː t
szín	s iː n
színben	s iː m b ɛ n
színei	s iː n ɛ j i
színek	s iː n ɛ k
színekben	s iː n ɛ ɡ b ɛ n
színeket	s iː n ɛ k ɛ t
színház	s i n ɦ aː z
színpadra	s iː m p ɒ d r ɒ
színt	s iː n t
színvonala	s iː ɱ v o n ɒ l ɒ
színvonalat	s iː ɱ v o n ɒ l ɒ t
színvonalon	s iː ɱ v o n ɒ l o n
színvonalát	s iː ɱ v o n ɒ l aː t
színét	s iː n eː t
színű	s iː n yː
szív	s iː v
szívelégtelenség	s iː v ɛ l eː k t ɛ l ɛ n ʃ eː ɡ
szívem	s iː v ɛ m
szíves	s iː v ɛ ʃ
szívesebben	s iː v ɛ ʃ ɛ bː ɛ n
szívesen	s iː v ɛ ʃ ɛ n
szívvel	s iː vː ɛ l
szívében	s iː v eː b ɛ n
szívélyes	s iː v eː j ɛ ʃ
szó	s oː
szóba	s oː b ɒ
szóban	s oː b ɒ n
szóbeli	s oː b ɛ l i
szója	s oː j ɒ
szókimondó	s oː k i m o n d oː
szól	s oː l
szólal	s oː l ɒ l
szólj	s oː jː
szólni	s oː l n i
szólt	s oː l t
szóló	s oː l oː
szórakozást	s oː r ɒ k o z aː ʃ t
szórvány	s oː r v aː ɲ
szót	s oː t
szóval	s oː v ɒ l
szóvivő	s oː v i v øː
szökik	s ø k i k
szökött	s ø k ø tː
szörnyeteg	s ø r ɲ ɛ t ɛ ɡ
szöveg	s ø v ɛ ɡ
szövegben	s ø v ɛ ɡ b ɛ n
szövegek	s ø v ɛ ɡ ɛ k
szöveget	s ø v ɛ ɡ ɛ t
szövetség	s ø v ɛ t͡ʃː eː ɡ
szövetsége	s ø v ɛ t͡ʃː eː ɡ ɛ
szövetségek	s ø v ɛ t͡ʃː eː ɡ ɛ k
szövetségesek	s ø v ɛ t͡ʃː eː ɡ ɛ ʃ ɛ k
szövetségi	s ø v ɛ t͡ʃː eː ɡ i
szövetségének	s ø v ɛ t͡ʃː eː ɡ eː n ɛ k
szúnyogok	s uː ɲ o ɡ o k
szúrt	s uː r t
szükség	s y k ʃ eː ɡ
szüksége	s y k ʃ eː ɡ ɛ
szükségünk	s y k ʃ eː ɡ y ŋ k
szül	s y l
szülei	s y l ɛ j i
született	s y l ɛ t ɛ tː
születik	s y l ɛ t i k
születése	s y l ɛ t eː ʃ ɛ
születésnapját	s y l ɛ t eː ʃ n ɒ p j aː t
szülések	s y l eː ʃ ɛ k
szülői	s y l øː j i
szünet	s y n ɛ t
szünetben	s y n ɛ d b ɛ n
szüntelenül	s y n t ɛ l ɛ n y l
szürke	s y r k ɛ
szőke	s øː k ɛ
szőlő	s øː l øː
szőnyegek	s øː ɲ ɛ ɡ ɛ k
szőnyegen	s øː ɲ ɛ ɡ ɛ n
szőr	s øː r
szőrme	s øː r m ɛ
szűnik	s yː n i k
szűz	s yː z
sámuel	ʃ aː m u ɛ l
sándor	ʃ aː n d o r
sánta	ʃ aː n t ɒ
sápadt	ʃ aː p ɒ tː
sárkány	ʃ aː r k aː ɲ
sátor	ʃ aː t o r
sátrak	ʃ aː t r ɒ k
sátán	ʃ aː t aː n
sávos	ʃ aː v o ʃ
sávszélesség	ʃ aː f s eː l ɛ ʃː eː ɡ
sértő	ʃ eː r t øː
sérülés	ʃ eː r y l eː ʃ
sérülések	ʃ eː r y l eː ʃ ɛ k
sérülést	ʃ eː r y l eː ʃ t
sík	ʃ iː k
sípcsont	ʃ iː p t͡ʃ o n t
sír	ʃ iː r
sírok	ʃ iː r o k
sírva	ʃ iː r v ɒ
sógunátus	ʃ oː ɡ u n aː t u ʃ
sólyom	ʃ oː j o m
sós	ʃ oː ʃ
söpör	ʃ ø p ø r
sörök	ʃ ø r ø k
sötét	ʃ ø t eː t
sötétben	ʃ ø t eː d b ɛ n
sötétebb	ʃ ø t eː t ɛ bː
sötétek	ʃ ø t eː t ɛ k
sötétség	ʃ ø t eː t͡ʃː eː ɡ
súllyal	ʃ uː jː ɒ l
súlya	ʃ uː j ɒ
súlyos	ʃ uː j o ʃ
süllők	ʃ y lː øː k
sült	ʃ y l t
sürgősen	ʃ y r ɡ øː ʃ ɛ n
sütemények	ʃ y t ɛ m eː ɲ ɛ k
sütés	ʃ y t eː ʃ
sütő	ʃ y t øː
sőt	ʃ øː t
tagadja	t ɒ ɡ ɒ ɟː ɒ
tagdíj	t ɒ ɡ d iː j
tagja	t ɒ ɡ j ɒ
tagjai	t ɒ ɡ j ɒ j i
tagjaival	t ɒ ɡ j ɒ j i v ɒ l
tagjaként	t ɒ ɡ j ɒ k eː n t
tagjának	t ɒ ɡ j aː n ɒ k
tagok	t ɒ ɡ o k
tagokat	t ɒ ɡ o k ɒ t
tagországok	t ɒ ɡ o r s aː ɡ o k
tagú	t ɒ ɡ uː
tajvan	t ɒ j v ɒ n
takarékos	t ɒ k ɒ r eː k o ʃ
takarítunk	t ɒ k ɒ r iː t u ŋ k
talaj	t ɒ l ɒ j
talajok	t ɒ l ɒ j o k
talajt	t ɒ l ɒ j t
talpraesett	t ɒ l p r ɒ ɛ ʃ ɛ tː
talál	t ɒ l aː l
található	t ɒ l aː l ɦ ɒ t oː
találhatók	t ɒ l aː l ɦ ɒ t oː k
találja	t ɒ l aː jː ɒ
találják	t ɒ l aː jː aː k
találkozni	t ɒ l aː l k o z n i
találkozott	t ɒ l aː l k o z o tː
találkozunk	t ɒ l aː l k o z u ŋ k
találkozás	t ɒ l aː l k o z aː ʃ
találkozó	t ɒ l aː l k o z oː
találkozók	t ɒ l aː l k o z oː k
találkozókon	t ɒ l aː l k o z oː k o n
találkozót	t ɒ l aː l k o z oː t
találni	t ɒ l aː l n i
találom	t ɒ l aː l o m
találsz	t ɒ l aː l s
talált	t ɒ l aː l t
találta	t ɒ l aː l t ɒ
találtak	t ɒ l aː l t ɒ k
találtam	t ɒ l aː l t ɒ m
talán	t ɒ l aː n
tanfolyam	t ɒ ɱ f o j ɒ m
tanfolyamokat	t ɒ ɱ f o j ɒ m o k ɒ t
tanfolyamot	t ɒ ɱ f o j ɒ m o t
tankönyvek	t ɒ ŋ k ø ɲ v ɛ k
tanszék	t ɒ n s eː k
tantárgy	t ɒ n t aː r ɟ
tantárgyak	t ɒ n t aː r ɟ ɒ k
tantárgyi	t ɒ n t aː r ɟ i
tanulmány	t ɒ n u l m aː ɲ
tanulmányait	t ɒ n u l m aː ɲ ɒ j i t
tanulmányi	t ɒ n u l m aː ɲ i
tanulmányok	t ɒ n u l m aː ɲ o k
tanulmányokat	t ɒ n u l m aː ɲ o k ɒ t
tanulmányom	t ɒ n u l m aː ɲ o m
tanulmányra	t ɒ n u l m aː ɲ r ɒ
tanulmányt	t ɒ n u l m aː ɲ t
tanulságos	t ɒ n u l ʃ aː ɡ o ʃ
tanulás	t ɒ n u l aː ʃ
tanulásra	t ɒ n u l aː ʃ r ɒ
tanuló	t ɒ n u l oː
tanulói	t ɒ n u l oː j i
tanulók	t ɒ n u l oː k
tanáccsal	t ɒ n aː t͡ʃː ɒ l
tanács	t ɒ n aː t͡ʃ
tanácsa	t ɒ n aː t͡ʃ ɒ
tanácsadás	t ɒ n aː t͡ʃ ɒ d aː ʃ
tanácsadó	t ɒ n aː t͡ʃ ɒ d oː
tanácshoz	t ɒ n aː t͡ʃ h o z
tanácsi	t ɒ n aː t͡ʃ i
tanácskozás	t ɒ n aː t͡ʃ k o z aː ʃ
tanácsot	t ɒ n aː t͡ʃ o t
tanár	t ɒ n aː r
tanári	t ɒ n aː r i
tanárok	t ɒ n aː r o k
tanárokkal	t ɒ n aː r o kː ɒ l
tanév	t ɒ n eː v
tanítani	t ɒ n iː t ɒ n i
tanított	t ɒ n iː t o tː
tanítottak	t ɒ n iː t o tː ɒ k
tanítványa	t ɒ n iː t v aː ɲ ɒ
tanítása	t ɒ n iː t aː ʃ ɒ
tanítások	t ɒ n iː t aː ʃ o k
tanító	t ɒ n iː t oː
tanú	t ɒ n uː
tanúja	t ɒ n uː j ɒ
tanúk	t ɒ n uː k
tapasztalat	t ɒ p ɒ s t ɒ l ɒ t
tapasztalatai	t ɒ p ɒ s t ɒ l ɒ t ɒ j i
tapasztalatok	t ɒ p ɒ s t ɒ l ɒ t o k
tapasztalatot	t ɒ p ɒ s t ɒ l ɒ t o t
tapasztalt	t ɒ p ɒ s t ɒ l t
tapasztaltam	t ɒ p ɒ s t ɒ l t ɒ m
tart	t ɒ r t
tartalma	t ɒ r t ɒ l m ɒ
tartalmak	t ɒ r t ɒ l m ɒ k
tartalmaznia	t ɒ r t ɒ l m ɒ z n i j ɒ
tartalmazza	t ɒ r t ɒ l m ɒ zː ɒ
tartalmazó	t ɒ r t ɒ l m ɒ z oː
tartalmát	t ɒ r t ɒ l m aː t
tartalom	t ɒ r t ɒ l o m
tartalommal	t ɒ r t ɒ l o mː ɒ l
tartalék	t ɒ r t ɒ l eː k
tartana	t ɒ r t ɒ n ɒ
tartanak	t ɒ r t ɒ n ɒ k
tartandó	t ɒ r t ɒ n d oː
tartani	t ɒ r t ɒ n i
tartania	t ɒ r t ɒ n i j ɒ
tartanom	t ɒ r t ɒ n o m
tartaná	t ɒ r t ɒ n aː
tartanák	t ɒ r t ɒ n aː k
tarthat	t ɒ r t h ɒ t
tartja	t ɒ r c ɒ
tartjuk	t ɒ r c u k
tartják	t ɒ r c aː k
tartományban	t ɒ r t o m aː ɲ b ɒ n
tartott	t ɒ r t o tː
tartotta	t ɒ r t o tː ɒ
tartottak	t ɒ r t o tː ɒ k
tartottam	t ɒ r t o tː ɒ m
tartottuk	t ɒ r t o tː u k
tartottunk	t ɒ r t o tː u ŋ k
tartották	t ɒ r t o tː aː k
tartozik	t ɒ r t o z i k
tartoznak	t ɒ r t o z n ɒ k
tartozó	t ɒ r t o z oː
tartsanak	t ɒ r t͡ʃ ɒ n ɒ k
tartsuk	t ɒ r t͡ʃ u k
tartunk	t ɒ r t u ŋ k
tartó	t ɒ r t oː
tartók	t ɒ r t oː k
tartós	t ɒ r t oː ʃ
tartózkodik	t ɒ r t oː s k o d i k
tartózkodás	t ɒ r t oː s k o d aː ʃ
tasakok	t ɒ ʃ ɒ k o k
tatabánya	t ɒ t ɒ b aː ɲ ɒ
tavacska	t ɒ v ɒ t͡ʃ k ɒ
tavak	t ɒ v ɒ k
tavaly	t ɒ v ɒ j
tavalyi	t ɒ v ɒ j i
tavaszi	t ɒ v ɒ s i
tavat	t ɒ v ɒ t
tb	t eː b eː
te	t ɛ
technikai	t ɛ x n i k ɒ j i
technikusok	t ɛ x n i k u ʃ o k
technikát	t ɛ x n i k aː t
technikával	t ɛ x n i k aː v ɒ l
technológia	t ɛ x n o l oː ɡ i j ɒ
technológiai	t ɛ x n o l oː ɡ i j ɒ j i
technológiák	t ɛ x n o l oː ɡ i j aː k
technológiákat	t ɛ x n o l oː ɡ i j aː k ɒ t
technológiát	t ɛ x n o l oː ɡ i j aː t
teendők	t ɛ ɛ n d øː k
tegnap	t ɛ ɡ n ɒ p
tegnapi	t ɛ ɡ n ɒ p i
tegye	t ɛ ɟ ɛ
tegyenek	t ɛ ɟ ɛ n ɛ k
tegyék	t ɛ ɟ eː k
tegyük	t ɛ ɟ y k
teheti	t ɛ h ɛ t i
tehetséges	t ɛ h ɛ t͡ʃː eː ɡ ɛ ʃ
tehettek	t ɛ h ɛ tː ɛ k
tehették	t ɛ h ɛ tː eː k
tehetünk	t ɛ h ɛ t y ŋ k
tehát	t ɛ ɦ aː t
tejet	t ɛ j ɛ t
teker	t ɛ k ɛ r
tekintet	t ɛ k i n t ɛ t
tekintetek	t ɛ k i n t ɛ t ɛ k
tekintettel	t ɛ k i n t ɛ tː ɛ l
tekinthető	t ɛ k i n t h ɛ t øː
tekintve	t ɛ k i n t v ɛ
tekintély	t ɛ k i n t eː j
tekintélyes	t ɛ k i n t eː j ɛ ʃ
tele	t ɛ l ɛ
telefon	t ɛ l ɛ f o n
telefonnal	t ɛ l ɛ f o nː ɒ l
telefonon	t ɛ l ɛ f o n o n
telefonos	t ɛ l ɛ f o n o ʃ
teleki	t ɛ l ɛ k i
telepes	t ɛ l ɛ p ɛ ʃ
telepítése	t ɛ l ɛ p iː t eː ʃ ɛ
település	t ɛ l ɛ p y l eː ʃ
települések	t ɛ l ɛ p y l eː ʃ ɛ k
településeken	t ɛ l ɛ p y l eː ʃ ɛ k ɛ n
településekről	t ɛ l ɛ p y l eː ʃ ɛ k r øː l
településen	t ɛ l ɛ p y l eː ʃ ɛ n
települést	t ɛ l ɛ p y l eː ʃ t
teli	t ɛ l i
telik	t ɛ l i k
teljes	t ɛ jː ɛ ʃ
teljesebb	t ɛ jː ɛ ʃ ɛ bː
teljesen	t ɛ jː ɛ ʃ ɛ n
teljessé	t ɛ jː ɛ ʃː eː
teljesség	t ɛ jː ɛ ʃː eː ɡ
teljesítenek	t ɛ jː ɛ ʃ iː t ɛ n ɛ k
teljesíteni	t ɛ jː ɛ ʃ iː t ɛ n i
teljesíti	t ɛ jː ɛ ʃ iː t i
teljesítményét	t ɛ jː ɛ ʃ iː t m eː ɲ eː t
teljesítményű	t ɛ jː ɛ ʃ iː t m eː ɲ yː
teljesítése	t ɛ jː ɛ ʃ iː t eː ʃ ɛ
teljesítő	t ɛ jː ɛ ʃ iː t øː
teljesül	t ɛ jː ɛ ʃ y l
telt	t ɛ l t
temető	t ɛ m ɛ t øː
temetőben	t ɛ m ɛ t øː b ɛ n
templom	t ɛ m p l o m
templomi	t ɛ m p l o m i
templomok	t ɛ m p l o m o k
templomot	t ɛ m p l o m o t
tempó	t ɛ m p oː
tengerfenék	t ɛ ŋ ɡ ɛ r f ɛ n eː k
tengeri	t ɛ ŋ ɡ ɛ r i
tengerparti	t ɛ ŋ ɡ ɛ r p ɒ r t i
tenni	t ɛ nː i
tennie	t ɛ nː i j ɛ
tenné	t ɛ nː eː
tennék	t ɛ nː eː k
teológus	t ɛ o l oː ɡ u ʃ
terek	t ɛ r ɛ k
terem	t ɛ r ɛ m
terembe	t ɛ r ɛ m b ɛ
teremben	t ɛ r ɛ m b ɛ n
teremtő	t ɛ r ɛ m t øː
terep	t ɛ r ɛ p
terepen	t ɛ r ɛ p ɛ n
terepet	t ɛ r ɛ p ɛ t
teret	t ɛ r ɛ t
terheink	t ɛ r ɦ ɛ j i ŋ k
terjed	t ɛ r j ɛ d
termel	t ɛ r m ɛ l
termelés	t ɛ r m ɛ l eː ʃ
termék	t ɛ r m eː k
termékei	t ɛ r m eː k ɛ j i
termékek	t ɛ r m eː k ɛ k
termékeket	t ɛ r m eː k ɛ k ɛ t
terméket	t ɛ r m eː k ɛ t
termés	t ɛ r m eː ʃ
természet	t ɛ r m eː s ɛ t
természetbeni	t ɛ r m eː s ɛ d b ɛ n i
természetes	t ɛ r m eː s ɛ t ɛ ʃ
természetesen	t ɛ r m eː s ɛ t ɛ ʃ ɛ n
természetvédelem	t ɛ r m eː s ɛ t v eː d ɛ l ɛ m
terroristák	t ɛ rː o r i ʃ t aː k
terv	t ɛ r v
terve	t ɛ r v ɛ
terveik	t ɛ r v ɛ j i k
tervek	t ɛ r v ɛ k
terveket	t ɛ r v ɛ k ɛ t
tervet	t ɛ r v ɛ t
tervez	t ɛ r v ɛ z
tervezet	t ɛ r v ɛ z ɛ t
tervezetet	t ɛ r v ɛ z ɛ t ɛ t
tervezett	t ɛ r v ɛ z ɛ tː
tervezési	t ɛ r v ɛ z eː ʃ i
tervezők	t ɛ r v ɛ z øː k
terápiás	t ɛ r aː p i j aː ʃ
terén	t ɛ r eː n
terézia	t ɛ r eː z i j ɒ
teríték	t ɛ r iː t eː k
területe	t ɛ r y l ɛ t ɛ
területei	t ɛ r y l ɛ t ɛ j i
területein	t ɛ r y l ɛ t ɛ j i n
területfejlesztési	t ɛ r y l ɛ t f ɛ j l ɛ s t eː ʃ i
területi	t ɛ r y l ɛ t i
területileg	t ɛ r y l ɛ t i l ɛ ɡ
területén	t ɛ r y l ɛ t eː n
területét	t ɛ r y l ɛ t eː t
tessék	t ɛ ʃː eː k
teste	t ɛ ʃ t ɛ
testet	t ɛ ʃ t ɛ t
testi	t ɛ ʃ t i
testnevelés	t ɛ ʃ t n ɛ v ɛ l eː ʃ
testre	t ɛ ʃ t r ɛ
testvér	t ɛ ʃ t v eː r
testvére	t ɛ ʃ t v eː r ɛ
testvérek	t ɛ ʃ t v eː r ɛ k
testét	t ɛ ʃ t eː t
testük	t ɛ ʃ t y k
testület	t ɛ ʃ t y l ɛ t
testületek	t ɛ ʃ t y l ɛ t ɛ k
tesz	t ɛ s
teszem	t ɛ s ɛ m
teszik	t ɛ s i k
tesznek	t ɛ s n ɛ k
teszünk	t ɛ s y ŋ k
tetemes	t ɛ t ɛ m ɛ ʃ
tetszel	t ɛ t͡sː ɛ l
tetszett	t ɛ t͡sː ɛ tː
tetszik	t ɛ t͡sː i k
tett	t ɛ tː
tette	t ɛ tː ɛ
tettek	t ɛ tː ɛ k
tettelek	t ɛ tː ɛ l ɛ k
tettem	t ɛ tː ɛ m
tették	t ɛ tː eː k
tettünk	t ɛ tː y ŋ k
tető	t ɛ t øː
tetőt	t ɛ t øː t
tevé	t ɛ v eː
tevékeny	t ɛ v eː k ɛ ɲ
tevékenység	t ɛ v eː k ɛ ɲ ʃ eː ɡ
tevékenysége	t ɛ v eː k ɛ ɲ ʃ eː ɡ ɛ
tevékenységek	t ɛ v eː k ɛ ɲ ʃ eː ɡ ɛ k
tevékenységet	t ɛ v eː k ɛ ɲ ʃ eː ɡ ɛ t
tevékenységre	t ɛ v eː k ɛ ɲ ʃ eː ɡ r ɛ
tevékenységét	t ɛ v eː k ɛ ɲ ʃ eː ɡ eː t
textus	t ɛ k s t u ʃ
teát	t ɛ aː t
thaiföld	t aː j f ø l d
ti	t i
tibor	t i b o r
tigris	t i ɡ r i ʃ
tilalom	t i l ɒ l o m
tiltakozás	t i l t ɒ k o z aː ʃ
tiltsd	t i l d͡ʒ d
tipikus	t i p i k u ʃ
tipikusan	t i p i k u ʃ ɒ n
tisza	t i s ɒ
tiszt	t i s t
tisztaság	t i s t ɒ ʃ aː ɡ
tiszteletbeli	t i s t ɛ l ɛ d b ɛ l i
tiszteletére	t i s t ɛ l ɛ t eː r ɛ
tisztelt	t i s t ɛ l t
tisztes	t i s t ɛ ʃ
tisztességes	t i s t ɛ ʃː eː ɡ ɛ ʃ
tisztviselő	t i s t v i ʃ ɛ l øː
tisztátalan	t i s t aː t ɒ l ɒ n
tisztít	t i s t iː t
titeket	t i t ɛ k ɛ t
titka	t i t k ɒ
titkos	t i t k o ʃ
titkot	t i t k o t
titkára	t i t k aː r ɒ
titkárság	t i t k aː r ʃ aː ɡ
titokban	t i t o ɡ b ɒ n
titokzatos	t i t o ɡ z ɒ t o ʃ
tizedik	t i z ɛ d i k
tizenegyedik	t i z ɛ n ɛ ɟː ɛ d i k
tizenhat	t i z ɛ n ɦ ɒ t
tizenhét	t i z ɛ n ɦ eː t
tizenkét	t i z ɛ ŋ k eː t
tizennyolc	t i z ɛ ɲː o l t͡s
tizenéves	t i z ɛ n eː v ɛ ʃ
tojást	t o j aː ʃ t
tok	t o k
tollat	t o lː ɒ t
tolna	t o l n ɒ
tolvajt	t o l v ɒ j t
tonna	t o nː ɒ
torna	t o r n ɒ
torony	t o r o ɲ
torta	t o r t ɒ
további	t o v aː bː i
továbbiakban	t o v aː bː i j ɒ ɡ b ɒ n
továbbra	t o v aː b r ɒ
továbbá	t o v aː bː aː
tradicionális	t r ɒ d i t͡s i j o n aː l i ʃ
tragikus	t r ɒ ɡ i k u ʃ
tragédia	t r ɒ ɡ eː d i j ɒ
transzszexuális	t r ɒ n s ɛ k s u aː l i ʃ
tranzakciók	t r ɒ n z ɒ k t͡s i j oː k
trendi	t r ɛ n d i
tré	t r eː
tréning	t r eː n i ŋ ɡ
trójai	t r oː j ɒ j i
trópusi	t r oː p u ʃ i
trükk	t r y kː
tucat	t u t͡s ɒ t
tud	t u d
tudat	t u d ɒ t
tudatlanság	t u d ɒ t l ɒ n ʃ aː ɡ
tudatos	t u d ɒ t o ʃ
tudhat	t u t h ɒ t
tudja	t u ɟː ɒ
tudjunk	t u ɟː u ŋ k
tudna	t u d n ɒ
tudni	t u d n i
tudniillik	t u d n i i lː i k
tudniuk	t u d n i j u k
tudnák	t u d n aː k
tudod	t u d o d
tudok	t u d o k
tudom	t u d o m
tudomány	t u d o m aː ɲ
tudományos	t u d o m aː ɲ o ʃ
tudomásul	t u d o m aː ʃ u l
tudott	t u d o tː
tudsz	t u t͡sː
tudta	t u tː ɒ
tudtak	t u tː ɒ k
tudtam	t u tː ɒ m
tudtommal	t u tː o mː ɒ l
tudtuk	t u tː u k
tudtunk	t u tː u ŋ k
tudták	t u tː aː k
tudunk	t u d u ŋ k
tudás	t u d aː ʃ
tudások	t u d aː ʃ o k
tudásuk	t u d aː ʃ u k
tudásukat	t u d aː ʃ u k ɒ t
tudó	t u d oː
tulajdon	t u l ɒ j d o n
tulajdonképpen	t u l ɒ j d o ŋ k eː pː ɛ n
tulajdonos	t u l ɒ j d o n o ʃ
tulajdonosa	t u l ɒ j d o n o ʃ ɒ
tulajdonosai	t u l ɒ j d o n o ʃ ɒ j i
tulajdonosi	t u l ɒ j d o n o ʃ i
tulajdonság	t u l ɒ j d o n ʃ aː ɡ
tulajdonságai	t u l ɒ j d o n ʃ aː ɡ ɒ j i
turista	t u r i ʃ t ɒ
turisták	t u r i ʃ t aː k
turisztika	t u r i s t i k ɒ
turisztikai	t u r i s t i k ɒ j i
tv	t eː v eː
tyúk	c uː k
tábla	t aː b l ɒ
táblázat	t aː b l aː z ɒ t
tábornok	t aː b o r n o k
tábortűz	t aː b o r t yː z
tág	t aː ɡ
tágabb	t aː ɡ ɒ bː
tágasabb	t aː ɡ ɒ ʃ ɒ bː
táj	t aː j
tájak	t aː j ɒ k
tájkép	t aː j k eː p
tájékoztat	t aː j eː k o s t ɒ t
tájékoztatni	t aː j eː k o s t ɒ t n i
tájékoztatás	t aː j eː k o s t ɒ t aː ʃ
tájékoztatási	t aː j eː k o s t ɒ t aː ʃ i
tájékoztatást	t aː j eː k o s t ɒ t aː ʃ t
tájékoztató	t aː j eː k o s t ɒ t oː
tályog	t aː j o ɡ
támadt	t aː m ɒ tː
támadás	t aː m ɒ d aː ʃ
támadások	t aː m ɒ d aː ʃ o k
támadást	t aː m ɒ d aː ʃ t
támaszok	t aː m ɒ s o k
támaszt	t aː m ɒ s t
támasztott	t aː m ɒ s t o tː
támogatja	t aː m o ɡ ɒ cː ɒ
támogatni	t aː m o ɡ ɒ t n i
támogatás	t aː m o ɡ ɒ t aː ʃ
támogatási	t aː m o ɡ ɒ t aː ʃ i
támogatásnak	t aː m o ɡ ɒ t aː ʃ n ɒ k
támogatások	t aː m o ɡ ɒ t aː ʃ o k
támogatásokat	t aː m o ɡ ɒ t aː ʃ o k ɒ t
támogatásokkal	t aː m o ɡ ɒ t aː ʃ o kː ɒ l
támogatással	t aː m o ɡ ɒ t aː ʃː ɒ l
támogatást	t aː m o ɡ ɒ t aː ʃ t
támogató	t aː m o ɡ ɒ t oː
támogatói	t aː m o ɡ ɒ t oː j i
tánc	t aː n t͡s
tányér	t aː ɲ eː r
tár	t aː r
tárca	t aː r t͡s ɒ
tárcák	t aː r t͡s aː k
tárgya	t aː r ɟ ɒ
tárgyakat	t aː r ɟ ɒ k ɒ t
tárgyalni	t aː r ɟ ɒ l n i
tárgyalások	t aː r ɟ ɒ l aː ʃ o k
tárgyalásokat	t aː r ɟ ɒ l aː ʃ o k ɒ t
tárgyalást	t aː r ɟ ɒ l aː ʃ t
tárgyaló	t aː r ɟ ɒ l oː
tárgyilagos	t aː r ɟ i l ɒ ɡ o ʃ
tárgyában	t aː r ɟ aː b ɒ n
tárgyát	t aː r ɟ aː t
tárgyú	t aː r ɟ uː
tároló	t aː r o l oː
társadalmat	t aː r ʃ ɒ d ɒ l m ɒ t
társadalmi	t aː r ʃ ɒ d ɒ l m i
társadalom	t aː r ʃ ɒ d ɒ l o m
társadalombiztosítás	t aː r ʃ ɒ d ɒ l o m b i s t o ʃ iː t aː ʃ
társai	t aː r ʃ ɒ j i
társasága	t aː r ʃ ɒ ʃ aː ɡ ɒ
társul	t aː r ʃ u l
társulat	t aː r ʃ u l ɒ t
társulás	t aː r ʃ u l aː ʃ
távirati	t aː v i r ɒ t i
távoktatás	t aː v o k t ɒ t aː ʃ
távol	t aː v o l
távolabb	t aː v o l ɒ bː
távolodik	t aː v o l o d i k
távolról	t aː v o rː oː l
távolsági	t aː v o l ʃ aː ɡ i
távon	t aː v o n
távú	t aː v uː
téged	t eː ɡ ɛ d
tégla	t eː ɡ l ɒ
tégy	t eː ɟ
tél	t eː l
télen	t eː l ɛ n
téli	t eː l i
téma	t eː m ɒ
témakörök	t eː m ɒ k ø r ø k
témában	t eː m aː b ɒ n
témához	t eː m aː ɦ o z
témája	t eː m aː j ɒ
témák	t eː m aː k
témákról	t eː m aː k r oː l
témáról	t eː m aː r oː l
témát	t eː m aː t
témával	t eː m aː v ɒ l
tény	t eː ɲ
ténye	t eː ɲ ɛ
tények	t eː ɲ ɛ k
tényező	t eː ɲ ɛ z øː
tényezők	t eː ɲ ɛ z øː k
tényleges	t eː ɲ l ɛ ɡ ɛ ʃ
ténylegesen	t eː ɲ l ɛ ɡ ɛ ʃ ɛ n
tényét	t eː ɲ eː t
térben	t eː r b ɛ n
téren	t eː r ɛ n
térinformatika	t eː r i ɱ f o r m ɒ t i k ɒ
térjenek	t eː r j ɛ n ɛ k
térkép	t eː r k eː p
térképek	t eː r k eː p ɛ k
térképeket	t eː r k eː p ɛ k ɛ t
térképen	t eː r k eː p ɛ n
térképészet	t eː r k eː p eː s ɛ t
térni	t eː r n i
térség	t eː r ʃ eː ɡ
térségben	t eː r ʃ eː ɡ b ɛ n
térségek	t eː r ʃ eː ɡ ɛ k
térséggel	t eː r ʃ eː ɡː ɛ l
térségnek	t eː r ʃ eː ɡ n ɛ k
tért	t eː r t
térünk	t eː r y ŋ k
tét	t eː t
tétben	t eː d b ɛ n
téve	t eː v ɛ
tévedés	t eː v ɛ d eː ʃ
tévedésből	t eː v ɛ d eː ʒ b øː l
tévhit	t eː f h i t
tévében	t eː v eː b ɛ n
tévés	t eː v eː ʃ
tévét	t eː v eː t
típus	t iː p u ʃ
típust	t iː p u ʃ t
típusú	t iː p u ʃ uː
tíz	t iː z
tó	t oː
tóth	t oː t
több	t ø bː
többe	t ø bː ɛ
többek	t ø bː ɛ k
többen	t ø bː ɛ n
többet	t ø bː ɛ t
többféle	t ø p f eː l ɛ
többi	t ø bː i
többiek	t ø bː i j ɛ k
többiekkel	t ø bː i j ɛ kː ɛ l
többnyire	t ø b ɲ i r ɛ
többször	t ø p s ø r
többszörösen	t ø p s ø r ø ʃ ɛ n
többség	t ø p ʃ eː ɡ
többsége	t ø p ʃ eː ɡ ɛ
többséget	t ø p ʃ eː ɡ ɛ t
többé	t ø bː eː
tök	t ø k
tölt	t ø l t
tölteni	t ø l t ɛ n i
töltés	t ø l t eː ʃ
töltött	t ø l t ø tː
tömeg	t ø m ɛ ɡ
tömegben	t ø m ɛ ɡ b ɛ n
tömege	t ø m ɛ ɡ ɛ
tömegek	t ø m ɛ ɡ ɛ k
tömeges	t ø m ɛ ɡ ɛ ʃ
tömeget	t ø m ɛ ɡ ɛ t
tömör	t ø m ø r
tönk	t ø ŋ k
tönkre	t ø ŋ k r ɛ
tör	t ø r
törekszik	t ø r ɛ k s i k
törekvés	t ø r ɛ k v eː ʃ
törekvések	t ø r ɛ k v eː ʃ ɛ k
törlés	t ø r l eː ʃ
törpe	t ø r p ɛ
törsz	t ø r s
tört	t ø r t
történelem	t ø r t eː n ɛ l ɛ m
történelmi	t ø r t eː n ɛ l m i
történet	t ø r t eː n ɛ t
történetet	t ø r t eː n ɛ t ɛ t
történetre	t ø r t eː n ɛ t r ɛ
történetét	t ø r t eː n ɛ t eː t
történtek	t ø r t eː n t ɛ k
történő	t ø r t eː n øː
törvény	t ø r v eː ɲ
törvényben	t ø r v eː ɲ b ɛ n
törvénye	t ø r v eː ɲ ɛ
törvények	t ø r v eː ɲ ɛ k
törvényes	t ø r v eː ɲ ɛ ʃ
törvénykönyv	t ø r v eː ɲ k ø ɲ v
törvénynek	t ø r v eː ɲ n ɛ k
törvényt	t ø r v eː ɲ t
törzs	t ø r ʒ
törzsek	t ø r ʒ ɛ k
törékeny	t ø r eː k ɛ ɲ
török	t ø r ø k
törölni	t ø r ø l n i
törülközőt	t ø r y l k ø z øː t
törődj	t ø r øː ɟː
túl	t uː l
túli	t uː l i
túlnyomó	t uː l ɲ o m oː
túlságosan	t uː l ʃ aː ɡ o ʃ ɒ n
túlzott	t uː l z o tː
túlzottan	t uː l z o tː ɒ n
túlzsúfolt	t uː l ʒ uː f o l t
túlzás	t uː l z aː ʃ
túlórák	t uː l oː r aː k
túr	t uː r
túra	t uː r ɒ
tükrözi	t y k r ø z i
tükörreflexes	t y k ø rː ɛ f l ɛ k s ɛ ʃ
tündérek	t y n d eː r ɛ k
tünet	t y n ɛ t
tüneti	t y n ɛ t i
tüntető	t y n t ɛ t øː
tőke	t øː k ɛ
tőlem	t øː l ɛ m
tőlük	t øː l y k
tőzsdei	t øː ʒ d ɛ j i
tűnt	t yː n t
tűr	t yː r
tűrőképesség	t yː r øː k eː p ɛ ʃː eː ɡ
tűzfegyver	t yː s f ɛ ɟ v ɛ r
tűzoltók	t yː z o l t oː k
tűzoltóság	t yː z o l t oː ʃ aː ɡ
udvarias	u d v ɒ r i j ɒ ʃ
uefa	uː ɛ f ɒ
ugranak	u ɡ r ɒ n ɒ k
ugrik	u ɡ r i k
ugyanannyi	u ɟ ɒ n ɒ ɲː i
ugyanaz	u ɟ ɒ n ɒ z
ugyancsak	u ɟ ɒ n t͡ʃ ɒ k
ugyanez	u ɟ ɒ n ɛ z
ugyanezt	u ɟ ɒ n ɛ s t
ugyanilyen	u ɟ ɒ n i j ɛ n
ugyanis	u ɟ ɒ n i ʃ
ugyanolyan	u ɟ ɒ n o j ɒ n
ugyanott	u ɟ ɒ n o tː
ugyanúgy	u ɟ ɒ n uː ɟ
ugye	u ɟ ɛ
ukrajna	u k r ɒ j n ɒ
ukrán	u k r aː n
un	u n
unióban	u n i j oː b ɒ n
unióhoz	u n i j oː ɦ o z
ura	u r ɒ
uraim	u r ɒ j i m
uralkodik	u r ɒ l k o d i k
uralkodó	u r ɒ l k o d oː
uralkodók	u r ɒ l k o d oː k
uralom	u r ɒ l o m
uram	u r ɒ m
urat	u r ɒ t
uruguay	u r u ɡ v aː j
urán	u r aː n
usa	u ʃ ɒ
uszályok	u s aː j o k
utak	u t ɒ k
utakon	u t ɒ k o n
utakra	u t ɒ k r ɒ
utal	u t ɒ l
utalhat	u t ɒ l ɦ ɒ t
utalt	u t ɒ l t
utalva	u t ɒ l v ɒ
utalványok	u t ɒ l v aː ɲ o k
utas	u t ɒ ʃ
utasok	u t ɒ ʃ o k
utasítás	u t ɒ ʃ iː t aː ʃ
utasítást	u t ɒ ʃ iː t aː ʃ t
utat	u t ɒ t
utazik	u t ɒ z i k
utaznak	u t ɒ z n ɒ k
utazni	u t ɒ z n i
utazás	u t ɒ z aː ʃ
utazási	u t ɒ z aː ʃ i
utazást	u t ɒ z aː ʃ t
utazók	u t ɒ z oː k
utca	u t͡sː ɒ
utcában	u t͡sː aː b ɒ n
utcákon	u t͡sː aː k o n
utcán	u t͡sː aː n
utcára	u t͡sː aː r ɒ
utcát	u t͡sː aː t
utoljára	u t o jː aː r ɒ
utunk	u t u ŋ k
után	u t aː n
utáni	u t aː n i
utánoz	u t aː n o z
utánpótlás	u t aː m p oː t l aː ʃ
utóbbi	u t oː bː i
utóbbiak	u t oː bː i j ɒ k
utóbbit	u t oː bː i t
utólag	u t oː l ɒ ɡ
utólagos	u t oː l ɒ ɡ o ʃ
utópisztikus	u t oː p i s t i k u ʃ
vacsora	v ɒ t͡ʃ o r ɒ
vacsorát	v ɒ t͡ʃ o r aː t
vad	v ɒ d
vadon	v ɒ d o n
vadonatúj	v ɒ d o n ɒ t uː j
vadász	v ɒ d aː s
vadászok	v ɒ d aː s o k
vagy	v ɒ ɟ
vagyis	v ɒ ɟ i ʃ
vagyok	v ɒ ɟ o k
vagyon	v ɒ ɟ o n
vagytok	v ɒ c t o k
vaj	v ɒ j
vajon	v ɒ j o n
valaha	v ɒ l ɒ h ɒ
valahogy	v ɒ l ɒ ɦ o ɟ
valahol	v ɒ l ɒ ɦ o l
valahová	v ɒ l ɒ ɦ o v aː
valaki	v ɒ l ɒ k i
valakik	v ɒ l ɒ k i k
valakinek	v ɒ l ɒ k i n ɛ k
valakinél	v ɒ l ɒ k i n eː l
valakiről	v ɒ l ɒ k i r øː l
valamely	v ɒ l ɒ m ɛ j
valamelyest	v ɒ l ɒ m ɛ j ɛ ʃ t
valamelyik	v ɒ l ɒ m ɛ j i k
valamennyi	v ɒ l ɒ m ɛ ɲː i
valamennyien	v ɒ l ɒ m ɛ ɲː i j ɛ n
valamennyiünk	v ɒ l ɒ m ɛ ɲː i j y ŋ k
valami	v ɒ l ɒ m i
valamikor	v ɒ l ɒ m i k o r
valamilyen	v ɒ l ɒ m i j ɛ n
valaminek	v ɒ l ɒ m i n ɛ k
valamint	v ɒ l ɒ m i n t
valamire	v ɒ l ɒ m i r ɛ
valamirevaló	v ɒ l ɒ m i r ɛ v ɒ l oː
valamit	v ɒ l ɒ m i t
valamivel	v ɒ l ɒ m i v ɛ l
vall	v ɒ lː
vallás	v ɒ lː aː ʃ
vallási	v ɒ lː aː ʃ i
vallások	v ɒ lː aː ʃ o k
vallásos	v ɒ lː aː ʃ o ʃ
vallásosság	v ɒ lː aː ʃ o ʃː aː ɡ
valuta	v ɒ l u t ɒ
valódi	v ɒ l oː d i
valójában	v ɒ l oː j aː b ɒ n
valós	v ɒ l oː ʃ
valószínűleg	v ɒ l oː s iː n yː l ɛ ɡ
valószínűséggel	v ɒ l oː s iː n yː ʃ eː ɡː ɛ l
valóságos	v ɒ l oː ʃ aː ɡ o ʃ
van	v ɒ n
vannak	v ɒ nː ɒ k
varga	v ɒ r ɡ ɒ
varjújuk	v ɒ r j uː j u k
vas	v ɒ ʃ
vasas	v ɒ ʃ ɒ ʃ
vass	v ɒ ʃ
vasárnap	v ɒ ʃ aː r n ɒ p
vasárnapi	v ɒ ʃ aː r n ɒ p i
vasút	v ɒ ʃ uː t
vasúti	v ɒ ʃ uː t i
vb	v eː b eː
vedd	v ɛ dː
vegye	v ɛ ɟ ɛ
vegyenek	v ɛ ɟ ɛ n ɛ k
vegyes	v ɛ ɟ ɛ ʃ
vegyék	v ɛ ɟ eː k
vegyétek	v ɛ ɟ eː t ɛ k
vegyület	v ɛ ɟ y l ɛ t
vehetnek	v ɛ h ɛ t n ɛ k
vehettek	v ɛ h ɛ tː ɛ k
vele	v ɛ l ɛ
velem	v ɛ l ɛ m
velence	v ɛ l ɛ n t͡s ɛ
veleszületett	v ɛ l ɛ s y l ɛ t ɛ tː
velük	v ɛ l y k
velünk	v ɛ l y ŋ k
vendég	v ɛ n d eː ɡ
vendégek	v ɛ n d eː ɡ ɛ k
vendégeket	v ɛ n d eː ɡ ɛ k ɛ t
vendéget	v ɛ n d eː ɡ ɛ t
venni	v ɛ nː i
venné	v ɛ nː eː
vennénk	v ɛ nː eː ŋ k
vera	v ɛ r ɒ
verbális	v ɛ r b aː l i ʃ
verhetetlen	v ɛ r ɦ ɛ t ɛ t l ɛ n
vernek	v ɛ r n ɛ k
vers	v ɛ r ʃ
verse	v ɛ r ʃ ɛ
verseny	v ɛ r ʃ ɛ ɲ
versenyek	v ɛ r ʃ ɛ ɲ ɛ k
versenyen	v ɛ r ʃ ɛ ɲ ɛ n
versenyképes	v ɛ r ʃ ɛ ɲ k eː p ɛ ʃ
versenyre	v ɛ r ʃ ɛ ɲ r ɛ
versenyt	v ɛ r ʃ ɛ ɲ t
versenyző	v ɛ r ʃ ɛ ɲ z øː
versenyzők	v ɛ r ʃ ɛ ɲ z øː k
verset	v ɛ r ʃ ɛ t
vert	v ɛ r t
verte	v ɛ r t ɛ
vertikális	v ɛ r t i k aː l i ʃ
verzió	v ɛ r z i j oː
vessen	v ɛ ʃː ɛ n
vesszük	v ɛ sː y k
vesszők	v ɛ sː øː k
vesz	v ɛ s
veszem	v ɛ s ɛ m
veszi	v ɛ s i
veszik	v ɛ s i k
vesznek	v ɛ s n ɛ k
veszprém	v ɛ s p r eː m
veszprémi	v ɛ s p r eː m i
veszte	v ɛ s t ɛ
veszteség	v ɛ s t ɛ ʃ eː ɡ
veszteséget	v ɛ s t ɛ ʃ eː ɡ ɛ t
veszve	v ɛ s v ɛ
veszély	v ɛ s eː j
veszélybe	v ɛ s eː j b ɛ
veszélyben	v ɛ s eː j b ɛ n
veszélyes	v ɛ s eː j ɛ ʃ
veszélyesebb	v ɛ s eː j ɛ ʃ ɛ bː
veszünk	v ɛ s y ŋ k
vetem	v ɛ t ɛ m
veterán	v ɛ t ɛ r aː n
vetet	v ɛ t ɛ t
vetettem	v ɛ t ɛ tː ɛ m
veti	v ɛ t i
vett	v ɛ tː
vette	v ɛ tː ɛ
vetted	v ɛ tː ɛ d
vettek	v ɛ tː ɛ k
vettem	v ɛ tː ɛ m
vették	v ɛ tː eː k
vettük	v ɛ tː y k
vettünk	v ɛ tː y ŋ k
vetület	v ɛ t y l ɛ t
vezet	v ɛ z ɛ t
vezetett	v ɛ z ɛ t ɛ tː
vezeti	v ɛ z ɛ t i
vezetnek	v ɛ z ɛ t n ɛ k
vezetni	v ɛ z ɛ t n i
vezette	v ɛ z ɛ tː ɛ
vezetékes	v ɛ z ɛ t eː k ɛ ʃ
vezetése	v ɛ z ɛ t eː ʃ ɛ
vezetését	v ɛ z ɛ t eː ʃ eː t
vezető	v ɛ z ɛ t øː
vezetőedző	v ɛ z ɛ t øː ɛ d͡zː øː
vezetői	v ɛ z ɛ t øː j i
vezetőinek	v ɛ z ɛ t øː j i n ɛ k
vezetője	v ɛ z ɛ t øː j ɛ
vezetőjének	v ɛ z ɛ t øː j eː n ɛ k
vezetők	v ɛ z ɛ t øː k
vezetőkkel	v ɛ z ɛ t øː kː ɛ l
vezetőknek	v ɛ z ɛ t øː k n ɛ k
vezetőnek	v ɛ z ɛ t øː n ɛ k
vezetőt	v ɛ z ɛ t øː t
vezér	v ɛ z eː r
vezérigazgató	v ɛ z eː r i ɡ ɒ z ɡ ɒ t oː
vezérlő	v ɛ z eː r l øː
videók	v i d ɛ oː k
videót	v i d ɛ oː t
vidéken	v i d eː k ɛ n
vidéki	v i d eː k i
vigye	v i ɟ ɛ
vigyázz	v i ɟ aː zː
vigyük	v i ɟ y k
viharok	v i ɦ ɒ r o k
vihart	v i ɦ ɒ r t
viktor	v i k t o r
villant	v i lː ɒ n t
villany	v i lː ɒ ɲ
villanyt	v i lː ɒ ɲ t
villányi	v i lː aː ɲ i
villát	v i lː aː t
világ	v i l aː ɡ
világbajnoki	v i l aː ɡ b ɒ j n o k i
világban	v i l aː ɡ b ɒ n
világgal	v i l aː ɡː ɒ l
világgazdaság	v i l aː ɡː ɒ z d ɒ ʃ aː ɡ
világháború	v i l aː k h aː b o r uː
világhírű	v i l aː k h iː r yː
világokról	v i l aː ɡ o k r oː l
világon	v i l aː ɡ o n
világos	v i l aː ɡ o ʃ
világosabb	v i l aː ɡ o ʃ ɒ bː
világosan	v i l aː ɡ o ʃ ɒ n
világossá	v i l aː ɡ o ʃː aː
világosság	v i l aː ɡ o ʃː aː ɡ
világot	v i l aː ɡ o t
világra	v i l aː ɡ r ɒ
világról	v i l aː ɡ r oː l
világszerte	v i l aː k s ɛ r t ɛ
világtól	v i l aː k t oː l
világvége	v i l aː ɡ v eː ɡ ɛ
vinne	v i nː ɛ
virsli	v i r ʃ l i
virtuális	v i r t u aː l i ʃ
virágot	v i r aː ɡ o t
visel	v i ʃ ɛ l
viselni	v i ʃ ɛ l n i
viselő	v i ʃ ɛ l øː
vissza	v i sː ɒ
visszaesés	v i sː ɒ ɛ ʃ eː ʃ
visszaesések	v i sː ɒ ɛ ʃ eː ʃ ɛ k
visszafelé	v i sː ɒ f ɛ l eː
visszaható	v i sː ɒ h ɒ t oː
visszatér	v i sː ɒ t eː r
viszed	v i s ɛ d
viszi	v i s i
visznek	v i s n ɛ k
viszont	v i s o n t
viszonthallásra	v i s o n t h ɒ lː aː ʃ r ɒ
viszony	v i s o ɲ
viszonyban	v i s o ɲ b ɒ n
viszonylat	v i s o ɲ l ɒ t
viszonyok	v i s o ɲ o k
viszonyát	v i s o ɲ aː t
vitathatatlan	v i t ɒ t h ɒ t ɒ t l ɒ n
vitorlás	v i t o r l aː ʃ
vitt	v i tː
vitte	v i tː ɛ
vitték	v i tː eː k
vitás	v i t aː ʃ
vizek	v i z ɛ k
vizes	v i z ɛ ʃ
vizet	v i z ɛ t
vizsga	v i ʒ ɡ ɒ
vizsgálat	v i ʒ ɡ aː l ɒ t
vizsgálata	v i ʒ ɡ aː l ɒ t ɒ
vizsgálatokat	v i ʒ ɡ aː l ɒ t o k ɒ t
vizsgálatot	v i ʒ ɡ aː l ɒ t o t
vizsgálatra	v i ʒ ɡ aː l ɒ t r ɒ
vizsgálatára	v i ʒ ɡ aː l ɒ t aː r ɒ
vizsgálja	v i ʒ ɡ aː jː ɒ
vizsgáljuk	v i ʒ ɡ aː jː u k
vizsgálni	v i ʒ ɡ aː l n i
vizsgálta	v i ʒ ɡ aː l t ɒ
vizuális	v i z u aː l i ʃ
volna	v o l n ɒ
volnék	v o l n eː k
volt	v o l t
voltak	v o l t ɒ k
voltaképpen	v o l t ɒ k eː pː ɛ n
volán	v o l aː n
von	v o n
vonal	v o n ɒ l
vonalat	v o n ɒ l ɒ t
vonat	v o n ɒ t
vonatkozik	v o n ɒ t k o z i k
vonatkozása	v o n ɒ t k o z aː ʃ ɒ
vonatkozásban	v o n ɒ t k o z aː ʒ b ɒ n
vonatkozásában	v o n ɒ t k o z aː ʃ aː b ɒ n
vonatkozó	v o n ɒ t k o z oː
vonatok	v o n ɒ t o k
vonattal	v o n ɒ tː ɒ l
vonta	v o n t ɒ
vonták	v o n t aː k
vonz	v o n z
vonzanak	v o n z ɒ n ɒ k
vonzza	v o n z ɒ
vonzó	v o n z oː
vonás	v o n aː ʃ
vulkáni	v u l k aː n i
vác	v aː t͡s
vádolja	v aː d o jː ɒ
vágy	v aː ɟ
vágya	v aː ɟ ɒ
vágyak	v aː ɟ ɒ k
vágyik	v aː ɟ i k
vágynak	v aː ɟ n ɒ k
vágó	v aː ɡ oː
válaszolni	v aː l ɒ s o l n i
válaszolta	v aː l ɒ s o l t ɒ
válaszoltak	v aː l ɒ s o l t ɒ k
válaszoltam	v aː l ɒ s o l t ɒ m
válaszoló	v aː l ɒ s o l oː
választanak	v aː l ɒ s t ɒ n ɒ k
választani	v aː l ɒ s t ɒ n i
választhat	v aː l ɒ s t h ɒ t
választható	v aː l ɒ s t h ɒ t oː
választják	v aː l ɒ s c aː k
választott	v aː l ɒ s t o tː
választotta	v aː l ɒ s t o tː ɒ
választották	v aː l ɒ s t o tː aː k
választás	v aː l ɒ s t aː ʃ
választása	v aː l ɒ s t aː ʃ ɒ
választási	v aː l ɒ s t aː ʃ i
választások	v aː l ɒ s t aː ʃ o k
választásokon	v aː l ɒ s t aː ʃ o k o n
választáson	v aː l ɒ s t aː ʃ o n
választást	v aː l ɒ s t aː ʃ t
választék	v aː l ɒ s t eː k
választó	v aː l ɒ s t oː
választók	v aː l ɒ s t oː k
választókerület	v aː l ɒ s t oː k ɛ r y l ɛ t
válik	v aː l i k
váljon	v aː jː o n
vállalat	v aː lː ɒ l ɒ t
vállalatok	v aː lː ɒ l ɒ t o k
vállaljuk	v aː lː ɒ jː u k
vállalkozás	v aː lː ɒ l k o z aː ʃ
vállalkozási	v aː lː ɒ l k o z aː ʃ i
vállalkozások	v aː lː ɒ l k o z aː ʃ o k
vállalkozó	v aː lː ɒ l k o z oː
vállalkozók	v aː lː ɒ l k o z oː k
vállalni	v aː lː ɒ l n i
vállaltam	v aː lː ɒ l t ɒ m
válnak	v aː l n ɒ k
válni	v aː l n i
válogatott	v aː l o ɡ ɒ t o tː
válogatás	v aː l o ɡ ɒ t aː ʃ
válság	v aː l ʃ aː ɡ
válságok	v aː l ʃ aː ɡ o k
vált	v aː l t
váltakozik	v aː l t ɒ k o z i k
váltaná	v aː l t ɒ n aː
váltják	v aː l c aː k
váltott	v aː l t o tː
váltotta	v aː l t o tː ɒ
változat	v aː l t o z ɒ t
változata	v aː l t o z ɒ t ɒ
változatos	v aː l t o z ɒ t o ʃ
változik	v aː l t o z i k
változott	v aː l t o z o tː
változtatni	v aː l t o s t ɒ t n i
változtatás	v aː l t o s t ɒ t aː ʃ
változás	v aː l t o z aː ʃ
változása	v aː l t o z aː ʃ ɒ
változások	v aː l t o z aː ʃ o k
változást	v aː l t o z aː ʃ t
változékony	v aː l t o z eː k o ɲ
változó	v aː l t o z oː
váltva	v aː l t v ɒ
váltó	v aː l t oː
váló	v aː l oː
vár	v aː r
várakozás	v aː r ɒ k o z aː ʃ
várat	v aː r ɒ t
váratlan	v aː r ɒ t l ɒ n
várható	v aː r ɦ ɒ t oː
várhatóan	v aː r ɦ ɒ t oː ɒ n
várja	v aː r j ɒ
várjuk	v aː r j u k
várják	v aː r j aː k
várjátok	v aː r j aː t o k
várnak	v aː r n ɒ k
várni	v aː r n i
várom	v aː r o m
város	v aː r o ʃ
városa	v aː r o ʃ ɒ
városban	v aː r o ʒ b ɒ n
városháza	v aː r o ʃ h aː z ɒ
városi	v aː r o ʃ i
városnak	v aː r o ʃ n ɒ k
városok	v aː r o ʃ o k
várost	v aː r o ʃ t
városában	v aː r o ʃ aː b ɒ n
várva	v aː r v ɒ
váró	v aː r oː
várók	v aː r oː k
vásár	v aː ʃ aː r
vásárlási	v aː ʃ aː r l aː ʃ i
vásárlók	v aː ʃ aː r l oː k
vásárolható	v aː ʃ aː r o l ɦ ɒ t oː
védekezés	v eː d ɛ k ɛ z eː ʃ
védelme	v eː d ɛ l m ɛ
védelmi	v eː d ɛ l m i
védelmében	v eː d ɛ l m eː b ɛ n
védelméről	v eː d ɛ l m eː r øː l
védeni	v eː d ɛ n i
védett	v eː d ɛ tː
védjegy	v eː d j ɛ ɟ
védő	v eː d øː
végbe	v eː ɡ b ɛ
végbélnyílás	v eː ɡ b eː l ɲ iː l aː ʃ
végeredmény	v eː ɡ ɛ r ɛ d m eː ɲ
véget	v eː ɡ ɛ t
végez	v eː ɡ ɛ z
végezetül	v eː ɡ ɛ z ɛ t y l
végezni	v eː ɡ ɛ z n i
végi	v eː ɡ i
végig	v eː ɡ i ɡ
végre	v eː ɡ r ɛ
végrehajtani	v eː ɡ r ɛ ɦ ɒ j t ɒ n i
végrehajtási	v eː ɡ r ɛ ɦ ɒ j t aː ʃ i
végrehajtását	v eː ɡ r ɛ ɦ ɒ j t aː ʃ aː t
végzetes	v eː ɡ z ɛ t ɛ ʃ
végzett	v eː ɡ z ɛ tː
végzettség	v eː ɡ z ɛ t͡ʃː eː ɡ
végzi	v eː ɡ z i
végző	v eː ɡ z øː
vékony	v eː k o ɲ
vél	v eː l
vélekedik	v eː l ɛ k ɛ d i k
vélemény	v eː l ɛ m eː ɲ
véleménye	v eː l ɛ m eː ɲ ɛ
vélemények	v eː l ɛ m eː ɲ ɛ k
véleményem	v eː l ɛ m eː ɲ ɛ m
véleményt	v eː l ɛ m eː ɲ t
véleményét	v eː l ɛ m eː ɲ eː t
véletlen	v eː l ɛ t l ɛ n
véletlenszerűen	v eː l ɛ t l ɛ n s ɛ r yː ɛ n
véletlenül	v eː l ɛ t l ɛ n y l
vélik	v eː l i k
vér	v eː r
vérnyomás	v eː r ɲ o m aː ʃ
vétele	v eː t ɛ l ɛ
vételi	v eː t ɛ l i
vételével	v eː t ɛ l eː v ɛ l
véve	v eː v ɛ
víg	v iː ɡ
vígjáték	v iː ɡ j aː t eː k
vírus	v iː r u ʃ
víz	v iː z
vízben	v iː z b ɛ n
vízen	v iː z ɛ n
vízi	v iː z i
vízilabda	v i z i l ɒ b d ɒ
vízvezeték	v iː z v ɛ z ɛ t eː k
vízvezetékek	v iː z v ɛ z ɛ t eː k ɛ k
vízzel	v iː zː ɛ l
vödröt	v ø d r ø t
völgy	v ø l ɟ
vörösmarty	v ø r ø ʃ m ɒ r t i
washington	v ɒ ʃ i ŋ k t o n
washingtoni	v ɒ ʃ i ŋ k t o n i
wc	v eː t͡s eː
web	v ɛ b
weben	v ɛ b ɛ n
webes	v ɛ b ɛ ʃ
weblap	v ɛ b l ɒ p
weboldalon	v ɛ b o l d ɒ l o n
who	v eː ɦ aː oː
william	v i l i j ɛ m
zaj	z ɒ j
zajlik	z ɒ j l i k
zala	z ɒ l ɒ
zamatos	z ɒ m ɒ t o ʃ
zavarta	z ɒ v ɒ r t ɒ
zavartalan	z ɒ v ɒ r t ɒ l ɒ n
zeller	z ɛ lː ɛ r
zene	z ɛ n ɛ
zenei	z ɛ n ɛ j i
zenekar	z ɛ n ɛ k ɒ r
zenekari	z ɛ n ɛ k ɒ r i
zenekart	z ɛ n ɛ k ɒ r t
zeneszerző	z ɛ n ɛ s ɛ r z øː
zenés	z ɛ n eː ʃ
zenész	z ɛ n eː s
zenészek	z ɛ n eː s ɛ k
zenét	z ɛ n eː t
zichy	z i t͡ʃ i
zoltán	z o l t aː n
zongorista	z o ŋ ɡ o r i ʃ t ɒ
zrínyi	z r iː ɲ i
zsidóság	ʒ i d oː ʃ aː ɡ
zsinat	ʒ i n ɒ t
zsinórban	ʒ i n oː r b ɒ n
zsuzsanna	ʒ u ʒ ɒ nː ɒ
zsíros	ʒ iː r o ʃ
zsófi	ʒ oː f i
zsófia	ʒ oː f i j ɒ
zsűri	ʒ yː r i
zuhatag	z u ɦ ɒ t ɒ ɡ
záporok	z aː p o r o k
zárat	z aː r ɒ t
zárda	z aː r d ɒ
zárható	z aː r ɦ ɒ t oː
zárni	z aː r n i
zárom	z aː r o m
zárták	z aː r t aː k
zárul	z aː r u l
zárójelben	z aː r oː j ɛ l b ɛ n
zászlók	z aː s l oː k
zászlót	z aː s l oː t
zöld	z ø l d
zöldkártya	z ø l t k aː r c ɒ
zűrzavaros	z yː r z ɒ v ɒ r o ʃ
ábrázol	aː b r aː z o l
ábrázoló	aː b r aː z o l oː
ág	aː ɡ
ágazat	aː ɡ ɒ z ɒ t
ágyon	aː ɟ o n
álcák	aː l t͡s aː k
áldj	aː l ɟ
áldozat	aː l d o z ɒ t
áldozatok	aː l d o z ɒ t o k
áldozatot	aː l d o z ɒ t o t
áldozatul	aː l d o z ɒ t u l
áll	aː lː
állam	aː lː ɒ m
államfő	aː lː ɒ ɱ f øː
államháztartás	aː lː ɒ m ɦ aː s t ɒ r t aː ʃ
állami	aː lː ɒ m i
államkincstár	aː lː ɒ m k i n t͡ʃ t aː r
államok	aː lː ɒ m o k
állampolgári	aː lː ɒ m p o l ɡ aː r i
állampolgárság	aː lː ɒ m p o l ɡ aː r ʃ aː ɡ
állampolgárságú	aː lː ɒ m p o l ɡ aː r ʃ aː ɡ uː
államtitkár	aː lː ɒ m t i t k aː r
államtitkára	aː lː ɒ m t i t k aː r ɒ
állandó	aː lː ɒ n d oː
állandóan	aː lː ɒ n d oː ɒ n
állandóság	aː lː ɒ n d oː ʃ aː ɡ
állapot	aː lː ɒ p o t
állapotban	aː lː ɒ p o d b ɒ n
állapotos	aː lː ɒ p o t o ʃ
állapotot	aː lː ɒ p o t o t
állapít	aː lː ɒ p iː t
állat	aː lː ɒ t
állati	aː lː ɒ t i
állatkertek	aː lː ɒ t k ɛ r t ɛ k
állatok	aː lː ɒ t o k
állatorvos	aː lː ɒ t o r v o ʃ
állatorvosi	aː lː ɒ t o r v o ʃ i
állja	aː jː ɒ
álljon	aː jː o n
állnak	aː l n ɒ k
állnia	aː l n i j ɒ
állomány	aː lː o m aː ɲ
állomás	aː lː o m aː ʃ
állomása	aː lː o m aː ʃ ɒ
állomások	aː lː o m aː ʃ o k
állott	aː lː o tː
állt	aː l t
állták	aː l t aː k
állunk	aː lː u ŋ k
állva	aː l v ɒ
állás	aː lː aː ʃ
állások	aː lː aː ʃ o k
álláspont	aː lː aː ʃ p o n t
álláspontja	aː lː aː ʃ p o ɲ c ɒ
álláspontját	aː lː aː ʃ p o ɲ c aː t
állást	aː lː aː ʃ t
állítani	aː lː iː t ɒ n i
állítja	aː lː iː cː ɒ
állítva	aː lː iː t v ɒ
állítás	aː lː iː t aː ʃ
állítása	aː lː iː t aː ʃ ɒ
állítólag	aː lː iː t oː l ɒ ɡ
álló	aː lː oː
álmai	aː l m ɒ j i
álmos	aː l m o ʃ
álmát	aː l m aː t
álom	aː l o m
által	aː l t ɒ l
általuk	aː l t ɒ l u k
általában	aː l t ɒ l aː b ɒ n
általánosabb	aː l t ɒ l aː n o ʃ ɒ bː
ám	aː m
ápoltak	aː p o l t ɒ k
ápolás	aː p o l aː ʃ
ápolási	aː p o l aː ʃ i
áprilisban	aː p r i l i ʒ b ɒ n
áprilisában	aː p r i l i ʃ aː b ɒ n
ár	aː r
árai	aː r ɒ j i
árak	aː r ɒ k
áramkör	aː r ɒ m k ø r
árban	aː r b ɒ n
árbóc	aː r b oː t͡s
árfolyam	aː r f o j ɒ m
árfolyamok	aː r f o j ɒ m o k
árkok	aː r k o k
áron	aː r o n
árral	aː rː ɒ l
árt	aː r t
ártalmas	aː r t ɒ l m ɒ ʃ
ártatlan	aː r t ɒ t l ɒ n
ártatlanok	aː r t ɒ t l ɒ n o k
áru	aː r u
árut	aː r u t
árva	aː r v ɒ
árvíz	aː r v iː z
árú	aː r uː
áshat	aː ʃ h ɒ t
ásnak	aː ʃ n ɒ k
át	aː t
átadás	aː t ɒ d aː ʃ
átadása	aː t ɒ d aː ʃ ɒ
átalakul	aː t ɒ l ɒ k u l
átalakulások	aː t ɒ l ɒ k u l aː ʃ o k
átkelőhely	aː t k ɛ l øː ɦ ɛ j
átlag	aː t l ɒ ɡ
átlagban	aː t l ɒ ɡ b ɒ n
átlagnál	aː t l ɒ ɡ n aː l
átlagos	aː t l ɒ ɡ o ʃ
átlagosan	aː t l ɒ ɡ o ʃ ɒ n
átlagosnál	aː t l ɒ ɡ o ʃ n aː l
átlát	aː t l aː t
átmeneti	aː t m ɛ n ɛ t i
átmérő	aː t m eː r øː
áttekinthető	aː tː ɛ k i n t h ɛ t øː
átvitel	aː t v i t ɛ l
ázsiai	aː ʒ i j ɒ j i
éber	eː b ɛ r
ébred	eː b r ɛ d
ébresztőórák	eː b r ɛ s t øː oː r aː k
édes	eː d ɛ ʃ
édesanyja	eː d ɛ ʃ ɒ ɲː ɒ
édesanyám	eː d ɛ ʃ ɒ ɲ aː m
édesapja	eː d ɛ ʃ ɒ p j ɒ
ég	eː ɡ
égbe	eː ɡ b ɛ
égen	eː ɡ ɛ n
égett	eː ɡ ɛ tː
égi	eː ɡ i
égtájak	eː k t aː j ɒ k
égöv	eː ɡ ø v
égő	eː ɡ øː
éhes	eː ɦ ɛ ʃ
éjjel	eː jː ɛ l
éjszaka	eː j s ɒ k ɒ
éjszakába	eː j s ɒ k aː b ɒ
ékszer	eː k s ɛ r
él	eː l
élek	eː l ɛ k
élelme	eː l ɛ l m ɛ
élelmiszerek	eː l ɛ l m i s ɛ r ɛ k
élen	eː l ɛ n
éles	eː l ɛ ʃ
élesen	eː l ɛ ʃ ɛ n
élet	eː l ɛ t
életben	eː l ɛ d b ɛ n
élete	eː l ɛ t ɛ
életed	eː l ɛ t ɛ d
életem	eː l ɛ t ɛ m
életemben	eː l ɛ t ɛ m b ɛ n
életen	eː l ɛ t ɛ n
életet	eː l ɛ t ɛ t
élethez	eː l ɛ t h ɛ z
életkor	eː l ɛ t k o r
életmód	eː l ɛ t m oː d
életmódot	eː l ɛ t m oː d o t
életnek	eː l ɛ t n ɛ k
életre	eː l ɛ t r ɛ
életről	eː l ɛ t r øː l
élettartam	eː l ɛ tː ɒ r t ɒ m
életveszélyes	eː l ɛ t v ɛ s eː j ɛ ʃ
életébe	eː l ɛ t eː b ɛ
életéről	eː l ɛ t eː r øː l
életét	eː l ɛ t eː t
életút	eː l ɛ t uː t
életüket	eː l ɛ t y k ɛ t
életünk	eː l ɛ t y ŋ k
életünket	eː l ɛ t y ŋ k ɛ t
élhet	eː l ɦ ɛ t
éli	eː l i
élik	eː l i k
élnek	eː l n ɛ k
élni	eː l n i
élnének	eː l n eː n ɛ k
élt	eː l t
éltek	eː l t ɛ k
éltet	eː l t ɛ t
éltünk	eː l t y ŋ k
élve	eː l v ɛ
élvez	eː l v ɛ z
élvezet	eː l v ɛ z ɛ t
élvezetes	eː l v ɛ z ɛ t ɛ ʃ
élén	eː l eː n
élénk	eː l eː ŋ k
élére	eː l eː r ɛ
élünk	eː l y ŋ k
élősködők	eː l øː ʃ k ø d øː k
én	eː n
énekbe	eː n ɛ ɡ b ɛ
énekeltünk	eː n ɛ k ɛ l t y ŋ k
énekes	eː n ɛ k ɛ ʃ
énekesek	eː n ɛ k ɛ ʃ ɛ k
éneket	eː n ɛ k ɛ t
énekkar	eː n ɛ kː ɒ r
épp	eː pː
éppen	eː pː ɛ n
éppoly	eː pː o j
építeni	eː p iː t ɛ n i
építmény	eː p iː t m eː ɲ
építmények	eː p iː t m eː ɲ ɛ k
építési	eː p iː t eː ʃ i
építész	eː p iː t eː s
építőipari	eː p iː t øː j i p ɒ r i
építők	eː p iː t øː k
épül	eː p y l
épület	eː p y l ɛ t
épületbe	eː p y l ɛ d b ɛ
épületben	eː p y l ɛ d b ɛ n
épülete	eː p y l ɛ t ɛ
épületek	eː p y l ɛ t ɛ k
épületekben	eː p y l ɛ t ɛ ɡ b ɛ n
épületeket	eː p y l ɛ t ɛ k ɛ t
épületében	eː p y l ɛ t eː b ɛ n
épületét	eː p y l ɛ t eː t
épült	eː p y l t
épülő	eː p y l øː
ér	eː r
érdeke	eː r d ɛ k ɛ
érdekel	eː r d ɛ k ɛ l
érdekelni	eː r d ɛ k ɛ l n i
érdekelt	eː r d ɛ k ɛ l t
érdekes	eː r d ɛ k ɛ ʃ
érdekli	eː r d ɛ k l i
érdeklődtek	eː r d ɛ k l øː tː ɛ k
érdeklődés	eː r d ɛ k l øː d eː ʃ
érdeklődő	eː r d ɛ k l øː d øː
érdeklődőket	eː r d ɛ k l øː d øː k ɛ t
érdeklődőt	eː r d ɛ k l øː d øː t
érdekében	eː r d ɛ k eː b ɛ n
érdem	eː r d ɛ m
érdemes	eː r d ɛ m ɛ ʃ
érek	eː r ɛ k
érettségi	eː r ɛ t͡ʃː eː ɡ i
érezhetően	eː r ɛ s h ɛ t øː ɛ n
érezni	eː r ɛ z n i
érezte	eː r ɛ s t ɛ
éreztem	eː r ɛ s t ɛ m
érhet	eː r ɦ ɛ t
éri	eː r i
érik	eː r i k
érintett	eː r i n t ɛ tː
érintette	eː r i n t ɛ tː ɛ
érintő	eː r i n t øː
érjen	eː r j ɛ n
érkezett	eː r k ɛ z ɛ tː
érkeznek	eː r k ɛ z n ɛ k
érkeztek	eː r k ɛ s t ɛ k
érmék	eː r m eː k
érmünk	eː r m y ŋ k
érné	eː r n eː
érsek	eː r ʃ ɛ k
ért	eː r t
érte	eː r t ɛ
értelemben	eː r t ɛ l ɛ m b ɛ n
értelmetlen	eː r t ɛ l m ɛ t l ɛ n
értelmezhető	eː r t ɛ l m ɛ s h ɛ t øː
értelmezni	eː r t ɛ l m ɛ z n i
értem	eː r t ɛ m
értenek	eː r t ɛ n ɛ k
érteni	eː r t ɛ n i
érteniük	eː r t ɛ n i j y k
értesítés	eː r t ɛ ʃ iː t eː ʃ
értesítést	eː r t ɛ ʃ iː t eː ʃ t
értett	eː r t ɛ tː
értetődő	eː r t ɛ t øː d øː
érthető	eː r t h ɛ t øː
érti	eː r t i
értitek	eː r t i t ɛ k
értjük	eː r c y k
értse	eː r t͡ʃ ɛ
érték	eː r t eː k
értékben	eː r t eː ɡ b ɛ n
értéke	eː r t eː k ɛ
értékek	eː r t eː k ɛ k
értékeket	eː r t eː k ɛ k ɛ t
értékelés	eː r t eː k ɛ l eː ʃ
értékelési	eː r t eː k ɛ l eː ʃ i
értékesebb	eː r t eː k ɛ ʃ ɛ bː
értékesítés	eː r t eː k ɛ ʃ iː t eː ʃ
értékesítése	eː r t eː k ɛ ʃ iː t eː ʃ ɛ
értéket	eː r t eː k ɛ t
értéktőzsde	eː r t eː k t øː ʒ d ɛ
értékét	eː r t eː k eː t
értékű	eː r t eː k yː
értünk	eː r t y ŋ k
értő	eː r t øː
érvek	eː r v ɛ k
érveket	eː r v ɛ k ɛ t
érvelés	eː r v ɛ l eː ʃ
érvényben	eː r v eː ɲ b ɛ n
érvényes	eː r v eː ɲ ɛ ʃ
érvényesek	eː r v eː ɲ ɛ ʃ ɛ k
érzek	eː r z ɛ k
érzelmi	eː r z ɛ l m i
érzik	eː r z i k
érzékelés	eː r z eː k ɛ l eː ʃ
érzékeny	eː r z eː k ɛ ɲ
érzékenység	eː r z eː k ɛ ɲ ʃ eː ɡ
érzés	eː r z eː ʃ
érzések	eː r z eː ʃ ɛ k
érzéseket	eː r z eː ʃ ɛ k ɛ t
érzésem	eː r z eː ʃ ɛ m
érzést	eː r z eː ʃ t
és	eː ʃ
ésszel	eː sː ɛ l
ésszerűség	eː sː ɛ r yː ʃ eː ɡ
északi	eː s ɒ k i
északra	eː s ɒ k r ɒ
észre	eː s r ɛ
észrevétlenül	eː s r ɛ v eː t l ɛ n y l
észtország	eː s t o r s aː ɡ
étkezési	eː t k ɛ z eː ʃ i
étterme	eː tː ɛ r m ɛ
étvágytalanság	eː t v aː c t ɒ l ɒ n ʃ aː ɡ
év	eː v
évben	eː v b ɛ n
éve	eː v ɛ
évei	eː v ɛ j i
éveiben	eː v ɛ j i b ɛ n
évek	eː v ɛ k
években	eː v ɛ ɡ b ɛ n
évekhez	eː v ɛ k h ɛ z
évekig	eː v ɛ k i ɡ
évekkel	eː v ɛ kː ɛ l
éven	eː v ɛ n
évenként	eː v ɛ ŋ k eː n t
évente	eː v ɛ n t ɛ
éves	eː v ɛ ʃ
évesen	eː v ɛ ʃ ɛ n
évet	eː v ɛ t
évezredek	eː v ɛ z r ɛ d ɛ k
évezredes	eː v ɛ z r ɛ d ɛ ʃ
évfolyam	eː fː o j ɒ m
évforduló	eː fː o r d u l oː
évi	eː v i
évig	eː v i ɡ
évnek	eː v n ɛ k
évnél	eː v n eː l
évre	eː v r ɛ
évszakok	eː f s ɒ k o k
évtized	eː f t i z ɛ d
évtizedben	eː f t i z ɛ d b ɛ n
évtizede	eː f t i z ɛ d ɛ
évtizedek	eː f t i z ɛ d ɛ k
évtizedekben	eː f t i z ɛ d ɛ ɡ b ɛ n
évtizedekig	eː f t i z ɛ d ɛ k i ɡ
évtől	eː f t øː l
évvel	eː vː ɛ l
így	iː ɟ
ígéretet	iː ɡ eː r ɛ t ɛ t
ígéri	iː ɡ eː r i
ígérkezik	iː ɡ eː r k ɛ z i k
íjászok	iː j aː s o k
ír	iː r
írj	iː r ʝ
írja	iː r j ɒ
írjon	iː r j o n
írják	iː r j aː k
írnak	iː r n ɒ k
írni	iː r n i
írország	iː r o r s aː ɡ
írott	iː r o tː
írsz	iː r s
írt	iː r t
írta	iː r t ɒ
írtam	iː r t ɒ m
írtuk	iː r t u k
írva	iː r v ɒ
írás	iː r aː ʃ
írása	iː r aː ʃ ɒ
írásban	iː r aː ʒ b ɒ n
írásbeli	iː r aː ʒ b ɛ l i
írások	iː r aː ʃ o k
írásos	iː r aː ʃ o ʃ
írást	iː r aː ʃ t
írói	iː r oː j i
írója	iː r oː j ɒ
írónő	iː r oː n øː
ítéletet	i t eː l ɛ t ɛ t
ívek	iː v ɛ k
íz	iː z
íze	iː z ɛ
ízletes	iː z l ɛ t ɛ ʃ
ízlik	iː z l i k
óhatatlanul	oː ɦ ɒ t ɒ t l ɒ n u l
ókori	oː k o r i
óra	oː r ɒ
órakor	oː r ɒ k o r
óráig	oː r aː j i ɡ
órák	oː r aː k
órákat	oː r aː k ɒ t
órákon	oː r aː k o n
órákra	oː r aː k r ɒ
órán	oː r aː n
órára	oː r aː r ɒ
órás	oː r aː ʃ
órától	oː r aː t oː l
órával	oː r aː v ɒ l
óvatosan	oː v ɒ t o ʃ ɒ n
óvoda	o v o d ɒ
óvodai	oː v o d ɒ j i
óvodák	o v o d aː k
óvszer	oː f s ɛ r
ökológiai	ø k o l oː ɡ i j ɒ j i
ökonómiai	ø k o n oː m i j ɒ j i
ökölvívó	ø k ø l v iː v oː
ölel	ø l ɛ l
ölitek	ø l i t ɛ k
öltés	ø l t eː ʃ
ömlik	ø m l i k
öngyilkos	ø ɲ ɟ i l k o ʃ
önkormányzat	ø ŋ k o r m aː ɲ z ɒ t
önkormányzata	ø ŋ k o r m aː ɲ z ɒ t ɒ
önkormányzatok	ø ŋ k o r m aː ɲ z ɒ t o k
önként	ø ŋ k eː n t
önkéntes	ø ŋ k eː n t ɛ ʃ
önmaga	ø mː ɒ ɡ ɒ
önmagát	ø mː ɒ ɡ aː t
önnek	ø nː ɛ k
önnel	ø nː ɛ l
önre	ø n r ɛ
önrendelkezés	ø n r ɛ n d ɛ l k ɛ z eː ʃ
önálló	ø n aː lː oː
önök	ø n ø k
önökkel	ø n ø kː ɛ l
önökre	ø n ø k r ɛ
ördög	ø r d ø ɡ
ördögi	ø r d ø ɡ i
öregedés	ø r ɛ ɡ ɛ d eː ʃ
örök	ø r ø k
örökké	ø r ø kː eː
örökre	ø r ø k r ɛ
örömet	ø r ø m ɛ t
örömteli	ø r ø m t ɛ l i
örömére	ø r ø m eː r ɛ
örül	ø r y l
örülni	ø r y l n i
örülök	ø r y l ø k
össze	ø sː ɛ
összefüggésben	ø sː ɛ f y ɡː eː ʒ b ɛ n
összefüggésekben	ø sː ɛ f y ɡː eː ʃ ɛ ɡ b ɛ n
összefüggő	ø sː ɛ f y ɡː øː
összege	ø sː ɛ ɡ ɛ
összegének	ø sː ɛ ɡ eː n ɛ k
összehasonlító	ø sː ɛ ɦ ɒ ʃ o n l iː t oː
összekötő	ø sː ɛ k ø t øː
összes	ø sː ɛ ʃ
összesen	ø sː ɛ ʃ ɛ n
összességében	ø sː ɛ ʃː eː ɡ eː b ɛ n
összetartozás	ø sː ɛ t ɒ r t o z aː ʃ
összetett	ø sː ɛ t ɛ tː
összeállítás	ø sː ɛ aː lː iː t aː ʃ
összhang	ø s h ɒ ŋ ɡ
összhangban	ø s h ɒ ŋ ɡ b ɒ n
ösztönök	ø s t ø n ø k
öten	ø t ɛ n
ötlet	ø t l ɛ t
ötlete	ø t l ɛ t ɛ
ötletet	ø t l ɛ t ɛ t
ötszáz	ø t s aː z
ötször	ø t͡sː ø r
ötven	ø t v ɛ n
ötvenedik	ø t v ɛ n ɛ d i k
ötvenes	ø t v ɛ n ɛ ʃ
övek	ø v ɛ k
övet	ø v ɛ t
övé	ø v eː
övék	ø v eː k
úgy	uː ɟ
úgyhogy	uː c h o ɟ
úgymond	uː ɟ m o n d
úgynevezett	uː ɟ n ɛ v ɛ z ɛ tː
új	uː j
újabb	uː j ɒ bː
újabban	uː j ɒ bː ɒ n
újat	uː j ɒ t
újból	uː j b oː l
újdonság	uː j d o n ʃ aː ɡ
újfajta	uː j f ɒ j t ɒ
újhoz	uː j ɦ o z
újjászületett	uː jː aː s y l ɛ t ɛ tː
újjáépítés	uː jː aː j eː p iː t eː ʃ
újnak	uː j n ɒ k
újonnan	uː j o nː ɒ n
újra	uː j r ɒ
újszerű	uː j s ɛ r yː
újszülött	uː j s y l ø tː
újság	uː j ʃ aː ɡ
újságban	uː j ʃ aː ɡ b ɒ n
újságot	uː j ʃ aː ɡ o t
újságíró	uː j ʃ aː ɡ iː r oː
úr	uː r
úrral	uː rː ɒ l
úszni	uː s n i
úszómedence	uː s oː m ɛ d ɛ n t͡s ɛ
út	uː t
úti	uː t i
útja	uː cː ɒ
útjai	uː cː ɒ j i
útjuk	uː cː u k
útján	uː cː aː n
útnak	uː t n ɒ k
úton	uː t o n
útra	uː t r ɒ
útvonal	uː t v o n ɒ l
üdvözlettel	y d v ø z l ɛ tː ɛ l
üdvözlő	y d v ø z l øː
ügy	y ɟ
ügyben	y ɟ b ɛ n
ügye	y ɟ ɛ
ügyek	y ɟ ɛ k
ügyekben	y ɟ ɛ ɡ b ɛ n
ügyeket	y ɟ ɛ k ɛ t
ügyes	y ɟ ɛ ʃ
ügyesen	y ɟ ɛ ʃ ɛ n
ügyet	y ɟ ɛ t
ügyfeleink	y c f ɛ l ɛ j i ŋ k
ügyfelek	y c f ɛ l ɛ k
ügyfél	y c f eː l
ügyfélkapu	y c f eː l k ɒ p u
ügynök	y ɟ n ø k
ügynökség	y ɟ n ø k ʃ eː ɡ
ügyvezető	y ɟ v ɛ z ɛ t øː
ügyvéd	y ɟ v eː d
ügyvédi	y ɟ v eː d i
ügyében	y ɟ eː b ɛ n
ügyész	y ɟ eː s
ügyészség	y ɟ eː ʃː eː ɡ
ülhet	y l ɦ ɛ t
üljön	y jː ø n
ült	y l t
ültünk	y l t y ŋ k
ülése	y l eː ʃ ɛ
ülésén	y l eː ʃ eː n
ülök	y l ø k
ülő	y l øː
ünnep	y nː ɛ p
ünnepek	y nː ɛ p ɛ k
ünnepi	y nː ɛ p i
ünneplő	y nː ɛ p l øː
ünnepség	y nː ɛ p ʃ eː ɡ
ünnepélyes	y nː ɛ p eː j ɛ ʃ
üreg	y r ɛ ɡ
ütemben	y t ɛ m b ɛ n
ütközet	y t k ø z ɛ t
ütött	y t ø tː
üveg	y v ɛ ɡ
üzemel	y z ɛ m ɛ l
üzemeltetés	y z ɛ m ɛ l t ɛ t eː ʃ
üzemeltetési	y z ɛ m ɛ l t ɛ t eː ʃ i
üzemeltető	y z ɛ m ɛ l t ɛ t øː
üzenete	y z ɛ n ɛ t ɛ
üzenetét	y z ɛ n ɛ t eː t
üzlet	y z l ɛ t
üzletben	y z l ɛ d b ɛ n
üzletek	y z l ɛ t ɛ k
üzleti	y z l ɛ t i
üzletág	y z l ɛ t aː ɡ
ők	øː k
őneki	øː n ɛ k i
őrizetbe	øː r i z ɛ d b ɛ
őrzi	øː r z i
őrület	øː r y l ɛ t
őrült	øː r y l t
őserdők	øː ʃ ɛ r d øː k
ősi	øː ʃ i
ősszel	øː sː ɛ l
őszi	øː s i
őszinte	øː s i n t ɛ
őszintén	øː s i n t eː n
őszt	øː s t
ősök	øː ʃ ø k
őt	øː t
űrhajó	yː r ɦ ɒ j oː
űrkutatás	yː r k u t ɒ t aː ʃ
űrrepülőgép	yː rː ɛ p y l øː ɡ eː p
űz	yː z
űző	yː z øː
