あいかわらず	a̠ i k a̠ ɰᵝ a̠ ɾ a̠ z ɨᵝ
あいがん	a̠ i ɡ ã̠ ɴ
あいくち	a̠ i k ɯ̟ᵝ t͡ɕ i
あいけん	a̠ i k ẽ̞ ɴ
あいこくしゅぎ	a̠ i k o̞ k ɯ̟ᵝ ɕ ɨᵝ ɡʲ i
あいご	a̠ i ɡ o̞
あいさつ	a̠ i s a̠ t͡s ɨᵝ
あいしゅう	a̠ i ɕ ɨᵝː
あいしょうか	a̠ i ɕ o̞ː k a̠
あいしんかくら	a̠ i ɕ ĩ ŋ k a̠ k ɯ̟ᵝ ɾ a̠
あいじょう	a̠ i ʑ o̞ː
あいぞう	a̠ i z o̞ː
あいぞうばん	a̠ i z o̞ː b ã̠ ɴ
あいだがら	a̠ i d a̠ ɡ a̠ ɾ a̠
あいつぐ	a̠ i t͡s ɨᵝ ɡ ɯ̟ᵝ
あいつら	a̠ i t͡s ɨᵝ ɾ a̠
あいな	a̠ i n a̠
あいにく	a̠ i ɲ̟ i k ɯ̟ᵝ
あいふく	a̠ i ɸ ɯ̟ᵝ k ɯ̟ᵝ
あいぶ	a̠ i b ɯ̟ᵝ
あいぼ	a̠ i b o̞
あいまい	a̠ i m a̠ i
あいよ	a̠ i j o̞
あう	a̠ ɯ̟ᵝ
あえぐ	a̠ e̞ ɡ ɯ̟ᵝ
あえる	a̠ e̞ ɾ ɯ̟ᵝ
あえん	a̠ ẽ̞ ɴ
あお	a̠ o̞
あおい	a̠ o̞ i
あおうなばら	a̠ o̞ ɯ̟ᵝ n a̠ b a̠ ɾ a̠
あおき	a̠ o̞ kʲ i
あおぎり	a̠ o̞ ɡʲ i ɾʲ i
あおぐ	a̠ o̞ ɡ ɯ̟ᵝ
あおげいとう	a̠ o̞ ɡ e̞ː t o̞ː
あおさ	a̠ o̞ s a̠
あおば	a̠ o̞ b a̠
あおもの	a̠ o̞ m o̞ n o̞
あおもり	a̠ o̞ m o̞ ɾʲ i
あおもりけん	a̠ o̞ m o̞ ɾʲ i k ẽ̞ ɴ
あおる	a̠ o̞ ɾ ɯ̟ᵝ
あか	a̠ k a̠
あかい	a̠ k a̠ i
あかがみ	a̠ k a̠ ɡ a̠ mʲ i
あかぐろい	a̠ k a̠ ɡ ɯ̟ᵝ ɾ o̞ i
あかげざる	a̠ k a̠ ɡ e̞ z a̠ ɾ ɯ̟ᵝ
あかし	a̠ k a̠ ɕ i
あかじ	a̠ k a̠ ʑ i
あかちょうちん	a̠ k a̠ t͡ɕ o̞ː t͡ɕ ĩ ɴ
あかつき	a̠ k a̠ t͡s ɨ̥ᵝ kʲ i
あかつめくさ	a̠ k a̠ t͡s ɨᵝ m e̞ k ɯ̟̊ᵝ s a̠
あかてん	a̠ k a̠ t ẽ̞ ɴ
あかなす	a̠ k a̠ n a̠ s ɨᵝ
あかね	a̠ k a̠ n e̞
あかはた	a̠ k a̠ h a̠ t a̠
あかはな	a̠ k a̠ h a̠ n a̠
あかべこ	a̠ k a̠ b e̞ k o̞
あかむつ	a̠ k a̠ m ɯ̟ᵝ t͡s ɨᵝ
あかり	a̠ k a̠ ɾʲ i
あかるむ	a̠ k a̠ ɾ ɯ̟ᵝ m ɯ̟ᵝ
あかんべえ	a̠ k ã̠ m b e̞ː
あがき	a̠ ɡ a̠ kʲ i
あがく	a̠ ɡ a̠ k ɯ̟ᵝ
あがめる	a̠ ɡ a̠ m e̞ ɾ ɯ̟ᵝ
あがる	a̠ ɡ a̠ ɾ ɯ̟ᵝ
あき	a̠ kʲ i
あきかぜ	a̠ kʲ i k a̠ z e̞
あきぞら	a̠ kʲ i z o̞ ɾ a̠
あきびん	a̠ kʲ i bʲ ĩ ɴ
あきや	a̠ kʲ i j a̠
あく	a̠ k ɯ̟ᵝ
あくいあくしょく	a̠ k ɯ̟ᵝ i a̠ k ɯ̟ᵝ ɕ o̞ k ɯ̟ᵝ
あくいんあっか	a̠ k ɯ̟ᵝ ĩ ɰ̃ a̠ k̚ k a̠
あくぎゃくひどう	a̠ k ɯ̟ᵝ ɡʲ a̠ k ɯ̟ᵝ ç i d o̞ː
あくしゅかい	a̠ k ɯ̟ᵝ ɕ ɨᵝ k a̠ i
あくしゅけん	a̠ k ɯ̟ᵝ ɕ ɨᵝ k ẽ̞ ɴ
あくしゅみ	a̠ k ɯ̟ᵝ ɕ ɨᵝ mʲ i
あくせく	a̠ k ɯ̟ᵝ s e̞ k ɯ̟ᵝ
あくとう	a̠ k ɯ̟ᵝ t o̞ː
あくとく	a̠ k ɯ̟̊ᵝ t o̞ k ɯ̟ᵝ
あくにち	a̠ k ɯ̟ᵝ ɲ̟ i t͡ɕ i
あくば	a̠ k ɯ̟ᵝ b a̠
あくび	a̠ k ɯ̟ᵝ bʲ i
あくむ	a̠ k ɯ̟ᵝ m ɯ̟ᵝ
あぐり	a̠ ɡ ɯ̟ᵝ ɾʲ i
あけ	a̠ k e̞
あけがた	a̠ k e̞ ɡ a̠ t a̠
あけくれる	a̠ k e̞ k ɯ̟ᵝ ɾ e̞ ɾ ɯ̟ᵝ
あけち	m e̞ː t͡ɕ i
あけっぱなし	a̠ k e̞ p̚ p a̠ n a̠ ɕ i
あけはなす	a̠ k e̞ h a̠ n a̠ s ɨᵝ
あけび	a̠ k e̞ bʲ i
あけぼの	a̠ k e̞ b o̞ n o̞
あける	a̠ k e̞ ɾ ɯ̟ᵝ
あげあげ	a̠ ɡ e̞ a̠ ɡ e̞
あげは	a̠ ɡ e̞ h a̠
あげはちょう	a̠ ɡ e̞ h a̠ t͡ɕ o̞ː
あこがれ	a̠ k o̞ ɡ a̠ ɾ e̞
あこがれる	a̠ k o̞ ɡ a̠ ɾ e̞ ɾ ɯ̟ᵝ
あご	a̠ ɡ o̞
あごひげ	a̠ ɡ o̞ ç i ɡ e̞
あさ	a̠ s a̠
あさいろ	a̠ s a̠ i ɾ o̞
あさおき	a̠ s a̠ o̞ kʲ i
あさくら	a̠ s a̠ k ɯ̟ᵝ ɾ a̠
あさって	a̠ s a̠ t̚ t e̞
あさね	a̠ s a̠ n e̞
あさのかい	a̠ s a̠ n o̞ k a̠ i
あさひ	a̠ s a̠ ç i̥
あさひる	a̠ s a̠ ç i ɾ ɯ̟ᵝ
あざ	a̠ z a̠
あざとい	a̠ z a̠ t o̞ i
あざみ	a̠ z a̠ mʲ i
あざむく	a̠ z a̠ m ɯ̟ᵝ k ɯ̟ᵝ
あざやか	a̠ z a̠ j a̠ k a̠
あざらし	a̠ z a̠ ɾ a̠ ɕ i
あざわらう	a̠ z a̠ ɰᵝ a̠ ɾ a̠ ɯ̟ᵝ
あしたれぼし	a̠ ɕ i t a̠ ɾ e̞ b o̞ ɕ i
あしばや	a̠ ɕ i b a̠ j a̠
あしもと	a̠ ɕ i m o̞ t o̞
あしゅら	a̠ ɕ ɨᵝ ɾ a̠
あしゆ	a̠ ɕ i j ɯ̟ᵝ
あじ	a̠ ʑ i
あじさい	a̠ ʑ i s a̠ i
あじむ	a̠ ʑ i m ɯ̟ᵝ
あじわい	a̠ ʑ i ɰᵝ a̠ i
あすなろ	a̠ s ɨᵝ n a̠ ɾ o̞
あずき	a̠ z ɨᵝ kʲ i
あずさ	a̠ z ɨᵝ s a̠
あずまくだり	a̠ z ɨᵝ m a̠ k ɯ̟ᵝ d a̠ ɾʲ i
あずまごと	a̠ z ɨᵝ m a̠ ɡ o̞ t o̞
あずまや	a̠ z ɨᵝ m a̠ j a̠
あせ	a̠ s e̞
あそびば	a̠ s o̞ bʲ i b a̠
あそん	a̠ s õ̞ ɴ
あたえる	a̠ t a̠ e̞ ɾ ɯ̟ᵝ
あたくし	a̠ t a̠ k ɯ̟̊ᵝ ɕ i
あたご	a̠ t a̠ ɡ o̞
あたし	a̠ t a̠ ɕ i
あたたかい	a̠ t a̠ t a̠ k a̠ i
あたためる	a̠ t a̠ t a̠ m e̞ ɾ ɯ̟ᵝ
あたまじらみ	a̠ t a̠ m a̠ ʑ i ɾ a̠ mʲ i
あだ	a̠ d a̠
あだな	a̠ d a̠ n a̠
あだばな	a̠ d a̠ b a̠ n a̠
あちら	a̠ t͡ɕ i ɾ a̠
あっけない	a̠ k̚ k e̞ n a̠ i
あっさく	a̠ sː a̠ k ɯ̟ᵝ
あっさり	a̠ sː a̠ ɾʲ i
あったかい	a̠ t̚ t a̠ k a̠ i
あっというま	a̠ t̚ t o̞ i ɯ̟ᵝ m a̠
あっといわせる	a̠ t̚ t o̞ i ɰᵝ a̠ s e̞ ɾ ɯ̟ᵝ
あっとうてき	a̠ t̚ t o̞ː t e̞ kʲ i
あっとおどろく	a̠ t̚ t o̞ o̞ d o̞ ɾ o̞ k ɯ̟ᵝ
あつ	a̠ t͡s ɨᵝ
あつあつ	a̠ t͡s ɨᵝ a̠ t͡s ɨᵝ
あつい	a̠ t͡s ɨᵝ i
あつくるしい	a̠ t͡s ɨᵝ k ɯ̟ᵝ ɾ ɯ̟ᵝ ɕ iː
あつし	a̠ t͡s ɨᵝ ɕ i
あつひろ	a̠ t͡s ɨᵝ ç i ɾ o̞
あつまる	a̠ t͡s ɨᵝ m a̠ ɾ ɯ̟ᵝ
あつめる	a̠ t͡s ɨᵝ m e̞ ɾ ɯ̟ᵝ
あつらえる	a̠ t͡s ɨᵝ ɾ a̠ e̞ ɾ ɯ̟ᵝ
あつりょくなべ	a̠ t͡s ɨᵝ ɾʲ o̞ k ɯ̟ᵝ n a̠ b e̞
あて	a̠ t e̞
あてこむ	a̠ t e̞ k o̞ m ɯ̟ᵝ
あてじ	a̠ t e̞ ʑ i
あてにげ	a̠ t e̞ ɲ̟ i ɡ e̞
あてはめる	a̠ t e̞ h a̠ m e̞ ɾ ɯ̟ᵝ
あてる	a̠ t e̞ ɾ ɯ̟ᵝ
あと	a̠ t o̞
あとかぶ	a̠ t o̞ k a̠ b ɯ̟ᵝ
あとがき	a̠ t o̞ ɡ a̠ kʲ i
あとのまつり	a̠ t o̞ n o̞ m a̠ t͡s ɨᵝ ɾʲ i
あとり	a̠ t o̞ ɾʲ i
あどけない	a̠ d o̞ k e̞ n a̠ i
あな	a̠ n a̠
あなた	a̠ n a̠ t a̠
あなどり	a̠ n a̠ d o̞ ɾʲ i
あなどる	a̠ n a̠ d o̞ ɾ ɯ̟ᵝ
あに	a̠ ɲ̟ i
あにき	a̠ ɲ̟ i kʲ i
あね	a̠ n e̞
あの	a̠ n o̞
あのう	a̠ n o̞ː
あのかた	a̠ n o̞ k a̠ t a̠
あのかたがた	a̠ n o̞ k a̠ t a̠ ɡ a̠ t a̠
あばく	a̠ b a̠ k ɯ̟ᵝ
あばずれ	a̠ b a̠ z ɨᵝ ɾ e̞
あばら	a̠ b a̠ ɾ a̠
あばれる	a̠ b a̠ ɾ e̞ ɾ ɯ̟ᵝ
あひさん	a̠ ç i s ã̠ ɴ
あびこ	a̠ bʲ i k o̞
あびる	a̠ bʲ i ɾ ɯ̟ᵝ
あふれでる	a̠ ɸ ɯ̟ᵝ ɾ e̞ d e̞ ɾ ɯ̟ᵝ
あふれる	a̠ ɸ ɯ̟ᵝ ɾ e̞ ɾ ɯ̟ᵝ
あぶ	a̠ b ɯ̟ᵝ
あぶない	a̠ b ɯ̟ᵝ n a̠ i
あぶら	a̠ b ɯ̟ᵝ ɾ a̠
あぶらとりがみ	a̠ b ɯ̟ᵝ ɾ a̠ t o̞ ɾʲ i ɡ a̠ mʲ i
あぶる	a̠ b ɯ̟ᵝ ɾ ɯ̟ᵝ
あへん	a̠ h ẽ̞ ɴ
あほくさい	a̠ h o̞ k ɯ̟ᵝ s a̠ i
あま	a̠ m a̠
あまい	a̠ m a̠ i
あまぐも	a̠ m a̠ ɡ ɯ̟ᵝ m o̞
あまっちょろい	a̠ m a̠ t̚ t͡ɕ o̞ ɾ o̞ i
あまてらす	a̠ m a̠ t e̞ ɾ a̠ s ɨᵝ
あまでら	a̠ m a̠ d e̞ ɾ a̠
あまねく	a̠ m a̠ n e̞ k ɯ̟ᵝ
あまのがわ	a̠ m a̠ n o̞ ɡ a̠ ɰᵝ a̠
あまのじゃく	a̠ m a̠ n o̞ ʑ a̠ k ɯ̟ᵝ
あまのむらくものつるぎ	a̠ m a̠ n o̞ m ɯ̟ᵝ ɾ a̠ k ɯ̟ᵝ m o̞ n o̞ t͡s ɨᵝ ɾ ɯ̟ᵝ ɡʲ i
あまみ	a̠ m a̠ mʲ i
あまやかす	a̠ m a̠ j a̠ k a̠ s ɨᵝ
あみ	a̠ mʲ i
あみだな	a̠ mʲ i d a̠ n a̠
あみめにしきへび	a̠ mʲ i m e̞ ɲ̟ i ɕ i kʲ i h e̞ bʲ i
あみもの	a̠ mʲ i m o̞ n o̞
あむ	a̠ m ɯ̟ᵝ
あめあがり	a̠ m e̞ a̠ ɡ a̠ ɾʲ i
あめだま	a̠ m e̞ d a̠ m a̠
あめのした	a̠ m e̞ n o̞ ɕ i̥ t a̠
あめもよう	a̠ m e̞ m o̞ j o̞ː
あもく	a̠ m o̞ k ɯ̟ᵝ
あやうい	a̠ j a̠ ɯ̟ᵝ i
あやかる	a̠ j a̠ k a̠ ɾ ɯ̟ᵝ
あやとり	a̠ j a̠ t o̞ ɾʲ i
あやぶむ	a̠ j a̠ b ɯ̟ᵝ m ɯ̟ᵝ
あやまる	a̠ j a̠ m a̠ ɾ ɯ̟ᵝ
あやめ	a̠ j a̠ m e̞
あやめる	a̠ j a̠ m e̞ ɾ ɯ̟ᵝ
あゆ	a̠ j ɯ̟ᵝ
あゆみ	a̠ j ɯ̟ᵝ mʲ i
あゆむ	a̠ j ɯ̟ᵝ m ɯ̟ᵝ
あら	a̠ ɾ a̠
あらあら	a̠ ɾ a̠ː ɾ a̠
あらい	a̠ ɾ a̠ i
あらう	a̠ ɾ a̠ ɯ̟ᵝ
あらかた	a̠ ɾ a̠ k a̠ t a̠
あらかん	a̠ ɾ a̠ k ã̠ ɴ
あらがう	a̠ ɾ a̠ ɡ a̠ ɯ̟ᵝ
あらけずり	a̠ ɾ a̠ k e̞ z ɨᵝ ɾʲ i
あらし	a̠ ɾ a̠ ɕ i
あらす	a̠ ɾ a̠ s ɨᵝ
あらすじ	a̠ ɾ a̠ s ɨᵝ ʑ i
あらた	a̠ ɾ a̠ t a̠
あらたまる	a̠ ɾ a̠ t a̠ m a̠ ɾ ɯ̟ᵝ
あらて	a̠ ɾ a̠ t e̞
あらぶる	a̠ ɾ a̠ b ɯ̟ᵝ ɾ ɯ̟ᵝ
あらまあ	a̠ ɾ a̠ m a̠ː
あらめ	a̠ ɾ a̠ m e̞
あらゆる	a̠ ɾ a̠ j ɯ̟ᵝ ɾ ɯ̟ᵝ
あらら	a̠ ɾ a̠ ɾ a̠
あられいし	a̠ ɾ a̠ ɾ e̞ i ɕ i
あられもない	a̠ ɾ a̠ ɾ e̞ m o̞ n a̠ i
あらわれる	a̠ ɾ a̠ ɰᵝ a̠ ɾ e̞ ɾ ɯ̟ᵝ
ありあけ	a̠ ɾʲ i a̠ k e̞
ありがたい	a̠ ɾʲ i ɡ a̠ t a̠ i
ありがと	a̠ ɾʲ i ɡ a̠ t o̞
ありがとう	a̠ ɾʲ i ɡ a̠ t o̞ː
ありきたり	a̠ ɾʲ i kʲ i t a̠ ɾʲ i
ありじごく	a̠ ɾʲ i ʑ i ɡ o̞ k ɯ̟ᵝ
ありのこ	a̠ ɾʲ i n o̞ k o̞
ありゅうさん	a̠ ɾʲ ɨᵝː s ã̠ ɴ
ある	a̠ ɾ ɯ̟ᵝ
あるある	a̠ ɾ ɯ̟ᵝ a̠ ɾ ɯ̟ᵝ
あるいは	a̠ ɾ ɯ̟ᵝ i ɰᵝ a̠
あるく	a̠ ɾ ɯ̟ᵝ k ɯ̟ᵝ
あるじ	a̠ ɾ ɯ̟ᵝ ʑ i
あれ	a̠ ɾ e̞
あれい	a̠ ɾ e̞ː
あれこれ	a̠ ɾ e̞ k o̞ ɾ e̞
あれはだ	a̠ ɾ e̞ h a̠ d a̠
あれる	a̠ ɾ e̞ ɾ ɯ̟ᵝ
あろうことか	a̠ ɾ o̞ː k o̞ t o̞ k a̠
あわ	a̠ ɰᵝ a̠
あわす	a̠ ɰᵝ a̠ s ɨᵝ
あわせる	a̠ ɰᵝ a̠ s e̞ ɾ ɯ̟ᵝ
あわただしい	a̠ ɰᵝ a̠ t a̠ d a̠ ɕ i i
あわだてき	a̠ ɰᵝ a̠ d a̠ t e̞ kʲ i
あわてる	a̠ ɰᵝ a̠ t e̞ ɾ ɯ̟ᵝ
あわや	a̠ ɰᵝ a̠ j a̠
あわよくば	a̠ ɰᵝ a̠ j o̞ k ɯ̟ᵝ b a̠
あわれ	a̠ ɰᵝ a̠ ɾ e̞
あわれみ	a̠ ɰᵝ a̠ ɾ e̞ mʲ i
あん	ã̠ ɴ
あんうつ	ã̠ ɰ̃ ɯ̟ᵝ t͡s ɨᵝ
あんきも	ã̠ ŋʲ kʲ i m o̞
あんこ	ã̠ ŋ k o̞
あんこう	ã̠ ŋ k o̞ː
あんこくぶっしつ	ã̠ ŋ k o̞ k ɯ̟ᵝ b ɯ̟ᵝ ɕː i̥ t͡s ɨᵝ
あんざん	ã̠ n d͡z ã̠ ɴ
あんざんし	ã̠ n d͡z ã̠ ɰ̃ ɕ i
あんしじゅつ	ã̠ ɰ̃ ɕ i ʑ ɨᵝ t͡s ɨᵝ
あんしつ	ã̠ ɰ̃ ɕ i̥ t͡s ɨᵝ
あんしょ	ã̠ ɰ̃ ɕ o̞
あんしん	ã̠ ɰ̃ ɕ ĩ ɴ
あんず	ã̠ n d͡z ɨᵝ
あんせい	ã̠ ɰ̃ s e̞ː
あんぜん	ã̠ n d͡z ẽ̞ ɴ
あんぜんこうきてい	ã̠ n d͡z ẽ̞ ŋ k o̞ː kʲ i t e̞ː
あんた	ã̠ n t a̠
あんたい	ã̠ n t a̠ i
あんちょく	ã̠ ɲ̟ t͡ɕ o̞ k ɯ̟ᵝ
あんな	ã̠ nː a̠
あんないしょ	ã̠ nː a̠ i ɕ o̞
あんなに	ã̠ nː a̠ ɲ̟ i
あんのじょう	ã̠ nː o̞ ʑ o̞ː
あんのん	ã̠ nː õ̞ ɴ
あんまり	ã̠ mː a̠ ɾʲ i
あんまん	ã̠ mː ã̠ ɴ
あんもち	ã̠ mː o̞ t͡ɕ i
あんらくし	ã̠ n ɾ a̠ k ɯ̟ᵝ ɕ i
いあつ	i a̠ t͡s ɨᵝ
いあんふ	i ã̠ ɰ̃ ɸ ɯ̟ᵝ
いいあう	i i a̠ ɯ̟ᵝ
いいえ	iː e̞
いいかげん	i i k a̠ ɡ ẽ̞ ɴ
いいきる	i i kʲ i ɾ ɯ̟ᵝ
いいこなす	iː k o̞ n a̠ s ɨᵝ
いいだす	i i d a̠ s ɨᵝ
いいなずけ	iː n a̠ z ɨᵝ k e̞
いいんかい	i ĩ ŋ k a̠ i
いう	i ɯ̟ᵝ
いえ	i e̞
いえいえ	i e̞ː e̞
いおん	i õ̞ ɴ
いかが	i k a̠ ɡ a̠
いかがわしい	i k a̠ ɡ a̠ ɰᵝ a̠ ɕ iː
いかけ	i k a̠ k e̞
いかけや	i k a̠ k e̞ j a̠
いかす	i k a̠ s ɨᵝ
いかだ	i k a̠ d a̠
いかり	i k a̠ ɾʲ i
いかれる	i k a̠ ɾ e̞ ɾ ɯ̟ᵝ
いかん	i k ã̠ ɴ
いき	i kʲ i
いきうめ	i kʲ i ɯ̟ᵝ m e̞
いきおい	i kʲ i o̞ i
いきか	i kʲ i k a̠
いきぐすり	i kʲ i ɡ ɯ̟ᵝ s ɨᵝ ɾʲ i
いきじびき	i kʲ i d͡ʑ i bʲ i kʲ i
いきなり	i kʲ i n a̠ ɾʲ i
いきのこる	i kʲ i n o̞ k o̞ ɾ ɯ̟ᵝ
いきもの	i kʲ i m o̞ n o̞
いきょう	i kʲ o̞ː
いきょく	i kʲ o̞ k ɯ̟ᵝ
いぎ	i ɡʲ i
いく	i k ɯ̟ᵝ
いくぐすり	i k ɯ̟ᵝ ɡ ɯ̟ᵝ s ɨᵝ ɾʲ i
いくせん	i k ɯ̟ᵝ s ẽ̞ ɴ
いくた	i k ɯ̟ᵝ t a̠
いくつ	i k ɯ̟ᵝ t͡s ɨᵝ
いくねん	i k ɯ̟ᵝ n ẽ̞ ɴ
いくばく	i k ɯ̟ᵝ b a̠ k ɯ̟ᵝ
いくぶん	i k ɯ̟ᵝ b ɯ̟̃ᵝ ɴ
いくらか	i k ɯ̟ᵝ ɾ a̠ k a̠
いけ	i k e̞
いけいれん	i k e̞ː ɾ ẽ̞ ɴ
いけにえ	i k e̞ ɲ̟ i e̞
いけばな	i k e̞ b a̠ n a̠
いけん	i k ẽ̞ ɴ
いけんらん	i k ẽ̞ n ɾ ã̠ ɴ
いこ	i k o̞
いこみき	i k o̞
いご	i ɡ o̞
いさつ	i s a̠ t͡s ɨᵝ
いさましい	i s a̠ m a̠ ɕ i i
いざ	i z a̠
いざなみ	i z a̠ n a̠ mʲ i
いざよい	i z a̠ j o̞ i
いし	i ɕ i
いしい	i ɕ iː
いしかり	i ɕ i k a̠ ɾʲ i
いしかわけん	i ɕ i k a̠ ɰᵝ a̠ k ẽ̞ ɴ
いしがんとう	i ɕ i ɡ ã̠ n t o̞ː
いしだたみ	i ɕ i d a̠ t a̠ mʲ i
いしだて	i ɕ i d a̠ t e̞
いしばしをたたいてこわす	i ɕ i b a̠ ɕ i o̞ t a̠ t a̠ i t e̞ k o̞ ɰᵝ a̠ s ɨᵝ
いしばしをたたいてわたる	i ɕ i b a̠ ɕ i o̞ t a̠ t a̠ i t e̞ ɰᵝ a̠ t a̠ ɾ ɯ̟ᵝ
いしゅう	i ɕ ɨᵝː
いしゅく	i ɕ ɨᵝ k ɯ̟ᵝ
いしょ	i ɕ o̞
いしょく	i ɕ o̞ k ɯ̟ᵝ
いしわた	i ɕ i ɰᵝ a̠ t a̠
いしん	i ɕ ĩ ɴ
いじ	i ʑ i
いじいじ	i ʑ i i ʑ i
いじめる	i ʑ i m e̞ ɾ ɯ̟ᵝ
いじる	i ʑ i ɾ ɯ̟ᵝ
いじわる	i ʑ i ɰᵝ a̠ ɾ ɯ̟ᵝ
いじんしゅかん	i ʑ ĩ ɰ̃ ɕ ɨᵝ k ã̠ ɴ
いすず	i s ɨᵝ z ɨᵝ
いすゞ	i s ɨᵝ z ɨᵝ
いずこ	i z ɨᵝ k o̞
いずのくに	i z ɨᵝ n o̞ k ɯ̟ᵝ ɲ̟ i
いずみ	i z ɨᵝ mʲ i
いずれ	i z ɨᵝ ɾ e̞
いせい	i s e̞ː
いせいしゃ	i s e̞ː ɕ a̠
いせえび	i s e̞ e̞ bʲ i
いせつ	i s e̞ t͡s ɨᵝ
いせん	i s ẽ̞ ɴ
いぜん	i z ẽ̞ ɴ
いぜんけい	i z ẽ̞ ŋ k e̞ː
いそ	i s o̞
いそうきかがく	i s o̞ː kʲ i̥ k a̠ ɡ a̠ k ɯ̟ᵝ
いそがしい	i s o̞ ɡ a̠ ɕ iː
いそく	i s o̞ k ɯ̟ᵝ
いそしむ	i s o̞ ɕ i m ɯ̟ᵝ
いた	i t a̠
いたくさんか	i t a̠ k ɯ̟ᵝ s ã̠ ŋ k a̠
いたしゃ	i t a̠ ɕ a̠
いただきます	i t a̠ d a̠ kʲ i m a̠ s ɨ̥ᵝ
いただく	i t a̠ d a̠ k ɯ̟ᵝ
いたって	i t a̠ t̚ t e̞
いたで	i t a̠ d e̞
いたにつく	i t a̠ ɲ̟ i t͡s ɨᵝ k ɯ̟ᵝ
いたむ	i t a̠ m ɯ̟ᵝ
いたわる	i t a̠ ɰᵝ a̠ ɾ ɯ̟ᵝ
いたん	i t ã̠ ɴ
いだい	i d a̠ i
いだてん	i d a̠ t ẽ̞ ɴ
いだてんばしり	i d a̠ t ẽ̞ m b a̠ ɕ i ɾʲ i
いち	i t͡ɕ i
いちい	i t͡ɕ i i
いちいち	i t͡ɕ iː t͡ɕ i
いちか	i t͡ɕ i k a̠
いちかばちか	i t͡ɕ i k a̠ b a̠ t͡ɕ i k a̠
いちころ	i t͡ɕ i k o̞ ɾ o̞
いちご	i t͡ɕ i ɡ o̞
いちごん	i t͡ɕ i ɡ õ̞ ɴ
いちごんほうおん	i t͡ɕ i ɡ õ̞ ɰ̃ h o̞ː õ̞ ɴ
いちじく	i t͡ɕ i ʑ i k ɯ̟ᵝ
いちじくか	i t͡ɕ i ʑ i k ɯ̟ᵝ k a̠
いちじていし	i t͡ɕ i ʑ i t e̞ː ɕ i
いちだん	i t͡ɕ i d ã̠ ɴ
いちど	i t͡ɕ i d o̞
いちにちもはやい	i t͡ɕ i ɲ̟ i t͡ɕ i m o̞ h a̠ j a̠ i
いちにんまえ	i t͡ɕ i ɲ̟ ĩ mː a̠ e̞
いちねん	i t͡ɕ i n ẽ̞ ɴ
いちねんせい	i t͡ɕ i n ẽ̞ ɰ̃ s e̞ː
いちはやく	i t͡ɕ i h a̠ j a̠ k ɯ̟ᵝ
いちばん	i t͡ɕ i b ã̠ ɴ
いちぶ	i t͡ɕ i b ɯ̟ᵝ
いちまつもよう	i t͡ɕ i m a̠ t͡s ɨᵝ m o̞ j o̞ː
いちもん	i t͡ɕ i m õ̞ ɴ
いちゃいちゃ	i t͡ɕ a̠ i t͡ɕ a̠
いちや	i t͡ɕ i j a̠
いちやく	i t͡ɕ i j a̠ k ɯ̟ᵝ
いちようぶんぷ	i t͡ɕ i j o̞ː b ɯ̟̃ᵝ m p ɯ̟ᵝ
いちらん	i t͡ɕ i ɾ ã̠ ɴ
いっかく	i k̚ k a̠ k ɯ̟ᵝ
いっかつばらい	i k̚ k a̠ t͡s ɨᵝ b a̠ ɾ a̠ i
いっきょいちどう	i k̚ʲ kʲ o̞ i t͡ɕ i d o̞ː
いっけん	i k̚ k ẽ̞ ɴ
いっこ	i k̚ k o̞
いっさい	i sː a̠ i
いっさいがっさい	i sː a̠ i ɡ a̠ sː a̠ i
いっさくさくじつ	i sː a̠ k ɯ̟ᵝ s a̠ k ɯ̟ᵝ ʑ i t͡s ɨᵝ
いっさんかたんそ	i sː ã̠ ŋ k a̠ t ã̠ ɰ̃ s o̞
いっさんかちっそ	i sː ã̠ ŋ k a̠ t͡ɕ i sː o̞
いっし	i ɕː i
いっしゅう	i ɕː ɯ̟ᵝː
いっしょ	i ɕː o̞
いっしょく	i ɕː o̞ k ɯ̟ᵝ
いっしんどうたい	i ɕː ĩ n d o̞ː t a̠ i
いっする	i sː ɯ̟ᵝ ɾ ɯ̟ᵝ
いっすんぼうし	i sː ɯ̟̃ᵝ m b o̞ː ɕ i
いっせい	i sː e̞ː
いっせきにちょう	i sː e̞ kʲ i ɲ̟ i t͡ɕ o̞ː
いったい	i t̚ t a̠ i
いったいぜんたい	i t̚ t a̠ i z ẽ̞ n t a̠ i
いったりきたり	i t̚ t a̠ ɾʲ i kʲ i t a̠ ɾʲ i
いってきます	i t̚ t e̞ kʲ i m a̠ s ɨᵝ
いってまいります	i t̚ t e̞ m a̠ i ɾʲ i m a̠ s ɨᵝ
いってよし	i t̚ t e̞ j o̞ ɕ i
いっとう	i t̚ t o̞ː
いっぱい	i p̚ p a̠ i
いっぱつどり	i p̚ p a̠ t͡s ɨᵝ d o̞ ɾʲ i
いっぱんじん	i p̚ p ã̠ ɲ̟ d͡ʑ ĩ ɴ
いっぱんそうたいせいりろん	i p̚ p ã̠ ɰ̃ s o̞ː t a̠ i s e̞ː ɾʲ i ɾ õ̞ ɴ
いっぴょう	i p̚ʲ pʲ o̞ː
いっぷたさいせい	i p̚ p ɯ̟ᵝ t a̠ s a̠ i s e̞ː
いっぺん	i p̚ p ẽ̞ ɴ
いっぽうつうこう	i p̚ p o̞ː t͡s ɨᵝː k o̞ː
いっぽん	i p̚ p õ̞ ɴ
いっぽんみち	i p̚ p õ̞ mʲː i t͡ɕ i
いつ	i t͡s ɨᵝ
いつか	i t͡s ɨᵝ k a̠
いつき	i t͡s ɨᵝ kʲ i
いつくしみ	i t͡s ɨᵝ k ɯ̟ᵝ ɕ i mʲ i
いつしか	i t͡s ɨᵝ ɕ i k a̠
いつも	i t͡s ɨᵝ m o̞
いつわり	i t͡s ɨᵝ ɰᵝ a̠ ɾʲ i
いつわる	i t͡s ɨᵝ ɰᵝ a̠ ɾ ɯ̟ᵝ
いてざ	i t e̞ z a̠
いてつく	i t e̞ t͡s ɨᵝ k ɯ̟ᵝ
いてん	i t ẽ̞ ɴ
いと	i t o̞
いとい	i t o̞ i
いとおしい	i t o̞ː ɕ i i
いとこ	i t o̞ k o̞
いとしい	i t o̞ ɕ i i
いとなむ	i t o̞ n a̠ m ɯ̟ᵝ
いなか	i n a̠ k a̠
いなくなる	i n a̠ k ɯ̟ᵝ n a̠ ɾ ɯ̟ᵝ
いなご	i n a̠ ɡ o̞
いなせ	i n a̠ s e̞
いななく	i n a̠ n a̠ k ɯ̟ᵝ
いなほ	i n a̠ h o̞
いなむ	i n a̠ m ɯ̟ᵝ
いぬ	i n ɯ̟ᵝ
いぬか	i n ɯ̟ᵝ k a̠
いぬつげ	i n ɯ̟ᵝ t͡s ɨᵝ ɡ e̞
いぬのとおぼえ	i n ɯ̟ᵝ n o̞ t o̞ː b o̞ e̞
いね	i n e̞
いのしし	i n o̞ ɕ i ɕ i
いのち	i n o̞ t͡ɕ i
いのなかのかわずたいかいをしらず	i n o̞ n a̠ k a̠ n o̞ k a̠ ɰᵝ a̠ z ɨᵝ t a̠ i k a̠ i o̞ ɕ i ɾ a̠ z ɨᵝ
いのり	i n o̞ ɾʲ i
いのる	i n o̞ ɾ ɯ̟ᵝ
いはん	i h ã̠ ɴ
いば	i b a̠
いばら	i b a̠ ɾ a̠
いばらきけん	i b a̠ ɾ a̠ kʲ i k ẽ̞ ɴ
いばらきべん	i b a̠ ɾ a̠ kʲ i b ẽ̞ ɴ
いばる	i b a̠ ɾ ɯ̟ᵝ
いびく	i bʲ i k ɯ̟ᵝ
いびつ	i bʲ i t͡s ɨᵝ
いふく	i ɸ ɯ̟̊ᵝ k ɯ̟ᵝ
いぶかしい	i b ɯ̟ᵝ k a̠ ɕ i i
いぶかる	i b ɯ̟ᵝ k a̠ ɾ ɯ̟ᵝ
いぼ	i b o̞
いぼじ	i b o̞ ʑ i
いま	i m a̠
いまかれ	i m a̠ k a̠ ɾ e̞
いまきたさんぎょう	i m a̠ kʲ i t a̠ s ã̠ ŋʲ ɡʲ o̞ː
いまさら	i m a̠ s a̠ ɾ a̠
いまだに	i m a̠ d a̠ ɲ̟ i
いまどき	i m a̠ d o̞ kʲ i
いまひとつ	i m a̠ ç i t o̞ t͡s ɨᵝ
いまや	i m a̠ j a̠
いまわしい	i m a̠ ɰᵝ a̠ ɕ iː
いみ	i mʲ i
いむ	i m ɯ̟ᵝ
いも	i m o̞
いもうとぶん	i m o̞ː t o̞ b ɯ̟̃ᵝ ɴ
いもり	i m o̞ ɾʲ i
いや	i j a̠
いやがる	i j a̠ ɡ a̠ ɾ ɯ̟ᵝ
いやしい	i j a̠ ɕ i i
いやす	i j a̠ s ɨᵝ
いやらしい	i j a̠ ɾ a̠ ɕ iː
いよいよ	i j o̞ i j o̞
いらい	i ɾ a̠ i
いらっしゃい	i ɾ a̠ ɕː a̠ i
いらっしゃる	i ɾ a̠ ɕː a̠ ɾ ɯ̟ᵝ
いらつこ	i ɾ a̠ t͡s ɨᵝ k o̞
いりえわに	i ɾʲ i e̞ ɰᵝ a̠ ɲ̟ i
いりこむ	i ɾʲ i k o̞ m ɯ̟ᵝ
いりょう	i ɾʲ o̞ː
いりょく	i ɾʲ o̞ k ɯ̟ᵝ
いるか	i ɾ ɯ̟ᵝ k a̠
いるす	i ɾ ɯ̟ᵝ s ɨᵝ
いれかわる	i ɾ e̞ k a̠ ɰᵝ a̠ ɾ ɯ̟ᵝ
いれこ	i ɾ e̞ k o̞
いれずみ	i ɾ e̞ z ɨᵝ mʲ i
いれもの	i ɾ e̞ m o̞ n o̞
いれる	i ɾ e̞ ɾ ɯ̟ᵝ
いろ	i ɾ o̞
いろあざやか	i ɾ o̞ a̠ z a̠ j a̠ k a̠
いろあせる	i ɾ o̞ a̠ s e̞ ɾ ɯ̟ᵝ
いろいろ	i ɾ o̞ i ɾ o̞
いろけ	i ɾ o̞ k e̞
いろざと	i ɾ o̞ z a̠ t o̞
いろじかけ	i ɾ o̞ ʑ i k a̠ k e̞
いろづけ	i ɾ o̞ z ɨᵝ k e̞
いろり	i ɾ o̞ ɾʲ i
いわ	i ɰᵝ a̠
いわい	i ɰᵝ a̠ i
いわお	i ɰᵝ a̠ o̞
いわく	i ɰᵝ a̠ k ɯ̟ᵝ
いわくつき	i ɰᵝ a̠ k ɯ̟ᵝ t͡s ɨᵝ kʲ i
いわし	i ɰᵝ a̠ ɕ i
いわしくじら	i ɰᵝ a̠ ɕ i̥ k ɯ̟ᵝ ʑ i ɾ a̠
いわてけん	i ɰᵝ a̠ t e̞ k ẽ̞ ɴ
いわのぼり	i ɰᵝ a̠ n o̞ b o̞ ɾʲ i
いわほり	i ɰᵝ a̠ h o̞ ɾʲ i
いわゆる	i ɰᵝ a̠ j ɯ̟ᵝ ɾ ɯ̟ᵝ
いん	ĩ ɴ
いんがし	ĩ ŋ ɡ a̠ ɕ i
いんきょくせんかん	ĩ ŋʲ kʲ o̞ k ɯ̟̊ᵝ s ẽ̞ ŋ k ã̠ ɴ
いんぎんぶれい	ĩ ŋʲ ɡʲ ĩ m b ɯ̟ᵝ ɾ e̞ː
いんけい	ĩ ŋ k e̞ː
いんげんまめ	ĩ ŋ ɡ ẽ̞ mː a̠ m e̞
いんさつき	ĩ ɰ̃ s a̠ t͡s ɨᵝ kʲ i
いんじゃ	ĩ ɲ̟ d͡ʑ a̠
いんせい	ĩ ɰ̃ s e̞ː
いんちき	ĩ ɲ̟ t͡ɕ i kʲ i
いんとうおん	ĩ n t o̞ː õ̞ ɴ
いんぶ	ĩ m b ɯ̟ᵝ
いんぼうろんしゃ	ĩ m b o̞ː ɾ õ̞ ɰ̃ ɕ a̠
いんも	ĩ mː o̞
いんようすい	ĩ ɰ̃ j o̞ː s ɨᵝ i
いんらん	ĩ n ɾ ã̠ ɴ
いんれき	ĩ n ɾ e̞ kʲ i
いんれつ	ĩ n ɾ e̞ t͡s ɨᵝ
うい	ɯ̟ᵝ i
ういういしい	ɯ̟ᵝ i ɯ̟ᵝ i ɕ iː
うぇ	ɰᵝ e̞
うえ	ɯ̟ᵝ e̞
うえき	ɯ̟ᵝ e̞ kʲ i
うえきばち	ɯ̟ᵝ e̞ kʲ i b a̠ t͡ɕ i
うえさま	ɯ̟ᵝ e̞ s a̠ m a̠
うえちち	ɯ̟ᵝ e̞ t͡ɕ i t͡ɕ i
うぉ	ɰᵝ o̞
うおざ	ɯ̟ᵝ o̞ z a̠
うか	ɯ̟ᵝ k a̠
うかうか	ɯ̟ᵝ k a̠ ɯ̟ᵝ k a̠
うかがう	ɯ̟ᵝ k a̠ ɡ a̠ ɯ̟ᵝ
うかつ	ɯ̟ᵝ k a̠ t͡s ɨᵝ
うかぶ	ɯ̟ᵝ k a̠ b ɯ̟ᵝ
うかべる	ɯ̟ᵝ k a̠ b e̞ ɾ ɯ̟ᵝ
うがつ	ɯ̟ᵝ ɡ a̠ t͡s ɨᵝ
うき	ɯ̟ᵝ kʲ i
うきうき	ɯ̟ᵝ kʲ i ɯ̟ᵝ kʲ i
うきすどり	ɯ̟ᵝ kʲ i s ɨᵝ d o̞ ɾʲ i
うきわ	ɯ̟ᵝ kʲ i ɰᵝ a̠
うぐいす	ɯ̟ᵝ ɡ ɯ̟ᵝ i s ɨᵝ
うけ	ɯ̟ᵝ k e̞
うけいれる	ɯ̟ᵝ k e̞ː ɾ e̞ ɾ ɯ̟ᵝ
うけたまわる	ɯ̟ᵝ k e̞ t a̠ m a̠ ɰᵝ a̠ ɾ ɯ̟ᵝ
うけつける	ɯ̟ᵝ k e̞ t͡s ɨᵝ k e̞ ɾ ɯ̟ᵝ
うけとる	ɯ̟ᵝ k e̞ t o̞ ɾ ɯ̟ᵝ
うけもつ	ɯ̟ᵝ k e̞ m o̞ t͡s ɨᵝ
うける	ɯ̟ᵝ k e̞ ɾ ɯ̟ᵝ
うげつ	ɯ̟ᵝ ɡ e̞ t͡s ɨᵝ
うこん	ɯ̟ᵝ k õ̞ ɴ
うこんいろ	ɯ̟ᵝ k õ̞ ɰ̃ i ɾ o̞
うごく	ɯ̟ᵝ ɡ o̞ k ɯ̟ᵝ
うさ	ɯ̟ᵝ s a̠
うさぎ	ɯ̟ᵝ s a̠ ɡʲ i
うしつ	ɯ̟ᵝ ɕ i t͡s ɨᵝ
うしみつどき	ɯ̟ᵝ ɕ i mʲ i t͡s ɨᵝ d o̞ kʲ i
うしろあるき	ɯ̟ᵝ ɕ i ɾ o̞ a̠ ɾ ɯ̟ᵝ kʲ i
うしろすがた	ɯ̟ᵝ ɕ i ɾ o̞ s ɨᵝ ɡ a̠ t a̠
うしんしつ	ɯ̟ᵝ ɕ ĩ ɰ̃ ɕ i t͡s ɨᵝ
うじ	ɯ̟ᵝ ʑ i
うす	ɯ̟ᵝ s ɨᵝ
うすい	ɯ̟ᵝ s ɨᵝ i
うすきみわるい	ɯ̟ᵝ s ɨᵝ kʲ i mʲ i ɰᵝ a̠ ɾ ɯ̟ᵝ i
うすぐらい	ɯ̟ᵝ s ɨᵝ ɡ ɯ̟ᵝ ɾ a̠ i
うすばかげろう	ɯ̟ᵝ s ɨᵝ b a̠ k a̠ ɡ e̞ ɾ o̞ː
うすめ	ɯ̟ᵝ s ɨᵝ m e̞
うすわらい	ɯ̟ᵝ s ɨᵝ ɰᵝ a̠ ɾ a̠ i
うずく	ɯ̟ᵝ z ɨᵝ k ɯ̟ᵝ
うずまき	ɯ̟ᵝ z ɨᵝ m a̠ kʲ i
うずら	ɯ̟ᵝ z ɨᵝ ɾ a̠
うせる	ɯ̟ᵝ s e̞ ɾ ɯ̟ᵝ
うそ	ɯ̟ᵝ s o̞
うそはっけんき	ɯ̟ᵝ s o̞ h a̠ k̚ k ẽ̞ ŋʲ kʲ i
うそひめ	ɯ̟ᵝ s o̞ ç i m e̞
うそをつく	ɯ̟ᵝ s o̞ o̞ t͡s ɨᵝ k ɯ̟ᵝ
うた	ɯ̟ᵝ t a̠
うたいて	ɯ̟ᵝ t a̠ i t e̞
うたう	ɯ̟ᵝ t a̠ ɯ̟ᵝ
うたがわしい	ɯ̟ᵝ t a̠ ɡ a̠ ɰᵝ a̠ ɕ iː
うたごえ	ɯ̟ᵝ t a̠ ɡ o̞ e̞
うたたね	ɯ̟ᵝ t a̠ t a̠ n e̞
うたってみた	ɯ̟ᵝ t a̠ t̚ t e̞ mʲ i t a̠
うたつぐみ	ɯ̟ᵝ t a̠ t͡s ɨᵝ ɡ ɯ̟ᵝ mʲ i
うたひめ	ɯ̟ᵝ t a̠ ç i m e̞
うたわり	ɯ̟ᵝ t a̠ ɰᵝ a̠ ɾʲ i
うだいじん	ɯ̟ᵝ d a̠ i ʑ ĩ ɴ
うち	ɯ̟ᵝ t͡ɕ i
うちおとす	ɯ̟ᵝ t͡ɕ i o̞ t o̞ s ɨᵝ
うちがけ	ɯ̟ᵝ t͡ɕ i ɡ a̠ k e̞
うちがわ	ɯ̟ᵝ t͡ɕ i ɡ a̠ ɰᵝ a̠
うちくだく	ɯ̟ᵝ t͡ɕ i k ɯ̟ᵝ d a̠ k ɯ̟ᵝ
うちけす	ɯ̟ᵝ t͡ɕ i k e̞ s ɨᵝ
うちこみ	ɯ̟ᵝ t͡ɕ i k o̞ mʲ i
うちとみ	ɯ̟ᵝ t͡ɕ i t o̞ mʲ i
うちのめす	ɯ̟ᵝ t͡ɕ i n o̞ m e̞ s ɨᵝ
うちべんけい	ɯ̟ᵝ t͡ɕ i b ẽ̞ ŋ k e̞ː
うちほろぼす	ɯ̟ᵝ t͡ɕ i h o̞ ɾ o̞ b o̞ s ɨᵝ
うちもも	ɯ̟ᵝ t͡ɕ i m o̞ m o̞
うちゅうじん	ɯ̟ᵝ t͡ɕ ɨᵝː ʑ ĩ ɴ
うちゅうたんさき	ɯ̟ᵝ t͡ɕ ɨᵝː t ã̠ ɰ̃ s a̠ kʲ i
うちゅうひこうし	ɯ̟ᵝ t͡ɕ ɨᵝː ç i̥ k o̞ː ɕ i
うちわ	ɯ̟ᵝ t͡ɕ i ɰᵝ a̠
うちわげんか	ɯ̟ᵝ t͡ɕ i ɰᵝ a̠ ɡ ẽ̞ ŋ k a̠
うっとうしい	ɯ̟ᵝ t̚ t o̞ː ɕ i i
うっとり	ɯ̟ᵝ t̚ t o̞ ɾʲ i
うつそみ	ɯ̟ᵝ t͡s ɨᵝ s o̞ mʲ i
うつのみや	ɯ̟ᵝ t͡s ɨᵝ n o̞ mʲ i j a̠
うつむく	ɯ̟ᵝ t͡s ɨᵝ m ɯ̟ᵝ k ɯ̟ᵝ
うつる	ɯ̟ᵝ t͡s ɨᵝ ɾ ɯ̟ᵝ
うつろ	ɯ̟ᵝ t͡s ɨᵝ ɾ o̞
うづき	ɯ̟ᵝ z ɨᵝ kʲ i
うてき	ɯ̟ᵝ t e̞ kʲ i
うで	ɯ̟ᵝ d e̞
うでじまん	ɯ̟ᵝ d e̞ ʑ i m ã̠ ɴ
うでずもう	ɯ̟ᵝ d e̞ z ɨᵝ m o̞ː
うでまえ	ɯ̟ᵝ d e̞ m a̠ e̞
うでわ	ɯ̟ᵝ d e̞ ɰᵝ a̠
うとい	ɯ̟ᵝ t o̞ i
うど	ɯ̟ᵝ d o̞
うながす	ɯ̟ᵝ n a̠ ɡ a̠ s ɨᵝ
うなじ	ɯ̟ᵝ n a̠ ʑ i
うなばら	ɯ̟ᵝ n a̠ b a̠ ɾ a̠
うに	ɯ̟ᵝ ɲ̟ i
うぬぼれる	ɯ̟ᵝ n ɯ̟ᵝ b o̞ ɾ e̞ ɾ ɯ̟ᵝ
うば	ɯ̟ᵝ b a̠
うぶごえ	ɯ̟ᵝ b ɯ̟ᵝ ɡ o̞ e̞
うぷる	ɯ̟ᵝ p ɯ̟ᵝ ɾ ɯ̟ᵝ
うまい	ɯ̟ᵝ m a̠ i
うまぬし	ɯ̟ᵝ m a̠ n ɯ̟ᵝ ɕ i
うまのほね	ɯ̟ᵝ m a̠ n o̞ h o̞ n e̞
うまみ	ɯ̟ᵝ m a̠ mʲ i
うまる	ɯ̟ᵝ m a̠ ɾ ɯ̟ᵝ
うまれつき	ɯ̟ᵝ m a̠ ɾ e̞ t͡s ɨᵝ kʲ i
うみ	ɯ̟ᵝ mʲ i
うみうま	ɯ̟ᵝ mʲ i ɯ̟ᵝ m a̠
うみせんやません	ɯ̟ᵝ mʲ i s ẽ̞ ɰ̃ j a̠ m a̠ s ẽ̞ ɴ
うみとかげ	ɯ̟ᵝ mʲ i t o̞ k a̠ ɡ e̞
うみへびざ	ɯ̟ᵝ mʲ i h e̞ bʲ i z a̠
うめ	ɯ̟ᵝ m e̞
うめき	ɯ̟ᵝ m e̞ kʲ i
うめく	ɯ̟ᵝ m e̞ k ɯ̟ᵝ
うめる	ɯ̟ᵝ m e̞ ɾ ɯ̟ᵝ
うら	ɯ̟ᵝ ɾ a̠
うらがえし	ɯ̟ᵝ ɾ a̠ ɡ a̠ e̞ ɕ i
うらぎり	ɯ̟ᵝ ɾ a̠ ɡʲ i ɾʲ i
うらぎりもの	ɯ̟ᵝ ɾ a̠ ɡʲ i ɾʲ i m o̞ n o̞
うらない	ɯ̟ᵝ ɾ a̠ n a̠ i
うらばなし	ɯ̟ᵝ ɾ a̠ b a̠ n a̠ ɕ i
うらびょうし	ɯ̟ᵝ ɾ a̠ bʲ o̞ː ɕ i
うらみ	ɯ̟ᵝ ɾ a̠ mʲ i
うらみぶし	ɯ̟ᵝ ɾ a̠ mʲ i b ɯ̟ᵝ ɕ i
うらむき	ɯ̟ᵝ ɾ a̠ m ɯ̟ᵝ kʲ i
うらやましい	ɯ̟ᵝ ɾ a̠ j a̠ m a̠ ɕ i i
うらやみ	ɯ̟ᵝ ɾ a̠ j a̠ mʲ i
うらやむ	ɯ̟ᵝ ɾ a̠ j a̠ m ɯ̟ᵝ
うり	ɯ̟ᵝ ɾʲ i
うりきれる	ɯ̟ᵝ ɾʲ i kʲ i ɾ e̞ ɾ ɯ̟ᵝ
うりこ	ɯ̟ᵝ ɾʲ i k o̞
うりて	ɯ̟ᵝ ɾʲ i t e̞
うりにつめありつめにつめなし	ɯ̟ᵝ ɾʲ i ɲ̟ i t͡s ɨᵝ m e̞ a̠ ɾʲ i t͡s ɨᵝ m e̞ ɲ̟ i t͡s ɨᵝ m e̞ n a̠ ɕ i
うりはらう	ɯ̟ᵝ ɾʲ i h a̠ ɾ a̠ ɯ̟ᵝ
うる	ɯ̟ᵝ ɾ ɯ̟ᵝ
うるおい	ɯ̟ᵝ ɾ ɯ̟ᵝ o̞ i
うるおす	ɯ̟ᵝ ɾ ɯ̟ᵝ o̞ s ɨᵝ
うるさい	ɯ̟ᵝ ɾ ɯ̟ᵝ s a̠ i
うるわしい	ɯ̟ᵝ ɾ ɯ̟ᵝ ɰᵝ a̠ ɕ iː
うれえる	ɯ̟ᵝ ɾ e̞ː ɾ ɯ̟ᵝ
うれしい	ɯ̟ᵝ ɾ e̞ ɕ iː
うれしなき	ɯ̟ᵝ ɾ e̞ ɕ i n a̠ kʲ i
うれのこり	ɯ̟ᵝ ɾ e̞ n o̞ k o̞ ɾʲ i
うろおぼえ	ɯ̟ᵝ ɾ o̞ː b o̞ e̞
うろこ	ɯ̟ᵝ ɾ o̞ k o̞
うろたえる	ɯ̟ᵝ ɾ o̞ t a̠ e̞ ɾ ɯ̟ᵝ
うろつく	ɯ̟ᵝ ɾ o̞ t͡s ɨ̥ᵝ k ɯ̟ᵝ
うろん	ɯ̟ᵝ ɾ õ̞ ɴ
うわがき	ɯ̟ᵝ ɰᵝ a̠ ɡ a̠ kʲ i
うわごと	ɯ̟ᵝ ɰᵝ a̠ ɡ o̞ t o̞
うわさ	ɯ̟ᵝ ɰᵝ a̠ s a̠
うわさばなし	ɯ̟ᵝ ɰᵝ a̠ s a̠ b a̠ n a̠ ɕ i
うわつく	ɯ̟ᵝ ɰᵝ a̠ t͡s ɨᵝ k ɯ̟ᵝ
うわづみ	ɯ̟ᵝ ɰᵝ a̠ z ɨᵝ mʲ i
うわなり	ɡ o̞ s a̠ i
うわば	ɯ̟ᵝ ɰᵝ a̠ b a̠
うわべ	ɯ̟ᵝ ɰᵝ a̠ b e̞
うん	ɯ̟̃ᵝ ɴ
うんこ	ɯ̟̃ᵝ ŋ k o̞
うんちく	ɯ̟̃ᵝ ɲ̟ t͡ɕ i k ɯ̟ᵝ
うんでい	ɯ̟̃ᵝ n d e̞ː
うんでいのさ	ɯ̟̃ᵝ n d e̞ː n o̞ s a̠
うんどうおんち	ɯ̟̃ᵝ n d o̞ː õ̞ ɲ̟ t͡ɕ i
うんどうぐつ	ɯ̟̃ᵝ n d o̞ː ɡ ɯ̟ᵝ t͡s ɨᵝ
うんどうりょう	ɯ̟̃ᵝ n d o̞ː ɾʲ o̞ː
うんめい	ɯ̟̃ᵝ mː e̞ː
うんも	ɯ̟̃ᵝ mː o̞
えいいんぼん	e̞ː ĩ m b õ̞ ɴ
えいせいとし	e̞ː s e̞ː t o̞ ɕ i
えいぞう	e̞ː z o̞ː
えいほう	e̞ː h o̞ː
えいよ	e̞ː j o̞
えいようふりょう	e̞ː j o̞ː ɸ ɯ̟ᵝ ɾʲ o̞ː
えいりょく	e̞ː ɾʲ o̞ k ɯ̟ᵝ
えがお	e̞ ɡ a̠ o̞
えき	e̞ kʲ i
えきがく	e̞ kʲ i ɡ a̠ k ɯ̟ᵝ
えきめいひょう	e̞ kʲ i m e̞ː ç o̞ː
えくぼ	e̞ k ɯ̟ᵝ b o̞
えぐい	e̞ ɡ ɯ̟ᵝ i
えげつない	e̞ ɡ e̞ t͡s ɨᵝ n a̠ i
えごま	e̞ ɡ o̞ m a̠
えさ	e̞ s a̠
えさし	e̞ s a̠ ɕ i
えし	e̞ ɕ i
えそ	e̞ s o̞
えぞおおかみ	e̞ z o̞ o̞ː k a̠ mʲ i
えだまめ	e̞ d a̠ m a̠ m e̞
えっとう	e̞ t̚ t o̞ː
えつ	e̞ t͡s ɨᵝ
えつらん	e̞ t͡s ɨᵝ ɾ ã̠ ɴ
えばら	e̞ b a̠ ɾ a̠
えひめ	e̞ ç i m e̞
えび	e̞ bʲ i
えびす	e̞ bʲ i s ɨᵝ
えびでたいをつる	e̞ bʲ i d e̞ t a̠ i o̞ t͡s ɨᵝ ɾ ɯ̟ᵝ
えま	e̞ m a̠
えみこ	e̞ mʲ i k o̞
えもと	e̞ m o̞ t o̞
えらい	e̞ ɾ a̠ i
えらぶ	e̞ ɾ a̠ b ɯ̟ᵝ
えり	e̞ ɾʲ i
えりか	e̞ ɾʲ i k a̠
える	e̞ ɾ ɯ̟ᵝ
えん	ẽ̞ ɴ
えんえき	ẽ̞ ɴ e̞ kʲ i
えんえん	ẽ̞ ɰ̃ ẽ̞ ɴ
えんか	ẽ̞ ŋ k a̠
えんかく	ẽ̞ ŋ k a̠ k ɯ̟ᵝ
えんきせい	ẽ̞ ŋʲ kʲ i̥ s e̞ː
えんご	ẽ̞ ŋ ɡ o̞
えんざんぞうふくき	ẽ̞ n d͡z ã̠ n d͡z o̞ː ɸ ɯ̟ᵝ k ɯ̟̊ᵝ kʲ i
えんし	ẽ̞ ɰ̃ ɕ i
えんしゅう	ẽ̞ ɰ̃ ɕ ɨᵝː
えんしょく	ẽ̞ ɰ̃ ɕ o̞ k ɯ̟ᵝ
えんじょ	ẽ̞ ɲ̟ d͡ʑ o̞
えんじん	ẽ̞ ɲ̟ d͡ʑ ĩ ɴ
えんすいきょくせん	ẽ̞ ɰ̃ s ɨᵝ i kʲ o̞ k ɯ̟̊ᵝ s ẽ̞ ɴ
えんせいか	ẽ̞ ɰ̃ s e̞ː k a̠
えんせいてき	ẽ̞ ɰ̃ s e̞ː t e̞ kʲ i
えんそ	ẽ̞ ɰ̃ s o̞
えんそうかい	ẽ̞ ɰ̃ s o̞ː k a̠ i
えんたく	ẽ̞ n t a̠ k ɯ̟ᵝ
えんだい	ẽ̞ n d a̠ i
えんちゅうひょう	ẽ̞ ɲ̟ t͡ɕ ɨᵝː ç o̞ː
えんちょうせん	ẽ̞ ɲ̟ t͡ɕ o̞ː s ẽ̞ ɴ
えんちょく	ẽ̞ ɲ̟ t͡ɕ o̞ k ɯ̟ᵝ
えんてん	ẽ̞ n t ẽ̞ ɴ
えんでん	ẽ̞ n d ẽ̞ ɴ
えんでんりゅう	ẽ̞ n d ẽ̞ n ɾʲ ɨᵝː
えんど	ẽ̞ n d o̞
えんない	ẽ̞ nː a̠ i
えんびふく	ẽ̞ m bʲ i ɸ ɯ̟̊ᵝ k ɯ̟ᵝ
えんぴつ	ẽ̞ m pʲ i̥ t͡s ɨᵝ
えんぶきょく	ẽ̞ m b ɯ̟ᵝ kʲ o̞ k ɯ̟ᵝ
えんぺい	ẽ̞ m p e̞ː
えんぺん	ẽ̞ m p ẽ̞ ɴ
えんまん	ẽ̞ mː ã̠ ɴ
えんるい	ẽ̞ n ɾ ɯ̟ᵝ i
おい	o̞ i
おいうつ	o̞ i ɯ̟ᵝ t͡s ɨᵝ
おいかける	o̞ i k a̠ k e̞ ɾ ɯ̟ᵝ
おいしい	o̞ i ɕ iː
おいたつ	o̞ i t a̠ t͡s ɨᵝ
おいつく	o̞ i t͡s ɨᵝ k ɯ̟ᵝ
おいて	o̞ i t e̞
おいてけぼり	o̞ i t e̞ k e̞ b o̞ ɾʲ i
おいでになる	o̞ i d e̞ ɲ̟ i n a̠ ɾ ɯ̟ᵝ
おいぼれ	o̞ i b o̞ ɾ e̞
おいらん	o̞ i ɾ ã̠ ɴ
おうえんだん	o̞ː ẽ̞ n d ã̠ ɴ
おうか	o̞ː k a̠
おうかくまく	o̞ː k a̠ k ɯ̟ᵝ m a̠ k ɯ̟ᵝ
おうこう	o̞ː k o̞ː
おうこく	o̞ː k o̞ k ɯ̟ᵝ
おうごんしょくしょくぶつ	o̞ː ɡ õ̞ ɰ̃ ɕ o̞ k ɯ̟ᵝ ɕ o̞ k ɯ̟ᵝ b ɯ̟ᵝ t͡s ɨᵝ
おうごんじだい	o̞ː ɡ õ̞ ɲ̟ d͡ʑ i d a̠ i
おうごんひ	o̞ː ɡ õ̞ ɰ̃ ç i
おうじ	o̞ː ʑ i
おうじゃ	o̞ː ʑ a̠
おうじょうぎわ	o̞ː ʑ o̞ː ɡʲ i ɰᵝ a̠
おうすい	o̞ː s ɨᵝ i
おうせ	o̞ː s e̞
おうだんほどう	o̞ː d ã̠ ɰ̃ h o̞ d o̞ː
おうてん	o̞ː t ẽ̞ ɴ
おうど	o̞ː d o̞
おうへい	o̞ː h e̞ː
おうぼう	o̞ː b o̞ː
おうりょく	o̞ː ɾʲ o̞ k ɯ̟ᵝ
おうれん	o̞ː ɾ ẽ̞ ɴ
おえ	o̞ e̞
おえかき	o̞ e̞ k a̠ kʲ i
おえる	o̞ e̞ ɾ ɯ̟ᵝ
おおい	o̞ː i
おおいかくす	o̞ː i k a̠ k ɯ̟ᵝ s ɨᵝ
おおいちざ	o̞ː i t͡ɕ i z a̠
おおいぬざ	o̞ː i n ɯ̟ᵝ z a̠
おおう	o̞ː ɯ̟ᵝ
おおうそ	o̞ː ɯ̟ᵝ s o̞
おおうみがらす	o̞ː ɯ̟ᵝ mʲ i ɡ a̠ ɾ a̠ s ɨᵝ
おおかた	o̞ː k a̠ t a̠
おおかみ	o̞ː k a̠ mʲ i
おおがた	o̞ː ɡ a̠ t a̠
おおがま	o̞ː ɡ a̠ m a̠
おおきに	o̞ː kʲ i ɲ̟ i
おおぐい	o̞ː ɡ ɯ̟ᵝ i
おおごま	o̞ː ɡ o̞ m a̠
おおじしん	o̞ː ʑ i ɕ ĩ ɴ
おおずもう	o̞ː z ɨᵝ m o̞ː
おおせ	o̞ː s e̞
おおでき	o̞ː d e̞ kʲ i
おおはくちょう	o̞ː h a̠ k ɯ̟̊ᵝ t͡ɕ o̞ː
おおはし	o̞ː h a̠ ɕ i
おおびる	o̞ː bʲ i ɾ ɯ̟ᵝ
おおみず	o̞ː mʲ i z ɨᵝ
おおもじ	o̞ː m o̞ ʑ i
おおもと	o̞ː m o̞ t o̞
おおるり	o̞ː ɾ ɯ̟ᵝ ɾʲ i
おおわらわ	o̞ː ɰᵝ a̠ ɾ a̠ ɰᵝ a̠
おかあさん	o̞ k a̠ː s ã̠ ɴ
おかえり	o̞ k a̠ e̞ ɾʲ i
おかざわ	o̞ k a̠ z a̠ ɰᵝ a̠
おかし	o̞ k a̠ ɕ i
おかしい	o̞ k a̠ ɕ iː
おかしな	o̞ k a̠ ɕ i n a̠
おかしや	o̞ k a̠ ɕ i j a̠
おかす	o̞ k a̠ s ɨᵝ
おかね	o̞ k a̠ n e̞
おかみ	o̞ k a̠ mʲ i
おから	o̞ k a̠ ɾ a̠
おからこうじ	o̞ k a̠ ɾ a̠ k o̞ː ʑ i
おき	o̞ kʲ i
おきじ	o̞ kʲ i ʑ i
おきて	o̞ kʲ i t e̞
おきなわけん	o̞ kʲ i n a̠ ɰᵝ a̠ k ẽ̞ ɴ
おきぬけ	o̞ kʲ i n ɯ̟ᵝ k e̞
おきゃく	o̞ kʲ a̠ k ɯ̟ᵝ
おきる	o̞ kʲ i ɾ ɯ̟ᵝ
おぎなう	o̞ ɡʲ i n a̠ ɯ̟ᵝ
おぎゃる	o̞ ɡʲ a̠ ɾ ɯ̟ᵝ
おく	o̞ k ɯ̟ᵝ
おくそこ	o̞ k ɯ̟ᵝ s o̞ k o̞
おくびょうもの	o̞ k ɯ̟ᵝ bʲ o̞ː m o̞ n o̞
おくらせる	o̞ k ɯ̟ᵝ ɾ a̠ s e̞ ɾ ɯ̟ᵝ
おくりもの	o̞ k ɯ̟ᵝ ɾʲ i m o̞ n o̞
おくる	o̞ k ɯ̟ᵝ ɾ ɯ̟ᵝ
おくれげ	o̞ k ɯ̟ᵝ ɾ e̞ ɡ e̞
おくれる	o̞ k ɯ̟ᵝ ɾ e̞ ɾ ɯ̟ᵝ
おけ	o̞ k e̞
おこがましい	o̞ k o̞ ɡ a̠ m a̠ ɕ iː
おこす	o̞ k o̞ s ɨᵝ
おこなう	o̞ k o̞ n a̠ ɯ̟ᵝ
おこもり	o̞ k o̞ m o̞ ɾʲ i
おこる	o̞ k o̞ ɾ ɯ̟ᵝ
おさえ	o̞ s a̠ e̞
おさがめ	o̞ s a̠ ɡ a̠ m e̞
おさない	o̞ s a̠ n a̠ i
おさなともだち	o̞ s a̠ n a̠ t o̞ m o̞ d a̠ t͡ɕ i
おさまる	o̞ s a̠ m a̠ ɾ ɯ̟ᵝ
おさめる	o̞ s a̠ m e̞ ɾ ɯ̟ᵝ
おし	o̞ ɕ i
おしい	o̞ ɕ i i
おしいれ	o̞ ɕ i i ɾ e̞
おしえる	o̞ ɕ i e̞ ɾ ɯ̟ᵝ
おしきる	o̞ ɕ i kʲ i ɾ ɯ̟ᵝ
おしすすめる	o̞ ɕ i s ɨᵝ s ɨᵝ m e̞ ɾ ɯ̟ᵝ
おしつけがましい	o̞ ɕ i t͡s ɨᵝ k e̞ ɡ a̠ m a̠ ɕ iː
おしまい	o̞ ɕ i m a̠ i
おしゃぶり	o̞ ɕ a̠ b ɯ̟ᵝ ɾʲ i
おしゃべり	o̞ ɕ a̠ b e̞ ɾʲ i
おしゃれ	o̞ ɕ a̠ ɾ e̞
おしや	o̞ ɕ i j a̠
おしり	o̞ ɕ i ɾʲ i
おじ	o̞ ʑ i
おじいさん	o̞ ʑ iː s ã̠ ɴ
おじいちゃん	o̞ ʑ iː t͡ɕ ã̠ ɴ
おじうえ	o̞ ʑ i ɯ̟ᵝ e̞
おじさん	o̞ ʑ i s ã̠ ɴ
おじさんこうぶん	o̞ ʑ i s ã̠ ŋ k o̞ː b ɯ̟̃ᵝ ɴ
おじゃん	o̞ ʑ ã̠ ɴ
おそ	o̞ s o̞
おそい	o̞ s o̞ i
おそう	o̞ s o̞ ɯ̟ᵝ
おそけ	o̞ s o̞ k e̞
おそらく	o̞ s o̞ ɾ a̠ k ɯ̟ᵝ
おそれる	o̞ s o̞ ɾ e̞ ɾ ɯ̟ᵝ
おそろしい	o̞ s o̞ ɾ o̞ ɕ i i
おそわる	o̞ s o̞ ɰᵝ a̠ ɾ ɯ̟ᵝ
おそん	o̞ s õ̞ ɴ
おたがいさま	o̞ t a̠ ɡ a̠ i s a̠ m a̠
おたとも	o̞ t a̠ t o̞ m o̞
おだてる	o̞ d a̠ t e̞ ɾ ɯ̟ᵝ
おだやか	o̞ d a̠ j a̠ k a̠
おち	o̞ t͡ɕ i
おちいる	o̞ t͡ɕ i i ɾ ɯ̟ᵝ
おちつく	o̞ t͡ɕ i t͡s ɨᵝ k ɯ̟ᵝ
おちつける	o̞ t͡ɕ i t͡s ɨᵝ k e̞ ɾ ɯ̟ᵝ
おちゃだい	o̞ t͡ɕ a̠ d a̠ i
おちんちん	o̞ t͡ɕ ĩ ɲ̟ t͡ɕ ĩ ɴ
おっきい	o̞ k̚ʲ kʲ i i
おっくう	o̞ k̚ k ɯ̟ᵝː
おっさん	o̞ sː ã̠ ɴ
おっしゃる	o̞ ɕː a̠ ɾ ɯ̟ᵝ
おっちぬ	o̞ t̚ t͡ɕ i n ɯ̟ᵝ
おっとせい	o̞ t̚ t o̞ s e̞ː
おっぱい	o̞ p̚ p a̠ i
おっぱらう	o̞ p̚ p a̠ ɾ a̠ ɯ̟ᵝ
おてなみ	o̞ t e̞ n a̠ mʲ i
おてんば	o̞ t ẽ̞ m b a̠
おでこ	o̞ d e̞ k o̞
おとうさん	o̞ t o̞ː s ã̠ ɴ
おとぎばなし	o̞ t o̞ ɡʲ i b a̠ n a̠ ɕ i
おとこ	o̞ t o̞ k o̞
おとこがお	o̞ t o̞ k o̞ ɡ a̠ o̞
おとこがすたる	o̞ t o̞ k o̞ ɡ a̠ s ɨᵝ t a̠ ɾ ɯ̟ᵝ
おとこごころ	o̞ t o̞ k o̞ ɡ o̞ k o̞ ɾ o̞
おとこのこ	o̞ t o̞ k o̞ n o̞ k o̞
おとこをみがく	o̞ t o̞ k o̞ o̞ mʲ i ɡ a̠ k ɯ̟ᵝ
おとしあな	o̞ t o̞ ɕ i a̠ n a̠
おとす	o̞ t o̞ s ɨᵝ
おとな	o̞ t o̞ n a̠
おとなしい	o̞ t o̞ n a̠ ɕ iː
おとなぶる	o̞ t o̞ n a̠ b ɯ̟ᵝ ɾ ɯ̟ᵝ
おとめ	o̞ t o̞ m e̞
おとめざ	o̞ t o̞ m e̞ z a̠
おとり	o̞ t o̞ ɾʲ i
おとる	o̞ t o̞ ɾ ɯ̟ᵝ
おとろえる	o̞ t o̞ ɾ o̞ e̞ ɾ ɯ̟ᵝ
おとわれ	o̞ t o̞ ɰᵝ a̠ ɾ e̞
おどかす	o̞ d o̞ k a̠ s ɨᵝ
おどす	o̞ d o̞ s ɨᵝ
おどる	o̞ d o̞ ɾ ɯ̟ᵝ
おどろかす	o̞ d o̞ ɾ o̞ k a̠ s ɨᵝ
おどろき	o̞ d o̞ ɾ o̞ kʲ i
おどろく	o̞ d o̞ ɾ o̞ k ɯ̟ᵝ
おないどし	o̞ n a̠ i d o̞ ɕ i
おなか	o̞ n a̠ k a̠
おにぎり	o̞ ɲ̟ i ɡʲ i ɾʲ i
おにび	o̞ ɲ̟ i bʲ i
おによめ	o̞ ɲ̟ i j o̞ m e̞
おねえさん	o̞ n e̞ː s ã̠ ɴ
おの	o̞ n o̞
おのおの	o̞ n o̞ o̞ n o̞
おのれ	o̞ n o̞ ɾ e̞
おはよう	o̞ h a̠ j o̞ː
おば	o̞ b a̠
おひさま	o̞ ç i s a̠ m a̠
おひとよし	o̞ ç i t o̞ j o̞ ɕ i
おび	o̞ bʲ i
おびえる	o̞ bʲ i e̞ ɾ ɯ̟ᵝ
おびただしい	o̞ bʲ i t a̠ d a̠ ɕ i i
おびる	o̞ bʲ i ɾ ɯ̟ᵝ
おふくろ	o̞ ɸ ɯ̟̊ᵝ k ɯ̟ᵝ ɾ o̞
おぶさる	o̞ b ɯ̟ᵝ s a̠ ɾ ɯ̟ᵝ
おへや	o̞ h e̞ j a̠
おべっか	o̞ b e̞ k̚ k a̠
おべんちゃら	o̞ b ẽ̞ ɲ̟ t͡ɕ a̠ ɾ a̠
おぼえる	o̞ b o̞ e̞ ɾ ɯ̟ᵝ
おぼろづきよ	o̞ b o̞ ɾ o̞ z ɨᵝ kʲ i j o̞
おまいつ	o̞ m a̠ i t͡s ɨᵝ
おまえ	o̞ m a̠ e̞
おまえたち	o̞ m a̠ e̞ t a̠ t͡ɕ i
おまかせ	o̞ m a̠ k a̠ s e̞
おまもり	o̞ m a̠ m o̞ ɾʲ i
おまんこ	o̞ m ã̠ ŋ k o̞
おむつ	o̞ m ɯ̟ᵝ t͡s ɨᵝ
おめいばんかい	o̞ m e̞ː b ã̠ ŋ k a̠ i
おめかし	o̞ m e̞ k a̠ ɕ i
おめでとう	o̞ m e̞ d e̞ t o̞ː
おめにかかる	o̞ m e̞ ɲ̟ i k a̠ k a̠ ɾ ɯ̟ᵝ
おめめ	o̞ m e̞ m e̞
おもいうかべる	o̞ m o̞ i ɯ̟ᵝ k a̠ b e̞ ɾ ɯ̟ᵝ
おもいたつ	o̞ m o̞ i t a̠ t͡s ɨᵝ
おもいだす	o̞ m o̞ i d a̠ s ɨᵝ
おもいつき	o̞ m o̞ i t͡s ɨᵝ kʲ i
おもいつく	o̞ m o̞ i t͡s ɨᵝ k ɯ̟ᵝ
おもいで	o̞ m o̞ i d e̞
おもいどおり	o̞ m o̞ i d o̞ː ɾʲ i
おもいやり	o̞ m o̞ i j a̠ ɾʲ i
おもう	o̞ m o̞ ɯ̟ᵝ
おもしろい	o̞ m o̞ ɕ i ɾ o̞ i
おもたい	o̞ m o̞ t a̠ i
おもちゃ	o̞ m o̞ t͡ɕ a̠
おもてざた	o̞ m o̞ t e̞ z a̠ t a̠
おもに	o̞ m o̞ ɲ̟ i
おもねる	o̞ m o̞ n e̞ ɾ ɯ̟ᵝ
おもむく	o̞ m o̞ m ɯ̟ᵝ k ɯ̟ᵝ
おもや	o̞ m o̞ j a̠
おもり	o̞ m o̞ ɾʲ i
おもんぱかる	o̞ m õ̞ m p a̠ k a̠ ɾ ɯ̟ᵝ
おや	o̞ j a̠
おやごころ	o̞ j a̠ ɡ o̞ k o̞ ɾ o̞
おやしらず	o̞ j a̠ ɕ i ɾ a̠ z ɨᵝ
おやじ	o̞ j a̠ ʑ i
おやすみ	o̞ j a̠ s ɨᵝ mʲ i
おやすみなさい	o̞ j a̠ s ɨᵝ mʲ i n a̠ s a̠ i
おやすみになる	o̞ j a̠ s ɨᵝ mʲ i ɲ̟ i n a̠ ɾ ɯ̟ᵝ
おやゆずり	o̞ j a̠ j ɯ̟ᵝ z ɨᵝ ɾʲ i
およぎ	o̞ j o̞ ɡʲ i
およそ	o̞ j o̞ s o̞
および	o̞ j o̞ bʲ i
およぶ	o̞ j o̞ b ɯ̟ᵝ
おり	o̞ ɾʲ i
おりがみ	o̞ ɾʲ i ɡ a̠ mʲ i
おりど	o̞ ɾʲ i d o̞
おりひめぼし	o̞ ɾʲ i ç i m e̞ b o̞ ɕ i
おりる	o̞ ɾʲ i ɾ ɯ̟ᵝ
おる	o̞ ɾ ɯ̟ᵝ
おれ	o̞ ɾ e̞
おれさま	o̞ ɾ e̞ s a̠ m a̠
おれまがる	o̞ ɾ e̞ m a̠ ɡ a̠ ɾ ɯ̟ᵝ
おろ	o̞ ɾ o̞
おろか	o̞ ɾ o̞ k a̠
おろかしい	o̞ ɾ o̞ k a̠ ɕ iː
おろしうり	o̞ ɾ o̞ ɕ i ɯ̟ᵝ ɾʲ i
おろす	o̞ ɾ o̞ s ɨᵝ
おろそか	o̞ ɾ o̞ s o̞ k a̠
おろち	o̞ ɾ o̞ t͡ɕ i
おわり	o̞ ɰᵝ a̠ ɾʲ i
おん	õ̞ ɴ
おんあつ	õ̞ ɰ̃ a̠ t͡s ɨᵝ
おんいき	õ̞ ɰ̃ i kʲ i
おんかかかびさんまえいそわか	õ̞ ŋ k a̠ k a̠ k a̠ bʲ i s ã̠ mː a̠ e̞ː s o̞ ɰᵝ a̠ k a̠
おんきょう	õ̞ ŋʲ kʲ o̞ː
おんそ	õ̞ ɰ̃ s o̞
おんどく	õ̞ n d o̞ k ɯ̟ᵝ
おんどけい	õ̞ n d o̞ k e̞ː
おんどり	õ̞ n d o̞ ɾʲ i
おんな	õ̞ nː a̠
おんながお	õ̞ nː a̠ ɡ a̠ o̞
おんなのこ	õ̞ nː a̠ n o̞ k o̞
おんなぶげいしゃ	õ̞ nː a̠ b ɯ̟ᵝ ɡ e̞ː ɕ a̠
おんなもの	õ̞ nː a̠ m o̞ n o̞
おんぶ	õ̞ m b ɯ̟ᵝ
おんみょうじ	õ̞ mʲː o̞ː ʑ i
おんよみ	õ̞ ɰ̃ j o̞ mʲ i
かいあげる	k a̠ i a̠ ɡ e̞ ɾ ɯ̟ᵝ
かいあわせ	k a̠ i a̠ ɰᵝ a̠ s e̞
かいい	k a̠ i i
かいえん	k a̠ i ẽ̞ ɴ
かいか	k a̠ i k a̠
かいかく	k a̠ i k a̠ k ɯ̟ᵝ
かいかん	k a̠ i k ã̠ ɴ
かいがい	k a̠ i ɡ a̠ i
かいがん	k a̠ i ɡ ã̠ ɴ
かいがんせん	k a̠ i ɡ ã̠ ɰ̃ s ẽ̞ ɴ
かいきせん	k a̠ i kʲ i̥ s ẽ̞ ɴ
かいきょうと	k a̠ i kʲ o̞ː t o̞
かいきん	k a̠ i kʲ ĩ ɴ
かいぎしつ	k a̠ i ɡʲ i ɕ i t͡s ɨᵝ
かいけつ	k a̠ i k e̞ t͡s ɨᵝ
かいけん	k a̠ i k ẽ̞ ɴ
かいげつ	k a̠ i ɡ e̞ t͡s ɨᵝ
かいこう	k a̠ i k o̞ː
かいこく	k a̠ i k o̞ k ɯ̟ᵝ
かいころく	k a̠ i k o̞ ɾ o̞ k ɯ̟ᵝ
かいご	k a̠ i ɡ o̞
かいさ	k a̠ i s a̠
かいさつ	k a̠ i s a̠ t͡s ɨᵝ
かいさつぐち	k a̠ i s a̠ t͡s ɨᵝ ɡ ɯ̟ᵝ t͡ɕ i
かいざん	k a̠ i z ã̠ ɴ
かいし	k a̠ i ɕ i
かいしめ	k a̠ i ɕ i m e̞
かいしゃいん	k a̠ i ɕ a̠ ĩ ɴ
かいしゅうりつ	k a̠ i ɕ ɨᵝː ɾʲ i t͡s ɨᵝ
かいしょく	k a̠ i ɕ o̞ k ɯ̟ᵝ
かいしん	k a̠ i ɕ ĩ ɴ
かいじつ	k a̠ i ʑ i t͡s ɨᵝ
かいじゅう	k a̠ i ʑ ɨᵝː
かいず	k a̠ i z ɨᵝ
かいせきがく	k a̠ i s e̞ kʲ i ɡ a̠ k ɯ̟ᵝ
かいせつ	k a̠ i s e̞ t͡s ɨᵝ
かいそ	k a̠ i s o̞
かいそう	k a̠ i s o̞ː
かいぞうど	k a̠ i z o̞ː d o̞
かいぞく	k a̠ i z o̞ k ɯ̟ᵝ
かいぞくせん	k a̠ i z o̞ k ɯ̟̊ᵝ s ẽ̞ ɴ
かいぞくばん	k a̠ i z o̞ k ɯ̟ᵝ b ã̠ ɴ
かいたい	k a̠ i t a̠ i
かいたく	k a̠ i t a̠ k ɯ̟ᵝ
かいたくしゃ	k a̠ i t a̠ k ɯ̟ᵝ ɕ a̠
かいだい	k a̠ i d a̠ i
かいだく	k a̠ i d a̠ k ɯ̟ᵝ
かいちゅうでんとう	k a̠ i t͡ɕ ɨᵝː d ẽ̞ n t o̞ː
かいちゅうどけい	k a̠ i d o̞ k e̞ː
かいちょうふん	k a̠ i t͡ɕ o̞ː ɸ ɯ̟̃ᵝ ɴ
かいとう	k a̠ i t o̞ː
かいはい	k a̠ i h a̠ i
かいふくたいい	k a̠ i ɸ ɯ̟ᵝ k ɯ̟ᵝ t a̠ i i
かいへいき	k a̠ i h e̞ː kʲ i
かいほう	k a̠ i h o̞ː
かいめん	k a̠ i m ẽ̞ ɴ
かいよう	k a̠ i j o̞ː
かいようがく	k a̠ i j o̞ː ɡ a̠ k ɯ̟ᵝ
かいらいし	k a̠ i ɾ a̠ i ɕ i
かいりゅう	k a̠ i ɾʲ ɨᵝː
かいろう	k a̠ i ɾ o̞ː
かいわい	k a̠ i ɰᵝ a̠ i
かいん	k a̠ ĩ ɴ
かう	k a̠ ɯ̟ᵝ
かえうた	k a̠ e̞ ɯ̟ᵝ t a̠
かえしん	k a̠ e̞ ɕ ĩ ɴ
かえす	k a̠ e̞ s ɨᵝ
かえすがえす	k a̠ e̞ s ɨᵝ ɡ a̠ e̞ s ɨᵝ
かえでか	k a̠ e̞ d e̞ k a̠
かえる	k a̠ e̞ ɾ ɯ̟ᵝ
かえんびん	k a̠ ẽ̞ m bʲ ĩ ɴ
かえんほうしゃき	k a̠ ẽ̞ ɰ̃ h o̞ː ɕ a̠ kʲ i
かお	k a̠ o̞
かおだし	k a̠ o̞ d a̠ ɕ i
かか	k a̠ k a̠
かかあでんか	k a̠ k a̠ː d ẽ̞ ŋ k a̠
かかえる	k a̠ k a̠ e̞ ɾ ɯ̟ᵝ
かかげる	k a̠ k a̠ ɡ e̞ ɾ ɯ̟ᵝ
かかし	k a̠ k a̠ ɕ i
かかす	k a̠ k a̠ s ɨᵝ
かかる	k a̠ k a̠ ɾ ɯ̟ᵝ
かかわり	k a̠ k a̠ ɰᵝ a̠ ɾʲ i
かかわる	k a̠ k a̠ ɰᵝ a̠ ɾ ɯ̟ᵝ
かが	k a̠ ɡ e̞
かがいしゃ	k a̠ ɡ a̠ i ɕ a̠
かがくはくぶつかん	k a̠ ɡ a̠ k ɯ̟ᵝ h a̠ k ɯ̟ᵝ b ɯ̟ᵝ t͡s ɨ̥ᵝ k ã̠ ɴ
かがみ	k a̠ ɡ a̠ mʲ i
かがみもじ	k a̠ ɡ a̠ mʲ i m o̞ ʑ i
かがみもち	k a̠ ɡ a̠ mʲ i m o̞ t͡ɕ i
かがむ	k a̠ ɡ a̠ m ɯ̟ᵝ
かがやく	k a̠ ɡ a̠ j a̠ k ɯ̟ᵝ
かがり	k a̠ ɡ a̠ ɾʲ i
かがりかご	k a̠ ɡ a̠ ɾʲ i k a̠ ɡ o̞
かきあげ	k a̠ kʲ i a̠ ɡ e̞
かきおろす	k a̠ kʲ i o̞ ɾ o̞ s ɨᵝ
かきだし	k a̠ kʲ i d a̠ ɕ i
かきとる	k a̠ kʲ i t o̞ ɾ ɯ̟ᵝ
かきなおす	k a̠ kʲ i n a̠ o̞ s ɨᵝ
かきまわす	k a̠ kʲ i m a̠ ɰᵝ a̠ s ɨᵝ
かきみだす	k a̠ kʲ i mʲ i d a̠ s ɨᵝ
かきゅう	k a̠ kʲ ɨᵝː
かきゅうてき	k a̠ kʲ ɨᵝː t e̞ kʲ i
かきょ	k a̠ kʲ o̞
かぎ	k a̠ ɡʲ i
かぎっこ	k a̠ ɡʲ i k̚ k o̞
かぎまわる	k a̠ ɡʲ i m a̠ ɰᵝ a̠ ɾ ɯ̟ᵝ
かぎや	k a̠ ɡʲ i j a̠
かぎゅう	k a̠ ɡʲ ɨᵝː
かぎり	k a̠ ɡʲ i ɾʲ i
かぎる	k a̠ ɡʲ i ɾ ɯ̟ᵝ
かぎをにぎる	k a̠ ɡʲ i o̞ ɲ̟ i ɡʲ i ɾ ɯ̟ᵝ
かく	k a̠ k ɯ̟ᵝ
かくおび	k a̠ k ɯ̟ᵝ o̞ bʲ i
かくかっこ	k a̠ k ɯ̟ᵝ ɡ a̠ k̚ k o̞
かくぎょう	k a̠ k ɯ̟ᵝ ɡʲ o̞ː
かくさ	k a̠ k ɯ̟ᵝ s a̠
かくしあじ	k a̠ k ɯ̟ᵝ ɕ i a̠ ʑ i
かくしゅ	k a̠ k ɯ̟ᵝ ɕ ɨᵝ
かくじ	k a̠ k ɯ̟ᵝ ʑ i
かくすい	k a̠ k ɯ̟̊ᵝ s ɨᵝ i
かくせいき	k a̠ k ɯ̟ᵝ s e̞ː kʲ i
かくせいざい	k a̠ k ɯ̟ᵝ s e̞ː z a̠ i
かくたる	k a̠ k ɯ̟ᵝ t a̠ ɾ ɯ̟ᵝ
かくだい	k a̠ k ɯ̟ᵝ d a̠ i
かくちょう	k a̠ k ɯ̟ᵝ t͡ɕ o̞ː
かくとく	k a̠ k ɯ̟ᵝ t o̞ k ɯ̟ᵝ
かくど	k a̠ k ɯ̟ᵝ d o̞
かくのう	k a̠ k ɯ̟ᵝ n o̞ː
かくはん	k a̠ k ɯ̟̊ᵝ h ã̠ ɴ
かくはんのう	k a̠ k ɯ̟ᵝ h ã̠ nː o̞ː
かくべつ	k a̠ k ɯ̟ᵝ b e̞ t͡s ɨᵝ
かくまく	k a̠ k ɯ̟ᵝ m a̠ k ɯ̟ᵝ
かくめい	k a̠ k ɯ̟ᵝ m e̞ː
かくらん	k a̠ k ɯ̟ᵝ ɾ ã̠ ɴ
かくり	k a̠ k ɯ̟ᵝ ɾʲ i
かくりつ	k a̠ k ɯ̟ᵝ ɾʲ i t͡s ɨᵝ
かくれご	k a̠ k ɯ̟ᵝ ɾ e̞ ɡ o̞
かくれる	k a̠ k ɯ̟ᵝ ɾ e̞ ɾ ɯ̟ᵝ
かくれんぼ	k a̠ k ɯ̟ᵝ ɾ ẽ̞ m b o̞
かぐ	k a̠ ɡ ɯ̟ᵝ
かぐらざか	k a̠ ɡ ɯ̟ᵝ ɾ a̠ z a̠ k a̠
かぐらすず	k a̠ ɡ ɯ̟ᵝ ɾ a̠ s ɨᵝ z ɨᵝ
かぐらぶえ	k a̠ ɡ ɯ̟ᵝ ɾ a̠ b ɯ̟ᵝ e̞
かけがえ	k a̠ k e̞ ɡ a̠ e̞
かけがわ	k a̠ k e̞ ɡ a̠ ɰᵝ a̠
かけごと	k a̠ k e̞ ɡ o̞ t o̞
かけざん	k a̠ k e̞ z ã̠ ɴ
かけじく	k a̠ k e̞ ʑ i k ɯ̟ᵝ
かけつ	k a̠ k e̞ t͡s ɨᵝ
かけぬける	k a̠ k e̞ n ɯ̟ᵝ k e̞ ɾ ɯ̟ᵝ
かけまわる	k a̠ k e̞ m a̠ ɰᵝ a̠ ɾ ɯ̟ᵝ
かけもの	k a̠ k e̞ m o̞ n o̞
かける	k a̠ k e̞ ɾ ɯ̟ᵝ
かげえ	k a̠ ɡ e̞ e̞
かげき	k a̠ ɡ e̞ kʲ i
かげむしゃ	k a̠ ɡ e̞ m ɯ̟ᵝ ɕ a̠
かげり	k a̠ ɡ e̞ ɾʲ i
かげろう	k a̠ ɡ e̞ ɾ o̞ː
かげん	k a̠ ɡ ẽ̞ ɴ
かこ	k a̠ k o̞
かこきゅう	k a̠ k o̞ kʲ ɨᵝː
かこん	k a̠ k õ̞ ɴ
かご	k a̠ ɡ o̞
かごうぶつ	k a̠ ɡ o̞ː b ɯ̟ᵝ t͡s ɨᵝ
かごしま	k a̠ ɡ o̞ ɕ i m a̠
かさい	k a̠ s a̠ i
かさね	k a̠ s a̠ n e̞
かさばる	k a̠ s a̠ b a̠ ɾ ɯ̟ᵝ
かさぶた	k a̠ s a̠ b ɯ̟ᵝ t a̠
かさむ	k a̠ s a̠ m ɯ̟ᵝ
かさん	k a̠ s ã̠ ɴ
かさんかすいそ	k a̠ s ã̠ ŋ k a̠ s ɨᵝ i s o̞
かざあな	k a̠ z a̠ a̠ n a̠
かざい	k a̠ z a̠ i
かざくち	k a̠ z a̠ k ɯ̟ᵝ t͡ɕ i
かざけ	k a̠ z a̠ k e̞
かざんがん	k a̠ z ã̠ ŋ ɡ ã̠ ɴ
かざんとう	k a̠ z ã̠ n t o̞ː
かし	k a̠ ɕ i
かしおんど	k a̠ ɕ i õ̞ n d o̞
かしかん	k a̠ ɕ i̥ k ã̠ ɴ
かしこ	k a̠ ɕ i̥ k o̞
かしこい	k a̠ ɕ i k o̞ i
かしだし	k a̠ ɕ i d a̠ ɕ i
かしま	k a̠ ɕ i m a̠
かしましい	k a̠ ɕ i m a̠ ɕ iː
かしゃ	k a̠ ɕ a̠
かしょ	k a̠ ɕ o̞
かしょう	k a̠ ɕ o̞ː
かしょく	k a̠ ɕ o̞ k ɯ̟ᵝ
かしら	k a̠ ɕ i ɾ a̠
かしわ	k a̠ ɕ i ɰᵝ a̠
かしわもち	k a̠ ɕ i ɰᵝ a̠ m o̞ t͡ɕ i
かじ	k a̠ ʑ i
かじき	k a̠ ʑ i kʲ i
かじきざ	k a̠ ʑ i kʲ i z a̠
かじつしゅ	k a̠ ʑ i t͡s ɨᵝ ɕ ɨᵝ
かじば	k a̠ ʑ i b a̠
かじゅ	k a̠ ʑ ɨᵝ
かじゅう	k a̠ ʑ ɨᵝː
かじゅえん	k a̠ ʑ ɨᵝ ẽ̞ ɴ
かじょ	k a̠ ʑ o̞
かじょうがき	k a̠ ʑ o̞ː ɡ a̠ kʲ i
かじょうせっしゅ	k a̠ ʑ o̞ː s e̞ ɕː ɯ̟ᵝ
かじる	k a̠ ʑ i ɾ ɯ̟ᵝ
かす	k a̠ s ɨᵝ
かすい	k a̠ s ɨᵝ i
かすみ	k a̠ s ɨᵝ mʲ i
かすむ	k a̠ s ɨᵝ m ɯ̟ᵝ
かず	k a̠ z ɨᵝ
かずお	k a̠ z ɨᵝ o̞
かずおおい	k a̠ z ɨᵝ o̞ː i
かずかず	k a̠ z ɨᵝ k a̠ z ɨᵝ
かずみ	k a̠ z ɨᵝ mʲ i
かずゆき	k a̠ z ɨᵝ j ɯ̟ᵝ kʲ i
かせい	k a̠ s e̞ː
かせき	k a̠ s e̞ kʲ i
かせぐ	k a̠ s e̞ ɡ ɯ̟ᵝ
かぜ	k a̠ z e̞
かぜあたり	k a̠ z e̞ a̠ t a̠ ɾʲ i
かそうてき	k a̠ s o̞ː t e̞ kʲ i
かそくどびょう	k a̠ s o̞ k ɯ̟ᵝ d o̞ bʲ o̞ː
かそる	k a̠ s o̞ ɾ ɯ̟ᵝ
かぞえる	k a̠ z o̞ e̞ ɾ ɯ̟ᵝ
かたい	k a̠ t a̠ i
かたがた	k a̠ t a̠ ɡ a̠ t a̠
かたぎ	k a̠ t a̠ ɡʲ i
かたく	k a̠ t a̠ k ɯ̟ᵝ
かたくちいわし	k a̠ t a̠ k ɯ̟̊ᵝ t͡ɕ i i ɰᵝ a̠ ɕ i
かたこり	k a̠ t a̠ k o̞ ɾʲ i
かたじけない	k a̠ t a̠ ʑ i k e̞ n a̠ i
かたすみ	k a̠ t a̠ s ɨᵝ mʲ i
かたち	j o̞ː
かたづけ	k a̠ t a̠ z ɨᵝ k e̞
かたて	k a̠ t a̠ t e̞
かたな	k a̠ t a̠ n a̠
かたなかじ	k a̠ t a̠ n a̠ k a̠ ʑ i
かたは	k a̠ t a̠ h a̠
かたまり	k a̠ t a̠ m a̠ ɾʲ i
かたみ	k a̠ t a̠ mʲ i
かためる	k a̠ t a̠ m e̞ ɾ ɯ̟ᵝ
かたる	k a̠ t a̠ ɾ ɯ̟ᵝ
かたをいれる	k a̠ t a̠ o̞ i ɾ e̞ ɾ ɯ̟ᵝ
かだん	k a̠ d ã̠ ɴ
かちほこる	k a̠ t͡ɕ i h o̞ k o̞ ɾ ɯ̟ᵝ
かちぼし	k a̠ t͡ɕ i b o̞ ɕ i
かっけ	k a̠ k̚ k e̞
かっこいい	k a̠ k̚ k o̞ iː
かっこう	k a̠ k̚ k o̞ː
かっこうわるい	k a̠ k̚ k o̞ː ɰᵝ a̠ ɾ ɯ̟ᵝ i
かっさらう	k a̠ sː a̠ ɾ a̠ ɯ̟ᵝ
かっせい	k a̠ sː e̞ː
かっせん	k a̠ sː ẽ̞ ɴ
かっそうろ	k a̠ sː o̞ː ɾ o̞
かったるい	k a̠ t̚ t a̠ ɾ ɯ̟ᵝ i
かって	k a̠ t̚ t e̞
かっぱ	k a̠ p̚ p a̠
かっぱつ	k a̠ p̚ p a̠ t͡s ɨᵝ
かっぽうぎ	k a̠ p̚ p o̞ː ɡʲ i
かつ	k a̠ t͡s ɨᵝ
かつえき	k a̠ t͡s ɨᵝ e̞ kʲ i
かつお	k a̠ t͡s ɨᵝ o̞
かつおのえぼし	k a̠ t͡s ɨᵝ o̞ n o̞ e̞ b o̞ ɕ i
かつま	k a̠ t͡s ɨᵝ m a̠
かつら	k a̠ t͡s ɨᵝ ɾ a̠
かてい	k a̠ t e̞ː
かていけい	k a̠ t e̞ː k e̞ː
かと	k a̠ t o̞
かとう	k a̠ t o̞ː
かとうせい	k a̠ t o̞ː s e̞ː
かど	k a̠ d o̞
かな	k a̠ n a̠
かない	k a̠ n a̠ i
かなう	k a̠ n a̠ ɯ̟ᵝ
かなえる	k a̠ n a̠ e̞ ɾ ɯ̟ᵝ
かながわ	k a̠ n a̠ ɡ a̠ ɰᵝ a̠
かなざわ	k a̠ n a̠ z a̠ ɰᵝ a̠
かなしい	k a̠ n a̠ ɕ i i
かなしみ	k a̠ n a̠ ɕ i mʲ i
かなつんぼ	k a̠ n a̠ t͡s ɨ̃ᵝ m b o̞
かなづかい	k a̠ n a̠ z ɨᵝ k a̠ i
かなぶみ	k a̠ n a̠ b ɯ̟ᵝ mʲ i
かなまじりぶん	k a̠ n a̠ m a̠ ʑ i ɾʲ i b ɯ̟̃ᵝ ɴ
かならず	k a̠ n a̠ ɾ a̠ z ɨᵝ
かなり	k a̠ n a̠ ɾʲ i
かに	k a̠ ɲ̟ i
かにゅう	k a̠ ɲ̟ ɯ̟ᵝː
かね	k a̠ n e̞
かねまわり	k a̠ n e̞ m a̠ ɰᵝ a̠ ɾʲ i
かの	k a̠ n o̞
かのう	k a̠ n o̞ː
かのうどうし	k a̠ n o̞ː d o̞ː ɕ i
かのうば	k a̠ n o̞ ɯ̟ᵝ b a̠
かのうほう	k a̠ n o̞ː h o̞ː
かはん	k a̠ h ã̠ ɴ
かばう	k a̠ b a̠ ɯ̟ᵝ
かばん	k a̠ b ã̠ ɴ
かひ	k a̠ ç i
かふ	k a̠ ɸ ɯ̟ᵝ
かふか	k a̠ ɸ ɯ̟ᵝ k a̠
かぶ	k a̠ b ɯ̟ᵝ
かぶさる	k a̠ b ɯ̟ᵝ s a̠ ɾ ɯ̟ᵝ
かぶしきがいしゃ	k a̠ b ɯ̟ᵝ ɕ i̥ kʲ i ɡ a̠ i ɕ a̠
かぶとあわせ	k a̠ b ɯ̟ᵝ t o̞ a̠ ɰᵝ a̠ s e̞
かぶとがに	k a̠ b ɯ̟ᵝ t o̞ ɡ a̠ ɲ̟ i
かぶとむし	k a̠ b ɯ̟ᵝ t o̞ m ɯ̟ᵝ ɕ i
かぶぬし	k a̠ b ɯ̟ᵝ n ɯ̟ᵝ ɕ i
かぶれ	k a̠ b ɯ̟ᵝ ɾ e̞
かぶれる	k a̠ b ɯ̟ᵝ ɾ e̞ ɾ ɯ̟ᵝ
かへい	k a̠ h e̞ː
かべがみ	k a̠ b e̞ ɡ a̠ mʲ i
かま	k a̠ m a̠
かまう	k a̠ m a̠ ɯ̟ᵝ
かまきり	k a̠ m a̠ kʲ i ɾʲ i
かまくら	k a̠ m a̠ k ɯ̟ᵝ ɾ a̠
かまびすしい	k a̠ m a̠ bʲ i s ɨᵝ ɕ i i
かまぼこ	k a̠ m a̠ b o̞ k o̞
かみ	k a̠ mʲ i
かみあう	k a̠ mʲ i a̠ ɯ̟ᵝ
かみあわせる	k a̠ mʲ i a̠ ɰᵝ a̠ s e̞ ɾ ɯ̟ᵝ
かみがた	k a̠ mʲ i ɡ a̠ t a̠
かみこなす	k a̠ mʲ i k o̞ n a̠ s ɨᵝ
かみころす	k a̠ mʲ i k o̞ ɾ o̞ s ɨᵝ
かみさま	k a̠ mʲ i s a̠ m a̠
かみしばい	k a̠ mʲ i ɕ i b a̠ i
かみしめる	k a̠ mʲ i ɕ i m e̞ ɾ ɯ̟ᵝ
かみだな	k a̠ mʲ i d a̠ n a̠
かみなり	k a̠ mʲ i n a̠ ɾʲ i
かみにだんかつよう	k a̠ mʲ i ɲ̟ i d ã̠ ŋ k a̠ t͡s ɨᵝ j o̞ː
かみのけざ	k a̠ mʲ i n o̞ k e̞ z a̠
かみひこうき	k a̠ mʲ i ç i̥ k o̞ː kʲ i
かみまき	k a̠ mʲ i m a̠ kʲ i
かみやすり	k a̠ mʲ i j a̠ s ɨᵝ ɾʲ i
かむ	k a̠ m ɯ̟ᵝ
かめ	k a̠ m e̞
かも	k a̠ m o̞
かもく	k a̠ m o̞ k ɯ̟ᵝ
かもしか	k a̠ m o̞ ɕ i̥ k a̠
かもしだす	k a̠ m o̞ ɕ i d a̠ s ɨᵝ
かもつれっしゃ	k a̠ m o̞ t͡s ɨᵝ ɾ e̞ ɕː a̠
かもめ	k a̠ m o̞ m e̞
かやきん	k a̠ j a̠ kʲ ĩ ɴ
かやく	k a̠ j a̠ k ɯ̟ᵝ
かゆ	k a̠ j ɯ̟ᵝ
かよわい	k a̠ j o̞ ɰᵝ a̠ i
から	k a̠ ɾ a̠
からあげ	k a̠ ɾ a̠ː ɡ e̞
からい	k a̠ ɾ a̠ i
からかう	k a̠ ɾ a̠ k a̠ ɯ̟ᵝ
からくだもの	k a̠ ɾ a̠ k ɯ̟ᵝ d a̠ m o̞ n o̞
からす	k a̠ ɾ a̠ s ɨᵝ
からすとんび	k a̠ ɾ a̠ s ɨ̥ᵝ t õ̞ m bʲ i
からだ	k a̠ ɾ a̠ d a̠
からだき	k a̠ ɾ a̠ d a̠ kʲ i
からぼり	k a̠ ɾ a̠ b o̞ ɾʲ i
からみつく	k a̠ ɾ a̠ mʲ i t͡s ɨᵝ k ɯ̟ᵝ
からむ	k a̠ ɾ a̠ m ɯ̟ᵝ
からもの	k a̠ ɾ a̠ m o̞ n o̞
かり	k a̠ ɾʲ i
かりうた	k a̠ ɾʲ i ɯ̟ᵝ t a̠
かりしゃくほう	k a̠ ɾʲ i ɕ a̠ k ɯ̟̊ᵝ h o̞ː
かりそめ	k a̠ ɾʲ i s o̞ m e̞
かりちん	k a̠ ɾʲ i t͡ɕ ĩ ɴ
かりとる	k a̠ ɾʲ i t o̞ ɾ ɯ̟ᵝ
かりな	k a̠ ɾʲ i n a̠
かりも	k a̠ ɾʲ i m o̞
かる	k a̠ ɾ ɯ̟ᵝ
かるい	k a̠ ɾ ɯ̟ᵝ i
かるさん	k a̠ ɾ ɯ̟ᵝ s ã̠ ɴ
かれつ	k a̠ ɾ e̞ t͡s ɨᵝ
かれは	k a̠ ɾ e̞ h a̠
かれる	k a̠ ɾ e̞ ɾ ɯ̟ᵝ
かろう	k a̠ ɾ o̞ː
かわ	k a̠ ɰᵝ a̠
かわいい	k a̠ ɰᵝ a̠ i i
かわいそう	k a̠ ɰᵝ a̠ i s o̞ː
かわいらしい	k a̠ ɰᵝ a̠ i ɾ a̠ ɕ iː
かわく	k a̠ ɰᵝ a̠ k ɯ̟ᵝ
かわぐち	k a̠ ɰᵝ a̠ ɡ ɯ̟ᵝ t͡ɕ i
かわす	k a̠ ɰᵝ a̠ s ɨᵝ
かわら	k a̠ ɰᵝ a̠ ɾ a̠
かわらひわ	k a̠ ɰᵝ a̠ ɾ a̠ ç i ɰᵝ a̠
かわり	k a̠ ɰᵝ a̠ ɾʲ i
かわる	k a̠ ɰᵝ a̠ ɾ ɯ̟ᵝ
かんい	k ã̠ ɰ̃ i
かんいっぱつ	k ã̠ ɰ̃ i p̚ p a̠ t͡s ɨᵝ
かんいん	k ã̠ ɰ̃ ĩ ɴ
かんえん	k ã̠ ɰ̃ ẽ̞ ɴ
かんおん	k ã̠ ɰ̃ õ̞ ɴ
かんかじ	k ã̠ ŋ k a̠ ʑ i
かんかつ	k ã̠ ŋ k a̠ t͡s ɨᵝ
かんがい	k ã̠ ŋ ɡ a̠ i
かんがいむりょう	k ã̠ ŋ ɡ a̠ i m ɯ̟ᵝ ɾʲ o̞ː
かんがえる	k ã̠ ŋ ɡ a̠ e̞ ɾ ɯ̟ᵝ
かんき	k ã̠ ŋʲ kʲ i
かんきこう	k ã̠ ŋʲ kʲ i k o̞ː
かんけ	k ã̠ ŋ k e̞
かんけいどうぶつ	k ã̠ ŋ k e̞ː d o̞ː b ɯ̟ᵝ t͡s ɨᵝ
かんけつせん	k ã̠ ŋ k e̞ t͡s ɨ̥ᵝ s ẽ̞ ɴ
かんげい	k ã̠ ŋ ɡ e̞ː
かんこう	k ã̠ ŋ k o̞ː
かんこく	k ã̠ ŋ k o̞ k ɯ̟ᵝ
かんこどり	k ã̠ ŋ k o̞ d o̞ ɾʲ i
かんこれ	k ã̠ ŋ k o̞ ɾ e̞
かんこんそうさい	k ã̠ ŋ k õ̞ ɰ̃ s o̞ː s a̠ i
かんごし	k ã̠ ŋ ɡ o̞ ɕ i
かんごふ	k ã̠ ŋ ɡ o̞ ɸ ɯ̟ᵝ
かんさいじん	k ã̠ ɰ̃ s a̠ i ʑ ĩ ɴ
かんさいぼう	k ã̠ ɰ̃ s a̠ i b o̞ː
かんさつ	k ã̠ ɰ̃ s a̠ t͡s ɨᵝ
かんし	k ã̠ ɰ̃ ɕ i
かんしつけい	k ã̠ ɰ̃ ɕ i t͡s ɨᵝ k e̞ː
かんしょ	k ã̠ ɰ̃ ɕ o̞
かんしょく	k ã̠ ɰ̃ ɕ o̞ k ɯ̟ᵝ
かんじ	k ã̠ ɲ̟ d͡ʑ i
かんじゅ	k ã̠ ɲ̟ d͡ʑ ɨᵝ
かんじゅく	k ã̠ ɲ̟ d͡ʑ ɨᵝ k ɯ̟ᵝ
かんじょうてき	k ã̠ ɲ̟ d͡ʑ o̞ː t e̞ kʲ i
かんすう	k ã̠ ɰ̃ s ɨᵝː
かんする	k ã̠ ɰ̃ s ɨᵝ ɾ ɯ̟ᵝ
かんせいけい	k ã̠ ɰ̃ s e̞ː k e̞ː
かんせつしょうめい	k ã̠ ɰ̃ s e̞ t͡s ɨᵝ ɕ o̞ː m e̞ː
かんせつわほう	k ã̠ ɰ̃ s e̞ t͡s ɨᵝ ɰᵝ a̠ h o̞ː
かんせん	k ã̠ ɰ̃ s ẽ̞ ɴ
かんせんげん	k ã̠ ɰ̃ s ẽ̞ ŋ ɡ ẽ̞ ɴ
かんせんしょう	k ã̠ ɰ̃ s ẽ̞ ɰ̃ ɕ o̞ː
かんぜん	k ã̠ n d͡z ẽ̞ ɴ
かんそうき	k ã̠ ɰ̃ s o̞ː kʲ i
かんたく	k ã̠ n t a̠ k ɯ̟ᵝ
かんたん	k ã̠ n t ã̠ ɴ
かんちょう	k ã̠ ɲ̟ t͡ɕ o̞ː
かんてい	k ã̠ n t e̞ː
かんてん	k ã̠ n t ẽ̞ ɴ
かんとく	k ã̠ n t o̞ k ɯ̟ᵝ
かんな	k ã̠ nː a̠
かんなぎ	k ã̠ nː a̠ ɡʲ i
かんなん	k ã̠ nː ã̠ ɴ
かんばん	k ã̠ m b ã̠ ɴ
かんばんむすめ	k ã̠ m b ã̠ m m ɯ̟ᵝ s ɨᵝ m e̞
かんぱい	k ã̠ m p a̠ i
かんび	k ã̠ m bʲ i
かんぶ	k ã̠ m b ɯ̟ᵝ
かんぶつ	k ã̠ m b ɯ̟ᵝ t͡s ɨᵝ
かんぷく	k ã̠ m p ɯ̟ᵝ k ɯ̟ᵝ
かんぺき	k ã̠ m p e̞ kʲ i
かんぼつ	k ã̠ m b o̞ t͡s ɨᵝ
かんぽ	k ã̠ m p o̞
かんぽどうぶつ	k ã̠ m p o̞ d o̞ː b ɯ̟ᵝ t͡s ɨᵝ
かんみりょう	k ã̠ mʲː i ɾʲ o̞ː
かんむりょう	k ã̠ mː ɯ̟ᵝ ɾʲ o̞ː
かんむりわし	k ã̠ mː ɯ̟ᵝ ɾʲ i ɰᵝ a̠ ɕ i
かんゆう	k ã̠ ɰ̃ j ɯ̟ᵝː
かんようご	k ã̠ ɰ̃ j o̞ː ɡ o̞
かんらん	k ã̠ n ɾ ã̠ ɴ
かんりょう	k ã̠ n ɾʲ o̞ː
かんりょうせい	k ã̠ n ɾʲ o̞ː s e̞ː
かんれいしゃ	k ã̠ n ɾ e̞ː ɕ a̠
かんれき	k ã̠ n ɾ e̞ kʲ i
かんろ	k ã̠ n ɾ o̞
か゚	ŋ a̠
がいか	ɡ a̠ i k a̠
がいこうかん	ɡ a̠ i k o̞ː k ã̠ ɴ
がいこうじれい	ɡ a̠ i k o̞ː ʑ i ɾ e̞ː
がいこく	ɡ a̠ i k o̞ k ɯ̟ᵝ
がいこくご	ɡ a̠ i k o̞ k ɯ̟ᵝ ɡ o̞
がいこくじん	ɡ a̠ i k o̞ k ɯ̟ᵝ ʑ ĩ ɴ
がいこくじんけんお	ɡ a̠ i k o̞ k ɯ̟ᵝ ʑ ĩ ŋ k ẽ̞ ɰ̃ o̞
がいこつ	ɡ a̠ i k o̞ t͡s ɨᵝ
がいご	ɡ a̠ i ɡ o̞
がいじん	ɡ a̠ i ʑ ĩ ɴ
がいする	ɡ a̠ i s ɨᵝ ɾ ɯ̟ᵝ
がいせん	ɡ a̠ i s ẽ̞ ɴ
がいちょう	ɡ a̠ i t͡ɕ o̞ː
がいでん	ɡ a̠ i d ẽ̞ ɴ
がいはく	ɡ a̠ i h a̠ k ɯ̟ᵝ
がいむしょう	ɡ a̠ i m ɯ̟ᵝ ɕ o̞ː
がいや	ɡ a̠ i j a̠
がいよう	ɡ a̠ i j o̞ː
がいようらん	ɡ a̠ i j o̞ː ɾ ã̠ ɴ
がいらいご	ɡ a̠ i ɾ a̠ i ɡ o̞
がいりゃく	ɡ a̠ i ɾʲ a̠ k ɯ̟ᵝ
がか	ɡ a̠ k a̠
がかざ	ɡ a̠ k a̠ z a̠
がき	ɡ a̠ kʲ i
がくい	ɡ a̠ k ɯ̟ᵝ i
がくいん	ɡ a̠ k ɯ̟ᵝ ĩ ɴ
がくがく	ɡ a̠ k ɯ̟ᵝ ɡ a̠ k ɯ̟ᵝ
がくし	ɡ a̠ k ɯ̟̊ᵝ ɕ i
がくしゃ	ɡ a̠ k ɯ̟ᵝ ɕ a̠
がくしょう	ɡ a̠ k ɯ̟ᵝ ɕ o̞ː
がくぜん	ɡ a̠ k ɯ̟ᵝ z ẽ̞ ɴ
がくと	ɡ a̠ k ɯ̟ᵝ t o̞
がくひ	ɡ a̠ k ɯ̟ᵝ ç i
がくふ	ɡ a̠ k ɯ̟ᵝ ɸ ɯ̟ᵝ
がくぶち	ɡ a̠ k ɯ̟ᵝ b ɯ̟ᵝ t͡ɕ i
がごう	ɡ a̠ ɡ o̞ː
がさつ	ɡ a̠ s a̠ t͡s ɨᵝ
がし	ɡ a̠ ɕ i
がぜん	ɡ a̠ z ẽ̞ ɴ
がそ	ɡ a̠ s o̞
がたおち	ɡ a̠ t a̠ o̞ t͡ɕ i
がちょう	ɡ a̠ t͡ɕ o̞ː
がっか	ɡ a̠ k̚ k a̠
がっきょく	ɡ a̠ k̚ʲ kʲ o̞ k ɯ̟ᵝ
がっこ	ɡ a̠ k̚ k o̞
がってん	ɡ a̠ t̚ t ẽ̞ ɴ
がってんし	ɡ a̠ t̚ t ẽ̞ ɰ̃ ɕ i
がっぴ	ɡ a̠ p̚ʲ pʲ i
がにまた	ɡ a̠ ɲ̟ i m a̠ t a̠
がま	ɡ a̠ m a̠
がまんづよい	ɡ a̠ m ã̠ n d͡z ɨᵝ j o̞ i
がらん	ɡ a̠ ɾ ã̠ ɴ
がらんび	ɡ a̠ ɾ ã̠ m bʲ i
がりべん	ɡ a̠ ɾʲ i b ẽ̞ ɴ
がりょう	ɡ a̠ ɾʲ o̞ː
がれき	ɡ a̠ ɾ e̞ kʲ i
がろう	ɡ a̠ ɾ o̞ː
がわ	ɡ a̠ ɰᵝ a̠
がん	ɡ ã̠ ɴ
がんがれ	ɡ ã̠ ŋ ɡ a̠ ɾ e̞
がんきゅう	ɡ ã̠ ŋʲ kʲ ɨᵝː
がんきょう	ɡ ã̠ ŋʲ kʲ o̞ː
がんこう	ɡ ã̠ ŋ k o̞ː
がんしゃ	ɡ ã̠ ɰ̃ ɕ a̠
がんせき	ɡ ã̠ ɰ̃ s e̞ kʲ i
がんたん	ɡ ã̠ n t ã̠ ɴ
がんねん	ɡ ã̠ nː ẽ̞ ɴ
がんばれ	ɡ ã̠ m b a̠ ɾ e̞
がんもどき	ɡ ã̠ mː o̞ d o̞ kʲ i
がんやく	ɡ ã̠ ɰ̃ j a̠ k ɯ̟ᵝ
がんゆう	ɡ ã̠ ɰ̃ j ɯ̟ᵝː
がんりょう	ɡ ã̠ n ɾʲ o̞ː
きあんこう	kʲ i ã̠ ŋ k o̞ː
きい	kʲ iː
きいろ	kʲ i i ɾ o̞
きぇ	kʲ e̞
きえ	kʲ i e̞
きえさる	kʲ i e̞ s a̠ ɾ ɯ̟ᵝ
きえはてる	kʲ i e̞ h a̠ t e̞ ɾ ɯ̟ᵝ
きえる	kʲ i e̞ ɾ ɯ̟ᵝ
きえん	kʲ i ẽ̞ ɴ
きか	kʲ i k a̠
きかいせい	kʲ i k a̠ i s e̞ː
きかいせいたい	kʲ i k a̠ i s e̞ː t a̠ i
きかえる	kʲ i̥ k a̠ e̞ ɾ ɯ̟ᵝ
きかがく	kʲ i̥ k a̠ ɡ a̠ k ɯ̟ᵝ
きかく	kʲ i k a̠ k ɯ̟ᵝ
きかくか	kʲ i k a̠ k ɯ̟ᵝ k a̠
きかこうがく	kʲ i k a̠ k o̞ː ɡ a̠ k ɯ̟ᵝ
きかしょくぶつ	kʲ i k a̠ ɕ o̞ k ɯ̟ᵝ b ɯ̟ᵝ t͡s ɨᵝ
きかんしゃ	kʲ i k ã̠ ɰ̃ ɕ a̠
きが	kʲ i ɡ a̠
きがくるう	kʲ i ɡ a̠ k ɯ̟ᵝ ɾ ɯ̟ᵝː
きがじゅくする	kʲ i ɡ a̠ d͡ʑ ɨᵝ k ɯ̟ᵝ s ɨᵝ ɾ ɯ̟ᵝ
きがね	kʲ i ɡ a̠ n e̞
きがる	kʲ i ɡ a̠ ɾ ɯ̟ᵝ
きき	kʲ i kʲ i
ききいっぱつ	kʲ i kʲ iː p̚ p a̠ t͡s ɨᵝ
ききいる	kʲ i kʲ iː ɾ ɯ̟ᵝ
ききおとす	kʲ i kʲ i n o̞ ɡ a̠ s ɨᵝ
ききかんり	kʲ i kʲ i k ã̠ n ɾʲ i
ききながす	kʲ i kʲ i n a̠ ɡ a̠ s ɨᵝ
ききはずす	kʲ i kʲ i h a̠ z ɨᵝ s ɨᵝ
きぎょうか	kʲ i ɡʲ o̞ː k a̠
きくきん	kʲ i k ɯ̟ᵝ kʲ ĩ ɴ
きくのせっく	kʲ i k ɯ̟ᵝ n o̞ s e̞ k̚ k ɯ̟ᵝ
きくらげ	kʲ i k ɯ̟ᵝ ɾ a̠ ɡ e̞
きくん	kʲ i k ɯ̟̃ᵝ ɴ
きぐう	kʲ i ɡ ɯ̟ᵝː
きこくしじょ	kʲ i k o̞ k ɯ̟ᵝ ɕ i ʑ o̞
きこなす	kʲ i k o̞ n a̠ s ɨᵝ
きこり	kʲ i k o̞ ɾʲ i
きこん	kʲ i k õ̞ ɴ
きごう	kʲ i ɡ o̞ː
きごうがく	kʲ i ɡ o̞ː ɡ a̠ k ɯ̟ᵝ
きさらぎ	kʲ i̥ s a̠ ɾ a̠ ɡʲ i
きざ	kʲ i z a̠
きざし	kʲ i z a̠ ɕ i
きざむ	kʲ i z a̠ m ɯ̟ᵝ
きし	kʲ i ɕ i
きしなみ	kʲ i ɕ i n a̠ mʲ i
きしべ	kʲ i ɕ i b e̞
きしむ	kʲ i ɕ i m ɯ̟ᵝ
きじゅつ	kʲ i ʑ ɨᵝ t͡s ɨᵝ
きじゅん	kʲ i ʑ ɨ̃ᵝ ɴ
きじょ	kʲ i ʑ o̞
きじん	kʲ i ʑ ĩ ɴ
きす	kʲ i s ɨᵝ
きすう	kʲ i s ɨᵝː
きず	kʲ i z ɨᵝ
きずあと	kʲ i z ɨᵝ a̠ t o̞
きずきあげる	kʲ i z ɨᵝ kʲ i a̠ ɡ e̞ ɾ ɯ̟ᵝ
きずく	kʲ i z ɨᵝ k ɯ̟ᵝ
きずつく	kʲ i z ɨᵝ t͡s ɨᵝ k ɯ̟ᵝ
きずつける	kʲ i z ɨᵝ t͡s ɨᵝ k e̞ ɾ ɯ̟ᵝ
きせいちゅう	kʲ i s e̞ː t͡ɕ ɨᵝː
きせきてき	kʲ i s e̞ kʲ i t e̞ kʲ i
きせつ	kʲ i s e̞ t͡s ɨᵝ
きそく	kʲ i s o̞ k ɯ̟ᵝ
きそくてき	kʲ i s o̞ k ɯ̟ᵝ t e̞ kʲ i
きそん	kʲ i s õ̞ ɴ
きたいはずれ	kʲ i t a̠ i h a̠ z ɨᵝ ɾ e̞
きたえる	kʲ i t a̠ e̞ ɾ ɯ̟ᵝ
きたかいきせん	kʲ i̥ t a̠ k a̠ i kʲ i̥ s ẽ̞ ɴ
きたこれ	kʲ i t a̠ k o̞ ɾ e̞
きたす	kʲ i t a̠ s ɨᵝ
きたない	kʲ i̥ t a̠ n a̠ i
きたないばくだん	kʲ i t a̠ n a̠ i b a̠ k ɯ̟ᵝ d ã̠ ɴ
きだい	kʲ i d a̠ i
きだて	kʲ i d a̠ t e̞
きちょうめん	kʲ i̥ t͡ɕ o̞ː m ẽ̞ ɴ
きっさてん	kʲ i sː a̠ t ẽ̞ ɴ
きっと	kʲ i̥ t̚ t o̞
きつい	kʲ i̥ t͡s ɨᵝ i
きつつき	kʲ i̥ t͡s ɨᵝ t͡s ɨ̥ᵝ kʲ i
きつね	kʲ i̥ t͡s ɨᵝ n e̞
きつねあざみ	ɡ a̠
きづかわしい	kʲ i z ɨᵝ k a̠ ɰᵝ a̠ ɕ i i
きと	kʲ i t o̞
きどあいらく	kʲ i d o̞ a̠ i ɾ a̠ k ɯ̟ᵝ
きどう	kʲ i d o̞ː
きなこ	kʲ i n a̠ k o̞
きにする	kʲ i ɲ̟ i s ɨᵝ ɾ ɯ̟ᵝ
きにち	kʲ i ɲ̟ i t͡ɕ i
きぬいと	kʲ i n ɯ̟ᵝ i t o̞
きぬのみち	kʲ i n ɯ̟ᵝ n o̞ mʲ i t͡ɕ i
きね	kʲ i n e̞
きねんひん	kʲ i n ẽ̞ ɰ̃ ç ĩ ɴ
きのう	kʲ i n o̞ː
きのこ	kʲ i n o̞ k o̞
きはつせい	kʲ i h a̠ t͡s ɨᵝ s e̞ː
きはつゆ	kʲ i̥ h a̠ t͡s ɨᵝ j ɯ̟ᵝ
きはんじ	kʲ i h ã̠ ɲ̟ d͡ʑ i
きば	kʲ i b a̠
きびしい	kʲ i bʲ i ɕ i i
きほう	kʲ i h o̞ː
きぼう	kʲ i b o̞ː
きまぐれ	kʲ i m a̠ ɡ ɯ̟ᵝ ɾ e̞
きまじめ	kʲ i m a̠ ʑ i m e̞
きまま	kʲ i m a̠ m a̠
きまり	kʲ i m a̠ ɾʲ i
きまりじ	kʲ i m a̠ ɾʲ i ʑ i
きまる	kʲ i m a̠ ɾ ɯ̟ᵝ
きみ	kʲ i mʲ i
きみょうきてれつ	kʲ i mʲ o̞ː kʲ i t e̞ ɾ e̞ t͡s ɨᵝ
きも	k ã̠ ɴ
きもの	kʲ i m o̞ n o̞
きゃ	kʲ a̠
きゃくしょく	kʲ a̠ k ɯ̟ᵝ ɕ o̞ k ɯ̟ᵝ
きゃくま	kʲ a̠ k ɯ̟ᵝ m a̠
きゃっか	kʲ a̠ k̚ k a̠
きゅう	kʲ ɨᵝː
きゅうきん	kʲ ɨᵝː kʲ ĩ ɴ
きゅうけい	kʲ ɨᵝː k e̞ː
きゅうけつき	kʲ ɨᵝː k e̞ t͡s ɨ̥ᵝ kʲ i
きゅうげき	kʲ ɨᵝː ɡ e̞ kʲ i
きゅうげん	kʲ ɨᵝː ɡ ẽ̞ ɴ
きゅうご	kʲ ɨᵝː ɡ o̞
きゅうごう	kʲ ɨᵝː ɡ o̞ː
きゅうしき	kʲ ɨᵝː ɕ i kʲ i
きゅうしふ	kʲ ɨᵝː ɕ i ɸ ɯ̟ᵝ
きゅうしょう	kʲ ɨᵝː ɕ o̞ː
きゅうしんしゅぎ	kʲ ɨᵝː ɕ ĩ ɰ̃ ɕ ɨᵝ ɡʲ i
きゅうじ	kʲ ɨᵝː ʑ i
きゅうすい	kʲ ɨᵝː s ɨᵝ i
きゅうせいしゅ	kʲ ɨᵝː s e̞ː ɕ ɨᵝ
きゅうせかいざる	kʲ ɨᵝː s e̞ k a̠ i z a̠ ɾ ɯ̟ᵝ
きゅうそう	kʲ ɨᵝː s o̞ː
きゅうねん	kʲ ɨᵝː n ẽ̞ ɴ
きゅうのう	kʲ ɨᵝː n o̞ː
きゅうひ	kʲ ɨᵝː ç i
きゅうへい	kʲ ɨᵝː h e̞ː
きゅうぼ	kʲ ɨᵝː b o̞
きゅうよ	kʲ ɨᵝː j o̞
きゅうり	kʲ ɨᵝː ɾʲ i
きょう	kʲ o̞ː
きょういくがく	kʲ o̞ː i k ɯ̟ᵝ ɡ a̠ k ɯ̟ᵝ
きょうえいもじ	kʲ o̞ː e̞ː m o̞ ʑ i
きょうえん	kʲ o̞ː ẽ̞ ɴ
きょうかすいげつ	kʲ o̞ː k a̠ s ɨᵝ i ɡ e̞ t͡s ɨᵝ
きょうぎかい	kʲ o̞ː ɡʲ i k a̠ i
きょうぎじょう	kʲ o̞ː ɡʲ i ʑ o̞ː
きょうくん	kʲ o̞ː k ɯ̟̃ᵝ ɴ
きょうけん	kʲ o̞ː k ẽ̞ ɴ
きょうごうじょうたい	kʲ o̞ː ɡ o̞ː d͡ʑ o̞ː t a̠ i
きょうさいくみあい	kʲ o̞ː s a̠ i k ɯ̟ᵝ mʲ i a̠ i
きょうさんしゅぎ	kʲ o̞ː s ã̠ ɰ̃ ɕ ɨᵝ ɡʲ i
きょうさんしゅぎしゃ	kʲ o̞ː s ã̠ ɰ̃ ɕ ɨᵝ ɡʲ i ɕ a̠
きょうしゃ	kʲ o̞ː ɕ a̠
きょうしょう	kʲ o̞ː ɕ o̞ː
きょうじ	kʲ o̞ː ʑ i
きょうじゅ	kʲ o̞ː ʑ ɨᵝ
きょうじょう	kʲ o̞ː ʑ o̞ː
きょうじん	kʲ o̞ː ʑ ĩ ɴ
きょうせいしゅうようじょ	kʲ o̞ː s e̞ː ɕ ɨᵝː j o̞ː ʑ o̞
きょうせいろうどうしょう	kʲ o̞ː s e̞ː ɾ o̞ː d o̞ː ɕ o̞ː
きょうそう	kʲ o̞ː s o̞ː
きょうそうきょく	kʲ o̞ː s o̞ː kʲ o̞ k ɯ̟ᵝ
きょうだい	kʲ o̞ː d a̠ i
きょうちょう	kʲ o̞ː t͡ɕ o̞ː
きょうちょくせいせきついえん	kʲ o̞ː t͡ɕ o̞ k ɯ̟ᵝ s e̞ː s e̞ kʲ i t͡s ɨᵝ i ẽ̞ ɴ
きょうつうしゅうごう	kʲ o̞ː t͡s ɨᵝː ɕ ɨᵝː ɡ o̞ː
きょうてん	kʲ o̞ː t ẽ̞ ɴ
きょうと	kʲ o̞ː t o̞
きょうどう	kʲ o̞ː d o̞ː
きょうどうしゅっし	kʲ o̞ː d o̞ː ɕ ɨᵝ ɕː i
きょうどうたい	kʲ o̞ː d o̞ː t a̠ i
きょうにん	kʲ o̞ː ɲ̟ ĩ ɴ
きょうねん	kʲ o̞ː n ẽ̞ ɴ
きょうはんしゃ	kʲ o̞ː h ã̠ ɰ̃ ɕ a̠
きょうふしょう	kʲ o̞ː ɸ ɯ̟ᵝ ɕ o̞ː
きょうほう	kʲ o̞ː h o̞ː
きょうぼう	kʲ o̞ː b o̞ː
きょうむ	kʲ o̞ː m ɯ̟ᵝ
きょうよう	kʲ o̞ː j o̞ː
きょうらく	kʲ o̞ː ɾ a̠ k ɯ̟ᵝ
きょうりょく	kʲ o̞ː ɾʲ o̞ k ɯ̟ᵝ
きょか	kʲ o̞ k a̠
きょきん	kʲ o̞ kʲ ĩ ɴ
きょく	kʲ o̞ k ɯ̟ᵝ
きょくあじさし	kʲ o̞ k ɯ̟ᵝ a̠ ʑ i s a̠ ɕ i
きょくげん	kʲ o̞ k ɯ̟ᵝ ɡ ẽ̞ ɴ
きょくとう	kʲ o̞ k ɯ̟̊ᵝ t o̞ː
きょこん	kʲ o̞ k õ̞ ɴ
きょしゅつ	kʲ o̞ ɕ ɨᵝ t͡s ɨᵝ
きょしゅつきん	kʲ o̞ ɕ ɨᵝ t͡s ɨᵝ kʲ ĩ ɴ
きょしょく	kʲ o̞ ɕ o̞ k ɯ̟ᵝ
きょじゅうしゃ	kʲ o̞ ʑ ɨᵝː ɕ a̠
きょせい	kʲ o̞ s e̞ː
きょぜつ	kʲ o̞ z e̞ t͡s ɨᵝ
きょたんやく	kʲ o̞ t ã̠ ɰ̃ j a̠ k ɯ̟ᵝ
きょだく	kʲ o̞ d a̠ k ɯ̟ᵝ
きょっこう	kʲ o̞ k̚ k o̞ː
きょてん	kʲ o̞ t ẽ̞ ɴ
きょとう	kʲ o̞ t o̞ː
きょにゅう	kʲ o̞ ɲ̟ ɯ̟ᵝː
きょはく	kʲ o̞ h a̠ k ɯ̟ᵝ
きょりきょうぎ	kʲ o̞ ɾʲ i kʲ o̞ː ɡʲ i
きょろきょろ	kʲ o̞ ɾ o̞ kʲ o̞ ɾ o̞
きよ	kʲ i j o̞
きよう	kʲ i j o̞ː
きよめる	kʲ i j o̞ m e̞ ɾ ɯ̟ᵝ
きら	kʲ i ɾ a̠
きらう	kʲ i ɾ a̠ ɯ̟ᵝ
きらきら	kʲ i ɾ a̠ kʲ i ɾ a̠
きらめく	kʲ i ɾ a̠ m e̞ k ɯ̟ᵝ
きり	kʲ i ɾʲ i
きりがみ	kʲ i ɾʲ i ɡ a̠ mʲ i
きりがやつ	kʲ i ɾʲ i ɡ a̠ j a̠ t͡s ɨᵝ
きりぎりす	kʲ i ɾʲ i ɡʲ i ɾʲ i s ɨᵝ
きりさく	kʲ i ɾʲ i s a̠ k ɯ̟ᵝ
きりつせい	kʲ i ɾʲ i t͡s ɨᵝ s e̞ː
きりつせいていけつあつ	kʲ i ɾʲ i t͡s ɨᵝ s e̞ː t e̞ː k e̞ t͡s ɨᵝ a̠ t͡s ɨᵝ
きりとる	kʲ i ɾʲ i t o̞ ɾ ɯ̟ᵝ
きりは	kʲ i ɾʲ i h a̠
きりひらく	kʲ i ɾʲ i ç i ɾ a̠ k ɯ̟ᵝ
きりふだ	kʲ i ɾʲ i ɸ ɯ̟ᵝ d a̠
きりょく	kʲ i ɾʲ o̞ k ɯ̟ᵝ
きりん	kʲ i ɾʲ ĩ ɴ
きりんざ	kʲ i ɾʲ ĩ n d͡z a̠
きりんじ	kʲ i ɾʲ ĩ ɲ̟ d͡ʑ i
きれい	kʲ i ɾ e̞ː
きれて	kʲ i ɾ e̞ t e̞
きれる	kʲ i ɾ e̞ ɾ ɯ̟ᵝ
きろう	kʲ i ɾ o̞ː
きわみ	kʲ i ɰᵝ a̠ mʲ i
きをとりなおす	kʲ i o̞ t o̞ ɾʲ i n a̠ o̞ s ɨᵝ
きん	kʲ ĩ ɴ
きんいしゅくせいそくさくこうかしょう	kʲ ĩ ɰ̃ i ɕ ɨᵝ k ɯ̟ᵝ s e̞ː s o̞ k ɯ̟ᵝ s a̠ k ɯ̟ᵝ k o̞ː k a̠ ɕ o̞ː
きんいろ	kʲ ĩ ɰ̃ i ɾ o̞
きんかんがっき	kʲ ĩ ŋ k ã̠ ŋ ɡ a̠ k̚ʲ kʲ i
きんがん	kʲ ĩ ŋ ɡ ã̠ ɴ
きんきゅう	kʲ ĩ ŋʲ kʲ ɨᵝː
きんぎょばち	kʲ ĩ ŋʲ ɡʲ o̞ b a̠ t͡ɕ i
きんけり	kʲ ĩ ŋ k e̞ ɾʲ i
きんけんせいじ	kʲ ĩ ŋ k ẽ̞ ɰ̃ s e̞ː ʑ i
きんこ	kʲ ĩ ŋ k o̞
きんし	kʲ ĩ ɰ̃ ɕ i
きんしゅく	kʲ ĩ ɰ̃ ɕ ɨᵝ k ɯ̟ᵝ
きんしんそうかん	kʲ ĩ ɰ̃ ɕ ĩ ɰ̃ s o̞ː k ã̠ ɴ
きんじ	kʲ ĩ ɲ̟ d͡ʑ i
きんじつ	kʲ ĩ ɲ̟ d͡ʑ i t͡s ɨᵝ
きんじょうてっぺき	kʲ ĩ ɲ̟ d͡ʑ o̞ː t e̞ p̚ p e̞ kʲ i
きんせつ	kʲ ĩ ɰ̃ s e̞ t͡s ɨᵝ
きんだい	kʲ ĩ n d a̠ i
きんだん	kʲ ĩ n d ã̠ ɴ
きんちゃく	kʲ ĩ ɲ̟ t͡ɕ a̠ k ɯ̟ᵝ
きんちょう	kʲ ĩ ɲ̟ t͡ɕ o̞ː
きんて	kʲ ĩ n t e̞
きんてき	kʲ ĩ n t e̞ kʲ i
きんにく	kʲ ĩ ɲ̟ ɲ̟ i k ɯ̟ᵝ
きんぼう	kʲ ĩ m b o̞ː
きんよう	kʲ ĩ ɰ̃ j o̞ː
きんよく	kʲ ĩ ɰ̃ j o̞ k ɯ̟ᵝ
きんらん	kʲ ĩ n ɾ ã̠ ɴ
きんりょく	kʲ ĩ n ɾʲ o̞ k ɯ̟ᵝ
ぎいん	ɡʲ i ĩ ɴ
ぎおん	ɡʲ i õ̞ ɴ
ぎぐん	ɡʲ i ɡ ɯ̟̃ᵝ ɴ
ぎざ	ɡʲ i z a̠
ぎし	ɡʲ i ɕ i
ぎじ	ɡʲ i ʑ i
ぎじょう	ɡʲ i ʑ o̞ː
ぎじょうご	ɡʲ i ʑ o̞ː ɡ o̞
ぎせき	ɡʲ i s e̞ kʲ i
ぎぜんしゃ	ɡʲ i z ẽ̞ ɰ̃ ɕ a̠
ぎぞく	ɡʲ i z o̞ k ɯ̟ᵝ
ぎふ	ɡʲ i ɸ ɯ̟ᵝ
ぎふけん	ɡʲ i ɸ ɯ̟ᵝ k ẽ̞ ɴ
ぎむづける	ɡʲ i m ɯ̟ᵝ z ɨᵝ k e̞ ɾ ɯ̟ᵝ
ぎめい	ɡʲ i m e̞ː
ぎもんふ	ɡʲ i m õ̞ ɰ̃ ɸ ɯ̟ᵝ
ぎゃ	ɡʲ a̠
ぎゃく	ɡʲ a̠ k ɯ̟ᵝ
ぎゃくさつ	ɡʲ a̠ k ɯ̟ᵝ s a̠ t͡s ɨᵝ
ぎゃくばり	ɡʲ a̠ k ɯ̟ᵝ b a̠ ɾʲ i
ぎゃふ	ɡʲ a̠ ɸ ɯ̟ᵝ
ぎゃんなき	ɡʲ ã̠ nː a̠ kʲ i
ぎゅ	ɡʲ ɨᵝ
ぎゅうしゃ	ɡʲ ɨᵝː ɕ a̠
ぎゅうじる	ɡʲ ɨᵝː ʑ i ɾ ɯ̟ᵝ
ぎゅっと	ɡʲ ɨᵝ t̚ t o̞
ぎょ	ɡʲ o̞
ぎょうぎ	ɡʲ o̞ː ɡʲ i
ぎょうこう	ɡʲ o̞ː k o̞ː
ぎょうざ	ɡʲ o̞ː z a̠
ぎょうし	ɡʲ o̞ː ɕ i
ぎょうしゅう	ɡʲ o̞ː ɕ ɨᵝː
ぎょうしゅく	ɡʲ o̞ː ɕ ɨᵝ k ɯ̟ᵝ
ぎょがんせき	ɡʲ o̞ ɡ ã̠ ɰ̃ s e̞ kʲ i
ぎょくろ	ɡʲ o̞ k ɯ̟ᵝ ɾ o̞
ぎょぐん	ɡʲ o̞ ɡ ɯ̟̃ᵝ ɴ
ぎょたく	ɡʲ o̞ t a̠ k ɯ̟ᵝ
ぎょにく	ɡʲ o̞ ɲ̟ i k ɯ̟ᵝ
ぎょもう	ɡʲ o̞ m o̞ː
ぎょるいがく	ɡʲ o̞ ɾ ɯ̟ᵝ i ɡ a̠ k ɯ̟ᵝ
ぎりぎり	ɡʲ i ɾʲ i ɡʲ i ɾʲ i
ぎろん	ɡʲ i ɾ õ̞ ɴ
ぎん	ɡʲ ĩ ɴ
ぎんが	ɡʲ ĩ ŋ ɡ a̠
ぎんこう	ɡʲ ĩ ŋ k o̞ː
ぎんぽ	ɡʲ ĩ m p o̞
ぎんみ	ɡʲ ĩ mʲː i
くぁ	k ɰᵝ a̠
くいこむ	k ɯ̟ᵝ i k o̞ m ɯ̟ᵝ
くいころす	k ɯ̟ᵝ i k o̞ ɾ o̞ s ɨᵝ
くいさがる	k ɯ̟ᵝ i s a̠ ɡ a̠ ɾ ɯ̟ᵝ
くう	k ɯ̟ᵝː
くうきせいじょうき	k ɯ̟ᵝː kʲ i s e̞ː ʑ o̞ː kʲ i
くうきりきがく	k ɯ̟ᵝː kʲ i ɾʲ i kʲ i ɡ a̠ k ɯ̟ᵝ
くうげき	k ɯ̟ᵝː ɡ e̞ kʲ i
くうこう	k ɯ̟ᵝː k o̞ː
くうそくぜしき	k ɯ̟ᵝː s o̞ k ɯ̟ᵝ d͡z e̞ ɕ i kʲ i
くうちゅう	k ɯ̟ᵝː t͡ɕ ɨᵝː
くぇ	k ɰᵝ e̞
くき	k ɯ̟̊ᵝ kʲ i
くきちゃ	k ɯ̟ᵝ kʲ i t͡ɕ a̠
くきょう	k ɯ̟ᵝ kʲ o̞ː
くきわかめ	k ɯ̟ᵝ kʲ i ɰᵝ a̠ k a̠ m e̞
くぎ	k ɯ̟ᵝ ɡʲ i
くぎょう	k ɯ̟ᵝ ɡʲ o̞ː
くぎり	k ɯ̟ᵝ ɡʲ i ɾʲ i
くぎる	k ɯ̟ᵝ ɡʲ i ɾ ɯ̟ᵝ
くく	k ɯ̟̊ᵝ k ɯ̟ᵝ
くくる	k ɯ̟ᵝ k ɯ̟ᵝ ɾ ɯ̟ᵝ
くぐつ	k ɯ̟ᵝ ɡ ɯ̟ᵝ t͡s ɨᵝ
くぐりぬける	k ɯ̟ᵝ ɡ ɯ̟ᵝ ɾʲ i n ɯ̟ᵝ k e̞ ɾ ɯ̟ᵝ
くぐる	k ɯ̟ᵝ ɡ ɯ̟ᵝ ɾ ɯ̟ᵝ
くげ	k ɯ̟ᵝ ɡ e̞
くさ	k ɯ̟̊ᵝ s a̠
くさい	k ɯ̟̊ᵝ s a̠ i
くさき	k ɯ̟̊ᵝ s a̠ kʲ i
くさなぎのつるぎ	k ɯ̟̊ᵝ s a̠ n a̠ ɡʲ i n o̞ t͡s ɨᵝ ɾ ɯ̟ᵝ ɡʲ i
くさにくさはやすな	k ɯ̟ᵝ s a̠ ɲ̟ i k ɯ̟ᵝ s a̠ h a̠ j a̠ s ɨᵝ n a̠
くさのね	k ɯ̟ᵝ s a̠ n o̞ n e̞
くさはえる	k ɯ̟ᵝ s a̠ h a̠ e̞ ɾ ɯ̟ᵝ
くさばな	k ɯ̟̊ᵝ s a̠ b a̠ n a̠
くさび	k ɯ̟̊ᵝ s a̠ bʲ i
くさびがたもじ	k ɯ̟̊ᵝ s a̠ bʲ i ɡ a̠ t a̠ m o̞ ʑ i
くさわけ	k ɯ̟ᵝ s a̠ ɰᵝ a̠ k e̞
くしくも	k ɯ̟ᵝ ɕ i k ɯ̟ᵝ m o̞
くしゃみ	k ɯ̟ᵝ ɕ a̠ mʲ i
くじ	k ɯ̟ᵝ ʑ i
くじける	k ɯ̟ᵝ ʑ i k e̞ ɾ ɯ̟ᵝ
くじゃくざ	k ɯ̟ᵝ ʑ a̠ k ɯ̟ᵝ z a̠
くじゃくせき	k ɯ̟ᵝ ʑ a̠ k ɯ̟ᵝ s e̞ kʲ i
くじゅう	k ɯ̟ᵝ ʑ ɨᵝː
くじら	k ɯ̟ᵝ ʑ i ɾ a̠
くじらざ	k ɯ̟ᵝ ʑ i ɾ a̠ z a̠
くすぐったい	k ɯ̟ᵝ s ɨᵝ ɡ ɯ̟ᵝ t̚ t a̠ i
くすみ	k ɯ̟ᵝ s ɨᵝ mʲ i
くず	k ɯ̟ᵝ z ɨᵝ
くずかご	k ɯ̟ᵝ z ɨᵝ k a̠ ɡ o̞
くずし	k ɯ̟ᵝ z ɨᵝ ɕ i
くずしじ	k ɯ̟ᵝ z ɨᵝ ɕ i ʑ i
くずす	k ɯ̟ᵝ z ɨᵝ s ɨᵝ
くずゆ	k ɯ̟ᵝ z ɨᵝ j ɯ̟ᵝ
くずれる	k ɯ̟ᵝ z ɨᵝ ɾ e̞ ɾ ɯ̟ᵝ
くせげ	k ɯ̟ᵝ s e̞ ɡ e̞
くせに	k ɯ̟ᵝ s e̞ ɲ̟ i
くそ	k ɯ̟̊ᵝ s o̞
くたびれる	k ɯ̟ᵝ t a̠ bʲ i ɾ e̞ ɾ ɯ̟ᵝ
くだく	k ɯ̟ᵝ d a̠ k ɯ̟ᵝ
くださる	k ɯ̟ᵝ d a̠ s a̠ ɾ ɯ̟ᵝ
くだらごと	k ɯ̟ᵝ d a̠ ɾ a̠ ɡ o̞ t o̞
くだる	k ɯ̟ᵝ d a̠ ɾ ɯ̟ᵝ
くちずさむ	k ɯ̟ᵝ t͡ɕ i z ɨᵝ s a̠ m ɯ̟ᵝ
くちなし	k ɯ̟ᵝ t͡ɕ i n a̠ ɕ i
くちのは	k ɯ̟ᵝ t͡ɕ i n o̞ h a̠
くちはっちょうてはっちょう	k ɯ̟ᵝ t͡ɕ i h a̠ t̚ t͡ɕ o̞ː t e̞ h a̠ t̚ t͡ɕ o̞ː
くちばし	k ɯ̟̊ᵝ t͡ɕ i b a̠ ɕ i
くちびる	k ɯ̟̊ᵝ t͡ɕ i bʲ i ɾ ɯ̟ᵝ
くちぶり	k ɯ̟ᵝ t͡ɕ i b ɯ̟ᵝ ɾʲ i
くっきょく	k ɯ̟̊ᵝ k̚ʲ kʲ o̞ k ɯ̟ᵝ
くっきょくい	k ɯ̟ᵝ k̚ʲ kʲ o̞ k ɯ̟ᵝ i
くっきり	k ɯ̟ᵝ k̚ʲ kʲ i ɾʲ i
くっぷく	k ɯ̟ᵝ p̚ p ɯ̟ᵝ k ɯ̟ᵝ
くつかくし	k ɯ̟ᵝ t͡s ɨᵝ k a̠ k ɯ̟ᵝ ɕ i
くつがえす	k ɯ̟ᵝ t͡s ɨᵝ ɡ a̠ e̞ s ɨᵝ
くつがえる	k ɯ̟ᵝ t͡s ɨᵝ ɡ a̠ e̞ ɾ ɯ̟ᵝ
くつした	k ɯ̟̊ᵝ t͡s ɨᵝ ɕ i̥ t a̠
くつろぐ	k ɯ̟̊ᵝ t͡s ɨᵝ ɾ o̞ ɡ ɯ̟ᵝ
くとう	k ɯ̟ᵝ t o̞ː
くど	k ɯ̟ᵝ d o̞
くどう	k ɯ̟ᵝ d o̞ː
くどきおとす	k ɯ̟ᵝ d o̞ kʲ i o̞ t o̞ s ɨᵝ
くに	k ɯ̟ᵝ ɲ̟ i
くにこ	k ɯ̟ᵝ ɲ̟ i k o̞
くにゆき	k ɯ̟ᵝ ɲ̟ i j ɯ̟ᵝ kʲ i
くねくね	k ɯ̟ᵝ n e̞ k ɯ̟ᵝ n e̞
くばる	k ɯ̟ᵝ b a̠ ɾ ɯ̟ᵝ
くびかせ	k ɯ̟ᵝ bʲ i k a̠ s e̞
くびったけ	k ɯ̟ᵝ bʲ i t̚ t a̠ k e̞
くびながりゅう	k ɯ̟ᵝ bʲ i n a̠ ɡ a̠ ɾʲ ɨᵝː
くびになる	k ɯ̟ᵝ bʲ i ɲ̟ i n a̠ ɾ ɯ̟ᵝ
くびれ	k ɯ̟ᵝ bʲ i ɾ e̞
くふう	k ɯ̟ᵝ ɸ ɯ̟ᵝː
くへんとうすい	k ɯ̟ᵝ h ẽ̞ n t o̞ː s ɨᵝ i
くへんとうゆ	k ɯ̟ᵝ h ẽ̞ n t o̞ː j ɯ̟ᵝ
くぼみ	k ɯ̟ᵝ b o̞ mʲ i
くま	k ɯ̟ᵝ m a̠
くまなく	k ɯ̟ᵝ m a̠ n a̠ k ɯ̟ᵝ
くまのみ	k ɯ̟ᵝ m a̠ n o̞ mʲ i
くまもと	k ɯ̟ᵝ m a̠ m o̞ t o̞
くまもとけん	k ɯ̟ᵝ m a̠ m o̞ t o̞ k ẽ̞ ɴ
くみたてる	k ɯ̟ᵝ mʲ i t a̠ t e̞ ɾ ɯ̟ᵝ
くみはん	k ɯ̟ᵝ mʲ i h ã̠ ɴ
くむ	k ɯ̟ᵝ m ɯ̟ᵝ
くも	k ɯ̟ᵝ m o̞
くもざる	k ɯ̟ᵝ m o̞ z a̠ ɾ ɯ̟ᵝ
くもり	k ɯ̟ᵝ m o̞ ɾʲ i
くやしい	k ɯ̟ᵝ j a̠ ɕ iː
くやみ	k ɯ̟ᵝ j a̠ mʲ i
くらげ	k ɯ̟ᵝ ɾ a̠ ɡ e̞
くらし	k ɯ̟ᵝ ɾ a̠ ɕ i
くらべ	k ɯ̟ᵝ ɾ a̠ b e̞
くらべる	k ɯ̟ᵝ ɾ a̠ b e̞ ɾ ɯ̟ᵝ
くらむ	k ɯ̟ᵝ ɾ a̠ m ɯ̟ᵝ
くり	k ɯ̟ᵝ ɾʲ i
くりかえし	k ɯ̟ᵝ ɾʲ i k a̠ e̞ ɕ i
くりかえす	k ɯ̟ᵝ ɾʲ i k a̠ e̞ s ɨᵝ
くりひろげる	k ɯ̟ᵝ ɾʲ i ç i ɾ o̞ ɡ e̞ ɾ ɯ̟ᵝ
くる	k ɯ̟ᵝ ɾ ɯ̟ᵝ
くるい	k ɯ̟ᵝ ɾ ɯ̟ᵝ i
くるいざき	k ɯ̟ᵝ ɾ ɯ̟ᵝ i z a̠ kʲ i
くるう	k ɯ̟ᵝ ɾ ɯ̟ᵝː
くるおしい	k ɯ̟ᵝ ɾ ɯ̟ᵝ o̞ ɕ iː
くるくる	k ɯ̟ᵝ ɾ ɯ̟ᵝ k ɯ̟ᵝ ɾ ɯ̟ᵝ
くるしみ	k ɯ̟ᵝ ɾ ɯ̟ᵝ ɕ i mʲ i
くるす	k ɯ̟ᵝ ɾ ɯ̟ᵝ s ɨᵝ
くるみわり	k ɯ̟ᵝ ɾ ɯ̟ᵝ mʲ i ɰᵝ a̠ ɾʲ i
くるわことば	k ɯ̟ᵝ ɾ ɯ̟ᵝ ɰᵝ a̠ k o̞ t o̞ b a̠
くれたけ	k ɯ̟ᵝ ɾ e̞ t a̠ k e̞
くろ	k ɯ̟ᵝ ɾ o̞
くろい	k ɯ̟ᵝ ɾ o̞ i
くろう	k ɯ̟ᵝ ɾ o̞ː
くろうたどり	k ɯ̟ᵝ ɾ o̞ ɯ̟ᵝ t a̠ d o̞ ɾʲ i
くろうと	k ɯ̟ᵝ ɾ o̞ ɯ̟ᵝ t o̞
くろかみ	k ɯ̟ᵝ ɾ o̞ k a̠ mʲ i
くろごけぐも	k ɯ̟ᵝ ɾ o̞ ɡ o̞ k e̞ ɡ ɯ̟ᵝ m o̞
くろしお	k ɯ̟ᵝ ɾ o̞ ɕ i o̞
くろねこ	k ɯ̟ᵝ ɾ o̞ n e̞ k o̞
くろみ	k ɯ̟ᵝ ɾ o̞ mʲ i
くろみつ	k ɯ̟ᵝ ɾ o̞ mʲ i t͡s ɨᵝ
くろめ	k ɯ̟ᵝ ɾ o̞ m e̞
くろれきし	k ɯ̟ᵝ ɾ o̞ ɾ e̞ kʲ i ɕ i
くわ	k ɯ̟ᵝ ɰᵝ a̠
くわえて	k ɯ̟ᵝ ɰᵝ a̠ e̞ t e̞
くわえる	k ɯ̟ᵝ ɰᵝ a̠ e̞ ɾ ɯ̟ᵝ
くわがた	k ɯ̟ᵝ ɰᵝ a̠ ɡ a̠ t a̠
くわしい	k ɯ̟ᵝ ɰᵝ a̠ ɕ i i
くわずぎらい	k ɯ̟ᵝ ɰᵝ a̠ z ɨᵝ ɡʲ i ɾ a̠ i
くわだて	k ɯ̟ᵝ ɰᵝ a̠ d a̠ t e̞
くわわる	k ɯ̟ᵝ ɰᵝ a̠ ɰᵝ a̠ ɾ ɯ̟ᵝ
くん	k ɯ̟̃ᵝ ɴ
くんしゅせい	k ɯ̟̃ᵝ ɰ̃ ɕ ɨ̥ᵝ s e̞ː
くんよみ	k ɯ̟̃ᵝ ɰ̃ j o̞ mʲ i
ぐぁ	ɡ ɰᵝ a̠
ぐぃ	ɡ ɰᵝ i
ぐうきせい	ɡ ɯ̟ᵝː kʲ i̥ s e̞ː
ぐうぐう	ɡ ɯ̟ᵝː ɡ ɯ̟ᵝː
ぐうげん	ɡ ɯ̟ᵝː ɡ ẽ̞ ɴ
ぐうぞうすうはい	ɡ ɯ̟ᵝː z o̞ː s ɨᵝː h a̠ i
ぐげん	ɡ ɯ̟ᵝ ɡ ẽ̞ ɴ
ぐこうやまをうつす	ɡ ɯ̟ᵝ k o̞ː j a̠ m a̠ o̞ ɯ̟ᵝ t͡s ɨᵝ s ɨᵝ
ぐしゃぐしゃ	ɡ ɯ̟ᵝ ɕ a̠ ɡ ɯ̟ᵝ ɕ a̠
ぐしん	ɡ ɯ̟ᵝ ɕ ĩ ɴ
ぐせい	ɡ ɯ̟ᵝ s e̞ː
ぐたい	ɡ ɯ̟ᵝ t a̠ i
ぐち	ɡ ɯ̟ᵝ t͡ɕ i
ぐちる	ɡ ɯ̟ᵝ t͡ɕ i ɾ ɯ̟ᵝ
ぐちをこぼす	ɡ ɯ̟ᵝ t͡ɕ i o̞ k o̞ b o̞ s ɨᵝ
ぐっすり	ɡ ɯ̟ᵝ sː ɯ̟ᵝ ɾʲ i
ぐらつく	ɡ ɯ̟ᵝ ɾ a̠ t͡s ɨᵝ k ɯ̟ᵝ
ぐり	ɡ ɯ̟ᵝ ɾʲ i
ぐるぐる	ɡ ɯ̟ᵝ ɾ ɯ̟ᵝ ɡ ɯ̟ᵝ ɾ ɯ̟ᵝ
ぐれんじごく	ɡ ɯ̟ᵝ ɾ ẽ̞ ɲ̟ d͡ʑ i ɡ o̞ k ɯ̟ᵝ
ぐん	ɡ ɯ̟̃ᵝ ɴ
ぐんか	ɡ ɯ̟̃ᵝ ŋ k a̠
ぐんそう	ɡ ɯ̟̃ᵝ ɰ̃ s o̞ː
ぐんて	ɡ ɯ̟̃ᵝ n t e̞
ぐんばいがあがる	ɡ ɯ̟̃ᵝ m b a̠ i ɡ a̠ a̠ ɡ a̠ ɾ ɯ̟ᵝ
ぐんぴ	ɡ ɯ̟̃ᵝ m pʲ i
ぐんまけん	ɡ ɯ̟̃ᵝ mː a̠ k ẽ̞ ɴ
けいか	k e̞ː k a̠
けいかくうんきゅう	k e̞ː k a̠ k ɯ̟ᵝ ɯ̟̃ᵝ ŋʲ kʲ ɨᵝː
けいかん	k e̞ː k ã̠ ɴ
けいきかんじゅう	k e̞ː kʲ i k ã̠ ɲ̟ d͡ʑ ɨᵝː
けいきょく	k e̞ː kʲ o̞ k ɯ̟ᵝ
けいこ	k e̞ː k o̞
けいこう	k e̞ː k o̞ː
けいこうひにんやく	k e̞ː k o̞ː ç i ɲ̟ ĩ ɰ̃ j a̠ k ɯ̟ᵝ
けいさい	k e̞ː s a̠ i
けいさく	k e̞ː s a̠ k ɯ̟ᵝ
けいさんきかがく	k e̞ː s ã̠ ŋʲ kʲ i k a̠ ɡ a̠ k ɯ̟ᵝ
けいざい	k e̞ː z a̠ i
けいしき	k e̞ː ɕ i̥ kʲ i
けいしちょう	k e̞ː ɕ i t͡ɕ o̞ː
けいしん	k e̞ː ɕ ĩ ɴ
けいじか	k e̞ː ʑ i k a̠
けいじょう	k e̞ː ʑ o̞ː
けいすけ	k e̞ː s ɨᵝ k e̞
けいたいそ	k e̞ː t a̠ i s o̞
けいたいばんごう	k e̞ː t a̠ i b ã̠ ŋ ɡ o̞ː
けいてき	k e̞ː t e̞ kʲ i
けいとう	k e̞ː t o̞ː
けいはんざい	k e̞ː h ã̠ n d͡z a̠ i
けいはんな	k e̞ː h ã̠ nː a̠
けいべつ	k e̞ː b e̞ t͡s ɨᵝ
けいほうき	k e̞ː h o̞ː kʲ i
けいまい	k e̞ː m a̠ i
けいめい	k e̞ː m e̞ː
けいらん	k e̞ː ɾ ã̠ ɴ
けいりゅう	k e̞ː ɾʲ ɨᵝː
けいりゅうし	k e̞ː ɾʲ ɨᵝː ɕ i
けいりょうき	k e̞ː ɾʲ o̞ː kʲ i
けいりん	k e̞ː ɾʲ ĩ ɴ
けが	k e̞ ɡ a̠
けがに	k e̞ ɡ a̠ ɲ̟ i
けがわ	k e̞ ɡ a̠ ɰᵝ a̠
けさ	k e̞ s a̠
けしとぶ	k e̞ ɕ i t o̞ b ɯ̟ᵝ
けじめ	k e̞ ʑ i m e̞
けじらみ	k e̞ ʑ i ɾ a̠ mʲ i
けす	k e̞ s ɨᵝ
けた	k e̞ t a̠
けたたましい	k e̞ t a̠ t a̠ m a̠ ɕ iː
けっか	k e̞ k̚ k a̠
けっきゅう	k e̞ k̚ʲ kʲ ɨᵝː
けっこう	k e̞ k̚ k o̞ː
けっこん	k e̞ k̚ k õ̞ ɴ
けっしょう	k e̞ ɕː o̞ː
けっしん	k e̞ ɕː ĩ ɴ
けっそん	k e̞ sː õ̞ ɴ
けったく	k e̞ t̚ t a̠ k ɯ̟ᵝ
けっとうち	k e̞ t̚ t o̞ː t͡ɕ i
けっぱん	k e̞ p̚ p ã̠ ɴ
けっぽん	k e̞ p̚ p õ̞ ɴ
けつい	k e̞ t͡s ɨᵝ i
けつけつ	k e̞ t͡s ɨᵝ k e̞ t͡s ɨᵝ
けつぞく	k e̞ t͡s ɨᵝ z o̞ k ɯ̟ᵝ
けとばす	k e̞ t o̞ b a̠ s ɨᵝ
けど	k e̞ d o̞
けなげ	k e̞ n a̠ ɡ e̞
けなす	k e̞ n a̠ s ɨᵝ
けはい	k e̞ h a̠ i
けびいし	k e̞ bʲ iː ɕ i
けむり	k e̞ m ɯ̟ᵝ ɾʲ i
けやき	k e̞ j a̠ kʲ i
けら	k e̞ ɾ a̠
けらば	k e̞ ɾ a̠ b a̠
けり	k e̞ ɾʲ i
ける	k e̞ ɾ ɯ̟ᵝ
けれど	k e̞ ɾ e̞ d o̞
けれども	k e̞ ɾ e̞ d o̞ m o̞
けわしい	k e̞ ɰᵝ a̠ ɕ i i
けん	k ẽ̞ ɴ
けんいしゅぎ	k ẽ̞ ɰ̃ i ɕ ɨᵝ ɡʲ i
けんいんやく	k ẽ̞ ɰ̃ ĩ ɰ̃ j a̠ k ɯ̟ᵝ
けんえき	k ẽ̞ ɰ̃ e̞ kʲ i
けんおんき	k ẽ̞ ɰ̃ õ̞ ŋʲ kʲ i
けんか	k ẽ̞ ŋ k a̠
けんかごし	k ẽ̞ ŋ k a̠ ɡ o̞ ɕ i
けんきゅういん	k ẽ̞ ŋʲ kʲ ɨᵝː ĩ ɴ
けんきゅうかい	k ẽ̞ ŋʲ kʲ ɨᵝː k a̠ i
けんきょ	k ẽ̞ ŋʲ kʲ o̞
けんぎ	k ẽ̞ ŋʲ ɡʲ i
けんぎゅうか	k ẽ̞ ŋʲ ɡʲ ɨᵝː k a̠
けんぎゅうせい	k ẽ̞ ŋʲ ɡʲ ɨᵝː s e̞ː
けんぎょう	k ẽ̞ ŋʲ ɡʲ o̞ː
けんけい	k ẽ̞ ŋ k e̞ː
けんこうしんさ	k ẽ̞ ŋ k o̞ː ɕ ĩ ɰ̃ s a̠
けんこうしんだん	k ẽ̞ ŋ k o̞ː ɕ ĩ n d ã̠ ɴ
けんご	k ẽ̞ ŋ ɡ o̞
けんさつ	k ẽ̞ ɰ̃ s a̠ t͡s ɨᵝ
けんさん	k ẽ̞ ɰ̃ s ã̠ ɴ
けんざい	k ẽ̞ n d͡z a̠ i
けんし	k ẽ̞ ɰ̃ ɕ i
けんしゅう	k ẽ̞ ɰ̃ ɕ ɨᵝː
けんしん	k ẽ̞ ɰ̃ ɕ ĩ ɴ
けんじ	k ẽ̞ ɲ̟ d͡ʑ i
けんじゅつ	k ẽ̞ ɲ̟ d͡ʑ ɨᵝ t͡s ɨᵝ
けんじょうご	k ẽ̞ ɲ̟ d͡ʑ o̞ː ɡ o̞
けんじょうしゃ	k ẽ̞ ɲ̟ d͡ʑ o̞ː ɕ a̠
けんじろう	k ẽ̞ ɲ̟ d͡ʑ i ɾ o̞ː
けんたい	k ẽ̞ n t a̠ i
けんばい	k ẽ̞ m b a̠ i
けんぱく	k ẽ̞ m p a̠ k ɯ̟ᵝ
けんぱくしょ	k ẽ̞ m p a̠ k ɯ̟ᵝ ɕ o̞
けんぽう	k ẽ̞ m p o̞ː
けんめい	k ẽ̞ mː e̞ː
けんもん	k ẽ̞ mː õ̞ ɴ
け゚	ŋ e̞
げいご	ɡ e̞ː ɡ o̞
げいじゅつ	ɡ e̞ː ʑ ɨᵝ t͡s ɨᵝ
げいじゅつせい	ɡ e̞ː ʑ ɨᵝ t͡s ɨᵝ s e̞ː
げき	ɡ e̞ kʲ i
げきから	ɡ e̞ kʲ i k a̠ ɾ a̠
げきそう	ɡ e̞ kʲ i s o̞ː
げきだん	ɡ e̞ kʲ i d ã̠ ɴ
げこう	ɡ e̞ k o̞ː
げしゅく	ɡ e̞ ɕ ɨ̥ᵝ k ɯ̟ᵝ
げじ	ɡ e̞ ʑ i
げじげじ	ɡ e̞ ʑ i ɡ e̞ ʑ i
げせん	ɡ e̞ s ẽ̞ ɴ
げた	ɡ e̞ t a̠
げっか	ɡ e̞ k̚ k a̠
げっぺい	ɡ e̞ p̚ p e̞ː
げつめん	ɡ e̞ t͡s ɨᵝ m ẽ̞ ɴ
げどう	ɡ e̞ d o̞ː
げどく	ɡ e̞ d o̞ k ɯ̟ᵝ
げん	ɡ ẽ̞ ɴ
げんかい	ɡ ẽ̞ ŋ k a̠ i
げんかく	ɡ ẽ̞ ŋ k a̠ k ɯ̟ᵝ
げんかん	ɡ ẽ̞ ŋ k ã̠ ɴ
げんが	ɡ ẽ̞ ŋ ɡ a̠
げんき	ɡ ẽ̞ ŋʲ kʲ i
げんきょく	ɡ ẽ̞ ŋʲ kʲ o̞ k ɯ̟ᵝ
げんきん	ɡ ẽ̞ ŋʲ kʲ ĩ ɴ
げんぎ	ɡ ẽ̞ ŋʲ ɡʲ i
げんげつ	ɡ ẽ̞ ŋ ɡ e̞ t͡s ɨᵝ
げんこう	ɡ ẽ̞ ŋ k o̞ː
げんこく	ɡ ẽ̞ ŋ k o̞ k ɯ̟ᵝ
げんこつ	ɡ ẽ̞ ŋ k o̞ t͡s ɨᵝ
げんごろうぶな	ɡ ẽ̞ ŋ ɡ o̞ ɾ o̞ː b ɯ̟ᵝ n a̠
げんざい	ɡ ẽ̞ n d͡z a̠ i
げんざいじせい	ɡ ẽ̞ n d͡z a̠ i d͡ʑ i s e̞ː
げんしかくぶつりがく	ɡ ẽ̞ ɰ̃ ɕ i̥ k a̠ k ɯ̟ᵝ b ɯ̟ᵝ t͡s ɨᵝ ɾʲ i ɡ a̠ k ɯ̟ᵝ
げんしてき	ɡ ẽ̞ ɰ̃ ɕ i t e̞ kʲ i
げんしゅつ	ɡ ẽ̞ ɰ̃ ɕ ɨᵝ t͡s ɨᵝ
げんしろ	ɡ ẽ̞ ɰ̃ ɕ i ɾ o̞
げんじつかん	ɡ ẽ̞ ɲ̟ d͡ʑ i t͡s ɨᵝ k ã̠ ɴ
げんじつとうひ	ɡ ẽ̞ ɲ̟ d͡ʑ i t͡s ɨᵝ t o̞ː ç i
げんじょう	ɡ ẽ̞ ɲ̟ d͡ʑ o̞ː
げんせいせいぶつ	ɡ ẽ̞ ɰ̃ s e̞ː s e̞ː b ɯ̟ᵝ t͡s ɨᵝ
げんせいだい	ɡ ẽ̞ ɰ̃ s e̞ː d a̠ i
げんそうきょく	ɡ ẽ̞ ɰ̃ s o̞ː kʲ o̞ k ɯ̟ᵝ
げんだいげき	ɡ ẽ̞ n d a̠ i ɡ e̞ kʲ i
げんちご	ɡ ẽ̞ ɲ̟ t͡ɕ i ɡ o̞
げんつき	ɡ ẽ̞ n t͡s ɨᵝ kʲ i
げんとうき	ɡ ẽ̞ n t o̞ː kʲ i
げんば	ɡ ẽ̞ m b a̠
げんまい	ɡ ẽ̞ mː a̠ i
げんめつ	ɡ ẽ̞ mː e̞ t͡s ɨᵝ
げんや	ɡ ẽ̞ ɰ̃ j a̠
げんりゅう	ɡ ẽ̞ n ɾʲ ɨᵝː
こい	k o̞ i
こいがたき	k o̞ i ɡ a̠ t a̠ kʲ i
こいこがれる	k o̞ i k o̞ ɡ a̠ ɾ e̞ ɾ ɯ̟ᵝ
こいし	k o̞ i ɕ i
こいびと	k o̞ i bʲ i t o̞
こいぶみ	k o̞ i b ɯ̟ᵝ mʲ i
こいん	k o̞ ĩ ɴ
こうい	k o̞ː i
こういう	k o̞ː i ɯ̟ᵝ
こういしつ	k o̞ː i ɕ i t͡s ɨᵝ
こういしょう	k o̞ː i ɕ o̞ː
こういち	k o̞ː i t͡ɕ i
こういってん	k o̞ː i t̚ t ẽ̞ ɴ
こううつやく	k o̞ː ɯ̟ᵝ t͡s ɨᵝ j a̠ k ɯ̟ᵝ
こううん	k o̞ː ɯ̟̃ᵝ ɴ
こうえい	k o̞ː e̞ː
こうえん	k o̞ː ẽ̞ ɴ
こうお	k o̞ː o̞
こうおつへいてい	k o̞ː o̞ t͡s ɨᵝ h e̞ː t e̞ː
こうがい	k o̞ː ɡ a̠ i
こうがく	k o̞ː ɡ a̠ k ɯ̟ᵝ
こうがくけんびきょう	k o̞ː ɡ a̠ k ɯ̟ᵝ k ẽ̞ m bʲ i kʲ o̞ː
こうき	k o̞ː kʲ i
こうきあつ	k o̞ː kʲ i a̠ t͡s ɨᵝ
こうきゅう	k o̞ː kʲ ɨᵝː
こうきょうきょく	k o̞ː kʲ o̞ː kʲ o̞ k ɯ̟ᵝ
こうきょうしょくぎょうあんていじょ	k o̞ː kʲ o̞ː ɕ o̞ k ɯ̟ᵝ ɡʲ o̞ː ã̠ n t e̞ː ʑ o̞
こうぎ	k o̞ː ɡʲ i
こうぎょう	k o̞ː ɡʲ o̞ː
こうくう	k o̞ː k ɯ̟ᵝː
こうくうびん	k o̞ː k ɯ̟ᵝː bʲ ĩ ɴ
こうけっとう	k o̞ː k e̞ t̚ t o̞ː
こうけつ	k o̞ː k e̞ t͡s ɨᵝ
こうげん	k o̞ː ɡ ẽ̞ ɴ
こうこ	k o̞ː k o̞
こうこがく	k o̞ː k o̞ ɡ a̠ k ɯ̟ᵝ
こうこく	k o̞ː k o̞ k ɯ̟ᵝ
こうこくとう	k o̞ː k o̞ k ɯ̟ᵝ t o̞ː
こうご	k o̞ː ɡ o̞
こうごう	k o̞ː ɡ o̞ː
こうごうせい	k o̞ː ɡ o̞ː s e̞ː
こうさつ	k o̞ː s a̠ t͡s ɨᵝ
こうざ	k o̞ː z a̠
こうざい	k o̞ː z a̠ i
こうざん	k o̞ː z ã̠ ɴ
こうしきせん	k o̞ː ɕ i kʲ i s ẽ̞ ɴ
こうしゅ	k o̞ː ɕ ɨᵝ
こうしょう	k o̞ː ɕ o̞ː
こうしんきょく	k o̞ː ɕ ĩ ŋʲ kʲ o̞ k ɯ̟ᵝ
こうじ	k o̞ː ʑ i
こうじゅん	k o̞ː ʑ ɨ̃ᵝ ɴ
こうせい	k o̞ː s e̞ː
こうせいきょく	k o̞ː s e̞ː kʲ o̞ k ɯ̟ᵝ
こうせいざい	k o̞ː s e̞ː z a̠ i
こうせつ	k o̞ː s e̞ t͡s ɨᵝ
こうそく	k o̞ː s o̞ k ɯ̟ᵝ
こうそつ	k o̞ː s o̞ t͡s ɨᵝ
こうそふ	k o̞ː s o̞ ɸ ɯ̟ᵝ
こうぞく	k o̞ː z o̞ k ɯ̟ᵝ
こうたく	k o̞ː t a̠ k ɯ̟ᵝ
こうだい	k o̞ː d a̠ i
こうだいむへん	k o̞ː d a̠ i m ɯ̟ᵝ h ẽ̞ ɴ
こうちしょ	k o̞ː t͡ɕ i ɕ o̞
こうちょうどうぶつ	k o̞ː t͡ɕ o̞ː d o̞ː b ɯ̟ᵝ t͡s ɨᵝ
こうつうきかん	k o̞ː t͡s ɨᵝː kʲ i k ã̠ ɴ
こうつごう	k o̞ː t͡s ɨᵝ ɡ o̞ː
こうていてき	k o̞ː t e̞ː t e̞ kʲ i
こうてつ	k o̞ː t e̞ t͡s ɨᵝ
こうてんせい	k o̞ː t ẽ̞ ɰ̃ s e̞ː
こうでん	k o̞ː d ẽ̞ ɴ
こうとうは	k o̞ː t o̞ː h a̠
こうどう	k o̞ː d o̞ː
こうない	k o̞ː n a̠ i
こうにち	k o̞ː ɲ̟ i t͡ɕ i
こうにん	k o̞ː ɲ̟ ĩ ɴ
こうねん	k o̞ː n ẽ̞ ɴ
こうはい	k o̞ː h a̠ i
こうはいい	k o̞ː h a̠ i i
こうはん	k o̞ː h ã̠ ɴ
こうばこずわり	k o̞ː b a̠ k o̞ z ɨᵝ ɰᵝ a̠ ɾʲ i
こうばしい	k o̞ː b a̠ ɕ i i
こうふ	k o̞ː ɸ ɯ̟ᵝ
こうふく	k o̞ː ɸ ɯ̟̊ᵝ k ɯ̟ᵝ
こうふん	k o̞ː ɸ ɯ̟̃ᵝ ɴ
こうぶんとうい	k o̞ː b ɯ̟̃ᵝ n t o̞ː i
こうぶんろん	k o̞ː b ɯ̟̃ᵝ n ɾ õ̞ ɴ
こうへいむし	k o̞ː h e̞ː m ɯ̟ᵝ ɕ i
こうめい	k o̞ː m e̞ː
こうもり	k o̞ː m o̞ ɾʲ i
こうや	k o̞ː j a̠
こうら	k o̞ː ɾ a̠
こうりゃく	k o̞ː ɾʲ a̠ k ɯ̟ᵝ
こうりょ	k o̞ː ɾʲ o̞
こうりょう	k o̞ː ɾʲ o̞ː
こうりょうしゅ	k o̞ː ɾʲ o̞ː ɕ ɨᵝ
こうれいじゅつ	k o̞ː ɾ e̞ː ʑ ɨᵝ t͡s ɨᵝ
こえ	k o̞ e̞
こえる	k o̞ e̞ ɾ ɯ̟ᵝ
こおらす	k o̞ː ɾ a̠ s ɨᵝ
こおり	k o̞ː ɾʲ i
こおりがし	k o̞ː ɾʲ i ɡ a̠ ɕ i
こおりや	k o̞ː ɾʲ i j a̠
こおろぎ	k o̞ː ɾ o̞ ɡʲ i
こかげ	k o̞ k a̠ ɡ e̞
こがお	k o̞ ɡ a̠ o̞
こがき	k o̞ ɡ a̠ kʲ i
こがす	k o̞ ɡ a̠ s ɨᵝ
こがねいろ	k o̞ ɡ a̠ n e̞ i ɾ o̞
こがら	k o̞ ɡ a̠ ɾ a̠
こきゃく	k o̞ kʲ a̠ k ɯ̟ᵝ
こきゅう	k o̞ kʲ ɨᵝː
こきん	k o̞ kʲ ĩ ɴ
こく	k o̞ k ɯ̟ᵝ
こくえき	k o̞ k ɯ̟ᵝ e̞ kʲ i
こくえん	k o̞ k ɯ̟ᵝ ẽ̞ ɴ
こくおう	k o̞ k ɯ̟ᵝ o̞ː
こくがい	k o̞ k ɯ̟ᵝ ɡ a̠ i
こくさいか	k o̞ k ɯ̟̊ᵝ s a̠ i k a̠
こくさいご	k o̞ k ɯ̟ᵝ s a̠ i ɡ o̞
こくさいほう	k o̞ k ɯ̟ᵝ s a̠ i h o̞ː
こくしむそう	k o̞ k ɯ̟ᵝ ɕ i m ɯ̟ᵝ s o̞ː
こくじ	k o̞ k ɯ̟ᵝ ʑ i
こくじら	k o̞ k ɯ̟ᵝ ʑ i ɾ a̠
こくじん	k o̞ k ɯ̟ᵝ ʑ ĩ ɴ
こくすい	k o̞ k ɯ̟ᵝ s ɨᵝ i
こくせき	k o̞ k ɯ̟̊ᵝ s e̞ kʲ i
こくそう	k o̞ k ɯ̟ᵝ s o̞ː
こくそく	k o̞ k ɯ̟ᵝ s o̞ k ɯ̟ᵝ
こくち	k o̞ k ɯ̟̊ᵝ t͡ɕ i
こくど	k o̞ k ɯ̟ᵝ d o̞
こくどう	k o̞ k ɯ̟ᵝ d o̞ː
こくはつ	k o̞ k ɯ̟ᵝ h a̠ t͡s ɨᵝ
こくはつしゃ	k o̞ k ɯ̟ᵝ h a̠ t͡s ɨᵝ ɕ a̠
こくばん	k o̞ k ɯ̟ᵝ b ã̠ ɴ
こくふく	k o̞ k ɯ̟ᵝ ɸ ɯ̟̊ᵝ k ɯ̟ᵝ
こくべつ	k o̞ k ɯ̟ᵝ b e̞ t͡s ɨᵝ
こくぼう	k o̞ k ɯ̟ᵝ b o̞ː
こくみん	k o̞ k ɯ̟ᵝ mʲ ĩ ɴ
こくみんとうひょう	k o̞ k ɯ̟ᵝ mʲ ĩ n t o̞ː ç o̞ː
こくめい	k o̞ k ɯ̟ᵝ m e̞ː
こくもつ	k o̞ k ɯ̟ᵝ m o̞ t͡s ɨᵝ
こくゆう	k o̞ k ɯ̟ᵝ j ɯ̟ᵝː
こくゆうか	k o̞ k ɯ̟ᵝ j ɯ̟ᵝː k a̠
こくりゅうこう	k o̞ k ɯ̟ᵝ ɾʲ ɨᵝː k o̞ː
こくる	k o̞ k ɯ̟ᵝ ɾ ɯ̟ᵝ
こくれん	k o̞ k ɯ̟ᵝ ɾ ẽ̞ ɴ
こぐ	k o̞ ɡ ɯ̟ᵝ
こぐま	k o̞ ɡ ɯ̟ᵝ m a̠
こけおどし	k o̞ k e̞ o̞ d o̞ ɕ i
こけつ	k o̞ k e̞ t͡s ɨᵝ
ここのか	k o̞ k o̞ n o̞ k a̠
こころ	k o̞ k o̞ ɾ o̞
こころえ	k o̞ k o̞ ɾ o̞ e̞
こころがおれる	k o̞ k o̞ ɾ o̞ ɡ a̠ o̞ ɾ e̞ ɾ ɯ̟ᵝ
こころざし	k o̞ k o̞ ɾ o̞ z a̠ ɕ i
こころづもり	k o̞ k o̞ ɾ o̞ z ɨᵝ m o̞ ɾʲ i
こころぼそい	k o̞ k o̞ ɾ o̞ b o̞ s o̞ i
こころみ	k o̞ k o̞ ɾ o̞ mʲ i
こころみる	k o̞ k o̞ ɾ o̞ mʲ i ɾ ɯ̟ᵝ
こごえ	k o̞ ɡ o̞ e̞
こごえしぬ	k o̞ ɡ o̞ e̞ ɕ i n ɯ̟ᵝ
こごえる	k o̞ ɡ o̞ e̞ ɾ ɯ̟ᵝ
こさか	k o̞ s a̠ k a̠
こさめ	k o̞ s a̠ m e̞
こし	k o̞ ɕ i
こしかける	k o̞ ɕ i k a̠ k e̞ ɾ ɯ̟ᵝ
こしふり	k o̞ ɕ i ɸ ɯ̟ᵝ ɾʲ i
こしょ	k o̞ ɕ o̞
こしょばい	k o̞ ɕ o̞ b a̠ i
こじ	k o̞ ʑ i
こじしざ	k o̞ ʑ i ɕ i z a̠
こじつける	k o̞ ʑ i t͡s ɨᵝ k e̞ ɾ ɯ̟ᵝ
こじつよみ	k o̞ ʑ i t͡s ɨᵝ j o̞ mʲ i
こじんてき	k o̞ ʑ ĩ n t e̞ kʲ i
こす	k o̞ s ɨᵝ
こすい	k o̞ s ɨᵝ i
こずえ	k o̞ z ɨᵝ e̞
こせい	k o̞ s e̞ː
こぜに	k o̞ z e̞ ɲ̟ i
こぞう	k o̞ z o̞ː
こたえる	k o̞ t a̠ e̞ ɾ ɯ̟ᵝ
こたつ	k o̞ t a̠ t͡s ɨᵝ
こだいこうこく	k o̞ d a̠ i k o̞ː k o̞ k ɯ̟ᵝ
こだいもうそう	k o̞ d a̠ i m o̞ː s o̞ː
こちとら	k o̞ t͡ɕ i t o̞ ɾ a̠
こちゃ	k o̞ t͡ɕ a̠
こちょう	k o̞ t͡ɕ o̞ː
こっか	k o̞ k̚ k a̠
こっから	k o̞ k̚ k a̠ ɾ a̠
こっくん	k o̞ k̚ k ɯ̟̃ᵝ ɴ
こっこく	k o̞ k̚ k o̞ k ɯ̟ᵝ
こっせつ	k o̞ sː e̞ t͡s ɨᵝ
こっそり	k o̞ sː o̞ ɾʲ i
こっち	k o̞ t̚ t͡ɕ i
こつつぼ	k o̞ t͡s ɨᵝ t͡s ɨᵝ b o̞
こつぶ	k o̞ t͡s ɨᵝ b ɯ̟ᵝ
こづかい	k o̞ z ɨᵝ k a̠ i
こづち	k o̞ z ɨᵝ t͡ɕ i
こづつみ	k o̞ z ɨᵝ t͡s ɨᵝ mʲ i
こてい	k o̞ t e̞ː
こていでんわ	k o̞ t e̞ː d ẽ̞ ɰ̃ ɰᵝ a̠
こていばいたい	k o̞ t e̞ː b a̠ i t a̠ i
こてんりきがく	k o̞ t ẽ̞ n ɾʲ i kʲ i ɡ a̠ k ɯ̟ᵝ
こと	k o̞ t o̞
ことあまつかみ	k o̞ t o̞ a̠ m a̠ t͡s ɨᵝ k a̠ mʲ i
ことかく	k o̞ t o̞ k a̠ k ɯ̟ᵝ
ことごとく	k o̞ t o̞ ɡ o̞ t o̞ k ɯ̟ᵝ
ことさら	k o̞ t o̞ s a̠ ɾ a̠
ことし	k o̞ t o̞ ɕ i
ことなかれしゅぎ	k o̞ t o̞ n a̠ k a̠ ɾ e̞ ɕ ɨᵝ ɡʲ i
ことなる	k o̞ t o̞ n a̠ ɾ ɯ̟ᵝ
ことば	k o̞ t o̞ b a̠
ことみ	k o̞ t o̞ mʲ i
ことわざ	k o̞ t o̞ ɰᵝ a̠ z a̠
ことわり	k o̞ t o̞ ɰᵝ a̠ ɾʲ i
ことわる	k o̞ t o̞ ɰᵝ a̠ ɾ ɯ̟ᵝ
こどく	k o̞ d o̞ k ɯ̟ᵝ
こども	k o̞ d o̞ m o̞
こどものひ	k o̞ d o̞ m o̞ n o̞ ç i
こどもべやおじさん	k o̞ d o̞ m o̞ b e̞ j a̠ o̞ ʑ i s ã̠ ɴ
こないだ	k o̞ n a̠ i d a̠
こなす	k o̞ n a̠ s ɨᵝ
こなべだて	k o̞ n a̠ b e̞ d a̠ t e̞
こなゆき	k o̞ n a̠ j ɯ̟ᵝ kʲ i
このはなのさくやひめ	k o̞ n o̞ h a̠ n a̠ n o̞ s a̠ k ɯ̟ᵝ j a̠ ç i m e̞
このみ	k o̞ n o̞ mʲ i
このむ	k o̞ n o̞ m ɯ̟ᵝ
こばむ	k o̞ b a̠ m ɯ̟ᵝ
こばんざめ	k o̞ b ã̠ n d͡z a̠ m e̞
こひ	k o̞ ç i
こひょう	k o̞ ç o̞ː
こび	k o̞ bʲ i
こふう	k o̞ ɸ ɯ̟ᵝː
こぶうし	k o̞ b ɯ̟ᵝ ɯ̟ᵝ ɕ i
こぶり	k o̞ b ɯ̟ᵝ ɾʲ i
こべつしどう	k o̞ b e̞ t͡s ɨᵝ ɕ i d o̞ː
こぼし	k o̞ b o̞ ɕ i
こぼす	k o̞ b o̞ s ɨᵝ
こぼれ	k o̞ b o̞ ɾ e̞
こぼれる	k o̞ b o̞ ɾ e̞ ɾ ɯ̟ᵝ
こま	k o̞ m a̠
こまい	k o̞ m a̠ i
こまち	k o̞ m a̠ t͡ɕ i
こまぶえ	k o̞ m a̠ b ɯ̟ᵝ e̞
こまります	k o̞ m a̠ ɾʲ i m a̠ s ɨᵝ
こまる	k o̞ m a̠ ɾ ɯ̟ᵝ
こむ	k o̞ m ɯ̟ᵝ
こむぎ	k o̞ m ɯ̟ᵝ ɡʲ i
こむそう	k o̞ m ɯ̟ᵝ s o̞ː
こめ	k o̞ m e̞
こめい	k o̞ m e̞ː
こめかみ	k o̞ m e̞ k a̠ mʲ i
こもごも	k o̞ m o̞ ɡ o̞ m o̞
こもりぐま	k o̞ m o̞ ɾʲ i ɡ ɯ̟ᵝ m a̠
こもる	k o̞ m o̞ ɾ ɯ̟ᵝ
こもん	k o̞ m õ̞ ɴ
こやま	o̞ j a̠ m a̠
こら	k o̞ ɾ a̠
こらしめる	k o̞ ɾ a̠ ɕ i m e̞ ɾ ɯ̟ᵝ
こりつは	k o̞ ɾʲ i t͡s ɨᵝ h a̠
こりん	k o̞ ɾʲ ĩ ɴ
こる	k o̞ ɾ ɯ̟ᵝ
これから	k o̞ ɾ e̞ k a̠ ɾ a̠
これだけ	k o̞ ɾ e̞ d a̠ k e̞
これまで	k o̞ ɾ e̞ m a̠ d e̞
ころがる	k o̞ ɾ o̞ ɡ a̠ ɾ ɯ̟ᵝ
ころばぬさきのつえ	k o̞ ɾ o̞ b a̠ n ɯ̟ᵝ s a̠ kʲ i n o̞ t͡s ɨᵝ e̞
ころぶ	k o̞ ɾ o̞ b ɯ̟ᵝ
こわい	k o̞ ɰᵝ a̠ i
こわす	k o̞ ɰᵝ a̠ s ɨᵝ
こわれる	k o̞ ɰᵝ a̠ ɾ e̞ ɾ ɯ̟ᵝ
こん	k õ̞ ɴ
こんい	k õ̞ ɰ̃ i
こんごう	k õ̞ ŋ ɡ o̞ː
こんごうさん	k õ̞ ŋ ɡ o̞ː s ã̠ ɴ
こんごうりん	k õ̞ ŋ ɡ o̞ː ɾʲ ĩ ɴ
こんざい	k õ̞ n d͡z a̠ i
こんしょく	k õ̞ ɰ̃ ɕ o̞ k ɯ̟ᵝ
こんしん	k õ̞ ɰ̃ ɕ ĩ ɴ
こんしんかい	k õ̞ ɰ̃ ɕ ĩ ŋ k a̠ i
こんじゃく	k õ̞ ɲ̟ d͡ʑ a̠ k ɯ̟ᵝ
こんせつ	k õ̞ ɰ̃ s e̞ t͡s ɨᵝ
こんぜつ	k õ̞ n d͡z e̞ t͡s ɨᵝ
こんたん	k õ̞ n t ã̠ ɴ
こんど	k õ̞ n d o̞
こんにゃく	k õ̞ ɲ̟ ɲ̟ a̠ k ɯ̟ᵝ
こんばんわ	k õ̞ m b ã̠ ɰ̃ ɰᵝ a̠
こんぺき	k õ̞ m p e̞ kʲ i
こんやく	k õ̞ ɰ̃ j a̠ k ɯ̟ᵝ
こんやくしゃ	k õ̞ ɰ̃ j a̠ k ɯ̟̊ᵝ ɕ a̠
こんらん	k õ̞ n ɾ ã̠ ɴ
こんれい	k õ̞ n ɾ e̞ː
ごい	ɡ o̞ i
ごいしゅう	ɡ o̞ i ɕ ɨᵝː
ごいりょく	ɡ o̞ i ɾʲ o̞ k ɯ̟ᵝ
ごうい	ɡ o̞ː i
ごうかんはん	ɡ o̞ː k ã̠ ɰ̃ h ã̠ ɴ
ごうがしゃ	ɡ o̞ː ɡ a̠ ɕ a̠
ごうぎ	ɡ o̞ː ɡʲ i
ごうけん	ɡ o̞ː k ẽ̞ ɴ
ごうご	ɡ o̞ː ɡ o̞
ごうじ	ɡ o̞ː ʑ i
ごうせつ	ɡ o̞ː s e̞ t͡s ɨᵝ
ごうだつ	ɡ o̞ː d a̠ t͡s ɨᵝ
ごうてい	ɡ o̞ː t e̞ː
ごうどうし	ɡ o̞ː d o̞ː ɕ i
ごうべんがいしゃ	ɡ o̞ː b ẽ̞ ŋ ɡ a̠ i ɕ a̠
ごうほう	ɡ o̞ː h o̞ː
ごうりてき	ɡ o̞ː ɾʲ i t e̞ kʲ i
ごうん	ɡ o̞ ɯ̟̃ᵝ ɴ
ごえもんぶろ	ɡ o̞ e̞ m õ̞ m b ɯ̟ᵝ ɾ o̞
ごおん	ɡ o̞ õ̞ ɴ
ごかん	ɡ o̞ k ã̠ ɴ
ごがつ	ɡ o̞ ɡ a̠ t͡s ɨᵝ
ごきげんよう	ɡ o̞ kʲ i ɡ ẽ̞ ɰ̃ j o̞ː
ごきょう	ɡ o̞ kʲ o̞ː
ごきょくかん	ɡ o̞ kʲ o̞ k ɯ̟̊ᵝ k ã̠ ɴ
ごぎゅう	ɡ o̞ ɡʲ ɨᵝː
ごく	ɡ o̞ k ɯ̟ᵝ
ごくあく	ɡ o̞ k ɯ̟ᵝ a̠ k ɯ̟ᵝ
ごくちゅう	ɡ o̞ k ɯ̟ᵝ t͡ɕ ɨᵝː
ごくらくちょう	ɡ o̞ k ɯ̟ᵝ ɾ a̠ k ɯ̟̊ᵝ t͡ɕ o̞ː
ごげんてき	ɡ o̞ ɡ ẽ̞ n t e̞ kʲ i
ごご	ɡ o̞ ɡ o̞
ごさ	ɡ o̞ s a̠
ござ	ɡ o̞ z a̠
ごし	ɡ o̞ ɕ i
ごしゅうしょうさまです	ɡ o̞ ɕ ɨᵝː ɕ o̞ː s a̠ m a̠ d e̞ s ɨᵝ
ごしん	ɡ o̞ ɕ ĩ ɴ
ごしんじゅつ	ɡ o̞ ɕ ĩ ɲ̟ d͡ʑ ɨᵝ t͡s ɨᵝ
ごじ	ɡ o̞ ʑ i
ごじっぽひゃっぽ	ɡ o̞ ʑ i p̚ p o̞ ç a̠ p̚ p o̞
ごじつ	ɡ o̞ ʑ i t͡s ɨᵝ
ごじゅん	ɡ o̞ ʑ ɨ̃ᵝ ɴ
ごずめず	ɡ o̞ z ɨᵝ m e̞ z ɨᵝ
ごぜんちゅう	ɡ o̞ z ẽ̞ ɲ̟ t͡ɕ ɨᵝː
ごぞうろっぷ	ɡ o̞ z o̞ː ɾ o̞ p̚ p ɯ̟ᵝ
ごだいみょうおう	ɡ o̞ d a̠ i mʲ o̞ː o̞ː
ごだんかつよう	ɡ o̞ d ã̠ ŋ k a̠ t͡s ɨᵝ j o̞ː
ごちそう	ɡ o̞ t͡ɕ i s o̞ː
ごちゃくちゃ	ɡ o̞ t͡ɕ a̠ k ɯ̟ᵝ t͡ɕ a̠
ごちゃごちゃ	ɡ o̞ t͡ɕ a̠ ɡ o̞ t͡ɕ a̠
ごちゃまぜ	ɡ o̞ t͡ɕ a̠ m a̠ z e̞
ごちょう	ɡ o̞ t͡ɕ o̞ː
ごっこ	ɡ o̞ k̚ k o̞
ごっちゃ	ɡ o̞ t̚ t͡ɕ a̠
ごつい	ɡ o̞ t͡s ɨᵝ i
ごは	ɡ o̞ h a̠
ごはん	ɡ o̞ h ã̠ ɴ
ごへい	ɡ o̞ h e̞ː
ごほう	ɡ o̞ h o̞ː
ごぼごぼ	ɡ o̞ b o̞ ɡ o̞ b o̞
ごま	ɡ o̞ m a̠
ごまかし	ɡ o̞ m a̠ k a̠ ɕ i
ごまかす	ɡ o̞ m a̠ k a̠ s ɨᵝ
ごめん	ɡ o̞ m ẽ̞ ɴ
ごめんなさい	ɡ o̞ m ẽ̞ nː a̠ s a̠ i
ごよう	ɡ o̞ j o̞ː
ごようろん	ɡ o̞ j o̞ː ɾ õ̞ ɴ
ごらんになる	ɡ o̞ ɾ ã̠ ɲ̟ ɲ̟ i n a̠ ɾ ɯ̟ᵝ
ごりんとう	ɡ o̞ ɾʲ ĩ n t o̞ː
ごろ	ɡ o̞ ɾ o̞
ごろつき	ɡ o̞ ɾ o̞ t͡s ɨᵝ kʲ i
さぁ	s a̠ː
さい	s a̠ i
さいか	s a̠ i k a̠
さいかい	s a̠ i k a̠ i
さいげつ	s a̠ i ɡ e̞ t͡s ɨᵝ
さいこう	s a̠ i k o̞ː
さいこうせい	s a̠ i k o̞ː s e̞ː
さいさつ	s a̠ i s a̠ t͡s ɨᵝ
さいしゅうび	s a̠ i ɕ ɨᵝː bʲ i
さいしょう	s a̠ i ɕ o̞ː
さいしょく	s a̠ i ɕ o̞ k ɯ̟ᵝ
さいしょくしゅぎ	s a̠ i ɕ o̞ k ɯ̟ᵝ ɕ ɨᵝ ɡʲ i
さいしん	s a̠ i ɕ ĩ ɴ
さいじょう	s a̠ i ʑ o̞ː
さいする	s a̠ i s ɨᵝ ɾ ɯ̟ᵝ
さいせき	s a̠ i s e̞ kʲ i
さいせん	s a̠ i s ẽ̞ ɴ
さいた	s a̠ i t a̠
さいたい	s a̠ i t a̠ i
さいたま	s a̠ i t a̠ m a̠
さいちょう	s a̠ i t͡ɕ o̞ː
さいでん	s a̠ i d ẽ̞ ɴ
さいなんじけん	s a̠ i n ã̠ ɲ̟ d͡ʑ i k ẽ̞ ɴ
さいにん	s a̠ i ɲ̟ ĩ ɴ
さいはて	s a̠ i h a̠ t e̞
さいばんけん	s a̠ i b ã̠ ŋ k ẽ̞ ɴ
さいふ	s a̠ i ɸ ɯ̟ᵝ
さいほうし	s a̠ i h o̞ː ɕ i
さいほくたん	s a̠ i h o̞ k ɯ̟ᵝ t ã̠ ɴ
さいみんりょうほう	s a̠ i mʲ ĩ n ɾʲ o̞ː h o̞ː
さいりょう	s a̠ i ɾʲ o̞ː
さいるいだん	s a̠ i ɾ ɯ̟ᵝ i d ã̠ ɴ
さいわい	s a̠ i ɰᵝ a̠ i
さえ	s a̠ e̞
さえぎる	s a̠ e̞ ɡʲ i ɾ ɯ̟ᵝ
さえずる	s a̠ e̞ z ɨᵝ ɾ ɯ̟ᵝ
さえもん	s a̠ e̞ m õ̞ ɴ
さえる	s a̠ e̞ ɾ ɯ̟ᵝ
さかいめ	s a̠ k a̠ i m e̞
さかえる	s a̠ k a̠ e̞ ɾ ɯ̟ᵝ
さかさ	s a̠ k a̠ s a̠
さかさよみ	s a̠ k a̠ s a̠ j o̞ m i
さかた	s a̠ k a̠ t a̠
さかな	s a̠ k a̠ n a̠
さかのぼる	s a̠ k a̠ n o̞ b o̞ ɾ ɯ̟ᵝ
さかみせ	s a̠ k a̠ mʲ i s e̞
さかみち	s a̠ k a̠ mʲ i t͡ɕ i
さかむけ	s a̠ k a̠ m ɯ̟ᵝ k e̞
さからう	s a̠ k a̠ ɾ a̠ ɯ̟ᵝ
さかん	s a̠ k ã̠ ɴ
さが	s a̠ ɡ a̠
さがく	s a̠ ɡ a̠ k ɯ̟ᵝ
さがけん	s a̠ ɡ a̠ k ẽ̞ ɴ
さがす	s a̠ ɡ a̠ s ɨᵝ
さがる	s a̠ ɡ a̠ ɾ ɯ̟ᵝ
さき	s a̠ kʲ i
さきおととし	s a̠ kʲ i o̞ t o̞ t o̞ ɕ i
さきだつ	s a̠ kʲ i d a̠ t͡s ɨᵝ
さきに	s a̠ kʲ i ɲ̟ i
さぎ	s a̠ ɡʲ i
さぎし	s a̠ ɡʲ i ɕ i
さぎょうい	s a̠ ɡʲ o̞ː i
さぎょうへんかくかつよう	s a̠ ɡʲ o̞ː
さくがんき	s a̠ k ɯ̟ᵝ ɡ ã̠ ŋʲ kʲ i
さくしゅ	s a̠ k ɯ̟̊ᵝ ɕ ɨᵝ
さくちょう	s a̠ k ɯ̟ᵝ t͡ɕ o̞ː
さくっと	s a̠ k ɯ̟ᵝ t̚ t o̞
さくてき	s a̠ k ɯ̟ᵝ t e̞ kʲ i
さくひん	s a̠ k ɯ̟̊ᵝ ç ĩ ɴ
さくもん	s a̠ k ɯ̟ᵝ m õ̞ ɴ
さくら	s a̠ k ɯ̟ᵝ ɾ a̠
さくらぎ	s a̠ k ɯ̟ᵝ ɾ a̠ ɡʲ i
さくらそう	s a̠ k ɯ̟ᵝ ɾ a̠ s o̞ː
さくらもち	s a̠ k ɯ̟ᵝ ɾ a̠ m o̞ t͡ɕ i
さくれつ	s a̠ k ɯ̟ᵝ ɾ e̞ t͡s ɨᵝ
さぐる	s a̠ ɡ ɯ̟ᵝ ɾ ɯ̟ᵝ
さけ	s a̠ k e̞
さけび	s a̠ k e̞ bʲ i
さける	s a̠ k e̞ ɾ ɯ̟ᵝ
さげる	s a̠ ɡ e̞ ɾ ɯ̟ᵝ
さこう	s a̠ k o̞ː
ささ	s a̠ s a̠
ささい	s a̠ s a̠ i
ささえ	s a̠ s a̠ e̞
ささえる	s a̠ s a̠ e̞ ɾ ɯ̟ᵝ
ささくれ	s a̠ s a̠ k ɯ̟ᵝ ɾ e̞
ささげる	s a̠ s a̠ ɡ e̞ ɾ ɯ̟ᵝ
ささやか	s a̠ s a̠ j a̠ k a̠
ささやく	s a̠ s a̠ j a̠ k ɯ̟ᵝ
ささる	s a̠ s a̠ ɾ ɯ̟ᵝ
さざなみ	s a̠ z a̠ n a̠ mʲ i
さし	s a̠ ɕ i
さしあげる	s a̠ ɕ i a̠ ɡ e̞ ɾ ɯ̟ᵝ
さしいれる	s a̠ ɕ iː ɾ e̞ ɾ ɯ̟ᵝ
さしかかる	s a̠ ɕ i k a̠ k a̠ ɾ ɯ̟ᵝ
さしさわり	s a̠ ɕ i s a̠ ɰᵝ a̠ ɾʲ i
さしひかえる	s a̠ ɕ i ç i k a̠ e̞ ɾ ɯ̟ᵝ
さしひく	s a̠ ɕ i ç i k ɯ̟ᵝ
さしぼう	s a̠ ɕ i b o̞ː
さしみぼうちょう	s a̠ ɕ i mʲ i b o̞ː t͡ɕ o̞ː
さす	s a̠ s ɨᵝ
さすが	s a̠ s ɨᵝ ɡ a̠
さすけね	s a̠ s ɨᵝ k e̞ n e̞
さずかる	s a̠ z ɨᵝ k a̠ ɾ ɯ̟ᵝ
させん	s a̠ s ẽ̞ ɴ
さそり	s a̠ s o̞ ɾʲ i
さぞ	s a̠ z o̞
さぞかし	s a̠ z o̞ k a̠ ɕ i
さだあき	s a̠ d a̠ː kʲ i
さだお	s a̠ d a̠ o̞
さだめ	s a̠ d a̠ m e̞
さだめない	s a̠ d a̠ m e̞ n a̠ i
さっかく	s a̠ k̚ k a̠ k ɯ̟ᵝ
さっかしょう	s a̠ k̚ k a̠ ɕ o̞ː
さっき	s a̠ k̚ʲ kʲ i
さっきゅう	s a̠ k̚ʲ kʲ ɨᵝː
さっさと	s a̠ sː a̠ t o̞
さっしょう	s a̠ ɕː o̞ː
さっしん	s a̠ ɕː ĩ ɴ
さっちゅう	s a̠ t̚ t͡ɕ ɨᵝː
さっぱり	s a̠ p̚ p a̠ ɾʲ i
さっぷうけい	s a̠ p̚ p ɯ̟ᵝː k e̞ː
さついれ	s a̠ t͡s ɨᵝ i ɾ e̞
さつえい	s a̠ t͡s ɨᵝ e̞ː
さつがい	s a̠ t͡s ɨᵝ ɡ a̠ i
さつばつ	s a̠ t͡s ɨᵝ b a̠ t͡s ɨᵝ
さてつ	s a̠ t e̞ t͡s ɨᵝ
さと	s a̠ t o̞
さとい	s a̠ t o̞ i
さとうきび	s a̠ t o̞ː kʲ i bʲ i
さとうや	s a̠ t o̞ː j a̠
さとす	s a̠ t o̞ s ɨᵝ
さとつ	s a̠ t o̞ t͡s ɨᵝ
さとやま	s a̠ t o̞ j a̠ m a̠
さとる	s a̠ t o̞ ɾ ɯ̟ᵝ
さどう	s a̠ d o̞ː
さなえ	s a̠ n a̠ e̞
さなぎ	s a̠ n a̠ ɡʲ i
さなだひも	s a̠ n a̠ d a̠ ç i m o̞
さば	s a̠ b a̠
さばく	s a̠ b a̠ k ɯ̟ᵝ
さばひい	s a̠ b a̠ ç iː
さびしい	s a̠ bʲ i ɕ iː
さびつく	s a̠ bʲ i t͡s ɨᵝ k ɯ̟ᵝ
さびる	s a̠ bʲ i ɾ ɯ̟ᵝ
さべつ	s a̠ b e̞ t͡s ɨᵝ
さほひめ	s a̠ h o̞ ç i m e̞
さま	s a̠ m a̠
さます	s a̠ m a̠ s ɨᵝ
さまよう	s a̠ m a̠ j o̞ ɯ̟ᵝ
さみだれ	s a̠ mʲ i d a̠ ɾ e̞
さむい	s a̠ m ɯ̟ᵝ i
さめ	s a̠ m e̞
さやとり	s a̠ j a̠ t o̞ ɾʲ i
さゆ	s a̠ j ɯ̟ᵝ
さよ	s a̠ j o̞
さよう	s a̠ j o̞ː
さようなら	s a̠ j o̞ː n a̠ ɾ a̠
さよなら	s a̠ j o̞ n a̠ ɾ a̠
さらあらい	s a̠ ɾ a̠ a̠ ɾ a̠ i
さらう	s a̠ ɾ a̠ ɯ̟ᵝ
さらけだす	s a̠ ɾ a̠ k e̞ d a̠ s ɨᵝ
さらし	s a̠ ɾ a̠ ɕ i
さらす	s a̠ ɾ a̠ s ɨᵝ
さらそうじゅ	s a̠ ɾ a̠ s o̞ː ʑ ɨᵝ
さらち	s a̠ ɾ a̠ t͡ɕ i
さらなる	s a̠ ɾ a̠ n a̠ ɾ ɯ̟ᵝ
さる	s a̠ ɾ ɯ̟ᵝ
さるしばい	s a̠ ɾ ɯ̟ᵝ ɕ i b a̠ i
さるすべり	s a̠ ɾ ɯ̟ᵝ s ɨᵝ b e̞ ɾʲ i
さわ	s a̠ ɰᵝ a̠
さわがしい	s a̠ ɰᵝ a̠ ɡ a̠ ɕ i i
さわやか	s a̠ ɰᵝ a̠ j a̠ k a̠
さわらん	s a̠ ɰᵝ a̠ ɾ ã̠ ɴ
さわり	s a̠ ɰᵝ a̠ ɾʲ i
さわる	s a̠ ɰᵝ a̠ ɾ ɯ̟ᵝ
さん	s ã̠ ɴ
さんかくざ	s ã̠ ŋ k a̠ k ɯ̟ᵝ z a̠
さんかくす	s ã̠ ŋ k a̠ k ɯ̟̊ᵝ s ɨᵝ
さんかん	s ã̠ ŋ k ã̠ ɴ
さんきょくかん	s ã̠ ŋʲ kʲ o̞ k ɯ̟̊ᵝ k ã̠ ɴ
さんぎょう	s ã̠ ŋʲ ɡʲ o̞ː
さんけっしょう	s ã̠ ŋ k e̞ ɕː o̞ː
さんけん	s ã̠ ŋ k ẽ̞ ɴ
さんげ	s ã̠ ŋ ɡ e̞
さんこう	s ã̠ ŋ k o̞ː
さんさく	s ã̠ ɰ̃ s a̠ k ɯ̟ᵝ
さんした	s ã̠ ɰ̃ ɕ i t a̠
さんしょううお	s ã̠ ɰ̃ ɕ o̞ː ɯ̟ᵝ o̞
さんじゅういち	s ã̠ ɲ̟ d͡ʑ ɨᵝː i t͡ɕ i
さんじゅういちにち	s ã̠ ɲ̟ d͡ʑ ɨᵝː i t͡ɕ i ɲ̟ i t͡ɕ i
さんじゅうし	s ã̠ ɲ̟ d͡ʑ ɨᵝː ɕ i
さんじゅうすいそ	s ã̠ ɲ̟ d͡ʑ ɨᵝː s ɨᵝ i s o̞
さんじゅつえんざん	s ã̠ ɲ̟ d͡ʑ ɨᵝ t͡s ɨᵝ ẽ̞ n d͡z ã̠ ɴ
さんじょ	s ã̠ ɲ̟ d͡ʑ o̞
さんじょうき	s ã̠ ɲ̟ d͡ʑ o̞ː kʲ i
さんじょうこん	s ã̠ ɲ̟ d͡ʑ o̞ː k õ̞ ɴ
さんぞう	s ã̠ n d͡z o̞ː
さんたい	s ã̠ n t a̠ i
さんだん	s ã̠ n d ã̠ ɴ
さんだんじゅう	s ã̠ n d ã̠ ɲ̟ d͡ʑ ɨᵝː
さんち	s ã̠ ɲ̟ t͡ɕ i
さんちょう	s ã̠ ɲ̟ t͡ɕ o̞ː
さんば	s ã̠ m b a̠
さんぱくがん	s ã̠ m p a̠ k ɯ̟ᵝ ɡ ã̠ ɴ
さんぶつ	s ã̠ m b ɯ̟ᵝ t͡s ɨᵝ
さんぶつげ	s ã̠ m b ɯ̟ᵝ t͡s ɨᵝ ɡ e̞
さんぷく	s ã̠ m p ɯ̟ᵝ k ɯ̟ᵝ
さんぽ	s ã̠ m p o̞
さんま	s ã̠ mː a̠
さんまい	s ã̠ mː a̠ i
さんまいめ	s ã̠ mː a̠ i m e̞
さんみいったい	s ã̠ mʲː i i t̚ t a̠ i
さんみつ	s ã̠ mʲː i t͡s ɨᵝ
さんるい	s ã̠ n ɾ ɯ̟ᵝ i
ざいごう	d͡z a̠ i ɡ o̞ː
ざいにち	d͡z a̠ i ɲ̟ i t͡ɕ i
ざいらいせん	d͡z a̠ i ɾ a̠ i s ẽ̞ ɴ
ざいりゅうほうじん	d͡z a̠ i ɾʲ ɨᵝː h o̞ː ʑ ĩ ɴ
ざく	d͡z a̠ k ɯ̟ᵝ
ざくろ	d͡z a̠ k ɯ̟ᵝ ɾ o̞
ざくろいし	d͡z a̠ k ɯ̟ᵝ ɾ o̞ i ɕ i
ざこつしんけい	d͡z a̠ k o̞ t͡s ɨᵝ ɕ ĩ ŋ k e̞ː
ざせき	d͡z a̠ s e̞ kʲ i
ざせつ	d͡z a̠ s e̞ t͡s ɨᵝ
ざっこく	d͡z a̠ k̚ k o̞ k ɯ̟ᵝ
ざっこん	d͡z a̠ k̚ k õ̞ ɴ
ざっさん	d͡z a̠ sː ã̠ ɴ
ざっしょく	d͡z a̠ ɕː o̞ k ɯ̟ᵝ
ざっとう	d͡z a̠ t̚ t o̞ː
ざつがく	d͡z a̠ t͡s ɨᵝ ɡ a̠ k ɯ̟ᵝ
ざつよう	d͡z a̠ t͡s ɨᵝ j o̞ː
ざとうむし	d͡z a̠ t o̞ː m ɯ̟ᵝ ɕ i
ざひょう	d͡z a̠ ç o̞ː
ざぶとん	d͡z a̠ b ɯ̟ᵝ t õ̞ ɴ
ざほう	d͡z a̠ h o̞ː
ざゆうのめい	d͡z a̠ j ɯ̟ᵝː n o̞ m e̞ː
ざら	d͡z a̠ ɾ a̠
ざるそば	d͡z a̠ ɾ ɯ̟ᵝ s o̞ b a̠
ざん	d͡z ã̠ ɴ
ざんがく	d͡z ã̠ ŋ ɡ a̠ k ɯ̟ᵝ
ざんきん	d͡z ã̠ ŋʲ kʲ ĩ ɴ
ざんこく	d͡z ã̠ ŋ k o̞ k ɯ̟ᵝ
ざんし	d͡z ã̠ ɰ̃ ɕ i
ざんしん	d͡z ã̠ ɰ̃ ɕ ĩ ɴ
ざんてい	d͡z ã̠ n t e̞ː
ざんとく	d͡z ã̠ n t o̞ k ɯ̟ᵝ
ざんにゅう	d͡z ã̠ ɲ̟ ɲ̟ ɯ̟ᵝː
ざんにん	d͡z ã̠ ɲ̟ ɲ̟ ĩ ɴ
ざんねん	d͡z ã̠ nː ẽ̞ ɴ
ざんぷく	d͡z ã̠ m p ɯ̟ᵝ k ɯ̟ᵝ
しあがり	ɕ i a̠ ɡ a̠ ɾʲ i
しあわせ	ɕ i a̠ ɰᵝ a̠ s e̞
しいたけ	ɕ iː t a̠ k e̞
しいな	ɕ iː n a̠
しいれ	ɕ iː ɾ e̞
しお	ɕ i o̞
しおう	ɕ i o̞ː
しおから	ɕ i o̞ k a̠ ɾ a̠
しおからい	ɕ i o̞ k a̠ ɾ a̠ i
しおしお	ɕ i o̞ ɕ i o̞
しおり	ɕ i o̞ ɾʲ i
しかく	ɕ i̥ k a̠ k ɯ̟ᵝ
しかくすい	ɕ i k a̠ k ɯ̟ᵝ s ɨᵝ i
しかけ	ɕ i k a̠ k e̞
しかけにん	ɕ i k a̠ k e̞ ɲ̟ ĩ ɴ
しかける	ɕ i k a̠ k e̞ ɾ ɯ̟ᵝ
しかたない	ɕ i k a̠ t a̠ n a̠ i
しかめる	ɕ i k a̠ m e̞ ɾ ɯ̟ᵝ
しかも	ɕ i k a̠ m o̞
しかり	ɕ i k a̠ ɾʲ i
しかりつける	ɕ i̥ k a̠ ɾʲ i t͡s ɨ̥ᵝ k e̞ ɾ ɯ̟ᵝ
しかる	ɕ i k a̠ ɾ ɯ̟ᵝ
しかん	ɕ i k ã̠ ɴ
しかんしき	ɕ i k ã̠ ɰ̃ ɕ i kʲ i
しがいせん	ɕ i ɡ a̠ i s ẽ̞ ɴ
しがみつく	ɕ i ɡ a̠ mʲ i t͡s ɨ̥ᵝ k ɯ̟ᵝ
しきかくいじょう	ɕ i̥ kʲ i k a̠ k ɯ̟ᵝ i ʑ o̞ː
しきたり	ɕ i kʲ i t a̠ ɾʲ i
しきちない	ɕ i kʲ i t͡ɕ i n a̠ i
しきべつ	ɕ i kʲ i b e̞ t͡s ɨᵝ
しきものるい	ɕ i kʲ i m o̞ n o̞ ɾ ɯ̟ᵝ i
しきょ	ɕ i kʲ o̞
しきり	ɕ i kʲ i ɾʲ i
しきる	ɕ i kʲ i ɾ ɯ̟ᵝ
しぎんえん	ɕ i ɡʲ ĩ ɰ̃ ẽ̞ ɴ
しく	ɕ i k ɯ̟ᵝ
しくじる	ɕ i k ɯ̟ᵝ ʑ i ɾ ɯ̟ᵝ
しくんし	ɕ i k ɯ̟̃ᵝ ɰ̃ ɕ i
しぐれ	ɕ i ɡ ɯ̟ᵝ ɾ e̞
しける	ɕ i k e̞ ɾ ɯ̟ᵝ
しけん	ɕ i k ẽ̞ ɴ
しげお	ɕ i ɡ e̞ o̞
しげる	ɕ i ɡ e̞ ɾ ɯ̟ᵝ
しころ	ɕ i k o̞ ɾ o̞
しさん	ɕ i s ã̠ ɴ
しざい	ɕ i z a̠ i
ししきゅう	ɕ i̥ ɕ i kʲ ɨᵝː
ししまい	ɕ i ɕ i m a̠ i
ししゃかい	ɕ i ɕ a̠ k a̠ i
ししゃごにゅう	ɕ i ɕ a̠ ɡ o̞ ɲ̟ ɯ̟ᵝː
ししゃしつ	ɕ i ɕ a̠ ɕ i t͡s ɨᵝ
ししゅう	ɕ i ɕ ɨᵝː
ししゅうびょう	ɕ i ɕ ɨᵝː bʲ o̞ː
ししょ	ɕ i ɕ o̞
ししょう	ɕ i ɕ o̞ː
ししょごきょう	ɕ i ɕ o̞ ɡ o̞ kʲ o̞ː
しじつ	ɕ i ʑ i t͡s ɨᵝ
しじゅうから	ɕ i ʑ ɨᵝː k a̠ ɾ a̠
しじょ	ɕ i ʑ o̞
しする	ɕ i s ɨᵝ ɾ ɯ̟ᵝ
しずか	ɕ i z ɨᵝ k a̠
しずく	ɕ i z ɨᵝ k ɯ̟ᵝ
しずめる	ɕ i z ɨᵝ m e̞ ɾ ɯ̟ᵝ
しせい	ɕ i s e̞ː
しせいかつ	ɕ i s e̞ː k a̠ t͡s ɨᵝ
しせいかんせん	ɕ i s e̞ː k ã̠ ɰ̃ s ẽ̞ ɴ
しせいどう	ɕ i s e̞ː d o̞ː
しせきえい	ɕ i s e̞ kʲ i e̞ː
しせん	ɕ i s ẽ̞ ɴ
しぜん	ɕ i z ẽ̞ ɴ
しぜんかんきょう	ɕ i z ẽ̞ ŋ k ã̠ ŋʲ kʲ o̞ː
しぜんげんご	ɕ i z ẽ̞ ŋ ɡ ẽ̞ ŋ ɡ o̞
しぜんげんしょう	ɕ i z ẽ̞ ŋ ɡ ẽ̞ ɰ̃ ɕ o̞ː
しぜんすう	ɕ i z ẽ̞ ɰ̃ s ɨᵝː
しぜんせんたく	ɕ i z ẽ̞ ɰ̃ s ẽ̞ n t a̠ k ɯ̟ᵝ
しぜんてき	ɕ i z ẽ̞ n t e̞ kʲ i
しそつ	ɕ i s o̞ t͡s ɨᵝ
したい	ɕ i t a̠ i
したがう	ɕ i t a̠ ɡ a̠ ɯ̟ᵝ
したがえる	ɕ i t a̠ ɡ a̠ e̞ ɾ ɯ̟ᵝ
したくちびる	ɕ i t a̠ k ɯ̟ᵝ t͡ɕ i bʲ i ɾ ɯ̟ᵝ
したごしらえ	ɕ i t a̠ ɡ o̞ ɕ i ɾ a̠ e̞
したさきさんずん	ɕ i t a̠ s a̠ kʲ i s ã̠ n d͡z ɨ̃ᵝ ɴ
したしむ	ɕ i t a̠ ɕ i m ɯ̟ᵝ
したじ	ɕ i t a̠ ʑ i
したたか	ɕ i t a̠ t a̠ k a̠
したたる	ɕ i t a̠ t a̠ ɾ ɯ̟ᵝ
したて	ɕ i t a̠ t e̞
したてる	ɕ i t a̠ t e̞ ɾ ɯ̟ᵝ
したどり	ɕ i t a̠ d o̞ ɾʲ i
したら	ɕ i t a̠ ɾ a̠
しだいに	ɕ i d a̠ i ɲ̟ i
しちせい	ɕ i t͡ɕ i s e̞ː
しちょうりつ	ɕ i t͡ɕ o̞ː ɾʲ i t͡s ɨᵝ
しちよう	ɕ i t͡ɕ i j o̞ː
しっかく	ɕ i k̚ k a̠ k ɯ̟ᵝ
しっかり	ɕ i k̚ k a̠ ɾʲ i
しっくい	ɕ i k̚ k ɯ̟ᵝ i
しっけいせんばん	ɕ i k̚ k e̞ː s ẽ̞ m b ã̠ ɴ
しっしん	ɕ i̥ ɕː ĩ ɴ
しっそう	ɕ i s s o̞ː
しったつり	ɕ i t̚ t a̠ t͡s ɨᵝ ɾʲ i
しったんもじ	ɕ i t̚ t ã̠ m m o̞ ʑ i
しっちょう	ɕ i t̚ t͡ɕ o̞ː
しっぷうどとう	ɕ i̥ p̚ p ɯ̟ᵝː d o̞ t o̞ː
しっぽ	ɕ i p̚ p o̞
しっぽうやき	ɕ i p̚ p o̞ː j a̠ kʲ i
しつ	ɕ i t͡s ɨᵝ
しつぎ	ɕ i t͡s ɨᵝ ɡʲ i
しつぎおうとう	ɕ i t͡s ɨᵝ ɡʲ i o̞ː t o̞ː
しつげん	ɕ i t͡s ɨᵝ ɡ ẽ̞ ɴ
しつこい	ɕ i t͡s ɨᵝ k o̞ i
しつどくしょう	ɕ i t͡s ɨᵝ d o̞ k ɯ̟ᵝ ɕ o̞ː
しつないがく	ɕ i̥ t͡s ɨᵝ n a̠ i ɡ a̠ k ɯ̟ᵝ
しつないきょうぎ	ɕ i t͡s ɨᵝ n a̠ i kʲ o̞ː ɡʲ i
しつないゆうぎ	ɕ i t͡s ɨᵝ n a̠ i j ɯ̟ᵝː ɡʲ i
しつねん	ɕ i̥ t͡s ɨᵝ n ẽ̞ ɴ
していせき	ɕ i̥ t e̞ː s e̞ kʲ i
してき	ɕ i t e̞ kʲ i
してんのう	ɕ i t ẽ̞ nː o̞ː
しでん	ɕ i d ẽ̞ ɴ
しと	ɕ i t o̞
しとぎょうでん	ɕ i t o̞ ɡʲ o̞ː d ẽ̞ ɴ
しとめる	ɕ i t o̞ m e̞ ɾ ɯ̟ᵝ
しとやか	ɕ i t o̞ j a̠ k a̠
しどう	ɕ i d o̞ː
しどうしゃ	ɕ i d o̞ː ɕ a̠
しな	ɕ i n a̠
しなぎれ	ɕ i n a̠ ɡʲ i ɾ e̞
しなつう	ɕ i n a̠ t͡s ɨᵝː
しなやか	ɕ i n a̠ j a̠ k a̠
しに	ɕ i ɲ̟ i
しにかける	ɕ i ɲ̟ i k a̠ k e̞ ɾ ɯ̟ᵝ
しにせ	ɕ i ɲ̟ i s e̞
しにぞこない	ɕ i ɲ̟ i z o̞ k o̞ n a̠ i
しにものぐるい	ɕ i ɲ̟ i m o̞ n o̞ ɡ ɯ̟ᵝ ɾ ɯ̟ᵝ i
しぬ	ɕ i n ɯ̟ᵝ
しの	ɕ i n o̞
しのぐ	ɕ i n o̞ ɡ ɯ̟ᵝ
しのび	ɕ i n o̞ bʲ i
しのびこむ	ɕ i n o̞ bʲ i k o̞ m ɯ̟ᵝ
しのびのもの	ɕ i n o̞ bʲ i n o̞ m o̞ n o̞
しのぶ	ɕ i n o̞ b ɯ̟ᵝ
しのやき	ɕ i n o̞ j a̠ kʲ i
しはい	ɕ i h a̠ i
しはいにん	ɕ i h a̠ i ɲ̟ ĩ ɴ
しはらい	ɕ i h a̠ ɾ a̠ i
しば	ɕ i b a̠
しばい	ɕ i b a̠ i
しばし	ɕ i b a̠ ɕ i
しばしば	ɕ i b a̠ ɕ i b a̠
しふ	ɕ i ɸ ɯ̟ᵝ
しふう	ɕ i ɸ ɯ̟ᵝː
しふく	ɕ i ɸ ɯ̟ᵝ k ɯ̟ᵝ
しぶつ	ɕ i b ɯ̟ᵝ t͡s ɨᵝ
しぶとい	ɕ i b ɯ̟ᵝ t o̞ i
しぶる	ɕ i b ɯ̟ᵝ ɾ ɯ̟ᵝ
しへい	ɕ i h e̞ː
しへんけい	ɕ i̥ h ẽ̞ ŋ k e̞ː
しぼうこう	ɕ i b o̞ː k o̞ː
しぼうぞく	ɕ i b o̞ː z o̞ k ɯ̟ᵝ
しぼりこむ	ɕ i b o̞ ɾʲ i k o̞ m ɯ̟ᵝ
しぼる	ɕ i b o̞ ɾ ɯ̟ᵝ
しま	ɕ i m a̠
しまい	ɕ i m a̠ i
しまう	ɕ i m a̠ ɯ̟ᵝ
しまぐに	ɕ i m a̠ ɡ ɯ̟ᵝ ɲ̟ i
しまった	ɕ i m a̠ t̚ t a̠
しまながし	ɕ i m a̠ n a̠ ɡ a̠ ɕ i
しまね	ɕ i m a̠ n e̞
しまる	ɕ i m a̠ ɾ ɯ̟ᵝ
しみ	ɕ i mʲ i
しみいる	ɕ i mʲ i i ɾ ɯ̟ᵝ
しむ	ɕ i m ɯ̟ᵝ
しめ	ɕ i m e̞
しめい	ɕ i m e̞ː
しめきり	ɕ i m e̞ kʲ i ɾʲ i
しめす	ɕ i m e̞ s ɨᵝ
しめる	ɕ i m e̞ ɾ ɯ̟ᵝ
しめん	ɕ i m ẽ̞ ɴ
しめんたい	ɕ i m ẽ̞ n t a̠ i
しも	ɕ i m o̞
しもせかやく	ɕ i m o̞ s e̞ k a̠ j a̠ k ɯ̟ᵝ
しもだ	ɕ i m o̞ d a̠
しゃ	ɕ a̠
しゃい	ɕ a̠ i
しゃかいかがく	ɕ a̠ k a̠ i k a̠ ɡ a̠ k ɯ̟ᵝ
しゃかいちつじょ	ɕ a̠ k a̠ i t͡ɕ i t͡s ɨᵝ ʑ o̞
しゃがむ	ɕ a̠ ɡ a̠ m ɯ̟ᵝ
しゃがれる	ɕ a̠ ɡ a̠ ɾ e̞ ɾ ɯ̟ᵝ
しゃきょう	ɕ a̠ kʲ o̞ː
しゃく	ɕ a̠ k ɯ̟ᵝ
しゃくいち	ɕ a̠ k ɯ̟ᵝ i t͡ɕ i
しゃくしぎ	ɕ a̠ k ɯ̟̊ᵝ ɕ i ɡʲ i
しゃくしじょうぎ	ɕ a̠ k ɯ̟ᵝ ɕ i d͡ʑ o̞ː ɡʲ i
しゃくやく	ɕ a̠ k ɯ̟ᵝ j a̠ k ɯ̟ᵝ
しゃくようご	ɕ a̠ k ɯ̟ᵝ j o̞ː ɡ o̞
しゃくりあげる	ɕ a̠ k ɯ̟ᵝ ɾʲ i a̠ ɡ e̞ ɾ ɯ̟ᵝ
しゃしゅつざせき	ɕ a̠ ɕ ɨᵝ t͡s ɨᵝ d͡z a̠ s e̞ kʲ i
しゃじつしゅぎ	ɕ a̠ ʑ i t͡s ɨᵝ ɕ ɨᵝ ɡʲ i
しゃすいへき	ɕ a̠ s ɨᵝ i h e̞ kʲ i
しゃせい	ɕ a̠ s e̞ː
しゃだん	ɕ a̠ d ã̠ ɴ
しゃだんき	ɕ a̠ d ã̠ ŋʲ kʲ i
しゃっきん	ɕ a̠ k̚ʲ kʲ ĩ ɴ
しゃてい	ɕ a̠ t e̞ː
しゃどう	ɕ a̠ d o̞ː
しゃばく	ɕ a̠ b a̠ k ɯ̟ᵝ
しゃみ	ɕ a̠ mʲ i
しゃようぞく	ɕ a̠ j o̞ː z o̞ k ɯ̟ᵝ
しやくしょ	ɕ i j a̠ k ɯ̟̊ᵝ ɕ o̞
しゅい	ɕ ɨᵝ i
しゅう	ɕ ɨᵝː
しゅういん	ɕ ɨᵝː ĩ ɴ
しゅうえきか	ɕ ɨᵝː e̞ kʲ i k a̠
しゅうかく	ɕ ɨᵝː k a̠ k ɯ̟ᵝ
しゅうかん	ɕ ɨᵝː k ã̠ ɴ
しゅうき	ɕ ɨᵝː kʲ i
しゅうきひょう	ɕ ɨᵝː kʲ i̥ ç o̞ː
しゅうさく	ɕ ɨᵝː s a̠ k ɯ̟ᵝ
しゅうさん	ɕ ɨᵝː s ã̠ ɴ
しゅうしゅう	ɕ ɨᵝː ɕ ɨᵝː
しゅうしょう	ɕ ɨᵝː ɕ o̞ː
しゅうじがく	ɕ ɨᵝː ʑ i ɡ a̠ k ɯ̟ᵝ
しゅうじょし	ɕ ɨᵝː ʑ o̞ ɕ i
しゅうそ	ɕ ɨᵝː s o̞
しゅうそく	ɕ ɨᵝː s o̞ k ɯ̟ᵝ
しゅうたい	ɕ ɨᵝː t a̠ i
しゅうちゅう	ɕ ɨᵝː t͡ɕ ɨᵝː
しゅうちゅうりょく	ɕ ɨᵝː t͡ɕ ɨᵝː ɾʲ o̞ k ɯ̟ᵝ
しゅうどうしゃ	ɕ ɨᵝː d o̞ː ɕ a̠
しゅうどうふ	ɕ ɨᵝː d o̞ː ɸ ɯ̟ᵝ
しゅうねん	ɕ ɨᵝː n ẽ̞ ɴ
しゅうぶん	ɕ ɨᵝː b ɯ̟̃ᵝ ɴ
しゅうぶんてん	ɕ ɨᵝː b ɯ̟̃ᵝ n t ẽ̞ ɴ
しゅうめい	ɕ ɨᵝː m e̞ː
しゅうらい	ɕ ɨᵝː ɾ a̠ i
しゅえん	ɕ ɨᵝ ẽ̞ ɴ
しゅかん	ɕ ɨᵝ k ã̠ ɴ
しゅぎ	ɕ ɨᵝ ɡʲ i
しゅくがかい	ɕ ɨᵝ k ɯ̟ᵝ ɡ a̠ k a̠ i
しゅくせい	ɕ ɨᵝ k ɯ̟ᵝ s e̞ː
しゅけん	ɕ ɨᵝ k ẽ̞ ɴ
しゅこう	ɕ ɨᵝ k o̞ː
しゅさい	ɕ ɨᵝ s a̠ i
しゅざん	ɕ ɨᵝ z ã̠ ɴ
しゅじく	ɕ ɨᵝ ʑ i k ɯ̟ᵝ
しゅじん	ɕ ɨᵝ ʑ ĩ ɴ
しゅじんこうほせい	ɕ ɨᵝ ʑ ĩ ŋ k o̞ː h o̞ s e̞ː
しゅぞう	ɕ ɨᵝ z o̞ː
しゅぞく	ɕ ɨᵝ z o̞ k ɯ̟ᵝ
しゅたい	ɕ ɨᵝ t a̠ i
しゅだい	ɕ ɨᵝ d a̠ i
しゅっきん	ɕ ɨᵝ k̚ʲ kʲ ĩ ɴ
しゅっこう	ɕ ɨᵝ k̚ k o̞ː
しゅっしゃ	ɕ ɨᵝ ɕː a̠
しゅっしんせいぶん	ɕ ɨᵝ ɕː ĩ ɰ̃ s e̞ː b ɯ̟̃ᵝ ɴ
しゅっぱつ	ɕ ɨᵝ p̚ p a̠ t͡s ɨᵝ
しゅっぴ	ɕ ɨᵝ p̚ʲ pʲ i
しゅっぺい	ɕ ɨᵝ p̚ p e̞ː
しゅつりょく	ɕ ɨᵝ t͡s ɨᵝ ɾʲ o̞ k ɯ̟ᵝ
しゅつるい	ɕ ɨᵝ t͡s ɨᵝ ɾ ɯ̟ᵝ i
しゅと	ɕ ɨᵝ t o̞
しゅとう	ɕ ɨᵝ t o̞ː
しゅひ	ɕ ɨᵝ ç i
しゅび	ɕ ɨᵝ bʲ i
しゅほう	ɕ ɨᵝ h o̞ː
しゅもくざめ	ɕ ɨᵝ m o̞ k ɯ̟ᵝ z a̠ m e̞
しゅゆ	ɕ ɨᵝ j ɯ̟ᵝ
しゅよう	ɕ ɨᵝ j o̞ː
しゅらばる	ɕ ɨᵝ ɾ a̠ b a̠ ɾ ɯ̟ᵝ
しゅをいれる	ɕ ɨᵝ o̞ i ɾ e̞ ɾ ɯ̟ᵝ
しゅんかしゅうとう	ɕ ɨ̃ᵝ ŋ k a̠ ɕ ɨᵝː t o̞ː
しゅんかん	ɕ ɨ̃ᵝ ŋ k ã̠ ɴ
しゅんき	ɕ ɨ̃ᵝ ŋʲ kʲ i
しゅんげん	ɕ ɨ̃ᵝ ŋ ɡ ẽ̞ ɴ
しゅんじつ	ɕ ɨ̃ᵝ ɲ̟ d͡ʑ i t͡s ɨᵝ
しゅんせつ	ɕ ɨ̃ᵝ ɰ̃ s e̞ t͡s ɨᵝ
しゅんまく	ɕ ɨ̃ᵝ mː a̠ k ɯ̟ᵝ
しゅんみんあかつきをおぼえず	ɕ ɨ̃ᵝ mʲː ĩ ɰ̃ a̠ k a̠ t͡s ɨᵝ kʲ i o̞ o̞ b o̞ e̞ z ɨᵝ
しょいん	ɕ o̞ ĩ ɴ
しょういち	ɕ o̞ː i t͡ɕ i
しょうえんせい	ɕ o̞ː ẽ̞ ɰ̃ s e̞ː
しょうかき	ɕ o̞ː k a̠ kʲ i
しょうかせん	ɕ o̞ː k a̠ s ẽ̞ ɴ
しょうかたい	ɕ o̞ː k a̠ t a̠ i
しょうかんじゅう	ɕ o̞ː k ã̠ ɲ̟ d͡ʑ ɨᵝː
しょうが	ɕ o̞ː ɡ a̠
しょうがっこう	ɕ o̞ː ɡ a̠ k̚ k o̞ː
しょうがない	ɕ o̞ː ɡ a̠ n a̠ i
しょうけん	ɕ o̞ː k ẽ̞ ɴ
しょうげきは	ɕ o̞ː ɡ e̞ kʲ i̥ ɰᵝ a̠
しょうこ	ɕ o̞ː k o̞
しょうこう	ɕ o̞ː k o̞ː
しょうしつ	ɕ o̞ː ɕ i t͡s ɨᵝ
しょうしょう	ɕ o̞ː ɕ o̞ː
しょうじゅう	ɕ o̞ː ʑ ɨᵝː
しょうじょ	ɕ o̞ː ʑ o̞
しょうすい	ɕ o̞ː s ɨᵝ i
しょうすう	ɕ o̞ː s ɨᵝː
しょうすうは	ɕ o̞ː s ɨᵝː h a̠
しょうせき	ɕ o̞ː s e̞ kʲ i
しょうせつ	ɕ o̞ː s e̞ t͡s ɨᵝ
しょうせん	ɕ o̞ː s ẽ̞ ɴ
しょうぜんていせん	ɕ o̞ː z ẽ̞ n t e̞ː s ẽ̞ ɴ
しょうそ	ɕ o̞ː s o̞
しょうぞく	ɕ o̞ː z o̞ k ɯ̟ᵝ
しょうちょうてき	ɕ o̞ː t͡ɕ o̞ː t e̞ kʲ i
しょうでんきん	ɕ o̞ː d ẽ̞ ŋʲ kʲ ĩ ɴ
しょうとう	ɕ o̞ː t o̞ː
しょうどう	ɕ o̞ː d o̞ː
しょうどうがい	ɕ o̞ː d o̞ː ɡ a̠ i
しょうねんあい	ɕ o̞ː n ẽ̞ ɰ̃ a̠ i
しょうねんおいやすくがくなりがたし	ɕ o̞ː n ẽ̞ ɰ̃ o̞ i j a̠ s ɨᵝ k ɯ̟ᵝ ɡ a̠ k ɯ̟ᵝ n a̠ ɾʲ i ɡ a̠ t a̠ ɕ i
しょうねんば	ɕ o̞ː n ẽ̞ m b a̠
しょうひきげん	ɕ o̞ː ç i kʲ i ɡ ẽ̞ ɴ
しょうひん	ɕ o̞ː ç ĩ ɴ
しょうふ	ɕ o̞ː ɸ ɯ̟ᵝ
しょうぶ	ɕ o̞ː b ɯ̟ᵝ
しょうぼう	ɕ o̞ː b o̞ː
しょうぼうしょ	ɕ o̞ː b o̞ː ɕ o̞
しょうまん	ɕ o̞ː m ã̠ ɴ
しょうみ	ɕ o̞ː mʲ i
しょうめい	ɕ o̞ː m e̞ː
しょうもうひん	ɕ o̞ː m o̞ː ç ĩ ɴ
しょうやく	ɕ o̞ː j a̠ k ɯ̟ᵝ
しょうよう	ɕ o̞ː j o̞ː
しょうり	ɕ o̞ː ɾʲ i
しょうりんじけんぽう	ɕ o̞ː ɾʲ ĩ ɲ̟ d͡ʑ i k ẽ̞ m p o̞ː
しょうわくせい	ɕ o̞ː ɰᵝ a̠ k ɯ̟̊ᵝ s e̞ː
しょき	ɕ o̞ kʲ i
しょきちょう	ɕ o̞ kʲ i t͡ɕ o̞ː
しょきゅう	ɕ o̞ kʲ ɨᵝː
しょぎょうむじょう	ɕ o̞ ɡʲ o̞ː m ɯ̟ᵝ ʑ o̞ː
しょく	ɕ o̞ k ɯ̟ᵝ
しょくい	ɕ o̞ k ɯ̟ᵝ i
しょくかん	ɕ o̞ k ɯ̟ᵝ k ã̠ ɴ
しょくがん	ɕ o̞ k ɯ̟ᵝ ɡ ã̠ ɴ
しょくざい	ɕ o̞ k ɯ̟ᵝ z a̠ i
しょくちゅう	ɕ o̞ k ɯ̟ᵝ t͡ɕ ɨᵝː
しょくどう	ɕ o̞ k ɯ̟ᵝ d o̞ː
しょくにん	ɕ o̞ k ɯ̟ᵝ ɲ̟ ĩ ɴ
しょくぶつじょうたい	ɕ o̞ k ɯ̟ᵝ b ɯ̟ᵝ t͡s ɨᵝ d͡ʑ o̞ː t a̠ i
しょくもつ	ɕ o̞ k ɯ̟ᵝ m o̞ t͡s ɨᵝ
しょくわん	ɕ o̞ k ɯ̟ᵝ ɰᵝ ã̠ ɴ
しょくん	ɕ o̞ k ɯ̟̃ᵝ ɴ
しょぐう	ɕ o̞ ɡ ɯ̟ᵝː
しょけん	ɕ o̞ k ẽ̞ ɴ
しょしん	ɕ o̞ ɕ ĩ ɴ
しょじにん	ɕ o̞ ʑ i ɲ̟ ĩ ɴ
しょす	ɕ o̞ s ɨᵝ
しょせいじゅつ	ɕ o̞ s e̞ː ʑ ɨᵝ t͡s ɨᵝ
しょせき	ɕ o̞ s e̞ kʲ i
しょたい	ɕ o̞ t a̠ i
しょっかん	ɕ o̞ k̚ k ã̠ ɴ
しょっきだな	ɕ o̞ k̚ʲ kʲ i d a̠ n a̠
しょっちゅう	ɕ o̞ t̚ t͡ɕ ɨᵝː
しょっぱい	ɕ o̞ p̚ p a̠ i
しょとくぜい	ɕ o̞ t o̞ k ɯ̟ᵝ z e̞ː
しょねん	ɕ o̞ n ẽ̞ ɴ
しょはん	ɕ o̞ h ã̠ ɴ
しょるい	ɕ o̞ ɾ ɯ̟ᵝ i
しらが	ɕ i ɾ a̠ ɡ a̠
しらぎ	ɕ i ɾ a̠ ɡʲ i
しらぎごと	ɕ i ɾ a̠ ɡʲ i ɡ o̞ t o̞
しらける	ɕ i ɾ a̠ k e̞ ɾ ɯ̟ᵝ
しらさぎ	ɕ i ɾ a̠ s a̠ ɡʲ i
しらせ	ɕ i ɾ a̠ s e̞
しらせる	ɕ i ɾ a̠ s e̞ ɾ ɯ̟ᵝ
しらたま	ɕ i ɾ a̠ t a̠ m a̠
しらたまつばき	ɕ i ɾ a̠ t a̠ m a̠ t͡s ɨᵝ b a̠ kʲ i
しらぬい	ɕ i ɾ a̠ n ɯ̟ᵝ i
しらんぷり	ɕ i ɾ ã̠ m p ɯ̟ᵝ ɾʲ i
しりあい	ɕ i ɾʲ i a̠ i
しりうち	ɕ i ɾʲ i ɯ̟ᵝ t͡ɕ i
しりこだま	ɕ i ɾʲ i k o̞ d a̠ m a̠
しる	ɕ i ɾ ɯ̟ᵝ
しるし	ɕ i ɾ ɯ̟ᵝ ɕ i
しるひとぞしる	ɕ i ɾ ɯ̟ᵝ ç i t o̞ d͡z o̞ ɕ i ɾ ɯ̟ᵝ
しれっと	ɕ i ɾ e̞ t̚ t o̞
しれつ	ɕ i ɾ e̞ t͡s ɨᵝ
しろ	ɕ i ɾ o̞
しろあり	ɕ i ɾ o̞ a̠ ɾʲ i
しろうと	ɕ i ɾ o̞ː t o̞
しろきくらげ	ɕ i ɾ o̞ kʲ i k ɯ̟ᵝ ɾ a̠ ɡ e̞
しろくま	ɕ i ɾ o̞ k ɯ̟ᵝ m a̠
しろざ	ɕ i ɾ o̞ z a̠
しろながすくじら	ɕ i ɾ o̞ n a̠ ɡ a̠ s ɨ̥ᵝ k ɯ̟ᵝ ʑ i ɾ a̠
しろはら	ɕ i ɾ o̞ h a̠ ɾ a̠
しろまめ	ɕ i ɾ o̞ m a̠ m e̞
しろんぼ	ɕ i ɾ õ̞ m b o̞
しわ	ɕ i ɰᵝ a̠
しんおきなわもじ	ɕ ĩ ɰ̃ o̞ kʲ i n a̠ ɰᵝ a̠ m o̞ ʑ i
しんかい	ɕ ĩ ŋ k a̠ i
しんかん	ɕ ĩ ŋ k ã̠ ɴ
しんがい	ɕ ĩ ŋ ɡ a̠ i
しんがた	ɕ ĩ ŋ ɡ a̠ t a̠
しんきゅう	ɕ ĩ ŋʲ kʲ ɨᵝː
しんきろう	ɕ ĩ ŋʲ kʲ i ɾ o̞ː
しんけいさいぼう	ɕ ĩ ŋ k e̞ː s a̠ i b o̞ː
しんげん	ɕ ĩ ŋ ɡ ẽ̞ ɴ
しんげんち	ɕ ĩ ŋ ɡ ẽ̞ ɲ̟ t͡ɕ i
しんこっちょう	ɕ ĩ ŋ k o̞ t̚ t͡ɕ o̞ː
しんこてんしゅぎ	ɕ ĩ ŋ k o̞ t ẽ̞ ɰ̃ ɕ ɨᵝ ɡʲ i
しんごう	ɕ ĩ ŋ ɡ o̞ː
しんごうき	ɕ ĩ ŋ ɡ o̞ː kʲ i
しんさつ	ɕ ĩ ɰ̃ s a̠ t͡s ɨᵝ
しんし	ɕ ĩ ɰ̃ ɕ i
しんしおん	ɕ ĩ ɰ̃ ɕ i õ̞ ɴ
しんしゃ	ɕ ĩ ɰ̃ ɕ a̠
しんしゅ	ɕ ĩ ɰ̃ ɕ ɨᵝ
しんしょう	ɕ ĩ ɰ̃ ɕ o̞ː
しんしょく	ɕ ĩ ɰ̃ ɕ o̞ k ɯ̟ᵝ
しんしん	ɕ ĩ ɰ̃ ɕ ĩ ɴ
しんじ	ɕ ĩ ɲ̟ d͡ʑ i
しんじだい	ɕ ĩ ɲ̟ d͡ʑ i d a̠ i
しんじつ	ɕ ĩ ɲ̟ d͡ʑ i t͡s ɨᵝ
しんじゅ	ɕ ĩ ɲ̟ d͡ʑ ɨᵝ
しんじゅう	ɕ ĩ ɲ̟ d͡ʑ ɨᵝː
しんせい	ɕ ĩ ɰ̃ s e̞ː
しんせいだい	ɕ ĩ ɰ̃ s e̞ː d a̠ i
しんせかいざる	ɕ ĩ ɰ̃ s e̞ k a̠ i z a̠ ɾ ɯ̟ᵝ
しんせつ	ɕ ĩ ɰ̃ s e̞ t͡s ɨᵝ
しんぜん	ɕ ĩ n d͡z ẽ̞ ɴ
しんそう	ɕ ĩ ɰ̃ s o̞ː
しんそうがくしゅう	ɕ ĩ ɰ̃ s o̞ː ɡ a̠ k ɯ̟ᵝ ɕ ɨᵝː
しんそつ	ɕ ĩ ɰ̃ s o̞ t͡s ɨᵝ
しんだいしゃ	ɕ ĩ n d a̠ i ɕ a̠
しんちく	ɕ ĩ ɲ̟ t͡ɕ i k ɯ̟ᵝ
しんちゃ	ɕ ĩ ɲ̟ t͡ɕ a̠
しんちゃく	ɕ ĩ ɲ̟ t͡ɕ a̠ k ɯ̟ᵝ
しんちゅう	ɕ ĩ ɲ̟ t͡ɕ ɨᵝː
しんちょうい	ɕ ĩ ɲ̟ t͡ɕ o̞ː i
しんちょく	ɕ ĩ ɲ̟ t͡ɕ o̞ k ɯ̟ᵝ
しんつう	ɕ ĩ n t͡s ɨᵝː
しんでん	ɕ ĩ n d ẽ̞ ɴ
しんと	ɕ ĩ n t o̞
しんどく	ɕ ĩ n d o̞ k ɯ̟ᵝ
しんにちは	ɕ ĩ ɲ̟ ɲ̟ i t͡ɕ i h a̠
しんねん	ɕ ĩ nː ẽ̞ ɴ
しんのすけ	ɕ ĩ nː o̞ s ɨᵝ k e̞
しんはつばい	ɕ ĩ ɰ̃ h a̠ t͡s ɨᵝ b a̠ i
しんぱ	ɕ ĩ m p a̠
しんぱいていし	ɕ ĩ m p a̠ i t e̞ː ɕ i
しんぱく	ɕ ĩ m p a̠ k ɯ̟ᵝ
しんぱんいん	ɕ ĩ m p ã̠ ɰ̃ ĩ ɴ
しんびがん	ɕ ĩ m bʲ i ɡ ã̠ ɴ
しんぴつ	ɕ ĩ m pʲ i t͡s ɨᵝ
しんぴょう	ɕ ĩ m pʲ o̞ː
しんぶつ	ɕ ĩ m b ɯ̟ᵝ t͡s ɨᵝ
しんぶん	ɕ ĩ m b ɯ̟̃ᵝ ɴ
しんぶんしゃ	ɕ ĩ m b ɯ̟̃ᵝ ɰ̃ ɕ a̠
しんぷく	ɕ ĩ m p ɯ̟̊ᵝ k ɯ̟ᵝ
しんぺい	ɕ ĩ m p e̞ː
しんぺん	ɕ ĩ m p ẽ̞ ɴ
しんぼう	ɕ ĩ m b o̞ː
しんぼく	ɕ ĩ m b o̞ k ɯ̟ᵝ
しんまい	ɕ ĩ mː a̠ i
しんみん	ɕ ĩ mʲː ĩ ɴ
しんやく	ɕ ĩ ɰ̃ j a̠ k ɯ̟ᵝ
しんようはんばい	ɕ ĩ ɰ̃ j o̞ː h ã̠ m b a̠ i
しんら	ɕ ĩ n ɾ a̠
しんりせん	ɕ ĩ n ɾʲ i s ẽ̞ ɴ
しんりょう	ɕ ĩ n ɾʲ o̞ː
しんりん	ɕ ĩ n ɾʲ ĩ ɴ
しんろ	ɕ ĩ n ɾ o̞
しんわ	ɕ ĩ ɰ̃ ɰᵝ a̠
じいしきかじょう	d͡ʑ iː ɕ i kʲ i k a̠ ʑ o̞ː
じぇ	d͡ʑ e̞
じえいたい	d͡ʑ i e̞ː t a̠ i
じかい	d͡ʑ i k a̠ i
じかく	d͡ʑ i k a̠ k ɯ̟ᵝ
じかに	d͡ʑ i k a̠ ɲ̟ i
じかんたい	d͡ʑ i k ã̠ n t a̠ i
じき	d͡ʑ i kʲ i
じきばき	d͡ʑ i kʲ i b a̠ kʲ i
じきゅうじそく	d͡ʑ i kʲ ɨᵝː ʑ i s o̞ k ɯ̟ᵝ
じきょう	d͡ʑ i kʲ o̞ː
じぎょうけいかく	d͡ʑ i ɡʲ o̞ː k e̞ː k a̠ k ɯ̟ᵝ
じげしょうめいしょ	d͡ʑ i ɡ e̞ ɕ o̞ː m e̞ː ɕ o̞
じこく	d͡ʑ i k o̞ k ɯ̟ᵝ
じこけんじよく	d͡ʑ i k o̞ k ẽ̞ ɲ̟ d͡ʑ i j o̞ k ɯ̟ᵝ
じこちゅうしん	d͡ʑ i k o̞ t͡ɕ ɨᵝː ɕ ĩ ɴ
じこまんぞく	d͡ʑ i k o̞ m ã̠ n d͡z o̞ k ɯ̟ᵝ
じこる	d͡ʑ i k o̞ ɾ ɯ̟ᵝ
じごうじとく	d͡ʑ i ɡ o̞ː ʑ i t o̞ k ɯ̟ᵝ
じごく	d͡ʑ i ɡ o̞ k ɯ̟ᵝ
じごくへのみちはぜんいでほそうされている	d͡ʑ i ɡ o̞ k ɯ̟ᵝ e̞ n o̞ mʲ i t͡ɕ i ɰᵝ a̠ d͡z ẽ̞ ɰ̃ i d e̞ h o̞ s o̞ː s a̠ ɾ e̞ t e̞ i ɾ ɯ̟ᵝ
じさつ	d͡ʑ i s a̠ t͡s ɨᵝ
じさつてん	d͡ʑ i s a̠ t͡s ɨᵝ t ẽ̞ ɴ
じし	d͡ʑ i ɕ i
じしゅく	d͡ʑ i ɕ ɨᵝ k ɯ̟ᵝ
じしゅれんしゅう	d͡ʑ i ɕ ɨᵝ ɾ ẽ̞ ɰ̃ ɕ ɨᵝː
じしょ	d͡ʑ i ɕ o̞
じしょけい	d͡ʑ i ɕ o̞ k e̞ː
じじつごにん	d͡ʑ i ʑ i t͡s ɨᵝ ɡ o̞ ɲ̟ ĩ ɴ
じじょ	d͡ʑ i ʑ o̞
じじょう	d͡ʑ i ʑ o̞ː
じすべり	d͡ʑ i s ɨᵝ b e̞ ɾʲ i
じせいしん	d͡ʑ i s e̞ː ɕ ĩ ɴ
じそ	d͡ʑ i s o̞
じだいげき	d͡ʑ i d a̠ i ɡ e̞ kʲ i
じち	d͡ʑ i t͡ɕ i
じちき	d͡ʑ i t͡ɕ i kʲ i
じちたい	d͡ʑ i t͡ɕ i t a̠ i
じちたいけいさつ	d͡ʑ i t͡ɕ i t a̠ i k e̞ː s a̠ t͡s ɨᵝ
じちょう	d͡ʑ i t͡ɕ o̞ː
じっか	d͡ʑ i k̚ k a̠
じっき	d͡ʑ i k̚ʲ kʲ i
じっけん	d͡ʑ i k̚ k ẽ̞ ɴ
じっけんしつ	d͡ʑ i k̚ k ẽ̞ ɰ̃ ɕ i̥ t͡s ɨᵝ
じっしょく	d͡ʑ i ɕː o̞ k ɯ̟ᵝ
じったいきょう	d͡ʑ i t̚ t a̠ i kʲ o̞ː
じっと	d͡ʑ i t̚ t o̞
じつげつ	d͡ʑ i t͡s ɨᵝ ɡ e̞ t͡s ɨᵝ
じつげん	d͡ʑ i t͡s ɨᵝ ɡ ẽ̞ ɴ
じつざい	d͡ʑ i t͡s ɨᵝ z a̠ i
じつざいろん	d͡ʑ i t͡s ɨᵝ z a̠ i ɾ õ̞ ɴ
じつだん	d͡ʑ i t͡s ɨᵝ d ã̠ ɴ
じつひきすう	d͡ʑ i t͡s ɨᵝ ç i kʲ i s ɨᵝː
じつろく	d͡ʑ i t͡s ɨᵝ ɾ o̞ k ɯ̟ᵝ
じてん	d͡ʑ i t ẽ̞ ɴ
じてんしゃどう	d͡ʑ i t ẽ̞ ɰ̃ ɕ a̠ d o̞ː
じどうか	d͡ʑ i d o̞ː k a̠
じどうぎゃくたい	d͡ʑ i d o̞ː ɡʲ a̠ k ɯ̟ᵝ t a̠ i
じどうげんきんよはらいき	d͡ʑ i d o̞ː ɡ ẽ̞ ŋʲ kʲ ĩ ɰ̃ j o̞ h a̠ ɾ a̠ i kʲ i
じどうし	d͡ʑ i d o̞ː ɕ i
じどうしゃ	d͡ʑ i d o̞ː ɕ a̠
じどうしょうじゅう	d͡ʑ i d o̞ː ɕ o̞ː ʑ ɨᵝː
じどり	d͡ʑ i d o̞ ɾʲ i
じねずみ	d͡ʑ i n e̞ z ɨᵝ mʲ i
じびき	d͡ʑ i bʲ i kʲ i
じびょう	d͡ʑ i bʲ o̞ː
じぼ	d͡ʑ i b o̞
じまい	d͡ʑ i m a̠ i
じまん	d͡ʑ i m ã̠ ɴ
じみ	d͡ʑ i mʲ i
じみこ	d͡ʑ i mʲ i k o̞
じみんとう	d͡ʑ i mʲ ĩ n t o̞ː
じめん	d͡ʑ i m ẽ̞ ɴ
じもと	d͡ʑ i m o̞ t o̞
じもんじとう	d͡ʑ i m õ̞ ɲ̟ d͡ʑ i t o̞ː
じゃ	d͡ʑ a̠
じゃあく	d͡ʑ a̠ a̠ k ɯ̟ᵝ
じゃかじゃか	d͡ʑ a̠ k a̠ ʑ a̠ k a̠
じゃく	d͡ʑ a̠ k ɯ̟ᵝ
じゃくしゃ	d͡ʑ a̠ k ɯ̟̊ᵝ ɕ a̠
じゃけ	d͡ʑ a̠ k e̞
じゃこうねこ	d͡ʑ a̠ k o̞ː n e̞ k o̞
じゃっきゅう	d͡ʑ a̠ k̚ʲ kʲ ɨᵝː
じゃび	d͡ʑ a̠ bʲ i
じゃま	d͡ʑ a̠ m a̠
じゅいん	d͡ʑ ɨᵝ ĩ ɴ
じゅう	d͡ʑ ɨᵝː
じゅうえん	d͡ʑ ɨᵝː ẽ̞ ɴ
じゅうおく	d͡ʑ ɨᵝː o̞ k ɯ̟ᵝ
じゅうがい	d͡ʑ ɨᵝː ɡ a̠ i
じゅうきゅう	d͡ʑ ɨᵝː kʲ ɨᵝː
じゅうこうぎょう	d͡ʑ ɨᵝː k o̞ː ɡʲ o̞ː
じゅうさん	d͡ʑ ɨᵝː s ã̠ ɴ
じゅうざい	d͡ʑ ɨᵝː z a̠ i
じゅうしち	d͡ʑ ɨᵝː ɕ i t͡ɕ i
じゅうじ	d͡ʑ ɨᵝː ʑ i
じゅうじろ	d͡ʑ ɨᵝː ʑ i ɾ o̞
じゅうすいそ	d͡ʑ ɨᵝː s ɨᵝ i s o̞
じゅうぜん	d͡ʑ ɨᵝː z ẽ̞ ɴ
じゅうぞく	d͡ʑ ɨᵝː z o̞ k ɯ̟ᵝ
じゅうていおん	d͡ʑ ɨᵝː t e̞ː õ̞ ɴ
じゅうでん	d͡ʑ ɨᵝː d ẽ̞ ɴ
じゅうでんき	d͡ʑ ɨᵝː d ẽ̞ ŋʲ kʲ i
じゅうど	d͡ʑ ɨᵝː d o̞
じゅうどう	d͡ʑ ɨᵝː d o̞ː
じゅうに	d͡ʑ ɨᵝː ɲ̟ i
じゅうにしちょうかいよう	d͡ʑ ɨᵝː ɲ̟ i ɕ i t͡ɕ o̞ː k a̠ i j o̞ː
じゅうにひとえ	d͡ʑ ɨᵝː ɲ̟ i ç i t o̞ e̞
じゅうはん	d͡ʑ ɨᵝː h ã̠ ɴ
じゅうみん	d͡ʑ ɨᵝː mʲ ĩ ɴ
じゅうよう	d͡ʑ ɨᵝː j o̞ː
じゅうようぎょうせきひょうかしひょう	d͡ʑ ɨᵝː j o̞ː ɡʲ o̞ː s e̞ kʲ i ç o̞ː k a̠ ɕ i ç o̞ː
じゅうりん	d͡ʑ ɨᵝː ɾʲ ĩ ɴ
じゅかい	d͡ʑ ɨᵝ k a̠ i
じゅかん	d͡ʑ ɨᵝ k ã̠ ɴ
じゅきょう	d͡ʑ ɨᵝ kʲ o̞ː
じゅぎょうさんかん	d͡ʑ ɨᵝ ɡʲ o̞ː s ã̠ ŋ k ã̠ ɴ
じゅくせい	d͡ʑ ɨᵝ k ɯ̟ᵝ s e̞ː
じゅくみん	d͡ʑ ɨᵝ k ɯ̟ᵝ mʲ ĩ ɴ
じゅしょう	d͡ʑ ɨᵝ ɕ o̞ː
じゅしょうしき	d͡ʑ ɨᵝ ɕ o̞ː ɕ i kʲ i
じゅじょうとっき	d͡ʑ ɨᵝ ʑ o̞ː t o̞ k̚ʲ kʲ i
じゅずかけばと	d͡ʑ ɨᵝ z ɨᵝ k a̠ k e̞ b a̠ t o̞
じゅそ	d͡ʑ ɨᵝ s o̞
じゅつご	d͡ʑ ɨᵝ t͡s ɨᵝ ɡ o̞
じゅでん	d͡ʑ ɨᵝ d ẽ̞ ɴ
じゅなん	d͡ʑ ɨᵝ n ã̠ ɴ
じゅなんきょく	d͡ʑ ɨᵝ n ã̠ ŋʲ kʲ o̞ k ɯ̟ᵝ
じゅにゅう	d͡ʑ ɨᵝ ɲ̟ ɯ̟ᵝː
じゅひ	d͡ʑ ɨᵝ ç i
じゅふ	d͡ʑ ɨᵝ ɸ ɯ̟ᵝ
じゅみょう	d͡ʑ ɨᵝ mʲ o̞ː
じゅよ	d͡ʑ ɨᵝ j o̞
じゅらく	d͡ʑ ɨᵝ ɾ a̠ k ɯ̟ᵝ
じゅりあ	d͡ʑ ɨᵝ ɾʲ i a̠
じゅんか	d͡ʑ ɨ̃ᵝ ŋ k a̠
じゅんかつゆ	d͡ʑ ɨ̃ᵝ ŋ k a̠ t͡s ɨᵝ j ɯ̟ᵝ
じゅんきょう	d͡ʑ ɨ̃ᵝ ŋʲ kʲ o̞ː
じゅんきょうしゃ	d͡ʑ ɨ̃ᵝ ŋʲ kʲ o̞ː ɕ a̠
じゅんけつ	d͡ʑ ɨ̃ᵝ ŋ k e̞ t͡s ɨᵝ
じゅんこう	d͡ʑ ɨ̃ᵝ ŋ k o̞ː
じゅんしゅう	d͡ʑ ɨ̃ᵝ ɰ̃ ɕ ɨᵝː
じゅんしょう	d͡ʑ ɨ̃ᵝ ɰ̃ ɕ o̞ː
じゅんじ	d͡ʑ ɨ̃ᵝ ɲ̟ d͡ʑ i
じゅんじゅん	d͡ʑ ɨ̃ᵝ ɲ̟ d͡ʑ ɨ̃ᵝ ɴ
じゅんたく	d͡ʑ ɨ̃ᵝ n t a̠ k ɯ̟ᵝ
じゅんなん	d͡ʑ ɨ̃ᵝ nː ã̠ ɴ
じゅんねん	d͡ʑ ɨ̃ᵝ nː ẽ̞ ɴ
じゅんび	d͡ʑ ɨ̃ᵝ m bʲ i
じゅんぷうまんぱん	d͡ʑ ɨ̃ᵝ m p ɯ̟ᵝː m ã̠ m p ã̠ ɴ
じゅんようかん	d͡ʑ ɨ̃ᵝ ɰ̃ j o̞ː k ã̠ ɴ
じゆう	d͡ʑ i j ɯ̟ᵝː
じゆうか	d͡ʑ i j ɯ̟ᵝː k a̠
じゆうしゅぎ	d͡ʑ i j ɯ̟ᵝː ɕ ɨᵝ ɡʲ i
じゆうせき	d͡ʑ i j ɯ̟ᵝː s e̞ kʲ i
じゆうとう	d͡ʑ i j ɯ̟ᵝː t o̞ː
じゆうど	d͡ʑ i j ɯ̟ᵝː d o̞
じょ	d͡ʑ o̞
じょう	d͡ʑ o̞ː
じょういん	d͡ʑ o̞ː ĩ ɴ
じょうおう	d͡ʑ o̞ː o̞ː
じょうおん	d͡ʑ o̞ː õ̞ ɴ
じょうき	d͡ʑ o̞ː kʲ i
じょうきゅう	d͡ʑ o̞ː kʲ ɨᵝː
じょうぎざ	d͡ʑ o̞ː ɡʲ i z a̠
じょうけん	d͡ʑ o̞ː k ẽ̞ ɴ
じょうげん	d͡ʑ o̞ː ɡ ẽ̞ ɴ
じょうこ	d͡ʑ o̞ː k o̞
じょうざぶ	d͡ʑ o̞ː z a̠ b ɯ̟ᵝ
じょうしゃ	d͡ʑ o̞ː ɕ a̠
じょうしゃけん	d͡ʑ o̞ː ɕ a̠ k ẽ̞ ɴ
じょうしゃひっすい	d͡ʑ o̞ː ɕ a̠ ç i sː ɯ̟ᵝ i
じょうしょうきりゅう	d͡ʑ o̞ː ɕ o̞ː kʲ i ɾʲ ɨᵝː
じょうしょく	d͡ʑ o̞ː ɕ o̞ k ɯ̟ᵝ
じょうじ	d͡ʑ o̞ː ʑ i
じょうじょう	d͡ʑ o̞ː ʑ o̞ː
じょうせい	d͡ʑ o̞ː s e̞ː
じょうたいか	d͡ʑ o̞ː t a̠ i k a̠
じょうだん	d͡ʑ o̞ː d ã̠ ɴ
じょうちゅう	d͡ʑ o̞ː t͡ɕ ɨᵝː
じょうでき	d͡ʑ o̞ː d e̞ kʲ i
じょうと	d͡ʑ o̞ː t o̞
じょうねつ	d͡ʑ o̞ː n e̞ t͡s ɨᵝ
じょうはつ	d͡ʑ o̞ː h a̠ t͡s ɨᵝ
じょうはんしんはだか	d͡ʑ o̞ː h ã̠ ɰ̃ ɕ ĩ ɰ̃ h a̠ d a̠ k a̠
じょうほうけんさく	d͡ʑ o̞ː h o̞ː k ẽ̞ ɰ̃ s a̠ k ɯ̟ᵝ
じょうまえや	d͡ʑ o̞ː m a̠ e̞ j a̠
じょうみゃくちゅうしゃ	d͡ʑ o̞ː mʲ a̠ k ɯ̟ᵝ t͡ɕ ɨᵝː ɕ a̠
じょうむいん	d͡ʑ o̞ː m ɯ̟ᵝ ĩ ɴ
じょうやく	d͡ʑ o̞ː j a̠ k ɯ̟ᵝ
じょうようかんじ	d͡ʑ o̞ː j o̞ː k ã̠ ɲ̟ d͡ʑ i
じょうようたいすう	d͡ʑ o̞ː j o̞ː t a̠ i s ɨᵝː
じょうら	d͡ʑ o̞ː ɾ a̠
じょうり	d͡ʑ o̞ː ɾʲ i
じょうるり	d͡ʑ o̞ː ɾ ɯ̟ᵝ ɾʲ i
じょうろ	d͡ʑ o̞ː ɾ o̞
じょうわ	d͡ʑ o̞ː ɰᵝ a̠
じょうわんこつ	d͡ʑ o̞ː ɰᵝ ã̠ ŋ k o̞ t͡s ɨᵝ
じょがくせい	d͡ʑ o̞ ɡ a̠ k ɯ̟̊ᵝ s e̞ː
じょきょく	d͡ʑ o̞ kʲ o̞ k ɯ̟ᵝ
じょきん	d͡ʑ o̞ kʲ ĩ ɴ
じょげん	d͡ʑ o̞ ɡ ẽ̞ ɴ
じょし	d͡ʑ o̞ ɕ i
じょしりょう	d͡ʑ o̞ ɕ i ɾʲ o̞ː
じょじし	d͡ʑ o̞ ʑ i ɕ i
じょすう	d͡ʑ o̞ s ɨᵝː
じょそう	d͡ʑ o̞ s o̞ː
じょそうざい	d͡ʑ o̞ s o̞ː z a̠ i
じょたい	d͡ʑ o̞ t a̠ i
じょてい	d͡ʑ o̞ t e̞ː
じょゆう	d͡ʑ o̞ j ɯ̟ᵝː
じりん	d͡ʑ i ɾʲ ĩ ɴ
じろう	d͡ʑ i ɾ o̞ː
じろん	d͡ʑ i ɾ õ̞ ɴ
じわり	d͡ʑ i ɰᵝ a̠ ɾʲ i
じん	d͡ʑ ĩ ɴ
じんい	d͡ʑ ĩ ɰ̃ i
じんぎ	d͡ʑ ĩ ŋʲ ɡʲ i
じんけん	d͡ʑ ĩ ŋ k ẽ̞ ɴ
じんこうげんご	d͡ʑ ĩ ŋ k o̞ː ɡ ẽ̞ ŋ ɡ o̞
じんこうちのう	d͡ʑ ĩ ŋ k o̞ː t͡ɕ i n o̞ː
じんざい	d͡ʑ ĩ n d͡z a̠ i
じんせん	d͡ʑ ĩ ɰ̃ s ẽ̞ ɴ
じんそく	d͡ʑ ĩ ɰ̃ s o̞ k ɯ̟ᵝ
じんぞう	d͡ʑ ĩ n d͡z o̞ː
じんぞうにんげん	d͡ʑ ĩ n d͡z o̞ː ɲ̟ ĩ ŋ ɡ ẽ̞ ɴ
じんどう	d͡ʑ ĩ n d o̞ː
じんばきゅう	d͡ʑ ĩ m b a̠ kʲ ɨᵝː
じんぶん	d͡ʑ ĩ m b ɯ̟̃ᵝ ɴ
じんべえ	d͡ʑ ĩ m b e̞ e̞
じんめい	d͡ʑ ĩ mː e̞ː
じんらい	d͡ʑ ĩ n ɾ a̠ i
すあし	s ɨᵝ a̠ ɕ i
すい	s ɨᵝ i
すいあげる	s ɨᵝ i a̠ ɡ e̞ ɾ ɯ̟ᵝ
すいいき	s ɨᵝ i i kʲ i
すいか	s ɨᵝ i k a̠
すいがい	s ɨᵝ i ɡ a̠ i
すいげん	s ɨᵝ i ɡ ẽ̞ ɴ
すいこう	s ɨᵝ i k o̞ː
すいこむ	s ɨᵝ i k o̞ m ɯ̟ᵝ
すいさい	s ɨᵝ i s a̠ i
すいさつ	s ɨᵝ i s a̠ t͡s ɨᵝ
すいさん	s ɨᵝ i s ã̠ ɴ
すいさんか	s ɨᵝ i s ã̠ ŋ k a̠
すいしんき	s ɨᵝ i ɕ ĩ ŋʲ kʲ i
すいじ	s ɨᵝ i ʑ i
すいじゃく	s ɨᵝ i ʑ a̠ k ɯ̟ᵝ
すいじゅん	s ɨᵝ i ʑ ɨ̃ᵝ ɴ
すいじょう	s ɨᵝ i ʑ o̞ː
すいせん	s ɨᵝ i s ẽ̞ ɴ
すいせんじょう	s ɨᵝ i s ẽ̞ ɲ̟ d͡ʑ o̞ː
すいぜん	s ɨᵝ i z ẽ̞ ɴ
すいそうがく	s ɨᵝ i s o̞ː ɡ a̠ k ɯ̟ᵝ
すいそく	s ɨᵝ i s o̞ k ɯ̟ᵝ
すいそばくだん	s ɨᵝ i s o̞ b a̠ k ɯ̟ᵝ d ã̠ ɴ
すいぞう	s ɨᵝ i z o̞ː
すいぞくかん	s ɨᵝ i z o̞ k ɯ̟̊ᵝ k ã̠ ɴ
すいたい	s ɨᵝ i t a̠ i
すいちょく	s ɨᵝ i t͡ɕ o̞ k ɯ̟ᵝ
すいとう	s ɨᵝ i t o̞ː
すいとりがみ	s ɨᵝ i t o̞ ɾʲ i ɡ a̠ mʲ i
すいとる	s ɨᵝ i t o̞ ɾ ɯ̟ᵝ
すいはんき	s ɨᵝ i h ã̠ ŋʲ kʲ i
すいばく	s ɨᵝ i b a̠ k ɯ̟ᵝ
すいふ	s ɨᵝ i ɸ ɯ̟ᵝ
すいへいせん	s ɨᵝ i h e̞ː s ẽ̞ ɴ
すいほう	s ɨᵝ i h o̞ː
すいほうにきす	s ɨᵝ i h o̞ː ɲ̟ i kʲ i s ɨᵝ
すいぼう	s ɨᵝ i b o̞ː
すいぼくが	s ɨᵝ i b o̞ k ɯ̟ᵝ ɡ a̠
すいもんがく	s ɨᵝ i m õ̞ ŋ ɡ a̠ k ɯ̟ᵝ
すいりゅう	s ɨᵝ i ɾʲ ɨᵝː
すいりょう	s ɨᵝ i ɾʲ o̞ː
すいりょく	s ɨᵝ i ɾʲ o̞ k ɯ̟ᵝ
すいれん	s ɨᵝ i ɾ ẽ̞ ɴ
すいろきょう	s ɨᵝ i ɾ o̞ kʲ o̞ː
すいろく	s ɨᵝ i ɾ o̞ k ɯ̟ᵝ
すいろん	s ɨᵝ i ɾ õ̞ ɴ
すう	s ɨᵝ ɯ̟ᵝ
すうがく	s ɨᵝː ɡ a̠ k ɯ̟ᵝ
すうがくしゃ	s ɨᵝː ɡ a̠ k ɯ̟̊ᵝ ɕ a̠
すうけい	s ɨᵝː k e̞ː
すうじくこく	s ɨᵝː ʑ i k ɯ̟̊ᵝ k o̞ k ɯ̟ᵝ
すうすう	s ɨᵝː s ɨᵝː
すうせい	s ɨᵝː s e̞ː
すうちょくせん	s ɨᵝː t͡ɕ o̞ k ɯ̟ᵝ s ẽ̞ ɴ
すうりょう	s ɨᵝː ɾʲ o̞ː
すえおそろしい	s ɨᵝ e̞ o̞ s o̞ ɾ o̞ ɕ iː
すか	s ɨ̥ᵝ k a̠
すがすがしい	s ɨᵝ ɡ a̠ s ɨᵝ ɡ a̠ ɕ i i
すがたをけす	s ɨᵝ ɡ a̠ t a̠ o̞ k e̞ s ɨᵝ
すき	s ɨᵝ kʲ i
すきずき	s ɨ̥ᵝ kʲ i z ɨᵝ kʲ i
すきなだけ	s ɨᵝ kʲ i n a̠ d a̠ k e̞
すきばさみ	s ɨᵝ kʲ i b a̠ s a̠ mʲ i
すきま	s ɨ̥ᵝ kʲ i m a̠
すぎ	s ɨᵝ ɡʲ i
すぎる	s ɨᵝ ɡʲ i ɾ ɯ̟ᵝ
すくい	s ɨᵝ k ɯ̟ᵝ i
すくいあげる	s ɨ̥ᵝ k ɯ̟ᵝ i a̠ ɡ e̞ ɾ ɯ̟ᵝ
すくう	s ɨ̥ᵝ k ɯ̟ᵝː
すくない	s ɨ̥ᵝ k ɯ̟ᵝ n a̠ i
すくなくとも	s ɨᵝ k ɯ̟ᵝ n a̠ k ɯ̟ᵝ t o̞ m o̞
すくむ	s ɨ̥ᵝ k ɯ̟ᵝ m ɯ̟ᵝ
すくめる	s ɨᵝ k ɯ̟ᵝ m e̞ ɾ ɯ̟ᵝ
すぐ	s ɨᵝ ɡ ɯ̟ᵝ
すけそうだら	s ɨᵝ k e̞ s o̞ː d a̠ ɾ a̠
すけひろ	s ɨᵝ k e̞ ç i ɾ o̞
すける	s ɨ̥ᵝ k e̞ ɾ ɯ̟ᵝ
すげ	s ɨᵝ ɡ e̞
すこぶる	s ɨᵝ k o̞ b ɯ̟ᵝ ɾ ɯ̟ᵝ
すこやか	s ɨ̥ᵝ k o̞ j a̠ k a̠
すごい	s ɨᵝ ɡ o̞ i
すごく	s ɨᵝ ɡ o̞ k ɯ̟ᵝ
すごす	s ɨᵝ ɡ o̞ s ɨᵝ
すごすご	s ɨᵝ ɡ o̞ s ɨᵝ ɡ o̞
すごろく	s ɨᵝ ɡ o̞ ɾ o̞ k ɯ̟ᵝ
すさまじい	s ɨᵝ s a̠ m a̠ ʑ iː
すさむ	s ɨᵝ s a̠ m ɯ̟ᵝ
すし	s ɨᵝ ɕ i
すじ	s ɨᵝ ʑ i
すす	s ɨᵝ s ɨᵝ
すすめ	s ɨᵝ s ɨᵝ m e̞
すする	s ɨᵝ s ɨᵝ ɾ ɯ̟ᵝ
すず	s ɨᵝ z ɨᵝ
すずき	s ɨᵝ z ɨᵝ kʲ i
すずしい	s ɨᵝ z ɨᵝ ɕ iː
すずなり	s ɨᵝ z ɨᵝ n a̠ ɾʲ i
すずはく	s ɨᵝ z ɨᵝ h a̠ k ɯ̟ᵝ
すずめ	s ɨᵝ z ɨᵝ m e̞
すずらん	s ɨᵝ z ɨᵝ ɾ ã̠ ɴ
すそ	s ɨᵝ s o̞
すっかり	s ɨ̥ᵝ k̚ k a̠ ɾʲ i
すっきり	s ɨ̥ᵝ k̚ʲ kʲ i ɾʲ i
すっぱい	s ɨ̥ᵝ p̚ p a̠ i
すっぴん	s ɨᵝ p̚ʲ pʲ ĩ ɴ
すっぽん	s ɨ̥ᵝ p̚ p õ̞ ɴ
すてる	s ɨᵝ t e̞ ɾ ɯ̟ᵝ
すでに	s ɨᵝ d e̞ ɲ̟ i
すな	s ɨᵝ n a̠
すなあらし	s ɨᵝ n a̠ː ɾ a̠ ɕ i
すなねずみ	s ɨᵝ n a̠ n e̞ z ɨᵝ mʲ i
すなのみ	s ɨᵝ n a̠ n o̞ mʲ i
すなはま	s ɨᵝ n a̠ h a̠ m a̠
すなば	s ɨᵝ n a̠ b a̠
すなわち	s ɨᵝ n a̠ ɰᵝ a̠ t͡ɕ i
すね	s ɨᵝ n e̞
すねる	s ɨᵝ n e̞ ɾ ɯ̟ᵝ
すばしこい	s ɨᵝ b a̠ ɕ i̥ k o̞ i
すばやい	s ɨᵝ b a̠ j a̠ i
すばらしい	s ɨᵝ b a̠ ɾ a̠ ɕ iː
すばる	s ɨᵝ b a̠ ɾ ɯ̟ᵝ
すべからく	s ɨᵝ b e̞ k a̠ ɾ a̠ k ɯ̟ᵝ
すべて	s ɨᵝ b e̞ t e̞
すべりだし	s ɨᵝ b e̞ ɾʲ i d a̠ ɕ i
すべる	s ɨᵝ b e̞ ɾ ɯ̟ᵝ
すぼまる	s ɨᵝ b o̞ m a̠ ɾ ɯ̟ᵝ
すぼめる	s ɨᵝ b o̞ m e̞ ɾ ɯ̟ᵝ
すまう	s ɨᵝ m a̠ ɯ̟ᵝ
すませる	s ɨᵝ m a̠ s e̞ ɾ ɯ̟ᵝ
すまた	s ɨᵝ m a̠ t a̠
すみ	s ɨᵝ mʲ i
すみだ	s ɨᵝ mʲ i d a̠
すみび	s ɨᵝ mʲ i bʲ i
すみません	s ɨᵝ mʲ i m a̠ s ẽ̞ ɴ
すみやか	s ɨᵝ mʲ i j a̠ k a̠
すみれ	s ɨᵝ mʲ i ɾ e̞
すみれいろ	s ɨᵝ mʲ i ɾ e̞ i ɾ o̞
すむ	s ɨᵝ m ɯ̟ᵝ
すめばみやこ	s ɨᵝ m e̞ b a̠ mʲ i j a̠ k o̞
すもう	s ɨᵝ m o̞ː
すもも	s ɨᵝ m o̞ m o̞
すら	s ɨᵝ ɾ a̠
すらすら	s ɨᵝ ɾ a̠ s ɨᵝ ɾ a̠
すり	s ɨᵝ ɾʲ i
する	s ɨᵝ ɾ ɯ̟ᵝ
すれちがう	s ɨᵝ ɾ e̞ t͡ɕ i ɡ a̠ ɯ̟ᵝ
すわる	s ɨᵝ ɰᵝ a̠ ɾ ɯ̟ᵝ
すんか	s ɨ̃ᵝ ŋ k a̠
すんげき	s ɨ̃ᵝ ŋ ɡ e̞ kʲ i
ずあん	d͡z ɨᵝ ã̠ ɴ
ずい	d͡z ɨᵝ i
ずいい	d͡z ɨᵝ iː
ずいえき	d͡z ɨᵝ i e̞ kʲ i
ずいしょう	d͡z ɨᵝ i ɕ o̞ː
ずがい	d͡z ɨᵝ ɡ a̠ i
ずきん	d͡z ɨᵝ kʲ ĩ ɴ
ずさん	d͡z ɨᵝ s ã̠ ɴ
ずしき	d͡z ɨᵝ ɕ i̥ kʲ i
ずぞうがく	d͡z ɨᵝ z o̞ː ɡ a̠ k ɯ̟ᵝ
ずたずた	d͡z ɨᵝ t a̠ z ɨᵝ t a̠
ずっしり	d͡z ɨᵝ ɕː i ɾʲ i
ずっと	d͡z ɨᵝ t̚ t o̞
ずのう	d͡z ɨᵝ n o̞ː
ずばり	d͡z ɨᵝ b a̠ ɾʲ i
ずぶとい	d͡z ɨᵝ b ɯ̟ᵝ t o̞ i
ずぶぬれ	d͡z ɨᵝ b ɯ̟ᵝ n ɯ̟ᵝ ɾ e̞
ずぼし	d͡z ɨᵝ b o̞ ɕ i
ずる	d͡z ɨᵝ ɾ ɯ̟ᵝ
ずるい	d͡z ɨᵝ ɾ ɯ̟ᵝ i
ずるがしこい	d͡z ɨᵝ ɾ ɯ̟ᵝ ɡ a̠ ɕ i k o̞ i
ずるずる	d͡z ɨᵝ ɾ ɯ̟ᵝ z ɨᵝ ɾ ɯ̟ᵝ
ずれる	d͡z ɨᵝ ɾ e̞ ɾ ɯ̟ᵝ
ずろう	d͡z ɨᵝ ɾ o̞ː
ずろく	d͡z ɨᵝ ɾ o̞ k ɯ̟ᵝ
ずんぐりむっくり	d͡z ɨ̃ᵝ ŋ ɡ ɯ̟ᵝ ɾʲ i m ɯ̟ᵝ k̚ k ɯ̟ᵝ ɾʲ i
ずんだもち	d͡z ɨ̃ᵝ n d a̠ m o̞ t͡ɕ i
せいいき	s e̞ː i kʲ i
せいいく	s e̞ː i k ɯ̟ᵝ
せいいっぱい	s e̞ː i p̚ p a̠ i
せいう	s e̞ː ɯ̟ᵝ
せいかい	s e̞ː k a̠ i
せいかがく	s e̞ː k a̠ ɡ a̠ k ɯ̟ᵝ
せいかつおん	s e̞ː k a̠ t͡s ɨᵝ õ̞ ɴ
せいかん	s e̞ː k ã̠ ɴ
せいかんたい	s e̞ː k ã̠ n t a̠ i
せいがいふ	s e̞ː ɡ a̠ i ɸ ɯ̟ᵝ
せいきか	s e̞ː kʲ i k a̠
せいきょく	s e̞ː kʲ o̞ k ɯ̟ᵝ
せいぎ	s e̞ː ɡʲ i
せいくらべ	s e̞ː k ɯ̟ᵝ ɾ a̠ b e̞
せいぐ	s e̞ː ɡ ɯ̟ᵝ
せいけん	s e̞ː k ẽ̞ ɴ
せいこつ	s e̞ː k o̞ t͡s ɨᵝ
せいさい	s e̞ː s a̠ i
せいさく	s e̞ː s a̠ k ɯ̟ᵝ
せいさん	s e̞ː s ã̠ ɴ
せいさんえん	s e̞ː s ã̠ ɰ̃ ẽ̞ ɴ
せいさんかごうぶつ	s e̞ː s ã̠ ŋ k a̠ ɡ o̞ː b ɯ̟ᵝ t͡s ɨᵝ
せいし	s e̞ː ɕ i
せいしゅう	s e̞ː ɕ ɨᵝː
せいしゅく	s e̞ː ɕ ɨᵝ k ɯ̟ᵝ
せいしゅん	s e̞ː ɕ ɨ̃ᵝ ɴ
せいしゅんじだい	s e̞ː ɕ ɨ̃ᵝ ɲ̟ d͡ʑ i d a̠ i
せいしん	s e̞ː ɕ ĩ ɴ
せいしんりょうほう	s e̞ː ɕ ĩ n ɾʲ o̞ː h o̞ː
せいじ	s e̞ː ʑ i
せいじがくしゃ	s e̞ː ʑ i ɡ a̠ k ɯ̟̊ᵝ ɕ a̠
せいじてき	s e̞ː ʑ i t e̞ kʲ i
せいじゅつ	s e̞ː ʑ ɨᵝ t͡s ɨᵝ
せいじんしき	s e̞ː ʑ ĩ ɰ̃ ɕ i kʲ i
せいすい	s e̞ː s ɨᵝ i
せいすうがた	s e̞ː s ɨᵝː ɡ a̠ t a̠
せいせん	s e̞ː s ẽ̞ ɴ
せいぜんせつ	s e̞ː z ẽ̞ ɰ̃ s e̞ t͡s ɨᵝ
せいそう	s e̞ː s o̞ː
せいぞろい	s e̞ː z o̞ ɾ o̞ i
せいぞん	s e̞ː z õ̞ ɴ
せいたん	s e̞ː t ã̠ ɴ
せいだん	s e̞ː d ã̠ ɴ
せいち	s e̞ː t͡ɕ i
せいてい	s e̞ː t e̞ː
せいてん	s e̞ː t ẽ̞ ɴ
せいとう	s e̞ː t o̞ː
せいとうか	s e̞ː t o̞ː k a̠
せいどうきじだい	s e̞ː d o̞ː kʲ i d͡ʑ i d a̠ i
せいねん	s e̞ː n ẽ̞ ɴ
せいばい	s e̞ː b a̠ i
せいびょう	s e̞ː bʲ o̞ː
せいぶ	s e̞ː b ɯ̟ᵝ
せいぶつがく	s e̞ː b ɯ̟ᵝ t͡s ɨᵝ ɡ a̠ k ɯ̟ᵝ
せいぶつぶつりがく	s e̞ː b ɯ̟ᵝ t͡s ɨᵝ b ɯ̟ᵝ t͡s ɨᵝ ɾʲ i ɡ a̠ k ɯ̟ᵝ
せいめいせつ	s e̞ː m e̞ː s e̞ t͡s ɨᵝ
せいや	s e̞ː j a̠
せいやく	s e̞ː j a̠ k ɯ̟ᵝ
せいゆう	s e̞ː j ɯ̟ᵝː
せいようしょうぎ	s e̞ː j o̞ː ɕ o̞ː ɡʲ i
せいようふう	s e̞ː j o̞ː ɸ ɯ̟ᵝː
せいようわさび	s e̞ː j o̞ː ɰᵝ a̠ s a̠ bʲ i
せいり	s e̞ː ɾʲ i
せいりょく	s e̞ː ɾʲ o̞ k ɯ̟ᵝ
せいれい	s e̞ː ɾ e̞ː
せいれき	s e̞ː ɾ e̞ kʲ i
せいれんけっぱく	s e̞ː ɾ ẽ̞ ŋ k e̞ p̚ p a̠ k ɯ̟ᵝ
せかす	s e̞ k a̠ s ɨᵝ
せがむ	s e̞ ɡ a̠ m ɯ̟ᵝ
せがれ	s e̞ ɡ a̠ ɾ e̞
せき	s e̞ kʲ i
せきうん	s e̞ kʲ i ɯ̟̃ᵝ ɴ
せきえい	s e̞ kʲ i e̞ː
せきえん	s e̞ kʲ i ẽ̞ ɴ
せきがいせん	s e̞ kʲ i ɡ a̠ i s ẽ̞ ɴ
せきぐん	s e̞ kʲ i ɡ ɯ̟̃ᵝ ɴ
せきしょくやけい	s e̞ kʲ i̥ ɕ o̞ k ɯ̟ᵝ j a̠ k e̞ː
せきずいはんしゃ	s e̞ kʲ i z ɨᵝ i h ã̠ ɰ̃ ɕ a̠
せきたんさん	s e̞ kʲ i̥ t ã̠ ɰ̃ s ã̠ ɴ
せきにんかん	s e̞ k i n ĩ ŋ k ã̠ ɴ
せきばらい	s e̞ kʲ i b a̠ ɾ a̠ i
せじ	s e̞ ʑ i
せたけ	s e̞ t a̠ k e̞
せだい	s e̞ d a̠ i
せちな	s e̞ t͡ɕ i n a̠
せっかく	s e̞ k̚ k a̠ k ɯ̟ᵝ
せっかち	s e̞ k̚ k a̠ t͡ɕ i
せっかん	s e̞ k̚ k ã̠ ɴ
せっき	s e̞ k̚ʲ kʲ i
せっきん	s e̞ k̚ʲ kʲ ĩ ɴ
せっけいず	s e̞ k̚ k e̞ː z ɨᵝ
せっけん	s e̞ k̚ k ẽ̞ ɴ
せっしおんど	s e̞ ɕː i õ̞ n d o̞
せっしょう	s e̞ ɕː o̞ː
せっしょうせき	s e̞ ɕː o̞ː s e̞ kʲ i
せっちゃくざい	s e̞ t̚ t͡ɕ a̠ k ɯ̟ᵝ z a̠ i
せってん	s e̞ t̚ t ẽ̞ ɴ
せっとう	s e̞ t̚ t o̞ː
せっとうご	s e̞ t̚ t o̞ː ɡ o̞
せっとく	s e̞ t̚ t o̞ k ɯ̟ᵝ
せっぱ	s e̞ p̚ p a̠
せっぱく	s e̞ p̚ p a̠ k ɯ̟̊ᵝ
せついん	s e̞ t͡s ɨᵝ ĩ ɴ
せつぞく	s e̞ t͡s ɨᵝ z o̞ k ɯ̟ᵝ
せつど	s e̞ t͡s ɨᵝ d o̞
せつない	s e̞ t͡s ɨᵝ n a̠ i
せつわ	s e̞ t͡s ɨᵝ ɰᵝ a̠
せともの	s e̞ t o̞ m o̞ n o̞
せなか	s e̞ n a̠ k a̠
せばまる	s e̞ b a̠ m a̠ ɾ ɯ̟ᵝ
せびれ	s e̞ bʲ i ɾ e̞
せびろ	s e̞ bʲ i ɾ o̞
せぼね	s e̞ b o̞ n e̞
せまい	s e̞ m a̠ i
せまる	s e̞ m a̠ ɾ ɯ̟ᵝ
せみ	s e̞ mʲ i
せめ	s e̞ m e̞
せめて	s e̞ m e̞ t e̞
せめる	s e̞ m e̞ ɾ ɯ̟ᵝ
せりふ	s e̞ ɾʲ i ɸ ɯ̟ᵝ
せわやき	s e̞ ɰᵝ a̠ j a̠ kʲ i
せん	s ẽ̞ ɴ
せんいこうがく	s ẽ̞ ɰ̃ i k o̞ː ɡ a̠ k ɯ̟ᵝ
せんえつ	s ẽ̞ ɰ̃ e̞ t͡s ɨᵝ
せんかい	s ẽ̞ ŋ k a̠ i
せんきゅう	s ẽ̞ ŋʲ kʲ ɨᵝː
せんきょう	s ẽ̞ ŋʲ kʲ o̞ː
せんくしゃ	s ẽ̞ ŋ k ɯ̟ᵝ ɕ a̠
せんけいけいかくほう	s ẽ̞ ŋ k e̞ː k e̞ː k a̠ k ɯ̟ᵝ h o̞ː
せんけいせい	s ẽ̞ ŋ k e̞ː s e̞ː
せんげん	s ẽ̞ ŋ ɡ ẽ̞ ɴ
せんこう	s ẽ̞ ŋ k o̞ː
せんさい	s ẽ̞ ɰ̃ s a̠ i
せんざんこう	s ẽ̞ n d͡z ã̠ ŋ k o̞ː
せんしゃ	s ẽ̞ ɰ̃ ɕ a̠
せんしゅう	s ẽ̞ ɰ̃ ɕ ɨᵝː
せんしゅうらく	s ẽ̞ ɰ̃ ɕ ɨᵝː ɾ a̠ k ɯ̟ᵝ
せんしょくけんろうど	s ẽ̞ ɰ̃ ɕ o̞ k ɯ̟ᵝ k ẽ̞ n ɾ o̞ː d o̞
せんじ	s ẽ̞ ɲ̟ d͡ʑ i
せんじょう	s ẽ̞ ɲ̟ d͡ʑ o̞ː
せんすいかん	s ẽ̞ ɰ̃ s ɨᵝ i k ã̠ ɴ
せんせい	s ẽ̞ ɰ̃ s e̞ː
せんせき	s ẽ̞ ɰ̃ s e̞ kʲ i
せんたくこうり	s ẽ̞ n t a̠ k ɯ̟ᵝ k o̞ː ɾʲ i
せんたくばさみ	s ẽ̞ n t a̠ k ɯ̟ᵝ b a̠ s a̠ mʲ i
せんたん	s ẽ̞ n t ã̠ ɴ
せんだい	s ẽ̞ n d a̠ i
せんてつ	s ẽ̞ n t e̞ t͡s ɨᵝ
せんてんせい	s ẽ̞ n t ẽ̞ ɰ̃ s e̞ː
せんてんてき	s ẽ̞ n t ẽ̞ n t e̞ kʲ i
せんど	s ẽ̞ n d o̞
せんのう	s ẽ̞ nː o̞ː
せんばい	s ẽ̞ m b a̠ i
せんばん	s ẽ̞ m b ã̠ ɴ
せんぷ	s ẽ̞ m p ɯ̟ᵝ
せんべい	s ẽ̞ m b e̞ː
せんべつ	s ẽ̞ m b e̞ t͡s ɨᵝ
せんめい	s ẽ̞ mː e̞ː
せんめつ	s ẽ̞ mː e̞ t͡s ɨᵝ
せんもう	s ẽ̞ mː o̞ː
せんりがん	s ẽ̞ n ɾʲ i ɡ ã̠ ɴ
せんれい	s ẽ̞ n ɾ e̞ː
ぜいじゃくせい	d͡z e̞ː ʑ a̠ k ɯ̟̊ᵝ s e̞ː
ぜいせい	d͡z e̞ː s e̞ː
ぜいたく	d͡z e̞ː t a̠ k ɯ̟ᵝ
ぜげん	d͡z e̞ ɡ ẽ̞ ɴ
ぜっこう	d͡z e̞ k̚ k o̞ː
ぜったい	d͡z e̞ t̚ t a̠ i
ぜったいおんかん	d͡z e̞ t̚ t a̠ i õ̞ ŋ k ã̠ ɴ
ぜったいてき	d͡z e̞ t̚ t a̠ i t e̞ kʲ i
ぜったいりょういき	d͡z e̞ t̚ t a̠ i ɾʲ o̞ː i kʲ i
ぜったいれいど	d͡z e̞ t̚ t a̠ i ɾ e̞ː d o̞
ぜっぴん	d͡z e̞ p̚ʲ pʲ ĩ ɴ
ぜっぺき	d͡z e̞ p̚ p e̞ kʲ i
ぜつえん	d͡z e̞ t͡s ɨᵝ ẽ̞ ɴ
ぜつふちょう	d͡z e̞ t͡s ɨᵝ ɸ ɯ̟ᵝ t͡ɕ o̞ː
ぜつぼうてき	d͡z e̞ t͡s ɨᵝ b o̞ː t e̞ kʲ i
ぜつみょう	d͡z e̞ t͡s ɨᵝ mʲ o̞ː
ぜにがたあざらし	d͡z e̞ ɲ̟ i ɡ a̠ t a̠ a̠ z a̠ ɾ a̠ ɕ i
ぜひ	d͡z e̞ ç i
ぜん	d͡z ẽ̞ ɴ
ぜんえい	d͡z ẽ̞ ɰ̃ e̞ː
ぜんえいてき	d͡z ẽ̞ ɰ̃ e̞ː t e̞ kʲ i
ぜんき	d͡z ẽ̞ ŋʲ kʲ i
ぜんしょう	d͡z ẽ̞ ɰ̃ ɕ o̞ː
ぜんしょうとう	d͡z ẽ̞ ɰ̃ ɕ o̞ː t o̞ː
ぜんせいき	d͡z ẽ̞ ɰ̃ s e̞ː kʲ i
ぜんたいしゅぎ	d͡z ẽ̞ n t a̠ i ɕ ɨᵝ ɡʲ i
ぜんち	d͡z ẽ̞ ɲ̟ t͡ɕ i
ぜんと	d͡z ẽ̞ n t o̞
ぜんぱい	d͡z ẽ̞ m p a̠ i
ぜんぶ	d͡z ẽ̞ m b ɯ̟ᵝ
ぜんぶん	d͡z ẽ̞ m b ɯ̟̃ᵝ ɴ
ぜんぼう	d͡z ẽ̞ m b o̞ː
ぜんめつ	d͡z ẽ̞ mː e̞ t͡s ɨᵝ
ぜんもう	d͡z ẽ̞ mː o̞ː
そいね	s o̞ i n e̞
そういう	s o̞ː i ɯ̟ᵝ
そういえば	s o̞ː i e̞ b a̠
そういくふう	s o̞ː i k ɯ̟ᵝ ɸ ɯ̟ᵝː
そういや	s o̞ː i j a̠
そううけ	s o̞ː ɯ̟ᵝ k e̞
そうかい	s o̞ː k a̠ i
そうかいそうでん	s o̞ː k a̠ i s o̞ː d ẽ̞ ɴ
そうかん	s o̞ː k ã̠ ɴ
そうき	s o̞ː kʲ i
そうきょくせいしょうがい	s o̞ː kʲ o̞ k ɯ̟̊ᵝ s e̞ː ɕ o̞ː ɡ a̠ i
そうぎ	s o̞ː ɡʲ i
そうぎや	s o̞ː ɡʲ i j a̠
そうぎょきゅう	s o̞ː ɡʲ o̞ kʲ ɨᵝː
そうぐう	s o̞ː ɡ ɯ̟ᵝː
そうこう	s o̞ː k o̞ː
そうこうのつま	s o̞ː k o̞ː n o̞ t͡s ɨᵝ m a̠
そうこばん	s o̞ː k o̞ b ã̠ ɴ
そうざい	s o̞ː z a̠ i
そうしたら	s o̞ː ɕ i t a̠ ɾ a̠
そうして	s o̞ː ɕ i̥ t e̞
そうしゅ	s o̞ː ɕ ɨᵝ
そうじふ	s o̞ː ʑ i ɸ ɯ̟ᵝ
そうじゅうかん	s o̞ː ʑ ɨᵝː k ã̠ ɴ
そうじゅうし	s o̞ː ʑ ɨᵝː ɕ i
そうじょうがんどうりゅうかてっこうこうしょう	s o̞ː ʑ o̞ː ɡ ã̠ n d o̞ː ɾʲ ɨᵝː k a̠ t e̞ k̚ k o̞ː k o̞ː ɕ o̞ː
そうせい	s o̞ː s e̞ː
そうぞうしい	s o̞ː z o̞ː ɕ i i
そうぞうしゅ	s o̞ː z o̞ː ɕ ɨᵝ
そうぞうてき	s o̞ː z o̞ː t e̞ kʲ i
そうたいおんかん	d͡z e̞ t̚ t a̠ i õ̞ ŋ k ã̠ ɴ
そうたいしつど	s o̞ː t a̠ i ɕ i t͡s ɨᵝ d o̞
そうたいせいりろん	s o̞ː t a̠ i s e̞ː ɾʲ i ɾ õ̞ ɴ
そうち	s o̞ː t͡ɕ i
そうでんそうかい	s o̞ː d ẽ̞ ɰ̃ s o̞ː k a̠ i
そうとう	s o̞ː t o̞ː
そうどく	s o̞ː d o̞ k ɯ̟ᵝ
そうにょう	s o̞ː ɲ̟ o̞ː
そうび	s o̞ː bʲ i
そうびょう	s o̞ː bʲ o̞ː
そうみ	s o̞ː mʲ i
そうめい	s o̞ː m e̞ː
そうめいきょく	s o̞ː m e̞ː kʲ o̞ k ɯ̟ᵝ
そうりきょうせい	s o̞ː ɾʲ i kʲ o̞ː s e̞ː
そうわ	s o̞ː ɰᵝ a̠
そがい	s o̞ ɡ a̠ i
そき	s o̞ kʲ i
そく	s o̞ k ɯ̟ᵝ
そくい	s o̞ k ɯ̟ᵝ i
そくいき	s o̞ k ɯ̟ᵝ i kʲ i
そくじょ	s o̞ k ɯ̟ᵝ ʑ o̞
そくす	s o̞ k ɯ̟ᵝ s ɨᵝ
そくず	s o̞ k ɯ̟ᵝ z ɨᵝ
そくど	s o̞ k ɯ̟ᵝ d o̞
そくどくじゅつ	s o̞ k ɯ̟ᵝ d o̞ k ɯ̟ᵝ ʑ ɨᵝ t͡s ɨᵝ
そくばいかい	s o̞ k ɯ̟ᵝ b a̠ i k a̠ i
そくや	s o̞ k ɯ̟ᵝ j a̠
そくりょう	s o̞ k ɯ̟ᵝ ɾʲ o̞ː
そぐ	s o̞ ɡ ɯ̟ᵝ
そこ	s o̞ k o̞
そこく	s o̞ k o̞ k ɯ̟ᵝ
そこなう	s o̞ k o̞ n a̠ ɯ̟ᵝ
そこねる	s o̞ k o̞ n e̞ ɾ ɯ̟ᵝ
そご	s o̞ ɡ o̞
そし	s o̞ ɕ i
そしき	s o̞ ɕ i̥ kʲ i
そして	s o̞ ɕ i̥ t e̞
そしる	s o̞ ɕ i ɾ ɯ̟ᵝ
そすう	s o̞ s ɨᵝː
そせい	s o̞ s e̞ː
そぜいかいひち	s o̞ z e̞ː k a̠ i ç i t͡ɕ i
そそう	s o̞ s o̞ː
そそぐ	s o̞ s o̞ ɡ ɯ̟ᵝ
そそっかしい	s o̞ s o̞ k̚ k a̠ ɕ i i
そぞろ	s o̞ z o̞ ɾ o̞
そだち	s o̞ d a̠ t͡ɕ i
そだつ	s o̞ d a̠ t͡s ɨᵝ
そだてる	s o̞ d a̠ t e̞ ɾ ɯ̟ᵝ
そっけない	s o̞ k̚ k e̞ n a̠ i
そっぱ	s o̞ p̚ p a̠
そっぽ	s o̞ p̚ p o̞
そっぽをむく	s o̞ p̚ p o̞ o̞ m ɯ̟ᵝ k ɯ̟ᵝ
そつ	s o̞ t͡s ɨᵝ
そつぎょうしけん	s o̞ t͡s ɨᵝ ɡʲ o̞ː ɕ i k ẽ̞ ɴ
そつぎょうせい	s o̞ t͡s ɨᵝ ɡʲ o̞ː s e̞ː
そつにゅう	s o̞ t͡s ɨᵝ ɲ̟ ɯ̟ᵝː
そで	s o̞ d e̞
そなえ	s o̞ n a̠ e̞
そなえる	s o̞ n a̠ e̞ ɾ ɯ̟ᵝ
そなわる	s o̞ n a̠ ɰᵝ a̠ ɾ ɯ̟ᵝ
そにん	s o̞ ɲ̟ ĩ ɴ
その	s o̞ n o̞
そのうえ	s o̞ n o̞ ɯ̟ᵝ e̞
そのばかぎり	s o̞ n o̞ b a̠ k a̠ ɡʲ i ɾʲ i
そば	s o̞ b a̠
そびえる	s o̞ bʲ i e̞ ɾ ɯ̟ᵝ
そぼろ	s o̞ b o̞ ɾ o̞
そむく	s o̞ m ɯ̟ᵝ k ɯ̟ᵝ
そむける	s o̞ m ɯ̟ᵝ k e̞ ɾ ɯ̟ᵝ
そめあげる	s o̞ m e̞ a̠ ɡ e̞ ɾ ɯ̟ᵝ
そめる	s o̞ m e̞ ɾ ɯ̟ᵝ
そもそも	s o̞ m o̞ s o̞ m o̞
そよぐ	s o̞ j o̞ ɡ ɯ̟ᵝ
そらす	s o̞ ɾ a̠ s ɨᵝ
そらみみ	s o̞ ɾ a̠ mʲ i mʲ i
そらめ	s o̞ ɾ a̠ m e̞
そらもよう	s o̞ ɾ a̠ m o̞ j o̞ː
そりじたおん	s o̞ ɾʲ i ʑ i t a̠ õ̞ ɴ
そりゅうし	s o̞ ɾʲ ɨᵝː ɕ i
そる	s o̞ ɾ ɯ̟ᵝ
それ	s o̞ ɾ e̞
それより	s o̞ ɾ e̞ j o̞ ɾʲ i
それる	s o̞ ɾ e̞ ɾ ɯ̟ᵝ
そろう	s o̞ ɾ o̞ ɯ̟ᵝ
そろそろ	s o̞ ɾ o̞ s o̞ ɾ o̞
そろばんだかい	s o̞ ɾ o̞ b ã̠ n d a̠ k a̠ i
そわか	s o̞ ɰᵝ a̠ k a̠
そわそわ	s o̞ ɰᵝ a̠ s o̞ ɰᵝ a̠
そんえきぶんきてん	s õ̞ ɰ̃ e̞ kʲ i b ɯ̟̃ᵝ ŋʲ kʲ i t ẽ̞ ɴ
そんかい	s õ̞ ŋ k a̠ i
そんがい	s õ̞ ŋ ɡ a̠ i
そんき	s õ̞ ŋʲ kʲ i
そんきょ	s õ̞ ŋʲ kʲ o̞
そんげん	s õ̞ ŋ ɡ ẽ̞ ɴ
そんご	s õ̞ ŋ ɡ o̞
そんし	m a̠ ɡ o̞ k o̞
そんしつ	s õ̞ ɰ̃ ɕ i t͡s ɨᵝ
そんしょく	s õ̞ ɰ̃ ɕ o̞ k ɯ̟ᵝ
そんたく	s õ̞ n t a̠ k ɯ̟ᵝ
そんだい	s õ̞ n d a̠ i
そんらく	s õ̞ n ɾ a̠ k ɯ̟ᵝ
ぞう	d͡z o̞ː
ぞうあざらし	d͡z o̞ː a̠ z a̠ ɾ a̠ ɕ i
ぞうお	d͡z o̞ː o̞
ぞうおひょうげん	d͡z o̞ː o̞ ç o̞ː ɡ ẽ̞ ɴ
ぞうがめ	d͡z o̞ː ɡ a̠ m e̞
ぞうき	d͡z o̞ː kʲ i
ぞうけつ	d͡z o̞ː k e̞ t͡s ɨᵝ
ぞうご	d͡z o̞ː ɡ o̞
ぞうしょ	d͡z o̞ː ɕ o̞
ぞうしょう	d͡z o̞ː ɕ o̞ː
ぞうしん	d͡z o̞ː ɕ ĩ ɴ
ぞうに	d͡z o̞ː ɲ̟ i
ぞくけ	d͡z o̞ k ɯ̟ᵝ k e̞
ぞくしょう	d͡z o̞ k ɯ̟ᵝ ɕ o̞ː
ぞくす	d͡z o̞ k ɯ̟ᵝ s ɨᵝ
ぞくぞく	d͡z o̞ k ɯ̟ᵝ z o̞ k ɯ̟ᵝ
ぞくらく	d͡z o̞ k ɯ̟ᵝ ɾ a̠ k ɯ̟ᵝ
ぞっかく	d͡z o̞ k̚ k a̠ k ɯ̟ᵝ
ぞろぞろ	d͡z o̞ ɾ o̞ z o̞ ɾ o̞
ぞろめ	d͡z o̞ ɾ o̞ m e̞
ぞんじる	d͡z õ̞ ɲ̟ d͡ʑ i ɾ ɯ̟ᵝ
たいいくずわり	t a̠ i i k ɯ̟ᵝ z ɨᵝ ɰᵝ a̠ ɾʲ i
たいいんれき	t a̠ i ĩ n ɾ e̞ kʲ i
たいおん	t a̠ i õ̞ ɴ
たいか	t a̠ i k a̠
たいかい	t a̠ i k a̠ i
たいがい	t a̠ i ɡ a̠ i
たいがん	t a̠ i ɡ ã̠ ɴ
たいき	t a̠ i kʲ i
たいきけん	t a̠ i kʲ i̥ k ẽ̞ ɴ
たいきょ	t a̠ i kʲ o̞
たいぎゃく	t a̠ i ɡʲ a̠ k ɯ̟ᵝ
たいぎゃくざい	t a̠ i ɡʲ a̠ k ɯ̟ᵝ z a̠ i
たいく	t a̠ i k ɯ̟ᵝ
たいくん	t a̠ i k ɯ̟̃ᵝ ɴ
たいけいてき	t a̠ i k e̞ː t e̞ kʲ i
たいげんそうご	t a̠ i ɡ ẽ̞ ɰ̃ s o̞ː ɡ o̞
たいこ	t a̠ i k o̞
たいさく	t a̠ i s a̠ k ɯ̟ᵝ
たいさん	t a̠ i s ã̠ ɴ
たいざい	t a̠ i z a̠ i
たいざん	t a̠ i z ã̠ ɴ
たいし	t a̠ i ɕ i
たいしゃ	t a̠ i ɕ a̠
たいしゅう	t a̠ i ɕ ɨᵝː
たいしょりょうほう	t a̠ i ɕ o̞ ɾʲ o̞ː h o̞ː
たいじ	t a̠ i ʑ i
たいじや	t a̠ i ʑ i j a̠
たいすう	t a̠ i s ɨᵝː
たいせい	t a̠ i s e̞ː
たいせき	t a̠ i s e̞ kʲ i
たいせきがん	t a̠ i s e̞ kʲ i ɡ ã̠ ɴ
たいそう	t a̠ i s o̞ː
たいだ	t a̠ i d a̠
たいてい	t a̠ i t e̞ː
たいない	t a̠ i n a̠ i
たいはい	t a̠ i h a̠ i
たいばつ	t a̠ i b a̠ t͡s ɨᵝ
たいふう	t a̠ i ɸ ɯ̟ᵝː
たいぺい	t a̠ i p e̞ː
たいほう	t a̠ i h o̞ː
たいめん	t a̠ i m ẽ̞ ɴ
たいよう	t a̠ i j o̞ː
たいようけい	t a̠ i j o̞ː k e̞ː
たいようしゅう	t a̠ i j o̞ː ɕ ɨᵝː
たいりつ	t a̠ i ɾʲ i t͡s ɨᵝ
たいりゅう	t a̠ i ɾʲ ɨᵝː
たいりょく	t a̠ i ɾʲ o̞ k ɯ̟ᵝ
たいれつ	t a̠ i ɾ e̞ t͡s ɨᵝ
たいわん	t a̠ i ɰᵝ ã̠ ɴ
たいわんご	t a̠ i ɰᵝ ã̠ ŋ ɡ o̞
たうえ	t a̠ ɯ̟ᵝ e̞
たうなぎ	t a̠ ɯ̟ᵝ n a̠ ɡʲ i
たえ	t a̠ e̞
たえず	t a̠ e̞ z ɨᵝ
たえま	t a̠ e̞ m a̠
たえる	t a̠ e̞ ɾ ɯ̟ᵝ
たおす	t a̠ o̞ s ɨᵝ
たおやか	t a̠ o̞ j a̠ k a̠
たおれる	t a̠ o̞ ɾ e̞ ɾ ɯ̟ᵝ
たか	t a̠ k a̠
たかい	t a̠ k a̠ i
たかいびき	t a̠ k a̠ i bʲ i kʲ i
たかが	t a̠ k a̠ ɡ a̠
たかさ	t a̠ k a̠ s a̠
たかす	t a̠ k a̠ s ɨᵝ
たかとび	t a̠ k a̠ t o̞ bʲ i
たかとびこみ	t a̠ k a̠ t o̞ bʲ i k o̞ mʲ i
たかなし	t a̠ k a̠ n a̠ ɕ i
たかなる	t a̠ k a̠ n a̠ ɾ ɯ̟ᵝ
たかね	t a̠ k a̠ n e̞
たかのぶ	t a̠ k a̠ n o̞ b ɯ̟ᵝ
たかはし	t a̠ k a̠ h a̠ ɕ i
たかふみ	t a̠ k a̠ ɸ ɯ̟ᵝ mʲ i
たかまる	t a̠ k a̠ m a̠ ɾ ɯ̟ᵝ
たかめる	t a̠ k a̠ m e̞ ɾ ɯ̟ᵝ
たから	t a̠ k a̠ ɾ a̠
たからか	t a̠ k a̠ ɾ a̠ k a̠
たかんしょう	t a̠ k ã̠ ɰ̃ ɕ o̞ː
たがいにそ	t a̠ ɡ a̠ i ɲ̟ i s o̞
たきがわ	t a̠ kʲ i ɡ a̠ ɰᵝ a̠
たきつける	t a̠ kʲ i t͡s ɨ̥ᵝ k e̞ ɾ ɯ̟ᵝ
たきょう	t a̠ kʲ o̞ː
たぎる	t a̠ ɡʲ i ɾ ɯ̟ᵝ
たく	t a̠ k ɯ̟ᵝ
たくさん	t a̠ k ɯ̟̊ᵝ s ã̠ ɴ
たくし	t a̠ k ɯ̟ᵝ ɕ i
たくみ	t a̠ k ɯ̟ᵝ mʲ i
たくや	t a̠ k ɯ̟ᵝ j a̠
たくらむ	t a̠ k ɯ̟ᵝ ɾ a̠ m ɯ̟ᵝ
たくろく	t a̠ k ɯ̟ᵝ ɾ o̞ k ɯ̟ᵝ
たぐる	t a̠ ɡ ɯ̟ᵝ ɾ ɯ̟ᵝ
たけ	t a̠ k e̞
たけぐし	t a̠ k e̞ ɡ ɯ̟ᵝ ɕ i
たけし	t a̠ k e̞ ɕ i
たけだ	t a̠ k e̞ d a̠
たげんうちゅう	t a̠ ɡ ẽ̞ ɰ̃ ɯ̟ᵝ t͡ɕ ɨᵝː
たげんご	t a̠ ɡ ẽ̞ ŋ ɡ o̞
たこ	t a̠ k o̞
たこう	t a̠ k o̞ː
たこく	t a̠ k o̞ k ɯ̟ᵝ
たさい	t a̠ s a̠ i
たざわ	t a̠ z a̠ ɰᵝ a̠
たし	t a̠ ɕ i
たしか	t a̠ ɕ i k a̠
たしかめる	t a̠ ɕ i k a̠ m e̞ ɾ ɯ̟ᵝ
たしなめる	t a̠ ɕ i n a̠ m e̞ ɾ ɯ̟ᵝ
たじ	t a̠ ʑ i
たす	t a̠ s ɨᵝ
たすけになる	t a̠ s ɨᵝ k e̞ ɲ̟ i n a̠ ɾ ɯ̟ᵝ
たすける	t a̠ s ɨ̥ᵝ k e̞ ɾ ɯ̟ᵝ
たずねる	t a̠ z ɨᵝ n e̞ ɾ ɯ̟ᵝ
たそがれる	t a̠ s o̞ ɡ a̠ ɾ e̞ ɾ ɯ̟ᵝ
たそくるい	t a̠ s o̞ k ɯ̟ᵝ ɾ ɯ̟ᵝ i
たたかい	t a̠ t a̠ k a̠ i
たたかう	t a̠ t a̠ k a̠ ɯ̟ᵝ
たたきおこす	t a̠ t a̠ kʲ i o̞ k o̞ s ɨᵝ
たたく	t a̠ t a̠ k ɯ̟ᵝ
たたずむ	t a̠ t a̠ z ɨᵝ m ɯ̟ᵝ
たたみ	t a̠ t a̠ mʲ i
たたむ	t a̠ t a̠ m ɯ̟ᵝ
たたら	t a̠ t a̠ ɾ a̠
たたり	t a̠ t a̠ ɾʲ i
ただ	t a̠ d a̠
ただし	t a̠ d a̠ ɕ i
ただしい	t a̠ d a̠ ɕ i i
ただしがき	t a̠ d a̠ ɕ i ɡ a̠ kʲ i
ただに	t a̠ d a̠ ɲ̟ i
ただよう	t a̠ d a̠ j o̞ ɯ̟ᵝ
たちあがる	t a̠ t͡ɕ i a̠ ɡ a̠ ɾ ɯ̟ᵝ
たちいりきんし	t a̠ t͡ɕ iː ɾʲ i kʲ ĩ ɰ̃ ɕ i
たちいる	t a̠ t͡ɕ iː ɾ ɯ̟ᵝ
たちえ	t a̠ t͡ɕ i e̞
たちき	t a̠ t͡ɕ i kʲ i
たちきる	t a̠ t͡ɕ i kʲ i ɾ ɯ̟ᵝ
たちつくす	t a̠ t͡ɕ i t͡s ɨᵝ k ɯ̟ᵝ s ɨᵝ
たちなおる	t a̠ t͡ɕ i n a̠ o̞ ɾ ɯ̟ᵝ
たちばな	t a̠ t͡ɕ i b a̠ n a̠
たちまち	t a̠ t͡ɕ i m a̠ t͡ɕ i
たちよる	t a̠ t͡ɕ i j o̞ ɾ ɯ̟ᵝ
たって	t a̠ t̚ t e̞
たっぴつ	t a̠ p̚ʲ pʲ i t͡s ɨᵝ
たつ	t a̠ t͡s ɨᵝ
たつたあげ	t a̠ t͡s ɨᵝ t a̠ a̠ ɡ e̞
たつのおとしご	t a̠ t͡s ɨᵝ n o̞ o̞ t o̞ ɕ i ɡ o̞
たづな	t a̠ z ɨᵝ n a̠
たて	t a̠ t e̞
たてがみ	t a̠ t e̞ ɡ a̠ mʲ i
たてがみいぬ	t a̠ t e̞ ɡ a̠ mʲ iː n ɯ̟ᵝ
たてつく	t a̠ t e̞ t͡s ɨ̥ᵝ k ɯ̟ᵝ
たてぶえ	t a̠ t e̞ b ɯ̟ᵝ e̞
たてよこちりめん	t a̠ t e̞ j o̞ k o̞ t͡ɕ i ɾʲ i m ẽ̞ ɴ
たてる	t a̠ t e̞ ɾ ɯ̟ᵝ
たとえる	t a̠ t o̞ e̞ ɾ ɯ̟ᵝ
たどりつく	t a̠ d o̞ ɾʲ i t͡s ɨᵝ k ɯ̟ᵝ
たどる	t a̠ d o̞ ɾ ɯ̟ᵝ
たどん	t a̠ d õ̞ ɴ
たにま	t a̠ ɲ̟ i m a̠
たぬきねいり	t a̠ n ɯ̟ᵝ kʲ i n e̞ i ɾʲ i
たねだ	t a̠ n e̞ d a̠
たのしい	t a̠ n o̞ ɕ iː
たのみ	t a̠ n o̞ mʲ i
たのむ	t a̠ n o̞ m ɯ̟ᵝ
たば	t a̠ b a̠
たばねる	t a̠ b a̠ n e̞ ɾ ɯ̟ᵝ
たび	t a̠ bʲ i
たびたび	t a̠ bʲ i t a̠ bʲ i
たびびと	t a̠ bʲ i bʲ i t o̞
たぶらかす	t a̠ b ɯ̟ᵝ ɾ a̠ k a̠ s ɨᵝ
たぷたぷ	t a̠ p ɯ̟ᵝ t a̠ p ɯ̟ᵝ
たべる	t a̠ b e̞ ɾ ɯ̟ᵝ
たまぐし	t a̠ m a̠ ɡ ɯ̟ᵝ ɕ i
たましい	t a̠ m a̠ ɕ iː
たまったもんじゃない	t a̠ m a̠ t̚ t a̠ m õ̞ ɲ̟ d͡ʑ a̠ n a̠ i
たまねぎ	t a̠ m a̠ n e̞ ɡʲ i
たまのお	t a̠ m a̠ n o̞ o̞
たまぶくろ	t a̠ m a̠ b ɯ̟ᵝ k ɯ̟ᵝ ɾ o̞
たまむしいろ	t a̠ m a̠ m ɯ̟ᵝ ɕ iː ɾ o̞
たまゆら	t a̠ m a̠ j ɯ̟ᵝ ɾ a̠
たまる	t a̠ m a̠ ɾ ɯ̟ᵝ
たまわる	t a̠ m a̠ ɰᵝ a̠ ɾ ɯ̟ᵝ
たみ	t a̠ mʲ i
たむけ	t a̠ m ɯ̟ᵝ k e̞
ため	t a̠ m e̞
ためいき	t a̠ m e̞ː kʲ i
ためかげ	t a̠ m e̞ k a̠ ɡ e̞
ためし	t a̠ m e̞ ɕ i
ためす	t a̠ m e̞ s ɨᵝ
ためになる	t a̠ m e̞ ɲ̟ i n a̠ ɾ ɯ̟ᵝ
ためらい	t a̠ m e̞ ɾ a̠ i
ためらう	t a̠ m e̞ ɾ a̠ ɯ̟ᵝ
ためる	t a̠ m e̞ ɾ ɯ̟ᵝ
たもつ	t a̠ m o̞ t͡s ɨᵝ
たもと	t a̠ m o̞ t o̞
たやすい	t a̠ j a̠ s ɨᵝ i
たゆたう	t a̠ j ɯ̟ᵝ t a̠ ɯ̟ᵝ
たよる	t a̠ j o̞ ɾ ɯ̟ᵝ
たる	t a̠ ɾ ɯ̟ᵝ
たるむ	t a̠ ɾ ɯ̟ᵝ m ɯ̟ᵝ
たれ	t a̠ ɾ e̞
たれめ	t a̠ ɾ e̞ m e̞
たれる	t a̠ ɾ e̞ ɾ ɯ̟ᵝ
たわけ	t a̠ ɰᵝ a̠ k e̞
たん	t ã̠ ɴ
たんあん	t ã̠ ɰ̃ ã̠ ɴ
たんいけい	t ã̠ ɰ̃ i k e̞ː
たんおし	t ã̠ ɰ̃ o̞ ɕ i
たんこぶ	t ã̠ ŋ k o̞ b ɯ̟ᵝ
たんこん	t ã̠ ŋ k õ̞ ɴ
たんさんいんりょう	t ã̠ ɰ̃ s ã̠ ɰ̃ ĩ n ɾʲ o̞ː
たんさんすい	t ã̠ ɰ̃ s ã̠ ɰ̃ s ɨᵝ i
たんしだい	t ã̠ ɰ̃ ɕ i d a̠ i
たんしょ	t ã̠ ɰ̃ ɕ o̞
たんす	t ã̠ ɰ̃ s ɨᵝ
たんのう	t ã̠ nː o̞ː
たんぱく	t ã̠ m p a̠ k ɯ̟ᵝ
たんぱくしつぶんかいこうそ	t ã̠ m p a̠ k ɯ̟ᵝ ɕ i t͡s ɨᵝ b ɯ̟̃ᵝ ŋ k a̠ i k o̞ː s o̞
たんぽ	t ã̠ m p o̞
たんぽぽ	t ã̠ m p o̞ p o̞
たんまつ	t ã̠ mː a̠ t͡s ɨᵝ
たんよう	t ã̠ ɰ̃ j o̞ː
たんら	t ã̠ n ɾ a̠
たんれん	t ã̠ n ɾ ẽ̞ ɴ
だい	d a̠ i
だいいち	d a̠ i i t͡ɕ i
だいえいていこく	d a̠ i e̞ː t e̞ː k o̞ k ɯ̟ᵝ
だいえつ	d a̠ i e̞ t͡s ɨᵝ
だいおういか	d a̠ i o̞ː i k a̠
だいきぎょう	d a̠ i kʲ i ɡʲ o̞ː
だいきゅうし	d a̠ i kʲ ɨᵝː ɕ i
だいきょう	d a̠ i kʲ o̞ː
だいくんい	d a̠ i k ɯ̟̃ᵝ ɰ̃ i
だいけい	d a̠ i k e̞ː
だいこんやくしゃ	d a̠ i k õ̞ ɰ̃ j a̠ k ɯ̟̊ᵝ ɕ a̠
だいさんき	d a̠ i s ã̠ ŋʲ kʲ i
だいしょう	d a̠ i ɕ o̞ː
だいしらず	d a̠ i ɕ i ɾ a̠ z ɨᵝ
だいじない	d a̠ i ʑ i n a̠ i
だいじょうかん	d a̠ i ʑ o̞ː k ã̠ ɴ
だいじょうぶ	d a̠ i ʑ o̞ː b ɯ̟ᵝ
だいじょうぶっきょう	d a̠ i ʑ o̞ː b ɯ̟ᵝ k̚ʲ kʲ o̞ː
だいじん	d a̠ i ʑ ĩ ɴ
だいす	d a̠ i s ɨᵝ
だいすうかんすう	d a̠ i s ɨᵝː k ã̠ ɰ̃ s ɨᵝː
だいすうがく	d a̠ i s ɨᵝː ɡ a̠ k ɯ̟ᵝ
だいぜんていせん	d a̠ i z ẽ̞ n t e̞ː s ẽ̞ ɴ
だいそれた	d a̠ i s o̞ ɾ e̞ t a̠
だいたい	d a̠ i t a̠ i
だいだい	d a̠ i d a̠ i
だいちょうきん	d a̠ i t͡ɕ o̞ː kʲ ĩ ɴ
だいどうしょうい	d a̠ i d o̞ː ɕ o̞ː i
だいにちにょらい	d a̠ i ɲ̟ i t͡ɕ i ɲ̟ o̞ ɾ a̠ i
だいのうせいりがく	d a̠ i n o̞ː s e̞ː ɾʲ i ɡ a̠ k ɯ̟ᵝ
だいひつ	d a̠ i ç i t͡s ɨᵝ
だいひょうだん	d a̠ i ç o̞ː d ã̠ ɴ
だいぶ	d a̠ i b ɯ̟ᵝ
だいほっさ	d a̠ i h o̞ sː a̠
だいぼいんすいい	d a̠ i b o̞ ĩ ɰ̃ s ɨᵝ i i
だいみょう	d a̠ i mʲ o̞ː
だいやく	d a̠ i j a̠ k ɯ̟ᵝ
だかいさく	d a̠ k a̠ i s a̠ k ɯ̟ᵝ
だかん	d a̠ k ã̠ ɴ
だがし	d a̠ ɡ a̠ ɕ i
だき	d a̠ kʲ i
だきかかえる	d a̠ kʲ i k a̠ k a̠ e̞ ɾ ɯ̟ᵝ
だきしめる	d a̠ kʲ i ɕ i m e̞ ɾ ɯ̟ᵝ
だく	d a̠ k ɯ̟ᵝ
だけど	d a̠ k e̞ d o̞
だけん	d a̠ k ẽ̞ ɴ
ださく	d a̠ s a̠ k ɯ̟ᵝ
だしゃ	d a̠ ɕ a̠
だしん	d a̠ ɕ ĩ ɴ
だじゃれ	d a̠ ʑ a̠ ɾ e̞
だす	d a̠ s ɨᵝ
だっこ	d a̠ k̚ k o̞
だっこう	d a̠ k̚ k o̞ː
だっしょく	d a̠ ɕː o̞ k ɯ̟ᵝ
だっぽう	d a̠ p̚ p o̞ː
だつ	d a̠ t͡s ɨᵝ
だつじ	d a̠ t͡s ɨᵝ ʑ i
だつぜい	d a̠ t͡s ɨᵝ z e̞ː
だとう	d a̠ t o̞ː
だに	d a̠ ɲ̟ i
だます	d a̠ m a̠ s ɨᵝ
だまりこむ	d a̠ m a̠ ɾʲ i k o̞ m ɯ̟ᵝ
だまる	d a̠ m a̠ ɾ ɯ̟ᵝ
だみごえ	d a̠ mʲ i ɡ o̞ e̞
だらだら	d a̠ ɾ a̠ d a̠ ɾ a̠
だるま	d a̠ ɾ ɯ̟ᵝ m a̠
だれ	d a̠ ɾ e̞
だん	d ã̠ ɴ
だんいん	d ã̠ ɰ̃ ĩ ɴ
だんがん	d ã̠ ŋ ɡ ã̠ ɴ
だんがんれっしゃ	d ã̠ ŋ ɡ ã̠ n ɾ e̞ ɕː a̠
だんこ	d ã̠ ŋ k o̞
だんごむし	d ã̠ ŋ ɡ o̞ m ɯ̟ᵝ ɕ i
だんしょう	d ã̠ ɰ̃ ɕ o̞ː
だんしょうしゅぎ	d ã̠ ɰ̃ ɕ o̞ː ɕ ɨᵝ ɡʲ i
だんしょく	d ã̠ ɰ̃ ɕ o̞ k ɯ̟ᵝ
だんせい	d ã̠ ɰ̃ s e̞ː
だんせん	d ã̠ ɰ̃ s ẽ̞ ɴ
だんたい	d ã̠ n t a̠ i
だんち	d ã̠ ɲ̟ t͡ɕ i
だんちょう	d ã̠ ɲ̟ t͡ɕ o̞ː
だんとう	d ã̠ n t o̞ː
だんどり	d ã̠ n d o̞ ɾʲ i
だんな	d ã̠ nː a̠
だんねん	d ã̠ nː ẽ̞ ɴ
だんまつま	d ã̠ mː a̠ t͡s ɨᵝ m a̠
だんりょく	d ã̠ n ɾʲ o̞ k ɯ̟ᵝ
だんわ	d ã̠ ɰ̃ ɰᵝ a̠
ちあき	t͡ɕ i a̠ kʲ i
ちいさな	t͡ɕ iː s a̠ n a̠
ちいさめ	t͡ɕ iː s a̠ m e̞
ちえ	t͡ɕ i e̞
ちか	t͡ɕ i k a̠
ちかう	t͡ɕ i̥ k a̠ ɯ̟ᵝ
ちかてつ	t͡ɕ i̥ k a̠ t e̞ t͡s ɨᵝ
ちかみち	t͡ɕ i k a̠ mʲ i t͡ɕ i
ちから	t͡ɕ i̥ k a̠ ɾ a̠
ちからづよい	t͡ɕ i̥ k a̠ ɾ a̠ z ɨᵝ j o̞ i
ちがい	t͡ɕ i ɡ a̠ i
ちがう	t͡ɕ i ɡ a̠ ɯ̟ᵝ
ちがえる	t͡ɕ i ɡ a̠ e̞ ɾ ɯ̟ᵝ
ちぎる	t͡ɕ i ɡʲ i ɾ ɯ̟ᵝ
ちぎれる	t͡ɕ i ɡʲ i ɾ e̞ ɾ ɯ̟ᵝ
ちくさつば	t͡ɕ i k ɯ̟ᵝ s a̠ t͡s ɨᵝ b a̠
ちくじ	t͡ɕ i k ɯ̟ᵝ ʑ i
ちくせい	t͡ɕ i k ɯ̟ᵝ s e̞ː
ちくでんき	t͡ɕ i k ɯ̟̊ᵝ d ẽ̞ ŋʲ kʲ i
ちくび	t͡ɕ i k ɯ̟ᵝ bʲ i
ちご	t͡ɕ i ɡ o̞
ちしき	t͡ɕ i ɕ i̥ kʲ i
ちしまれっとう	t͡ɕ i ɕ i m a̠ ɾ e̞ t̚ t o̞ː
ちじょ	t͡ɕ i ʑ o̞
ちじょうは	t͡ɕ i ʑ o̞ː h a̠
ちず	t͡ɕ i z ɨᵝ
ちせいがく	t͡ɕ i̥ s e̞ː ɡ a̠ k ɯ̟ᵝ
ちせつ	t͡ɕ i s e̞ t͡s ɨᵝ
ちちご	t͡ɕ i t͡ɕ i ɡ o̞
ちちのひ	t͡ɕ i̥ t͡ɕ i n o̞ ç i
ちぢむ	t͡ɕ i ʑ i m ɯ̟ᵝ
ちぢめる	t͡ɕ i ʑ i m e̞ ɾ ɯ̟ᵝ
ちっこい	t͡ɕ i̥ k̚ k o̞ i
ちっちゃい	t͡ɕ i̥ t̚ t͡ɕ a̠ i
ちていじん	t͡ɕ i t e̞ː ʑ ĩ ɴ
ちてん	t͡ɕ i t ẽ̞ ɴ
ちと	t͡ɕ i t o̞
ちとせ	t͡ɕ i̥ t o̞ s e̞
ちどり	t͡ɕ i d o̞ ɾʲ i
ちな	t͡ɕ i n a̠
ちなむ	t͡ɕ i n a̠ m ɯ̟ᵝ
ちのうしすう	t͡ɕ i n o̞ː ɕ i̥ s ɨᵝː
ちばけん	t͡ɕ i b a̠ k ẽ̞ ɴ
ちび	t͡ɕ i bʲ i
ちびっこ	t͡ɕ i bʲ i k̚ k o̞
ちびる	t͡ɕ i bʲ i ɾ ɯ̟ᵝ
ちぶ	t͡ɕ i b ɯ̟ᵝ
ちほう	t͡ɕ i h o̞ː
ちまき	t͡ɕ i m a̠ kʲ i
ちまよう	t͡ɕ i m a̠ j o̞ː
ちめ	t͡ɕ i m e̞
ちゃ	t͡ɕ a̠
ちゃいろい	t͡ɕ a̠ i ɾ o̞ i
ちゃかす	t͡ɕ a̠ k a̠ s ɨᵝ
ちゃくすい	t͡ɕ a̠ k ɯ̟ᵝ s ɨᵝ i
ちゃくせい	t͡ɕ a̠ k ɯ̟̊ᵝ s e̞ː
ちゃくだつ	t͡ɕ a̠ k ɯ̟ᵝ d a̠ t͡s ɨᵝ
ちゃくりく	t͡ɕ a̠ k ɯ̟ᵝ ɾʲ i k ɯ̟ᵝ
ちゃづけ	t͡ɕ a̠ z ɨᵝ k e̞
ちゃばたけ	t͡ɕ a̠ b a̠ t a̠ k e̞
ちゃんぽん	t͡ɕ ã̠ m p õ̞ ɴ
ちやほや	t͡ɕ i j a̠ h o̞ j a̠
ちゅう	t͡ɕ ɨᵝː
ちゅうい	t͡ɕ ɨᵝː i
ちゅうかそば	t͡ɕ ɨᵝː k a̠ s o̞ b a̠
ちゅうかんけん	t͡ɕ ɨᵝː k ã̠ ŋ k ẽ̞ ɴ
ちゅうかんし	t͡ɕ ɨᵝː k ã̠ ɰ̃ ɕ i
ちゅうきえいご	t͡ɕ ɨᵝː kʲ i e̞ː ɡ o̞
ちゅうきんとう	t͡ɕ ɨᵝː kʲ ĩ n t o̞ː
ちゅうごく	t͡ɕ ɨᵝː ɡ o̞ k ɯ̟ᵝ
ちゅうごくか	t͡ɕ ɨᵝː ɡ o̞ k ɯ̟ᵝ k a̠
ちゅうさ	t͡ɕ ɨᵝː s a̠
ちゅうさいにん	t͡ɕ ɨᵝː s a̠ i ɲ̟ ĩ ɴ
ちゅうしょく	t͡ɕ ɨᵝː ɕ o̞ k ɯ̟ᵝ
ちゅうしん	t͡ɕ ɨᵝː ɕ ĩ ɴ
ちゅうせい	t͡ɕ ɨᵝː s e̞ː
ちゅうぜつ	t͡ɕ ɨᵝː z e̞ t͡s ɨᵝ
ちゅうそつ	t͡ɕ ɨᵝː s o̞ t͡s ɨᵝ
ちゅうたい	t͡ɕ ɨᵝː t a̠ i
ちゅうちょ	t͡ɕ ɨᵝː t͡ɕ o̞
ちゅうでんきん	t͡ɕ ɨᵝː d ẽ̞ ŋʲ kʲ ĩ ɴ
ちゅうとう	t͡ɕ ɨᵝː t o̞ː
ちゅうとうきょういくがっこう	t͡ɕ ɨᵝː t o̞ː kʲ o̞ː i k ɯ̟ᵝ ɡ a̠ k̚ k o̞ː
ちゅうどくせい	t͡ɕ ɨᵝː d o̞ k ɯ̟ᵝ s e̞ː
ちゅうひ	t͡ɕ ɨᵝː ç i
ちゅうりゃく	t͡ɕ ɨᵝː ɾʲ a̠ k ɯ̟ᵝ
ちゅうりん	t͡ɕ ɨᵝː ɾʲ ĩ ɴ
ちゅんてん	t͡ɕ ɨ̃ᵝ n t ẽ̞ ɴ
ちょ	t͡ɕ o̞
ちょう	t͡ɕ o̞ː
ちょうえつかんすう	t͡ɕ o̞ː e̞ t͡s ɨᵝ k ã̠ ɰ̃ s ɨᵝː
ちょうおんぷ	t͡ɕ o̞ː õ̞ m p ɯ̟ᵝ
ちょうかい	t͡ɕ o̞ː k a̠ i
ちょうげんじつ	t͡ɕ o̞ː ɡ ẽ̞ ɲ̟ d͡ʑ i t͡s ɨᵝ
ちょうしつ	t͡ɕ o̞ː ɕ i t͡s ɨᵝ
ちょうしょ	t͡ɕ o̞ː ɕ o̞
ちょうしょう	t͡ɕ o̞ː ɕ o̞ː
ちょうしんせい	t͡ɕ o̞ː ɕ ĩ ɰ̃ s e̞ː
ちょうしんるこつ	t͡ɕ o̞ː ɕ ĩ n ɾ ɯ̟ᵝ k o̞ t͡s ɨᵝ
ちょうじかん	t͡ɕ o̞ː ʑ i k ã̠ ɴ
ちょうせん	t͡ɕ o̞ː s ẽ̞ ɴ
ちょうせんはんとう	t͡ɕ o̞ː s ẽ̞ ɰ̃ h ã̠ n t o̞ː
ちょうだい	t͡ɕ o̞ː d a̠ i
ちょうちょう	t͡ɕ o̞ː t͡ɕ o̞ː
ちょうちんあんこう	t͡ɕ o̞ː t͡ɕ ĩ ɰ̃ ã̠ ŋ k o̞ː
ちょうていしゅうはおん	t͡ɕ o̞ː t e̞ː ɕ ɨᵝː h a̠ õ̞ ɴ
ちょうてき	t͡ɕ o̞ː t e̞ kʲ i
ちょうてん	t͡ɕ o̞ː t ẽ̞ ɴ
ちょうど	t͡ɕ o̞ː d o̞
ちょうなん	t͡ɕ o̞ː n ã̠ ɴ
ちょうにゅう	t͡ɕ o̞ː ɲ̟ ɯ̟ᵝː
ちょうはつ	t͡ɕ o̞ː h a̠ t͡s ɨᵝ
ちょうはつぞく	t͡ɕ o̞ː h a̠ t͡s ɨᵝ z o̞ k ɯ̟ᵝ
ちょうふ	t͡ɕ o̞ː ɸ ɯ̟ᵝ
ちょうへん	t͡ɕ o̞ː h ẽ̞ ɴ
ちょうぼ	t͡ɕ o̞ː b o̞
ちょうやく	t͡ɕ o̞ː j a̠ k ɯ̟ᵝ
ちょうり	t͡ɕ o̞ː ɾʲ i
ちょうれい	t͡ɕ o̞ː ɾ e̞ː
ちょくし	t͡ɕ o̞ k ɯ̟̊ᵝ ɕ i
ちょくちょう	t͡ɕ o̞ k ɯ̟̊ᵝ t͡ɕ o̞ː
ちょくめん	t͡ɕ o̞ k ɯ̟ᵝ m ẽ̞ ɴ
ちょくりつ	t͡ɕ o̞ k ɯ̟ᵝ ɾʲ i t͡s ɨᵝ
ちょっかく	t͡ɕ o̞ k̚ k a̠ k ɯ̟ᵝ
ちょっかっこう	t͡ɕ o̞ k̚ k a̠ k̚ k o̞ː
ちょっかん	t͡ɕ o̞ k̚ k ã̠ ɴ
ちょっかんてき	t͡ɕ o̞ k̚ k ã̠ n t e̞ kʲ i
ちょっきゅう	t͡ɕ o̞ k̚ʲ kʲ ɨᵝː
ちょっと	t͡ɕ o̞ t̚ t o̞
ちょろい	t͡ɕ o̞ ɾ o̞ i
ちらかる	t͡ɕ i ɾ a̠ k a̠ ɾ ɯ̟ᵝ
ちらす	t͡ɕ i ɾ a̠ s ɨᵝ
ちらつく	t͡ɕ i ɾ a̠ t͡s ɨᵝ k ɯ̟ᵝ
ちらばる	t͡ɕ i ɾ a̠ b a̠ ɾ ɯ̟ᵝ
ちり	t͡ɕ i ɾʲ i
ちりめん	t͡ɕ i ɾʲ i m ẽ̞ ɴ
ちりゃく	t͡ɕ i ɾʲ a̠ k ɯ̟ᵝ
ちりょう	t͡ɕ i ɾʲ o̞ː
ちりょく	t͡ɕ i ɾʲ o̞ k ɯ̟ᵝ
ちりれんげ	t͡ɕ i ɾʲ i ɾ ẽ̞ ŋ ɡ e̞
ちる	t͡ɕ i ɾ ɯ̟ᵝ
ちんあなご	t͡ɕ ĩ ɰ̃ a̠ n a̠ ɡ o̞
ちんこ	t͡ɕ ĩ ŋ k o̞
ちんこう	t͡ɕ ĩ ŋ k o̞ː
ちんこん	t͡ɕ ĩ ŋ k õ̞ ɴ
ちんこんきょく	t͡ɕ ĩ ŋ k õ̞ ŋʲ kʲ o̞ k ɯ̟ᵝ
ちんご	t͡ɕ ĩ ŋ ɡ o̞
ちんしゃ	t͡ɕ ĩ ɰ̃ ɕ a̠
ちんじゅつ	t͡ɕ ĩ ɲ̟ d͡ʑ ɨᵝ t͡s ɨᵝ
ちんせいか	t͡ɕ ĩ ɰ̃ s e̞ː k a̠
ちんちろりん	t͡ɕ ĩ ɲ̟ t͡ɕ i ɾ o̞ ɾʲ ĩ ɴ
ちんつう	t͡ɕ ĩ n t͡s ɨᵝː
ちんつうざい	t͡ɕ ĩ n t͡s ɨᵝː z a̠ i
ちんぷんかん	t͡ɕ ĩ m p ɯ̟̃ᵝ ŋ k ã̠ ɴ
ちんぽ	t͡ɕ ĩ m p o̞
ちんもく	t͡ɕ ĩ mː o̞ k ɯ̟ᵝ
ぢゅ	d͡ʑ ɨᵝ
っしゃ	ɕː a̠
っす	sː ɯ̟ᵝ
って	t̚ t e̞
ってば	t̚ t e̞ b a̠
ついか	t͡s ɨᵝ i k a̠
ついしけん	t͡s ɨᵝ i ɕ i k ẽ̞ ɴ
ついじゅう	t͡s ɨᵝ i ʑ ɨᵝː
ついせき	t͡s ɨᵝ i s e̞ kʲ i
ついそう	t͡s ɨᵝ i s o̞ː
ついぞ	t͡s ɨᵝ i z o̞
ついたち	t͡s ɨᵝ i t a̠ t͡ɕ i
ついとつ	t͡s ɨᵝ i t o̞ t͡s ɨᵝ
ついばむ	t͡s ɨᵝ i b a̠ m ɯ̟ᵝ
ついほう	t͡s ɨᵝ i h o̞ː
ついやす	t͡s ɨᵝ i j a̠ s ɨᵝ
ついらく	t͡s ɨᵝ i ɾ a̠ k ɯ̟ᵝ
つうか	t͡s ɨᵝː k a̠
つうきん	t͡s ɨᵝː kʲ ĩ ɴ
つうこう	t͡s ɨᵝː k o̞ː
つうこく	t͡s ɨᵝː k o̞ k ɯ̟ᵝ
つうしん	t͡s ɨᵝː ɕ ĩ ɴ
つうしんはんばい	t͡s ɨᵝː ɕ ĩ ɰ̃ h ã̠ m b a̠ i
つうちょう	t͡s ɨᵝː t͡ɕ o̞ː
つうれつ	t͡s ɨᵝː ɾ e̞ t͡s ɨᵝ
つうろ	t͡s ɨᵝː ɾ o̞
つうわ	t͡s ɨᵝː ɰᵝ a̠
つえ	t͡s ɨᵝ e̞
つか	t͡s ɨ̥ᵝ k a̠
つかい	t͡s ɨ̥ᵝ k a̠ i
つかいっぱしり	t͡s ɨᵝ k a̠ i p̚ p a̠ ɕ i ɾʲ i
つかいふるし	t͡s ɨᵝ k a̠ i ɸ ɯ̟ᵝ ɾ ɯ̟ᵝ ɕ i
つかいみち	t͡s ɨ̥ᵝ k a̠ i mʲ i t͡ɕ i
つかう	t͡s ɨ̥ᵝ k a̠ ɯ̟ᵝ
つかえる	t͡s ɨᵝ k a̠ e̞ ɾ ɯ̟ᵝ
つかさどる	t͡s ɨ̥ᵝ k a̠ s a̠ d o̞ ɾ ɯ̟ᵝ
つかまえる	t͡s ɨᵝ k a̠ m a̠ e̞ ɾ ɯ̟ᵝ
つかまつる	t͡s ɨᵝ k a̠ m a̠ t͡s ɨᵝ ɾ ɯ̟ᵝ
つかまる	t͡s ɨᵝ k a̠ m a̠ ɾ ɯ̟ᵝ
つかる	t͡s ɨᵝ k a̠ ɾ ɯ̟ᵝ
つかれ	t͡s ɨ̥ᵝ k a̠ ɾ e̞
つかれる	t͡s ɨᵝ k a̠ ɾ e̞ ɾ ɯ̟ᵝ
つが	t͡s ɨᵝ ɡ a̠
つがう	t͡s ɨᵝ ɡ a̠ ɯ̟ᵝ
つがざくら	t͡s ɨᵝ ɡ a̠ z a̠ k ɯ̟ᵝ ɾ a̠
つがる	t͡s ɨᵝ ɡ a̠ ɾ ɯ̟ᵝ
つきあい	t͡s ɨ̥ᵝ kʲ i a̠ i
つきあう	t͡s ɨᵝ kʲ i a̠ ɯ̟ᵝ
つきあたり	t͡s ɨᵝ kʲ i a̠ t a̠ ɾʲ i
つきあたる	t͡s ɨᵝ kʲ i a̠ t a̠ ɾ ɯ̟ᵝ
つきかげ	t͡s ɨ̥ᵝ kʲ i k a̠ ɡ e̞
つきすすむ	t͡s ɨᵝ kʲ i s ɨᵝ s ɨᵝ m ɯ̟ᵝ
つきつめる	t͡s ɨᵝ kʲ i t͡s ɨᵝ m e̞ ɾ ɯ̟ᵝ
つきとめる	t͡s ɨᵝ kʲ i t o̞ m e̞ ɾ ɯ̟ᵝ
つきまとう	t͡s ɨᵝ kʲ i m a̠ t o̞ ɯ̟ᵝ
つきみ	t͡s ɨᵝ kʲ i mʲ i
つきんぼう	t͡s ɨᵝ kʲ ĩ m b o̞ː
つく	t͡s ɨᵝ k ɯ̟ᵝ
つくえ	t͡s ɨᵝ k ɯ̟ᵝ e̞
つくす	t͡s ɨᵝ k ɯ̟ᵝ s ɨᵝ
つくね	t͡s ɨ̥ᵝ k ɯ̟ᵝ n e̞
つくひよ	t͡s ɨᵝ k ɯ̟ᵝ ç i j o̞
つくり	t͡s ɨᵝ k ɯ̟ᵝ ɾʲ i
つくりあげる	t͡s ɨᵝ k ɯ̟ᵝ ɾʲ i a̠ ɡ e̞ ɾ ɯ̟ᵝ
つくりたけ	t͡s ɨᵝ k ɯ̟ᵝ ɾʲ i t a̠ k e̞
つくりだす	t͡s ɨᵝ k ɯ̟ᵝ ɾʲ i d a̠ s ɨᵝ
つくりもの	t͡s ɨᵝ k ɯ̟ᵝ ɾʲ i m o̞ n o̞
つくろう	t͡s ɨᵝ k ɯ̟ᵝ ɾ o̞ ɯ̟ᵝ
つぐ	t͡s ɨᵝ ɡ ɯ̟ᵝ
つぐなう	t͡s ɨᵝ ɡ ɯ̟ᵝ n a̠ ɯ̟ᵝ
つけくわえる	t͡s ɨᵝ k e̞ k ɯ̟ᵝ ɰᵝ a̠ e̞ ɾ ɯ̟ᵝ
つけこむ	t͡s ɨᵝ k e̞ k o̞ m ɯ̟ᵝ
つけもの	t͡s ɨ̥ᵝ k e̞ m o̞ n o̞
つげる	t͡s ɨᵝ ɡ e̞ ɾ ɯ̟ᵝ
つごう	t͡s ɨᵝ ɡ o̞ː
つじうらせんべい	t͡s ɨᵝ ʑ i ɯ̟ᵝ ɾ a̠ s ẽ̞ m b e̞ː
つじぎり	t͡s ɨᵝ ʑ i ɡʲ i ɾʲ i
つじじどうしゃ	t͡s ɨᵝ ʑ i ʑ i d o̞ː ɕ a̠
つじつま	t͡s ɨᵝ ʑ i t͡s ɨᵝ m a̠
つたない	t͡s ɨᵝ t a̠ n a̠ i
つたわる	t͡s ɨᵝ t a̠ ɰᵝ a̠ ɾ ɯ̟ᵝ
つちかう	t͡s ɨᵝ t͡ɕ i k a̠ ɯ̟ᵝ
つちぐも	t͡s ɨ̥ᵝ t͡ɕ i ɡ ɯ̟ᵝ m o̞
つっこみ	t͡s ɨ̥ᵝ k̚ k o̞ mʲ i
つっこむ	t͡s ɨᵝ k̚ k o̞ m ɯ̟ᵝ
つっぱり	t͡s ɨᵝ p̚ p a̠ ɾʲ i
つっぱりぼう	t͡s ɨᵝ p̚ p a̠ ɾʲ i b o̞ː
つつ	t͡s ɨ̥ᵝ t͡s ɨᵝ
つついづつ	t͡s ɨᵝ t͡s ɨᵝ i z ɨᵝ t͡s ɨᵝ
つつきまわす	t͡s ɨᵝ t͡s ɨᵝ kʲ i m a̠ ɰᵝ a̠ s ɨᵝ
つつしむ	t͡s ɨᵝ t͡s ɨᵝ ɕ i m ɯ̟ᵝ
つづみ	t͡s ɨᵝ z ɨᵝ mʲ i
つづり	t͡s ɨᵝ z ɨᵝ ɾʲ i
つづる	t͡s ɨᵝ z ɨᵝ ɾ ɯ̟ᵝ
つて	t͡s ɨ̥ᵝ t e̞
つとまる	t͡s ɨᵝ t o̞ m a̠ ɾ ɯ̟ᵝ
つとめる	t͡s ɨᵝ t o̞ m e̞ ɾ ɯ̟ᵝ
つどう	t͡s ɨᵝ d o̞ ɯ̟ᵝ
つな	t͡s ɨᵝ n a̠
つなぐ	t͡s ɨᵝ n a̠ ɡ ɯ̟ᵝ
つなみけいほう	t͡s ɨᵝ n a̠ mʲ i k e̞ː h o̞ː
つのめどり	t͡s ɨᵝ n o̞ m e̞ d o̞ ɾʲ i
つのる	t͡s ɨᵝ n o̞ ɾ ɯ̟ᵝ
つば	t͡s ɨᵝ b a̠
つばくらめ	t͡s ɨᵝ b a̠ k ɯ̟ᵝ ɾ a̠ m e̞
つばさ	t͡s ɨᵝ b a̠ s a̠
つぶす	t͡s ɨᵝ b ɯ̟ᵝ s ɨᵝ
つぶやき	t͡s ɨᵝ b ɯ̟ᵝ j a̠ kʲ i
つぶやく	t͡s ɨᵝ b ɯ̟ᵝ j a̠ k ɯ̟ᵝ
つぶる	t͡s ɨᵝ b ɯ̟ᵝ ɾ ɯ̟ᵝ
つぶれる	t͡s ɨᵝ b ɯ̟ᵝ ɾ e̞ ɾ ɯ̟ᵝ
つべ	t͡s ɨᵝ b e̞
つぼる	t͡s ɨᵝ b o̞ ɾ ɯ̟ᵝ
つま	t͡s ɨᵝ m a̠
つまさき	t͡s ɨᵝ m a̠ s a̠ kʲ i
つまずく	t͡s ɨᵝ m a̠ z ɨᵝ k ɯ̟ᵝ
つまびく	t͡s ɨᵝ m a̠ bʲ i k ɯ̟ᵝ
つまる	t͡s ɨᵝ m a̠ ɾ ɯ̟ᵝ
つみぶかい	t͡s ɨᵝ mʲ i b ɯ̟ᵝ k a̠ i
つみれ	t͡s ɨᵝ mʲ i ɾ e̞
つむる	t͡s ɨᵝ m ɯ̟ᵝ ɾ ɯ̟ᵝ
つめ	t͡s ɨᵝ m e̞
つめかんむり	t͡s ɨᵝ m e̞ k ã̠ mː ɯ̟ᵝ ɾʲ i
つめる	t͡s ɨᵝ m e̞ ɾ ɯ̟ᵝ
つや	t͡s ɨᵝ j a̠
つゆ	t͡s ɨᵝ j ɯ̟ᵝ
つゆあけ	t͡s ɨᵝ j ɯ̟ᵝ a̠ k e̞
つよび	t͡s ɨᵝ j o̞ bʲ i
つよまる	t͡s ɨᵝ j o̞ m a̠ ɾ ɯ̟ᵝ
つらなる	t͡s ɨᵝ ɾ a̠ n a̠ ɾ ɯ̟ᵝ
つらねる	t͡s ɨᵝ ɾ a̠ n e̞ ɾ ɯ̟ᵝ
つりぐ	t͡s ɨᵝ ɾʲ i ɡ ɯ̟ᵝ
つりばしこうか	t͡s ɨᵝ ɾʲ i b a̠ ɕ i k o̞ː k a̠
つる	t͡s ɨᵝ ɾ ɯ̟ᵝ
つるす	t͡s ɨᵝ ɾ ɯ̟ᵝ s ɨᵝ
つるはし	t͡s ɨᵝ ɾ ɯ̟ᵝ h a̠ ɕ i
つれ	t͡s ɨᵝ ɾ e̞
つれさる	t͡s ɨᵝ ɾ e̞ s a̠ ɾ ɯ̟ᵝ
つれだす	t͡s ɨᵝ ɾ e̞ d a̠ s ɨᵝ
つわり	t͡s ɨᵝ ɰᵝ a̠ ɾʲ i
つ゚	t ɯ̟ᵝ
てあし	t e̞ a̠ ɕ i
てあて	t e̞ a̠ t e̞
ていおうせっかい	t e̞ː o̞ː s e̞ k̚ k a̠ i
ていきゅう	t e̞ː kʲ ɨᵝː
ていきん	t e̞ː kʲ ĩ ɴ
ていぎ	t e̞ː ɡʲ i
ていこうき	t e̞ː k o̞ː kʲ i
ていし	t e̞ː ɕ i
ていしゃじょう	t e̞ː ɕ a̠ ʑ o̞ː
ていしゅかんぱく	t e̞ː ɕ ɨᵝ k ã̠ m p a̠ k ɯ̟ᵝ
ていしょとくしゃ	t e̞ː ɕ o̞ t o̞ k ɯ̟ᵝ s o̞ː
ていじ	t e̞ː ʑ i
ていじゅう	t e̞ː ʑ ɨᵝː
ていせつ	t e̞ː s e̞ t͡s ɨᵝ
ていぞく	t e̞ː z o̞ k ɯ̟ᵝ
ていちゃく	t e̞ː t͡ɕ a̠ k ɯ̟ᵝ
ていてつ	t e̞ː t e̞ t͡s ɨᵝ
ていぼう	t e̞ː b o̞ː
ていれ	t e̞ i ɾ e̞
ていれつ	t e̞ː ɾ e̞ t͡s ɨᵝ
てかがみ	t e̞ k a̠ ɡ a̠ mʲ i
てかき	t e̞ k a̠ kʲ i
てかてか	t e̞ k a̠ t e̞ k a̠
てがける	t e̞ ɡ a̠ k e̞ ɾ ɯ̟ᵝ
てがる	t e̞ ɡ a̠ ɾ ɯ̟ᵝ
てき	t e̞ kʲ i
てきおう	t e̞ kʲ i o̞ː
てきしゅつ	t e̞ kʲ i ɕ ɨᵝ t͡s ɨᵝ
てきだんへい	t e̞ kʲ i d ã̠ ɰ̃ h e̞ː
てきち	t e̞ kʲ i t͡ɕ i
てきちょく	t e̞ kʲ i t͡ɕ o̞ k ɯ̟ᵝ
てきよう	t e̞ kʲ i j o̞ː
てぎわ	t e̞ ɡʲ i ɰᵝ a̠
てこずる	t e̞ k o̞ z ɨᵝ ɾ ɯ̟ᵝ
てさき	t e̞ s a̠ kʲ i
てさばき	t e̞ s a̠ b a̠ kʲ i
てじゅん	t e̞ ʑ ɨ̃ᵝ ɴ
てじょう	t e̞ ʑ o̞ː
てだて	t e̞ d a̠ t e̞
てっかい	t e̞ k̚ k a̠ i
てっき	t e̞ k̚ʲ kʲ i
てっきり	t e̞ k̚ʲ kʲ i ɾʲ i
てっきん	t e̞ k̚ʲ kʲ ĩ ɴ
てっこう	t e̞ k̚ k o̞ː
てっこうかぎ	t e̞ k̚ k o̞ː k a̠ ɡʲ i
てっさ	t e̞ sː a̠
てっせい	t e̞ sː e̞ː
てつ	t e̞ t͡s ɨᵝ
てつがく	t e̞ t͡s ɨᵝ ɡ a̠ k ɯ̟ᵝ
てつくず	t e̞ t͡s ɨᵝ k ɯ̟ᵝ z ɨᵝ
てつじ	t e̞ t͡s ɨᵝ ʑ i
てつだう	t e̞ t͡s ɨᵝ d a̠ ɯ̟ᵝ
てつばんど	t e̞ t͡s ɨᵝ b ã̠ n d o̞
てつびん	t e̞ t͡s ɨᵝ bʲ ĩ ɴ
てつや	t e̞ t͡s ɨᵝ j a̠
てつをふむ	t e̞ t͡s ɨᵝ o̞ ɸ ɯ̟ᵝ m ɯ̟ᵝ
てづくり	t e̞ z ɨᵝ k ɯ̟ᵝ ɾʲ i
てながざる	t e̞ n a̠ ɡ a̠ z a̠ ɾ ɯ̟ᵝ
てなみ	t e̞ n a̠ mʲ i
てにはいる	t e̞ ɲ̟ i h a̠ i ɾ ɯ̟ᵝ
てぬかり	t e̞ n ɯ̟ᵝ k a̠ ɾʲ i
てぬぐい	t e̞ n ɯ̟ᵝ ɡ ɯ̟ᵝ i
てばた	t e̞ b a̠ t a̠
てぶれ	t e̞ b ɯ̟ᵝ ɾ e̞
てまえ	t e̞ m a̠ e̞
てみじか	t e̞ mʲ i ʑ i k a̠
てめ	t e̞ m e̞
てら	t e̞ ɾ a̠
てらう	t e̞ ɾ a̠ ɯ̟ᵝ
てりかえす	t e̞ ɾʲ i k a̠ e̞ s ɨᵝ
てりょうり	t e̞ ɾʲ o̞ː ɾʲ i
てる	t e̞ ɾ ɯ̟ᵝ
てるお	t e̞ ɾ ɯ̟ᵝ o̞
てるてるぼうず	t e̞ ɾ ɯ̟ᵝ t e̞ ɾ ɯ̟ᵝ b o̞ː z ɨᵝ
てるのぶ	t e̞ ɾ ɯ̟ᵝ n o̞ b ɯ̟ᵝ
てるひで	t e̞ ɾ ɯ̟ᵝ ç i d e̞
てわたす	t e̞ ɰᵝ a̠ t a̠ s ɨᵝ
てん	t ẽ̞ ɴ
てんい	t ẽ̞ ɰ̃ i
てんか	t ẽ̞ ŋ k a̠
てんかつきゅう	t ẽ̞ ŋ k a̠ t͡s ɨ̥ᵝ kʲ ɨᵝː
てんかん	t ẽ̞ ŋ k ã̠ ɴ
てんが	t ẽ̞ ŋ ɡ a̠
てんがじゅう	t ẽ̞ ŋ ɡ a̠ ʑ ɨᵝː
てんき	t ẽ̞ ŋʲ kʲ i
てんくう	t ẽ̞ ŋ k ɯ̟ᵝː
てんぐ	t ẽ̞ ŋ ɡ ɯ̟ᵝ
てんけい	t ẽ̞ ŋ k e̞ː
てんけん	t ẽ̞ ŋ k ẽ̞ ɴ
てんこう	t ẽ̞ ŋ k o̞ː
てんこうこくしょく	t ẽ̞ ŋ k o̞ː k o̞ k ɯ̟ᵝ ɕ o̞ k ɯ̟ᵝ
てんし	t ẽ̞ ɰ̃ ɕ i
てんしゅ	t ẽ̞ ɰ̃ ɕ ɨᵝ
てんじ	t ẽ̞ ɲ̟ d͡ʑ i
てんじかい	t ẽ̞ ɲ̟ d͡ʑ i k a̠ i
てんじくがく	t ẽ̞ ɲ̟ d͡ʑ i k ɯ̟ᵝ ɡ a̠ k ɯ̟ᵝ
てんすう	t ẽ̞ ɰ̃ s ɨᵝː
てんぜんしば	t ẽ̞ ɰ̃ s ẽ̞ ɰ̃ ɕ i b a̠
てんそく	t ẽ̞ ɰ̃ s o̞ k ɯ̟ᵝ
てんち	t ẽ̞ ɲ̟ t͡ɕ i
てんてん	t ẽ̞ n t ẽ̞ ɴ
てんとう	t ẽ̞ n t o̞ː
てんとうむし	t ẽ̞ n t o̞ː m ɯ̟ᵝ ɕ i
てんない	t ẽ̞ nː a̠ i
てんねんおんせん	t ẽ̞ nː ẽ̞ ɰ̃ õ̞ ɰ̃ s ẽ̞ ɴ
てんのうへいか	t ẽ̞ nː o̞ː h e̞ː k a̠
てんはみずからたすくるものをたすく	t ẽ̞ ɰ̃ ɰᵝ a̠ mʲ i z ɨᵝ k a̠ ɾ a̠ t a̠ s ɨᵝ k ɯ̟ᵝ ɾ ɯ̟ᵝ m o̞ n o̞ o̞ t a̠ s ɨᵝ k ɯ̟ᵝ
てんびんきゅう	t ẽ̞ m bʲ ĩ ŋʲ kʲ ɨᵝː
てんびんぼう	t ẽ̞ m bʲ ĩ m b o̞ː
てんぷ	t ẽ̞ m p ɯ̟ᵝ
てんぷら	t ẽ̞ m p ɯ̟ᵝ ɾ a̠
てんまつ	t ẽ̞ mː a̠ t͡s ɨᵝ
てんもう	t ẽ̞ mː o̞ː
であいがしら	d e̞ a̠ i ɡ a̠ ɕ i ɾ a̠
であう	d e̞ a̠ ɯ̟ᵝ
でかい	d e̞ k a̠ i
でかける	d e̞ k a̠ k e̞ ɾ ɯ̟ᵝ
できあがる	d e̞ kʲ i a̠ ɡ a̠ ɾ ɯ̟ᵝ
できごころ	d e̞ kʲ i ɡ o̞ k o̞ ɾ o̞
できそこない	d e̞ kʲ i s o̞ k o̞ n a̠ i
できる	d e̞ kʲ i ɾ ɯ̟ᵝ
できるだけ	d e̞ kʲ i ɾ ɯ̟ᵝ d a̠ k e̞
でくわす	d e̞ k ɯ̟ᵝ ɰᵝ a̠ s ɨᵝ
でじま	d e̞ ʑ i m a̠
です	d e̞ s ɨ̥ᵝ
ですから	d e̞ s ɨ̥ᵝ k a̠ ɾ a̠
でそろう	d e̞ s o̞ ɾ o̞ ɯ̟ᵝ
でっぱ	d e̞ p̚ p a̠
でば	d e̞ b a̠
でばん	d e̞ b ã̠ ɴ
でむかえる	d e̞ m ɯ̟ᵝ k a̠ e̞ ɾ ɯ̟ᵝ
でる	d e̞ ɾ ɯ̟ᵝ
でんか	d ẽ̞ ŋ k a̠
でんき	d ẽ̞ ŋʲ kʲ i
でんきつうしん	d ẽ̞ ŋʲ kʲ i t͡s ɨᵝː ɕ ĩ ɴ
でんげき	d ẽ̞ ŋ ɡ e̞ kʲ i
でんこうせっか	d ẽ̞ ŋ k o̞ː s e̞ k̚ k a̠
でんしたばこ	d ẽ̞ ɰ̃ ɕ i t a̠ b a̠ k o̞
でんしゃ	d ẽ̞ ɰ̃ ɕ a̠
でんしょうぶんがく	d ẽ̞ ɰ̃ ɕ o̞ː b ɯ̟̃ᵝ ŋ ɡ a̠ k ɯ̟ᵝ
でんしん	d ẽ̞ ɰ̃ ɕ ĩ ɴ
でんじゅ	d ẽ̞ ɲ̟ d͡ʑ ɨᵝ
でんたつ	d ẽ̞ n t a̠ t͡s ɨᵝ
でんてい	d ẽ̞ n t e̞ː
でんでんだいこ	d ẽ̞ n d ẽ̞ n d a̠ i k o̞
でんでんむし	d ẽ̞ n d ẽ̞ mː ɯ̟ᵝ ɕ i
でんとつ	d ẽ̞ n t o̞ t͡s ɨᵝ
でんどうし	d ẽ̞ n d o̞ː ɕ i
でんぱ	d ẽ̞ m p a̠
でんぴょう	d ẽ̞ m pʲ o̞ː
でんりゅう	d ẽ̞ n ɾʲ ɨᵝː
でんわ	d ẽ̞ ɰ̃ ɰᵝ a̠
とぃ	t ɰᵝ i
とい	t o̞ i
といあわせ	t o̞ i a̠ ɰᵝ a̠ s e̞
といえども	t o̞ i e̞ d o̞ m o̞
といし	t o̞ i ɕ i
とうあん	t o̞ː ã̠ ɴ
とういん	t o̞ː ĩ ɴ
とうおん	t o̞ː õ̞ ɴ
とうかん	t o̞ː k ã̠ ɴ
とうがい	t o̞ː ɡ a̠ i
とうき	t o̞ː kʲ i
とうきょ	t o̞ː kʲ o̞
とうきょうと	t o̞ː kʲ o̞ː t o̞
とうきょうぶ	t o̞ː kʲ o̞ː b ɯ̟ᵝ
とうけい	t o̞ː k e̞ː
とうけん	t o̞ː k ẽ̞ ɴ
とうげい	t o̞ː ɡ e̞ː
とうごう	t o̞ː ɡ o̞ː
とうごうしっちょうしょう	t o̞ː ɡ o̞ː ɕ i t̚ t͡ɕ o̞ː ɕ o̞ː
とうごく	t o̞ː ɡ o̞ k ɯ̟ᵝ
とうさん	t o̞ː s ã̠ ɴ
とうしつ	t o̞ː ɕ i t͡s ɨᵝ
とうしゃ	t o̞ː ɕ a̠
とうしゅ	t o̞ː ɕ ɨᵝ
とうしんだい	t o̞ː ɕ ĩ n d a̠ i
とうじょう	t o̞ː ʑ o̞ː
とうじょうけん	t o̞ː ʑ o̞ː k ẽ̞ ɴ
とうじん	t o̞ː ʑ ĩ ɴ
とうせいふう	t o̞ː s e̞ː ɸ ɯ̟ᵝː
とうぜん	t o̞ː z ẽ̞ ɴ
とうそう	t o̞ː s o̞ː
とうた	t o̞ː t a̠
とうたん	t o̞ː t ã̠ ɴ
とうだい	t o̞ː d a̠ i
とうちゃん	t o̞ː t͡ɕ ã̠ ɴ
とうちょうき	t o̞ː t͡ɕ o̞ː kʲ i
とうちりめん	t o̞ː t͡ɕ i ɾʲ i m ẽ̞ ɴ
とうてい	t o̞ː t e̞ː
とうてん	t o̞ː t ẽ̞ ɴ
とうとう	t o̞ː t o̞ː
とうとつ	t o̞ː t o̞ t͡s ɨᵝ
とうとぶ	t o̞ː t o̞ b ɯ̟ᵝ
とうど	t o̞ː d o̞
とうなす	t o̞ː n a̠ s ɨᵝ
とうは	t o̞ː h a̠
とうはん	t o̞ː h ã̠ ɴ
とうばん	t o̞ː b ã̠ ɴ
とうひょうようし	t o̞ː ç o̞ː j o̞ː ɕ i
とうひょうりつ	t o̞ː ç o̞ː ɾʲ i t͡s ɨᵝ
とうぶ	t o̞ː b ɯ̟ᵝ
とうぶがいしょう	t o̞ː b ɯ̟ᵝ ɡ a̠ i ɕ o̞ː
とうべん	t o̞ː b ẽ̞ ɴ
とうほう	t o̞ː h o̞ː
とうほんせいそう	t o̞ː h õ̞ ɰ̃ s e̞ː s o̞ː
とうぼうしゃ	t o̞ː b o̞ː ɕ a̠
とうまつ	t o̞ː m a̠ t͡s ɨᵝ
とうみつ	t o̞ː mʲ i t͡s ɨᵝ
とうみん	t o̞ː mʲ ĩ ɴ
とうめいたい	t o̞ː m e̞ː t a̠ i
とうや	t o̞ː j a̠
とうよう	t o̞ː j o̞ː
とぇ	t ɰᵝ e̞
とえい	t o̞ e̞ː
とお	ẽ̞ ɴ
とおい	t o̞ː i
とおく	t o̞ː k ɯ̟ᵝ
とおす	t o̞ː s ɨᵝ
とおせんぼう	t o̞ː s ẽ̞ m b o̞ː
とおで	t o̞ː d e̞
とおる	t o̞ː ɾ ɯ̟ᵝ
とかげ	t o̞ k a̠ ɡ e̞
とかげざ	t o̞ k a̠ ɡ e̞ z a̠
とかす	t o̞ k a̠ s ɨᵝ
ときあかす	t o̞ kʲ i a̠ k a̠ s ɨᵝ
ときおり	t o̞ kʲ i o̞ ɾʲ i
ときどき	t o̞ kʲ i d o̞ kʲ i
ときふせる	t o̞ kʲ i ɸ ɯ̟ᵝ s e̞ ɾ ɯ̟ᵝ
ときめく	t o̞ kʲ i m e̞ k ɯ̟ᵝ
ときわ	t o̞ kʲ i ɰᵝ a̠
ときん	t o̞ kʲ ĩ ɴ
とぎ	t o̞ ɡʲ i
とぎかい	t o̞ ɡʲ i k a̠ i
とぎれとぎれ	t o̞ ɡʲ i ɾ e̞ t o̞ ɡʲ i ɾ e̞
とぎれる	t o̞ ɡʲ i ɾ e̞ ɾ ɯ̟ᵝ
とく	t o̞ k ɯ̟ᵝ
とくい	t o̞ k ɯ̟ᵝ i
とくいさき	t o̞ k ɯ̟ᵝ i s a̠ kʲ i
とくさつ	t o̞ k ɯ̟̊ᵝ s a̠ t͡s ɨᵝ
とくしつ	t o̞ k ɯ̟ᵝ ɕ i̥ t͡s ɨᵝ
とくしゃ	t o̞ k ɯ̟ᵝ ɕ a̠
とくしん	t o̞ k ɯ̟ᵝ ɕ ĩ ɴ
とくちゅう	t o̞ k ɯ̟ᵝ t͡ɕ ɨᵝː
とくどう	t o̞ k ɯ̟ᵝ d o̞ː
とくに	t o̞ k ɯ̟ᵝ ɲ̟ i
とくはいん	t o̞ k ɯ̟ᵝ h a̠ ĩ ɴ
とくべつ	t o̞ k ɯ̟ᵝ b e̞ t͡s ɨᵝ
とくほう	t o̞ k ɯ̟ᵝ h o̞ː
とくむ	t o̞ k ɯ̟ᵝ m ɯ̟ᵝ
とくよう	t o̞ k ɯ̟ᵝ j o̞ː
とくれい	t o̞ k ɯ̟ᵝ ɾ e̞ː
とぐ	t o̞ ɡ ɯ̟ᵝ
とぐら	t o̞ ɡ ɯ̟ᵝ ɾ a̠
とぐろ	t o̞ ɡ ɯ̟ᵝ ɾ o̞
とけい	t o̞ k e̞ː
とけいこうじ	t o̞ k e̞ː k o̞ː ʑ i
とけいそう	t o̞ k e̞ː s o̞ː
とけつ	t o̞ k e̞ t͡s ɨᵝ
とける	t o̞ k e̞ ɾ ɯ̟ᵝ
とげ	t o̞ ɡ e̞
とげる	t o̞ ɡ e̞ ɾ ɯ̟ᵝ
とこ	t o̞ k o̞
とこう	t o̞ k o̞ː
とことん	t o̞ k o̞ t õ̞ ɴ
とこむし	t o̞ k o̞ m ɯ̟ᵝ ɕ i
ところ	k o̞
ところてん	t o̞ k o̞ ɾ o̞ t ẽ̞ ɴ
ところで	t o̞ k o̞ ɾ o̞ d e̞
とさか	t o̞ s a̠ k a̠
とざん	t o̞ z ã̠ ɴ
とざんしゃ	t o̞ z ã̠ ɰ̃ ɕ a̠
としうえ	t o̞ ɕ i ɯ̟ᵝ e̞
としおいる	t o̞ ɕ i o̞ i ɾ ɯ̟ᵝ
としこし	t o̞ ɕ i k o̞ ɕ i
としごろ	t o̞ ɕ i ɡ o̞ ɾ o̞
としゅ	t o̞ ɕ ɨᵝ
としょしつ	t o̞ ɕ o̞ ɕ i t͡s ɨᵝ
としより	t o̞ ɕ i j o̞ ɾʲ i
としよりのひやみず	t o̞ ɕ i j o̞ ɾʲ i n o̞ ç i j a̠ mʲ i z ɨᵝ
としん	t o̞ ɕ ĩ ɴ
とじ	t o̞ ʑ i
とじこみ	t o̞ ʑ i k o̞ mʲ i
とじる	t o̞ ʑ i ɾ ɯ̟ᵝ
とす	t o̞ s ɨᵝ
とそう	t o̞ s o̞ː
とたん	t o̞ t ã̠ ɴ
とち	t o̞ t͡ɕ i
とっかえひっかえ	t o̞ k̚ k a̠ e̞ ç i k̚ k a̠ e̞
とっき	t o̞ k̚ʲ kʲ i
とっくに	t o̞ k̚ k ɯ̟ᵝ ɲ̟ i
とっくり	t o̞ k̚ k ɯ̟ᵝ ɾʲ i
とっこつ	t o̞ k̚ k o̞ t͡s ɨᵝ
とって	t o̞ t̚ t e̞
とっておき	t o̞ t̚ t e̞ o̞ kʲ i
とっとと	t o̞ t̚ t o̞ t o̞
とっとり	t o̞ t̚ t o̞ ɾʲ i
とっぱ	t o̞ p̚ p a̠
とつくに	t o̞ t͡s ɨᵝ k ɯ̟ᵝ ɲ̟ i
とつぐ	t o̞ t͡s ɨᵝ ɡ ɯ̟ᵝ
とつぜん	t o̞ t͡s ɨᵝ z ẽ̞ ɴ
とてつもない	t o̞ t e̞ t͡s ɨᵝ m o̞ n a̠ i
とても	t o̞ t e̞ m o̞
ととのう	t o̞ t o̞ n o̞ ɯ̟ᵝ
ととのえる	t o̞ t o̞ n o̞ e̞ ɾ ɯ̟ᵝ
とど	t o̞ d o̞
とどく	t o̞ d o̞ k ɯ̟ᵝ
とどける	t o̞ d o̞ k e̞ ɾ ɯ̟ᵝ
とどめる	t o̞ d o̞ m e̞ ɾ ɯ̟ᵝ
とどろく	t o̞ d o̞ ɾ o̞ k ɯ̟ᵝ
となえる	t o̞ n a̠ e̞ ɾ ɯ̟ᵝ
とにち	t o̞ ɲ̟ i t͡ɕ i
とにもかくにも	t o̞ ɲ̟ i m o̞ k a̠ k ɯ̟ᵝ ɲ̟ i m o̞
とばく	t o̞ b a̠ k ɯ̟ᵝ
とばし	t o̞ b a̠ ɕ i
とばしきじ	t o̞ b a̠ ɕ i kʲ i ʑ i
とばしけいたい	t o̞ b a̠ ɕ i k e̞ː t a̠ i
とびうお	t o̞ bʲ i ɯ̟ᵝ o̞
とびおりる	t o̞ bʲ i o̞ ɾʲ i ɾ ɯ̟ᵝ
とびだす	t o̞ bʲ i d a̠ s ɨᵝ
とびちる	t o̞ bʲ i t͡ɕ i ɾ ɯ̟ᵝ
とびまわる	t o̞ bʲ i m a̠ ɰᵝ a̠ ɾ ɯ̟ᵝ
とふざい	t o̞ ɸ ɯ̟ᵝ z a̠ i
とぶ	t o̞ b ɯ̟ᵝ
とほ	t o̞ h o̞
とほうにくれる	t o̞ h o̞ː ɲ̟ i k ɯ̟ᵝ ɾ e̞ ɾ ɯ̟ᵝ
とぼしい	t o̞ b o̞ ɕ i i
とま	t o̞ m a̠
とまどう	t o̞ m a̠ d o̞ ɯ̟ᵝ
とまる	t o̞ m a̠ ɾ ɯ̟ᵝ
とまれかくまれ	t o̞ m a̠ ɾ e̞ k a̠ k ɯ̟ᵝ m a̠ ɾ e̞
とみ	t o̞ mʲ i
とみくじ	t o̞ mʲ i k ɯ̟ᵝ ʑ i
とみん	t o̞ mʲ ĩ ɴ
とむ	t o̞ m ɯ̟ᵝ
とめ	t o̞ m e̞
とめがね	t o̞ m e̞ ɡ a̠ n e̞
とめる	t o̞ m e̞ ɾ ɯ̟ᵝ
とも	t o̞ m o̞
ともあれ	t o̞ m o̞ a̠ ɾ e̞
ともえ	t o̞ m o̞ e̞
ともかく	t o̞ m o̞ k a̠ k ɯ̟ᵝ
ともがら	t o̞ m o̞ ɡ a̠ ɾ a̠
ともき	t o̞ m o̞ kʲ i
ともこ	t o̞ m o̞ k o̞
ともじろう	t o̞ m o̞ ʑ i ɾ o̞ː
ともだち	t o̞ m o̞ d a̠ t͡ɕ i
ともひろ	t o̞ m o̞ ç i ɾ o̞
ともみ	t o̞ m o̞ mʲ i
ともゆき	t o̞ m o̞ j ɯ̟ᵝ kʲ i
ともよし	t o̞ m o̞ j o̞ ɕ i
ともる	t o̞ m o̞ ɾ ɯ̟ᵝ
とよくこん	t o̞ j o̞ k ɯ̟ᵝ k õ̞ ɴ
とよじ	t o̞ j o̞ ʑ i
とよた	t o̞ j o̞ t a̠
とら	t o̞ ɾ a̠
とらえる	t o̞ ɾ a̠ e̞ ɾ ɯ̟ᵝ
とらぞう	t o̞ ɾ a̠ z o̞ː
とり	t o̞ ɾʲ i
とりあげる	t o̞ ɾʲ i a̠ ɡ e̞ ɾ ɯ̟ᵝ
とりあたま	t o̞ ɾʲ i a̠ t a̠ m a̠
とりあつかう	t o̞ ɾʲ i a̠ t͡s ɨᵝ k a̠ ɯ̟ᵝ
とりいれる	t o̞ ɾʲ i i ɾ e̞ ɾ ɯ̟ᵝ
とりかかる	t o̞ ɾʲ i k a̠ k a̠ ɾ ɯ̟ᵝ
とりかこむ	t o̞ ɾʲ i k a̠ k o̞ m ɯ̟ᵝ
とりきめ	t o̞ ɾʲ i kʲ i m e̞
とりくみ	t o̞ ɾʲ i k ɯ̟ᵝ mʲ i
とりくむ	t o̞ ɾʲ i k ɯ̟ᵝ m ɯ̟ᵝ
とりけす	t o̞ ɾʲ i k e̞ s ɨᵝ
とりこ	t o̞ ɾʲ i k o̞
とりこむ	t o̞ ɾʲ i k o̞ m ɯ̟ᵝ
とりしまりやくかい	t o̞ ɾʲ i ɕ i m a̠ ɾʲ i j a̠ k ɯ̟̊ᵝ k a̠ i
とりしまる	t o̞ ɾʲ i ɕ i m a̠ ɾ ɯ̟ᵝ
とりだす	t o̞ ɾʲ i d a̠ s ɨᵝ
とりつく	t o̞ ɾʲ i t͡s ɨᵝ k ɯ̟ᵝ
とりつける	t o̞ ɾʲ i t͡s ɨᵝ k e̞ ɾ ɯ̟ᵝ
とりとめ	t o̞ ɾʲ i t o̞ m e̞
とりとめる	t o̞ ɾʲ i t o̞ m e̞ ɾ ɯ̟ᵝ
とりのぞく	t o̞ ɾʲ i n o̞ z o̞ k ɯ̟ᵝ
とりひきじょ	t o̞ ɾʲ i ç i̥ kʲ i ʑ o̞
とりまく	t o̞ ɾʲ i m a̠ k ɯ̟ᵝ
とりもどす	t o̞ ɾʲ i m o̞ d o̞ s ɨᵝ
とる	t o̞ ɾ ɯ̟ᵝ
とれる	t o̞ ɾ e̞ ɾ ɯ̟ᵝ
とんしゃ	t õ̞ ɰ̃ ɕ a̠
とんま	t õ̞ mː a̠
どあい	d o̞ a̠ i
どぃ	d ɰᵝ i
どぅ	d ɯ̟ᵝ
どう	d o̞ː
どういう	d o̞ː i ɯ̟ᵝ
どういご	d o̞ː i ɡ o̞
どういたい	d o̞ː i t a̠ i
どうか	d o̞ː k a̠
どうかつ	d o̞ː k a̠ t͡s ɨᵝ
どうかん	d o̞ː k ã̠ ɴ
どうき	d o̞ː kʲ i
どうぎ	d o̞ː ɡʲ i
どうぎご	d o̞ː ɡʲ i ɡ o̞
どうぎょう	mʲ i t͡ɕ i j ɯ̟ᵝ kʲ i
どうぎょうににん	d o̞ː ɡʲ o̞ː ɲ̟ i ɲ̟ ĩ ɴ
どうぐ	d o̞ː ɡ ɯ̟ᵝ
どうけ	d o̞ː k e̞
どうこう	d o̞ː k o̞ː
どうこうかい	d o̞ː k o̞ː k a̠ i
どうし	d o̞ː ɕ i
どうして	d o̞ː ɕ i t e̞
どうしゅつ	d o̞ː ɕ ɨᵝ t͡s ɨᵝ
どうしょう	d o̞ː ɕ o̞ː
どうじょう	d o̞ː ʑ o̞ː
どうじる	d o̞ː ʑ i ɾ ɯ̟ᵝ
どうじんざっし	d o̞ː ʑ ĩ n d͡z a̠ ɕː i
どうせ	d o̞ː s e̞
どうせい	d o̞ː s e̞ː
どうせいあい	d o̞ː s e̞ː a̠ i
どうせき	d o̞ː s e̞ kʲ i
どうそうかい	d o̞ː s o̞ː k a̠ i
どうそじん	d o̞ː s o̞ ʑ ĩ ɴ
どうたい	d o̞ː t a̠ i
どうてん	d o̞ː t ẽ̞ ɴ
どうとう	d o̞ː t o̞ː
どうない	d o̞ː n a̠ i
どうなん	d o̞ː n ã̠ ɴ
どうねん	d o̞ː n ẽ̞ ɴ
どうぶつ	d o̞ː b ɯ̟ᵝ t͡s ɨᵝ
どうぶつゆらいかんせんしょう	d o̞ː b ɯ̟ᵝ t͡s ɨᵝ j ɯ̟ᵝ ɾ a̠ i k ã̠ ɰ̃ s ẽ̞ ɰ̃ ɕ o̞ː
どうみゃく	d o̞ː mʲ a̠ k ɯ̟ᵝ
どうみょう	d o̞ː mʲ o̞ː
どうも	d o̞ː m o̞
どうもありがとう	d o̞ː m o̞ a̠ ɾʲ i ɡ a̠ t o̞ː
どうよう	d o̞ː j o̞ː
どうりょう	d o̞ː ɾʲ o̞ː
どかん	d o̞ k ã̠ ɴ
どきょう	d o̞ kʲ o̞ː
どく	d o̞ k ɯ̟ᵝ
どくさつ	d o̞ k ɯ̟̊ᵝ s a̠ t͡s ɨᵝ
どくしゃ	d o̞ k ɯ̟̊ᵝ ɕ a̠
どくしょ	d o̞ k ɯ̟̊ᵝ ɕ o̞
どくしょう	d o̞ k ɯ̟̊ᵝ ɕ o̞ː
どくしんじゅつ	d o̞ k ɯ̟̊ᵝ ɕ ĩ ɲ̟ d͡ʑ ɨᵝ t͡s ɨᵝ
どくせい	d o̞ k ɯ̟̊ᵝ s e̞ː
どくせんよく	d o̞ k ɯ̟ᵝ s ẽ̞ ɰ̃ j o̞ k ɯ̟ᵝ
どくぜん	d o̞ k ɯ̟ᵝ z ẽ̞ ɴ
どくぜんしゅぎ	d o̞ k ɯ̟ᵝ z ẽ̞ ɰ̃ ɕ ɨᵝ ɡʲ i
どくそ	d o̞ k ɯ̟̊ᵝ s o̞
どくとく	d o̞ k ɯ̟̊ᵝ t o̞ k ɯ̟ᵝ
どくはく	d o̞ k ɯ̟̊ᵝ h a̠ k ɯ̟ᵝ
どくろ	d o̞ k ɯ̟ᵝ ɾ o̞
どげざ	d o̞ ɡ e̞ z a̠
どこ	d o̞ k o̞
どこう	d o̞ k o̞ː
どさんこ	d o̞ s ã̠ ŋ k o̞
どじょう	d o̞ ʑ o̞ː
どせきりゅう	d o̞ s e̞ kʲ i ɾʲ ɨᵝː
どそく	d o̞ s o̞ k ɯ̟ᵝ
どだい	d o̞ d a̠ i
どちざめ	d o̞ t͡ɕ i z a̠ m e̞
どちら	d o̞ t͡ɕ i ɾ a̠
どっから	d o̞ k̚ k a̠ ɾ a̠
どっきょ	d o̞ k̚ʲ kʲ o̞
どっこいどっこい	d o̞ k̚ k o̞ i d o̞ k̚ k o̞ i
どっちもどっち	d o̞ t̚ t͡ɕ i m o̞ d o̞ t̚ t͡ɕ i
どてら	d o̞ t e̞ ɾ a̠
どとう	d o̞ t o̞ː
どの	d o̞ n o̞
どぶいた	d o̞ b ɯ̟ᵝ i t a̠
どぶん	d o̞ b ɯ̟̃ᵝ ɴ
どべい	d o̞ b e̞ː
どぼく	d o̞ b o̞ k ɯ̟ᵝ
どや	d o̞ j a̠
どら	d o̞ ɾ a̠
どらやき	d o̞ ɾ a̠ j a̠ kʲ i
どれ	d o̞ ɾ e̞
どれいせいど	d o̞ ɾ e̞ː s e̞ː d o̞
どれどれ	d o̞ ɾ e̞ d o̞ ɾ e̞
どろがめ	d o̞ ɾ o̞ ɡ a̠ m e̞
どろじあい	d o̞ ɾ o̞ ʑ i a̠ i
どろまみれ	d o̞ ɾ o̞ m a̠ mʲ i ɾ e̞
どんき	d õ̞ ŋʲ kʲ i
どんそう	d õ̞ ɰ̃ s o̞ː
どんちょう	d õ̞ ɲ̟ t͡ɕ o̞ː
どんてん	d õ̞ n t ẽ̞ ɴ
どんぶらこ	d õ̞ m b ɯ̟ᵝ ɾ a̠ k o̞
どんぶり	d õ̞ m b ɯ̟ᵝ ɾʲ i
どんより	d õ̞ ɰ̃ j o̞ ɾʲ i
ない	n a̠ i
ないかく	n a̠ i k a̠ k ɯ̟ᵝ
ないがしろ	n a̠ i ɡ a̠ ɕ i ɾ o̞
ないくう	n a̠ i k ɯ̟ᵝː
ないしゅっけつ	n a̠ i ɕ ɨᵝ k̚ k e̞ t͡s ɨᵝ
ないしょ	n a̠ i ɕ o̞
ないしん	n a̠ i ɕ ĩ ɴ
ないじつ	n a̠ i ʑ i t͡s ɨᵝ
ないじょ	n a̠ i ʑ o̞
ないせい	n a̠ i s e̞ː
ないせいかんしょう	n a̠ i s e̞ː k ã̠ ɰ̃ ɕ o̞ː
ないそう	n a̠ i s o̞ː
ないそふ	n a̠ i s o̞ ɸ ɯ̟ᵝ
ないぞう	n a̠ i z o̞ː
ないてい	n a̠ i t e̞ː
ないてんきん	n a̠ i t ẽ̞ ŋʲ kʲ ĩ ɴ
ないはんそく	n a̠ i h ã̠ ɰ̃ s o̞ k ɯ̟ᵝ
ないみつ	n a̠ i mʲ i t͡s ɨᵝ
ないよう	n a̠ i j o̞ː
なお	n a̠ o̞
なおき	n a̠ o̞ kʲ i
なおさら	n a̠ o̞ s a̠ ɾ a̠
なおす	n a̠ o̞ s ɨᵝ
なか	n a̠ k a̠
なかいま	n a̠ k a̠ i m a̠
なかおれ	n a̠ k a̠ o̞ ɾ e̞
なかおれぼう	n a̠ k a̠ o̞ ɾ e̞ b o̞ː
なかがいにん	n a̠ k a̠ ɡ a̠ i ɲ̟ ĩ ɴ
なかじたぼいん	n a̠ k a̠ ʑ i t a̠ b o̞ ĩ ɴ
なかだかがた	n a̠ k a̠ d a̠ k a̠ ɡ a̠ t a̠
なかだし	n a̠ k a̠ d a̠ ɕ i
なかだち	n a̠ k a̠ d a̠ t͡ɕ i
なかだちにん	n a̠ k a̠ d a̠ t͡ɕ i ɲ̟ ĩ ɴ
なかば	n a̠ k a̠ b a̠
なかま	n a̠ k a̠ m a̠
なかまいしき	n a̠ k a̠ m a̠ i ɕ i kʲ i
なかまはずれ	n a̠ k a̠ m a̠ h a̠ z ɨᵝ ɾ e̞
なかもり	n a̠ k a̠ m o̞ ɾʲ i
なかゆび	n a̠ k a̠ j ɯ̟ᵝ bʲ i
なかよし	n a̠ k a̠ j o̞ ɕ i
なかれ	n a̠ k a̠ ɾ e̞
ながい	n a̠ ɡ a̠ i
ながいき	n a̠ ɡ a̠ i kʲ i
ながいす	n a̠ ɡ a̠ i s ɨᵝ
なががたな	n a̠ ɡ a̠ ɡ a̠ t a̠ n a̠
ながさ	n a̠ ɡ a̠ s a̠
ながさきけん	n a̠ ɡ a̠ s a̠ kʲ i k ẽ̞ ɴ
ながしめ	n a̠ ɡ a̠ ɕ i m e̞
ながじゅばん	n a̠ ɡ a̠ ʑ ɨᵝ b ã̠ ɴ
ながす	n a̠ ɡ a̠ s ɨᵝ
ながすくじら	n a̠ ɡ a̠ s ɨ̥ᵝ k ɯ̟ᵝ ʑ i ɾ a̠
ながの	n a̠ ɡ a̠ n o̞
ながばなし	n a̠ ɡ a̠ b a̠ n a̠ ɕ i
ながめる	n a̠ ɡ a̠ m e̞ ɾ ɯ̟ᵝ
ながら	n a̠ ɡ a̠ ɾ a̠
ながれ	n a̠ ɡ a̠ ɾ e̞
ながれだす	n a̠ ɡ a̠ ɾ e̞ d a̠ s ɨᵝ
ながれる	n a̠ ɡ a̠ ɾ e̞ ɾ ɯ̟ᵝ
ながわずらい	n a̠ ɡ a̠ ɰᵝ a̠ z ɨᵝ ɾ a̠ i
なき	n a̠ kʲ i
なきうさぎ	n a̠ kʲ i ɯ̟ᵝ s a̠ ɡʲ i
なく	n a̠ k ɯ̟ᵝ
なくす	n a̠ k ɯ̟ᵝ s ɨᵝ
なくなる	n a̠ k ɯ̟ᵝ n a̠ ɾ ɯ̟ᵝ
なぐりがき	n a̠ ɡ ɯ̟ᵝ ɾʲ i ɡ a̠ kʲ i
なぐる	n a̠ ɡ ɯ̟ᵝ ɾ ɯ̟ᵝ
なげうつ	n a̠ ɡ e̞ ɯ̟ᵝ t͡s ɨᵝ
なげく	n a̠ ɡ e̞ k ɯ̟ᵝ
なげなわ	n a̠ ɡ e̞ n a̠ ɰᵝ a̠
なげやり	n a̠ ɡ e̞ j a̠ ɾʲ i
なごや	n a̠ ɡ o̞ j a̠
なごん	n a̠ ɡ õ̞ ɴ
なさる	n a̠ s a̠ ɾ ɯ̟ᵝ
なし	n a̠ ɕ i
なしとげる	n a̠ ɕ i t o̞ ɡ e̞ ɾ ɯ̟ᵝ
なじる	n a̠ ʑ i ɾ ɯ̟ᵝ
なす	n a̠ s ɨᵝ
なすりつける	n a̠ s ɨᵝ ɾʲ i t͡s ɨᵝ k e̞ ɾ ɯ̟ᵝ
なずき	n a̠ z ɨᵝ kʲ i
なずな	n a̠ z ɨᵝ n a̠
なぜ	n a̠ z e̞
なぜなら	n a̠ z e̞ n a̠ ɾ a̠
なぞなぞ	n a̠ z o̞ n a̠ z o̞
なぞにく	n a̠ z o̞ ɲ̟ i k ɯ̟ᵝ
なぞらえる	n a̠ z o̞ ɾ a̠ e̞ ɾ ɯ̟ᵝ
なた	n a̠ t a̠
なたね	n a̠ t a̠ n e̞
なだ	n a̠ d a̠
なだめる	n a̠ d a̠ m e̞ ɾ ɯ̟ᵝ
なつ	n a̠ t͡s ɨᵝ
なつかしい	n a̠ t͡s ɨ̥ᵝ k a̠ ɕ iː
なつかしむ	n a̠ t͡s ɨᵝ k a̠ ɕ i m ɯ̟ᵝ
なつき	n a̠ t͡s ɨᵝ kʲ i
なつくさ	n a̠ t͡s ɨᵝ k ɯ̟ᵝ s a̠
なつぞら	n a̠ t͡s ɨᵝ z o̞ ɾ a̠
なづける	n a̠ z ɨᵝ k e̞ ɾ ɯ̟ᵝ
なでおろす	n a̠ d e̞ o̞ ɾ o̞ s ɨᵝ
なでる	n a̠ d e̞ ɾ ɯ̟ᵝ
など	n a̠ d o̞
なな	n a̠ n a̠
ななえ	n a̠ n a̠ e̞
ななしゆび	n a̠ n a̠ ɕ i j ɯ̟ᵝ bʲ i
ななつ	n a̠ n a̠ t͡s ɨᵝ
ななふし	n a̠ n a̠ ɸ ɯ̟̊ᵝ ɕ i
ななほしてんとう	n a̠ n a̠ h o̞ ɕ i t ẽ̞ n t o̞ː
ななめ	n a̠ n a̠ m e̞
なに	n a̠ ɲ̟ i
なにげない	n a̠ ɲ̟ i ɡ e̞ n a̠ i
なにせ	n a̠ ɲ̟ i s e̞
なにもの	n a̠ ɲ̟ i m o̞ n o̞
なにより	n a̠ ɲ̟ i j o̞ ɾʲ i
なのに	n a̠ n o̞ ɲ̟ i
なは	n a̠ h a̠
なばな	n a̠ b a̠ n a̠
なべ	n a̠ b e̞
なま	n a̠ m a̠
なまぐさ	n a̠ m a̠ ɡ ɯ̟ᵝ s a̠
なまけぐま	n a̠ m a̠ k e̞ ɡ ɯ̟ᵝ m a̠
なまごみ	n a̠ m a̠ ɡ o̞ mʲ i
なまごろし	n a̠ m a̠ ɡ o̞ ɾ o̞ ɕ i
なまず	n a̠ m a̠ z ɨᵝ
なまぬるい	n a̠ m a̠ n ɯ̟ᵝ ɾ ɯ̟ᵝ i
なまみ	n a̠ m a̠ mʲ i
なまり	n a̠ m a̠ ɾʲ i
なまりいろ	n a̠ m a̠ ɾʲ iː ɾ o̞
なみ	n a̠ mʲ i
なみかぜ	n a̠ mʲ i k a̠ z e̞
なみだがち	n a̠ mʲ i d a̠ ɡ a̠ t͡ɕ i
なみだぐむ	n a̠ mʲ i d a̠ ɡ ɯ̟ᵝ m ɯ̟ᵝ
なみだぶくろ	n a̠ mʲ i d a̠ b ɯ̟ᵝ k ɯ̟ᵝ ɾ o̞
なみはずれる	n a̠ mʲ i h a̠ z ɨᵝ ɾ e̞ ɾ ɯ̟ᵝ
なむ	n a̠ m ɯ̟ᵝ
なむさん	n a̠ m ɯ̟ᵝ s ã̠ ɴ
なめくじ	n a̠ m e̞ k ɯ̟ᵝ ʑ i
なめこ	n a̠ m e̞ k o̞
なめる	n a̠ m e̞ ɾ ɯ̟ᵝ
なやましい	n a̠ j a̠ m a̠ ɕ iː
なやます	n a̠ j a̠ m a̠ s ɨᵝ
なやむ	n a̠ j a̠ m ɯ̟ᵝ
なら	n a̠ ɾ a̠
ならく	n a̠ ɾ a̠ k ɯ̟ᵝ
ならす	n a̠ ɾ a̠ s ɨᵝ
ならずもの	n a̠ ɾ a̠ z ɨᵝ m o̞ n o̞
ならはら	n a̠ ɾ a̠ h a̠ ɾ a̠
ならぶ	n a̠ ɾ a̠ b ɯ̟ᵝ
ならべる	n a̠ ɾ a̠ b e̞ ɾ ɯ̟ᵝ
ならわし	n a̠ ɾ a̠ ɰᵝ a̠ ɕ i
なりぎん	n a̠ ɾʲ i ɡʲ ĩ ɴ
なりけい	n a̠ ɾʲ i k e̞ː
なる	n a̠ ɾ ɯ̟ᵝ
なるほど	n a̠ ɾ ɯ̟ᵝ h o̞ d o̞
なれあい	n a̠ ɾ e̞ a̠ i
なれる	n a̠ ɾ e̞ ɾ ɯ̟ᵝ
なわ	n a̠ ɰᵝ a̠
なん	n ã̠ ɴ
なんい	n ã̠ ɰ̃ i
なんか	n ã̠ ŋ k a̠
なんがつ	n ã̠ ŋ ɡ a̠ t͡s ɨᵝ
なんきょくかい	n ã̠ ŋʲ kʲ o̞ k ɯ̟ᵝ k a̠ i
なんきんまめ	n ã̠ ŋʲ kʲ ĩ mː a̠ m e̞
なんきんむし	n ã̠ ŋʲ kʲ ĩ mː ɯ̟ᵝ ɕ i
なんくせ	n ã̠ ŋ k ɯ̟ᵝ s e̞
なんこう	n ã̠ ŋ k o̞ː
なんこつ	n ã̠ ŋ k o̞ t͡s ɨᵝ
なんごく	n ã̠ ŋ ɡ o̞ k ɯ̟ᵝ
なんさいですか	n ã̠ ɰ̃ s a̠ i d e̞ s ɨ̥ᵝ k a̠
なんしんせいさく	n ã̠ ɰ̃ ɕ ĩ ɰ̃ s e̞ː s a̠ k ɯ̟ᵝ
なんじゅう	n ã̠ ɲ̟ d͡ʑ ɨᵝː
なんたい	n ã̠ n t a̠ i
なんだか	n ã̠ n d a̠ k a̠
なんだって	n ã̠ n d a̠ t̚ t e̞
なんて	n ã̠ n t e̞
なんてんもん	n ã̠ n t ẽ̞ m m õ̞ ɴ
なんで	n ã̠ n d e̞
なんでやねん	n ã̠ n d e̞ j a̠ n ẽ̞ ɴ
なんなら	n ã̠ nː a̠ ɾ a̠
なんばんじん	n ã̠ m b ã̠ ɲ̟ d͡ʑ ĩ ɴ
なんべん	n ã̠ m b ẽ̞ ɴ
なんぼ	n ã̠ m b o̞
なんぼく	n ã̠ m b o̞ k ɯ̟ᵝ
なんぼくせんそう	n ã̠ m b o̞ k ɯ̟ᵝ s ẽ̞ ɰ̃ s o̞ː
なんら	n ã̠ n ɾ a̠
にいがたけん	ɲ̟ iː ɡ a̠ t a̠ k ẽ̞ ɴ
におい	ɲ̟ i o̞ i
におう	ɲ̟ i o̞ ɯ̟ᵝ
におし	ɲ̟ i o̞ ɕ i
におわす	ɲ̟ i o̞ ɰᵝ a̠ s ɨᵝ
にがて	ɲ̟ i ɡ a̠ t e̞
にがわらい	ɲ̟ i ɡ a̠ ɰᵝ a̠ ɾ a̠ i
にぎやか	ɲ̟ i ɡʲ i j a̠ k a̠
にぎり	ɲ̟ i ɡʲ i ɾʲ i
にぎる	ɲ̟ i ɡʲ i ɾ ɯ̟ᵝ
にくい	ɲ̟ i k ɯ̟ᵝ i
にくしみ	ɲ̟ i k ɯ̟ᵝ ɕ i mʲ i
にくしょう	ɲ̟ i k ɯ̟̊ᵝ ɕ o̞ː
にくしょくけい	ɲ̟ i k ɯ̟ᵝ ɕ o̞ k ɯ̟ᵝ k e̞ː
にくしん	ɲ̟ i k ɯ̟̊ᵝ ɕ ĩ ɴ
にくじゅう	ɲ̟ i k ɯ̟ᵝ ʑ ɨᵝː
にくたいび	ɲ̟ i k ɯ̟ᵝ t a̠ i bʲ i
にくだんせん	ɲ̟ i k ɯ̟ᵝ d ã̠ ɰ̃ s ẽ̞ ɴ
にくへん	ɲ̟ i k ɯ̟ᵝ h ẽ̞ ɴ
にくぼう	ɲ̟ i k ɯ̟ᵝ b o̞ː
にくまん	ɲ̟ i k ɯ̟ᵝ m ã̠ ɴ
にくよく	ɲ̟ i k ɯ̟ᵝ j o̞ k ɯ̟ᵝ
にくらしい	ɲ̟ i k ɯ̟ᵝ ɾ a̠ ɕ iː
にくるい	ɲ̟ i k ɯ̟ᵝ ɾ ɯ̟ᵝ i
にげこむ	ɲ̟ i ɡ e̞ k o̞ m ɯ̟ᵝ
にげみち	ɲ̟ i ɡ e̞ mʲ i t͡ɕ i
にこ	ɲ̟ i k o̞
にこげ	ɲ̟ i k o̞ ɡ e̞
にさんかたんそ	ɲ̟ i s ã̠ ŋ k a̠ t ã̠ ɰ̃ s o̞
にしごり	ɲ̟ i ɕ i ɡ o̞ ɾʲ i
にじ	ɲ̟ i ʑ i
にじかい	ɲ̟ i ʑ i k a̠ i
にじそうさく	ɲ̟ i ʑ i s o̞ː s a̠ k ɯ̟ᵝ
にじほうていしき	ɲ̟ i ʑ i h o̞ː t e̞ː ɕ i̥ kʲ i
にじます	ɲ̟ i ʑ i m a̠ s ɨᵝ
にじむ	ɲ̟ i ʑ i m ɯ̟ᵝ
にじめい	ɲ̟ i ʑ i m e̞ː
にじゅういち	ɲ̟ i ʑ ɨᵝː i t͡ɕ i
にじゅうご	ɲ̟ i ʑ ɨᵝː ɡ o̞
にじゅうごにち	ɲ̟ i ʑ ɨᵝː ɡ o̞ ɲ̟ i t͡ɕ i
にじゅうさん	ɲ̟ i ʑ ɨᵝː s ã̠ ɴ
にじゅうしちにち	ɲ̟ i ʑ ɨᵝː ɕ i t͡ɕ i ɲ̟ i t͡ɕ i
にじゅうぞこ	ɲ̟ i ʑ ɨᵝː z o̞ k o̞
にじゅうはちにち	ɲ̟ i ʑ ɨᵝː h a̠ t͡ɕ i ɲ̟ i t͡ɕ i
にじゅうひてい	ɲ̟ i ʑ ɨᵝː ç i t e̞ː
にじゅうみっか	ɲ̟ i ʑ ɨᵝː mʲ i k̚ k a̠
にじゅうろくにち	ɲ̟ i ʑ ɨᵝː ɾ o̞ k ɯ̟ᵝ ɲ̟ i t͡ɕ i
にせ	ɲ̟ i s e̞
にせき	ɲ̟ i s e̞ kʲ i
にそくさんもん	ɲ̟ i s o̞ k ɯ̟̊ᵝ s ã̠ mː õ̞ ɴ
にたりよったり	ɲ̟ i t a̠ ɾʲ i j o̞ t̚ t a̠ ɾʲ i
にだい	ɲ̟ i d a̠ i
にちじょうせいかつ	ɲ̟ i t͡ɕ i ʑ o̞ː s e̞ː k a̠ t͡s ɨᵝ
にちべい	ɲ̟ i t͡ɕ i b e̞ː
にちぼつ	ɲ̟ i t͡ɕ i b o̞ t͡s ɨᵝ
にちよう	ɲ̟ i t͡ɕ i j o̞ː
にちようび	ɲ̟ i t͡ɕ i j o̞ː bʲ i
にっき	ɲ̟ i k̚ʲ kʲ i
にっきちょう	ɲ̟ i k̚ʲ kʲ i t͡ɕ o̞ː
にっこうよく	ɲ̟ i k̚ k o̞ː j o̞ k ɯ̟ᵝ
にっすう	ɲ̟ i sː ɯ̟ᵝː
につかわしい	ɲ̟ i t͡s ɨ̥ᵝ k a̠ ɰᵝ a̠ ɕ iː
にて	ɲ̟ i t e̞
になう	ɲ̟ i n a̠ ɯ̟ᵝ
ににんばおり	ɲ̟ i ɲ̟ ĩ m b a̠ o̞ ɾʲ i
にひゃくご	ɲ̟ i ç a̠ k ɯ̟ᵝ ɡ o̞
にひゃくとおか	ɲ̟ i ç a̠ k ɯ̟ᵝ t o̞ː k a̠
にぶる	ɲ̟ i b ɯ̟ᵝ ɾ ɯ̟ᵝ
にほん	ɲ̟ i h õ̞ ɴ
にほんおおかみ	ɲ̟ i h õ̞ ɰ̃ o̞ː k a̠ mʲ i
にほんかいりゅう	ɲ̟ i h õ̞ ŋ k a̠ i ɾʲ ɨᵝː
にほんこく	ɲ̟ i h õ̞ ŋ k o̞ k ɯ̟ᵝ
にほんご	ɲ̟ i h õ̞ ŋ ɡ o̞
にほんざる	ɲ̟ i h õ̞ n d͡z a̠ ɾ ɯ̟ᵝ
にほんしゅ	ɲ̟ i h õ̞ ɰ̃ ɕ ɨᵝ
にほんとう	ɲ̟ i h õ̞ n t o̞ː
にほんりょうり	ɲ̟ i h õ̞ n ɾʲ o̞ː ɾʲ i
にもかかわらず	ɲ̟ i m o̞ k a̠ k a̠ ɰᵝ a̠ ɾ a̠ z ɨᵝ
にゃ	ɲ̟ a̠
にやく	ɲ̟ i j a̠ k ɯ̟ᵝ
にやす	ɲ̟ i j a̠ s ɨᵝ
にゅうか	ɲ̟ ɯ̟ᵝː k a̠
にゅうかく	ɲ̟ ɯ̟ᵝː k a̠ k ɯ̟ᵝ
にゅうかん	ɲ̟ ɯ̟ᵝː k ã̠ ɴ
にゅうこ	ɲ̟ ɯ̟ᵝː k o̞
にゅうこう	ɲ̟ ɯ̟ᵝː k o̞ː
にゅうせい	ɲ̟ ɯ̟ᵝː s e̞ː
にゅうせき	ɲ̟ ɯ̟ᵝː s e̞ kʲ i
にゅうたい	ɲ̟ ɯ̟ᵝː t a̠ i
にゅうどうぐも	ɲ̟ ɯ̟ᵝː d o̞ː ɡ ɯ̟ᵝ m o̞
にゅうひ	ɲ̟ ɯ̟ᵝː ç i
にゅうぶ	ɲ̟ ɯ̟ᵝː b ɯ̟ᵝ
にゅうらい	ɲ̟ ɯ̟ᵝː ɾ a̠ i
にょう	ɲ̟ o̞ː
にょうどうきゅうせん	ɲ̟ o̞ː d o̞ː kʲ ɨᵝː s ẽ̞ ɴ
にょうどうきゅうせんえき	ɲ̟ o̞ː d o̞ː kʲ ɨᵝː s ẽ̞ ɰ̃ e̞ kʲ i
にょじつ	ɲ̟ o̞ ʑ i t͡s ɨᵝ
にょろにょろ	ɲ̟ o̞ ɾ o̞ ɲ̟ o̞ ɾ o̞
により	ɲ̟ i j o̞ ɾʲ i
にらめっこ	ɲ̟ i ɾ a̠ m e̞ k̚ k o̞
にりつはいはん	ɲ̟ i ɾʲ i t͡s ɨᵝ h a̠ i h ã̠ ɴ
にりんしゃ	ɲ̟ i ɾʲ ĩ ɰ̃ ɕ a̠
にりんそう	ɲ̟ i ɾʲ ĩ ɰ̃ s o̞ː
にる	ɲ̟ i ɾ ɯ̟ᵝ
にるい	ɲ̟ i ɾ ɯ̟ᵝ i
にるいしゅ	ɲ̟ i ɾ ɯ̟ᵝ i ɕ ɨᵝ
にれ	ɲ̟ i ɾ e̞
にわ	ɲ̟ i ɰᵝ a̠
にわか	ɲ̟ i ɰᵝ a̠ k a̠
にわとこ	ɲ̟ i ɰᵝ a̠ t o̞ k o̞
にわとり	ɲ̟ i ɰᵝ a̠ t o̞ ɾʲ i
にんき	ɲ̟ ĩ ŋʲ kʲ i
にんぎょうげき	ɲ̟ ĩ ŋʲ ɡʲ o̞ː ɡ e̞ kʲ i
にんげん	ɲ̟ ĩ ŋ ɡ ẽ̞ ɴ
にんじゃ	ɲ̟ ĩ ɲ̟ d͡ʑ a̠
にんじん	ɲ̟ ĩ ɲ̟ d͡ʑ ĩ ɴ
にんちど	ɲ̟ ĩ ɲ̟ t͡ɕ i d o̞
にんにく	ɲ̟ ĩ ɲ̟ ɲ̟ i k ɯ̟ᵝ
にんむ	ɲ̟ ĩ mː ɯ̟ᵝ
ぬいぐるみ	n ɯ̟ᵝ i ɡ ɯ̟ᵝ ɾ ɯ̟ᵝ mʲ i
ぬか	n ɯ̟ᵝ k a̠
ぬかばえ	n ɯ̟ᵝ k a̠ b a̠ e̞
ぬかよろこび	n ɯ̟ᵝ k a̠ j o̞ ɾ o̞ k o̞ bʲ i
ぬがす	n ɯ̟ᵝ ɡ a̠ s ɨᵝ
ぬぐ	n ɯ̟ᵝ ɡ ɯ̟ᵝ
ぬけがら	n ɯ̟ᵝ k e̞ ɡ a̠ ɾ a̠
ぬけだす	n ɯ̟ᵝ k e̞ d a̠ s ɨᵝ
ぬける	n ɯ̟ᵝ k e̞ ɾ ɯ̟ᵝ
ぬらす	n ɯ̟ᵝ ɾ a̠ s ɨᵝ
ぬる	n ɯ̟ᵝ ɾ ɯ̟ᵝ
ぬるぽ	n ɯ̟ᵝ ɾ ɯ̟ᵝ p o̞
ぬれそぼつ	n ɯ̟ᵝ ɾ e̞ s o̞ b o̞ t͡s ɨᵝ
ぬれる	n ɯ̟ᵝ ɾ e̞ ɾ ɯ̟ᵝ
ぬんちゃく	n ɯ̟̃ᵝ ɲ̟ t͡ɕ a̠ k ɯ̟ᵝ
ねあげ	n e̞ a̠ ɡ e̞
ねいき	n e̞ i kʲ i
ねうお	n e̞ ɯ̟ᵝ o̞
ねえ	n e̞ː
ねおち	n e̞ o̞ t͡ɕ i
ねかす	n e̞ k a̠ s ɨᵝ
ねかた	n e̞ k a̠ t a̠
ねから	n e̞ k a̠ ɾ a̠
ねがい	n e̞ ɡ a̠ i
ねがえり	n e̞ ɡ a̠ e̞ ɾʲ i
ねがお	n e̞ ɡ a̠ o̞
ねぐら	n e̞ ɡ ɯ̟ᵝ ɾ a̠
ねこ	n e̞ k o̞
ねこすい	n e̞ k o̞ s ɨᵝ i
ねこぜ	n e̞ k o̞ z e̞
ねこめいし	n e̞ k o̞ m e̞ i ɕ i
ねころがる	n e̞ k o̞ ɾ o̞ ɡ a̠ ɾ ɯ̟ᵝ
ねじまわし	n e̞ ʑ i m a̠ ɰᵝ a̠ ɕ i
ねすがた	n e̞ s ɨᵝ ɡ a̠ t a̠
ねすごす	n e̞ s ɨᵝ ɡ o̞ s ɨᵝ
ねずみ	n e̞ z ɨᵝ mʲ i
ねずみいるか	n e̞ z ɨᵝ mʲ i i ɾ ɯ̟ᵝ k a̠
ねそべる	n e̞ s o̞ b e̞ ɾ ɯ̟ᵝ
ねたきり	n e̞ t a̠ kʲ i ɾʲ i
ねちがえる	n e̞ t͡ɕ i ɡ a̠ e̞ ɾ ɯ̟ᵝ
ねっから	n e̞ k̚ k a̠ ɾ a̠
ねっきょう	n e̞ k̚ʲ kʲ o̞ː
ねっちゅう	n e̞ t̚ t͡ɕ ɨᵝː
ねつ	n e̞ t͡s ɨᵝ
ねつおせん	n e̞ t͡s ɨᵝ o̞ s ẽ̞ ɴ
ねつきうお	n e̞ t͡s ɨᵝ kʲ i ɯ̟ᵝ o̞
ねつききゅう	n e̞ t͡s ɨ̥ᵝ kʲ i kʲ ɨᵝː
ねつけ	n e̞ t͡s ɨ̥ᵝ k e̞
ねつけん	n e̞ t͡s ɨᵝ k ẽ̞ ɴ
ねつぞう	n e̞ t͡s ɨᵝ z o̞ː
ねつぼうそう	n e̞ t͡s ɨᵝ b o̞ː s o̞ː
ねづく	n e̞ z ɨᵝ k ɯ̟ᵝ
ねどこ	n e̞ d o̞ k o̞
ねばねば	n e̞ b a̠ n e̞ b a̠
ねびき	n e̞ bʲ i kʲ i
ねぼう	n e̞ b o̞ː
ねぼける	n e̞ b o̞ k e̞ ɾ ɯ̟ᵝ
ねまき	n e̞ m a̠ kʲ i
ねむい	n e̞ m ɯ̟ᵝ i
ねむけ	n e̞ m ɯ̟ᵝ k e̞
ねむけがおそう	n e̞ m ɯ̟ᵝ k e̞ ɡ a̠ o̞ s o̞ː
ねむる	n e̞ m ɯ̟ᵝ ɾ ɯ̟ᵝ
ねもと	n e̞ m o̞ t o̞
ねものがたり	n e̞ m o̞ n o̞ ɡ a̠ t a̠ ɾʲ i
ねらう	n e̞ ɾ a̠ ɯ̟ᵝ
ねりこ	n e̞ ɾʲ i k o̞
ねりなおす	n e̞ ɾʲ i n a̠ o̞ s ɨᵝ
ねる	n e̞ ɾ ɯ̟ᵝ
ねん	n ẽ̞ ɴ
ねんかん	n ẽ̞ ŋ k ã̠ ɴ
ねんがっぴ	n ẽ̞ ŋ ɡ a̠ p̚ʲ pʲ i
ねんざ	n ẽ̞ n d͡z a̠
ねんし	n ẽ̞ ɰ̃ ɕ i
ねんしゅう	n ẽ̞ ɰ̃ ɕ ɨᵝː
ねんしゅつ	n ẽ̞ ɰ̃ ɕ ɨᵝ t͡s ɨᵝ
ねんしょう	n ẽ̞ ɰ̃ ɕ o̞ː
ねんじゅう	n ẽ̞ ɲ̟ d͡ʑ ɨᵝː
ねんにいちど	n ẽ̞ ɲ̟ ɲ̟ i i t͡ɕ i d o̞
ねんぴ	n ẽ̞ m pʲ i
ねんぶつ	n ẽ̞ m b ɯ̟ᵝ t͡s ɨᵝ
ねんまつ	n ẽ̞ mː a̠ t͡s ɨᵝ
ねんりょ	n ẽ̞ n ɾʲ o̞
のう	n o̞ː
のうか	n o̞ː k a̠
のうがくしゃ	n o̞ː ɡ a̠ k ɯ̟ᵝ ɕ a̠
のうこん	n o̞ː k õ̞ ɴ
のうさいぼう	n o̞ː s a̠ i b o̞ː
のうさつ	n o̞ː s a̠ t͡s ɨᵝ
のうしょう	n o̞ː ɕ o̞ː
のうじょう	n o̞ː ʑ o̞ː
のうずい	n o̞ː z ɨᵝ i
のうどうたい	n o̞ː d o̞ː t a̠ i
のうどうてき	n o̞ː d o̞ː t e̞ kʲ i
のうない	n o̞ː n a̠ i
のうにゅう	n o̞ː ɲ̟ ɯ̟ᵝː
のうひん	n o̞ː ç ĩ ɴ
のうふ	n o̞ː ɸ ɯ̟ᵝ
のうま	n o̞ ɯ̟ᵝ m a̠
のうみそ	n o̞ː mʲ i s o̞
のうみん	n o̞ː mʲ ĩ ɴ
のうよう	n o̞ː j o̞ː
のうりつ	n o̞ː ɾʲ i t͡s ɨᵝ
のうりょく	n o̞ː ɾʲ o̞ k ɯ̟ᵝ
のがす	n o̞ ɡ a̠ s ɨᵝ
のがれ	n o̞ ɡ a̠ ɾ e̞
のき	n o̞ kʲ i
のきさき	n o̞ kʲ i̥ s a̠ kʲ i
のこす	n o̞ k o̞ s ɨᵝ
のこり	n o̞ k o̞ ɾʲ i
のこる	n o̞ k o̞ ɾ ɯ̟ᵝ
のし	n o̞ ɕ i
のじこ	n o̞ ʑ i k o̞
のせ	n o̞ s e̞
のぞく	n o̞ z o̞ k ɯ̟ᵝ
のぞむ	n o̞ z o̞ m ɯ̟ᵝ
のっかる	n o̞ k̚ k a̠ ɾ ɯ̟ᵝ
のっとる	n o̞ t̚ t o̞ ɾ ɯ̟ᵝ
のてんぶろ	n o̞ t ẽ̞ m b ɯ̟ᵝ ɾ o̞
のど	n o̞ d o̞
のどか	n o̞ d o̞ k a̠
のどちんこ	n o̞ d o̞ t͡ɕ ĩ ŋ k o̞
のどぼとけ	n o̞ d o̞ b o̞ t o̞ k e̞
のどもと	n o̞ d o̞ m o̞ t o̞
ののしる	n o̞ n o̞ ɕ i ɾ ɯ̟ᵝ
ののてん	n o̞ n o̞ t ẽ̞ ɴ
のばす	n o̞ b a̠ s ɨᵝ
のびのび	n o̞ bʲ i n o̞ bʲ i
のびやか	n o̞ bʲ i j a̠ k a̠
のびる	n o̞ bʲ i ɾ ɯ̟ᵝ
のぶはる	n o̞ b ɯ̟ᵝ h a̠ ɾ ɯ̟ᵝ
のぼりぼう	n o̞ b o̞ ɾʲ i b o̞ː
のぼる	n o̞ b o̞ ɾ ɯ̟ᵝ
のみ	n o̞ mʲ i
のみこみ	n o̞ mʲ i k o̞ mʲ i
のみこむ	n o̞ mʲ i k o̞ m ɯ̟ᵝ
のらねこ	n o̞ ɾ a̠ n e̞ k o̞
のり	n o̞ ɾʲ i
のりあいじどうしゃ	n o̞ ɾʲ i a̠ i ʑ i d o̞ː ɕ a̠
のりあげる	n o̞ ɾʲ i a̠ ɡ e̞ ɾ ɯ̟ᵝ
のりかえ	n o̞ ɾʲ i k a̠ e̞
のりき	n o̞ ɾʲ i kʲ i
のりきる	n o̞ ɾʲ i kʲ i ɾ ɯ̟ᵝ
のりこ	n o̞ ɾʲ i k o̞
のりまさ	n o̞ ɾʲ i m a̠ s a̠
のりもの	n o̞ ɾʲ i m o̞ n o̞
のる	n o̞ ɾ ɯ̟ᵝ
のるかそるか	n o̞ ɾ ɯ̟ᵝ k a̠ s o̞ ɾ ɯ̟ᵝ k a̠
のろい	n o̞ ɾ o̞ i
のろう	n o̞ ɾ o̞ ɯ̟ᵝ
のんき	n õ̞ ŋʲ kʲ i
のんびり	n õ̞ m bʲ i ɾʲ i
はぁ	h a̠ː
はい	h a̠ i
はいいろ	h a̠ iː ɾ o̞
はいいろぎつね	h a̠ i i ɾ o̞ ɡʲ i t͡s ɨᵝ n e̞
はいえき	h a̠ i e̞ kʲ i
はいか	h a̠ i k a̠
はいかい	h a̠ i k a̠ i
はいがん	h a̠ i ɡ ã̠ ɴ
はいき	h a̠ i kʲ i
はいきもの	h a̠ i kʲ i m o̞ n o̞
はいきゅう	h a̠ i kʲ ɨᵝː
はいきょ	h a̠ i kʲ o̞
はいきょう	h a̠ i kʲ o̞ː
はいけい	h a̠ i k e̞ː
はいこうじょう	h a̠ i k o̞ː ʑ o̞ː
はいざら	h a̠ i z a̠ ɾ a̠
はいすいこう	h a̠ i s ɨᵝ i k o̞ː
はいせき	h a̠ i s e̞ kʲ i
はいせつ	h a̠ i s e̞ t͡s ɨᵝ
はいせつぶつ	h a̠ i s e̞ t͡s ɨᵝ b ɯ̟ᵝ t͡s ɨᵝ
はいせん	h a̠ i s ẽ̞ ɴ
はいせんしゃ	h a̠ i s ẽ̞ ɰ̃ ɕ a̠
はいそ	h a̠ i s o̞
はいそん	h a̠ i s õ̞ ɴ
はいたつ	h a̠ i t a̠ t͡s ɨᵝ
はいちょう	h a̠ i t͡ɕ o̞ː
はいでんばん	h a̠ i d ẽ̞ m b ã̠ ɴ
はいび	h a̠ i bʲ i
はいふ	h a̠ i ɸ ɯ̟ᵝ
はいめん	h a̠ i m ẽ̞ ɴ
はいゆう	h a̠ i j ɯ̟ᵝː
はいる	h a̠ i ɾ ɯ̟ᵝ
はいれつ	h a̠ i ɾ e̞ t͡s ɨᵝ
はえ	h a̠ e̞
はえる	h a̠ e̞ ɾ ɯ̟ᵝ
はおり	h a̠ o̞ ɾʲ i
はか	h a̠ k a̠
はかい	h a̠ k a̠ i
はかいかつどう	h a̠ k a̠ i k a̠ t͡s ɨᵝ d o̞ː
はかいしゃ	h a̠ k a̠ i ɕ a̠
はかく	h a̠ k a̠ k ɯ̟ᵝ
はかた	h a̠ k a̠ t a̠
はかない	h a̠ k a̠ n a̠ i
はかば	h a̠ k a̠ b a̠
はかま	h a̠ k a̠ m a̠
はかり	h a̠ k a̠ ɾʲ i
はがす	h a̠ ɡ a̠ s ɨᵝ
はがね	h a̠ ɡ a̠ n e̞
はがゆい	h a̠ ɡ a̠ j ɯ̟ᵝ i
はき	h a̠ kʲ i
はきけ	h a̠ kʲ i̥ k e̞
はきだす	h a̠ kʲ i d a̠ s ɨᵝ
はぎ	h a̠ ɡʲ i
はく	h a̠ k ɯ̟ᵝ
はくあかん	h a̠ k ɯ̟ᵝ a̠ k ã̠ ɴ
はくい	h a̠ k ɯ̟ᵝ i
はくがく	h a̠ k ɯ̟ᵝ ɡ a̠ k ɯ̟ᵝ
はくがん	h a̠ k ɯ̟ᵝ ɡ ã̠ ɴ
はくぎん	h a̠ k ɯ̟ᵝ ɡʲ ĩ ɴ
はくさい	h a̠ k ɯ̟̊ᵝ s a̠ i
はくしつ	h a̠ k ɯ̟̊ᵝ ɕ i t͡s ɨᵝ
はくしゅう	h a̠ k ɯ̟ᵝ ɕ ɨᵝː
はくしょ	h a̠ k ɯ̟ᵝ ɕ o̞
はくしん	h a̠ k ɯ̟ᵝ ɕ ĩ ɴ
はくじょう	h a̠ k ɯ̟ᵝ ʑ o̞ː
はくせい	h a̠ k ɯ̟̊ᵝ s e̞ː
はくだつ	h a̠ k ɯ̟ᵝ d a̠ t͡s ɨᵝ
はくちょう	h a̠ k ɯ̟̊ᵝ t͡ɕ o̞ː
はくちょうざ	h a̠ k ɯ̟̊ᵝ t͡ɕ o̞ː z a̠
はくまい	h a̠ k ɯ̟ᵝ m a̠ i
はくめい	h a̠ k ɯ̟ᵝ m e̞ː
はくらい	h a̠ k ɯ̟ᵝ ɾ a̠ i
はくらいひん	h a̠ k ɯ̟ᵝ ɾ a̠ i ç ĩ ɴ
はくり	h a̠ k ɯ̟ᵝ ɾʲ i
はくりきこ	h a̠ k ɯ̟ᵝ ɾʲ i kʲ i k o̞
はぐ	h a̠ ɡ ɯ̟ᵝ
はぐき	h a̠ ɡ ɯ̟ᵝ kʲ i
はぐきおん	h a̠ ɡ ɯ̟ᵝ kʲ i õ̞ ɴ
はぐらかす	h a̠ ɡ ɯ̟ᵝ ɾ a̠ k a̠ s ɨᵝ
はぐるま	h a̠ ɡ ɯ̟ᵝ ɾ ɯ̟ᵝ m a̠
はけぐち	h a̠ k e̞ ɡ ɯ̟̊ᵝ t͡ɕ i
はげ	h a̠ ɡ e̞
はげしい	h a̠ ɡ e̞ ɕ i i
はげむ	h a̠ ɡ e̞ m ɯ̟ᵝ
はげる	h a̠ ɡ e̞ ɾ ɯ̟ᵝ
はこ	h a̠ k o̞
はこせこ	h a̠ k o̞ s e̞ k o̞
はこびこむ	h a̠ k o̞ bʲ i k o̞ m ɯ̟ᵝ
はこべ	h a̠ k o̞ b e̞
はごいた	h a̠ ɡ o̞ i t a̠
はさまる	h a̠ s a̠ m a̠ ɾ ɯ̟ᵝ
はさみ	h a̠ s a̠ mʲ i
はさむ	h a̠ s a̠ m ɯ̟ᵝ
はさん	h a̠ s ã̠ ɴ
はざま	h a̠ z a̠ m a̠
はし	h a̠ ɕ i
はしご	h a̠ ɕ i ɡ o̞
はしござけ	h a̠ ɕ i ɡ o̞ z a̠ k e̞
はしばし	h a̠ ɕ i b a̠ ɕ i
はしり	h a̠ ɕ i ɾʲ i
はしりがき	h a̠ ɕ i ɾʲ i ɡ a̠ kʲ i
はしりまわる	h a̠ ɕ i ɾʲ i m a̠ ɰᵝ a̠ ɾ ɯ̟ᵝ
はしわたし	h a̠ ɕ i ɰᵝ a̠ t a̠ ɕ i
はじ	h a̠ ʑ i
はじき	h a̠ ʑ i kʲ i
はじさらし	h a̠ ʑ i s a̠ ɾ a̠ ɕ i
はじしらず	h a̠ ʑ i ɕ i ɾ a̠ z ɨᵝ
はじまり	h a̠ ʑ i m a̠ ɾʲ i
はじまる	h a̠ ʑ i m a̠ ɾ ɯ̟ᵝ
はじめまして	h a̠ ʑ i m e̞ m a̠ ɕ i̥ t e̞
はじめる	h a̠ ʑ i m e̞ ɾ ɯ̟ᵝ
はじゃけんしょう	h a̠ ʑ a̠ k ẽ̞ ɰ̃ ɕ o̞ː
はじらう	h a̠ ʑ i ɾ a̠ ɯ̟ᵝ
はずかしめる	h a̠ z ɨᵝ k a̠ ɕ i m e̞ ɾ ɯ̟ᵝ
はずす	h a̠ z ɨᵝ s ɨᵝ
はずれる	h a̠ z ɨᵝ ɾ e̞ ɾ ɯ̟ᵝ
はせ	h a̠ s e̞
はせい	h a̠ s e̞ː
はせさんじる	h a̠ s e̞ s ã̠ ɲ̟ d͡ʑ i ɾ ɯ̟ᵝ
はた	h a̠ t a̠
はたけ	h a̠ t a̠ k e̞
はたしじょう	h a̠ t a̠ ɕ i ʑ o̞ː
はたす	h a̠ t a̠ s ɨᵝ
はためいわく	h a̠ t a̠ m e̞ː ɰᵝ a̠ k ɯ̟ᵝ
はたらき	h a̠ t a̠ ɾ a̠ kʲ i
はたらきもの	h a̠ t a̠ ɾ a̠ kʲ i m o̞ n o̞
はたらく	h a̠ t a̠ ɾ a̠ k ɯ̟ᵝ
はたん	h a̠ t ã̠ ɴ
はだかのつきあい	h a̠ d a̠ k a̠ n o̞ t͡s ɨᵝ kʲ i a̠ i
はだかまいり	h a̠ d a̠ k a̠ m a̠ i ɾʲ i
はだぎ	h a̠ d a̠ ɡʲ i
はだし	h a̠ d a̠ ɕ i
はだでしる	h a̠ d a̠ d e̞ ɕ i ɾ ɯ̟ᵝ
はだん	h a̠ d ã̠ ɴ
はちく	h a̠ t͡ɕ i k ɯ̟ᵝ
はちじゅう	h a̠ t͡ɕ i ʑ ɨᵝː
はちす	h a̠ t͡ɕ i s ɨᵝ
はちすか	h a̠ t͡ɕ i s ɨᵝ k a̠
はちどり	h a̠ t͡ɕ i d o̞ ɾʲ i
はちぶんぎざ	h a̠ t͡ɕ i b ɯ̟̃ᵝ ŋʲ ɡʲ i z a̠
はちみつ	h a̠ t͡ɕ i mʲ i t͡s ɨᵝ
はちゅうるい	h a̠ t͡ɕ ɨᵝː ɾ ɯ̟ᵝ i
はちりはん	h a̠ t͡ɕ i ɾʲ i h ã̠ ɴ
はっかい	h a̠ k̚ k a̠ i
はっきり	h a̠ k̚ʲ kʲ i ɾʲ i
はっけしょう	h a̠ k̚ k e̞ ɕ o̞ː
はっけっきゅう	h a̠ k̚ k e̞ k̚ʲ kʲ ɨᵝː
はっけつびょう	h a̠ k̚ k e̞ t͡s ɨᵝ bʲ o̞ː
はっけん	h a̠ k̚ k ẽ̞ ɴ
はっしゃ	h a̠ ɕː a̠
はっせい	h a̠ sː e̞ː
はっせいせいぶつがく	h a̠ sː e̞ː s e̞ː b ɯ̟ᵝ t͡s ɨᵝ ɡ a̠ k ɯ̟ᵝ
はっそう	h a̠ sː o̞ː
はったつしょうがい	h a̠ t̚ t a̠ t͡s ɨᵝ ɕ o̞ː ɡ a̠ i
はっちゅう	h a̠ t̚ t͡ɕ ɨᵝː
はってん	h a̠ t̚ t ẽ̞ ɴ
はっと	h a̠ t̚ t o̞
はっとり	h a̠ t̚ t o̞ ɾʲ i
はっぱ	h a̠ p̚ p a̠
はっぴょう	h a̠ p̚ʲ pʲ o̞ː
はっぽうしゅ	h a̠ p̚ p o̞ː ɕ ɨᵝ
はつ	h a̠ t͡s ɨᵝ
はつえん	h a̠ t͡s ɨᵝ ẽ̞ ɴ
はつか	h a̠ t͡s ɨ̥ᵝ k a̠
はつがげんまい	h a̠ t͡s ɨᵝ ɡ a̠ ɡ ẽ̞ mː a̠ i
はつがんぶっしつ	h a̠ t͡s ɨᵝ ɡ ã̠ m b ɯ̟ᵝ ɕː i t͡s ɨᵝ
はつげん	h a̠ t͡s ɨᵝ ɡ ẽ̞ ɴ
はつご	h a̠ t͡s ɨᵝ ɡ o̞
はつたいけん	h a̠ t͡s ɨᵝ t a̠ i k ẽ̞ ɴ
はつばい	h a̠ t͡s ɨᵝ b a̠ i
はつもの	h a̠ t͡s ɨᵝ m o̞ n o̞
はつれい	h a̠ t͡s ɨᵝ ɾ e̞ː
はつわ	h a̠ t͡s ɨᵝ ɰᵝ a̠
はづき	h a̠ z ɨᵝ kʲ i
はて	h a̠ t e̞
はで	h a̠ d e̞
はと	h a̠ t o̞
はとどけい	h a̠ t o̞ d o̞ k e̞ː
はな	h a̠ n a̠
はなうた	h a̠ n a̠ ɯ̟ᵝ t a̠
はなえ	h a̠ n a̠ e̞
はなかんらん	h a̠ n a̠ k ã̠ n ɾ ã̠ ɴ
はなざかり	h a̠ n a̠ z a̠ k a̠ ɾʲ i
はなしがい	h a̠ n a̠ ɕ i ɡ a̠ i
はなす	h a̠ n a̠ s ɨᵝ
はなぞの	h a̠ n a̠ z o̞ n o̞
はなだいろ	h a̠ n a̠ d a̠ i ɾ o̞
はなづまり	h a̠ n a̠ z ɨᵝ m a̠ ɾʲ i
はなはだ	h a̠ n a̠ h a̠ d a̠
はなはだしい	h a̠ n a̠ h a̠ d a̠ ɕ i i
はなびえ	h a̠ n a̠ bʲ i e̞
はなみ	h a̠ n a̠ mʲ i
はなむけ	h a̠ n a̠ m ɯ̟ᵝ k e̞
はなればなれ	h a̠ n a̠ ɾ e̞ b a̠ n a̠ ɾ e̞
はにかむ	h a̠ ɲ̟ i k a̠ m ɯ̟ᵝ
はにわ	h a̠ ɲ̟ i ɰᵝ a̠
はね	h a̠ n e̞
はねつき	h a̠ n e̞ t͡s ɨ̥ᵝ kʲ i
はねる	h a̠ n e̞ ɾ ɯ̟ᵝ
はばひろい	h a̠ b a̠ ç i ɾ o̞ i
はばむ	h a̠ b a̠ m ɯ̟ᵝ
はびこる	h a̠ bʲ i k o̞ ɾ ɯ̟ᵝ
はぶく	h a̠ b ɯ̟ᵝ k ɯ̟ᵝ
はまじゅつ	h a̠ m a̠ ʑ ɨᵝ t͡s ɨᵝ
はまる	h a̠ m a̠ ɾ ɯ̟ᵝ
はみ	h a̠ mʲ i
はみがき	h a̠ mʲ i ɡ a̠ kʲ i
はむ	h a̠ m ɯ̟ᵝ
はむかう	h a̠ m ɯ̟ᵝ k a̠ ɯ̟ᵝ
はめ	h a̠ m e̞
はめたおす	h a̠ m e̞ t a̠ o̞ s ɨᵝ
はめる	h a̠ m e̞ ɾ ɯ̟ᵝ
はもん	h a̠ m õ̞ ɴ
はや	h a̠ j a̠
はやい	h a̠ j a̠ i
はやおきはさんもんのとく	h a̠ j a̠ o̞ kʲ i ɰᵝ a̠ s ã̠ mː õ̞ n n o̞ t o̞ k ɯ̟ᵝ
はやおし	h a̠ j a̠ o̞ ɕ i
はやかれおそかれ	h a̠ j a̠ k a̠ ɾ e̞ o̞ s o̞ k a̠ ɾ e̞
はやがき	h a̠ j a̠ ɡ a̠ kʲ i
はやがてん	h a̠ j a̠ ɡ a̠ t ẽ̞ ɴ
はやく	h a̠ j a̠ k ɯ̟ᵝ
はやし	h a̠ j a̠ ɕ i
はやじに	h a̠ j a̠ ʑ i ɲ̟ i
はやとちり	h a̠ j a̠ t o̞ t͡ɕ i ɾʲ i
はやね	h a̠ j a̠ n e̞
はやのみこみ	h a̠ j a̠ n o̞ mʲ i k o̞ mʲ i
はやばん	h a̠ j a̠ b ã̠ ɴ
はやびき	h a̠ j a̠ bʲ i kʲ i
はやべん	h a̠ j a̠ b ẽ̞ ɴ
はやめ	h a̠ j a̠ m e̞
はやめる	h a̠ j a̠ m e̞ ɾ ɯ̟ᵝ
はやる	h a̠ j a̠ ɾ ɯ̟ᵝ
はよ	h a̠ j o̞
はら	h a̠ ɾ a̠
はらいせ	h a̠ ɾ a̠ i s e̞
はらいもどし	h a̠ ɾ a̠ i m o̞ d o̞ ɕ i
はらから	h a̠ ɾ a̠ k a̠ ɾ a̠
はらがへる	h a̠ ɾ a̠ ɡ a̠ h e̞ ɾ ɯ̟ᵝ
はらす	h a̠ ɾ a̠ s ɨᵝ
はらだち	h a̠ ɾ a̠ d a̠ t͡ɕ i
はらはちぶ	h a̠ ɾ a̠ h a̠ t͡ɕ i b ɯ̟ᵝ
はらはら	h a̠ ɾ a̠ h a̠ ɾ a̠
はらばい	h a̠ ɾ a̠ b a̠ i
はりあう	h a̠ ɾʲ i a̠ ɯ̟ᵝ
はりあわせる	h a̠ ɾʲ i a̠ ɰᵝ a̠ s e̞ ɾ ɯ̟ᵝ
はりがみ	h a̠ ɾʲ i ɡ a̠ mʲ i
はりきる	h a̠ ɾʲ i kʲ i ɾ ɯ̟ᵝ
はりちりょう	h a̠ ɾ i t͡ɕ i ɾ j o̞ː
はる	h a̠ ɾ ɯ̟ᵝ
はるさめ	h a̠ ɾ ɯ̟ᵝ s a̠ m e̞
はるまき	h a̠ ɾ ɯ̟ᵝ m a̠ kʲ i
はれる	h a̠ ɾ e̞ ɾ ɯ̟ᵝ
はろう	h a̠ ɾ o̞ː
はん	h ã̠ ɴ
はんい	h ã̠ ɰ̃ i
はんえいゆう	h ã̠ ɰ̃ e̞ː j ɯ̟ᵝː
はんか	h ã̠ ŋ k a̠
はんきょうていい	h ã̠ ŋʲ kʲ o̞ː t e̞ː i
はんぎご	h ã̠ ŋʲ ɡʲ i ɡ o̞
はんざい	h ã̠ n d͡z a̠ i
はんしゃきょう	h ã̠ ɰ̃ ɕ a̠ kʲ o̞ː
はんしゃてき	h ã̠ ɰ̃ ɕ a̠ t e̞ kʲ i
はんしょう	h ã̠ ɰ̃ ɕ o̞ː
はんしん	h ã̠ ɰ̃ ɕ ĩ ɴ
はんすう	h ã̠ ɰ̃ s ɨᵝː
はんだい	h ã̠ n d a̠ i
はんだづけ	h ã̠ n d a̠ z ɨᵝ k e̞
はんだん	h ã̠ n d ã̠ ɴ
はんだんりょく	h ã̠ n d ã̠ n ɾʲ o̞ k ɯ̟ᵝ
はんてん	h ã̠ n t ẽ̞ ɴ
はんばい	h ã̠ m b a̠ i
はんばいいん	h ã̠ m b a̠ i ĩ ɴ
はんばいしゃ	h ã̠ m b a̠ i ɕ a̠
はんべつ	h ã̠ m b e̞ t͡s ɨᵝ
ばあい	b a̠ a̠ i
ばいおん	b a̠ i õ̞ ɴ
ばいきゃく	b a̠ i kʲ a̠ k ɯ̟ᵝ
ばいきん	b a̠ i kʲ ĩ ɴ
ばいこく	b a̠ i k o̞ k ɯ̟ᵝ
ばいすう	b a̠ i s ɨᵝː
ばいたん	b a̠ i t ã̠ ɴ
ばか	b a̠ k a̠
ばかぢから	b a̠ k a̠ ʑ i k a̠ ɾ a̠
ばかばかしい	b a̠ k a̠ b a̠ k a̠ ɕ i i
ばからしい	b a̠ k a̠ ɾ a̠ ɕ iː
ばきゃく	b a̠ kʲ a̠ k ɯ̟ᵝ
ばくえき	b a̠ k ɯ̟ᵝ e̞ kʲ i
ばくおん	b a̠ k ɯ̟ᵝ õ̞ ɴ
ばくが	b a̠ k ɯ̟ᵝ ɡ a̠
ばくがとう	b a̠ k ɯ̟ᵝ ɡ a̠ t o̞ː
ばくげきき	b a̠ k ɯ̟ᵝ ɡ e̞ kʲ i̥ kʲ i
ばくしん	b a̠ k ɯ̟̊ᵝ ɕ ĩ ɴ
ばくすい	b a̠ k ɯ̟ᵝ s ɨᵝ i
ばくだい	b a̠ k ɯ̟ᵝ d a̠ i
ばくち	b a̠ k ɯ̟̊ᵝ t͡ɕ i
ばくちく	b a̠ k ɯ̟ᵝ t͡ɕ i̥ k ɯ̟ᵝ
ばくは	b a̠ k ɯ̟̊ᵝ ɰᵝ a̠
ばくはつおん	b a̠ k ɯ̟ᵝ h a̠ t͡s ɨᵝ õ̞ ɴ
ばくめいき	b a̠ k ɯ̟ᵝ m e̞ː kʲ i
ばくろ	b a̠ k ɯ̟ᵝ ɾ o̞
ばぐ	b a̠ ɡ ɯ̟ᵝ
ばけのかわ	b a̠ k e̞ n o̞ k a̠ ɰᵝ a̠
ばける	b a̠ k e̞ ɾ ɯ̟ᵝ
ばけん	b a̠ k ẽ̞ ɴ
ばしょ	b a̠ ɕ o̞
ばせい	b a̠ s e̞ː
ばたんきゅう	b a̠ t ã̠ ŋʲ kʲ ɨᵝː
ばっか	b a̠ k̚ k a̠
ばっさり	b a̠ sː a̠ ɾʲ i
ばっすい	b a̠ sː ɯ̟ᵝ i
ばっする	b a̠ sː ɯ̟ᵝ ɾ ɯ̟ᵝ
ばっちり	b a̠ t̚ t͡ɕ i ɾʲ i
ばつぐん	b a̠ t͡s ɨᵝ ɡ ɯ̟̃ᵝ ɴ
ばとうかんのん	b a̠ t o̞ː k ã̠ nː õ̞ ɴ
ばにゅう	b a̠ ɲ̟ ɯ̟ᵝː
ばね	b a̠ n e̞
ばば	b a̠ b a̠
ばふだ	b a̠ ɸ ɯ̟ᵝ d a̠
ばめん	b a̠ m ẽ̞ ɴ
ばらす	b a̠ ɾ a̠ s ɨᵝ
ばらにく	b a̠ ɾ a̠ ɲ̟ i k ɯ̟ᵝ
ばらばら	b a̠ ɾ a̠ b a̠ ɾ a̠
ばらまく	b a̠ ɾ a̠ m a̠ k ɯ̟ᵝ
ばりき	b a̠ ɾʲ i kʲ i
ばれん	b a̠ ɾ ẽ̞ ɴ
ばん	b ã̠ ɴ
ばんかじゅ	b ã̠ ŋ k a̠ ʑ ɨᵝ
ばんぐみ	b ã̠ ŋ ɡ ɯ̟ᵝ mʲ i
ばんこうば	b ã̠ ŋ k o̞ː b a̠
ばんこく	b ã̠ ŋ k o̞ k ɯ̟ᵝ
ばんごう	b ã̠ ŋ ɡ o̞ː
ばんちょう	b ã̠ ɲ̟ t͡ɕ o̞ː
ばんねん	b ã̠ nː ẽ̞ ɴ
ばんぶつ	b ã̠ m b ɯ̟ᵝ t͡s ɨᵝ
ばんぺいゆ	b ã̠ m p e̞ː j ɯ̟ᵝ
ばんめ	b ã̠ mː e̞
ぱくり	p a̠ k ɯ̟ᵝ ɾʲ i
ぱらぱら	p a̠ ɾ a̠ p a̠ ɾ a̠
ひあがる	ç i a̠ ɡ a̠ ɾ ɯ̟ᵝ
ひいき	ç iː kʲ i
ひうちいし	ç i ɯ̟ᵝ t͡ɕ i i ɕ i
ひうん	ç i ɯ̟̃ᵝ ɴ
ひぇ	ç e̞
ひえきる	ç i e̞ kʲ i ɾ ɯ̟ᵝ
ひかえめ	ç i k a̠ e̞ m e̞
ひかがくてき	ç i k a̠ ɡ a̠ k ɯ̟ᵝ t e̞ kʲ i
ひかり	ç i̥ k a̠ ɾʲ i
ひかる	ç i k a̠ ɾ ɯ̟ᵝ
ひかれる	ç i k a̠ ɾ e̞ ɾ ɯ̟ᵝ
ひがし	ç i ɡ a̠ ɕ i
ひがしがわ	ç i ɡ a̠ ɕ i ɡ a̠ ɰᵝ a̠
ひがんばな	ç i ɡ ã̠ m b a̠ n a̠
ひき	ç i kʲ i
ひきあげる	ç i̥ kʲ i a̠ ɡ e̞ ɾ ɯ̟ᵝ
ひきいる	ç i kʲ i i ɾ ɯ̟ᵝ
ひきおこす	ç i kʲ i o̞ k o̞ s ɨᵝ
ひきこなす	ç i kʲ i k o̞ n a̠ s ɨᵝ
ひきこもごも	ç i kʲ i k o̞ m o̞ ɡ o̞ m o̞
ひきさく	ç i kʲ i s a̠ k ɯ̟ᵝ
ひきざん	ç i̥ kʲ i z ã̠ ɴ
ひきずる	ç i kʲ i z ɨᵝ ɾ ɯ̟ᵝ
ひきたてる	ç i kʲ i t a̠ t e̞ ɾ ɯ̟ᵝ
ひきだす	ç i kʲ i d a̠ s ɨᵝ
ひきつけ	ç i kʲ i t͡s ɨᵝ k e̞
ひきつける	ç i kʲ i t͡s ɨᵝ k e̞ ɾ ɯ̟ᵝ
ひきゅう	ç i kʲ ɨᵝː
ひきょう	ç i kʲ o̞ː
ひぎつね	ç i ɡʲ i t͡s ɨᵝ n e̞
ひくい	ç i k ɯ̟ᵝ i
ひくいどり	ç i̥ k ɯ̟ᵝ i d o̞ ɾʲ i
ひぐま	ç i ɡ ɯ̟ᵝ m a̠
ひぐらし	ç i ɡ ɯ̟ᵝ ɾ a̠ ɕ i
ひけんしゃ	ç i k ẽ̞ ɰ̃ ɕ a̠
ひげんじつてき	ç i ɡ ẽ̞ ɲ̟ d͡ʑ i t͡s ɨᵝ t e̞ kʲ i
ひげんすう	ç i ɡ ẽ̞ ɰ̃ s ɨᵝː
ひこ	ç i k o̞
ひこうき	ç i̥ k o̞ː kʲ i
ひこうしん	ç i k o̞ː ɕ ĩ ɴ
ひこうせん	ç i̥ k o̞ː s ẽ̞ ɴ
ひこく	ç i k o̞ k ɯ̟ᵝ
ひこぼし	ç i̥ k o̞ b o̞ ɕ i
ひご	ç i ɡ o̞
ひさいしゃ	ç i s a̠ i ɕ a̠
ひさく	ç i s a̠ k ɯ̟ᵝ
ひさびさ	ç i s a̠ bʲ i s a̠
ひざ	ç i z a̠
ひざがしら	ç i z a̠ ɡ a̠ ɕ i ɾ a̠
ひざのさら	ç i z a̠ n o̞ s a̠ ɾ a̠
ひざまずく	ç i z a̠ m a̠ z ɨᵝ k ɯ̟ᵝ
ひし	ç i ɕ i
ひしゃかいしんど	ç i̥ ɕ a̠ k a̠ i ɕ ĩ n d o̞
ひじ	ç i ʑ i
ひじょうかいだん	ç i ʑ o̞ː k a̠ i d ã̠ ɴ
ひじょうすう	ç i ʑ o̞ː s ɨᵝː
ひそか	ç i s o̞ k a̠
ひそひそ	ç i s o̞ ç i s o̞
ひそむ	ç i s o̞ m ɯ̟ᵝ
ひそめる	ç i s o̞ m e̞ ɾ ɯ̟ᵝ
ひたす	ç i t a̠ s ɨᵝ
ひたむき	ç i t a̠ m ɯ̟ᵝ kʲ i
ひたる	ç i̥ t a̠ ɾ ɯ̟ᵝ
ひたん	ç i t ã̠ ɴ
ひだ	ç i d a̠
ひだき	ç i d a̠ kʲ i
ひだち	ç i d a̠ t͡ɕ i
ひちょう	ç i t͡ɕ o̞ː
ひっかえす	ç i k̚ k a̠ e̞ s ɨᵝ
ひっかく	ç i k̚ k a̠ k ɯ̟ᵝ
ひっくりかえる	ç i k̚ k ɯ̟ᵝ ɾʲ i k a̠ e̞ ɾ ɯ̟ᵝ
ひっくるめる	ç i k̚ k ɯ̟ᵝ ɾ ɯ̟ᵝ m e̞ ɾ ɯ̟ᵝ
ひっこむ	ç i k̚ k o̞ m ɯ̟ᵝ
ひっさつ	ç i̥ sː a̠ t͡s ɨᵝ
ひっし	ç i ɕː i
ひっしゃ	ç i ɕː a̠
ひっそり	ç i sː o̞ ɾʲ i
ひっぱる	ç i p̚ p a̠ ɾ ɯ̟ᵝ
ひつ	ç i t͡s ɨᵝ
ひつぎ	ç i t͡s ɨᵝ ɡʲ i
ひつじかい	ç i t͡s ɨᵝ ʑ i k a̠ i
ひつぜんせい	ç i t͡s ɨᵝ z ẽ̞ ɰ̃ s e̞ː
ひつよう	ç i t͡s ɨᵝ j o̞ː
ひづめ	ç i z ɨᵝ m e̞
ひていてき	ç i t e̞ː t e̞ kʲ i
ひでし	ç i d e̞ ɕ i
ひでたか	ç i d e̞ t a̠ k a̠
ひでみつ	ç i d e̞ mʲ i t͡s ɨᵝ
ひでり	ç i d e̞ ɾʲ i
ひでん	ç i d ẽ̞ ɴ
ひときれ	ç i t o̞ kʲ i ɾ e̞
ひとさしゆび	ç i̥ t o̞ s a̠ ɕ i j ɯ̟ᵝ bʲ i
ひとざと	ç i t o̞ z a̠ t o̞
ひとすじなわではいかぬ	ç i t o̞ s ɨᵝ ʑ i n a̠ ɰᵝ a̠ d e̞ ɰᵝ a̠ i k a̠ n ɯ̟ᵝ
ひとそろい	ç i̥ t o̞ s o̞ ɾ o̞ i
ひとたち	ç i̥ t o̞ t a̠ t͡ɕ i
ひとづて	ç i t o̞ z ɨᵝ t e̞
ひととなり	ç i t o̞ t o̞ n a̠ ɾʲ i
ひとなか	ç i t o̞ n a̠ k a̠
ひとばしら	ç i t o̞ b a̠ ɕ i ɾ a̠
ひとばんじゅう	ç i t o̞ b ã̠ ɲ̟ d͡ʑ ɨᵝː
ひとびと	ç i t o̞ bʲ i t o̞
ひとまえ	ç i t o̞ m a̠ e̞
ひとめ	ç i t o̞ m e̞
ひともどき	ç i t o̞ m o̞ d o̞ kʲ i
ひとり	ç i̥ t o̞ ɾʲ i
ひとりひとり	ç i t o̞ ɾʲ i ç i t o̞ ɾʲ i
ひどい	ç i d o̞ i
ひどう	ç i d o̞ː
ひな	ç i n a̠
ひなた	ç i n a̠ t a̠
ひねる	ç i n e̞ ɾ ɯ̟ᵝ
ひので	ç i n o̞ d e̞
ひばく	ç i b a̠ k ɯ̟ᵝ
ひばち	ç i b a̠ t͡ɕ i
ひひ	ç i̥ ç i
ひび	ç i bʲ i
ひふえん	ç i̥ ɸ ɯ̟ᵝ ẽ̞ ɴ
ひふびょう	ç i ɸ ɯ̟ᵝ bʲ o̞ː
ひへい	ç i h e̞ː
ひぼう	ç i b o̞ː
ひまつぶし	ç i m a̠ t͡s ɨᵝ b ɯ̟ᵝ ɕ i
ひまん	ç i m ã̠ ɴ
ひみつけいさつ	ç i mʲ i t͡s ɨᵝ k e̞ː s a̠ t͡s ɨᵝ
ひめいをあげる	ç i m e̞ː o̞ a̠ ɡ e̞ ɾ ɯ̟ᵝ
ひめはじめ	ç i m e̞ h a̠ ʑ i m e̞
ひめる	ç i m e̞ ɾ ɯ̟ᵝ
ひめん	ç i m ẽ̞ ɴ
ひも	ç i m o̞
ひもの	ç i m o̞ n o̞
ひゃく	ç a̠ k ɯ̟ᵝ
ひゃくえんきんいつ	ç a̠ k ɯ̟ᵝ ẽ̞ ŋʲ kʲ ĩ ɰ̃ i t͡s ɨᵝ
ひゃくじゅう	ç a̠ k ɯ̟ᵝ ʑ ɨᵝː
ひゃくせん	ç a̠ k ɯ̟ᵝ s ẽ̞ ɴ
ひゃくにちぜき	ç a̠ k ɯ̟ᵝ ɲ̟ i t͡ɕ i z e̞ kʲ i
ひゃくにんいっしゅ	ç a̠ k ɯ̟ᵝ ɲ̟ ĩ ɰ̃ i ɕː ɯ̟ᵝ
ひゃくぶんりつ	ç a̠ k ɯ̟ᵝ b ɯ̟̃ᵝ n ɾʲ i t͡s ɨᵝ
ひゃくまん	ç a̠ k ɯ̟ᵝ m ã̠ ɴ
ひゃっかせい	ç a̠ k̚ k a̠ s e̞ː
ひゃっぱつひゃくちゅう	ç a̠ p̚ p a̠ t͡s ɨᵝ ç a̠ k ɯ̟ᵝ t͡ɕ ɨᵝː
ひやかし	ç i j a̠ k a̠ ɕ i
ひやかす	ç i j a̠ k a̠ s ɨᵝ
ひやす	ç i j a̠ s ɨᵝ
ひややっこ	ç i j a̠ j a̠ k̚ k o̞
ひゅ	ç ɨᵝ
ひゅうがのくに	ç ɨᵝː ɡ a̠ n o̞ k ɯ̟ᵝ ɲ̟ i
ひゆ	ç i j ɯ̟ᵝ
ひょう	ç o̞ː
ひょういつ	ç o̞ː i t͡s ɨᵝ
ひょうか	ç o̞ː k a̠
ひょうかい	ç o̞ː k a̠ i
ひょうかく	ç o̞ː k a̠ k ɯ̟ᵝ
ひょうがいじ	ç o̞ː ɡ a̠ i ʑ i
ひょうぎかい	ç o̞ː ɡʲ i k a̠ i
ひょうご	ç o̞ː ɡ o̞
ひょうごけん	ç o̞ː ɡ o̞ k ẽ̞ ɴ
ひょうざん	ç o̞ː z ã̠ ɴ
ひょうじゅん	ç o̞ː ʑ ɨ̃ᵝ ɴ
ひょうじゅんしゅつりょく	ç o̞ː ʑ ɨ̃ᵝ ɰ̃ ɕ ɨᵝ t͡s ɨᵝ ɾʲ o̞ k ɯ̟ᵝ
ひょうじゅんじ	ç o̞ː ʑ ɨ̃ᵝ ɲ̟ d͡ʑ i
ひょうじゅんにゅうりょく	ç o̞ː ʑ ɨ̃ᵝ ɲ̟ ɲ̟ ɯ̟ᵝː ɾʲ o̞ k ɯ̟ᵝ
ひょうする	ç o̞ː s ɨᵝ ɾ ɯ̟ᵝ
ひょうちょう	ç o̞ː t͡ɕ o̞ː
ひょうてん	ç o̞ː t ẽ̞ ɴ
ひょうばん	ç o̞ː b ã̠ ɴ
ひよけ	ç i j o̞ k e̞
ひよめき	ç i j o̞ m e̞ kʲ i
ひよわ	ç i j o̞ ɰᵝ a̠
ひよわい	ç i j o̞ ɰᵝ a̠ i
ひら	ç i ɾ a̠
ひらいしん	ç i ɾ a̠ i ɕ ĩ ɴ
ひらおよぎ	ç i ɾ a̠ o̞ j o̞ ɡʲ i
ひらがな	ç i ɾ a̠ ɡ a̠ n a̠
ひらた	ç i ɾ a̠ t a̠
ひらま	ç i ɾ a̠ m a̠
ひらめき	ç i ɾ a̠ m e̞ kʲ i
ひらめく	ç i ɾ a̠ m e̞ k ɯ̟ᵝ
ひりき	ç i ɾʲ i kʲ i
ひりゅうず	ç i ɾʲ ɨᵝː z ɨᵝ
ひる	ç i ɾ ɯ̟ᵝ
ひるがえす	ç i ɾ ɯ̟ᵝ ɡ a̠ e̞ s ɨᵝ
ひるがえる	ç i ɾ ɯ̟ᵝ ɡ a̠ e̞ ɾ ɯ̟ᵝ
ひるごはん	ç i ɾ ɯ̟ᵝ ɡ o̞ h ã̠ ɴ
ひるま	ç i ɾ ɯ̟ᵝ m a̠
ひるむ	ç i ɾ ɯ̟ᵝ m ɯ̟ᵝ
ひるめし	ç i ɾ ɯ̟ᵝ m e̞ ɕ i
ひるやすみ	ç i ɾ ɯ̟ᵝ j a̠ s ɨᵝ mʲ i
ひれふす	ç i ɾ e̞ ɸ ɯ̟̊ᵝ s ɨᵝ
ひろいあげる	ç i ɾ o̞ i a̠ ɡ e̞ ɾ ɯ̟ᵝ
ひろお	ç i ɾ o̞ː
ひろがる	ç i ɾ o̞ ɡ a̠ ɾ ɯ̟ᵝ
ひろき	ç i ɾ o̞ kʲ i
ひろげる	ç i ɾ o̞ ɡ e̞ ɾ ɯ̟ᵝ
ひろし	ç i ɾ o̞ ɕ i
ひろしま	ç i ɾ o̞ ɕ i m a̠
ひろふみ	ç i ɾ o̞ ɸ ɯ̟ᵝ mʲ i
ひろみ	ç i ɾ o̞ mʲ i
ひろみつ	ç i ɾ o̞ mʲ i t͡s ɨᵝ
ひろめる	ç i ɾ o̞ m e̞ ɾ ɯ̟ᵝ
ひろやま	ç i ɾ o̞ j a̠ m a̠
ひろゆき	ç i ɾ o̞ j ɯ̟ᵝ kʲ i
ひんこく	ç ĩ ŋ k o̞ k ɯ̟ᵝ
ひんこんしゃ	ç ĩ ŋ k õ̞ ɰ̃ ɕ a̠
ひんし	ç ĩ ɰ̃ ɕ i
ひんせん	ç ĩ ɰ̃ s ẽ̞ ɴ
ひんだい	ç ĩ n d a̠ i
ひんぱん	ç ĩ m p ã̠ ɴ
ひんぷ	ç ĩ m p ɯ̟ᵝ
ひんやり	ç ĩ ɰ̃ j a̠ ɾʲ i
びいしき	bʲ iː ɕ i kʲ i
びぇ	bʲ e̞
びおん	bʲ i õ̞ ɴ
びき	bʲ i kʲ i
びく	bʲ i k ɯ̟ᵝ
びくに	bʲ i k ɯ̟ᵝ ɲ̟ i
びこう	bʲ i k o̞ː
びざい	bʲ i z a̠ i
びしゃもんてん	bʲ i ɕ a̠ m õ̞ n t ẽ̞ ɴ
びしょく	bʲ i ɕ o̞ k ɯ̟ᵝ
びしょぬれ	bʲ i ɕ o̞ n ɯ̟ᵝ ɾ e̞
びしょびしょ	bʲ i ɕ o̞ bʲ i ɕ o̞
びじゃく	bʲ i ʑ a̠ k ɯ̟ᵝ
びじゅつ	bʲ i ʑ ɨᵝ t͡s ɨᵝ
びじん	bʲ i ʑ ĩ ɴ
びせい	bʲ i s e̞ː
びちく	bʲ i t͡ɕ i k ɯ̟ᵝ
びっくり	bʲ i k̚ k ɯ̟ᵝ ɾʲ i
びっしゅ	bʲ i ɕː ɯ̟ᵝ
びでん	bʲ i d ẽ̞ ɴ
びみ	bʲ i mʲ i
びもく	bʲ i m o̞ k ɯ̟ᵝ
びゃ	bʲ a̠
びゃくし	bʲ a̠ k ɯ̟ᵝ ɕ i
びゃくだんゆ	bʲ a̠ k ɯ̟ᵝ d ã̠ ɰ̃ j ɯ̟ᵝ
びゃくろく	bʲ a̠ k ɯ̟ᵝ ɾ o̞ k ɯ̟ᵝ
びゅ	bʲ ɨᵝ
びょう	bʲ o̞ː
びょうき	bʲ o̞ː kʲ i
びょうげんたい	bʲ o̞ː ɡ ẽ̞ n t a̠ i
びょうしょう	bʲ o̞ː ɕ o̞ː
びょうじ	bʲ o̞ː ʑ i
びょうどう	bʲ o̞ː d o̞ː
びょうどうしゅぎ	bʲ o̞ː d o̞ː ɕ ɨᵝ ɡʲ i
びょうぶ	bʲ o̞ː b ɯ̟ᵝ
びょうへん	bʲ o̞ː h ẽ̞ ɴ
びょうめい	bʲ o̞ː m e̞ː
びょうりがく	bʲ o̞ː ɾʲ i ɡ a̠ k ɯ̟ᵝ
びよう	bʲ i j o̞ː
びよく	bʲ i j o̞ k ɯ̟ᵝ
びわ	bʲ i ɰᵝ a̠
びん	bʲ ĩ ɴ
びんかん	bʲ ĩ ŋ k ã̠ ɴ
びんざさら	bʲ ĩ n d͡z a̠ s a̠ ɾ a̠
びんせん	bʲ ĩ ɰ̃ s ẽ̞ ɴ
びんなんご	bʲ ĩ nː ã̠ ŋ ɡ o̞
ぴぇ	pʲ e̞
ぴえん	pʲ i ẽ̞ ɴ
ぴかぴか	pʲ i k a̠ pʲ i k a̠
ぴたり	pʲ i t a̠ ɾʲ i
ぴゅ	pʲ ɨᵝ
ぴんと	pʲ ĩ n t o̞
ふい	ɸ ɯ̟ᵝ i
ふいご	ɸ ɯ̟ᵝ i ɡ o̞
ふいちょう	ɸ ɯ̟ᵝ i t͡ɕ o̞ː
ふうか	ɸ ɯ̟ᵝː k a̠
ふうき	ɸ ɯ̟ᵝː kʲ i
ふうきん	ɸ ɯ̟ᵝː kʲ ĩ ɴ
ふうじて	ɸ ɯ̟ᵝː ʑ i t e̞
ふうじん	ɸ ɯ̟ᵝː ʑ ĩ ɴ
ふうすい	ɸ ɯ̟ᵝː s ɨᵝ i
ふうせんかずら	ɸ ɯ̟ᵝː s ẽ̞ ŋ k a̠ z ɨᵝ ɾ a̠
ふうそくけい	ɸ ɯ̟ᵝː s o̞ k ɯ̟ᵝ k e̞ː
ふうぞく	ɸ ɯ̟ᵝː z o̞ k ɯ̟ᵝ
ふうど	ɸ ɯ̟ᵝː d o̞
ふうひょう	ɸ ɯ̟ᵝː ç o̞ː
ふうぶん	ɸ ɯ̟ᵝː b ɯ̟̃ᵝ ɴ
ふうりょく	ɸ ɯ̟ᵝː ɾʲ o̞ k ɯ̟ᵝ
ふうりん	ɸ ɯ̟ᵝː ɾʲ ĩ ɴ
ふうろう	ɸ ɯ̟ᵝː ɾ o̞ː
ふえ	ɸ ɯ̟ᵝ e̞
ふえふき	ɸ ɯ̟ᵝ e̞ ɸ ɯ̟ᵝ kʲ i
ふえる	ɸ ɯ̟ᵝ e̞ ɾ ɯ̟ᵝ
ふえん	ɸ ɯ̟ᵝ ẽ̞ ɴ
ふぉ	ɸ o̞
ふか	ɸ ɯ̟ᵝ k a̠
ふかい	ɸ ɯ̟ᵝ k a̠ i
ふかいおん	ɸ ɯ̟ᵝ k a̠ i õ̞ ɴ
ふかかい	ɸ ɯ̟ᵝ k a̠ k a̠ i
ふかかちぜい	ɸ ɯ̟̊ᵝ k a̠ k a̠ t͡ɕ i z e̞ː
ふかす	ɸ ɯ̟ᵝ k a̠ s ɨᵝ
ふかのう	ɸ ɯ̟ᵝ k a̠ n o̞ː
ふかひ	ɸ ɯ̟ᵝ k a̠ ç i
ふかよみ	ɸ ɯ̟ᵝ k a̠ j o̞ mʲ i
ふがふが	ɸ ɯ̟ᵝ ɡ a̠ ɸ ɯ̟ᵝ ɡ a̠
ふきそくぎんが	ɸ ɯ̟ᵝ kʲ i s o̞ k ɯ̟ᵝ ɡʲ ĩ ŋ ɡ a̠
ふきだし	ɸ ɯ̟ᵝ kʲ i d a̠ ɕ i
ふきつ	ɸ ɯ̟ᵝ kʲ i t͡s ɨᵝ
ふきならす	ɸ ɯ̟ᵝ kʲ i n a̠ ɾ a̠ s ɨᵝ
ふきや	ɸ ɯ̟ᵝ kʲ i j a̠
ふくい	ɸ ɯ̟ᵝ k ɯ̟ᵝ i
ふくいん	ɸ ɯ̟ᵝ k ɯ̟ᵝ ĩ ɴ
ふくうじょうじゅにょらい	ɸ ɯ̟ᵝ k ɯ̟ᵝː ʑ o̞ː ʑ ɨᵝ ɲ̟ o̞ ɾ a̠ i
ふくおかけん	ɸ ɯ̟ᵝ k ɯ̟ᵝ o̞ k a̠ k ẽ̞ ɴ
ふくぎょう	ɸ ɯ̟ᵝ k ɯ̟ᵝ ɡʲ o̞ː
ふくごう	ɸ ɯ̟̊ᵝ k ɯ̟ᵝ ɡ o̞ː
ふくさんぶつ	ɸ ɯ̟ᵝ k ɯ̟ᵝ s ã̠ m b ɯ̟ᵝ t͡s ɨᵝ
ふくしゅう	ɸ ɯ̟ᵝ k ɯ̟̊ᵝ ɕ ɨᵝː
ふくじてき	ɸ ɯ̟ᵝ k ɯ̟ᵝ ʑ i t e̞ kʲ i
ふくじん	ɸ ɯ̟̊ᵝ k ɯ̟ᵝ ʑ ĩ ɴ
ふくそう	ɸ ɯ̟ᵝ k ɯ̟ᵝ s o̞ː
ふくふくし	ɸ ɯ̟ᵝ k ɯ̟ᵝ ɸ ɯ̟ᵝ k ɯ̟ᵝ ɕ i
ふくぶくろ	ɸ ɯ̟ᵝ k ɯ̟ᵝ b ɯ̟ᵝ k ɯ̟ᵝ ɾ o̞
ふくむ	ɸ ɯ̟ᵝ k ɯ̟ᵝ m ɯ̟ᵝ
ふくらむ	ɸ ɯ̟ᵝ k ɯ̟ᵝ ɾ a̠ m ɯ̟ᵝ
ふくれあがる	ɸ ɯ̟̊ᵝ k ɯ̟ᵝ ɾ e̞ a̠ ɡ a̠ ɾ ɯ̟ᵝ
ふくれる	ɸ ɯ̟ᵝ k ɯ̟ᵝ ɾ e̞ ɾ ɯ̟ᵝ
ふくろう	ɸ ɯ̟̊ᵝ k ɯ̟ᵝ ɾ o̞ː
ふくろおおかみ	ɸ ɯ̟̊ᵝ k ɯ̟ᵝ ɾ o̞ o̞ː k a̠ mʲ i
ふくろぐま	ɸ ɯ̟̊ᵝ k ɯ̟ᵝ ɾ o̞ ɡ ɯ̟ᵝ m a̠
ふぐ	ɸ ɯ̟ᵝ ɡ ɯ̟ᵝ
ふぐり	ɸ ɯ̟ᵝ ɡ ɯ̟ᵝ ɾʲ i
ふけ	ɸ ɯ̟ᵝ k e̞
ふけい	ɸ ɯ̟ᵝ k e̞ː
ふけしゅう	ɸ ɯ̟ᵝ k e̞ ɕ ɨᵝː
ふけつ	ɸ ɯ̟ᵝ k e̞ t͡s ɨᵝ
ふける	ɸ ɯ̟ᵝ k e̞ ɾ ɯ̟ᵝ
ふこく	ɸ ɯ̟ᵝ k o̞ k ɯ̟ᵝ
ふごう	ɸ ɯ̟ᵝ ɡ o̞ː
ふさい	ɸ ɯ̟ᵝ s a̠ i
ふさがる	ɸ ɯ̟ᵝ s a̠ ɡ a̠ ɾ ɯ̟ᵝ
ふさぐ	ɸ ɯ̟ᵝ s a̠ ɡ ɯ̟ᵝ
ふさわしい	ɸ ɯ̟ᵝ s a̠ ɰᵝ a̠ ɕ iː
ふざける	ɸ ɯ̟ᵝ z a̠ k e̞ ɾ ɯ̟ᵝ
ふしぎ	ɸ ɯ̟̊ᵝ ɕ i ɡʲ i
ふしぜん	ɸ ɯ̟ᵝ ɕ i z ẽ̞ ɴ
ふしゃ	ɸ ɯ̟ᵝ ɕ a̠
ふしょう	ɸ ɯ̟ᵝ ɕ o̞ː
ふしんじん	ɸ ɯ̟ᵝ ɕ ĩ ɲ̟ d͡ʑ ĩ ɴ
ふじ	ɸ ɯ̟ᵝ ʑ i
ふじいろ	ɸ ɯ̟ᵝ ʑ iː ɾ o̞
ふじさん	ɸ ɯ̟ᵝ ʑ i s ã̠ ɴ
ふじとう	ɸ ɯ̟ᵝ ʑ i t o̞ː
ふじばかま	ɸ ɯ̟ᵝ ʑ i b a̠ k a̠ m a̠
ふじみ	ɸ ɯ̟ᵝ ʑ i mʲ i
ふじゅん	ɸ ɯ̟ᵝ ʑ ɨ̃ᵝ ɴ
ふじゆう	ɸ ɯ̟ᵝ ʑ i j ɯ̟ᵝː
ふじょ	ɸ ɯ̟ᵝ ʑ o̞
ふじょし	ɸ ɯ̟ᵝ ʑ o̞ ɕ i
ふじん	ɸ ɯ̟ᵝ ʑ ĩ ɴ
ふせい	ɸ ɯ̟ᵝ s e̞ː
ふせぐ	ɸ ɯ̟̊ᵝ s e̞ ɡ ɯ̟ᵝ
ふせん	ɸ ɯ̟ᵝ s ẽ̞ ɴ
ふそうおう	ɸ ɯ̟ᵝ s o̞ː o̞ː
ふそん	ɸ ɯ̟ᵝ s õ̞ ɴ
ふた	ɸ ɯ̟ᵝ t a̠
ふたござ	ɸ ɯ̟ᵝ t a̠ ɡ o̞ z a̠
ふたしか	ɸ ɯ̟ᵝ t a̠ ɕ i k a̠
ふたたび	ɸ ɯ̟ᵝ t a̠ t a̠ bʲ i
ふたまた	ɸ ɯ̟ᵝ t a̠ m a̠ t a̠
ふたり	ɸ ɯ̟ᵝ t a̠ ɾʲ i
ふだん	ɸ ɯ̟ᵝ d ã̠ ɴ
ふだんそう	ɸ ɯ̟ᵝ d ã̠ ɰ̃ s o̞ː
ふち	ɸ ɯ̟ᵝ t͡ɕ i
ふちいし	ɸ ɯ̟ᵝ t͡ɕ i i ɕ i
ふっかつ	ɸ ɯ̟̊ᵝ k̚ k a̠ t͡s ɨᵝ
ふっきれる	ɸ ɯ̟ᵝ k̚ʲ kʲ i ɾ e̞ ɾ ɯ̟ᵝ
ふっくら	ɸ ɯ̟ᵝ k̚ k ɯ̟ᵝ ɾ a̠
ふつ	ɸ ɯ̟ᵝ t͡s ɨᵝ
ふつか	ɸ ɯ̟ᵝ t͡s ɨᵝ k a̠
ふとい	ɸ ɯ̟ᵝ t o̞ i
ふとう	ɸ ɯ̟ᵝ t o̞ː
ふとうえき	ɸ ɯ̟̊ᵝ t o̞ː e̞ kʲ i
ふとん	ɸ ɯ̟ᵝ t õ̞ ɴ
ふなかせつ	ɸ ɯ̟ᵝ n a̠ k a̠ s e̞ t͡s ɨᵝ
ふなくいむし	ɸ ɯ̟ᵝ n a̠ k ɯ̟ᵝ i m ɯ̟ᵝ ɕ i
ふなよい	ɸ ɯ̟ᵝ n a̠ j o̞ i
ふね	ɸ ɯ̟ᵝ n e̞
ふのかんじょう	ɸ ɯ̟ᵝ n o̞ k ã̠ ɲ̟ d͡ʑ o̞ː
ふはい	ɸ ɯ̟ᵝ h a̠ i
ふはつ	ɸ ɯ̟ᵝ h a̠ t͡s ɨᵝ
ふひょう	ɸ ɯ̟ᵝ ç o̞ː
ふびん	ɸ ɯ̟ᵝ bʲ ĩ ɴ
ふほう	ɸ ɯ̟ᵝ h o̞ː
ふほうにゅうこくしゃ	ɸ ɯ̟ᵝ h o̞ː ɲ̟ ɯ̟ᵝː k o̞ k ɯ̟ᵝ ɕ a̠
ふまえる	ɸ ɯ̟ᵝ m a̠ e̞ ɾ ɯ̟ᵝ
ふまんぞく	ɸ ɯ̟ᵝ m ã̠ n d͡z o̞ k ɯ̟ᵝ
ふみきり	ɸ ɯ̟ᵝ mʲ i kʲ i ɾʲ i
ふみつける	ɸ ɯ̟ᵝ mʲ i t͡s ɨᵝ k e̞ ɾ ɯ̟ᵝ
ふみづき	ɸ ɯ̟ᵝ mʲ i z ɨᵝ kʲ i
ふむ	ɸ ɯ̟ᵝ m ɯ̟ᵝ
ふめい	ɸ ɯ̟ᵝ m e̞ː
ふめいかく	ɸ ɯ̟ᵝ m e̞ː k a̠ k ɯ̟ᵝ
ふもと	ɸ ɯ̟ᵝ m o̞ t o̞
ふやす	ɸ ɯ̟ᵝ j a̠ s ɨᵝ
ふゆう	ɸ ɯ̟ᵝ j ɯ̟ᵝː
ふゆきとどき	ɸ ɯ̟ᵝ j ɯ̟ᵝ kʲ i t o̞ d o̞ kʲ i
ふゆぞら	ɸ ɯ̟ᵝ j ɯ̟ᵝ z o̞ ɾ a̠
ふゆふく	ɸ ɯ̟ᵝ j ɯ̟ᵝ ɸ ɯ̟ᵝ k ɯ̟ᵝ
ふよ	ɸ ɯ̟ᵝ j o̞
ふようしゃ	ɸ ɯ̟ᵝ j o̞ː ɕ a̠
ふようりょう	ɸ ɯ̟ᵝ j o̞ː ɾʲ o̞ː
ふらふら	ɸ ɯ̟ᵝ ɾ a̠ ɸ ɯ̟ᵝ ɾ a̠
ふらん	ɸ ɯ̟ᵝ ɾ ã̠ ɴ
ふらんき	ɸ ɯ̟ᵝ ɾ ã̠ ŋʲ kʲ i
ふり	ɸ ɯ̟ᵝ ɾʲ i
ふりかえる	ɸ ɯ̟ᵝ ɾʲ i k a̠ e̞ ɾ ɯ̟ᵝ
ふりこ	ɸ ɯ̟ᵝ ɾʲ i k o̞
ふりこむ	ɸ ɯ̟ᵝ ɾʲ i k o̞ m ɯ̟ᵝ
ふりしぼる	ɸ ɯ̟ᵝ ɾʲ i ɕ i b o̞ ɾ ɯ̟ᵝ
ふりん	ɸ ɯ̟ᵝ ɾʲ ĩ ɴ
ふる	ɸ ɯ̟ᵝ ɾ ɯ̟ᵝ
ふるい	ɸ ɯ̟ᵝ ɾ ɯ̟ᵝ i
ふるえる	ɸ ɯ̟ᵝ ɾ ɯ̟ᵝ e̞ ɾ ɯ̟ᵝ
ふるきず	ɸ ɯ̟ᵝ ɾ ɯ̟ᵝ kʲ i z ɨᵝ
ふるくさい	ɸ ɯ̟ᵝ ɾ ɯ̟ᵝ k ɯ̟ᵝ s a̠ i
ふるまい	ɸ ɯ̟ᵝ ɾ ɯ̟ᵝ m a̠ i
ふるまう	ɸ ɯ̟ᵝ ɾ ɯ̟ᵝ m a̠ ɯ̟ᵝ
ふるわせる	ɸ ɯ̟ᵝ ɾ ɯ̟ᵝ ɰᵝ a̠ s e̞ ɾ ɯ̟ᵝ
ふれあいどうぶつえん	ɸ ɯ̟ᵝ ɾ e̞ a̠ i d o̞ː b ɯ̟ᵝ t͡s ɨᵝ ẽ̞ ɴ
ふれあう	ɸ ɯ̟ᵝ ɾ e̞ a̠ ɯ̟ᵝ
ふれる	ɸ ɯ̟ᵝ ɾ e̞ ɾ ɯ̟ᵝ
ふろうしゃ	ɸ ɯ̟ᵝ ɾ o̞ː ɕ a̠
ふわ	ɸ ɯ̟ᵝ ɰᵝ a̠
ふわらいどう	ɸ ɯ̟ᵝ ɰᵝ a̠ ɾ a̠ i d o̞ː
ふわり	ɸ ɯ̟ᵝ ɰᵝ a̠ ɾʲ i
ふん	ɸ ɯ̟̃ᵝ ɴ
ふんいき	ɸ ɯ̟̃ᵝ ɰ̃ i kʲ i
ふんか	ɸ ɯ̟̃ᵝ ŋ k a̠
ふんど	ɸ ɯ̟̃ᵝ n d o̞
ふんどう	ɸ ɯ̟̃ᵝ n d o̞ː
ふんぱん	ɸ ɯ̟̃ᵝ m p ã̠ ɴ
ふんぼ	ɸ ɯ̟̃ᵝ m b o̞
ふんまつ	ɸ ɯ̟̃ᵝ mː a̠ t͡s ɨᵝ
ぶあいそう	b ɯ̟ᵝ a̠ i s o̞ː
ぶあつい	b ɯ̟ᵝ a̠ t͡s ɨᵝ i
ぶかつどう	b ɯ̟ᵝ k a̠ t͡s ɨᵝ d o̞ː
ぶかんはいえん	b ɯ̟ᵝ k ã̠ ɰ̃ h a̠ i ẽ̞ ɴ
ぶがいしゃ	b ɯ̟ᵝ ɡ a̠ i ɕ a̠
ぶきょく	b ɯ̟ᵝ kʲ o̞ k ɯ̟ᵝ
ぶさいく	b ɯ̟ᵝ s a̠ i k ɯ̟ᵝ
ぶじそくさい	b ɯ̟ᵝ ʑ i s o̞ k ɯ̟ᵝ s a̠ i
ぶす	b ɯ̟ᵝ s ɨᵝ
ぶぜん	b ɯ̟ᵝ z ẽ̞ ɴ
ぶた	b ɯ̟ᵝ t a̠
ぶたぎり	b ɯ̟ᵝ t a̠ ɡʲ i ɾʲ i
ぶちこむ	b ɯ̟ᵝ t͡ɕ i k o̞ m ɯ̟ᵝ
ぶっかけ	b ɯ̟ᵝ k̚ k a̠ k e̞
ぶっかだか	b ɯ̟ᵝ k̚ k a̠ d a̠ k a̠
ぶっきょう	b ɯ̟ᵝ k̚ʲ kʲ o̞ː
ぶっけん	b ɯ̟ᵝ k̚ k ẽ̞ ɴ
ぶっしゅかん	b ɯ̟ᵝ ɕː ɯ̟ᵝ k ã̠ ɴ
ぶっしん	b ɯ̟ᵝ ɕː ĩ ɴ
ぶっせつ	b ɯ̟ᵝ sː e̞ t͡s ɨᵝ
ぶったい	b ɯ̟ᵝ t̚ t a̠ i
ぶったくり	b ɯ̟ᵝ t̚ t a̠ k ɯ̟ᵝ ɾʲ i
ぶっちゃけ	b ɯ̟ᵝ t̚ t͡ɕ a̠ k e̞
ぶつかる	b ɯ̟ᵝ t͡s ɨᵝ k a̠ ɾ ɯ̟ᵝ
ぶつりかがく	b ɯ̟ᵝ t͡s ɨᵝ ɾʲ i k a̠ ɡ a̠ k ɯ̟ᵝ
ぶつりがくしゃ	b ɯ̟ᵝ t͡s ɨᵝ ɾʲ i ɡ a̠ k ɯ̟̊ᵝ ɕ a̠
ぶどう	b ɯ̟ᵝ d o̞ː
ぶどうだん	b ɯ̟ᵝ d o̞ː d ã̠ ɴ
ぶひん	b ɯ̟ᵝ ç ĩ ɴ
ぶぶん	b ɯ̟ᵝ b ɯ̟̃ᵝ ɴ
ぶゆ	b ɯ̟ᵝ j ɯ̟ᵝ
ぶようか	b ɯ̟ᵝ j o̞ː k a̠
ぶらい	b ɯ̟ᵝ ɾ a̠ i
ぶらさがる	b ɯ̟ᵝ ɾ a̠ s a̠ ɡ a̠ ɾ ɯ̟ᵝ
ぶらさげる	b ɯ̟ᵝ ɾ a̠ s a̠ ɡ e̞ ɾ ɯ̟ᵝ
ぶらつく	b ɯ̟ᵝ ɾ a̠ t͡s ɨᵝ k ɯ̟ᵝ
ぶり	b ɯ̟ᵝ ɾʲ i
ぶりっこ	b ɯ̟ᵝ ɾʲ i k̚ k o̞
ぶるぶる	b ɯ̟ᵝ ɾ ɯ̟ᵝ b ɯ̟ᵝ ɾ ɯ̟ᵝ
ぶん	b ɯ̟̃ᵝ ɴ
ぶんおんふごう	b ɯ̟̃ᵝ ɰ̃ õ̞ ɰ̃ ɸ ɯ̟ᵝ ɡ o̞ː
ぶんかけん	b ɯ̟̃ᵝ ŋ k a̠ k ẽ̞ ɴ
ぶんかざい	b ɯ̟̃ᵝ ŋ k a̠ z a̠ i
ぶんかたようせい	b ɯ̟̃ᵝ ŋ k a̠ t a̠ j o̞ː s e̞ː
ぶんかつ	b ɯ̟̃ᵝ ŋ k a̠ t͡s ɨᵝ
ぶんかつばらい	b ɯ̟̃ᵝ ŋ k a̠ t͡s ɨᵝ b a̠ ɾ a̠ i
ぶんこ	b ɯ̟̃ᵝ ŋ k o̞
ぶんこうき	b ɯ̟̃ᵝ ŋ k o̞ː kʲ i
ぶんご	b ɯ̟̃ᵝ ŋ ɡ o̞
ぶんしゅう	b ɯ̟̃ᵝ ɰ̃ ɕ ɨᵝː
ぶんせき	b ɯ̟̃ᵝ ɰ̃ s e̞ kʲ i
ぶんどき	b ɯ̟̃ᵝ n d o̞ kʲ i
ぶんみゃく	b ɯ̟̃ᵝ mʲː a̠ k ɯ̟ᵝ
ぶんめいかいか	b ɯ̟̃ᵝ mː e̞ː k a̠ i k a̠
ぶんり	b ɯ̟̃ᵝ n ɾʲ i
ぷにぷに	p ɯ̟ᵝ ɲ̟ i p ɯ̟ᵝ ɲ̟ i
へいあん	h e̞ː ã̠ ɴ
へいか	h e̞ː k a̠
へいかい	h e̞ː k a̠ i
へいがく	h e̞ː ɡ a̠ k ɯ̟ᵝ
へいこうしんか	h e̞ː k o̞ː ɕ ĩ ŋ k a̠
へいざん	h e̞ː z ã̠ ɴ
へいし	h e̞ː ɕ i
へいしゃ	h e̞ː ɕ a̠
へいじょう	h e̞ː ʑ o̞ː
へいじょうしん	h e̞ː ʑ o̞ː ɕ ĩ ɴ
へいぜん	h e̞ː z ẽ̞ ɴ
へいそう	h e̞ː s o̞ː
へいめん	h e̞ː m ẽ̞ ɴ
へいりつじょし	h e̞ː ɾʲ i t͡s ɨᵝ d͡ʑ o̞ ɕ i
へきち	h e̞ kʲ i t͡ɕ i
へきれき	h e̞ kʲ i ɾ e̞ kʲ i
へそ	h e̞ s o̞
へた	h e̞ t a̠
へたくそ	h e̞ t a̠ k ɯ̟̊ᵝ s o̞
へだて	h e̞ d a̠ t e̞
へちま	h e̞ t͡ɕ i m a̠
へっぽこ	h e̞ p̚ p o̞ k o̞
へのへのもへ	h e̞ n o̞ h e̞ n o̞ m o̞ h e̞
へのへのもへじ	h e̞ n o̞ h e̞ n o̞ m o̞ h e̞ ʑ i
へび	h e̞ bʲ i
へびくいわし	h e̞ bʲ i k ɯ̟ᵝ i ɰᵝ a̠ ɕ i
へや	h e̞ j a̠
へやちゃく	h e̞ j a̠ t͡ɕ a̠ k ɯ̟ᵝ
へり	h e̞ ɾʲ i
へりくだる	h e̞ ɾʲ i k ɯ̟ᵝ d a̠ ɾ ɯ̟ᵝ
へりくつ	h e̞ ɾʲ i k ɯ̟ᵝ t͡s ɨᵝ
へる	h e̞ ɾ ɯ̟ᵝ
へん	h ẽ̞ ɴ
へんきょく	h ẽ̞ ŋʲ kʲ o̞ k ɯ̟ᵝ
へんさい	h ẽ̞ ɰ̃ s a̠ i
へんさん	h ẽ̞ ɰ̃ s ã̠ ɴ
へんざい	h ẽ̞ n d͡z a̠ i
へんしゅう	h ẽ̞ ɰ̃ ɕ ɨᵝː
へんじょう	h ẽ̞ ɲ̟ d͡ʑ o̞ː
へんたい	h ẽ̞ n t a̠ i
へんたいかんぶん	h ẽ̞ n t a̠ i k ã̠ m b ɯ̟̃ᵝ ɴ
へんとうえん	h ẽ̞ n t o̞ː ẽ̞ ɴ
へんとうせん	h ẽ̞ n t o̞ː s ẽ̞ ɴ
へんぼう	h ẽ̞ m b o̞ː
へんめい	h ẽ̞ mː e̞ː
へんりきょうせい	h ẽ̞ n ɾʲ i kʲ o̞ː s e̞ː
べいこく	b e̞ː k o̞ k ɯ̟ᵝ
べいこくでんきでんしがっかい	b e̞ː k o̞ k ɯ̟ᵝ d ẽ̞ ŋʲ kʲ i d ẽ̞ ɰ̃ ɕ i ɡ a̠ k̚ k a̠ i
べき	b e̞ kʲ i
べし	b e̞ ɕ i
べそ	b e̞ s o̞
べっし	b e̞ ɕː i
べっそう	b e̞ sː o̞ː
べっぴん	b e̞ p̚ʲ pʲ ĩ ɴ
べつあか	b e̞ t͡s ɨᵝ a̠ k a̠
べつめい	b e̞ t͡s ɨᵝ m e̞ː
べら	b e̞ ɾ a̠
べらべら	b e̞ ɾ a̠ b e̞ ɾ a̠
べりべり	b e̞ ɾʲ i b e̞ ɾʲ i
べろ	b e̞ ɾ o̞
べんかい	b ẽ̞ ŋ k a̠ i
べんかん	b ẽ̞ ŋ k ã̠ ɴ
べんぎじょう	b ẽ̞ ŋʲ ɡʲ i ʑ o̞ː
べんざ	b ẽ̞ n d͡z a̠
べんしょう	b ẽ̞ ɰ̃ ɕ o̞ː
べんじょ	b ẽ̞ ɲ̟ d͡ʑ o̞
べんとうばこ	b ẽ̞ n t o̞ː b a̠ k o̞
べんぴ	b ẽ̞ m pʲ i
ぺたんすわり	p e̞ t ã̠ ɰ̃ s ɨᵝ ɰᵝ a̠ ɾʲ i
ぺらぺら	p e̞ ɾ a̠ p e̞ ɾ a̠
ほぁ	h ɰᵝ a̠
ほいくえん	h o̞ i k ɯ̟ᵝ ẽ̞ ɴ
ほうい	h o̞ː i
ほういかく	h o̞ː i k a̠ k ɯ̟ᵝ
ほうおうざ	h o̞ː o̞ː z a̠
ほうか	h o̞ː k a̠
ほうが	h o̞ː ɡ a̠
ほうき	h o̞ː kʲ i
ほうきょう	h o̞ː kʲ o̞ː
ほうきょうにん	h o̞ː kʲ o̞ː ɲ̟ ĩ ɴ
ほうぎゅう	h o̞ː ɡʲ ɨᵝː
ほうぎょ	h o̞ː ɡʲ o̞
ほうこ	h o̞ː k o̞
ほうこうせい	h o̞ː k o̞ː s e̞ː
ほうこく	h o̞ː k o̞ k ɯ̟ᵝ
ほうざい	h o̞ː z a̠ i
ほうしゃせん	h o̞ː ɕ a̠ s ẽ̞ ɴ
ほうしゅう	h o̞ː ɕ ɨᵝː
ほうしゅつ	h o̞ː ɕ ɨᵝ t͡s ɨᵝ
ほうしゅつおん	h o̞ː ɕ ɨᵝ t͡s ɨᵝ õ̞ ɴ
ほうしん	h o̞ː ɕ ĩ ɴ
ほうじゅん	h o̞ː ʑ ɨ̃ᵝ ɴ
ほうじょ	h o̞ː ʑ o̞
ほうじょう	h o̞ː ʑ o̞ː
ほうじる	h o̞ː ʑ i ɾ ɯ̟ᵝ
ほうすいほう	h o̞ː s ɨᵝ i h o̞ː
ほうせい	h o̞ː s e̞ː
ほうそう	h o̞ː s o̞ː
ほうだんのえじき	h o̞ː d ã̠ n n o̞ e̞ ʑ i kʲ i
ほうちゅう	h o̞ː t͡ɕ ɨᵝː
ほうちょう	h o̞ː t͡ɕ o̞ː
ほうっておく	h o̞ː t̚ t e̞ o̞ k ɯ̟ᵝ
ほうてい	h o̞ː t e̞ː
ほうでん	h o̞ː d ẽ̞ ɴ
ほうとう	h o̞ː t o̞ː
ほうのう	h o̞ː n o̞ː
ほうひ	h o̞ː ç i
ほうへいきゅう	h o̞ː h e̞ː kʲ ɨᵝː
ほうべん	h o̞ː b ẽ̞ ɴ
ほうまん	h o̞ː m ã̠ ɴ
ほうむだいじん	h o̞ː m ɯ̟ᵝ d a̠ i ʑ ĩ ɴ
ほうむる	h o̞ː m ɯ̟ᵝ ɾ ɯ̟ᵝ
ほうめん	h o̞ː m ẽ̞ ɴ
ほうゆう	h o̞ː j ɯ̟ᵝː
ほうよう	h o̞ː j o̞ː
ほうり	h o̞ː ɾʲ i
ほうりき	h o̞ː ɾʲ i kʲ i
ほうりこむ	h o̞ː ɾʲ i k o̞ m ɯ̟ᵝ
ほうりだす	h o̞ː ɾʲ i d a̠ s ɨᵝ
ほうろうしゃ	h o̞ː ɾ o̞ː ɕ a̠
ほえる	h o̞ e̞ ɾ ɯ̟ᵝ
ほお	h o̞ː
ほおじろ	h o̞ː ʑ i ɾ o̞
ほおじろざめ	h o̞ː ʑ i ɾ o̞ z a̠ m e̞
ほおずき	h o̞ː z ɨᵝ kʲ i
ほおづえ	h o̞ː z ɨᵝ e̞
ほか	h o̞ k a̠
ほかん	h o̞ k ã̠ ɴ
ほくぎ	h o̞ k ɯ̟ᵝ ɡʲ i
ほくしん	h o̞ k ɯ̟ᵝ ɕ ĩ ɴ
ほくしんろん	h o̞ k ɯ̟ᵝ ɕ ĩ n ɾ õ̞ ɴ
ほくだい	h o̞ k ɯ̟ᵝ d a̠ i
ほぐす	h o̞ ɡ ɯ̟ᵝ s ɨᵝ
ほぐれる	h o̞ ɡ ɯ̟ᵝ ɾ e̞ ɾ ɯ̟ᵝ
ほこら	h o̞ k o̞ ɾ a̠
ほこり	h o̞ k o̞ ɾʲ i
ほこる	h o̞ k o̞ ɾ ɯ̟ᵝ
ほごしゃ	h o̞ ɡ o̞ ɕ a̠
ほし	h o̞ ɕ i
ほしい	h o̞ ɕ iː
ほしがき	h o̞ ɕ i ɡ a̠ kʲ i
ほしがる	h o̞ ɕ i ɡ a̠ ɾ ɯ̟ᵝ
ほしざめ	h o̞ ɕ i z a̠ m e̞
ほしゅうこう	h o̞ ɕ ɨᵝː k o̞ː
ほしゅうじゅぎょうこう	h o̞ ɕ ɨᵝː d͡ʑ ɨᵝ ɡʲ o̞ː k o̞ː
ほしょく	h o̞ ɕ o̞ k ɯ̟ᵝ
ほじょどうし	h o̞ ʑ o̞ d o̞ː ɕ i
ほす	h o̞ s ɨᵝ
ほすう	h o̞ s ɨᵝː
ほせい	h o̞ s e̞ː
ほぜい	h o̞ z e̞ː
ほそい	h o̞ s o̞ i
ほたい	h o̞ t a̠ i
ほたる	h o̞ t a̠ ɾ ɯ̟ᵝ
ほっかいどう	h o̞ k̚ k a̠ i d o̞ː
ほっかん	h o̞ k̚ k ã̠ ɴ
ほっきょう	h o̞ k̚ʲ kʲ o̞ː
ほっきょくぎつね	h o̞ k̚ʲ kʲ o̞ k ɯ̟ᵝ ɡʲ i t͡s ɨᵝ n e̞
ほっきょくせい	h o̞ k̚ʲ kʲ o̞ k ɯ̟ᵝ s e̞ː
ほっけ	h o̞ k̚ k e̞
ほっそり	h o̞ sː o̞ ɾʲ i
ほっぴょうよう	h o̞ p̚ʲ pʲ o̞ː j o̞ː
ほっぺ	h o̞ p̚ p e̞
ほつれる	h o̞ t͡s ɨᵝ ɾ e̞ ɾ ɯ̟ᵝ
ほてい	h o̞ t e̞ː
ほてん	h o̞ t ẽ̞ ɴ
ほとけ	h o̞ t o̞ k e̞
ほとぼり	h o̞ t o̞ b o̞ ɾʲ i
ほとんど	h o̞ t õ̞ n d o̞
ほど	h o̞ d o̞
ほねみ	h o̞ n e̞ mʲ i
ほのぼの	h o̞ n o̞ b o̞ n o̞
ほへい	h o̞ h e̞ː
ほほ	h o̞ h o̞
ほほえむ	h o̞ h o̞ e̞ m ɯ̟ᵝ
ほめる	h o̞ m e̞ ɾ ɯ̟ᵝ
ほら	h o̞ ɾ a̠
ほらあな	h o̞ ɾ a̠ː n a̠
ほらがい	h o̞ ɾ a̠ ɡ a̠ i
ほり	h o̞ ɾʲ i
ほる	h o̞ ɾ ɯ̟ᵝ
ほれぼれ	h o̞ ɾ e̞ b o̞ ɾ e̞
ほろう	h o̞ ɾ o̞ː
ほろにがい	h o̞ ɾ o̞ ɲ̟ i ɡ a̠ i
ほろほろちょう	h o̞ ɾ o̞ h o̞ ɾ o̞ t͡ɕ o̞ː
ほろぼす	h o̞ ɾ o̞ b o̞ s ɨᵝ
ほろり	h o̞ ɾ o̞ ɾʲ i
ほゎ	h ɰᵝ a̠
ほんき	h õ̞ ŋʲ kʲ i
ほんきょく	h õ̞ ŋʲ kʲ o̞ k ɯ̟ᵝ
ほんこう	h õ̞ ŋ k o̞ː
ほんしゅう	h õ̞ ɰ̃ ɕ ɨᵝː
ほんしょ	h õ̞ ɰ̃ ɕ o̞
ほんしん	h õ̞ ɰ̃ ɕ ĩ ɴ
ほんたい	h õ̞ n t a̠ i
ほんちょう	h õ̞ ɲ̟ t͡ɕ o̞ː
ほんとう	h õ̞ n t o̞ː
ほんにん	h õ̞ ɲ̟ ɲ̟ ĩ ɴ
ほんねん	h õ̞ nː ẽ̞ ɴ
ほんのう	h õ̞ nː o̞ː
ほんばんこうい	h õ̞ m b ã̠ ŋ k o̞ː i
ほんぽう	h õ̞ m p o̞ː
ほんま	h õ̞ mː a̠
ほんまる	h õ̞ mː a̠ ɾ ɯ̟ᵝ
ほんや	h õ̞ ɰ̃ j a̠
ほんるいだ	h õ̞ n ɾ ɯ̟ᵝ i d a̠
ほんわか	h õ̞ ɰ̃ ɰᵝ a̠ k a̠
ぼいんちょうわ	b o̞ ĩ ɲ̟ t͡ɕ o̞ː ɰᵝ a̠
ぼう	b o̞ː
ぼうえい	b o̞ː e̞ː
ぼうえきふう	b o̞ː e̞ kʲ i̥ ɸ ɯ̟ᵝː
ぼうぎょ	b o̞ː ɡʲ o̞
ぼうこう	b o̞ː k o̞ː
ぼうこく	b o̞ː k o̞ k ɯ̟ᵝ
ぼうし	b o̞ː ɕ i
ぼうしょくぎょう	b o̞ː ɕ o̞ k ɯ̟ᵝ ɡʲ o̞ː
ぼうじつ	b o̞ː ʑ i t͡s ɨᵝ
ぼうじん	b o̞ː ʑ ĩ ɴ
ぼうぜん	b o̞ː z ẽ̞ ɴ
ぼうたかとび	b o̞ː t a̠ k a̠ t o̞ bʲ i
ぼうだい	b o̞ː d a̠ i
ぼうちょう	b o̞ː t͡ɕ o̞ː
ぼうちょうざい	b o̞ː t͡ɕ o̞ː z a̠ i
ぼうど	b o̞ː d o̞
ぼうにょうどうせん	b o̞ː ɲ̟ o̞ː d o̞ː s ẽ̞ ɴ
ぼうねんかい	b o̞ː n ẽ̞ ŋ k a̠ i
ぼうびき	b o̞ː bʲ i kʲ i
ぼうゆう	b o̞ː j ɯ̟ᵝː
ぼうろう	b o̞ː ɾ o̞ː
ぼかん	b o̞ k ã̠ ɴ
ぼく	b o̞ k ɯ̟ᵝ
ぼくし	b o̞ k ɯ̟ᵝ ɕ i
ぼくたち	b o̞ k ɯ̟ᵝ t a̠ t͡ɕ i
ぼくり	b o̞ k ɯ̟ᵝ ɾʲ i
ぼけ	b o̞ k e̞
ぼこく	b o̞ k o̞ k ɯ̟ᵝ
ぼこくご	b o̞ k o̞ k ɯ̟ᵝ ɡ o̞
ぼさつ	b o̞ s a̠ t͡s ɨᵝ
ぼし	b o̞ ɕ i
ぼせん	b o̞ s ẽ̞ ɴ
ぼたもち	b o̞ t a̠ m o̞ t͡ɕ i
ぼっか	b o̞ k̚ k a̠
ぼっき	b o̞ k̚ʲ kʲ i
ぼっちめし	b o̞ t̚ t͡ɕ i m e̞ ɕ i
ぼっちゃん	b o̞ t̚ t͡ɕ ã̠ ɴ
ぼつ	b o̞ t͡s ɨᵝ
ぼはん	b o̞ h ã̠ ɴ
ぼや	b o̞ j a̠
ぼやく	b o̞ j a̠ k ɯ̟ᵝ
ぼろぞうきん	b o̞ ɾ o̞ z o̞ː kʲ ĩ ɴ
ぼん	b õ̞ ɴ
ぼんご	b õ̞ ŋ ɡ o̞
ぼんぷ	b õ̞ m p ɯ̟ᵝ
ぼんやすみ	b õ̞ ɰ̃ j a̠ s ɨᵝ mʲ i
ぼんやり	b õ̞ ɰ̃ j a̠ ɾʲ i
ぽい	p o̞ i
ぽご	p o̞ ɡ o̞
ぽつり	p o̞ t͡s ɨᵝ ɾʲ i
ぽんこつ	p õ̞ ŋ k o̞ t͡s ɨᵝ
まあ	m a̠ː
まいおちる	m a̠ i o̞ t͡ɕ i ɾ ɯ̟ᵝ
まいこ	m a̠ i k o̞
まいしゅう	m a̠ i ɕ ɨᵝː
まいそう	m a̠ i s o̞ː
まいにち	m a̠ i ɲ̟ i t͡ɕ i
まいる	m a̠ i ɾ ɯ̟ᵝ
まえ	m a̠ e̞
まえうり	m a̠ e̞ ɯ̟ᵝ ɾʲ i
まえおき	m a̠ e̞ o̞ kʲ i
まえだて	m a̠ e̞ d a̠ t e̞
まえのめり	m a̠ e̞ n o̞ m e̞ ɾʲ i
まえぶれ	m a̠ e̞ b ɯ̟ᵝ ɾ e̞
まか	m a̠ k a̠
まかい	m a̠ k a̠ i
まかす	m a̠ k a̠ s ɨᵝ
まかせる	m a̠ k a̠ s e̞ ɾ ɯ̟ᵝ
まかない	m a̠ k a̠ n a̠ i
まかなう	m a̠ k a̠ n a̠ ɯ̟ᵝ
まがたま	m a̠ ɡ a̠ t a̠ m a̠
まがまがしい	m a̠ ɡ a̠ m a̠ ɡ a̠ ɕ iː
まがる	m a̠ ɡ a̠ ɾ ɯ̟ᵝ
まがん	m a̠ ɡ ã̠ ɴ
まき	m a̠ kʲ i
まきこ	m a̠ kʲ i k o̞
まきこむ	m a̠ kʲ i k o̞ m ɯ̟ᵝ
まきす	m a̠ kʲ i s ɨᵝ
まきぞえ	m a̠ kʲ i z o̞ e̞
まきもどす	m a̠ kʲ i m o̞ d o̞ s ɨᵝ
まぎらわしい	m a̠ ɡʲ i ɾ a̠ ɰᵝ a̠ ɕ i i
まく	m a̠ k ɯ̟ᵝ
まくじゃく	m a̠ k ɯ̟ᵝ ʑ a̠ k ɯ̟ᵝ
まくつ	m a̠ k ɯ̟ᵝ t͡s ɨᵝ
まくら	m a̠ k ɯ̟ᵝ ɾ a̠
まくらことば	m a̠ k ɯ̟ᵝ ɾ a̠ k o̞ t o̞ b a̠
まくらなげ	m a̠ k ɯ̟ᵝ ɾ a̠ n a̠ ɡ e̞
まくる	m a̠ k ɯ̟ᵝ ɾ ɯ̟ᵝ
まぐれ	m a̠ ɡ ɯ̟ᵝ ɾ e̞
まぐれあたり	m a̠ ɡ ɯ̟ᵝ ɾ e̞ a̠ t a̠ ɾʲ i
まぐろ	m a̠ ɡ ɯ̟ᵝ ɾ o̞
まけ	m a̠ k e̞
まけいぬ	m a̠ k e̞ː n ɯ̟ᵝ
まける	m a̠ k e̞ ɾ ɯ̟ᵝ
まけん	m a̠ k ẽ̞ ɴ
まげる	m a̠ ɡ e̞ ɾ ɯ̟ᵝ
まこ	m a̠ k o̞
まこと	m a̠ k o̞ t o̞
まごつく	m a̠ ɡ o̞ t͡s ɨᵝ k ɯ̟ᵝ
まさかり	e̞ t͡s ɨᵝ
まさき	m a̠ s a̠ kʲ i
まさくに	m a̠ s a̠ k ɯ̟ᵝ ɲ̟ i
まさし	m a̠ s a̠ ɕ i
まさと	m a̠ s a̠ t o̞
まさひろ	m a̠ s a̠ ç i ɾ o̞
まさゆめ	m a̠ s a̠ j ɯ̟ᵝ m e̞
まさよし	m a̠ s a̠ j o̞ ɕ i
まさる	m a̠ s a̠ ɾ ɯ̟ᵝ
まざる	m a̠ z a̠ ɾ ɯ̟ᵝ
ましお	m a̠ ɕ i o̞
ましょう	m a̠ ɕ o̞ː
ましょうめん	m a̠ ɕ o̞ː m ẽ̞ ɴ
まじき	m a̠ ʑ i kʲ i
まじめ	m a̠ ʑ i m e̞
まじゅつ	m a̠ ʑ ɨᵝ t͡s ɨᵝ
まじわり	m a̠ ʑ i ɰᵝ a̠ ɾʲ i
ますい	m a̠ s ɨᵝ i
ますいざい	m a̠ s ɨᵝ i z a̠ i
ますます	m a̠ s ɨᵝ m a̠ s ɨᵝ
ますみ	m a̠ s ɨᵝ mʲ i
ますめ	m a̠ s ɨᵝ m e̞
ますらお	m a̠ s ɨᵝ ɾ a̠ o̞
まずい	m a̠ z ɨᵝ i
まぜる	m a̠ z e̞ ɾ ɯ̟ᵝ
また	m a̠ t a̠
またがる	m a̠ t a̠ ɡ a̠ ɾ ɯ̟ᵝ
またたび	m a̠ t a̠ t a̠ bʲ i
またとない	m a̠ t a̠ t o̞ n a̠ i
またね	m a̠ t a̠ n e̞
またまた	m a̠ t a̠ m a̠ t a̠
まだまだ	m a̠ d a̠ m a̠ d a̠
まち	m a̠ t͡ɕ i
まちあい	m a̠ t͡ɕ i a̠ i
まちあいしつ	m a̠ t͡ɕ i a̠ i ɕ i t͡s ɨᵝ
まちがう	m a̠ t͡ɕ i ɡ a̠ ɯ̟ᵝ
まちどおしい	m a̠ t͡ɕ i d o̞ː ɕ iː
まちにまった	m a̠ t͡ɕ i ɲ̟ i m a̠ t̚ t a̠
まちまち	m a̠ t͡ɕ i m a̠ t͡ɕ i
まっかんがに	m a̠ k̚ k ã̠ ŋ ɡ a̠ ɲ̟ i
まっくら	m a̠ k̚ k ɯ̟ᵝ ɾ a̠
まっくろ	m a̠ k̚ k ɯ̟ᵝ ɾ o̞
まっくろい	m a̠ k̚ k ɯ̟ᵝ ɾ o̞ i
まっこう	m a̠ k̚ k o̞ː
まっしょう	m a̠ ɕː o̞ː
まっしょうしんけいけい	m a̠ ɕː o̞ː ɕ ĩ ŋ k e̞ː k e̞ː
まっしょうめん	m a̠ ɕː o̞ː m ẽ̞ ɴ
まっしろ	m a̠ ɕː i ɾ o̞
まっとう	m a̠ t̚ t o̞ː
まっぴるま	m a̠ p̚ʲ pʲ i ɾ ɯ̟ᵝ m a̠
まっぷたつ	m a̠ p̚ p ɯ̟ᵝ t a̠ t͡s ɨᵝ
まつ	m a̠ t͡s ɨᵝ
まつかぜ	m a̠ t͡s ɨᵝ k a̠ z e̞
まつげ	m a̠ t͡s ɨᵝ ɡ e̞
まつち	m a̠ t͡s ɨᵝ t͡ɕ i
まつば	m a̠ t͡s ɨᵝ b a̠
まつばくずし	m a̠ t͡s ɨᵝ b a̠ k ɯ̟ᵝ z ɨᵝ ɕ i
まつひら	m a̠ t͡s ɨᵝ ç i ɾ a̠
まつむし	m a̠ t͡s ɨᵝ m ɯ̟ᵝ ɕ i
まつやにあぶら	m a̠ t͡s ɨᵝ j a̠ ɲ̟ i a̠ b ɯ̟ᵝ ɾ a̠
まつり	m a̠ t͡s ɨᵝ ɾʲ i
まつりごと	m a̠ t͡s ɨᵝ ɾʲ i ɡ o̞ t o̞
まつる	m a̠ t͡s ɨᵝ ɾ ɯ̟ᵝ
まつろ	m a̠ t͡s ɨᵝ ɾ o̞
まつわる	m a̠ t͡s ɨᵝ ɰᵝ a̠ ɾ ɯ̟ᵝ
まて	m a̠ t e̞
まてい	m a̠ t e̞ː
まてんろう	m a̠ t ẽ̞ n ɾ o̞ː
まで	m a̠ d e̞
までもない	m a̠ d e̞ m o̞ n a̠ i
まとう	m a̠ t o̞ ɯ̟ᵝ
まとまり	m a̠ t o̞ m a̠ ɾʲ i
まとめる	m a̠ t o̞ m e̞ ɾ ɯ̟ᵝ
まどい	m a̠ d o̞ i
まどう	m a̠ d o̞ ɯ̟ᵝ
まどうし	m a̠ d o̞ː ɕ i
まどべ	m a̠ d o̞ b e̞
まどろむ	m a̠ d o̞ ɾ o̞ m ɯ̟ᵝ
まないた	m a̠ n a̠ i t a̠
まなざし	m a̠ n a̠ z a̠ ɕ i
まなぶ	m a̠ n a̠ b ɯ̟ᵝ
まなむすめ	m a̠ n a̠ m ɯ̟ᵝ s ɨᵝ m e̞
まにあう	m a̠ ɲ̟ i a̠ ɯ̟ᵝ
まにゅう	m a̠ ɲ̟ ɯ̟ᵝː
まねく	m a̠ n e̞ k ɯ̟ᵝ
まねる	m a̠ n e̞
まばゆい	m a̠ b a̠ j ɯ̟ᵝ i
まひる	m a̠ ç i ɾ ɯ̟ᵝ
まひわ	m a̠ ç i ɰᵝ a̠
まふたつ	m a̠ ɸ ɯ̟ᵝ t a̠ t͡s ɨᵝ
まふゆ	m a̠ ɸ ɯ̟ᵝ j ɯ̟ᵝ
まぶしい	m a̠ b ɯ̟ᵝ ɕ i i
まほし	m a̠ h o̞ ɕ i
まぼろし	m a̠ b o̞ ɾ o̞ ɕ i
まぼろしとう	m a̠ b o̞ ɾ o̞ ɕ i t o̞ː
まま	m a̠ m a̠
まみれる	m a̠ mʲ i ɾ e̞ ɾ ɯ̟ᵝ
まめ	m a̠ m e̞
まめあぶら	m a̠ m e̞ a̠ b ɯ̟ᵝ ɾ a̠
まめがら	m a̠ m e̞ ɡ a̠ ɾ a̠
まもの	m a̠ m o̞ n o̞
まもり	m a̠ m o̞ ɾʲ i
まもる	m a̠ m o̞ ɾ ɯ̟ᵝ
まゆげ	m a̠ j ɯ̟ᵝ ɡ e̞
まゆみ	m a̠ j ɯ̟ᵝ mʲ i
まよう	m a̠ j o̞ ɯ̟ᵝ
まよなか	m a̠ j o̞ n a̠ k a̠
まる	m a̠ ɾ ɯ̟ᵝ
まるがお	m a̠ ɾ ɯ̟ᵝ ɡ a̠ o̞
まるたごや	m a̠ ɾ ɯ̟ᵝ t a̠ ɡ o̞ j a̠
まるで	m a̠ ɾ ɯ̟ᵝ d e̞
まるのうち	m a̠ ɾ ɯ̟ᵝ n o̞ ɯ̟ᵝ t͡ɕ i
まるまる	m a̠ ɾ ɯ̟ᵝ m a̠ ɾ ɯ̟ᵝ
まるみえ	m a̠ ɾ ɯ̟ᵝ mʲ i e̞
まるめる	m a̠ ɾ ɯ̟ᵝ m e̞ ɾ ɯ̟ᵝ
まわす	m a̠ ɰᵝ a̠ s ɨᵝ
まわり	k a̠ i
まわりあわせ	m a̠ ɰᵝ a̠ ɾʲ i a̠ ɰᵝ a̠ s e̞
まわりくどい	m a̠ ɰᵝ a̠ ɾʲ i k ɯ̟ᵝ d o̞ i
まわる	m a̠ ɰᵝ a̠ ɾ ɯ̟ᵝ
まんえい	m ã̠ ɰ̃ e̞ː
まんえん	m ã̠ ɰ̃ ẽ̞ ɴ
まんかんしょく	m ã̠ ŋ k ã̠ ɰ̃ ɕ o̞ k ɯ̟ᵝ
まんかんぜんせき	m ã̠ ŋ k ã̠ n d͡z ẽ̞ ɰ̃ s e̞ kʲ i
まんきつ	m ã̠ ŋʲ kʲ i t͡s ɨᵝ
まんけん	m ã̠ ŋ k ẽ̞ ɴ
まんじ	m ã̠ ɲ̟ d͡ʑ i
まんじともえ	m ã̠ ɲ̟ d͡ʑ i t o̞ m o̞ e̞
まんじゅう	m ã̠ ɲ̟ d͡ʑ ɨᵝː
まんぞくど	m ã̠ n d͡z o̞ k ɯ̟ᵝ d o̞
まんてん	m ã̠ n t ẽ̞ ɴ
まんなか	m ã̠ nː a̠ k a̠
まんま	m ã̠ mː a̠
まんまるい	m ã̠ mː a̠ ɾ ɯ̟ᵝ i
まんまん	m ã̠ mː ã̠ ɴ
まんよう	m ã̠ ɰ̃ j o̞ː
まんようがな	m ã̠ ɰ̃ j o̞ː ɡ a̠ n a̠
まんりょう	m ã̠ n ɾʲ o̞ː
まんをじする	m ã̠ ɰ̃ o̞ d͡ʑ i s ɨᵝ ɾ ɯ̟ᵝ
みあい	mʲ i a̠ i
みあきる	mʲ i a̠ kʲ i ɾ ɯ̟ᵝ
みうら	mʲ i ɯ̟ᵝ ɾ a̠
みえけん	mʲ i e̞ k ẽ̞ ɴ
みえみえ	mʲ i e̞ mʲ i e̞
みえる	mʲ i e̞ ɾ ɯ̟ᵝ
みおさめ	mʲ i o̞ s a̠ m e̞
みおぼえる	mʲ i o̞ b o̞ e̞ ɾ ɯ̟ᵝ
みかくにん	mʲ i k a̠ k ɯ̟ᵝ ɲ̟ ĩ ɴ
みかける	mʲ i k a̠ k e̞ ɾ ɯ̟ᵝ
みかず	s ã̠ ɰ̃ i t͡ɕ i
みかた	mʲ i k a̠ t a̠
みかづき	mʲ i k a̠ z ɨᵝ kʲ i
みかん	mʲ i k ã̠ ɴ
みがく	mʲ i ɡ a̠ k ɯ̟ᵝ
みがわり	mʲ i ɡ a̠ ɰᵝ a̠ ɾʲ i
みき	mʲ i kʲ i
みぎ	mʲ i ɡʲ i
みぎがわ	mʲ i ɡʲ i ɡ a̠ ɰᵝ a̠
みくだりはん	mʲ i k ɯ̟ᵝ d a̠ ɾʲ i h ã̠ ɴ
みくらべる	mʲ i k ɯ̟ᵝ ɾ a̠ b e̞ ɾ ɯ̟ᵝ
みけ	mʲ i k e̞
みけねこ	mʲ i k e̞ n e̞ k o̞
みこむ	mʲ i k o̞ m ɯ̟ᵝ
みごと	mʲ i ɡ o̞ t o̞
みごろし	mʲ i ɡ o̞ ɾ o̞ ɕ i
みさこ	mʲ i s a̠ k o̞
みして	mʲ i ɕ i t e̞
みしょうぶん	mʲ i ɕ o̞ː b ɯ̟̃ᵝ ɴ
みしよう	mʲ i ɕ i j o̞ː
みしんじゃ	mʲ i ɕ ĩ ɲ̟ d͡ʑ a̠
みじめ	mʲ i ʑ i m e̞
みじゅく	mʲ i ʑ ɨᵝ k ɯ̟ᵝ
みじゅくもの	mʲ i ʑ ɨᵝ k ɯ̟ᵝ m o̞ n o̞
みじんぎり	mʲ i ʑ ĩ ŋʲ ɡʲ i ɾʲ i
みじんこ	mʲ i ʑ ĩ ŋ k o̞
みすぼらしい	mʲ i s ɨᵝ b o̞ ɾ a̠ ɕ i i
みずいらず	mʲ i z ɨᵝ i ɾ a̠ z ɨᵝ
みずうち	mʲ i z ɨᵝ ɯ̟ᵝ t͡ɕ i
みずから	mʲ i z ɨᵝ k a̠ ɾ a̠
みずがめざ	mʲ i z ɨᵝ ɡ a̠ m e̞ z a̠
みずぎ	mʲ i z ɨᵝ ɡʲ i
みずこ	mʲ i z ɨᵝ k o̞
みずでっぽう	mʲ i z ɨᵝ d e̞ p̚ p o̞ː
みずのあわ	mʲ i z ɨᵝ n o̞ a̠ ɰᵝ a̠
みせ	mʲ i s e̞
みせかける	mʲ i s e̞ k a̠ k e̞ ɾ ɯ̟ᵝ
みせる	mʲ i s e̞ ɾ ɯ̟ᵝ
みそ	mʲ i s o̞
みそち	mʲ i s o̞ t͡ɕ i
みたい	mʲ i t a̠ i
みたす	mʲ i t a̠ s ɨᵝ
みだしご	mʲ i d a̠ ɕ i ɡ o̞
みだれば	mʲ i d a̠ ɾ e̞ b a̠
みち	mʲ i t͡ɕ i
みちお	mʲ i t͡ɕ i o̞
みちすじ	mʲ i t͡ɕ i s ɨᵝ ʑ i
みちたか	mʲ i t͡ɕ i t a̠ k a̠
みちづれ	mʲ i t͡ɕ i z ɨᵝ ɾ e̞
みちひさ	mʲ i t͡ɕ i ç i s a̠
みちゆき	mʲ i t͡ɕ i j ɯ̟ᵝ kʲ i
みちる	mʲ i t͡ɕ i ɾ ɯ̟ᵝ
みっかん	mʲ i k̚ k ã̠ ɴ
みっせつ	mʲ i sː e̞ t͡s ɨᵝ
みっともない	mʲ i t̚ t o̞ m o̞ n a̠ i
みつお	mʲ i t͡s ɨᵝ o̞
みつかる	mʲ i t͡s ɨ̥ᵝ k a̠ ɾ ɯ̟ᵝ
みつぐ	mʲ i t͡s ɨᵝ ɡ ɯ̟ᵝ
みつげつ	mʲ i t͡s ɨᵝ ɡ e̞ t͡s ɨᵝ
みつばち	mʲ i t͡s ɨᵝ b a̠ t͡ɕ i
みつめる	mʲ i t͡s ɨᵝ m e̞ ɾ ɯ̟ᵝ
みつもる	mʲ i t͡s ɨᵝ m o̞ ɾ ɯ̟ᵝ
みてい	mʲ i t e̞ː
みと	mʲ i t o̞
みとおす	mʲ i t o̞ː s ɨᵝ
みとどける	mʲ i t o̞ d o̞ k e̞ ɾ ɯ̟ᵝ
みとる	mʲ i t o̞ ɾ ɯ̟ᵝ
みどり	mʲ i d o̞ ɾʲ i
みな	mʲ i n a̠
みなおす	mʲ i n a̠ o̞ s ɨᵝ
みなぎる	mʲ i n a̠ ɡʲ i ɾ ɯ̟ᵝ
みなごろし	mʲ i n a̠ ɡ o̞ ɾ o̞ ɕ i
みなさま	mʲ i n a̠ s a̠ m a̠
みなさん	mʲ i n a̠ s ã̠ ɴ
みなす	mʲ i n a̠ s ɨᵝ
みなみ	mʲ i n a̠ mʲ i
みなみかいきせん	mʲ i n a̠ mʲ i k a̠ i kʲ i̥ s ẽ̞ ɴ
みなれる	mʲ i n a̠ ɾ e̞ ɾ ɯ̟ᵝ
みにくい	mʲ i ɲ̟ i k ɯ̟ᵝ i
みの	mʲ i n o̞
みのり	mʲ i n o̞ ɾʲ i
みはる	mʲ i h a̠ ɾ ɯ̟ᵝ
みぶん	mʲ i b ɯ̟̃ᵝ ɴ
みぶんしょうめいしょ	mʲ i b ɯ̟̃ᵝ ɰ̃ ɕ o̞ː m e̞ː ɕ o̞
みまいきん	mʲ i m a̠ i kʲ ĩ ɴ
みみ	mʲ i mʲ i
みみあて	mʲ i mʲ i a̠ t e̞
みみかざり	mʲ i mʲ i k a̠ z a̠ ɾʲ i
みみず	mʲ i mʲ i z ɨᵝ
みみずく	mʲ i mʲ i z ɨᵝ k ɯ̟ᵝ
みみなり	mʲ i mʲ i n a̠ ɾʲ i
みみにのこる	mʲ i mʲ i ɲ̟ i n o̞ k o̞ ɾ ɯ̟ᵝ
みゃく	mʲ a̠ k ɯ̟ᵝ
みゃくせき	mʲ a̠ k ɯ̟ᵝ s e̞ kʲ i
みゃくはく	mʲ a̠ k ɯ̟ᵝ h a̠ k ɯ̟ᵝ
みゃくらく	mʲ a̠ k ɯ̟ᵝ ɾ a̠ k ɯ̟ᵝ
みや	mʲ i j a̠
みやげ	mʲ i j a̠ ɡ e̞
みやこ	mʲ i j a̠ k o̞
みやこじま	mʲ i j a̠ k o̞ ʑ i m a̠
みやこのじょう	mʲ i j a̠ k o̞ n o̞ ʑ o̞ː
みやつこぎ	mʲ i j a̠ t͡s ɨᵝ k o̞ ɡʲ i
みやの	mʲ i j a̠ n o̞
みやびやか	mʲ i j a̠ bʲ i j a̠ k a̠
みやぶ	mʲ i j a̠ b ɯ̟ᵝ
みゅ	mʲ ɨᵝ
みょ	mʲ o̞
みょうが	mʲ o̞ː ɡ a̠
みょうせき	mʲ o̞ː s e̞ kʲ i
みよし	mʲ i j o̞ ɕ i
みらいじせい	mʲ i ɾ a̠ i d͡ʑ i s e̞ː
みる	mʲ i ɾ ɯ̟ᵝ
みれんがましい	mʲ i ɾ ẽ̞ ŋ ɡ a̠ m a̠ ɕ iː
みろ	mʲ i ɾ o̞
みろく	mʲ i ɾ o̞ k ɯ̟ᵝ
みわたす	mʲ i ɰᵝ a̠ t a̠ s ɨᵝ
みをうる	mʲ i o̞ ɯ̟ᵝ ɾ ɯ̟ᵝ
みんかんほうそう	mʲ ĩ ŋ k ã̠ ɰ̃ h o̞ː s o̞ː
みんこく	mʲ ĩ ŋ k o̞ k ɯ̟ᵝ
みんせい	mʲ ĩ ɰ̃ s e̞ː
みんぞく	mʲ ĩ n d͡z o̞ k ɯ̟ᵝ
みんちょうたい	mʲ ĩ ɲ̟ t͡ɕ o̞ː t a̠ i
みんぺい	mʲ ĩ m p e̞ː
むいしき	m ɯ̟ᵝ i ɕ i̥ kʲ i
むいしきてき	m ɯ̟ᵝ i ɕ i kʲ i t e̞ kʲ i
むかい	m ɯ̟ᵝ k a̠ i
むかう	m ɯ̟ᵝ k a̠ ɯ̟ᵝ
むかえ	m ɯ̟ᵝ k a̠ e̞
むかえうつ	m ɯ̟ᵝ k a̠ e̞ ɯ̟ᵝ t͡s ɨᵝ
むかえる	m ɯ̟ᵝ k a̠ e̞ ɾ ɯ̟ᵝ
むかし	m ɯ̟ᵝ k a̠ ɕ i
むかつく	m ɯ̟ᵝ k a̠ t͡s ɨ̥ᵝ k ɯ̟ᵝ
むかで	m ɯ̟ᵝ k a̠ d e̞
むかんどう	m ɯ̟ᵝ k ã̠ n d o̞ː
むき	m ɯ̟ᵝ kʲ i
むきかごうぶつ	m ɯ̟̊ᵝ kʲ i k a̠ ɡ o̞ː b ɯ̟ᵝ t͡s ɨᵝ
むきだし	m ɯ̟ᵝ kʲ i d a̠ ɕ i
むきちょうえき	m ɯ̟ᵝ kʲ i t͡ɕ o̞ː e̞ kʲ i
むきゅう	m ɯ̟ᵝ kʲ ɨᵝː
むぎ	m ɯ̟ᵝ ɡʲ i
むく	m ɯ̟ᵝ k ɯ̟ᵝ
むけ	m ɯ̟ᵝ k e̞
むける	m ɯ̟ᵝ k e̞ ɾ ɯ̟ᵝ
むげんだい	m ɯ̟ᵝ ɡ ẽ̞ n d a̠ i
むげんれんさこう	m ɯ̟ᵝ ɡ ẽ̞ n ɾ ẽ̞ ɰ̃ s a̠ k o̞ː
むこう	m ɯ̟ᵝ k o̞ː
むこうがわ	m ɯ̟ᵝ k o̞ː ɡ a̠ ɰᵝ a̠
むこくせき	m ɯ̟ᵝ k o̞ k ɯ̟ᵝ s e̞ kʲ i
むごん	m ɯ̟ᵝ ɡ õ̞ ɴ
むさいしょく	m ɯ̟ᵝ s a̠ i ɕ o̞ k ɯ̟ᵝ
むさぼる	m ɯ̟ᵝ s a̠ b o̞ ɾ ɯ̟ᵝ
むし	m ɯ̟ᵝ ɕ i
むしけら	m ɯ̟ᵝ ɕ i k e̞ ɾ a̠
むしのいき	m ɯ̟ᵝ ɕ i n o̞ i kʲ i
むしのいどころがわるい	m ɯ̟ᵝ ɕ i n o̞ i d o̞ k o̞ ɾ o̞ ɡ a̠ ɰᵝ a̠ ɾ ɯ̟ᵝ i
むしょく	m ɯ̟ᵝ ɕ o̞ k ɯ̟ᵝ
むしる	m ɯ̟ᵝ ɕ i ɾ ɯ̟ᵝ
むしろ	m ɯ̟ᵝ ɕ i ɾ o̞
むじゅうりょう	m ɯ̟ᵝ ʑ ɨᵝː ɾʲ o̞ː
むじゅうりょく	m ɯ̟ᵝ ʑ ɨᵝː ɾʲ o̞ k ɯ̟ᵝ
むじるし	m ɯ̟ᵝ ʑ i ɾ ɯ̟ᵝ ɕ i
むす	m ɯ̟ᵝ s ɨᵝ
むすいぶつ	m ɯ̟ᵝ s ɨᵝ i b ɯ̟ᵝ t͡s ɨᵝ
むすこ	m ɯ̟ᵝ s ɨ̥ᵝ k o̞
むすび	m ɯ̟ᵝ s ɨᵝ bʲ i
むすびつき	m ɯ̟ᵝ s ɨᵝ bʲ i t͡s ɨᵝ kʲ i
むすびつく	m ɯ̟ᵝ s ɨᵝ bʲ i t͡s ɨᵝ k ɯ̟ᵝ
むすびのかみ	m ɯ̟ᵝ s ɨᵝ bʲ i n o̞ k a̠ mʲ i
むすめむこ	m ɯ̟ᵝ s ɨᵝ m e̞ m ɯ̟ᵝ k o̞
むずい	m ɯ̟ᵝ z ɨᵝ i
むずかしい	m ɯ̟ᵝ z ɨᵝ k a̠ ɕ i i
むずむず	m ɯ̟ᵝ z ɨᵝ m ɯ̟ᵝ z ɨᵝ
むせいせいしょく	m ɯ̟ᵝ s e̞ː s e̞ː ɕ o̞ k ɯ̟ᵝ
むせぶ	m ɯ̟ᵝ s e̞ b ɯ̟ᵝ
むせんでんわ	m ɯ̟ᵝ s ẽ̞ n d ẽ̞ ɰ̃ ɰᵝ a̠
むそう	m ɯ̟ᵝ s o̞ː
むぞうさ	m ɯ̟ᵝ z o̞ː s a̠
むだ	m ɯ̟ᵝ d a̠
むだげ	m ɯ̟ᵝ d a̠ ɡ e̞
むちうつ	m ɯ̟ᵝ t͡ɕ i ɯ̟ᵝ t͡s ɨᵝ
むっくり	m ɯ̟ᵝ k̚ k ɯ̟ᵝ ɾʲ i
むっと	m ɯ̟ᵝ t̚ t o̞
むつう	m ɯ̟ᵝ t͡s ɨᵝː
むつき	m ɯ̟ᵝ t͡s ɨ̥ᵝ kʲ i
むてき	m ɯ̟ᵝ t e̞ kʲ i
むな	m ɯ̟ᵝ n a̠
むなくそがわるい	m ɯ̟ᵝ n a̠ k ɯ̟ᵝ s o̞ ɡ a̠ ɰᵝ a̠ ɾ ɯ̟ᵝ i
むなくそわるい	m ɯ̟ᵝ n a̠ k ɯ̟ᵝ s o̞ ɰᵝ a̠ ɾ ɯ̟ᵝ i
むなぐら	m ɯ̟ᵝ n a̠ ɡ ɯ̟ᵝ ɾ a̠
むなぐるしい	m ɯ̟ᵝ n a̠ ɡ ɯ̟ᵝ ɾ ɯ̟ᵝ ɕ iː
むなしい	m ɯ̟ᵝ n a̠ ɕ i i
むね	m ɯ̟ᵝ n e̞
むねさんずん	m ɯ̟ᵝ n e̞ s ã̠ n d͡z ɨ̃ᵝ ɴ
むねつぶし	m ɯ̟ᵝ n e̞ t͡s ɨᵝ b ɯ̟ᵝ ɕ i
むねぽち	m ɯ̟ᵝ n e̞ p o̞ t͡ɕ i
むねやけ	m ɯ̟ᵝ n e̞ j a̠ k e̞
むのう	m ɯ̟ᵝ n o̞ː
むはい	m ɯ̟ᵝ h a̠ i
むやみ	m ɯ̟ᵝ j a̠ mʲ i
むやみやたら	m ɯ̟ᵝ j a̠ mʲ i j a̠ t a̠ ɾ a̠
むら	m ɯ̟ᵝ ɾ a̠
むらがる	m ɯ̟ᵝ ɾ a̠ ɡ a̠ ɾ ɯ̟ᵝ
むらまつ	m ɯ̟ᵝ ɾ a̠ m a̠ t͡s ɨᵝ
むらむら	m ɯ̟ᵝ ɾ a̠ m ɯ̟ᵝ ɾ a̠
むろん	m ɯ̟ᵝ ɾ õ̞ ɴ
むゎ	m ɰᵝ a̠
めあて	m e̞ a̠ t e̞
めいかい	m e̞ː k a̠ i
めいかく	m e̞ː k a̠ k ɯ̟ᵝ
めいが	m e̞ː ɡ a̠
めいし	m e̞ː ɕ i
めいしょう	m e̞ː ɕ o̞ː
めいじる	m e̞ː ʑ i ɾ ɯ̟ᵝ
めいじん	m e̞ː ʑ ĩ ɴ
めいせきむ	m e̞ː s e̞ kʲ i m ɯ̟ᵝ
めいそう	m e̞ː s o̞ː
めいばん	m e̞ː b ã̠ ɴ
めいぶん	m e̞ː b ɯ̟̃ᵝ ɴ
めいめいはくはく	m e̞ː m e̞ː h a̠ k ɯ̟ᵝ h a̠ k ɯ̟ᵝ
めいもく	m e̞ː m o̞ k ɯ̟ᵝ
めいやく	m e̞ː j a̠ k ɯ̟ᵝ
めいよ	m e̞ː j o̞
めいりょう	m e̞ː ɾʲ o̞ː
めいれい	m e̞ː ɾ e̞ː
めいろ	m e̞ː ɾ o̞
めうし	m e̞ ɯ̟ᵝ ɕ i
めがない	m e̞ ɡ a̠ n a̠ i
めがね	m e̞ ɡ a̠ n e̞
めがみ	m e̞ ɡ a̠ mʲ i
めくら	m e̞ k ɯ̟ᵝ ɾ a̠
めくらぐも	m e̞ k ɯ̟ᵝ ɾ a̠ ɡ ɯ̟ᵝ m o̞
めぐすり	m e̞ ɡ ɯ̟ᵝ s ɨᵝ ɾʲ i
めぐみ	m e̞ ɡ ɯ̟ᵝ mʲ i
めぐりあう	m e̞ ɡ ɯ̟ᵝ ɾʲ i a̠ ɯ̟ᵝ
めぐる	m e̞ ɡ ɯ̟ᵝ ɾ ɯ̟ᵝ
めげる	m e̞ ɡ e̞ ɾ ɯ̟ᵝ
めざし	m e̞ z a̠ ɕ i
めざす	m e̞ z a̠ s ɨᵝ
めざましい	m e̞ z a̠ m a̠ ɕ iː
めし	m e̞ ɕ i
めしかえ	m e̞ ɕ i k a̠ e̞
めしつかい	m e̞ ɕ i t͡s ɨᵝ k a̠ i
めしべ	m e̞ ɕ i b e̞
めじろ	m e̞ ʑ i ɾ o̞
めじろざめ	m e̞ ʑ i ɾ o̞ z a̠ m e̞
めすいぬ	m e̞ s ɨᵝ i n ɯ̟ᵝ
めず	m e̞ z ɨᵝ
めだしぼう	m e̞ d a̠ ɕ i b o̞ː
めだつ	m e̞ d a̠ t͡s ɨᵝ
めだまやき	m e̞ d a̠ m a̠ j a̠ kʲ i
めっきり	m e̞ k̚ʲ kʲ i ɾʲ i
めった	m e̞ t̚ t a̠
めっちゃ	m e̞ t̚ t͡ɕ a̠
めで	m e̞ d e̞
めでたい	m e̞ d e̞ t a̠ i
めでる	m e̞ d e̞ ɾ ɯ̟ᵝ
めとる	m e̞ t o̞ ɾ ɯ̟ᵝ
めのう	m e̞ n o̞ː
めのまえ	m e̞ n o̞ m a̠ e̞
めまい	m e̞ m a̠ i
めめしい	m e̞ m e̞ ɕ iː
めをくらます	m e̞ o̞ k ɯ̟ᵝ ɾ a̠ m a̠ s ɨᵝ
めをつける	m e̞ o̞ t͡s ɨᵝ k e̞ ɾ ɯ̟ᵝ
めをみはる	m e̞ o̞ mʲ i h a̠ ɾ ɯ̟ᵝ
めん	m ẽ̞ ɴ
めんえきふぜん	m ẽ̞ ɰ̃ e̞ kʲ i ɸ ɯ̟ᵝ z ẽ̞ ɴ
めんか	m ẽ̞ ŋ k a̠
めんし	m ẽ̞ ɰ̃ ɕ i
めんしき	m ẽ̞ ɰ̃ ɕ i kʲ i
めんせき	m ẽ̞ ɰ̃ s e̞ kʲ i
めんぜい	m ẽ̞ n d͡z e̞ː
めんたいこ	m ẽ̞ n t a̠ i k o̞
めんでん	m ẽ̞ n d ẽ̞ ɴ
めんどう	m ẽ̞ n d o̞ː
めんどり	m ẽ̞ n d o̞ ɾʲ i
もい	m o̞ i
もうえん	m o̞ː ẽ̞ ɴ
もうかる	m o̞ː k a̠ ɾ ɯ̟ᵝ
もうける	m o̞ː k e̞ ɾ ɯ̟ᵝ
もうこ	m o̞ː k o̞
もうこうま	m o̞ː k o̞ ɯ̟ᵝ m a̠
もうこはん	m o̞ː k o̞ h ã̠ ɴ
もうさいかん	m o̞ː s a̠ i k ã̠ ɴ
もうし	m o̞ː ɕ i
もうしでる	m o̞ː ɕ i d e̞ ɾ ɯ̟ᵝ
もうしゃ	m o̞ː ɕ a̠
もうす	m o̞ː s ɨᵝ
もうとう	m o̞ː t o̞ː
もうどく	m o̞ː d o̞ k ɯ̟ᵝ
もえ	m o̞ e̞
もおんな	m o̞ õ̞ nː a̠
もがく	m o̞ ɡ a̠ k ɯ̟ᵝ
もぎり	m o̞ ɡʲ i ɾʲ i
もくさつ	m o̞ k ɯ̟̊ᵝ s a̠ t͡s ɨᵝ
もくしろく	m o̞ k ɯ̟̊ᵝ ɕ i ɾ o̞ k ɯ̟ᵝ
もくそう	m o̞ k ɯ̟ᵝ s o̞ː
もくてきご	m o̞ k ɯ̟ᵝ t e̞ kʲ i ɡ o̞
もくてきろん	m o̞ k ɯ̟ᵝ t e̞ kʲ i ɾ õ̞ ɴ
もくとう	m o̞ k ɯ̟ᵝ t o̞ː
もくひょう	m o̞ k ɯ̟ᵝ ç o̞ː
もくろみ	m o̞ k ɯ̟ᵝ ɾ o̞ mʲ i
もくろむ	m o̞ k ɯ̟ᵝ ɾ o̞ m ɯ̟ᵝ
もぐ	m o̞ ɡ ɯ̟ᵝ
もぐら	m o̞ ɡ ɯ̟ᵝ ɾ a̠
もぐりこむ	m o̞ ɡ ɯ̟ᵝ ɾʲ i k o̞ m ɯ̟ᵝ
もさ	m o̞ s a̠
もし	m o̞ ɕ i
もしか	m o̞ ɕ i k a̠
もしかしたら	m o̞ ɕ i k a̠ ɕ i t a̠ ɾ a̠
もしかして	m o̞ ɕ i k a̠ ɕ i t e̞
もしも	m o̞ ɕ i m o̞
もしもし	m o̞ ɕ i m o̞ ɕ i̥
もしゅ	m o̞ ɕ ɨᵝ
もじどおり	m o̞ ʑ i d o̞ː ɾʲ i
もじばけ	m o̞ ʑ i b a̠ k e̞
もじる	m o̞ ʑ i ɾ ɯ̟ᵝ
もたつく	m o̞ t a̠ t͡s ɨᵝ k ɯ̟ᵝ
もたらす	m o̞ t a̠ ɾ a̠ s ɨᵝ
もたれる	m o̞ t a̠ ɾ e̞ ɾ ɯ̟ᵝ
もだえる	m o̞ d a̠ e̞ ɾ ɯ̟ᵝ
もち	m o̞ t͡ɕ i
もちあげる	m o̞ t͡ɕ i a̠ ɡ e̞ ɾ ɯ̟ᵝ
もちあわせ	m o̞ t͡ɕ i a̠ ɰᵝ a̠ s e̞
もちあわせる	m o̞ t͡ɕ i a̠ ɰᵝ a̠ s e̞ ɾ ɯ̟ᵝ
もちいる	m o̞ t͡ɕ iː ɾ ɯ̟ᵝ
もちきたる	m o̞ t͡ɕ i kʲ i t a̠ ɾ ɯ̟ᵝ
もちきり	m o̞ t͡ɕ i kʲ i ɾʲ i
もちこたえる	m o̞ t͡ɕ i k o̞ t a̠ e̞ ɾ ɯ̟ᵝ
もちさる	m o̞ t͡ɕ i s a̠ ɾ ɯ̟ᵝ
もちだす	m o̞ t͡ɕ i d a̠ s ɨᵝ
もちつけ	m o̞ t͡ɕ i t͡s ɨᵝ k e̞
もちぬし	m o̞ t͡ɕ i n ɯ̟ᵝ ɕ i
もちのろん	m o̞ t͡ɕ i n o̞ ɾ õ̞ ɴ
もちはこぶ	m o̞ t͡ɕ i h a̠ k o̞ b ɯ̟ᵝ
もっか	m o̞ k̚ k a̠
もっきん	m o̞ k̚ʲ kʲ ĩ ɴ
もったい	m o̞ t̚ t a̠ i
もったいない	m o̞ t̚ t a̠ i n a̠ i
もっと	m o̞ t̚ t o̞
もっとも	m o̞ t̚ t o̞ m o̞
もっともらしい	m o̞ t̚ t o̞ m o̞ ɾ a̠ ɕ iː
もっぱら	m o̞ p̚ p a̠ ɾ a̠
もつ	m o̞ t͡s ɨᵝ
もつれ	m o̞ t͡s ɨᵝ ɾ e̞
もつれる	m o̞ t͡s ɨᵝ ɾ e̞ ɾ ɯ̟ᵝ
もてあそぶ	m o̞ t e̞ a̠ s o̞ b ɯ̟ᵝ
もてなす	m o̞ t e̞ n a̠ s ɨᵝ
もてる	m o̞ t e̞ ɾ ɯ̟ᵝ
もと	m o̞ t o̞
もとづく	m o̞ t o̞ z ɨᵝ k ɯ̟ᵝ
もとむ	m o̞ t o̞ m ɯ̟ᵝ
もとめる	m o̞ t o̞ m e̞ ɾ ɯ̟ᵝ
もともこもない	m o̞ t o̞ m o̞ k o̞ m o̞ n a̠ i
もとる	m o̞ t o̞ ɾ ɯ̟ᵝ
もどかしい	m o̞ d o̞ k a̠ ɕ iː
もどき	m o̞ d o̞ kʲ i
もどる	m o̞ d o̞ ɾ ɯ̟ᵝ
もぬけ	m o̞ n ɯ̟ᵝ k e̞
ものいい	m o̞ n o̞ iː
ものおき	m o̞ n o̞ o̞ kʲ i
ものおと	m o̞ n o̞ o̞ t o̞
ものがたり	m o̞ n o̞ ɡ a̠ t a̠ ɾʲ i
ものがたる	m o̞ n o̞ ɡ a̠ t a̠ ɾ ɯ̟ᵝ
ものぐるい	m o̞ n o̞ ɡ ɯ̟ᵝ ɾ ɯ̟ᵝ i
ものごし	m o̞ n o̞ ɡ o̞ ɕ i
ものさし	m o̞ n o̞ s a̠ ɕ i
ものすごい	m o̞ n o̞ s ɨᵝ ɡ o̞ i
ものする	m o̞ n o̞ s ɨᵝ ɾ ɯ̟ᵝ
ものたりない	m o̞ n o̞ t a̠ ɾʲ i n a̠ i
ものまね	m o̞ n o̞ m a̠ n e̞
ものみだかい	m o̞ n o̞ mʲ i d a̠ k a̠ i
ものものしい	m o̞ n o̞ m o̞ n o̞ ɕ iː
もはや	m o̞ h a̠ j a̠
もふもふ	m o̞ ɸ ɯ̟ᵝ m o̞ ɸ ɯ̟ᵝ
もみ	m o̞ mʲ i
もみあげ	m o̞ mʲ i a̠ ɡ e̞
もみじ	m o̞ mʲ i ʑ i
もむ	m o̞ m ɯ̟ᵝ
もも	m o̞ m o̞
ももか	m o̞ m o̞ k a̠
もやし	m o̞ j a̠ ɕ i
もやす	m o̞ j a̠ s ɨᵝ
もよおす	m o̞ j o̞ː s ɨᵝ
もよりえき	m o̞ j o̞ ɾʲ i e̞ kʲ i
もらす	m o̞ ɾ a̠ s ɨᵝ
もりあげる	m o̞ ɾʲ i a̠ ɡ e̞ ɾ ɯ̟ᵝ
もれる	m o̞ ɾ e̞ ɾ ɯ̟ᵝ
もろい	m o̞ ɾ o̞ i
もん	m õ̞ ɴ
もんしろちょう	m õ̞ ɰ̃ ɕ i ɾ o̞ t͡ɕ o̞ː
もんじん	m õ̞ ɲ̟ d͡ʑ ĩ ɴ
もんだい	m õ̞ n d a̠ i
もんだいじ	m õ̞ n d a̠ i ʑ i
もんちゃく	m õ̞ ɲ̟ t͡ɕ a̠ k ɯ̟ᵝ
もんどう	m õ̞ n d o̞ː
やあ	j a̠ː
やいず	j a̠ i z ɨᵝ
やおい	j a̠ o̞ i
やおよろず	j a̠ o̞ j o̞ ɾ o̞ z ɨᵝ
やかい	j a̠ k a̠ i
やかた	j a̠ k a̠ t a̠
やから	j a̠ k a̠ ɾ a̠
やかん	j a̠ k ã̠ ɴ
やがい	j a̠ ɡ a̠ i
やきいも	j a̠ kʲ i i m o̞
やきば	j a̠ kʲ i b a̠
やぎ	j a̠ ɡʲ i
やく	j a̠ k ɯ̟ᵝ
やくご	j a̠ k ɯ̟ᵝ ɡ o̞
やくざ	j a̠ k ɯ̟ᵝ z a̠
やくすう	j a̠ k ɯ̟̊ᵝ s ɨᵝː
やくする	j a̠ k ɯ̟ᵝ s ɨᵝ ɾ ɯ̟ᵝ
やくそく	j a̠ k ɯ̟̊ᵝ s o̞ k ɯ̟ᵝ
やくだてる	j a̠ k ɯ̟ᵝ d a̠ t e̞ ɾ ɯ̟ᵝ
やくづくり	j a̠ k ɯ̟ᵝ z ɨᵝ k ɯ̟ᵝ ɾʲ i
やくどし	j a̠ k ɯ̟ᵝ d o̞ ɕ i
やくぶつらんよう	j a̠ k ɯ̟ᵝ b ɯ̟ᵝ t͡s ɨᵝ ɾ ã̠ ɰ̃ j o̞ː
やくぶん	j a̠ k ɯ̟ᵝ b ɯ̟̃ᵝ ɴ
やくも	j a̠ k ɯ̟ᵝ m o̞
やくりがく	j a̠ k ɯ̟ᵝ ɾʲ i ɡ a̠ k ɯ̟ᵝ
やぐ	j a̠ ɡ ɯ̟ᵝ
やけ	j a̠ k e̞
やけあと	j a̠ k e̞ a̠ t o̞
やけくそ	j a̠ k e̞ k ɯ̟ᵝ s o̞
やけど	j a̠ k e̞ d o̞
やける	j a̠ k e̞ ɾ ɯ̟ᵝ
やこ	j a̠ k o̞
やこぜん	j a̠ k o̞ z ẽ̞ ɴ
やご	j a̠ ɡ o̞
やさい	j a̠ s a̠ i
やさしい	j a̠ s a̠ ɕ i i
やし	j a̠ ɕ i
やしか	j a̠ ɕ i k a̠
やしろ	j a̠ ɕ i ɾ o̞
やじ	j a̠ ʑ i
やじゅうは	j a̠ ʑ ɨᵝː h a̠
やじん	j a̠ ʑ ĩ ɴ
やすい	j a̠ s ɨᵝ i
やすうり	j a̠ s ɨᵝ ɯ̟ᵝ ɾʲ i
やすげっきゅう	j a̠ s ɨᵝ ɡ e̞ k̚ʲ kʲ ɨᵝː
やすたか	j a̠ s ɨᵝ t a̠ k a̠
やすで	j a̠ s ɨᵝ d e̞
やすひろ	j a̠ s ɨᵝ ç i ɾ o̞
やすみ	j a̠ s ɨᵝ mʲ i
やすむ	j a̠ s ɨᵝ m ɯ̟ᵝ
やすめる	j a̠ s ɨᵝ m e̞ ɾ ɯ̟ᵝ
やすもの	j a̠ s ɨᵝ m o̞ n o̞
やすやど	j a̠ s ɨᵝ j a̠ d o̞
やすらぎ	j a̠ s ɨᵝ ɾ a̠ ɡʲ i
やせおとこ	j a̠ s e̞ o̞ t o̞ k o̞
やせん	j a̠ s ẽ̞ ɴ
やそきょう	j a̠ s o̞ kʲ o̞ː
やたら	j a̠ t a̠ ɾ a̠
やだいぼね	j a̠ d a̠ i b o̞ n e̞
やっかいばらい	j a̠ k̚ k a̠ i b a̠ ɾ a̠ i
やっき	j a̠ k̚ʲ kʲ i
やってくる	j a̠ t̚ t e̞ k ɯ̟ᵝ ɾ ɯ̟ᵝ
やっぱし	j a̠ p̚ p a̠ ɕ i
やっぱり	j a̠ p̚ p a̠ ɾʲ i
やつあたり	j a̠ t͡s ɨᵝ a̠ t a̠ ɾʲ i
やつぎばや	j a̠ t͡s ɨᵝ ɡʲ i b a̠ j a̠
やつめうなぎ	j a̠ t͡s ɨᵝ m e̞ ɯ̟ᵝ n a̠ ɡʲ i
やつら	j a̠ t͡s ɨᵝ ɾ a̠
やといぬし	j a̠ t o̞ i n ɯ̟ᵝ ɕ i
やに	j a̠ ɲ̟ i
やのあさって	j a̠ n o̞ a̠ s a̠ t̚ t e̞
やはり	j a̠ h a̠ ɾʲ i
やばい	j a̠ b a̠ i
やぶ	j a̠ b ɯ̟ᵝ
やぶこうじ	j a̠ b ɯ̟ᵝ k o̞ː ʑ i
やぶさめ	j a̠ b ɯ̟ᵝ s a̠ m e̞
やぶのなか	j a̠ b ɯ̟ᵝ n o̞ n a̠ k a̠
やぶる	j a̠ b ɯ̟ᵝ ɾ ɯ̟ᵝ
やま	j a̠ m a̠
やまい	j a̠ m a̠ i
やまいだれ	j a̠ m a̠ i d a̠ ɾ e̞
やまかわ	j a̠ m a̠ k a̠ ɰᵝ a̠
やまがた	j a̠ m a̠ ɡ a̠ t a̠
やまがら	j a̠ m a̠ ɡ a̠ ɾ a̠
やまぐち	j a̠ m a̠ ɡ ɯ̟ᵝ t͡ɕ i
やまたいこく	j a̠ m a̠ t a̠ i k o̞ k ɯ̟ᵝ
やまたかぼうし	j a̠ m a̠ t a̠ k a̠ b o̞ː ɕ i
やまつなみ	j a̠ m a̠ t͡s ɨᵝ n a̠ mʲ i
やまでら	j a̠ m a̠ d e̞ ɾ a̠
やまと	j a̠ m a̠ t o̞
やまとだましい	j a̠ m a̠ t o̞ d a̠ m a̠ ɕ iː
やまとなでしこ	j a̠ m a̠ t o̞ n a̠ d e̞ ɕ i k o̞
やまねこ	j a̠ m a̠ n e̞ k o̞
やまふだ	j a̠ m a̠ ɸ ɯ̟ᵝ d a̠
やまほど	j a̠ m a̠ h o̞ d o̞
やまわさび	j a̠ m a̠ ɰᵝ a̠ s a̠ bʲ i
やみ	j a̠ mʲ i
やみくも	j a̠ mʲ i k ɯ̟ᵝ m o̞
やみよ	j a̠ mʲ i j o̞
やむ	j a̠ m ɯ̟ᵝ
やむをえない	j a̠ m ɯ̟ᵝ o̞ e̞ n a̠ i
やめる	j a̠ m e̞ ɾ ɯ̟ᵝ
やもり	j a̠ m o̞ ɾʲ i
ややこしい	j a̠ j a̠ k o̞ ɕ iː
やよい	j a̠ j o̞ i
やらい	j a̠ ɾ a̠ i
やらせ	j a̠ ɾ a̠ s e̞
やられる	j a̠ ɾ a̠ ɾ e̞ ɾ ɯ̟ᵝ
やらん	j a̠ ɾ ã̠ ɴ
やりかた	j a̠ ɾʲ i k a̠ t a̠
やりくり	j a̠ ɾʲ i k ɯ̟ᵝ ɾʲ i
やりとげる	j a̠ ɾʲ i t o̞ ɡ e̞ ɾ ɯ̟ᵝ
やる	j a̠ ɾ ɯ̟ᵝ
やるき	j a̠ ɾ ɯ̟ᵝ kʲ i
やれやれ	j a̠ ɾ e̞ j a̠ ɾ e̞
やろう	j a̠ ɾ o̞ː
やわはだ	j a̠ ɰᵝ a̠ h a̠ d a̠
やわらかい	j a̠ ɰᵝ a̠ ɾ a̠ k a̠ i
やわらぐ	j a̠ ɰᵝ a̠ ɾ a̠ ɡ ɯ̟ᵝ
やわらげる	j a̠ ɰᵝ a̠ ɾ a̠ ɡ e̞ ɾ ɯ̟ᵝ
やんばるくいな	j ã̠ m b a̠ ɾ ɯ̟ᵝ k ɯ̟ᵝ i n a̠
ゆいしん	j ɯ̟ᵝ i ɕ ĩ ɴ
ゆう	j ɯ̟ᵝː
ゆううつ	j ɯ̟ᵝː ɯ̟ᵝ t͡s ɨᵝ
ゆうえつかん	j ɯ̟ᵝː e̞ t͡s ɨ̥ᵝ k ã̠ ɴ
ゆうえんち	j ɯ̟ᵝː ẽ̞ ɲ̟ t͡ɕ i
ゆうかい	j ɯ̟ᵝː k a̠ i
ゆうかいはん	j ɯ̟ᵝː k a̠ i h ã̠ ɴ
ゆうが	j ɯ̟ᵝː ɡ a̠
ゆうきたい	j ɯ̟ᵝː kʲ i t a̠ i
ゆうきゅうきゅうか	j ɯ̟ᵝː kʲ ɨᵝː kʲ ɨᵝː k a̠
ゆうぎ	j ɯ̟ᵝː ɡʲ i
ゆうけんしゃ	j ɯ̟ᵝː k ẽ̞ ɰ̃ ɕ a̠
ゆうこうてき	j ɯ̟ᵝː k o̞ː t e̞ kʲ i
ゆうさんそうんどう	j ɯ̟ᵝː s ã̠ ɰ̃ s o̞ ɯ̟̃ᵝ n d o̞ː
ゆうざい	j ɯ̟ᵝː z a̠ i
ゆうし	j ɯ̟ᵝː ɕ i
ゆうしゅう	j ɯ̟ᵝː ɕ ɨᵝː
ゆうしょく	j ɯ̟ᵝː ɕ o̞ k ɯ̟ᵝ
ゆうじ	j ɯ̟ᵝː ʑ i
ゆうじょう	j ɯ̟ᵝː ʑ o̞ː
ゆうすう	j ɯ̟ᵝː s ɨᵝː
ゆうすけ	j ɯ̟ᵝː s ɨᵝ k e̞
ゆうせい	j ɯ̟ᵝː s e̞ː
ゆうせいがく	j ɯ̟ᵝː s e̞ː ɡ a̠ k ɯ̟ᵝ
ゆうそう	j ɯ̟ᵝː s o̞ː
ゆうそくよみ	j ɯ̟ᵝː s o̞ k ɯ̟ᵝ j o̞ mʲ i
ゆうだち	j ɯ̟ᵝː d a̠ t͡ɕ i
ゆうでんたい	j ɯ̟ᵝː d ẽ̞ n t a̠ i
ゆうとう	j ɯ̟ᵝː t o̞ː
ゆうど	j ɯ̟ᵝː d o̞
ゆうどうだん	j ɯ̟ᵝː d o̞ː d ã̠ ɴ
ゆうどく	j ɯ̟ᵝː d o̞ k ɯ̟ᵝ
ゆうなぎ	j ɯ̟ᵝː n a̠ ɡʲ i
ゆうのう	j ɯ̟ᵝː n o̞ː
ゆうびんきょく	j ɯ̟ᵝː bʲ ĩ ŋʲ kʲ o̞ k ɯ̟ᵝ
ゆうぼくみん	j ɯ̟ᵝː b o̞ k ɯ̟ᵝ mʲ ĩ ɴ
ゆうめいじん	j ɯ̟ᵝː m e̞ː ʑ ĩ ɴ
ゆうや	j ɯ̟ᵝː j a̠
ゆうゆう	j ɯ̟ᵝː j ɯ̟ᵝː
ゆうよく	j ɯ̟ᵝː j o̞ k ɯ̟ᵝ
ゆうりょく	j ɯ̟ᵝː ɾʲ o̞ k ɯ̟ᵝ
ゆうれいやしき	j ɯ̟ᵝː ɾ e̞ː j a̠ ɕ i̥ kʲ i
ゆうれつ	j ɯ̟ᵝː ɾ e̞ t͡s ɨᵝ
ゆうわ	j ɯ̟ᵝː ɰᵝ a̠
ゆえに	j ɯ̟ᵝ e̞ ɲ̟ i
ゆえん	j ɯ̟ᵝ ẽ̞ ɴ
ゆか	j ɯ̟ᵝ k a̠
ゆかた	j ɯ̟ᵝ k a̠ t a̠
ゆかり	j ɯ̟ᵝ k a̠ ɾʲ i
ゆがみ	j ɯ̟ᵝ ɡ a̠ mʲ i
ゆき	j ɯ̟ᵝ kʲ i
ゆきこ	j ɯ̟ᵝ kʲ i k o̞
ゆきぞら	j ɯ̟ᵝ kʲ i z o̞ ɾ a̠
ゆきち	j ɯ̟ᵝ kʲ i t͡ɕ i
ゆきづまり	j ɯ̟ᵝ kʲ i z ɨᵝ m a̠ ɾʲ i
ゆきづまる	j ɯ̟ᵝ kʲ i z ɨᵝ m a̠ ɾ ɯ̟ᵝ
ゆきづり	j ɯ̟ᵝ kʲ i z ɨᵝ ɾʲ i
ゆきひろ	j ɯ̟ᵝ kʲ i ç i ɾ o̞
ゆくえ	j ɯ̟ᵝ k ɯ̟ᵝ e̞
ゆげ	j ɯ̟ᵝ ɡ e̞
ゆげん	j ɯ̟ᵝ ɡ ẽ̞ ɴ
ゆさん	j ɯ̟ᵝ s ã̠ ɴ
ゆしゅつ	j ɯ̟ᵝ ɕ ɨᵝ t͡s ɨᵝ
ゆず	j ɯ̟ᵝ z ɨᵝ
ゆずりあう	j ɯ̟ᵝ z ɨᵝ ɾʲ i a̠ ɯ̟ᵝ
ゆせい	j ɯ̟ᵝ s e̞ː
ゆたか	j ɯ̟ᵝ t a̠ k a̠
ゆだねる	j ɯ̟ᵝ d a̠ n e̞ ɾ ɯ̟ᵝ
ゆだんたいてき	j ɯ̟ᵝ d ã̠ n t a̠ i t e̞ kʲ i
ゆづる	j ɯ̟ᵝ z ɨᵝ ɾ ɯ̟ᵝ
ゆとう	j ɯ̟ᵝ t o̞ː
ゆとり	j ɯ̟ᵝ t o̞ ɾʲ i
ゆば	j ɯ̟ᵝ b a̠
ゆびわ	j ɯ̟ᵝ bʲ i ɰᵝ a̠
ゆめうつつ	j ɯ̟ᵝ m e̞ ɯ̟ᵝ t͡s ɨᵝ t͡s ɨᵝ
ゆもじ	j ɯ̟ᵝ m o̞ ʑ i
ゆらい	j ɯ̟ᵝ ɾ a̠ i
ゆり	j ɯ̟ᵝ ɾʲ i
ゆる	j ɯ̟ᵝ ɾ ɯ̟ᵝ
ゆるい	j ɯ̟ᵝ ɾ ɯ̟ᵝ i
ゆるぎ	j ɯ̟ᵝ ɾ ɯ̟ᵝ ɡʲ i
ゆるむ	j ɯ̟ᵝ ɾ ɯ̟ᵝ m ɯ̟ᵝ
ゆるめる	j ɯ̟ᵝ ɾ ɯ̟ᵝ m e̞ ɾ ɯ̟ᵝ
ゆるやか	j ɯ̟ᵝ ɾ ɯ̟ᵝ j a̠ k a̠
ゆわえつける	j ɯ̟ᵝ ɰᵝ a̠ e̞ t͡s ɨᵝ k e̞ ɾ ɯ̟ᵝ
ゆわえる	j ɯ̟ᵝ ɰᵝ a̠ e̞ ɾ ɯ̟ᵝ
よあつ	j o̞ a̠ t͡s ɨᵝ
よい	j o̞ i
よいしれる	j o̞ i ɕ i ɾ e̞ ɾ ɯ̟ᵝ
よいやみ	j o̞ i j a̠ mʲ i
よいゆめを	j o̞ i j ɯ̟ᵝ m e̞ o̞
ようか	j o̞ː k a̠
ようかい	j o̞ː k a̠ i
ようかん	j o̞ː k ã̠ ɴ
ようがっこう	j o̞ː ɡ a̠ k̚ k o̞ː
ようきし	j o̞ː kʲ i ɕ i
ようきょく	j o̞ː kʲ o̞ k ɯ̟ᵝ
ようきん	j o̞ː kʲ ĩ ɴ
ようぎょ	j o̞ː ɡʲ o̞
ようぐ	j o̞ː ɡ ɯ̟ᵝ
ようけいせいじゅく	j o̞ː k e̞ː s e̞ː ʑ ɨᵝ k ɯ̟ᵝ
ようこ	j o̞ː k o̞
ようこそ	j o̞ː k o̞ s o̞
ようしき	j o̞ː ɕ i kʲ i
ようしょう	j o̞ː ɕ o̞ː
ようしょく	j o̞ː ɕ o̞ k ɯ̟ᵝ
ようじ	j o̞ː ʑ i
ようじゅつ	j o̞ː ʑ ɨᵝ t͡s ɨᵝ
ようじょう	j o̞ː ʑ o̞ː
ようずみ	j o̞ː z ɨᵝ mʲ i
ようせい	j o̞ː s e̞ː
ようそ	j o̞ː s o̞
ようそろ	j o̞ː s o̞ ɾ o̞
ようだい	j o̞ː d a̠ i
ようちょう	j o̞ː t͡ɕ o̞ː
ようてん	j o̞ː t ẽ̞ ɴ
ようでんき	j o̞ː d ẽ̞ ŋʲ kʲ i
ようとん	j o̞ː t õ̞ ɴ
ようばい	j o̞ː b a̠ i
ようび	j o̞ː bʲ i
ようふう	j o̞ː ɸ ɯ̟ᵝː
ようへん	j o̞ː h ẽ̞ ɴ
ようやく	j o̞ː j a̠ k ɯ̟ᵝ
ようよう	j o̞ː j o̞ː
ようり	j o̞ː ɾʲ i
ようりょく	j o̞ː ɾʲ o̞ k ɯ̟ᵝ
ようりょくたい	j o̞ː ɾʲ o̞ k ɯ̟ᵝ t a̠ i
よき	j o̞ kʲ i
よぎ	j o̞ ɡʲ i
よぎり	j o̞ ɡʲ i ɾʲ i
よく	j o̞ k ɯ̟ᵝ
よくあさ	j o̞ k ɯ̟ᵝ a̠ s a̠
よくあつ	j o̞ k ɯ̟ᵝ a̠ t͡s ɨᵝ
よくあるしつもん	j o̞ k ɯ̟ᵝ a̠ ɾ ɯ̟ᵝ ɕ i t͡s ɨᵝ m õ̞ ɴ
よくばり	j o̞ k ɯ̟ᵝ b a̠ ɾʲ i
よくも	j o̞ k ɯ̟ᵝ m o̞
よくよう	j o̞ k ɯ̟ᵝ j o̞ː
よけい	j o̞ k e̞ː
よけん	j o̞ k ẽ̞ ɴ
よげん	j o̞ ɡ ẽ̞ ɴ
よこ	j o̞ k o̞
よこがみ	j o̞ k o̞ ɡ a̠ mʲ i
よこじま	j o̞ k o̞ ʑ i m a̠
よこす	j o̞ k o̞ s ɨᵝ
よこはば	j o̞ k o̞ h a̠ b a̠
よこはま	j o̞ k o̞ h a̠ m a̠
よこぶえ	j o̞ k o̞ b ɯ̟ᵝ e̞
よしあき	j o̞ ɕ i a̠ kʲ i
よしお	j o̞ ɕ i o̞
よしきり	j o̞ ɕ i̥ kʲ i ɾʲ i
よしこ	j o̞ ɕ i̥ k o̞
よしの	j o̞ ɕ i n o̞
よしひろ	j o̞ ɕ i ç i ɾ o̞
よしふみ	j o̞ ɕ i ɸ ɯ̟ᵝ mʲ i
よしゆき	j o̞ ɕ i j ɯ̟ᵝ kʲ i
よじじゅくご	j o̞ ʑ i d͡ʑ ɨᵝ k ɯ̟ᵝ ɡ o̞
よじせいく	j o̞ ʑ i s e̞ː k ɯ̟̊ᵝ
よじょうはん	j o̞ ʑ o̞ː h ã̠ ɴ
よす	j o̞ s ɨᵝ
よせ	j o̞ s e̞
よせい	j o̞ s e̞ː
よせつ	j o̞ s e̞ t͡s ɨᵝ
よせる	j o̞ s e̞ ɾ ɯ̟ᵝ
よそ	j o̞ s o̞
よそう	j o̞ s o̞ː
よそもの	j o̞ s o̞ m o̞ n o̞
よそゆき	j o̞ s o̞ j ɯ̟ᵝ kʲ i
よたか	j o̞ t a̠ k a̠
よだれかけ	j o̞ d a̠ ɾ e̞ k a̠ k e̞
よちょう	j o̞ t͡ɕ o̞ː
よっしゃ	j o̞ ɕː a̠
よつばい	j o̞ t͡s ɨᵝ b a̠ i
よどむ	j o̞ d o̞ m ɯ̟ᵝ
よなか	j o̞ n a̠ k a̠
よなが	j o̞ n a̠ ɡ a̠
よなよな	j o̞ n a̠ j o̞ n a̠
よは	j o̞ h a̠
よびかけ	j o̞ bʲ i k a̠ k e̞
よびかける	j o̞ bʲ i k a̠ k e̞ ɾ ɯ̟ᵝ
よびこう	j o̞ bʲ i k o̞ː
よぶ	j o̞ b ɯ̟ᵝ
よほう	j o̞ h o̞ː
よぼう	j o̞ b o̞ː
よみ	j o̞ mʲ i
よみあげる	j o̞ mʲ i a̠ ɡ e̞ ɾ ɯ̟ᵝ
よみがえる	j o̞ mʲ i ɡ a̠ e̞ ɾ ɯ̟ᵝ
よみこむ	j o̞ mʲ i k o̞ m ɯ̟ᵝ
よみだす	j o̞ mʲ i d a̠ s ɨᵝ
よみち	j o̞ mʲ i t͡ɕ i
よむ	j o̞ m ɯ̟ᵝ
よめ	j o̞ m e̞
よめい	j o̞ m e̞ː
よめいり	j o̞ m e̞ː ɾʲ i
よも	j o̞ m o̞
よもつしこめ	j o̞ m o̞ t͡s ɨᵝ ɕ i k o̞ m e̞
よやく	j o̞ j a̠ k ɯ̟ᵝ
より	j o̞ ɾʲ i
よりみち	j o̞ ɾʲ i mʲ i t͡ɕ i
よるがた	j o̞ ɾ ɯ̟ᵝ ɡ a̠ t a̠
よろい	j o̞ ɾ o̞ i
よろいどうし	j o̞ ɾ o̞ i d o̞ː ɕ i
よろける	j o̞ ɾ o̞ k e̞ ɾ ɯ̟ᵝ
よろこび	j o̞ ɾ o̞ k o̞ bʲ i
よろこぶ	j o̞ ɾ o̞ k o̞ b ɯ̟ᵝ
よろしい	j o̞ ɾ o̞ ɕ i i
よろしく	j o̞ ɾ o̞ ɕ i k ɯ̟ᵝ
よろしくおねがいします	j o̞ ɾ o̞ ɕ i k ɯ̟ᵝ o̞ n e̞ ɡ a̠ i ɕ i m a̠ s ɨ̥ᵝ
よわねをはく	j o̞ ɰᵝ a̠ n e̞ o̞ h a̠ k ɯ̟ᵝ
よわみ	j o̞ ɰᵝ a̠ mʲ i
よわめる	j o̞ ɰᵝ a̠ m e̞ ɾ ɯ̟ᵝ
よんきょくかん	j õ̞ ŋʲ kʲ o̞ k ɯ̟̊ᵝ k ã̠ ɴ
よんじゅう	j o̞ s o̞
らいう	ɾ a̠ i ɯ̟ᵝ
らいかん	ɾ a̠ i k ã̠ ɴ
らいき	ɾ a̠ i kʲ i
らいこう	ɾ a̠ i k o̞ː
らいねん	ɾ a̠ i n ẽ̞ ɴ
らいはん	ɾ a̠ i h ã̠ ɴ
らいひん	ɾ a̠ i ç ĩ ɴ
らぎょうへんかくかつよう	ɾ a̠ ɡʲ o̞ː
らく	ɾ a̠ k ɯ̟ᵝ
らくご	ɾ a̠ k ɯ̟ᵝ ɡ o̞
らくさん	ɾ a̠ k ɯ̟ᵝ s ã̠ ɴ
らくだ	ɾ a̠ k ɯ̟ᵝ d a̠
らくだい	ɾ a̠ k ɯ̟ᵝ d a̠ i
らくてんか	ɾ a̠ k ɯ̟ᵝ t ẽ̞ ŋ k a̠
らくてんしゅぎ	ɾ a̠ k ɯ̟ᵝ t ẽ̞ ɰ̃ ɕ ɨᵝ ɡʲ i
らくてんてき	ɾ a̠ k ɯ̟ᵝ t ẽ̞ n t e̞ kʲ i
らくよう	ɾ a̠ k ɯ̟ᵝ j o̞ː
らしゅう	ɾ a̠ ɕ ɨᵝː
らしんばん	ɾ a̠ ɕ ĩ m b ã̠ ɴ
らしんばんざ	ɾ a̠ ɕ ĩ m b ã̠ n d͡z a̠
らせん	ɾ a̠ s ẽ̞ ɴ
らせんけい	ɾ a̠ s ẽ̞ ŋ k e̞ː
らち	ɾ a̠ t͡ɕ i
らっかせい	ɾ a̠ k̚ k a̠ s e̞ː
らっぱすいせん	ɾ a̠ p̚ p a̠ z ɨᵝ i s ẽ̞ ɴ
らてい	ɾ a̠ t e̞ː
らぬきことば	ɾ a̠ n ɯ̟ᵝ kʲ i k o̞ t o̞ b a̠
らふく	ɾ a̠ ɸ ɯ̟ᵝ k ɯ̟ᵝ
らぶか	ɾ a̠ b ɯ̟ᵝ k a̠
らま	ɾ a̠ m a̠
らんおう	ɾ ã̠ ɰ̃ o̞ː
らんこく	ɾ ã̠ ŋ k o̞ k ɯ̟ᵝ
らんご	ɾ ã̠ ŋ ɡ o̞
らんさいぼう	ɾ ã̠ ɰ̃ s a̠ i b o̞ː
らんし	ɾ ã̠ ɰ̃ ɕ i
らんしゃ	ɾ ã̠ ɰ̃ ɕ a̠
らんしょ	ɾ ã̠ ɰ̃ ɕ o̞
らんちゅう	ɾ ã̠ ɲ̟ t͡ɕ ɨᵝː
らんちょう	ɾ ã̠ ɲ̟ t͡ɕ o̞ː
らんはんしゃ	ɾ ã̠ ɰ̃ h ã̠ ɰ̃ ɕ a̠
らんぱつ	ɾ ã̠ m p a̠ t͡s ɨᵝ
らんぼう	ɾ ã̠ m b o̞ː
らんまん	ɾ ã̠ mː ã̠ ɴ
りぇ	ɾʲ e̞
りえき	ɾʲ i e̞ kʲ i
りか	ɾʲ i k a̠
りかん	ɾʲ i k ã̠ ɴ
りがく	ɾʲ i ɡ a̠ k ɯ̟ᵝ
りがくりょうほう	ɾʲ i ɡ a̠ k ɯ̟ᵝ ɾʲ o̞ː h o̞ː
りき	ɾʲ i kʲ i
りきがくけい	ɾʲ i kʲ i ɡ a̠ k ɯ̟ᵝ k e̞ː
りきむ	ɾʲ i kʲ i m ɯ̟ᵝ
りくい	ɾʲ i k ɯ̟ᵝ i
りくそう	ɾʲ i k ɯ̟̊ᵝ s o̞ː
りくちゅう	ɾʲ i k ɯ̟̊ᵝ t͡ɕ ɨᵝː
りくつ	ɾʲ i k ɯ̟̊ᵝ t͡s ɨᵝ
りくつづき	ɾʲ i k ɯ̟̊ᵝ t͡s ɨᵝ z ɨᵝ kʲ i
りけい	ɾʲ i k e̞ː
りこしゅぎ	ɾʲ i k o̞ ɕ ɨᵝ ɡʲ i
りさん	ɾʲ i s ã̠ ɴ
りざや	ɾʲ i z a̠ j a̠
りしゅう	ɾʲ i ɕ ɨᵝː
りしょく	ɾʲ i ɕ o̞ k ɯ̟ᵝ
りそうきょう	ɾʲ i s o̞ː kʲ o̞ː
りそうしゅぎ	ɾʲ i s o̞ː ɕ ɨᵝ ɡʲ i
りっか	ɾʲ i k̚ k a̠
りっきゃくち	ɾʲ i k̚ʲ kʲ a̠ k ɯ̟ᵝ t͡ɕ i
りっきょう	ɾʲ i k̚ʲ kʲ o̞ː
りっこう	ɾʲ i k̚ k o̞ː
りっこうほ	ɾʲ i k̚ k o̞ː h o̞
りっしゅう	ɾʲ i ɕː ɯ̟ᵝː
りったいし	ɾʲ i t̚ t a̠ i ɕ i
りっとう	ɾʲ i t̚ t o̞ː
りっぱ	ɾʲ i p̚ p a̠
りっぽうこん	ɾʲ i p̚ p o̞ː k õ̞ ɴ
りっぽうたい	ɾʲ i p̚ p o̞ː t a̠ i
りつ	ɾʲ i t͡s ɨᵝ
りていひょう	ɾʲ i t e̞ː ç o̞ː
りゃく	ɾʲ a̠ k ɯ̟ᵝ
りゃくご	ɾʲ a̠ k ɯ̟ᵝ ɡ o̞
りゃくず	ɾʲ a̠ k ɯ̟ᵝ z ɨᵝ
りゃくだつ	ɾʲ a̠ k ɯ̟ᵝ d a̠ t͡s ɨᵝ
りゃくれき	ɾʲ a̠ k ɯ̟ᵝ ɾ e̞ kʲ i
りゅう	ɾʲ ɨᵝː
りゅういき	ɾʲ ɨᵝː i kʲ i
りゅうおん	ɾʲ ɨᵝː õ̞ ɴ
りゅうか	ɾʲ ɨᵝː k a̠
りゅうがく	ɾʲ ɨᵝː ɡ a̠ k ɯ̟ᵝ
りゅうがくせい	ɾʲ ɨᵝː ɡ a̠ k ɯ̟ᵝ s e̞ː
りゅうきょく	ɾʲ ɨᵝː kʲ o̞ k ɯ̟ᵝ
りゅうし	ɾʲ ɨᵝː ɕ i
りゅうしかそくき	ɾʲ ɨᵝː ɕ i k a̠ s o̞ k ɯ̟ᵝ kʲ i
りゅうじ	ɾʲ ɨᵝː ʑ i
りゅうせいう	ɾʲ ɨᵝː s e̞ː ɯ̟ᵝ
りゅうせんけい	ɾʲ ɨᵝː s ẽ̞ ŋ k e̞ː
りゅうぜんこう	ɾʲ ɨᵝː z ẽ̞ ŋ k o̞ː
りゅうたい	ɾʲ ɨᵝː t a̠ i
りゅうたろう	ɾʲ ɨᵝː t a̠ ɾ o̞ː
りゅうどう	ɾʲ ɨᵝː d o̞ː
りゅうは	ɾʲ ɨᵝː h a̠
りゅうめ	ɾʲ ɨᵝː m e̞
りゆう	ɾʲ i j ɯ̟ᵝː
りょう	ɾʲ o̞ː
りょういき	ɾʲ o̞ː i kʲ i
りょうかい	ɾʲ o̞ː k a̠ i
りょうが	ɾʲ o̞ː ɡ a̠
りょうきん	ɾʲ o̞ː kʲ ĩ ɴ
りょうきんじょ	ɾʲ o̞ː kʲ ĩ ɲ̟ d͡ʑ o̞
りょうくうしんぱん	ɾʲ o̞ː k ɯ̟ᵝː ɕ ĩ m p ã̠ ɴ
りょうけん	ɾʲ o̞ː k ẽ̞ ɴ
りょうげん	ɾʲ o̞ː ɡ ẽ̞ ɴ
りょうげんのひ	ɾʲ o̞ː ɡ ẽ̞ nː o̞ ç i
りょうさん	ɾʲ o̞ː s ã̠ ɴ
りょうし	ɾʲ o̞ː ɕ i
りょうしつ	ɾʲ o̞ː ɕ i t͡s ɨᵝ
りょうしゃ	ɾʲ o̞ː ɕ a̠
りょうじかん	ɾʲ o̞ː ʑ i k ã̠ ɴ
りょうじょく	ɾʲ o̞ː ʑ o̞ k ɯ̟ᵝ
りょうとり	ɾʲ o̞ː t o̞ ɾʲ i
りょうり	ɾʲ o̞ː ɾʲ i
りょうりしゅ	ɾʲ o̞ː ɾʲ i ɕ ɨᵝ
りょくちゃ	ɾʲ o̞ k ɯ̟ᵝ t͡ɕ a̠
りょっこう	ɾʲ o̞ k̚ k o̞ː
りよう	ɾʲ i j o̞ː
りようしゃ	ɾʲ i j o̞ː ɕ a̠
りりく	ɾʲ i ɾʲ i k ɯ̟ᵝ
りれき	ɾʲ i ɾ e̞ kʲ i
りれきしょ	ɾʲ i ɾ e̞ kʲ i ɕ o̞
りろ	ɾʲ i ɾ o̞
りん	ɾʲ ĩ ɴ
りんぎょう	ɾʲ ĩ ŋʲ ɡʲ o̞ː
りんしょう	ɾʲ ĩ ɰ̃ ɕ o̞ː
りんしょうしんりがく	ɾʲ ĩ ɰ̃ ɕ o̞ː ɕ ĩ n ɾʲ i ɡ a̠ k ɯ̟ᵝ
りんせつ	ɾʲ ĩ ɰ̃ s e̞ t͡s ɨᵝ
りんち	ɾʲ ĩ ɲ̟ t͡ɕ i
りんね	ɾʲ ĩ nː e̞
りんぴ	ɾʲ ĩ m pʲ i
りんり	ɾʲ ĩ n ɾʲ i
りんりがく	ɾʲ ĩ n ɾʲ i ɡ a̠ k ɯ̟ᵝ
るいごじてん	ɾ ɯ̟ᵝ i ɡ o̞ ʑ i t ẽ̞ ɴ
るいさん	ɾ ɯ̟ᵝ i s ã̠ ɴ
るいじ	ɾ ɯ̟ᵝ i ʑ i
れい	ɾ e̞ː
れいがい	ɾ e̞ː ɡ a̠ i
れいきゃくとう	ɾ e̞ː kʲ a̠ k ɯ̟ᵝ t o̞ː
れいきゅう	ɾ e̞ː kʲ ɨᵝː
れいげつ	ɾ e̞ː ɡ e̞ t͡s ɨᵝ
れいげん	ɾ e̞ː ɡ ẽ̞ ɴ
れいこん	ɾ e̞ː k õ̞ ɴ
れいさい	ɾ e̞ː s a̠ i
れいし	ɾ e̞ː ɕ i
れいじ	ɾ e̞ː ʑ i
れいすい	ɾ e̞ː s ɨᵝ i
れいせい	ɾ e̞ː s e̞ː
れいちゃ	ɾ e̞ː t͡ɕ a̠
れいちょう	ɾ e̞ː t͡ɕ o̞ː
れいてい	ɾ e̞ː t e̞ː
れいど	ɾ e̞ː d o̞
れいばい	ɾ e̞ː b a̠ i
れいむ	ɾ e̞ː m ɯ̟ᵝ
れいもつ	ɾ e̞ː m o̞ t͡s ɨᵝ
れき	ɾ e̞ kʲ i
れきしか	ɾ e̞ kʲ i ɕ i̥ k a̠
れきししゅうせいしゅぎ	ɾ e̞ kʲ i ɕ i ɕ ɨᵝː s e̞ː ɕ ɨᵝ ɡʲ i
れきししゅうせいしゅぎしゃ	ɾ e̞ kʲ i ɕ i ɕ ɨᵝː s e̞ː ɕ ɨᵝ ɡʲ i ɕ a̠
れきしてき	ɾ e̞ kʲ i ɕ i t e̞ kʲ i
れきせい	ɾ e̞ kʲ i̥ s e̞ː
れっか	ɾ e̞ k̚ k a̠
れっかいか	ɾ e̞ k̚ k a̠ i k a̠
れっきと	ɾ e̞ k̚ʲ kʲ i t o̞
れっし	ɾ e̞ ɕː i
れっとうかん	ɾ e̞ t̚ t o̞ː k ã̠ ɴ
れつ	ɾ e̞ t͡s ɨᵝ
れつあく	ɾ e̞ t͡s ɨᵝ a̠ k ɯ̟ᵝ
れんあい	ɾ ẽ̞ ɰ̃ a̠ i
れんが	ɾ ẽ̞ ŋ ɡ a̠
れんきんじゅつ	ɾ ẽ̞ ŋʲ kʲ ĩ ɲ̟ d͡ʑ ɨᵝ t͡s ɨᵝ
れんぎょ	ɾ ẽ̞ ŋʲ ɡʲ o̞
れんこ	ɾ ẽ̞ ŋ k o̞
れんこん	ɾ ẽ̞ ŋ k õ̞ ɴ
れんご	ɾ ẽ̞ ŋ ɡ o̞
れんごう	ɾ ẽ̞ ŋ ɡ o̞ː
れんしゅう	ɾ ẽ̞ ɰ̃ ɕ ɨᵝː
れんしゅうきょく	ɾ ẽ̞ ɰ̃ ɕ ɨᵝː kʲ o̞ k ɯ̟ᵝ
れんじょう	ɾ ẽ̞ ɲ̟ d͡ʑ o̞ː
れんち	ɾ ẽ̞ ɲ̟ t͡ɕ i
れんとう	ɾ ẽ̞ n t o̞ː
ろうあ	ɾ o̞ː a̠
ろうか	ɾ o̞ː k a̠
ろうかく	ɾ o̞ː k a̠ k ɯ̟ᵝ
ろうきゅう	ɾ o̞ː kʲ ɨᵝː
ろうし	ɾ o̞ː ɕ i
ろうしゃ	ɾ o̞ː ɕ a̠
ろうじん	ɾ o̞ː ʑ ĩ ɴ
ろうそく	ɾ o̞ː s o̞ k ɯ̟ᵝ
ろうと	ɾ o̞ː t o̞
ろうば	ɾ o̞ː b a̠
ろうほう	ɾ o̞ː h o̞ː
ろかい	ɾ o̞ k a̠ i
ろくじゅう	ɾ o̞ k ɯ̟ᵝ ʑ ɨᵝː
ろくぶんぎざ	ɾ o̞ k ɯ̟ᵝ b ɯ̟̃ᵝ ŋʲ ɡʲ i z a̠
ろしゅつけい	ɾ o̞ ɕ ɨᵝ t͡s ɨᵝ k e̞ː
ろそう	ɾ o̞ s o̞ː
ろだい	ɾ o̞ d a̠ i
ろだな	ɾ o̞ d a̠ n a̠
ろてい	ɾ o̞ t e̞ː
ろてんぶろ	ɾ o̞ t ẽ̞ m b ɯ̟ᵝ ɾ o̞
ろばん	ɾ o̞ b ã̠ ɴ
ろめんでんしゃ	ɾ o̞ m ẽ̞ n d ẽ̞ ɰ̃ ɕ a̠
ろわ	ɾ o̞ ɰᵝ a̠
ろんしょうきか	ɾ õ̞ ɰ̃ ɕ o̞ː kʲ i k a̠
ろんそう	ɾ õ̞ ɰ̃ s o̞ː
ろんぱ	ɾ õ̞ m p a̠
ろんり	ɾ õ̞ n ɾʲ i
わい	ɰᵝ a̠ i
わいろ	ɰᵝ a̠ i ɾ o̞
わかい	ɰᵝ a̠ k a̠ i
わかがえる	ɰᵝ a̠ k a̠ ɡ a̠ e̞ ɾ ɯ̟ᵝ
わかす	ɰᵝ a̠ k a̠ s ɨᵝ
わかとのばら	ɰᵝ a̠ k a̠ t o̞ n o̞ b a̠ ɾ a̠
わかな	ɰᵝ a̠ k a̠ n a̠
わかる	ɰᵝ a̠ k a̠ ɾ ɯ̟ᵝ
わかれ	ɰᵝ a̠ k a̠ ɾ e̞
わかれる	ɰᵝ a̠ k a̠ ɾ e̞ ɾ ɯ̟ᵝ
わかれをつげる	ɰᵝ a̠ k a̠ ɾ e̞ o̞ t͡s ɨᵝ ɡ e̞ ɾ ɯ̟ᵝ
わかわかしい	ɰᵝ a̠ k a̠ ɰᵝ a̠ k a̠ ɕ i i
わかんない	ɰᵝ a̠ k ã̠ nː a̠ i
わがはい	ɰᵝ a̠ ɡ a̠ h a̠ i
わがまま	ɰᵝ a̠ ɡ a̠ m a̠ m a̠
わき	ɰᵝ a̠ kʲ i
わきあがる	ɰᵝ a̠ kʲ i a̠ ɡ a̠ ɾ ɯ̟ᵝ
わきげ	ɰᵝ a̠ kʲ i ɡ e̞
わぎゅう	ɰᵝ a̠ ɡʲ ɨᵝː
わく	ɰᵝ a̠ k ɯ̟ᵝ
わくせい	ɰᵝ a̠ k ɯ̟ᵝ s e̞ː
わくせん	ɰᵝ a̠ k ɯ̟ᵝ s ẽ̞ ɴ
わけ	ɰᵝ a̠ k e̞
わけあたえる	ɰᵝ a̠ k e̞ a̠ t a̠ e̞ ɾ ɯ̟ᵝ
わけへだて	ɰᵝ a̠ k e̞ h e̞ d a̠ t e̞
わける	ɰᵝ a̠ k e̞ ɾ ɯ̟ᵝ
わごん	ɰᵝ a̠ ɡ õ̞ ɴ
わさび	ɰᵝ a̠ s a̠ bʲ i
わさん	ɰᵝ a̠ s ã̠ ɴ
わし	ɰᵝ a̠ ɕ i
わしばな	ɰᵝ a̠ ɕ i b a̠ n a̠
わしょ	ɰᵝ a̠ ɕ o̞
わすれがたみ	ɰᵝ a̠ s ɨᵝ ɾ e̞ ɡ a̠ t a̠ mʲ i
わすれなぐさ	ɰᵝ a̠ s ɨᵝ ɾ e̞ n a̠ ɡ ɯ̟ᵝ s a̠
わすれんぼう	ɰᵝ a̠ s ɨᵝ ɾ ẽ̞ m b o̞ː
わずらわしい	ɰᵝ a̠ z ɨᵝ ɾ a̠ ɰᵝ a̠ ɕ i i
わせ	ɰᵝ a̠ s e̞
わせいえいご	ɰᵝ a̠ s e̞ː e̞ː ɡ o̞
わせいかんご	ɰᵝ a̠ s e̞ː k ã̠ ŋ ɡ o̞
わそう	ɰᵝ a̠ s o̞ː
わた	ɰᵝ a̠ t a̠
わたくしする	ɰᵝ a̠ t a̠ k ɯ̟ᵝ ɕ i s ɨᵝ ɾ ɯ̟ᵝ
わたしたち	ɰᵝ a̠ t a̠ ɕ i̥ t a̠ t͡ɕ i
わたり	ɰᵝ a̠ t a̠ ɾʲ i
わたる	ɰᵝ a̠ t a̠ ɾ ɯ̟ᵝ
わちき	ɰᵝ a̠ t͡ɕ i kʲ i
わっそん	ɰᵝ a̠ sː õ̞ ɴ
わっぱ	ɰᵝ a̠ p̚ p a̠
わて	ɰᵝ a̠ t e̞
わに	ɰᵝ a̠ ɲ̟ i
わめい	ɰᵝ a̠ m e̞ː
わようちゅう	ɰᵝ a̠ j o̞ː t͡ɕ ɨᵝː
わら	ɰᵝ a̠ ɾ a̠
わらい	ɰᵝ a̠ ɾ a̠ i
わらじ	ɰᵝ a̠ ɾ a̠ ʑ i
わらべ	ɰᵝ a̠ ɾ a̠ b e̞
わらわ	ɰᵝ a̠ ɾ a̠ ɰᵝ a̠
わりあて	ɰᵝ a̠ ɾʲ i a̠ t e̞
わりきれる	ɰᵝ a̠ ɾʲ i kʲ i ɾ e̞ ɾ ɯ̟ᵝ
わりびき	ɰᵝ a̠ ɾʲ i bʲ i kʲ i
わる	ɰᵝ a̠ ɾ ɯ̟ᵝ
わるい	ɰᵝ a̠ ɾ ɯ̟ᵝ i
わるぎ	ɰᵝ a̠ ɾ ɯ̟ᵝ ɡʲ i
われ	ɰᵝ a̠ ɾ e̞
われら	ɰᵝ a̠ ɾ e̞ ɾ a̠
われる	ɰᵝ a̠ ɾ e̞ ɾ ɯ̟ᵝ
われわれ	ɰᵝ a̠ ɾ e̞ ɰᵝ a̠ ɾ e̞
わわる	ɰᵝ a̠ ɰᵝ a̠ ɾ ɯ̟ᵝ
わん	ɰᵝ ã̠ ɴ
わんさ	ɰᵝ ã̠ ɰ̃ s a̠
んで	n d e̞
んとする	n t o̞ s ɨᵝ ɾ ɯ̟ᵝ
ゔぇ	b e̞
ゔゃ	bʲ a̠
ゔゅ	bʲ ɨᵝ
ゔょ	bʲ o̞
