ᆯ지	ʎ t͡ɕ͈ i
ㄱㄴㄷ순	k a̠ n a̠ d a̠ sʰ u n
ㄴㄴ	n o̞ n o̞
ㅋㅋㅋ	k x ɯ k x ɯ k x ɯ
가가린	k a̠ ɡ a̠ ɾ i n
가감	k a̠ ɡ a̠ m
가게	k a̠ː ɡ e̞
가격	k a̠ ɡ j ʌ̹ k̚
가계	k a̠ ɡ j e̞
가공품	k a̠ ɡ o̞ ŋ pʰ u m
가구	k a̠ ɡ u
가깝다	k a̠ k͈ a̠ p̚ t͈ a̠
가끔	k a̠ k͈ ɯ m
가끔씩	k a̠ k͈ ɯ m ɕ͈ i k̚
가나	k a̠ n a̠
가난하다	k a̠ n a̠ n ɦ a̠ d a̠
가는쥐	k a̠ n ɯ ɲ d͡ʑ ɥ i
가늘다	k a̠ n ɯ ɭ d a̠
가늠	k a̠ n ɯ m
가늠하다	k a̠ n ɯ m ɦ a̠ d a̠
가능성	k a̠ː n ɯ ŋ s͈ ʌ̹ ŋ
가능하다	k a̠ː n ɯ ŋ ɦ a̠ d a̠
가독성	k a̠ d o̞ k s͈ ʌ̹ ŋ
가동	k a̠ d o̞ ŋ
가두리	k a̠ː d u ɾ i
가드	k a̠ d ɯ
가득	k a̠ d ɯ k̚
가득가득	k a̠ d ɯ k̚ k͈ a̠ d ɯ k̚
가득하다	k a̠ d ɯ kʰ a̠ d a̠
가따까나	k a̠ t͈ a̠ k͈ a̠ n a̠
가라데	k a̠ ɾ a̠ d e̞
가라오케	k a̠ ɾ a̠ o̞ kʰ e̞
가랑비	k a̠ ɾ a̠ ŋ b i
가령	k a̠ː ɾ j ʌ̹ ŋ
가로	k a̠ ɾ o̞
가로다	k a̠ ɾ o̞ d a̠
가로등	k a̠ ɾ o̞ d ɯ ŋ
가루	k a̠ ɾ u
가르치다	k a̠ ɾ ɯ t͡ɕʰ i d a̠
가르침	k a̠ ɾ ɯ t͡ɕʰ i m
가리다	k a̠ ɾ i d a̠
가리비	k a̠ ɾ i b i
가마솥	k a̠ m a̠ sʰ o̞ t̚
가마우지	k a̠ m a̠ u d͡ʑ i
가만	k a̠ m a̠ n
가만가만	k a̠ m a̠ n ɡ a̠ m a̠ n
가만두다	k a̠ m a̠ n d u d a̠
가만히	k a̠ m a̠ n ʝ i
가맣다	k a̠ː m a̠ tʰ a̠
가면	k a̠ː m j ʌ̹ n
가면극	k a̠ː m j ʌ̹ n ɡ ɯ k̚
가명	k a̠ː m j ʌ̹ ŋ
가무	k a̠ m u
가무이야기	k a̠ m u i j a̠ ɡ i
가문	k a̠ m u n
가물가물	k a̠ m u ɭ ɡ a̠ m u ɭ
가물치	k a̠ m u ʎ t͡ɕʰ i
가뭄	k a̠ m u m
가방	k a̠ b a̠ ŋ
가보	k a̠ b o̞
가봉	k a̠ b o̞ ŋ
가부좌	k a̠ b u d͡ʑ w a̠
가브리엘	k a̠ b ɯ ɾ i e̞ ɭ
가사	k a̠ sʰ a̠
가산	k a̠ sʰ a̠ n
가세	k a̠ sʰ e̞
가숭어	k a̠ː sʰ u ŋ ʌ̹
가스	k͈ a̠ sʰ ɯ
가시	k a̠ ɕʰ i
가시고기	k a̠ ɕʰ i ɡ o̞ ɡ i
가시나	k a̠ ɕʰ i n a̠
가시나무	k a̠ ɕʰ i n a̠ m u
가시다	k a̠ ɕʰ i d a̠
가시아버지	k a̠ ɕʰ i a̠ b ʌ̹ d͡ʑ i
가시화	k a̠ ɕʰ i β w a̠
가식	k a̠ː ɕʰ i k̚
가야금	k a̠ j a̠ ɡ ɯ m
가엾다	k a̠ː j ʌ̹ p̚ t͈ a̠
가운데	k a̠ u n d e̞
가운데소리	k a̠ u n d e̞ sʰ o̞ ɾ i
가위	k a̠ ɥ i
가위바위보	k a̠ ɥ i b a̠ ɥ i b o̞
가을	k a̠ ɯ ɭ
가을철	k a̠ ɯ ʎ t͡ɕʰ ʌ̹ ɭ
가이드	k a̠ i d ɯ
가자	k a̠ d͡ʑ a̠
가장자리	k a̠ː d͡ʑ a̠ ŋ d͡ʑ a̠ ɾ i
가정법	k a̠ː d͡ʑ ʌ̹ ŋ p͈ ʌ̹ p̚
가제	k a̠ d͡ʑ e̞
가제따	k a̠ d͡ʑ e̞ t͈ a̠
가젤	k a̠ d͡ʑ e̞ ɭ
가져가다	k a̠ d͡ʑ ʌ̹ ɡ a̠ d a̠
가져오다	k a̠ d͡ʑ ʌ̹ o̞ d a̠
가지	k a̠ d͡ʑ i
가지고	k a̠ d͡ʑ i ɡ o̞
가지다	k a̠ d͡ʑ i d a̠
가지뿔	k a̠ d͡ʑ i p͈ u ɭ
가차	k a̠ t͡ɕʰ a̠
가축	k a̠ t͡ɕʰ u k̚
가톨릭	k a̠ tʰ o̞ ʎ ʎ i k̚
가톨릭교회	k a̠ tʰ o̞ ʎ ʎ i k̚ k͈ j o β w e̞
가파르다	k a̠ pʰ a̠ ɾ ɯ d a̠
가히	k a̠ː ʝ i
각국	k a̠ k̚ k͈ u k̚
각기	k a̠ k̚ k͈ i
각다귀	k a̠ k̚ t͈ a̠ ɡ ɥ i
각도	k a̠ k̚ t͈ o̞
각막	k a̠ ŋ m a̠ k̚
각본	k a̠ k̚ p͈ o̞ n
각선미	k a̠ k s͈ ʌ̹ n m i
각설	k a̠ k s͈ ʌ̹ ɭ
각시	k a̠ k ɕ͈ i
각자	k a̠ k̚ t͡ɕ͈ a̠
각종	k a̠ k̚ t͡ɕ͈ o̞ ŋ
각하	k a̠ kʰ a̠
간간이	k a̠ n ɡ a̠ n i
간극	k a̠ n ɡ ɯ k̚
간단히	k a̠ n d a̠ n ʝ i
간드리	k a̠ n d ɯ ɾ i
간부	k a̠ n b u
간사	k a̠ n sʰ a̠
간사하다	k a̠ n sʰ a̠ ɦ a̠ d a̠
간선도로	k a̠ n sʰ ʌ̹ n d o̞ ɾ o̞
간성	k a̠ n sʰ ʌ̹ ŋ
간식	k a̠ː n ɕʰ i k̚
간악하다	k a̠ n a̠ kʰ a̠ d a̠
간유	k a̠ː ɲ j u
간음	k a̠ː n ɯ m
간절	k a̠ ɲ d͡ʑ ʌ̹ ɭ
간접	k a̠ː ɲ d͡ʑ ʌ̹ p̚
간주	k a̠ː ɲ d͡ʑ u
간지	k a̠ ɲ d͡ʑ i
간지럼	k a̠ ɲ d͡ʑ i ɾ ʌ̹ m
간질	k a̠ː ɲ d͡ʑ i ɭ
간질거리다	k a̠ ɲ d͡ʑ i ɭ ɡ ʌ̹ ɾ i d a̠
간질이다	k a̠ ɲ d͡ʑ i ɾ i d a̠
간첩	k a̠ː ɲ t͡ɕʰ ʌ̹ p̚
간체	k a̠ ɲ t͡ɕʰ e̞
간통	k a̠ː n tʰ o̞ ŋ
간판	k a̠ n pʰ a̠ n
간편하다	k a̠ n pʰ j ʌ̹ n ɦ a̠ d a̠
간헐천	k a̠ː n ɦ ʌ̹ ʎ t͡ɕʰ ʌ̹ n
간호사	k a̠ n β o̞ sʰ a̠
간혹	k a̠ː n β o̞ k̚
갈고	k a̠ ɭ ɡ o̞
갈기	k a̠ː ɭ ɡ i
갈등	k a̠ ɭ t͈ ɯ ŋ
갈륨	k a̠ ʎ ʎ j u m
갈리시아	k a̠ ʎ ʎ i ɕʰ i a̠
갈림길	k a̠ ʎ ʎ i m k͈ i ɭ
갈망	k a̠ ɭ m a̠ ŋ
갈망하다	k a̠ ɭ m a̠ ŋ ɦ a̠ d a̠
갈비	k a̠ ɭ b i
갈비뼈	k a̠ ɭ b i p͈ j ʌ̹
갈비탕	k a̠ ɭ b i tʰ a̠ ŋ
갈수록	k a̠ ɭ s͈ u ɾ o̞ k̚
갈아타다	k a̠ ɾ a̠ tʰ a̠ d a̠
갈증	k a̠ ʎ t͡ɕ͈ ɯ ŋ
갉다	k a̠ k̚ t͈ a̠
감각	k a̠ː m ɡ a̠ k̚
감각적	k a̠ m ɡ a̠ k̚ t͡ɕ͈ ʌ̹ k̚
감금	k a̠ m ɡ ɯ m
감기	k a̠ː m ɡ i
감당	k a̠ m d a̠ ŋ
감당하다	k a̠ m d a̠ ŋ ɦ a̠ d a̠
감동	k a̠ː m d o̞ ŋ
감리교	k a̠ m n i ɡ j o
감마	k a̠ m m a̠
감명	k a̠ m m j ʌ̹ ŋ
감미료	k a̠ m m i ɾ j o
감방	k a̠ m b a̠ ŋ
감사하다	k a̠ː m sʰ a̠ ɦ a̠ d a̠
감상	k a̠ m sʰ a̠ ŋ
감소	k a̠ː m sʰ o̞
감수하다	k a̠ː m sʰ u ɦ a̠ d a̠
감시	k a̠ m ɕʰ i
감시하다	k a̠ m ɕʰ i ɦ a̠ d a̠
감안	k a̠ m a̠ n
감염	k a̠ː m j ʌ̹ m
감옥	k a̠ m o̞ k̚
감자튀김	k a̠ m d͡ʑ a̠ tʰ ɥ i ɡ i m
감전	k a̠ː m d͡ʑ ʌ̹ n
감정	k a̠ː m d͡ʑ ʌ̹ ŋ
감초	k a̠ m t͡ɕʰ o̞
감탄	k a̠ː m tʰ a̠ n
갑분싸	k a̠ p̚ p͈ u n s͈ a̠
갑자기	k a̠ p̚ t͡ɕ͈ a̠ ɡ i
갑작스레	k a̠ p̚ t͡ɕ͈ a̠ k s͈ ɯ ɾ e̞
갑충	k a̠ p̚ t͡ɕʰ u ŋ
갑판	k a̠ p̚ pʰ a̠ n
강가	k a̠ ŋ k͈ a̠
강간	k a̠ː ŋ ɡ a̠ n
강간하다	k a̠ː ŋ ɡ a̠ n ɦ a̠ d a̠
강경	k a̠ ŋ ɡ j ʌ̹ ŋ
강국	k a̠ ŋ ɡ u k̚
강당	k a̠ː ŋ d a̠ ŋ
강력	k a̠ ŋ ɲ j ʌ̹ k̚
강력하다	k a̠ ŋ ɲ j ʌ̹ kʰ a̠ d a̠
강렬하다	k a̠ ŋ ɲ j ʌ̹ ɾ ɦ a̠ d a̠
강림	k a̠ː ŋ n i m
강물	k a̠ ŋ m u ɭ
강변	k a̠ ŋ b j ʌ̹ n
강설	k a̠ː ŋ sʰ ʌ̹ ɭ
강세	k a̠ ŋ sʰ e̞
강수	k a̠ː ŋ sʰ u
강아지	k a̠ ŋ a̠ d͡ʑ i
강아지풀	k a̠ ŋ a̠ d͡ʑ i pʰ u ɭ
강요	k a̠ː ŋ j o
강요하다	k a̠ː ŋ j o ɦ a̠ d a̠
강원도	k a̠ ŋ w ʌ̹ n d o̞
강의	k a̠ː ŋ ɰ i
강점기	k a̠ː ŋ d͡ʑ ʌ̹ m ɡ i
강정	k a̠ ŋ d͡ʑ ʌ̹ ŋ
강제	k a̠ː ŋ d͡ʑ e̞
강조하다	k a̠ ŋ d͡ʑ o̞ ɦ a̠ d a̠
강준치	k a̠ ŋ d͡ʑ u ɲ t͡ɕʰ i
강철	k a̠ ŋ t͡ɕʰ ʌ̹ ɭ
강추	k a̠ ŋ t͡ɕʰ u
강판	k a̠ ŋ pʰ a̠ n
강하다	k a̠ ŋ ɦ a̠ d a̠
강화도	k a̠ ŋ β w a̠ d o̞
갖가지	k a̠ t̚ k͈ a̠ d͡ʑ i
갖다	k a̠ t̚ t͈ a̠
같다	k a̠ t̚ t͈ a̠
같은	k a̠ tʰ ɯ n
같이	k a̠ t͡ɕʰ i
같이하다	k a̠ t͡ɕʰ i ɦ a̠ d a̠
같잖다	k a̠ t̚ t͡ɕ͈ a̠ n tʰ a̠
갚다	k a̠ p̚ t͈ a̠
개고기	k ɛː ɡ o̞ ɡ i
개나리	k ɛː n a̠ ɾ i
개나리꽃	k ɛː n a̠ ɾ i k͈ o̞ t̚
개다	k ɛː d a̠
개량	k ɛː ɾ j a̠ ŋ
개성	k ɛː sʰ ʌ̹ ŋ
개수	k ɛː s͈ u
개요	k ɛː j o
개인적	k ɛː i ɲ d͡ʑ ʌ̹ k̚
개정판	k ɛː d͡ʑ ʌ̹ ŋ pʰ a̠ n
개천	k ɛː t͡ɕʰ ʌ̹ n
개체	k ɛː t͡ɕʰ e̞
개판	k ɛː pʰ a̠ n
개혁	k ɛː ʝ j ʌ̹ k̚
갸웃거리다	k j a̠ u t̚ k͈ ʌ̹ ɾ i d a̠
갹출	k j a̠ k̚ t͡ɕʰ u ɭ
거기	k ʌ̹ ɡ i
거드름	k ɘː d ɯ ɾ ɯ m
거든	k ʌ̹ d ɯ n
거듭	k ʌ̹ d ɯ p̚
거뜨다	k ʌ̹ t͈ ɯ d a̠
거리다	k ʌ̹ ɾ i d a̠
거릿모테이	k ʌ̹ ɾ i n m o̞ tʰ e̞ i
거만	k ɘː m a̠ n
거만하다	k ɘː m a̠ n ɦ a̠ d a̠
거머리	k ɘː m ʌ̹ ɾ i
거문고	k ʌ̹ m u n ɡ o̞
거미	k ʌ̹ m i
거미줄	k ʌ̹ m i d͡ʑ u ɭ
거부하다	k ɘː b u ɦ a̠ d a̠
거북선	k ʌ̹ b u k s͈ ʌ̹ n
거북이	k ʌ̹ b u ɡ i
거성	k ɘː sʰ ʌ̹ ŋ
거세	k ɘː sʰ e̞
거세다	k ʌ̹ sʰ e̞ d a̠
거스러미	k ʌ̹ sʰ ɯ ɾ ʌ̹ m i
거스름돈	k ʌ̹ sʰ ɯ ɾ ɯ m t͈ o̞ n
거슬리다	k ʌ̹ sʰ ɯ ʎ ʎ i d a̠
거시기	k ʌ̹ ɕʰ i ɡ i
거실	k ʌ̹ ɕʰ i ɭ
거야	k ɘː j a̠
거역	k ɘː j ʌ̹ k̚
거울	k ʌ̹ u ɭ
거유	k ɘː j u
거의	k ʌ̹ ɰ i
거인	k ɘː i n
거절	k ɘː d͡ʑ ʌ̹ ɭ
거주	k ʌ̹ d͡ʑ u
거주하다	k ʌ̹ d͡ʑ u ɦ a̠ d a̠
거즈	k ʌ̹ d͡ʑ ɯ
거지	k ɘː d͡ʑ i
거짓	k ɘː d͡ʑ i t̚
거짓말	k ɘː d͡ʑ i n m a̠ ɭ
거치적거리다	k ʌ̹ t͡ɕʰ i d͡ʑ ʌ̹ k̚ k͈ ʌ̹ ɾ i d a̠
거칠다	k ʌ̹ t͡ɕʰ i ɭ d a̠
거품	k ʌ̹ pʰ u m
걱정	k ʌ̹ k̚ t͡ɕ͈ ʌ̹ ŋ
건강	k ɘː n ɡ a̠ ŋ
건강하다	k ɘː n ɡ a̠ ŋ ɦ a̠ d a̠
건강히	k ɘː n ɡ a̠ ŋ ʝ i
건너가다	k ɘː n n ʌ̹ ɡ a̠ d a̠
건너다	k ɘː n n ʌ̹ d a̠
건너편	k ɘː n n ʌ̹ pʰ j ʌ̹ n
건넌편	k ɘː n n ʌ̹ n pʰ j ʌ̹ n
건널목	k ɘː n n ʌ̹ ɭ m o̞ k̚
건네다	k ɘː n n e̞ d a̠
건답	k ʌ̹ n d a̠ p̚
건더기	k ʌ̹ n d ʌ̹ ɡ i
건반	k ʌ̹ n b a̠ n
건설	k ɘː n sʰ ʌ̹ ɭ
건설하다	k ɘː n sʰ ʌ̹ ɾ ɦ a̠ d a̠
건의	k ɘː n ɰ i
건전하다	k ʌ̹ ɲ d͡ʑ ʌ̹ n ɦ a̠ d a̠
건조	k ʌ̹ ɲ d͡ʑ o̞
건조기	k ʌ̹ ɲ d͡ʑ o̞ ɡ i
건조하다	k ʌ̹ ɲ d͡ʑ o̞ ɦ a̠ d a̠
건지다	k ʌ̹ ɲ d͡ʑ i d a̠
건축	k ɘː ɲ t͡ɕʰ u k̚
건축가	k ɘː ɲ t͡ɕʰ u k̚ k͈ a̠
건축물	k ɘː ɲ t͡ɕʰ u ŋ m u ɭ
걸다	k ɘː ɭ d a̠
걸레	k ʌ̹ ɭ ɭ e̞
걸리다	k ʌ̹ ʎ ʎ i d a̠
걸신	k ʌ̹ ɭ ɕ͈ i n
걸어	k ʌ̹ ɾ ʌ̹
걸어가다	k ʌ̹ ɾ ʌ̹ ɡ a̠ d a̠
걸음	k ʌ̹ ɾ ɯ m
걸음마	k ʌ̹ ɾ ɯ m m a̠
걸인	k ʌ̹ ɾ i n
걸치다	k ɘː ʎ t͡ɕʰ i d a̠
걸프렌드	k ʌ̹ ɭ pʰ ɯ ɾ e̞ n d ɯ
걸핏	k ʌ̹ ɭ pʰ i t̚
검다	k ɘː m t͈ a̠
검도	k ɘː m d o̞
검독수리	k ʌ̹ m d o̞ k s͈ u ɾ i
검둥오리	k ʌ̹ m d u ŋ o̞ ɾ i
검둥오리사촌	k ʌ̹ m d u ŋ o̞ ɾ i sʰ a̠ t͡ɕʰ o̞ n
검둥이	k ʌ̹ m d u ŋ i
검사	k ɘː m sʰ a̠
검소하다	k ɘː m sʰ o̞ ɦ a̠ d a̠
검술	k ɘː m sʰ u ɭ
검역	k ɘː m j ʌ̹ k̚
검열	k ɘː m ɲ j ʌ̹ ɭ
검은금	k ʌ̹ m ɯ n ɡ ɯ m
검은딸기	k ʌ̹ m ɯ n t͈ a̠ ɭ ɡ i
검은머리흰죽지	k ʌ̹ m ɯ n m ʌ̹ ɾ i ʝ i ɲ d͡ʑ u k̚ t͡ɕ͈ i
검정	k ʌ̹ m d͡ʑ ʌ̹ ŋ
검정망둑	k ʌ̹ m d͡ʑ ʌ̹ ŋ m a̠ ŋ d u k̚
검토	k ɘː m tʰ o̞
겉핥다	k ʌ̹ tʰ a̠ ɭ t͈ a̠
게다가	k e̞ d a̠ ɡ a̠
게르마늄	k e̞ ɾ ɯ m a̠ ɲ j u m
게르만	k e̞ ɾ ɯ m a̠ n
게릴라	k e̞ ɾ i ɭ ɭ a̠
게스트하우스	k e̞ sʰ ɯ tʰ ɯ ɦ a̠ u sʰ ɯ
게시	k e̞ː ɕʰ i
게시판	k e̞ː ɕʰ i pʰ a̠ n
게시하다	k e̞ː ɕʰ i ɦ a̠ d a̠
게으르다	k e̞ ɯ ɾ ɯ d a̠
게으름	k e̞ ɯ ɾ ɯ m
게이샤	k e̞ i ɕʰ a̠
게이트	k e̞ i tʰ ɯ
게임	k͈ e̞ i m
게임기	k͈ e̞ i m ɡ i
게장	k e̞ d͡ʑ a̠ ŋ
겨누다	k j ʌ̹ n u d a̠
겨드랑이	k j ʌ̹ d ɯ ɾ a̠ ŋ i
겨레	k j ʌ̹ ɾ e̞
겨루다	k j ʌ̹ ɾ u d a̠
겨를	k j ʌ̹ ɾ ɯ ɭ
겨우	k j ʌ̹ u
겨울철	k j ʌ̹ u ʎ t͡ɕʰ ʌ̹ ɭ
겨자	k j ʌ̹ d͡ʑ a̠
격납고	k j ʌ̹ ŋ n a̠ p̚ k͈ o̞
격려	k j ʌ̹ ŋ ɲ j ʌ̹
격리	k j ʌ̹ ŋ n i
격언	k j ʌ̹ ɡ ʌ̹ n
겪다	k j ʌ̹ k̚ t͈ a̠
견디다	k j ʌ̹ n d i d a̠
견본	k j ɘː n b o̞ n
견유	k j ʌ̹ ɲ j u
견주다	k j ʌ̹ ɲ d͡ʑ u d a̠
결론	k j ʌ̹ ɭ ɭ o̞ n
결심	k j ʌ̹ ɭ ɕ͈ i m
결장	k j ʌ̹ ʎ t͡ɕ͈ a̠ ŋ
결정	k j ʌ̹ ʎ t͡ɕ͈ ʌ̹ ŋ
결정되다	k j ʌ̹ ʎ t͡ɕ͈ ʌ̹ ŋ d w e̞ d a̠
결정론	k j ʌ̹ ʎ t͡ɕ͈ ʌ̹ ŋ n o̞ n
결정짓다	k j ʌ̹ ʎ t͡ɕ͈ ʌ̹ ŋ d͡ʑ i t̚ t͈ a̠
결정하다	k j ʌ̹ ʎ t͡ɕ͈ ʌ̹ ŋ ɦ a̠ d a̠
결코	k j ʌ̹ ɭ kʰ o̞
결핍	k j ʌ̹ ɭ pʰ i p̚
결함	k j ʌ̹ ɾ ɦ a̠ m
결합	k j ʌ̹ ɾ ɦ a̠ p̚
결합되다	k j ʌ̹ ɾ ɦ a̠ p̚ t͈ w e̞ d a̠
결혼	k j ʌ̹ ɾ β o̞ n
겸손	k j ʌ̹ m sʰ o̞ n
겸손하다	k j ʌ̹ m sʰ o̞ n ɦ a̠ d a̠
겹다	k j ɘː p̚ t͈ a̠
경계	k j ʌ̹ ŋ ɡ j e̞
경고	k j ɘː ŋ ɡ o̞
경고창	k j ɘː ŋ ɡ o̞ t͡ɕʰ a̠ ŋ
경고하다	k j ɘː ŋ ɡ o̞ ɦ a̠ d a̠
경관	k j ʌ̹ ŋ ɡ w a̠ n
경구	k j ɘː ŋ k͈ u
경기도	k j ʌ̹ ŋ ɡ i d o̞
경기장	k j ɘː ŋ ɡ i d͡ʑ a̠ ŋ
경력	k j ʌ̹ ŋ ɲ j ʌ̹ k̚
경로	k j ʌ̹ ŋ n o̞
경멸적	k j ʌ̹ ŋ m j ʌ̹ ʎ t͡ɕ͈ ʌ̹ k̚
경보기	k j ɘː ŋ b o̞ ɡ i
경비원	k j ɘː ŋ b i w ʌ̹ n
경상남도	k j ɘː ŋ sʰ a̠ ŋ n a̠ m d o̞
경상도	k j ɘː ŋ sʰ a̠ ŋ d o̞
경성	k j ʌ̹ ŋ sʰ ʌ̹ ŋ
경시	k j ʌ̹ ŋ ɕʰ i
경악	k j ʌ̹ ŋ a̠ k̚
경어	k j ɘː ŋ ʌ̹
경영	k j ʌ̹ ŋ j ʌ̹ ŋ
경영자	k j ʌ̹ ŋ j ʌ̹ ŋ d͡ʑ a̠
경영하다	k j ʌ̹ ŋ j ʌ̹ ŋ ɦ a̠ d a̠
경외	k j ɘː ŋ w e̞
경우	k j ʌ̹ ŋ u
경이롭다	k j ʌ̹ ŋ i ɾ o̞ p̚ t͈ a̠
경제	k j ʌ̹ ŋ d͡ʑ e̞
경제적	k j ʌ̹ ŋ d͡ʑ e̞ d͡ʑ ʌ̹ k̚
경주	k j ɘː ŋ d͡ʑ u
경찰	k j ɘː ŋ t͡ɕʰ a̠ ɭ
경찰서	k j ɘː ŋ t͡ɕʰ a̠ ɭ s͈ ʌ̹
경청	k j ʌ̹ ŋ t͡ɕʰ ʌ̹ ŋ
경축	k j ɘː ŋ t͡ɕʰ u k̚
경치	k j ʌ̹ ŋ t͡ɕʰ i
경향	k j ʌ̹ ŋ ʝ j a̠ ŋ
경험	k j ʌ̹ ŋ ɦ ʌ̹ m
경험하다	k j ʌ̹ ŋ ɦ ʌ̹ m ɦ a̠ d a̠
계간	k j e̞ ɡ a̠ n
계곡	k j e̞ ɡ o̞ k̚
계급	k j e̞ ɡ ɯ p̚
계단	k j e̞ d a̠ n
계란	k j e̞ ɾ a̠ n
계란찜	k j e̞ ɾ a̠ ɲ t͡ɕ͈ i m
계량경제학	k j e̞ː ɾ j a̠ ŋ ɡ j ʌ̹ ŋ d͡ʑ e̞ ɦ a̠ k̚
계렬	k j e̞ ɾ j ʌ̹ ɭ
계모	k j e̞ː m o̞
계산	k j e̞ː sʰ a̠ n
계산기	k j e̞ː sʰ a̠ n ɡ i
계산서	k j e̞ː sʰ a̠ n sʰ ʌ̹
계산원	k j e̞ː sʰ a̠ n w ʌ̹ n
계속	k j e̞ː sʰ o̞ k̚
계속하다	k j e̞ː sʰ o̞ kʰ a̠ d a̠
계수	k j e̞ː sʰ u
계승	k j e̞ sʰ ɯ ŋ
계시	k j e̞ː ɕʰ i
계시다	k j e̞ː ɕʰ i d a̠
계약	k j e̞ː j a̠ k̚
계열	k j e̞ j ʌ̹ ɭ
계절	k j e̞ː d͡ʑ ʌ̹ ɭ
계절적	k j e̞ː d͡ʑ ʌ̹ ʎ t͡ɕ͈ ʌ̹ k̚
계정	k j e̞ː d͡ʑ ʌ̹ ŋ
계좌	k j e̞ː d͡ʑ w a̠
계층	k j e̞ t͡ɕʰ ɯ ŋ
계통	k j e̞ː tʰ o̞ ŋ
고가교	k o̞ ɡ a̠ ɡ j o
고고학	k o̞ː ɡ o̞ ɦ a̠ k̚
고관	k o̞ ɡ w a̠ n
고구려	k o̞ ɡ u ɾ j ʌ̹
고구마	k o̞ː ɡ u m a̠
고국	k o̞ː ɡ u k̚
고급	k o̞ ɡ ɯ p̚
고기겹빵	k o̞ ɡ i ɡ j ʌ̹ p̚ p͈ a̠ ŋ
고난	k o̞ n a̠ n
고니	k o̞ n i
고달피다	k o̞ d a̠ ɭ pʰ i d a̠
고독	k o̞ d o̞ k̚
고독하다	k o̞ d o̞ kʰ a̠ d a̠
고등어	k o̞ d ɯ ŋ ʌ̹
고등학교	k o̞ d ɯ ŋ ɦ a̠ k̚ k͈ j o
고라니	k o̞ ɾ a̠ n i
고량주	k o̞ ɾ j a̠ ŋ d͡ʑ u
고려	k o̞ ɾ j ʌ̹
고려말	k o̞ ɾ j ʌ̹ m a̠ ɭ
고루	k o̞ ɾ u
고르다	k o̞ ɾ ɯ d a̠
고리	k o̞ ɾ i
고릴라	k o̞ ɾ i ɭ ɭ a̠
고마워	k o̞ m a̠ w ʌ̹
고맙다	k o̞ː m a̠ p̚ t͈ a̠
고맙습니다	k o̞ m a̠ p s͈ ɯ m n i d a̠
고모	k o̞ m o̞
고모부	k o̞ m o̞ b u
고무신	k o̞ m u ɕʰ i n
고문	k o̞ m u n
고민	k o̞ m i n
고민하다	k o̞ m i n ɦ a̠ d a̠
고바야시박쥐	k o̞ b a̠ j a̠ ɕʰ i b a̠ k̚ t͡ɕ͈ ɥ i
고발	k o̞ː b a̠ ɭ
고방오리	k o̞ b a̠ ŋ o̞ ɾ i
고삐	k o̞ p͈ i
고사기	k o̞ː sʰ a̠ ɡ i
고사리	k o̞ sʰ a̠ ɾ i
고사성어	k o̞ː sʰ a̠ sʰ ʌ̹ ŋ ʌ̹
고사포	k o̞ sʰ a̠ pʰ o̞
고산	k o̞ sʰ a̠ n
고속버스	k o̞ sʰ o̞ k̚ p͈ ʌ̹ sʰ ɯ
고수	k o̞ sʰ u
고순쥐	k o̞ sʰ u ɲ d͡ʑ ɥ i
고스트	k o̞ sʰ ɯ tʰ ɯ
고시	k o̞ː ɕʰ i
고아	k o̞ a̠
고아원	k o̞ a̠ w ʌ̹ n
고양이	k o̞ j a̠ ŋ i
고어	k o̞ː ʌ̹
고온	k o̞ o̞ n
고요	k o̞ j o
고용	k o̞ j o ŋ
고을	k o̞ ɯ ɭ
고저	k o̞ d͡ʑ ʌ̹
고전	k o̞ː d͡ʑ ʌ̹ n
고전적	k o̞ː d͡ʑ ʌ̹ ɲ d͡ʑ ʌ̹ k̚
고정	k o̞ d͡ʑ ʌ̹ ŋ
고정되다	k o̞ d͡ʑ ʌ̹ ŋ d w e̞ d a̠
고조	k o̞ d͡ʑ o̞
고조선	k o̞ː d͡ʑ o̞ sʰ ʌ̹ n
고지	k o̞ d͡ʑ i
고지리학	k o̞ː d͡ʑ i ɾ i ɦ a̠ k̚
고지식하다	k o̞ d͡ʑ i ɕʰ i kʰ a̠ d a̠
고질병	k o̞ d͡ʑ i ɭ p͈ j ʌ̹ ŋ
고집	k o̞ d͡ʑ i p̚
고집스럽다	k o̞ d͡ʑ i p s͈ ɯ ɾ ʌ̹ p̚ t͈ a̠
고집하다	k o̞ d͡ʑ i pʰ a̠ d a̠
고추장	k o̞ t͡ɕʰ u d͡ʑ a̠ ŋ
고춧가루	k o̞ t͡ɕʰ u t̚ k͈ a̠ ɾ u
고통	k o̞ tʰ o̞ ŋ
고통스럽다	k o̞ tʰ o̞ ŋ sʰ ɯ ɾ ʌ̹ p̚ t͈ a̠
고투	k o̞ː tʰ u
고프다	k o̞ pʰ ɯ d a̠
고혈압	k o̞ ʝ j ʌ̹ ɾ a̠ p̚
고환	k o̞ β w a̠ n
곡물	k o̞ ŋ m u ɭ
곡식	k o̞ k ɕ͈ i k̚
곡예사	k o̞ ɡ j e̞ sʰ a̠
곡조	k o̞ k̚ t͡ɕ͈ o̞
곤란	k o̞ː ɭ ɭ a̠ n
곤란하다	k o̞ː ɭ ɭ a̠ n ɦ a̠ d a̠
곤이	k o̞ n i
곤충	k o̞ ɲ t͡ɕʰ u ŋ
곤충학	k o̞ ɲ t͡ɕʰ u ŋ ɦ a̠ k̚
곧바로	k o̞ t̚ p͈ a̠ ɾ o̞
곧은창자	k o̞ d ɯ ɲ t͡ɕʰ a̠ ŋ d͡ʑ a̠
곧장	k o̞ t̚ t͡ɕ͈ a̠ ŋ
골드바	k o̞ ɭ d ɯ b a̠
골목	k o̞ː ɭ m o̞ k̚
골무	k o̞ ɭ m u
골반	k o̞ ɭ b a̠ n
골상학	k o̞ ɭ sʰ a̠ ŋ ɦ a̠ k̚
골수	k o̞ ɭ s͈ u
골인	k͈ o̞ ɾ i n
골짜기	k o̞ ʎ t͡ɕ͈ a̠ ɡ i
골프	k͈ o̞ ɭ pʰ ɯ
곪다	k o̞ː m t͈ a̠
곰국	k o̞ː m k͈ u k̚
곰비임비	k o̞ m b i i m b i
곰실	k o̞ m ɕʰ i ɭ
곰틀	k o̞ m tʰ ɯ ɭ
곰팡이	k o̞ m pʰ a̠ ŋ i
곱사연어	k o̞ p s͈ a̠ j ʌ̹ n ʌ̹
곱셈	k o̞ p s͈ e̞ m
곳곳	k o̞ t̚ k͈ o̞ t̚
공간	k o̞ ŋ ɡ a̠ n
공갈	k o̞ː ŋ ɡ a̠ ɭ
공격	k o̞ː ŋ ɡ j ʌ̹ k̚
공경	k o̞ ŋ ɡ j ʌ̹ ŋ
공공	k o̞ ŋ ɡ o̞ ŋ
공구	k o̞ ŋ ɡ u
공군	k o̞ ŋ ɡ u n
공급	k o̞ː ŋ ɡ ɯ p̚
공동	k o̞ː ŋ d o̞ ŋ
공동체	k o̞ː ŋ d o̞ ŋ t͡ɕʰ e̞
공로	k o̞ ŋ n o̞
공룡	k o̞ː ŋ ɲ j o ŋ
공리주의	k o̞ ŋ n i d͡ʑ u ɰ i
공모	k o̞ː ŋ m o̞
공무원	k o̞ ŋ m u w ʌ̹ n
공민	k o̞ ŋ m i n
공방	k o̞ ŋ b a̠ ŋ
공병	k o̞ ŋ b j ʌ̹ ŋ
공보원	k o̞ ŋ b o̞ w ʌ̹ n
공부하다	k o̞ ŋ b u ɦ a̠ d a̠
공산당	k o̞ː ŋ sʰ a̠ n d a̠ ŋ
공산주의	k o̞ː ŋ sʰ a̠ ɲ d͡ʑ u ɰ i
공산주의자	k o̞ː ŋ sʰ a̠ ɲ d͡ʑ u ɰ i d͡ʑ a̠
공성계	k o̞ ŋ sʰ ʌ̹ ŋ ɡ j e̞
공세	k o̞ː ŋ sʰ e̞
공수	k o̞ ŋ sʰ u
공수도	k o̞ ŋ sʰ u d o̞
공수병	k o̞ː ŋ sʰ u p͈ j ʌ̹ ŋ
공식	k o̞ ŋ ɕʰ i k̚
공식어	k o̞ ŋ ɕʰ i ɡ ʌ̹
공안	k o̞ ŋ a̠ n
공언	k o̞ ŋ ʌ̹ n
공언하다	k o̞ ŋ ʌ̹ n ɦ a̠ d a̠
공업	k o̞ ŋ ʌ̹ p̚
공업화	k o̞ː ŋ ʌ̹ pʰ w a̠
공연	k o̞ ŋ j ʌ̹ n
공용어	k o̞ ŋ j o ŋ ʌ̹
공원	k o̞ ŋ w ʌ̹ n
공인	k o̞ ŋ i n
공작	k o̞ː ŋ d͡ʑ a̠ k̚
공정	k o̞ ŋ d͡ʑ ʌ̹ ŋ
공정하다	k o̞ ŋ d͡ʑ ʌ̹ ŋ ɦ a̠ d a̠
공주	k o̞ ŋ d͡ʑ u
공중	k o̞ ŋ d͡ʑ u ŋ
공중전화	k o̞ ŋ d͡ʑ u ŋ d͡ʑ ʌ̹ n β w a̠
공지	k o̞ ŋ d͡ʑ i
공짜	k o̞ ŋ t͡ɕ͈ a̠
공통점	k o̞ː ŋ tʰ o̞ ŋ t͡ɕ͈ ʌ̹ m
공포	k o̞ː ŋ pʰ o̞
공학	k o̞ ŋ ɦ a̠ k̚
공항	k o̞ ŋ ɦ a̠ ŋ
공허하다	k o̞ ŋ ɦ ʌ̹ ɦ a̠ d a̠
공황	k o̞ː ŋ β w a̠ ŋ
과거형	k w a̠ː ɡ ʌ̹ ʝ j ʌ̹ ŋ
과금	k w a̠ ɡ ɯ m
과두	k w a̠ː d u
과들루쁘	k w a̠ d ɯ ɭ ɭ u p͈ ɯ
과들루프	k w a̠ d ɯ ɭ ɭ u pʰ ɯ
과떼말라	k w a̠ t͈ e̞ m a̠ ɭ ɭ a̠
과로	k w a̠ː ɾ o̞
과로사	k w a̠ː ɾ o̞ sʰ a̠
과립	k w a̠ ɾ i p̚
과메기	k w a̠ m e̞ ɡ i
과물	k w a̠ m u ɭ
과업	k w a̠ ʌ̹ p̚
과연	k w a̠ː j ʌ̹ n
과외	k w a̠ w e̞
과욕	k w a̠ː j o k̚
과일	k w a̠ː i ɭ
과일단물	k w a̠ i ɭ d a̠ n m u ɭ
과일물	k w a̠ː i ɭ m u ɭ
과자	k w a̠ː d͡ʑ a̠
과장	k w a̠ d͡ʑ a̠ ŋ
과정	k w a̠ː d͡ʑ ʌ̹ ŋ
과테말라	k w a̠ tʰ e̞ m a̠ ɭ ɭ a̠
과팅	k w a̠ tʰ i ŋ
과포자	k w a̠ pʰ o̞ d͡ʑ a̠
과학	k w a̠ ɦ a̠ k̚
과학관	k w a̠ ɦ a̠ k̚ k͈ w a̠ n
과학자	k w a̠ ɦ a̠ k̚ t͡ɕ͈ a̠
과학적	k w a̠ ɦ a̠ k̚ t͡ɕ͈ ʌ̹ k̚
곽밥	k w a̠ k̚ p͈ a̠ p̚
관계	k w a̠ n ɡ j e̞
관계어	k w a̠ n ɡ j e̞ ʌ̹
관계없이	k w a̠ n ɡ j e̞ ʌ̹ p ɕ͈ i
관계자	k w a̠ n ɡ j e̞ d͡ʑ a̠
관광	k w a̠ n ɡ w a̠ ŋ
관광버스	k w a̠ n ɡ w a̠ ŋ b ʌ̹ sʰ ɯ
관광학	k w a̠ n ɡ w a̠ ŋ ɦ a̠ k̚
관념	k w a̠ n ɲ j ʌ̹ m
관람차	k w a̠ ɭ ɭ a̠ m t͡ɕʰ a̠
관련	k w a̠ ʎ ʎ j ʌ̹ n
관련성	k w a̠ ʎ ʎ j ʌ̹ n s͈ ʌ̹ ŋ
관리	k w a̠ ʎ ʎ i
관리인	k w a̠ ʎ ʎ i i n
관리하다	k w a̠ ʎ ʎ i ɦ a̠ d a̠
관문	k w a̠ n m u n
관박쥐	k w a̠ n b a̠ k̚ t͡ɕ͈ ɥ i
관복	k w a̠ n b o̞ k̚
관사	k w a̠ n sʰ a̠
관성	k w a̠ n sʰ ʌ̹ ŋ
관세	k w a̠ n sʰ e̞
관심	k w a̠ n ɕʰ i m
관용구	k w a̠ ɲ j o ŋ k͈ u
관음	k w a̠ n ɯ m
관자놀이	k w a̠ ɲ d͡ʑ a̠ n o̞ ɾ i
관절	k w a̠ ɲ d͡ʑ ʌ̹ ɭ
관절염	k w a̠ ɲ d͡ʑ ʌ̹ ɾ j ʌ̹ m
관찰	k w a̠ ɲ t͡ɕʰ a̠ ɭ
관찰하다	k w a̠ ɲ t͡ɕʰ a̠ ɾ ɦ a̠ d a̠
관코박쥐	k w a̠ n kʰ o̞ b a̠ k̚ t͡ɕ͈ ɥ i
관풍금	k w a̠ n pʰ u ŋ ɡ ɯ m
관할	k w a̠ n ɦ a̠ ɭ
관현악단	k w a̠ n ʝ j ʌ̹ n a̠ k̚ t͈ a̠ n
관형사	k w a̠ n ʝ j ʌ̹ ŋ sʰ a̠
괄약근	k w a̠ ɾ j a̠ k̚ k͈ ɯ n
괄호	k w a̠ ɾ β o̞
광검	k w a̠ ŋ ɡ ʌ̹ m
광견병	k w a̠ ŋ ɡ j ʌ̹ n p͈ j ʌ̹ ŋ
광경	k w a̠ ŋ ɡ j ʌ̹ ŋ
광년	k w a̠ ŋ ɲ j ʌ̹ n
광동	k w a̠ː ŋ d o̞ ŋ
광동어	k w a̠ː ŋ d o̞ ŋ ʌ̹
광둥	k w a̠ ŋ d u ŋ
광명	k w a̠ ŋ m j ʌ̹ ŋ
광명성절	k w a̠ ŋ m j ʌ̹ ŋ sʰ ʌ̹ ŋ d͡ʑ ʌ̹ ɭ
광물	k w a̠ː ŋ m u ɭ
광부	k w a̠ː ŋ b u
광산	k w a̠ː ŋ sʰ a̠ n
광석	k w a̠ː ŋ sʰ ʌ̹ k̚
광선	k w a̠ ŋ sʰ ʌ̹ n
광시	k w a̠ ŋ ɕʰ i
광업	k w a̠ː ŋ ʌ̹ p̚
광역시	k w a̠ː ŋ j ʌ̹ k ɕ͈ i
광우병	k w a̠ ŋ u p͈ j ʌ̹ ŋ
광원	k w a̠ ŋ w ʌ̹ n
광장	k w a̠ː ŋ d͡ʑ a̠ ŋ
광초	k w a̠ ŋ t͡ɕʰ o̞
광학	k w a̠ ŋ ɦ a̠ k̚
광화문	k w a̠ ŋ β w a̠ m u n
괴기	k w e̞ ɡ i
괴다	k w e̞ː d a̠
괴담	k w e̞ː d a̠ m
괴로움	k w e̞ ɾ o̞ u m
괴롭다	k w e̞ ɾ o̞ p̚ t͈ a̠
괴뢰	k w e̞ː ɾ w e̞
괴리	k w e̞ ɾ i
괴물	k w e̞ː m u ɭ
괴수	k w e̞ː sʰ u
괴짜	k w e̞ː t͡ɕ͈ a̠
괴한	k w e̞ː ɦ a̠ n
굉장히	k w e̞ ŋ d͡ʑ a̠ ŋ ʝ i
교가	k j oː ɡ a̠
교각	k j o ɡ a̠ k̚
교거	k j o ɡ ʌ̹
교과서	k j oː k͈ w a̠ sʰ ʌ̹
교도	k j oː d o̞
교란	k j o ɾ a̠ n
교량	k j o ɾ j a̠ ŋ
교류	k j o ɾ j u
교리	k j oː ɾ i
교미	k j o m i
교복	k j oː b o̞ k̚
교수	k j oː sʰ u
교실	k j oː ɕʰ i ɭ
교양	k j oː j a̠ ŋ
교역	k j o j ʌ̹ k̚
교외	k j o w e̞
교원	k j oː w ʌ̹ n
교육	k j oː j u k̚
교육학	k j oː j u kʰ a̠ k̚
교인	k j oː i n
교장	k j oː d͡ʑ a̠ ŋ
교전	k j o d͡ʑ ʌ̹ n
교정	k j oː d͡ʑ ʌ̹ ŋ
교조	k j oː d͡ʑ o̞
교차로	k j o t͡ɕʰ a̠ ɾ o̞
교체	k j o t͡ɕʰ e̞
교체하다	k j o t͡ɕʰ e̞ ɦ a̠ d a̠
교탁	k j oː tʰ a̠ k̚
교토	k j o tʰ o̞
교통	k j o tʰ o̞ ŋ
교통사고	k j o tʰ o̞ ŋ sʰ a̠ ɡ o̞
교통요금	k j o tʰ o̞ ŋ j o ɡ ɯ m
교포	k j o pʰ o̞
교향곡	k j o ʝ j a̠ ŋ ɡ o̞ k̚
교환	k j o β w a̠ n
교활하다	k j o β w a̠ ɾ ɦ a̠ d a̠
교황	k j oː β w a̠ ŋ
교회론	k j oː β w e̞ ɾ o̞ n
구강	k uː ɡ a̠ ŋ
구결자	k uː ɡ j ʌ̹ ʎ t͡ɕ͈ a̠
구경	k uː ɡ j ʌ̹ ŋ
구경꾼	k uː ɡ j ʌ̹ ŋ k͈ u n
구경하다	k uː ɡ j ʌ̹ ŋ ɦ a̠ d a̠
구굴무치	k u ɡ u ɭ m u t͡ɕʰ i
구급차	k uː ɡ ɯ p̚ t͡ɕʰ a̠
구기자	k u ɡ i d͡ʑ a̠
구난	k uː n a̠ n
구녕	k u ɲ j ʌ̹ ŋ
구더기	k u d ʌ̹ ɡ i
구덩이	k u d ʌ̹ ŋ i
구라파	k u ɾ a̠ pʰ a̠
구렁이	k u ɾ ʌ̹ ŋ i
구레나룻	k u ɾ e̞ n a̠ ɾ u t̚
구름	k u ɾ ɯ m
구름다리	k u ɾ ɯ m d a̠ ɾ i
구마	k u m a̠
구멍	k u m ʌ̹ ŋ
구무	k u m u
구미호	k u m i β o̞
구부리다	k u b u ɾ i d a̠
구분	k u b u n
구분자	k uː b u ɲ d͡ʑ a̠
구상	k u sʰ a̠ ŋ
구성	k u sʰ ʌ̹ ŋ
구성원	k u sʰ ʌ̹ ŋ w ʌ̹ n
구성하다	k u sʰ ʌ̹ ŋ ɦ a̠ d a̠
구속	k u sʰ o̞ k̚
구슬	k u sʰ ɯ ɭ
구십	k u ɕʰ i p̚
구약	k u j a̠ k̚
구약성경	k uː j a̠ k s͈ ʌ̹ ŋ ɡ j ʌ̹ ŋ
구요	k u j o
구원	k uː w ʌ̹ n
구이	k u i
구입	k u i p̚
구입처	k u i p̚ t͡ɕʰ ʌ̹
구절	k u d͡ʑ ʌ̹ ɭ
구체적	k u t͡ɕʰ e̞ d͡ʑ ʌ̹ k̚
구축	k u t͡ɕʰ u k̚
구출	k uː t͡ɕʰ u ɭ
구취	k uː t͡ɕʰ ɥ i
구치소	k u t͡ɕʰ i sʰ o̞
구타	k u tʰ a̠
구토	k u tʰ o̞
구현	k u ʝ j ʌ̹ n
구호	k uː β o̞
구호금	k uː β o̞ ɡ ɯ m
구혼	k u β o̞ n
국가	k u k̚ k͈ a̠
국경	k u k̚ k͈ j ʌ̹ ŋ
국립	k u ŋ n i p̚
국면	k u ŋ m j ʌ̹ n
국물	k u ŋ m u ɭ
국민	k u ŋ m i n
국산	k u k s͈ a̠ n
국수주의	k u k s͈ u d͡ʑ u ɰ i
국악	k u ɡ a̠ k̚
국어	k u ɡ ʌ̹
국영	k u ɡ j ʌ̹ ŋ
국왕	k u ɡ w a̠ ŋ
국유화	k u ɡ j u β w a̠
국자	k u k̚ t͡ɕ͈ a̠
국적	k u k̚ t͡ɕ͈ ʌ̹ k̚
국제화	k u k̚ t͡ɕ͈ e̞ β w a̠
국토	k u k̚ tʰ o̞
국한문	k u kʰ a̠ n m u n
국화	k u kʰ w a̠
국회	k u kʰ w e̞
군관	k u n ɡ w a̠ n
군국주의	k u n ɡ u k̚ t͡ɕ͈ u ɰ i
군단	k u n d a̠ n
군데	k u n d e̞
군데군데	k u n d e̞ ɡ u n d e̞
군도	k u n d o̞
군만두	k uː n m a̠ n d u
군복	k u n b o̞ k̚
군소리	k uː n sʰ o̞ ɾ i
군인	k u n i n
군주제	k u ɲ d͡ʑ u d͡ʑ e̞
굳다	k u t̚ t͈ a̠
굴곡위	k u ɭ ɡ o̞ ɡ ɥ i
굴다	k u ɭ d a̠
굴뚝	k uː ɭ t͈ u k̚
굴레	k u ɭ ɭ e̞
굴비	k u ɭ b i
굴절	k u ʎ t͡ɕ͈ ʌ̹ ɭ
굴착기	k u ʎ t͡ɕʰ a̠ k̚ k͈ i
굶기다	k u m ɡ i d a̠
굼벵이	k uː m b e̞ ŋ i
굼실굼실	k u m ɕʰ i ɭ ɡ u m ɕʰ i ɭ
굼적굼적	k u m d͡ʑ ʌ̹ k̚ k͈ u m d͡ʑ ʌ̹ k̚
굽이	k u b i
굽히다	k u pʰ i d a̠
궁극적	k u ŋ ɡ ɯ k̚ t͡ɕ͈ ʌ̹ k̚
궁금하다	k u ŋ ɡ ɯ m ɦ a̠ d a̠
궁수	k u ŋ sʰ u
궁전	k u ŋ d͡ʑ ʌ̹ n
궁정	k u ŋ d͡ʑ ʌ̹ ŋ
궁중	k u ŋ d͡ʑ u ŋ
궁핍	k u ŋ pʰ i p̚
권고	k w ɘː n ɡ o̞
권당	k w ʌ̹ n d a̠ ŋ
권력	k w ɘː ʎ ʎ j ʌ̹ k̚
권리	k w ʌ̹ ʎ ʎ i
권세	k w ʌ̹ n sʰ e̞
권위	k w ʌ̹ n ɥ i
권투	k w ʌ̹ n tʰ u
궤도	k w e̞ː d o̞
궤변	k w e̞ː b j ʌ̹ n
귀걸이	k ɥ i ɡ ʌ̹ ɾ i
귀국	k ɥ iː ɡ u k̚
귀국하다	k ɥ iː ɡ u kʰ a̠ d a̠
귀뚜라미	k ɥ i t͈ u ɾ a̠ m i
귀뚤귀	k ɥ i t͈ u ɭ ɡ ɥ i
귀리	k ɥ iː ɾ i
귀신	k ɥ iː ɕʰ i n
귀양	k ɥ i j a̠ ŋ
귀엽다	k ɥ iː j ʌ̹ p̚ t͈ a̠
귀족	k ɥ i d͡ʑ o̞ k̚
귀주	k ɥ i d͡ʑ u
귀찮다	k ɥ i t͡ɕʰ a̠ n tʰ a̠
귀하다	k ɥ iː ɦ a̠ d a̠
귀환	k ɥ iː β w a̠ n
귓불	k ɥ i t̚ p͈ u ɭ
규모	k j u m o̞
규범	k j u b ʌ̹ m
규약	k j u j a̠ k̚
규율	k j u j u ɭ
규정	k j u d͡ʑ ʌ̹ ŋ
규제	k j u d͡ʑ e̞
규칙	k j u t͡ɕʰ i k̚
규칙적	k j u t͡ɕʰ i k̚ t͡ɕ͈ ʌ̹ k̚
균형	k j u n ʝ j ʌ̹ ŋ
그것	k ɯ ɡ ʌ̹ t̚
그곳	k ɯ ɡ o̞ t̚
그끄저께	k ɯ k͈ ɯ d͡ʑ ʌ̹ k͈ e̞
그날	k ɯ n a̠ ɭ
그냥	k ɯ ɲ j a̠ ŋ
그네	k ɯː n e̞
그네들	k ɯ n e̞ d ɯ ɭ
그녀들	k ɯ ɲ j ʌ̹ d ɯ ɭ
그늘	k ɯ n ɯ ɭ
그늘지다	k ɯ n ɯ ʎ d͡ʑ i d a̠
그다음	k ɯ d a̠ ɯ m
그다지	k ɯ d a̠ d͡ʑ i
그동안	k ɯ d o̞ ŋ a̠ n
그라프	k ɯ ɾ a̠ pʰ ɯ
그람	k ɯ ɾ a̠ m
그러나	k ɯ ɾ ʌ̹ n a̠
그러니까	k ɯ ɾ ʌ̹ n i k͈ a̠
그러다	k ɯ ɾ ʌ̹ d a̠
그러면	k ɯ ɾ ʌ̹ m j ʌ̹ n
그러므로	k ɯ ɾ ʌ̹ m ɯ ɾ o̞
그러하다	k ɯ ɾ ʌ̹ ɦ a̠ d a̠
그런	k ɯ ɾ ʌ̹ n
그런데	k ɯ ɾ ʌ̹ n d e̞
그럼	k ɯ ɾ ʌ̹ m
그렇게	k ɯ ɾ ʌ̹ kʰ e̞
그렇지	k ɯ ɾ ʌ̹ t͡ɕʰ i
그렇지만	k ɯ ɾ ʌ̹ t͡ɕʰ i m a̠ n
그레나다	k ɯ ɾ e̞ n a̠ d a̠
그레이프프루트	k͈ ɯ ɾ e̞ i pʰ ɯ pʰ ɯ ɾ u tʰ ɯ
그루	k ɯ ɾ u
그루지야	k ɯ ɾ u d͡ʑ i j a̠
그룹	k ɯ ɾ u p̚
그르다	k ɯ ɾ ɯ d a̠
그릇	k ɯ ɾ ɯ t̚
그릇되다	k ɯ ɾ ɯ t̚ t͈ w e̞ d a̠
그리	k ɯ ɾ i
그리고	k ɯ ɾ i ɡ o̞
그리다	k ɯː ɾ i d a̠
그리스도	k ɯ ɾ i sʰ ɯ d o̞
그리스도교	k ɯ ɾ i sʰ ɯ d o̞ ɡ j o
그리스어	k ɯ ɾ i sʰ ɯ ʌ̹
그리움	k ɯ ɾ i u m
그리워하다	k ɯ ɾ i w ʌ̹ ɦ a̠ d a̠
그린란드	k ɯ ɾ i n n a̠ n d ɯ
그림	k ɯː ɾ i m
그림자	k ɯː ɾ i m d͡ʑ a̠
그립다	k ɯ ɾ i p̚ t͈ a̠
그만	k ɯ m a̠ n
그만큼	k ɯ m a̠ n k x ɯ m
그만하다	k ɯ m a̠ n ɦ a̠ d a̠
그물	k ɯ m u ɭ
그믐	k ɯ m ɯ m
그믐날	k ɯ m ɯ m n a̠ ɭ
그야말로	k ɯ j a̠ m a̠ ɭ ɭ o̞
그윽하다	k ɯ ɯ kʰ a̠ d a̠
그저	k ɯ d͡ʑ ʌ̹
그저께	k ɯ d͡ʑ ʌ̹ k͈ e̞
그제	k ɯ d͡ʑ e̞
그중	k ɯ d͡ʑ u ŋ
그치다	k ɯ t͡ɕʰ i d a̠
그치만	k ɯ t͡ɕʰ i m a̠ n
그토록	k ɯ tʰ o̞ ɾ o̞ k̚
극단주의	k ɯ k̚ t͈ a̠ ɲ d͡ʑ u ɰ i
극동	k ɯ k̚ t͈ o̞ ŋ
극작가	k ɯ k̚ t͡ɕ͈ a̠ k̚ k͈ a̠
극장	k ɯ k̚ t͡ɕ͈ a̠ ŋ
근교	k ɯː n ɡ j o
근로자	k ɯː ɭ ɭ o̞ d͡ʑ a̠
근면	k ɯː n m j ʌ̹ n
근무	k ɯː n m u
근무하다	k ɯː n m u ɦ a̠ d a̠
근본	k ɯ n b o̞ n
근본적	k ɯ n b o̞ ɲ d͡ʑ ʌ̹ k̚
근삿값	k ɯː n sʰ a̠ t̚ k͈ a̠ p̚
근시	k ɯː n ɕʰ i
근원	k ɯ n w ʌ̹ n
근육	k ɯ ɲ j u k̚
근일점	k ɯː n i ʎ t͡ɕ͈ ʌ̹ m
근접	k ɯː ɲ d͡ʑ ʌ̹ p̚
근질근질하다	k ɯ ɲ d͡ʑ i ɭ ɡ ɯ ɲ d͡ʑ i ɾ ɦ a̠ d a̠
근처	k ɯː ɲ t͡ɕʰ ʌ̹
글꼴	k ɯ ɭ k͈ o̞ ɭ
글라스	k ɯ ɭ ɭ a̠ sʰ ɯ
글라이더	k ɯ ɭ ɭ a̠ i d ʌ̹
글루텐	k ɯ ɭ ɭ u tʰ e̞ n
글리세롤	k ɯ ʎ ʎ i sʰ e̞ ɾ o̞ ɭ
글리세린	k ɯ ʎ ʎ i sʰ e̞ ɾ i n
글쎄요	k ɯ ɭ s͈ e̞ j o
글쓰기	k ɯ ɭ s͈ ɯ ɡ i
글씨	k ɯ ɭ ɕ͈ i
글자	k ɯ ʎ t͡ɕ͈ a̠
글피	k ɯ ɭ pʰ i
긁다	k ɯ k̚ t͈ a̠
금고	k ɯ m ɡ o̞
금메달	k ɯ m m e̞ d a̠ ɭ
금방	k ɯ m b a̠ ŋ
금성	k ɯ m sʰ ʌ̹ ŋ
금속	k ɯ m sʰ o̞ k̚
금연	k ɯː m j ʌ̹ n
금요일	k ɯ m j o i ɭ
금융	k ɯ m ɲ j u ŋ
금일	k ɯ m i ɭ
금자탑	k ɯ m d͡ʑ a̠ tʰ a̠ p̚
금전	k ɯ m d͡ʑ ʌ̹ n
금지	k ɯː m d͡ʑ i
급격	k ɯ p̚ k͈ j ʌ̹ k̚
급격하다	k ɯ p̚ k͈ j ʌ̹ kʰ a̠ d a̠
급기야	k ɯ p̚ k͈ i j a̠
급료	k ɯ m ɲ j o
급습	k ɯ p s͈ ɯ p̚
급여	k ɯ b j ʌ̹
급우	k ɯ b u
급진주의	k ɯ p̚ t͡ɕ͈ i ɲ d͡ʑ u ɰ i
급하다	k ɯ pʰ a̠ d a̠
급히	k ɯ pʰ i
긋다	k ɯː t̚ t͈ a̠
긍정적	k ɯː ŋ d͡ʑ ʌ̹ ŋ d͡ʑ ʌ̹ k̚
기각	k i ɡ a̠ k̚
기간	k i ɡ a̠ n
기계	k i ɡ j e̞
기계공	k i ɡ j e̞ ɡ o̞ ŋ
기공	k i ɡ o̞ ŋ
기관	k i ɡ w a̠ n
기관차	k i ɡ w a̠ ɲ t͡ɕʰ a̠
기관총	k i ɡ w a̠ ɲ t͡ɕʰ o̞ ŋ
기근	k i ɡ ɯ n
기꺼이	k i k͈ ʌ̹ i
기녀	k iː ɲ j ʌ̹
기념관	k i ɲ j ʌ̹ m ɡ w a̠ n
기념물	k i ɲ j ʌ̹ m m u ɭ
기념일	k i ɲ j ʌ̹ m i ɭ
기념품	k i ɲ j ʌ̹ m pʰ u m
기능	k i n ɯ ŋ
기니피그	k i n i pʰ i ɡ ɯ
기도하다	k i d o̞ ɦ a̠ d a̠
기독교	k i d o̞ k̚ k͈ j o
기독교도	k i d o̞ k̚ k͈ j o d o̞
기라성	k i ɾ a̠ sʰ ʌ̹ ŋ
기러기	k i ɾ ʌ̹ ɡ i
기록	k i ɾ o̞ k̚
기록하다	k i ɾ o̞ kʰ a̠ d a̠
기르다	k i ɾ ɯ d a̠
기름	k i ɾ ɯ m
기린	k i ɾ i n
기린영양	k i ɾ i ɲ j ʌ̹ ŋ j a̠ ŋ
기마이	k i m a̠ i
기만하다	k i m a̠ n ɦ a̠ d a̠
기모노	k i m o̞ n o̞
기물	k i m u ɭ
기법	k i p͈ ʌ̹ p̚
기병	k i b j ʌ̹ ŋ
기본	k i b o̞ n
기본적	k i b o̞ ɲ d͡ʑ ʌ̹ k̚
기뻐하다	k i p͈ ʌ̹ ɦ a̠ d a̠
기쁘다	k i p͈ ɯ d a̠
기사	k i sʰ a̠
기수사	k i sʰ u sʰ a̠
기수열외	k i sʰ u j ʌ̹ ɾ w e̞
기숙사	k i sʰ u k s͈ a̠
기술	k i sʰ u ɭ
기술자	k i sʰ u ʎ t͡ɕ͈ a̠
기슭	k i sʰ ɯ k̚
기승위	k i sʰ ɯ ŋ ɥ i
기약	k i j a̠ k̚
기억	k i ʌ̹ k̚
기억나다	k i ʌ̹ ŋ n a̠ d a̠
기억력	k i ʌ̹ ŋ ɲ j ʌ̹ k̚
기억하다	k i ʌ̹ kʰ a̠ d a̠
기업	k i ʌ̹ p̚
기업가	k i ʌ̹ p̚ k͈ a̠
기업인	k i ʌ̹ b i n
기여	k i j ʌ̹
기여하다	k i j ʌ̹ ɦ a̠ d a̠
기역	k i j ʌ̹ k̚
기온	k i o̞ n
기와	k i w a̠
기운	k i u n
기울다	k i u ɭ d a̠
기울이다	k i u ɾ i d a̠
기원	k i w ʌ̹ n
기원전	k i w ʌ̹ ɲ d͡ʑ ʌ̹ n
기윽	k i ɯ k̚
기입	k i i p̚
기자	k i d͡ʑ a̠
기저	k i d͡ʑ ʌ̹
기절	k i d͡ʑ ʌ̹ ɭ
기준	k i d͡ʑ u n
기중기	k i d͡ʑ u ŋ ɡ i
기지	k i d͡ʑ i
기차	k i t͡ɕʰ a̠
기체	k i t͡ɕʰ e̞
기총	k i t͡ɕʰ o̞ ŋ
기치	k i t͡ɕʰ i
기침	k i t͡ɕʰ i m
기타	k i tʰ a̠
기한	k i ɦ a̠ n
기합	k i ɦ a̠ p̚
기호	k i β o̞
기회주의자	k i β w e̞ d͡ʑ u ɰ i d͡ʑ a̠
기후	k i β u
긴꼬리꼬마쥐	k i n k͈ o̞ ɾ i k͈ o̞ m a̠ d͡ʑ ɥ i
긴장	k i ɲ d͡ʑ a̠ ŋ
긷다	k iː t̚ t͈ a̠
길가	k i ɭ ɡ a̠
길거리	k i ɭ k͈ ʌ̹ ɾ i
길냥이	k iː ʎ ʎ j a̠ ŋ i
길다	k iː ɭ d a̠
길이	k i ɾ i
김일성화	k i m i ɭ sʰ ʌ̹ ŋ β w a̠
김장	k i m d͡ʑ a̠ ŋ
김정일화	k i m d͡ʑ ʌ̹ ŋ i ɾ β w a̠
김치	k i m t͡ɕʰ i
김치전	k i m t͡ɕʰ i d͡ʑ ʌ̹ n
깃발	k i t̚ p͈ a̠ ɭ
깇다	k i t̚ t͈ a̠
깊다	k i p̚ t͈ a̠
깊이	k i pʰ i
까닭	k͈ a̠ d a̠ k̚
까딸로그	k͈ a̠ t͈ a̠ ɭ ɭ o̞ ɡ ɯ
까마귀	k͈ a̠ m a̠ ɡ ɥ i
까막눈	k͈ a̠ m a̠ ŋ n u n
까맣다	k͈ a̠ː m a̠ tʰ a̠
까벨	k͈ a̠ b e̞ ɭ
까불다	k͈ a̠ b u ɭ d a̠
까지	k͈ a̠ d͡ʑ i
까치	k͈ a̠ t͡ɕʰ i
까치복	k͈ a̠ː t͡ɕʰ i b o̞ k̚
까히라	k͈ a̠ ʝ i ɾ a̠
깍두기	k͈ a̠ k̚ t͈ u ɡ i
깎다	k͈ a̠ k̚ t͈ a̠
깔끔하다	k͈ a̠ ɭ k͈ ɯ m ɦ a̠ d a̠
깔리다	k͈ a̠ ʎ ʎ i d a̠
깜박	k͈ a̠ m b a̠ k̚
깜박깜박	k͈ a̠ m b a̠ k̚ k͈ a̠ m b a̠ k̚
깜빡	k͈ a̠ m p͈ a̠ k̚
깜빡깜빡	k͈ a̠ m p͈ a̠ k̚ k͈ a̠ m p͈ a̠ k̚
깜작	k͈ a̠ m d͡ʑ a̠ k̚
깜짝	k͈ a̠ m t͡ɕ͈ a̠ k̚
깡통	k͈ a̠ ŋ tʰ o̞ ŋ
깨지다	k͈ ɛː d͡ʑ i d a̠
꺼리다	k͈ ɘː ɾ i d a̠
꺼지다	k͈ ʌ̹ d͡ʑ i d a̠
꺼풀	k͈ ʌ̹ pʰ u ɭ
꺽지	k͈ ʌ̹ k̚ t͡ɕ͈ i
꺾다	k͈ ʌ̹ k̚ t͈ a̠
꺾어지다	k͈ ʌ̹ k͈ ʌ̹ d͡ʑ i d a̠
껌벅껌벅	k͈ ʌ̹ m b ʌ̹ k̚ k͈ ʌ̹ m b ʌ̹ k̚
껌뻑껌뻑	k͈ ʌ̹ m p͈ ʌ̹ k̚ k͈ ʌ̹ m p͈ ʌ̹ k̚
껍질	k͈ ʌ̹ p̚ t͡ɕ͈ i ɭ
께서	k͈ e̞ sʰ ʌ̹
꼬르륵	k͈ o̞ ɾ ɯ ɾ ɯ k̚
꼬르륵꼬르륵	k͈ o̞ ɾ ɯ ɾ ɯ k̚ k͈ o̞ ɾ ɯ ɾ ɯ k̚
꼬리	k͈ o̞ ɾ i
꼬리지느러미	k͈ o̞ ɾ i d͡ʑ i n ɯ ɾ ʌ̹ m i
꼬리표	k͈ o̞ ɾ i pʰ j o
꼬마	k͈ o̞ m a̠
꼬물꼬물	k͈ o̞ m u ɭ k͈ o̞ m u ɭ
꼬치	k͈ o̞ t͡ɕʰ i
꼬치구이	k͈ o̞ t͡ɕʰ i ɡ u i
꼭두각시	k͈ o̞ k̚ t͈ u ɡ a̠ k ɕ͈ i
꼭지이응	k͈ o̞ k̚ t͡ɕ͈ i i ɯ ŋ
꼴꼴	k͈ o̞ ɭ k͈ o̞ ɭ
꼼수	k͈ o̞ m sʰ u
꼼실꼼실	k͈ o̞ m ɕʰ i ɭ k͈ o̞ m ɕʰ i ɭ
꼼작꼼작	k͈ o̞ m d͡ʑ a̠ k̚ k͈ o̞ m d͡ʑ a̠ k̚
꼼지락꼼지락	k͈ o̞ m d͡ʑ i ɾ a̠ k̚ k͈ o̞ m d͡ʑ i ɾ a̠ k̚
꼼짝	k͈ o̞ m t͡ɕ͈ a̠ k̚
꼼트락꼼트락	k͈ o̞ m tʰ ɯ ɾ a̠ k̚ k͈ o̞ m tʰ ɯ ɾ a̠ k̚
꽁무니	k͈ o̞ ŋ m u n i
꽁치	k͈ o̞ ŋ t͡ɕʰ i
꽂다	k͈ o̞ t̚ t͈ a̠
꽃가루	k͈ o̞ t̚ k͈ a̠ ɾ u
꽃꽂이	k͈ o̞ t̚ k͈ o̞ d͡ʑ i
꽃다발	k͈ o̞ t̚ t͈ a̠ b a̠ ɭ
꽃병	k͈ o̞ t̚ p͈ j ʌ̹ ŋ
꽃봉오리	k͈ o̞ t̚ p͈ o̞ ŋ o̞ ɾ i
꽃잎	k͈ o̞ n n i p̚
꽃집	k͈ o̞ t̚ t͡ɕ͈ i p̚
꽈리	k͈ w a̠ ɾ i
꽈잘	k͈ w a̠ d͡ʑ a̠ ɭ
꾀꼬리	k͈ w e̞ k͈ o̞ ɾ i
꾀병	k͈ w e̞ b j ʌ̹ ŋ
꾸러미	k͈ u ɾ ʌ̹ m i
꾸르륵	k͈ u ɾ ɯ ɾ ɯ k̚
꾸리다	k͈ u ɾ i d a̠
꾸물꾸물	k͈ u m u ɭ k͈ u m u ɭ
꾸짖다	k͈ u d͡ʑ i t̚ t͈ a̠
꿀밤	k͈ u ɭ b a̠ m
꿀벌	k͈ u ɭ b ʌ̹ ɭ
꿈꾸다	k͈ u m k͈ u d a̠
꿈적	k͈ u m d͡ʑ ʌ̹ k̚
꿈지럭꿈지럭	k͈ u m d͡ʑ i ɾ ʌ̹ k̚ k͈ u m d͡ʑ i ɾ ʌ̹ k̚
꿈쩍	k͈ u m t͡ɕ͈ ʌ̹ k̚
꿈쩍꿈쩍	k͈ u m t͡ɕ͈ ʌ̹ k̚ k͈ u m t͡ɕ͈ ʌ̹ k̚
꿈틀	k͈ u m tʰ ɯ ɭ
끄집다	k͈ ɯː d͡ʑ i p̚ t͈ a̠
끈기	k͈ ɯ n ɡ i
끊다	k͈ ɯ n tʰ a̠
끊임없이	k͈ ɯ n i m ʌ̹ p ɕ͈ i
끌신	k͈ ɯː ɭ ɕʰ i n
끌어안다	k͈ ɯː ɾ ʌ̹ a̠ n t͈ a̠
끓이다	k͈ ɯː ɾ i d a̠
끔벅	k͈ ɯ m b ʌ̹ k̚
끔벅끔벅	k͈ ɯ m b ʌ̹ k̚ k͈ ɯ m b ʌ̹ k̚
끔뻑끔뻑	k͈ ɯ m p͈ ʌ̹ k̚ k͈ ɯ m p͈ ʌ̹ k̚
끔적끔적	k͈ ɯ m d͡ʑ ʌ̹ k̚ k͈ ɯ m d͡ʑ ʌ̹ k̚
끔쩍	k͈ ɯ m t͡ɕ͈ ʌ̹ k̚
끔찍하다	k͈ ɯ m t͡ɕ͈ i kʰ a̠ d a̠
끝장	k͈ ɯ t̚ t͡ɕ͈ a̠ ŋ
끼니	k͈ i n i
끼다	k͈ i d a̠
끼리	k͈ i ɾ i
끼우다	k͈ i u d a̠
끼치다	k͈ i t͡ɕʰ i d a̠
나가다	n a̠ ɡ a̠ d a̠
나나니	n a̠ n a̠ n i
나누다	n a̠ n u d a̠
나다	n a̠ d a̠
나라	n a̠ ɾ a̠
나라님	n a̠ ɾ a̠ n i m
나라말	n a̠ ɾ a̠ m a̠ ɭ
나란히	n a̠ ɾ a̠ n ʝ i
나랑	n a̠ ɾ a̠ ŋ
나름	n a̠ ɾ ɯ m
나리	n a̠ ɾ i
나머지	n a̠ m ʌ̹ d͡ʑ i
나무	n a̠ m u
나물	n a̠ m u ɭ
나뭇가지	n a̠ m u t̚ k͈ a̠ d͡ʑ i
나미비아	n a̠ m i b i a̠
나방	n a̠ b a̠ ŋ
나비	n a̠ b i
나쁘다	n a̠ p͈ ɯ d a̠
나사	n a̠ sʰ a̠
나서다	n a̠ sʰ ʌ̹ d a̠
나선형	n a̠ sʰ ʌ̹ n ʝ j ʌ̹ ŋ
나소	n a̠ sʰ o̞
나시	n a̠ ɕʰ i
나아가다	n a̠ a̠ ɡ a̠ d a̠
나오다	n a̠ o̞ d a̠
나우루	n a̠ u ɾ u
나의	n a̠ ɰ i
나이	n a̠ i
나이로비	n a̠ i ɾ o̞ b i
나이오븀	n a̠ i o̞ b j u m
나이지리아	n a̠ i d͡ʑ i ɾ i a̠
나이트	n a̠ i tʰ ɯ
나이프	n a̠ i pʰ ɯ
나일론	n a̠ i ɭ ɭ o̞ n
나일틸라피아	n a̠ i ɭ tʰ i ɭ ɭ a̠ pʰ i a̠
나중	n a̠ː d͡ʑ u ŋ
나찰	n a̠ t͡ɕʰ a̠ ɭ
나치	n a̠ t͡ɕʰ i
나치즘	n a̠ t͡ɕʰ i d͡ʑ ɯ m
나침반	n a̠ t͡ɕʰ i m b a̠ n
나타나다	n a̠ tʰ a̠ n a̠ d a̠
나트륨	n a̠ tʰ ɯ ɾ j u m
나팔꽃	n a̠ pʰ a̠ ɭ k͈ o̞ t̚
나포	n a̠ː pʰ o̞
나폴리	n a̠ pʰ o̞ ʎ ʎ i
나한	n a̠ ɦ a̠ n
나홋카	n a̠ β o̞ t̚ kʰ a̠
나환자	n a̠ː β w a̠ ɲ d͡ʑ a̠
나흘	n a̠ ɣ ɯ ɭ
낙동강	n a̠ k̚ t͈ o̞ ŋ ɡ a̠ ŋ
낙엽	n a̠ ɡ j ʌ̹ p̚
낙인	n a̠ ɡ i n
낙지	n a̠ k̚ t͡ɕ͈ i
낙타	n a̠ k̚ tʰ a̠
낙하산	n a̠ kʰ a̠ sʰ a̠ n
낙하하다	n a̠ kʰ a̠ ɦ a̠ d a̠
낚다	n a̠ k̚ t͈ a̠
낚시	n a̠ k ɕ͈ i
낚시꾼	n a̠ k ɕ͈ i k͈ u n
낚시터	n a̠ k ɕ͈ i tʰ ʌ̹
난간	n a̠ n ɡ a̠ n
난로	n a̠ː ɭ ɭ o̞
난리	n a̠ː ʎ ʎ i
난민	n a̠ n m i n
난방	n a̠ n b a̠ ŋ
난센스	n a̠ n sʰ e̞ n sʰ ɯ
난소	n a̠ n sʰ o̞
난수	n a̠ n sʰ u
난시	n a̠ː n ɕʰ i
난자	n a̠ː ɲ d͡ʑ a̠
난초	n a̠ ɲ t͡ɕʰ o̞
난추니	n a̠ː ɲ t͡ɕʰ u n i
난치	n a̠ ɲ t͡ɕʰ i
날것	n a̠ ɭ ɡ ʌ̹ t̚
날고기	n a̠ ɭ ɡ o̞ ɡ i
날다	n a̠ ɭ d a̠
날리다	n a̠ ʎ ʎ i d a̠
날마다	n a̠ ɭ m a̠ d a̠
날아오르다	n a̠ ɾ a̠ o̞ ɾ ɯ d a̠
날짜	n a̠ ʎ t͡ɕ͈ a̠
날카롭다	n a̠ ɭ kʰ a̠ ɾ o̞ p̚ t͈ a̠
남극	n a̠ m ɡ ɯ k̚
남녀	n a̠ m ɲ j ʌ̹
남녀노소	n a̠ m ɲ j ʌ̹ n o̞ sʰ o̞
남루	n a̠ː m n u
남미	n a̠ m m i
남반구	n a̠ː m b a̠ n ɡ u
남방	n a̠ m b a̠ ŋ
남방동사리	n a̠ m b a̠ ŋ d o̞ ŋ sʰ a̠ ɾ i
남벌	n a̠ː m b ʌ̹ ɭ
남부	n a̠ m b u
남빙양	n a̠ m b i ŋ ɲ j a̠ ŋ
남서부	n a̠ m sʰ ʌ̹ b u
남성	n a̠ m sʰ ʌ̹ ŋ
남아메리카	n a̠ m a̠ m e̞ ɾ i kʰ a̠
남아프리카	n a̠ m a̠ pʰ ɯ ɾ i kʰ a̠
남용	n a̠ː m j o ŋ
남자답다	n a̠ m d͡ʑ a̠ d a̠ p̚ t͈ a̠
남자아이	n a̠ m d͡ʑ a̠ a̠ i
남작	n a̠ m d͡ʑ a̠ k̚
남장	n a̠ m d͡ʑ a̠ ŋ
남조선	n a̠ m d͡ʑ o̞ sʰ ʌ̹ n
남쪽	n a̠ m t͡ɕ͈ o̞ k̚
남체	n a̠ m t͡ɕʰ e̞
남초	n a̠ m t͡ɕʰ o̞
남측	n a̠ m t͡ɕʰ ɯ k̚
남편	n a̠ m pʰ j ʌ̹ n
남포	n a̠ m pʰ o̞
남프릭	n a̠ m pʰ ɯ ɾ i k̚
남한	n a̠ m ɦ a̠ n
납세자	n a̠ p s͈ e̞ d͡ʑ a̠
납작하다	n a̠ p̚ t͡ɕ͈ a̠ kʰ a̠ d a̠
납지리	n a̠ p̚ t͡ɕ͈ i ɾ i
납치	n a̠ p̚ t͡ɕʰ i
납품하다	n a̠ p̚ pʰ u m ɦ a̠ d a̠
낫다	n a̠ː t̚ t͈ a̠
낭비	n a̠ː ŋ b i
낭인	n a̠ː ŋ i n
낮다	n a̠ t̚ t͈ a̠
낮아지다	n a̠ d͡ʑ a̠ d͡ʑ i d a̠
낮잠	n a̠ t̚ t͡ɕ͈ a̠ m
낮추다	n a̠ t̚ t͡ɕʰ u d a̠
낯가리다	n a̠ t̚ k͈ a̠ ɾ i d a̠
낯익다	n a̠ n n i k̚ t͈ a̠
낱낱이	n a̠ː n n a̠ t͡ɕʰ i
낱말	n a̠ː n m a̠ ɭ
낳다	n a̠ tʰ a̠
내과	n ɛː k͈ w a̠
내국인	n ɛː ɡ u ɡ i n
내륙	n ɛː ɾ j u k̚
내몽고	n ɛː m o̞ ŋ ɡ o̞
내밀다	n ɛː m i ɭ d a̠
내부	n ɛː b u
내심	n ɛː ɕʰ i m
내야수	n ɛː j a̠ sʰ u
내외	n ɛː w e̞
내용	n ɛː j o ŋ
내장	n ɛː d͡ʑ a̠ ŋ
내전	n ɛː d͡ʑ ʌ̹ n
내주	n ɛː d͡ʑ u
내주다	n ɛː d͡ʑ u d a̠
내측광근	n ɛː t͡ɕʰ ɯ k̚ k͈ w a̠ ŋ ɡ ɯ n
내한	n ɛː ɦ a̠ n
냉기	n ɛː ŋ ɡ i
냉동	n ɛː ŋ d o̞ ŋ
냉동고	n ɛː ŋ d o̞ ŋ ɡ o̞
냉수	n ɛː ŋ sʰ u
냉장고	n ɛː ŋ d͡ʑ a̠ ŋ ɡ o̞
냉전	n ɛː ŋ d͡ʑ ʌ̹ n
냠냠	ɲ j a̠ m ɲ j a̠ m
너그럽다	n ʌ̹ ɡ ɯ ɾ ʌ̹ p̚ t͈ a̠
너나들이	n ʌ̹ n a̠ d ɯ ɾ i
너네	n ʌ̹ n e̞
너덧	n ʌ̹ d ʌ̹ t̚
너머	n ʌ̹ m ʌ̹
너머로	n ʌ̹ m ʌ̹ ɾ o̞
너무	n ʌ̹ m u
너무나	n ʌ̹ m u n a̠
너비아니	n ʌ̹ b i a̠ n i
너트	n ʌ̹ tʰ ɯ
너희	n ʌ̹ ʝ i
널다	n ɘː ɭ d a̠
널뛰기	n ʌ̹ ɭ t͈ ɥ i ɡ i
널리	n ʌ̹ ʎ ʎ i
넓다	n ʌ̹ ɭ t͈ a̠
넓이	n ʌ̹ ɭ b i
넓적다리	n ʌ̹ p̚ t͡ɕ͈ ʌ̹ k̚ t͈ a̠ ɾ i
넘기다	n ʌ̹ m ɡ i d a̠
넘다	n ɘː m t͈ a̠
넘실트리다	n ʌ̹ m ɕʰ i ɭ tʰ ɯ ɾ i d a̠
넘치다	n ɘː m t͡ɕʰ i d a̠
넙치	n ʌ̹ p̚ t͡ɕʰ i
넣다	n ɘː tʰ a̠
네거리	n e̞ː ɡ ʌ̹ ɾ i
네다섯	n e̞ː d a̠ sʰ ʌ̹ t̚
네모	n e̞ː m o̞
네모꼴	n e̞ː m o̞ k͈ o̞ ɭ
네바다	n e̞ b a̠ d a̠
네오나치	n e̞ o̞ n a̠ t͡ɕʰ i
네이멍구	n e̞ i m ʌ̹ ŋ ɡ u
네트워크	n e̞ tʰ ɯ w ʌ̹ k x ɯ
네티즌	n e̞ tʰ i d͡ʑ ɯ n
네피도	n e̞ pʰ i d o̞
넥타이	n e̞ k̚ tʰ a̠ i
넵투늄	n e̞ p̚ tʰ u ɲ j u m
녀석	ɲ j ʌ̹ sʰ ʌ̹ k̚
녀성중음	ɲ j ʌ̹ sʰ ʌ̹ ŋ d͡ʑ u ŋ ɯ m
녀신	ɲ j ʌ̹ ɕʰ i n
녀인	ɲ j ʌ̹ i n
년도	ɲ j ʌ̹ n d o̞
노고지리	n o̞ ɡ o̞ d͡ʑ i ɾ i
노끈	n o̞ k͈ ɯ n
노네인	n o̞ n e̞ i n
노년	n o̞ː ɲ j ʌ̹ n
노동	n o̞ d o̞ ŋ
노동계급	n o̞ d o̞ ŋ ɡ j e̞ ɡ ɯ p̚
노동법	n o̞ d o̞ ŋ p͈ ʌ̹ p̚
노동자	n o̞ d o̞ ŋ d͡ʑ a̠
노랑	n o̞ ɾ a̠ ŋ
노랗다	n o̞ː ɾ a̠ tʰ a̠
노려보다	n o̞ ɾ j ʌ̹ b o̞ d a̠
노력	n o̞ ɾ j ʌ̹ k̚
노력하다	n o̞ ɾ j ʌ̹ kʰ a̠ d a̠
노루	n o̞ ɾ u
노르마	n o̞ ɾ ɯ m a̠
노르웨이	n o̞ ɾ ɯ w e̞ i
노르웨이어	n o̞ ɾ ɯ w e̞ i ʌ̹
노른자	n o̞ ɾ ɯ ɲ d͡ʑ a̠
노른자위	n o̞ ɾ ɯ ɲ d͡ʑ a̠ ɥ i
노름	n o̞ ɾ ɯ m
노리다	n o̞ ɾ i d a̠
노망	n o̞ː m a̠ ŋ
노면	n o̞ m j ʌ̹ n
노면전차	n o̞ m j ʌ̹ ɲ d͡ʑ ʌ̹ ɲ t͡ɕʰ a̠
노병	n o̞ː b j ʌ̹ ŋ
노보시비르스크	n o̞ b o̞ ɕʰ i b i ɾ ɯ sʰ ɯ k x ɯ
노사	n o̞ː sʰ a̠
노서아	n o̞ sʰ ʌ̹ a̠
노선	n o̞ː sʰ ʌ̹ n
노선도	n o̞ː sʰ ʌ̹ n d o̞
노쇠	n o̞ː sʰ w e̞
노숙자	n o̞ sʰ u k̚ t͡ɕ͈ a̠
노아	n o̞ a̠
노안	n o̞ː a̠ n
노어	n o̞ ʌ̹
노여움	n o̞ː j ʌ̹ u m
노엽다	n o̞ː j ʌ̹ p̚ t͈ a̠
노예	n o̞ j e̞
노워스티	n o̞ w ʌ̹ sʰ ɯ tʰ i
노이로제	n o̞ i ɾ o̞ d͡ʑ e̞
노인	n o̞ː i n
노인학	n o̞ː i n ɦ a̠ k̚
노처녀	n o̞ː t͡ɕʰ ʌ̹ ɲ j ʌ̹
노천	n o̞ t͡ɕʰ ʌ̹ n
노크	n o̞ k x ɯ
노트	n o̞ tʰ ɯ
노트북	n o̞ tʰ ɯ b u k̚
노파	n o̞ː pʰ a̠
노파심	n o̞ː pʰ a̠ ɕʰ i m
노환	n o̞ː β w a̠ n
녹말	n o̞ ŋ m a̠ ɭ
녹음	n o̞ ɡ ɯ m
녹음기	n o̞ ɡ ɯ m ɡ i
녹음실	n o̞ ɡ ɯ m ɕʰ i ɭ
녹차	n o̞ k̚ t͡ɕʰ a̠
논다니	n o̞ː n d a̠ n i
논리	n o̞ ʎ ʎ i
논문	n o̞ n m u n
논병아리	n o̞ n b j ʌ̹ ŋ a̠ ɾ i
논어	n o̞ n ʌ̹
논의	n o̞ n ɰ i
논의하다	n o̞ n ɰ i ɦ a̠ d a̠
논평	n o̞ n pʰ j ʌ̹ ŋ
논하다	n o̞ n ɦ a̠ d a̠
놀라움	n o̞ː ɭ ɭ a̠ u m
놀랍다	n o̞ː ɭ ɭ a̠ p̚ t͈ a̠
놀이	n o̞ ɾ i
놀이감	n o̞ ɾ i ɡ a̠ m
놀이터	n o̞ ɾ i tʰ ʌ̹
농경	n o̞ ŋ ɡ j ʌ̹ ŋ
농구	n o̞ ŋ ɡ u
농민	n o̞ ŋ m i n
농부	n o̞ ŋ b u
농사	n o̞ ŋ sʰ a̠
농산물	n o̞ ŋ sʰ a̠ n m u ɭ
농어	n o̞ ŋ ʌ̹
농업	n o̞ ŋ ʌ̹ p̚
농장	n o̞ ŋ d͡ʑ a̠ ŋ
농촌	n o̞ ŋ t͡ɕʰ o̞ n
높다	n o̞ p̚ t͈ a̠
높이	n o̞ pʰ i
높이다	n o̞ pʰ i d a̠
놓다	n o̞ tʰ a̠
놓이다	n o̞ i d a̠
뇌관	n w e̞ ɡ w a̠ n
뇌물	n w e̞ m u ɭ
뇌우	n w e̞ u
뇌피셜	n w e̞ pʰ i ɕʰ ʌ̹ ɭ
누계	n uː ɡ j e̞
누구	n u ɡ u
누구세요	n u ɡ u sʰ e̞ j o
누군가	n u ɡ u n ɡ a̠
누나	n uː n a̠
누님	n u n i m
누두	n uː d u
누들	n u d ɯ ɭ
누르다	n uː ɾ ɯ d a̠
누리	n u ɾ i
누리꾼	n u ɾ i k͈ u n
누리집	n u ɾ i d͡ʑ i p̚
누설	n uː sʰ ʌ̹ ɭ
누악쇼트	n u a̠ k ɕ͈ o tʰ ɯ
누에	n u e̞
누이	n u i
누적	n uː d͡ʑ ʌ̹ k̚
누치	n u t͡ɕʰ i
눈곱	n u n k͈ o̞ p̚
눈길	n u n k͈ i ɭ
눈꺼풀	n u n k͈ ʌ̹ pʰ u ɭ
눈꼴사납다	n u n k͈ o̞ ɭ sʰ a̠ n a̠ p̚ t͈ a̠
눈꽃	n uː n k͈ o̞ t̚
눈다랑어	n u n d a̠ ɾ a̠ ŋ ʌ̹
눈물	n u n m u ɭ
눈보라	n u n b o̞ ɾ a̠
눈빛	n u n p͈ i t̚
눈사람	n uː n s͈ a̠ ɾ a̠ m
눈송이	n uː n s͈ o̞ ŋ i
눈앞	n u n a̠ p̚
눈엣가시	n u n e̞ t̚ k͈ a̠ ɕʰ i
눈웃음	n u n u sʰ ɯ m
뉴델리	ɲ j u d e̞ ʎ ʎ i
뉴런	ɲ j u ɾ ʌ̹ n
뉴스	ɲ j u s͈ ɯ
뉴욕	ɲ j u j o k̚
뉴트리아	ɲ j u tʰ ɯ ɾ i a̠
느끼다	n ɯ k͈ i d a̠
느낌	n ɯ k͈ i m
느리다	n ɯ ɾ i d a̠
는다	n ɯ n d a̠
는데	n ɯ n d e̞
는지	n ɯ ɲ d͡ʑ i
늘리다	n ɯ ʎ ʎ i d a̠
늘어나다	n ɯ ɾ ʌ̹ n a̠ d a̠
늙다	n ɯ k̚ t͈ a̠
능가	n ɯ ŋ ɡ a̠
능력	n ɯ ŋ ɲ j ʌ̹ k̚
능률	n ɯ ŋ ɲ j u ɭ
능하다	n ɯ ŋ ɦ a̠ d a̠
능히	n ɯ ŋ ʝ i
늦가을	n ɯ t̚ k͈ a̠ ɯ ɭ
늦다	n ɯ t̚ t͈ a̠
늦잠	n ɯ t̚ t͡ɕ͈ a̠ m
니은	n i ɯ n
니제르	n i d͡ʑ e̞ ɾ ɯ
니카라과	n i kʰ a̠ ɾ a̠ ɡ w a̠
니켈	n i kʰ e̞ ɭ
니코틴	n i kʰ o̞ tʰ i n
니트릴	n i tʰ ɯ ɾ i ɭ
니호늄	n i β o̞ ɲ j u m
닉네임	n i ŋ n e̞ i m
닌자	n i ɲ d͡ʑ a̠
닝샤	n i ŋ ɕʰ a̠
다가오다	t a̠ ɡ a̠ o̞ d a̠
다과	t a̠ ɡ w a̠
다니다	t a̠ n i d a̠
다다미	t a̠ d a̠ m i
다들	t a̠ d ɯ ɭ
다듬다	t a̠ d ɯ m t͈ a̠
다락	t a̠ ɾ a̠ k̚
다락방	t a̠ ɾ a̠ k̚ p͈ a̠ ŋ
다람쥐	t a̠ ɾ a̠ m d͡ʑ ɥ i
다랗다	t a̠ ɾ a̠ tʰ a̠
다롄	t a̠ ɾ j e̞ n
다루다	t a̠ ɾ u d a̠
다르다	t a̠ ɾ ɯ d a̠
다른	t a̠ ɾ ɯ n
다리	t a̠ ɾ i
다리미	t a̠ ɾ i m i
다림질	t a̠ ɾ i m d͡ʑ i ɭ
다마네기	t a̠ m a̠ n e̞ ɡ i
다마스쿠스	t a̠ m a̠ sʰ ɯ kʰ u sʰ ɯ
다만	t a̠ː m a̠ n
다문화	t a̠ m u n β w a̠
다발	t a̠ b a̠ ɭ
다부지다	t a̠ b u d͡ʑ i d a̠
다섯	t a̠ sʰ ʌ̹ t̚
다소	t a̠ sʰ o̞
다수	t a̠ sʰ u
다스	t a̠ sʰ ɯ
다시	t a̠ ɕʰ i
다양	t a̠ j a̠ ŋ
다양하다	t a̠ j a̠ ŋ ɦ a̠ d a̠
다엽	t a̠ j ʌ̹ p̚
다운로드	t a̠ u n n o̞ d ɯ
다윗	t a̠ ɥ i t̚
다이아몬드	t a̠ i a̠ m o̞ n d ɯ
다이어트	t a̠ i ʌ̹ tʰ ɯ
다이오드	t a̠ i o̞ d ɯ
다정하다	t a̠ d͡ʑ ʌ̹ ŋ ɦ a̠ d a̠
다정히	t a̠ d͡ʑ ʌ̹ ŋ ʝ i
다지다	t a̠ d͡ʑ i d a̠
다짐	t a̠ d͡ʑ i m
다치다	t a̠ t͡ɕʰ i d a̠
다카	t a̠ kʰ a̠
다크서클	t a̠ k x ɯ s͈ ʌ̹ k x ɯ ɭ
다투다	t a̠ tʰ u d a̠
다툼	t a̠ tʰ u m
닥나무	t a̠ ŋ n a̠ m u
닦다	t a̠ k̚ t͈ a̠
단계	t a̠ n ɡ j e̞
단고기	t a̠ n ɡ o̞ ɡ i
단골	t a̠ n ɡ o̞ ɭ
단념	t a̠ː n ɲ j ʌ̹ m
단념하다	t a̠ː n ɲ j ʌ̹ m ɦ a̠ d a̠
단단하다	t a̠ n d a̠ n ɦ a̠ d a̠
단락	t a̠ ɭ ɭ a̠ k̚
단수	t a̠ n sʰ u
단순	t a̠ n sʰ u n
단순하다	t a̠ n sʰ u n ɦ a̠ d a̠
단순히	t a̠ n sʰ u n ʝ i
단어	t a̠ n ʌ̹
단위	t a̠ n ɥ i
단일	t a̠ n i ɭ
단자	t a̠ ɲ d͡ʑ a̠
단지	t a̠ ɲ d͡ʑ i
단천	t a̠ ɲ t͡ɕʰ ʌ̹ n
단풍	t a̠ n pʰ u ŋ
단풍국	t a̠ n pʰ u ŋ ɡ u k̚
달걀	t a̠ ɭ ɡ j a̠ ɭ
달구다	t a̠ ɭ ɡ u d a̠
달려가다	t a̠ ʎ ʎ j ʌ̹ ɡ a̠ d a̠
달력	t a̠ ʎ ʎ j ʌ̹ k̚
달리	t a̠ ʎ ʎ i
달리다	t a̠ ʎ ʎ i d a̠
달마다	t a̠ ɭ m a̠ d a̠
달맞이	t a̠ ɭ m a̠ d͡ʑ i
달비	t a̠ ɭ b i
달빛	t a̠ ɭ p͈ i t̚
달성	t a̠ ɭ s͈ ʌ̹ ŋ
달아나다	t a̠ ɾ a̠ n a̠ d a̠
달인	t a̠ ɾ i n
달콤하다	t a̠ ɭ kʰ o̞ m ɦ a̠ d a̠
닭고기	t a̠ k̚ k͈ o̞ ɡ i
닭발	t a̠ k̚ p͈ a̠ ɭ
닭살	t a̠ k s͈ a̠ ɭ
닳다	t a̠ ɭ tʰ a̠
담다	t a̠ː m t͈ a̠
담담하다	t a̠ m d a̠ m ɦ a̠ d a̠
담당	t a̠ m d a̠ ŋ
담당하다	t a̠ m d a̠ ŋ ɦ a̠ d a̠
담벼락	t a̠ m p͈ j ʌ̹ ɾ a̠ k̚
담요	t a̠ː m ɲ j o
담임	t a̠ m i m
답다	t a̠ p̚ t͈ a̠
답답하다	t a̠ p̚ t͈ a̠ pʰ a̠ d a̠
답변	t a̠ p̚ p͈ j ʌ̹ n
답사	t a̠ p s͈ a̠
답습	t a̠ p s͈ ɯ p̚
답장	t a̠ p̚ t͡ɕ͈ a̠ ŋ
답정너	t a̠ p̚ t͡ɕ͈ ʌ̹ ŋ n ʌ̹
당구	t a̠ ŋ ɡ u
당국	t a̠ ŋ ɡ u k̚
당근	t a̠ ŋ ɡ ɯ n
당나귀	t a̠ ŋ n a̠ ɡ ɥ i
당뇨병	t a̠ ŋ ɲ j o p͈ j ʌ̹ ŋ
당당하다	t a̠ ŋ d a̠ ŋ ɦ a̠ d a̠
당류	t a̠ ŋ ɲ j u
당면	t a̠ ŋ m j ʌ̹ n
당시	t a̠ ŋ ɕʰ i
당연	t a̠ ŋ j ʌ̹ n
당연하다	t a̠ ŋ j ʌ̹ n ɦ a̠ d a̠
당연히	t a̠ ŋ j ʌ̹ n ʝ i
당중앙	t a̠ ŋ d͡ʑ u ŋ a̠ ŋ
당질	t a̠ ŋ d͡ʑ i ɭ
당황	t a̠ ŋ β w a̠ ŋ
닿다	t a̠ː tʰ a̠
대검집	t ɛː ɡ ʌ̹ m d͡ʑ i p̚
대관령	t ɛː ɡ w a̠ ʎ ʎ j ʌ̹ ŋ
대국	t ɛː ɡ u k̚
대궐	t ɛː ɡ w ʌ̹ ɭ
대규모	t ɛː ɡ j u m o̞
대기	t ɛː ɡ i
대기실	t ɛː ɡ i ɕʰ i ɭ
대기업	t ɛː ɡ i ʌ̹ p̚
대기하다	t ɛː ɡ i ɦ a̠ d a̠
대다	t ɛː d a̠
대단하다	t ɛː d a̠ n ɦ a̠ d a̠
대단히	t ɛː d a̠ n ʝ i
대답	t ɛː d a̠ p̚
대동강	t ɛː d o̞ ŋ ɡ a̠ ŋ
대두	t ɛː d u
대략	t ɛː ɾ j a̠ k̚
대량	t ɛː ɾ j a̠ ŋ
대령	t ɛː ɾ j ʌ̹ ŋ
대륙	t ɛː ɾ j u k̚
대리석	t ɛː ɾ i sʰ ʌ̹ k̚
대리인	t ɛː ɾ i i n
대리점	t ɛː ɾ i d͡ʑ ʌ̹ m
대마	t ɛː m a̠
대명사	t ɛː m j ʌ̹ ŋ sʰ a̠
대모	t ɛː m o̞
대문	t ɛː m u n
대박	t ɛː b a̠ k̚
대변	t ɛː b j ʌ̹ n
대보름	t ɛː b o̞ ɾ ɯ m
대부분	t ɛː b u b u n
대비하다	t ɛː b i ɦ a̠ d a̠
대사	t ɛː sʰ a̠
대사관	t ɛː sʰ a̠ ɡ w a̠ n
대상	t ɛː sʰ a̠ ŋ
대서양	t ɛː sʰ ʌ̹ j a̠ ŋ
대성당	t ɛː sʰ ʌ̹ ŋ d a̠ ŋ
대수	t ɛː sʰ u
대신	t ɛː ɕʰ i n
대양	t ɛː j a̠ ŋ
대여섯	t ɛː j ʌ̹ sʰ ʌ̹ t̚
대역죄	t ɛː j ʌ̹ k̚ t͡ɕ͈ w e̞
대영제국	t ɛː j ʌ̹ ŋ d͡ʑ e̞ ɡ u k̚
대우	t ɛː u
대원수	t ɛː w ʌ̹ n sʰ u
대위	t ɛː ɥ i
대응	t ɛː ɯ ŋ
대자보	t ɛː d͡ʑ a̠ b o̞
대작자	t ɛː d͡ʑ a̠ k̚ t͡ɕ͈ a̠
대장	t ɛː d͡ʑ a̠ ŋ
대전	t ɛː d͡ʑ ʌ̹ n
대접	t ɛː d͡ʑ ʌ̹ p̚
대접하다	t ɛː d͡ʑ ʌ̹ pʰ a̠ d a̠
대주교	t ɛː d͡ʑ u ɡ j o
대중	t ɛː d͡ʑ u ŋ
대중교통	t ɛː d͡ʑ u ŋ ɡ j o tʰ o̞ ŋ
대중문화	t ɛː d͡ʑ u ŋ m u n β w a̠
대중음악	t ɛː d͡ʑ u ŋ ɯ m a̠ k̚
대지	t ɛː d͡ʑ i
대체로	t ɛː t͡ɕʰ e̞ ɾ o̞
대출	t ɛː t͡ɕʰ u ɭ
대충	t ɛː t͡ɕʰ u ŋ
대치	t ɛː t͡ɕʰ i
대퇴	t ɛː tʰ w e̞
대포	t ɛː pʰ o̞
대폭적	t ɛː pʰ o̞ k̚ t͡ɕ͈ ʌ̹ k̚
대표	t ɛː pʰ j o
대표단	t ɛː pʰ j o d a̠ n
대표적	t ɛː pʰ j o d͡ʑ ʌ̹ k̚
대학	t ɛː ɦ a̠ k̚
대학교	t ɛː ɦ a̠ k̚ k͈ j o
대학수학능력시험	t ɛː ɦ a̠ k s͈ u ɦ a̠ ŋ n ɯ ŋ ɲ j ʌ̹ k ɕ͈ i ɦ ʌ̹ m
대학원	t ɛː ɦ a̠ ɡ w ʌ̹ n
대한민국	t ɛː ɦ a̠ n m i n ɡ u k̚
대한제국	t ɛː ɦ a̠ ɲ d͡ʑ e̞ ɡ u k̚
대합실	t ɛː ɦ a̠ p ɕ͈ i ɭ
대회	t ɛː β w e̞
더듬다	t ʌ̹ d ɯ m t͈ a̠
더듬이	t ʌ̹ d ɯ m i
더러워지다	t ɘː ɾ ʌ̹ w ʌ̹ d͡ʑ i d a̠
더럽다	t ɘː ɾ ʌ̹ p̚ t͈ a̠
더미	t ʌ̹ m i
더불다	t ʌ̹ b u ɭ d a̠
더불어	t ʌ̹ b u ɾ ʌ̹
더블린	t ʌ̹ b ɯ ʎ ʎ i n
더빙	t ʌ̹ b i ŋ
더욱	t ʌ̹ u k̚
더욱이	t ʌ̹ u ɡ i
더위	t ʌ̹ ɥ i
더위팔기	t ʌ̹ ɥ i pʰ a̠ ɭ ɡ i
더하기	t ʌ̹ ɦ a̠ ɡ i
더하다	t ʌ̹ ɦ a̠ d a̠
덕분	t ʌ̹ k̚ p͈ u n
덕트	t ʌ̹ k̚ tʰ ɯ
던데	t ʌ̹ n d e̞
던지다	t ʌ̹ ɲ d͡ʑ i d a̠
던지럽다	t ɘː ɲ d͡ʑ i ɾ ʌ̹ p̚ t͈ a̠
덧글	t ʌ̹ t̚ k͈ ɯ ɭ
덧머리	t ʌ̹ n m ʌ̹ ɾ i
덩어리	t ʌ̹ ŋ ʌ̹ ɾ i
덮이다	t ʌ̹ pʰ i d a̠
데릴사위	t e̞ ɾ i ɭ s͈ a̠ ɥ i
데모	t e̞ m o̞
데이터	t e̞ i tʰ ʌ̹
데이터베이스	t e̞ i tʰ ʌ̹ b e̞ i sʰ ɯ
데이트	t e̞ i tʰ ɯ
덴마크	t e̞ n m a̠ k x ɯ
덴마크어	t e̞ n m a̠ k x ɯ ʌ̹
덴뿌라	t e̞ n p͈ u ɾ a̠
델리	t e̞ ʎ ʎ i
도가니	t o̞ ɡ a̠ n i
도교	t o̞ː ɡ j o
도구	t o̞ː ɡ u
도금	t o̞ː ɡ ɯ m
도기	t o̞ ɡ i
도꾜	t o̞ k͈ j o
도끼	t o̞ k͈ i
도난	t o̞ n a̠ n
도넛	t o̞ n ʌ̹ t̚
도다리	t o̞ d a̠ ɾ i
도달	t o̞ː d a̠ ɭ
도달하다	t o̞ː d a̠ ɾ ɦ a̠ d a̠
도덕	t o̞ː d ʌ̹ k̚
도도마	t o̞ d o̞ m a̠
도둑	t o̞ d u k̚
도랑	t o̞ ɾ a̠ ŋ
도로	t o̞ː ɾ o̞
도료	t o̞ ɾ j o
도루	t o̞ ɾ u
도륙	t o̞ ɾ j u k̚
도리어	t o̞ ɾ i ʌ̹
도망	t o̞ m a̠ ŋ
도망치다	t o̞ m a̠ ŋ t͡ɕʰ i d a̠
도메인	t o̞ m e̞ i n
도모	t o̞ m o̞
도모하다	t o̞ m o̞ ɦ a̠ d a̠
도미니카	t o̞ m i n i kʰ a̠
도박	t o̞ b a̠ k̚
도벽	t o̞ b j ʌ̹ k̚
도시	t o̞ ɕʰ i
도시락	t o̞ ɕʰ i ɾ a̠ k̚
도예	t o̞ j e̞
도우미	t o̞ u m i
도움	t o̞ u m
도입	t o̞ː i p̚
도입부	t o̞ i p̚ p͈ u
도자기	t o̞ d͡ʑ a̠ ɡ i
도작	t o̞ d͡ʑ a̠ k̚
도장	t o̞ d͡ʑ a̠ ŋ
도저히	t o̞ː d͡ʑ ʌ̹ ʝ i
도적	t o̞ d͡ʑ ʌ̹ k̚
도전	t o̞ d͡ʑ ʌ̹ n
도청	t o̞ː t͡ɕʰ ʌ̹ ŋ
도청기	t o̞ t͡ɕʰ ʌ̹ ŋ ɡ i
도체	t o̞ː t͡ɕʰ e̞
도파민	t o̞ pʰ a̠ m i n
도표	t o̞ pʰ j o
도하	t o̞ ɦ a̠
도회인	t o̞ β w e̞ i n
독감	t o̞ k̚ k͈ a̠ m
독극물	t o̞ k̚ k͈ ɯ ŋ m u ɭ
독도	t o̞ k̚ t͈ o̞
독립	t o̞ ŋ n i p̚
독립성	t o̞ ŋ n i p s͈ ʌ̹ ŋ
독물	t o̞ ŋ m u ɭ
독방	t o̞ k̚ p͈ a̠ ŋ
독사	t o̞ k s͈ a̠
독살	t o̞ k s͈ a̠ ɭ
독서	t o̞ k s͈ ʌ̹
독서실	t o̞ k s͈ ʌ̹ ɕʰ i ɭ
독소	t o̞ k s͈ o̞
독수리	t o̞ k s͈ u ɾ i
독신	t o̞ k ɕ͈ i n
독신자	t o̞ k ɕ͈ i ɲ d͡ʑ a̠
독음	t o̞ ɡ ɯ m
독일	t o̞ ɡ i ɭ
독일어	t o̞ ɡ i ɾ ʌ̹
독자	t o̞ k̚ t͡ɕ͈ a̠
독점	t o̞ k̚ t͡ɕ͈ ʌ̹ m
독주	t o̞ k̚ t͡ɕ͈ u
독특하다	t o̞ k̚ tʰ ɯ kʰ a̠ d a̠
돋다	t o̞ t̚ t͈ a̠
돋보기	t o̞ t̚ p͈ o̞ ɡ i
돌격	t o̞ ɭ ɡ j ʌ̹ k̚
돌고기	t o̞ ɭ ɡ o̞ ɡ i
돌돔	t o̞ː ɭ d o̞ m
돌드	t o̞ ɭ d ɯ
돌리다	t o̞ ʎ ʎ i d a̠
돌멩이	t o̞ː ɭ m e̞ ŋ i
돌보다	t o̞ː ɭ b o̞ d a̠
돌상어	t o̞ ɭ sʰ a̠ ŋ ʌ̹
돌솥	t o̞ː ɭ sʰ o̞ t̚
돌아가다	t o̞ ɾ a̠ ɡ a̠ d a̠
돌아가시다	t o̞ ɾ a̠ ɡ a̠ ɕʰ i d a̠
돌아오다	t o̞ ɾ a̠ o̞ d a̠
돌연	t o̞ ɾ j ʌ̹ n
돌연변이	t o̞ ɾ j ʌ̹ n b j ʌ̹ n i
돌잡이	t o̞ ʎ d͡ʑ a̠ b i
돌팔이	t o̞ː ɭ pʰ a̠ ɾ i
돌하르방	t o̞ː ɾ ɦ a̠ ɾ ɯ b a̠ ŋ
돕다	t o̞ː p̚ t͈ a̠
돗자리	t o̞ t̚ t͡ɕ͈ a̠ ɾ i
동갑	t o̞ ŋ ɡ a̠ p̚
동거	t o̞ ŋ ɡ ʌ̹
동거인	t o̞ ŋ ɡ ʌ̹ i n
동경	t o̞ ŋ ɡ j ʌ̹ ŋ
동공	t o̞ː ŋ ɡ o̞ ŋ
동그라미	t o̞ ŋ ɡ ɯ ɾ a̠ m i
동글	t o̞ ŋ ɡ ɯ ɭ
동글다	t o̞ ŋ ɡ ɯ ɭ d a̠
동기	t o̞ ŋ ɡ i
동남아시아	t o̞ ŋ n a̠ m a̠ ɕʰ i a̠
동네	t o̞ː ŋ n e̞
동력	t o̞ː ŋ ɲ j ʌ̹ k̚
동료	t o̞ ŋ ɲ j o
동무	t o̞ ŋ m u
동문서답	t o̞ ŋ m u n sʰ ʌ̹ d a̠ p̚
동물	t o̞ː ŋ m u ɭ
동물학	t o̞ː ŋ m u ɾ ɦ a̠ k̚
동반자	t o̞ ŋ b a̠ ɲ d͡ʑ a̠
동부	t o̞ ŋ b u
동사리	t o̞ ŋ sʰ a̠ ɾ i
동산	t o̞ ŋ sʰ a̠ n
동성	t o̞ ŋ sʰ ʌ̹ ŋ
동시	t o̞ ŋ ɕʰ i
동아리	t o̞ ŋ a̠ ɾ i
동안	t o̞ ŋ a̠ n
동양	t o̞ ŋ j a̠ ŋ
동업자	t o̞ ŋ ʌ̹ p̚ t͡ɕ͈ a̠
동의	t o̞ ŋ ɰ i
동의어	t o̞ ŋ ɰ i ʌ̹
동일하다	t o̞ ŋ i ɾ ɦ a̠ d a̠
동작	t o̞ː ŋ d͡ʑ a̠ k̚
동전	t o̞ ŋ d͡ʑ ʌ̹ n
동정	t o̞ ŋ d͡ʑ ʌ̹ ŋ
동지	t o̞ ŋ d͡ʑ i
동쪽	t o̞ ŋ t͡ɕ͈ o̞ k̚
동창	t o̞ ŋ t͡ɕʰ a̠ ŋ
동포	t o̞ ŋ pʰ o̞
동호회	t o̞ ŋ β o̞ β w e̞
동화	t o̞ː ŋ β w a̠
돼지	t w ɛː d͡ʑ i
돼지꿈	t w ɛː d͡ʑ i k͈ u m
되게	t w e̞ː ɡ e̞
되놈	t w e̞ n o̞ m
되다	t w e̞ d a̠
되찾다	t w e̞ t͡ɕʰ a̠ t̚ t͈ a̠
되풀이	t w e̞ pʰ u ɾ i
되풀이하다	t w e̞ pʰ u ɾ i ɦ a̠ d a̠
된디읃	t w e̞ n d i ɯ t̚
된비읍	t w e̞ n b i ɯ p̚
된장	t w e̞ː ɲ d͡ʑ a̠ ŋ
된장녀	t w e̞ː ɲ d͡ʑ a̠ ŋ ɲ j ʌ̹
된장풀	t w e̞ ɲ d͡ʑ a̠ ŋ pʰ u ɭ
됨됨	t w e̞ m d w e̞ m
됨됨이	t w e̞ m d w e̞ m i
두건	t u ɡ ʌ̹ n
두견	t u ɡ j ʌ̹ n
두근거리다	t u ɡ ɯ n ɡ ʌ̹ ɾ i d a̠
두근두근	t u ɡ ɯ n d u ɡ ɯ n
두꺼비	t u k͈ ʌ̹ b i
두뇌	t u n w e̞
두더지	t u d ʌ̹ d͡ʑ i
두드러기	t u d ɯ ɾ ʌ̹ ɡ i
두드러지다	t u d ɯ ɾ ʌ̹ d͡ʑ i d a̠
두드리다	t u d ɯ ɾ i d a̠
두려움	t u ɾ j ʌ̹ u m
두렵다	t u ɾ j ʌ̹ p̚ t͈ a̠
두루미	t u ɾ u m i
두르다	t u ɾ ɯ d a̠
두마	t u m a̠
두만강	t u m a̠ n ɡ a̠ ŋ
두만강자그사니	t u m a̠ n ɡ a̠ ŋ d͡ʑ a̠ ɡ ɯ sʰ a̠ n i
두목	t u m o̞ k̚
두바이	t u b a̠ i
두반장	t u b a̠ ɲ d͡ʑ a̠ ŋ
두발	t u b a̠ ɭ
두벌식	t u b ʌ̹ ɭ ɕʰ i k̚
두부	t u b u
두상	t u sʰ a̠ ŋ
두서너	t u sʰ ʌ̹ n ʌ̹
두서넛	t u sʰ ʌ̹ n ʌ̹ t̚
두세	t u sʰ e̞
두어	t u ʌ̹
두연	t u j ʌ̹ n
두음	t u ɯ m
두음법칙	t u ɯ m b ʌ̹ p̚ t͡ɕʰ i k̚
두절	t u d͡ʑ ʌ̹ ɭ
두줄망둑	t uː d͡ʑ u ɭ m a̠ ŋ d u k̚
두통	t u tʰ o̞ ŋ
둔치다	t u ɲ t͡ɕʰ i d a̠
둘러보다	t u ɭ ɭ ʌ̹ b o̞ d a̠
둘러싸다	t u ɭ ɭ ʌ̹ s͈ a̠ d a̠
둘치	t u ʎ t͡ɕʰ i
둥지	t u ŋ d͡ʑ i
둥치	t u ŋ t͡ɕʰ i
뒤늦다	t ɥ iː n ɯ t̚ t͈ a̠
뒤지다	t ɥ i d͡ʑ i d a̠
뒤집다	t ɥ i d͡ʑ i p̚ t͈ a̠
뒤쫓다	t ɥ iː t͡ɕ͈ o̞ t̚ t͈ a̠
뒷간	t ɥ iː t̚ k͈ a̠ n
뒷다리	t ɥ iː t̚ t͈ a̠ ɾ i
뒷마당	t ɥ iː n m a̠ d a̠ ŋ
뒷면	t ɥ iː n m j ʌ̹ n
뒷모습	t ɥ iː n m o̞ sʰ ɯ p̚
뒹굴뒹굴	t ɥ i ŋ ɡ u ɭ d ɥ i ŋ ɡ u ɭ
듀엣	t j u e̞ t̚
듀오	t j u o̞
드라이브하다	t ɯ ɾ a̠ i b ɯ ɦ a̠ d a̠
드럼	t ɯ ɾ ʌ̹ m
드르렁	t ɯ ɾ ɯ ɾ ʌ̹ ŋ
드립	t ɯ ɾ i p̚
드물다	t ɯ m u ɭ d a̠
득남	t ɯ ŋ n a̠ m
득녀	t ɯ ŋ ɲ j ʌ̹
득점	t ɯ k̚ t͡ɕ͈ ʌ̹ m
듣다	t ɯ t̚ t͈ a̠
들기름	t ɯ ɭ ɡ i ɾ ɯ m
들꿩	t ɯ ɭ k͈ w ʌ̹ ŋ
들끓다	t ɯ ɭ k͈ ɯ ɭ tʰ a̠
들다	t ɯ ɭ d a̠
들러리	t ɯ ɭ ɭ ʌ̹ ɾ i
들르다	t ɯ ɭ ɭ ɯ d a̠
들어가다	t ɯ ɾ ʌ̹ ɡ a̠ d a̠
들어서다	t ɯ ɾ ʌ̹ sʰ ʌ̹ d a̠
들이다	t ɯ ɾ i d a̠
들쭉날쭉하다	t ɯ ʎ t͡ɕ͈ u ŋ n a̠ ʎ t͡ɕ͈ u kʰ a̠ d a̠
듯이	t ɯ ɕʰ i
등급	t ɯ ŋ ɡ ɯ p̚
등등	t ɯː ŋ d ɯ ŋ
등받이	t ɯ ŋ b a̠ d i
등불	t ɯ ŋ p͈ u ɭ
등산	t ɯ ŋ sʰ a̠ n
등심	t ɯ ŋ ɕʰ i m
등유	t ɯ ŋ j u
등자	t ɯ ŋ d͡ʑ a̠
등장	t ɯ ŋ d͡ʑ a̠ ŋ
등장인물	t ɯ ŋ d͡ʑ a̠ ŋ i n m u ɭ
등줄숭어	t ɯ ŋ t͡ɕ͈ u ɭ sʰ u ŋ ʌ̹
디귿	t i ɡ ɯ t̚
디디다	t i d i d a̠
디바이스	t i b a̠ i s͈ ɯ
디스켓	t i sʰ ɯ kʰ e̞ t̚
디스코	t i sʰ ɯ kʰ o̞
디스크	t i sʰ ɯ k x ɯ
디스플레이	t i sʰ ɯ pʰ ɯ ɭ ɭ e̞ i
디엔에이	t i e̞ n e̞ i
디자인	t i d͡ʑ a̠ i n
디저트	t i d͡ʑ ʌ̹ tʰ ɯ
디지털	t i d͡ʑ i tʰ ʌ̹ ɭ
딩딩	t i ŋ d i ŋ
따님	t͈ a̠ n i m
따다	t͈ a̠ d a̠
따뜻	t͈ a̠ t͈ ɯ t̚
따뜻하다	t͈ a̠ t͈ ɯ tʰ a̠ d a̠
따라가다	t͈ a̠ ɾ a̠ ɡ a̠ d a̠
따라서	t͈ a̠ ɾ a̠ sʰ ʌ̹
따라하다	t͈ a̠ ɾ a̠ ɦ a̠ d a̠
따로	t͈ a̠ ɾ o̞
따르다	t͈ a̠ ɾ ɯ d a̠
따르릉	t͈ a̠ ɾ ɯ ɾ ɯ ŋ
따름	t͈ a̠ ɾ ɯ m
따오기	t͈ a̠ o̞ ɡ i
따위	t͈ a̠ ɥ i
따이	t͈ a̠ i
따지다	t͈ a̠ d͡ʑ i d a̠
딱딱하다	t͈ a̠ k̚ t͈ a̠ kʰ a̠ d a̠
딱지	t͈ a̠ k̚ t͡ɕ͈ i
딸기	t͈ a̠ː ɭ ɡ i
딸꾹질	t͈ a̠ ɭ k͈ u k̚ t͡ɕ͈ i ɭ
땅크병	t͈ a̠ ŋ k x ɯ b j ʌ̹ ŋ
땋다	t͈ a̠ː tʰ a̠
땜납	t͈ ɛː m n a̠ p̚
떠다니다	t͈ ʌ̹ d a̠ n i d a̠
떠돌다	t͈ ʌ̹ d o̞ ɭ d a̠
떠들다	t͈ ɘː d ɯ ɭ d a̠
떠들썩하다	t͈ ʌ̹ d ɯ ɭ s͈ ʌ̹ kʰ a̠ d a̠
떠오르다	t͈ ʌ̹ o̞ ɾ ɯ d a̠
떡국	t͈ ʌ̹ k̚ k͈ u k̚
떡볶이	t͈ ʌ̹ k̚ p͈ o̞ k͈ i
떨다	t͈ ɘː ɭ d a̠
떨리다	t͈ ʌ̹ ʎ ʎ i d a̠
떨어뜨리다	t͈ ʌ̹ ɾ ʌ̹ t͈ ɯ ɾ i d a̠
떨어지다	t͈ ʌ̹ ɾ ʌ̹ d͡ʑ i d a̠
떨치다	t͈ ʌ̹ ʎ t͡ɕʰ i d a̠
떳떳하다	t͈ ʌ̹ t̚ t͈ ʌ̹ tʰ a̠ d a̠
떼지어	t͈ e̞ d͡ʑ i ʌ̹
또는	t͈ o̞ n ɯ n
또다시	t͈ o̞ d a̠ ɕʰ i
똑같다	t͈ o̞ k̚ k͈ a̠ t̚ t͈ a̠
똑같이	t͈ o̞ k̚ k͈ a̠ t͡ɕʰ i
똑똑	t͈ o̞ k̚ t͈ o̞ k̚
똑바로	t͈ o̞ k̚ p͈ a̠ ɾ o̞
똥침	t͈ o̞ ŋ t͡ɕʰ i m
똥파리	t͈ o̞ ŋ pʰ a̠ ɾ i
뙤약볕	t͈ w e̞ j a̠ k̚ p͈ j ʌ̹ t̚
뚜렷하다	t͈ u ɾ j ʌ̹ tʰ a̠ d a̠
뚱뚱하다	t͈ u ŋ t͈ u ŋ ɦ a̠ d a̠
뛰다	t͈ ɥ i d a̠
뛰어가다	t͈ ɥ i ʌ̹ ɡ a̠ d a̠
뛰어나다	t͈ ɥ i ʌ̹ n a̠ d a̠
뛰어다니다	t͈ ɥ i ʌ̹ d a̠ n i d a̠
뛰어들다	t͈ ɥ i ʌ̹ d ɯ ɭ d a̠
뜨겁다	t͈ ɯ ɡ ʌ̹ p̚ t͈ a̠
뜨다	t͈ ɯ d a̠
뜯다	t͈ ɯ t̚ t͈ a̠
뜸하다	t͈ ɯ m ɦ a̠ d a̠
뜻밖에	t͈ ɯ t̚ p͈ a̠ k͈ e̞
뜻하다	t͈ ɯ tʰ a̠ d a̠
띄어쓰기	t͈ i ʌ̹ s͈ ɯ ɡ i
라고	ɾ a̠ ɡ o̞
라고스	ɾ a̠ ɡ o̞ sʰ ɯ
라니	ɾ a̠ n i
라돈	ɾ a̠ d o̞ n
라듐	ɾ a̠ d j u m
라디에이터	ɾ a̠ d i e̞ i tʰ ʌ̹
라디오	ɾ a̠ d i o̞
라며	ɾ a̠ m j ʌ̹
라면	ɾ a̠ m j ʌ̹ n
라바트	ɾ a̠ b a̠ tʰ ɯ
라벨	ɾ a̠ b e̞ ɭ
라볶이	ɾ a̠ b o̞ k͈ i
라선	ɾ a̠ sʰ ʌ̹ n
라오스	ɾ a̠ o̞ sʰ ɯ
라우터	ɾ a̠ u tʰ ʌ̹
라운지	ɾ a̠ u ɲ d͡ʑ i
라이벌	ɾ a̠ i b ʌ̹ ɭ
라이베리아	ɾ a̠ i b e̞ ɾ i a̠
라이선스	ɾ a̠ i sʰ ʌ̹ n sʰ ɯ
라이터	ɾ a̠ i tʰ ʌ̹
라이플	ɾ a̠ i pʰ ɯ ɭ
라인	ɾ a̠ i n
라임	ɾ a̠ i m
라트비아	ɾ a̠ tʰ ɯ b i a̠
라트비아어	ɾ a̠ tʰ ɯ b i a̠ ʌ̹
라틴	ɾ a̠ tʰ i n
라파스	ɾ a̠ pʰ a̠ sʰ ɯ
락타	ɾ a̠ k̚ tʰ a̠
랭면	ɾ ɛː ŋ m j ʌ̹ n
량강도	ɾ j a̠ ŋ ɡ a̠ ŋ d o̞
러시아어	ɾ ʌ̹ ɕʰ i a̠ ʌ̹
러시아인	ɾ ʌ̹ ɕʰ i a̠ i n
레몬	ɾ e̞ m o̞ n
레바논	ɾ e̞ b a̠ n o̞ n
레소토	ɾ e̞ sʰ o̞ tʰ o̞
레스토랑	ɾ e̞ sʰ ɯ tʰ o̞ ɾ a̠ ŋ
레슬링	ɾ e̞ sʰ ɯ ʎ ʎ i ŋ
레위니옹	ɾ e̞ ɥ i n i o̞ ŋ
레이스	ɾ e̞ i sʰ ɯ
레이저	ɾ e̞ i d͡ʑ ʌ̹
레즈비언	ɾ e̞ d͡ʑ ɯ b i ʌ̹ n
레퍼토리	ɾ e̞ pʰ ʌ̹ tʰ o̞ ɾ i
렌즈	ɾ e̞ ɲ d͡ʑ ɯ
려관	ɾ j ʌ̹ ɡ w a̠ n
련락	ɾ j ʌ̹ ɭ ɭ a̠ k̚
련습	ɾ j ɘː n sʰ ɯ p̚
련합	ɾ j ʌ̹ n ɦ a̠ p̚
령도자	ɾ j ʌ̹ ŋ d o̞ d͡ʑ a̠
로고	ɾ o̞ ɡ o̞
로국	ɾ o̞ ɡ u k̚
로그	ɾ o̞ ɡ ɯ
로그인	ɾ o̞ ɡ ɯ i n
로또	ɾ o̞ t͈ o̞
로렌슘	ɾ o̞ ɾ e̞ n ɕʰ u m
로마	ɾ o̞ m a̠
로망	ɾ o̞ m a̠ ŋ
로므니아	ɾ o̞ m ɯ n i a̠
로보트	ɾ o̞ b o̞ tʰ ɯ
로사리오	ɾ o̞ sʰ a̠ ɾ i o̞
로씨야	ɾ o̞ ɕ͈ i j a̠
로어	ɾ o̞ ʌ̹
로켓	ɾ o̞ kʰ e̞ t̚
로토	ɾ o̞ tʰ o̞
로획	ɾ o̞ β w e̞ k̚
롤러코스터	ɾ o̞ ɭ ɭ ʌ̹ kʰ o̞ sʰ ɯ tʰ ʌ̹
뢴트겐	ɾ w e̞ n tʰ ɯ ɡ e̞ n
료법	ɾ j o b ʌ̹ p̚
루마니아	ɾ u m a̠ n i a̠
루마니아어	ɾ u m a̠ n i a̠ ʌ̹
루머	ɾ u m ʌ̹
루블	ɾ u b ɯ ɭ
루사카	ɾ u sʰ a̠ kʰ a̠
루저	ɾ u d͡ʑ ʌ̹
루카	ɾ u kʰ a̠
루테늄	ɾ u tʰ e̞ ɲ j u m
루테튬	ɾ u tʰ e̞ tʰ j u m
루프	ɾ u pʰ ɯ
룩셈부르크	ɾ u k s͈ e̞ m b u ɾ ɯ k x ɯ
룰렛	ɾ u ɭ ɭ e̞ t̚
류월	ɾ j u w ʌ̹ ɭ
륙지	ɾ j u k̚ t͡ɕ͈ i
르네상스	ɾ ɯ n e̞ sʰ a̠ ŋ sʰ ɯ
르완다	ɾ ɯ w a̠ n d a̠
리가	ɾ i ɡ a̠
리그	ɾ i ɡ ɯ
리눅스	ɾ i n u k s͈ ɯ
리듬	ɾ i d ɯ m
리모컨	ɾ i m o̞ kʰ ʌ̹ n
리무진	ɾ i m u d͡ʑ i n
리믹스	ɾ i m i k s͈ ɯ
리버모륨	ɾ i b ʌ̹ m o̞ ɾ j u m
리비아	ɾ i b i a̠
리셉션	ɾ i s͈ e̞ p ɕ͈ ʌ̹ n
리스본	ɾ i sʰ ɯ b o̞ n
리야드	ɾ i j a̠ d ɯ
리어카	ɾ i ʌ̹ kʰ a̠
리얼	ɾ i ʌ̹ ɭ
리옹	ɾ i o̞ ŋ
리왕조	ɾ i w a̠ ŋ d͡ʑ o̞
리우데자네이루	ɾ i u d e̞ d͡ʑ a̠ n e̞ i ɾ u
리원	ɾ i w ʌ̹ n
리터	ɾ i tʰ ʌ̹
리투아니아	ɾ i tʰ u a̠ n i a̠
리튬	ɾ i tʰ j u m
리포트	ɾ i pʰ o̞ tʰ ɯ
리히텐슈타인	ɾ i ʝ i tʰ e̞ n ɕʰ u tʰ a̠ i n
린스	ɾ i n s͈ ɯ
릴리스	ɾ i ʎ ʎ i sʰ ɯ
립스틱	ɾ i p s͈ ɯ tʰ i k̚
링귀네	ɾ i ŋ ɡ ɥ i n e̞
링크	ɾ i ŋ k x ɯ
마구	m a̠ ɡ u
마구간	m a̠ː ɡ u k͈ a̠ n
마귀	m a̠ ɡ ɥ i
마나과	m a̠ n a̠ ɡ w a̠
마나마	m a̠ n a̠ m a̠
마녀	m a̠ ɲ j ʌ̹
마누라	m a̠ n u ɾ a̠
마늘	m a̠ n ɯ ɭ
마니	m a̠ n i
마닐라	m a̠ n i ɭ ɭ a̠
마다	m a̠ d a̠
마다가스카르	m a̠ d a̠ ɡ a̠ sʰ ɯ kʰ a̠ ɾ ɯ
마달	m a̠ d a̠ ɭ
마더	m a̠ d ʌ̹
마드리드	m a̠ d ɯ ɾ i d ɯ
마땅하다	m a̠ t͈ a̠ ŋ ɦ a̠ d a̠
마라톤	m a̠ ɾ a̠ tʰ o̞ n
마력	m a̠ː ɾ j ʌ̹ k̚
마련	m a̠ ɾ j ʌ̹ n
마련하다	m a̠ ɾ j ʌ̹ n ɦ a̠ d a̠
마루	m a̠ ɾ u
마르멜로	m a̠ ɾ ɯ m e̞ ɭ ɭ o̞
마르스	m a̠ ɾ ɯ sʰ ɯ
마르코	m a̠ ɾ ɯ kʰ o̞
마르크스주의	m a̠ ɾ ɯ k x ɯ sʰ ɯ d͡ʑ u ɰ i
마르티니크	m a̠ ɾ ɯ tʰ i n i k x ɯ
마름모	m a̠ ɾ ɯ m m o̞
마리	m a̠ ɾ i
마마	m a̠ː m a̠
마무르다	m a̠ m u ɾ ɯ d a̠
마무리	m a̠ m u ɾ i
마법	m a̠ b ʌ̹ p̚
마법사	m a̠ b ʌ̹ p s͈ a̠
마사지	m a̠ sʰ a̠ d͡ʑ i
마소	m a̠ sʰ o̞
마술	m a̠ sʰ u ɭ
마술사	m a̠ sʰ u ɭ s͈ a̠
마스다	m a̠ sʰ ɯ d a̠
마스크	m a̠ sʰ ɯ k x ɯ
마스터베이션	m a̠ sʰ ɯ tʰ ʌ̹ b e̞ i ɕʰ ʌ̹ n
마시다	m a̠ ɕʰ i d a̠
마약	m a̠ j a̠ k̚
마우스	m a̠ u s͈ ɯ
마유	m a̠ː j u
마을	m a̠ ɯ ɭ
마을버스	m a̠ ɯ ɭ b ʌ̹ sʰ ɯ
마음	m a̠ ɯ m
마음속	m a̠ ɯ m s͈ o̞ k̚
마음씨	m a̠ ɯ m ɕ͈ i
마이너스	m a̠ i n ʌ̹ s͈ ɯ
마이웨이	m a̠ i w e̞ i
마이크	m a̠ i k x ɯ
마이크로소프트	m a̠ i k x ɯ ɾ o̞ sʰ o̞ pʰ ɯ tʰ ɯ
마이크로파	m a̠ i k x ɯ ɾ o̞ pʰ a̠
마일	m a̠ i ɭ
마작	m a̠ː d͡ʑ a̠ k̚
마주	m a̠ d͡ʑ u
마중	m a̠ d͡ʑ u ŋ
마지막	m a̠ d͡ʑ i m a̠ k̚
마차	m a̠ː t͡ɕʰ a̠
마찬가지	m a̠ t͡ɕʰ a̠ n ɡ a̠ d͡ʑ i
마찰	m a̠ t͡ɕʰ a̠ ɭ
마천루	m a̠ t͡ɕʰ ʌ̹ ɭ ɭ u
마취	m a̠ t͡ɕʰ ɥ i
마침	m a̠ t͡ɕʰ i m
마카로니	m a̠ kʰ a̠ ɾ o̞ n i
마케도니아	m a̠ kʰ e̞ d o̞ n i a̠
마케팅	m a̠ kʰ e̞ tʰ i ŋ
마켓	m a̠ kʰ e̞ t̚
마트	m a̠ tʰ ɯ
마트료시카	m a̠ tʰ ɯ ɾ j o ɕʰ i kʰ a̠
마팔디네	m a̠ pʰ a̠ ɭ d i n e̞
마푸토	m a̠ pʰ u tʰ o̞
마피아	m a̠ pʰ i a̠
마흐디	m a̠ ɣ ɯ d i
마흔	m a̠ ɣ ɯ n
막다	m a̠ k̚ t͈ a̠
막다르다	m a̠ k̚ t͈ a̠ ɾ ɯ d a̠
막바지	m a̠ k̚ p͈ a̠ d͡ʑ i
막차	m a̠ k̚ t͡ɕʰ a̠
만나기	m a̠ n n a̠ ɡ i
만나다	m a̠ n n a̠ d a̠
만날	m a̠ː n n a̠ ɭ
만남	m a̠ n n a̠ m
만년	m a̠ː n ɲ j ʌ̹ n
만년필	m a̠ː n ɲ j ʌ̹ n pʰ i ɭ
만능	m a̠ː n n ɯ ŋ
만들다	m a̠ n d ɯ ɭ d a̠
만리장성	m a̠ː ʎ ʎ i d͡ʑ a̠ ŋ sʰ ʌ̹ ŋ
만물	m a̠ː n m u ɭ
만성	m a̠ n sʰ ʌ̹ ŋ
만약	m a̠ː ɲ j a̠ k̚
만유	m a̠ː ɲ j u
만유인력	m a̠ː ɲ j u i ʎ ʎ j ʌ̹ k̚
만일	m a̠ː n i ɭ
만족	m a̠ ɲ d͡ʑ o̞ k̚
만주	m a̠ ɲ d͡ʑ u
만주국	m a̠ ɲ d͡ʑ u ɡ u k̚
만지다	m a̠ ɲ d͡ʑ i d a̠
만큼	m a̠ n k x ɯ m
만하다	m a̠ n ɦ a̠ d a̠
만화	m a̠ː n β w a̠
많은	m a̠ː n ɯ n
많이	m a̠ː n i
맏아들	m a̠ d a̠ d ɯ ɭ
맏이	m a̠ d͡ʑ i
맏형	m a̠ tʰ j ʌ̹ ŋ
말고기	m a̠ ɭ ɡ o̞ ɡ i
말기	m a̠ ɭ ɡ i
말다툼	m a̠ː ɭ d a̠ tʰ u m
말뚝	m a̠ ɭ t͈ u k̚
말라보	m a̠ ɭ ɭ a̠ b o̞
말라위	m a̠ ɭ ɭ a̠ ɥ i
말레	m a̠ ɭ ɭ e̞
말레이시아	m a̠ ɭ ɭ e̞ i ɕʰ i a̠
말레이어	m a̠ ɭ ɭ e̞ i ʌ̹
말리	m a̠ ʎ ʎ i
말미	m a̠ ɭ m i
말벌	m a̠ ɭ b ʌ̹ ɭ
말살하다	m a̠ ɭ s͈ a̠ ɾ ɦ a̠ d a̠
말솜씨	m a̠ː ɭ s͈ o̞ m ɕ͈ i
말썽꾸러기	m a̠ː ɭ s͈ ʌ̹ ŋ k͈ u ɾ ʌ̹ ɡ i
말씀	m a̠ː ɭ s͈ ɯ m
말하다	m a̠ː ɾ ɦ a̠ d a̠
맑다	m a̠ k̚ t͈ a̠
맑스주의	m a̠ k s͈ ɯ d͡ʑ u ɰ i
맛있다	m a̠ ɕʰ i t̚ t͈ a̠
망간	m a̠ ŋ ɡ a̠ n
망고	m a̠ ŋ ɡ o̞
망둑	m a̠ ŋ d u k̚
망령	m a̠ ŋ ɲ j ʌ̹ ŋ
망막	m a̠ ŋ m a̠ k̚
망상	m a̠ ŋ sʰ a̠ ŋ
망설이다	m a̠ ŋ sʰ ʌ̹ ɾ i d a̠
망시민	m a̠ ŋ ɕʰ i m i n
망치	m a̠ ŋ t͡ɕʰ i
망치다	m a̠ ŋ t͡ɕʰ i d a̠
망토	m a̠ ŋ tʰ o̞
맞벌이	m a̠ t̚ p͈ ʌ̹ ɾ i
맞부딪치다	m a̠ t̚ p͈ u d i t̚ t͡ɕʰ i d a̠
맞이	m a̠ d͡ʑ i
맞추다	m a̠ t̚ t͡ɕʰ u d a̠
맞춤	m a̠ t̚ t͡ɕʰ u m
맞흥정	m a̠ tʰ ɯ ŋ d͡ʑ ʌ̹ ŋ
맡다	m a̠ t̚ t͈ a̠
매국노	m ɛː ɡ u ŋ n o̞
매년	m ɛː ɲ j ʌ̹ n
매달리다	m ɛː d a̠ ʎ ʎ i d a̠
매미	m ɛː m i
매월	m ɛː w ʌ̹ ɭ
매일	m ɛː i ɭ
매장	m ɛː d͡ʑ a̠ ŋ
매점	m ɛː d͡ʑ ʌ̹ m
매주	m ɛː d͡ʑ u
매춘부	m ɛː t͡ɕʰ u n b u
매출	m ɛː t͡ɕʰ u ɭ
매표구	m ɛː pʰ j o ɡ u
맨날	m ɛː n n a̠ ɭ
맹세	m ɛː ŋ sʰ e̞
맹인	m ɛː ŋ i n
맹자	m ɛː ŋ d͡ʑ a̠
먄마	m j a̠ n m a̠
머구리	m ʌ̹ ɡ u ɾ i
머그잔	m ʌ̹ ɡ ɯ d͡ʑ a̠ n
머리	m ʌ̹ ɾ i
머리띠	m ʌ̹ ɾ i t͈ i
머리카락	m ʌ̹ ɾ i kʰ a̠ ɾ a̠ k̚
머리칼	m ʌ̹ ɾ i kʰ a̠ ɭ
머리털	m ʌ̹ ɾ i tʰ ʌ̹ ɭ
머리통	m ʌ̹ ɾ i tʰ o̞ ŋ
머무르다	m ʌ̹ m u ɾ ɯ d a̠
머물다	m ʌ̹ m u ɭ d a̠
머뭇거리다	m ʌ̹ m u t̚ k͈ ʌ̹ ɾ i d a̠
머슴	m ʌ̹ sʰ ɯ m
머시마	m ʌ̹ ɕʰ i m a̠
머핀	m ʌ̹ pʰ i n
먹다	m ʌ̹ k̚ t͈ a̠
먹물	m ʌ̹ ŋ m u ɭ
먹이	m ʌ̹ ɡ i
먹이다	m ʌ̹ ɡ i d a̠
먼저	m ʌ̹ ɲ d͡ʑ ʌ̹
먼지	m ʌ̹ ɲ d͡ʑ i
멀다	m ɘː ɭ d a̠
멀리	m ɘː ʎ ʎ i
멀미	m ʌ̹ ɭ m i
멀어지다	m ɘː ɾ ʌ̹ d͡ʑ i d a̠
멀쩡	m ʌ̹ ʎ t͡ɕ͈ ʌ̹ ŋ
멀쩡하다	m ʌ̹ ʎ t͡ɕ͈ ʌ̹ ŋ ɦ a̠ d a̠
멀찌감치	m ʌ̹ ʎ t͡ɕ͈ i ɡ a̠ m t͡ɕʰ i
멈추다	m ʌ̹ m t͡ɕʰ u d a̠
멋없다	m ʌ̹ d ʌ̹ p̚ t͈ a̠
멋있다	m ʌ̹ ɕʰ i t̚ t͈ a̠
멋지다	m ʌ̹ t̚ t͡ɕ͈ i d a̠
멍에	m ʌ̹ ŋ e̞
멍텅구리	m ʌ̹ ŋ tʰ ʌ̹ ŋ ɡ u ɾ i
메가나	m e̞ ɡ a̠ n a̠
메기	m e̞ː ɡ i
메뉴	m e̞ ɲ j u
메달	m e̞ d a̠ ɭ
메뚜기	m e̞ t͈ u ɡ i
메모	m e̞ m o̞
메모리	m e̞ m o̞ ɾ i
메밀	m e̞ m i ɭ
메서드	m e̞ sʰ ʌ̹ d ɯ
메소드	m e̞ sʰ o̞ d ɯ
메시아	m e̞ ɕʰ i a̠
메이스	m e̞ i sʰ ɯ
메일	m e̞ i ɭ
메카	m e̞ kʰ a̠
메탄	m e̞ tʰ a̠ n
메터	m e̞ tʰ ʌ̹
메토끼	m e̞ tʰ o̞ k͈ i
멕시코시티	m e̞ k ɕ͈ i kʰ o̞ ɕʰ i tʰ i
멜라닌	m e̞ ɭ ɭ a̠ n i n
멜로	m e̞ ɭ ɭ o̞
멜로드라마	m e̞ ɭ ɭ o̞ d ɯ ɾ a̠ m a̠
멜론	m e̞ ɭ ɭ o̞ n
멜버른	m e̞ ɭ b ʌ̹ ɾ ɯ n
멧닭	m e̞ t̚ t͈ a̠ k̚
며느리	m j ʌ̹ n ɯ ɾ i
며칠	m j ʌ̹ t͡ɕʰ i ɭ
멱살	m j ʌ̹ k s͈ a̠ ɭ
면도기	m j ɘː n d o̞ ɡ i
면도칼	m j ɘː n d o̞ kʰ a̠ ɭ
면도하다	m j ɘː n d o̞ ɦ a̠ d a̠
면발	m j ʌ̹ n b a̠ ɭ
면서	m j ʌ̹ n sʰ ʌ̹
면세	m j ɘː n sʰ e̞
면역학	m j ɘː ɲ j ʌ̹ kʰ a̠ k̚
면적	m j ɘː ɲ d͡ʑ ʌ̹ k̚
면전	m j ʌ̹ ɲ d͡ʑ ʌ̹ n
면접	m j ɘː ɲ d͡ʑ ʌ̹ p̚
면허증	m j ɘː n ɦ ʌ̹ t͡ɕ͈ ɯ ŋ
멸망	m j ʌ̹ ɭ m a̠ ŋ
멸종	m j ʌ̹ ʎ t͡ɕ͈ o̞ ŋ
멸치	m j ʌ̹ ʎ t͡ɕʰ i
명곡	m j ʌ̹ ŋ ɡ o̞ k̚
명관	m j ʌ̹ ŋ ɡ w a̠ n
명단	m j ʌ̹ ŋ d a̠ n
명동	m j ʌ̹ ŋ d o̞ ŋ
명령하다	m j ɘː ŋ ɲ j ʌ̹ ŋ ɦ a̠ d a̠
명말청초	m j ʌ̹ ŋ m a̠ ʎ t͡ɕʰ ʌ̹ ŋ t͡ɕʰ o̞
명부	m j ʌ̹ ŋ b u
명사	m j ʌ̹ ŋ sʰ a̠
명성	m j ʌ̹ ŋ sʰ ʌ̹ ŋ
명소	m j ʌ̹ ŋ sʰ o̞
명예	m j ʌ̹ ŋ j e̞
명왕성	m j ʌ̹ ŋ w a̠ ŋ sʰ ʌ̹ ŋ
명의	m j ʌ̹ ŋ ɰ i
명인	m j ʌ̹ ŋ i n
명일	m j ʌ̹ ŋ i ɭ
명절	m j ʌ̹ ŋ d͡ʑ ʌ̹ ɭ
명주	m j ʌ̹ ŋ d͡ʑ u
명중	m j ɘː ŋ d͡ʑ u ŋ
명칭	m j ʌ̹ ŋ t͡ɕʰ i ŋ
명하다	m j ɘː ŋ ɦ a̠ d a̠
명함	m j ʌ̹ ŋ ɦ a̠ m
몇몇	m j ʌ̹ n m j ʌ̹ t̚
모가디슈	m o̞ ɡ a̠ d i ɕʰ u
모과	m o̞ː ɡ w a̠
모교	m o̞ː ɡ j o
모국	m o̞ː ɡ u k̚
모금	m o̞ ɡ ɯ m
모나코	m o̞ n a̠ kʰ o̞
모니터링	m o̞ n i tʰ ʌ̹ ɾ i ŋ
모델	m o̞ d e̞ ɭ
모뎀	m o̞ d e̞ m
모독	m o̞ː d o̞ k̚
모두	m o̞ d u
모듈	m o̞ d j u ɭ
모드	m o̞ d ɯ
모든	m o̞ː d ɯ n
모듬	m o̞ d ɯ m
모란	m o̞ ɾ a̠ n
모란봉	m o̞ ɾ a̠ n b o̞ ŋ
모로코	m o̞ ɾ o̞ kʰ o̞
모루	m o̞ː ɾ u
모르핀	m o̞ ɾ ɯ pʰ i n
모리셔스	m o̞ ɾ i ɕʰ ʌ̹ sʰ ɯ
모방	m o̞ b a̠ ŋ
모사	m o̞ sʰ a̠
모서리	m o̞ sʰ ʌ̹ ɾ i
모세혈관	m o̞ sʰ e̞ ʝ j ʌ̹ ɭ ɡ w a̠ n
모순	m o̞ sʰ u n
모스코븀	m o̞ sʰ ɯ kʰ o̞ b j u m
모스크	m o̞ sʰ ɯ k x ɯ
모스크바	m o̞ sʰ ɯ k x ɯ b a̠
모습	m o̞ sʰ ɯ p̚
모시다	m o̞ː ɕʰ i d a̠
모양	m o̞ j a̠ ŋ
모어	m o̞ː ʌ̹
모에	m o̞ e̞
모오케	m o̞ o̞ kʰ e̞
모욕	m o̞ː j o k̚
모으다	m o̞ ɯ d a̠
모음	m o̞ː ɯ m
모음조화	m o̞ː ɯ m d͡ʑ o̞ β w a̠
모이	m o̞ i
모이다	m o̞ i d a̠
모임	m o̞ i m
모자라다	m o̞ː d͡ʑ a̠ ɾ a̠ d a̠
모잠비크	m o̞ d͡ʑ a̠ m b i k x ɯ
모전	m o̞ d͡ʑ ʌ̹ n
모조리	m o̞ d͡ʑ o̞ ɾ i
모처럼	m o̞ t͡ɕʰ ʌ̹ ɾ ʌ̹ m
모터보트	m o̞ tʰ ʌ̹ b o̞ tʰ ɯ
모텔	m o̞ tʰ e̞ ɭ
모토	m o̞ tʰ o̞
모퉁이	m o̞ tʰ u ŋ i
모피	m o̞ pʰ i
모험	m o̞ː ɦ ʌ̹ m
모형	m o̞ ʝ j ʌ̹ ŋ
모호하다	m o̞ β o̞ ɦ a̠ d a̠
목격자	m o̞ k̚ k͈ j ʌ̹ k̚ t͡ɕ͈ a̠
목구멍	m o̞ k̚ k͈ u m ʌ̹ ŋ
목란	m o̞ ŋ n a̠ n
목련	m o̞ ŋ ɲ j ʌ̹ n
목마	m o̞ ŋ m a̠
목마르다	m o̞ ŋ m a̠ ɾ ɯ d a̠
목발	m o̞ k̚ p͈ a̠ ɭ
목사	m o̞ k s͈ a̠
목사님	m o̞ k s͈ a̠ n i m
목석	m o̞ k s͈ ʌ̹ k̚
목수	m o̞ k s͈ u
목슈권	m o̞ k ɕ͈ u ɡ w ʌ̹ n
목요일	m o̞ ɡ j o i ɭ
목욕	m o̞ ɡ j o k̚
목욕탕	m o̞ ɡ j o k̚ tʰ a̠ ŋ
목장	m o̞ k̚ t͡ɕ͈ a̠ ŋ
목적	m o̞ k̚ t͡ɕ͈ ʌ̹ k̚
목전	m o̞ k̚ t͡ɕ͈ ʌ̹ n
목젖	m o̞ k̚ t͡ɕ͈ ʌ̹ t̚
목차	m o̞ k̚ t͡ɕʰ a̠
목청	m o̞ k̚ t͡ɕʰ ʌ̹ ŋ
목청껏	m o̞ k̚ t͡ɕʰ ʌ̹ ŋ k͈ ʌ̹ t̚
목표	m o̞ k̚ pʰ j o
몫몫이	m o̞ ŋ m o̞ k ɕ͈ i
몬로비아	m o̞ ɭ ɭ o̞ b i a̠
몬순	m o̞ n sʰ u n
몬테네그로	m o̞ n tʰ e̞ n e̞ ɡ ɯ ɾ o̞
몬테비데오	m o̞ n tʰ e̞ b i d e̞ o̞
몬트리올	m o̞ n tʰ ɯ ɾ i o̞ ɭ
몰골	m o̞ ɭ ɡ o̞ ɭ
몰다	m o̞ː ɭ d a̠
몰도바	m o̞ ɭ d o̞ b a̠
몰디브	m o̞ ɭ d i b ɯ
몰라	m o̞ ɭ ɭ a̠
몰상식	m o̞ ɭ s͈ a̠ ŋ ɕʰ i k̚
몰카	m o̞ ɭ kʰ a̠
몰타	m o̞ ɭ tʰ a̠
몰타어	m o̞ ɭ tʰ a̠ ʌ̹
몸살	m o̞ m sʰ a̠ ɭ
몸소	m o̞ m sʰ o̞
몸조리	m o̞ m d͡ʑ o̞ ɾ i
몸짓	m o̞ m t͡ɕ͈ i t̚
몸통	m o̞ m tʰ o̞ ŋ
몹시	m o̞ː p ɕ͈ i
못지않다	m o̞ː t̚ t͡ɕ͈ i a̠ n tʰ a̠
못하다	m o̞ tʰ a̠ d a̠
몽고	m o̞ ŋ ɡ o̞
몽골	m o̞ ŋ ɡ o̞ ɭ
몽둥이	m o̞ ŋ d u ŋ i
몽따쥬	m o̞ ŋ t͈ a̠ d͡ʑ u
몽어	m o̞ ŋ ʌ̹
몽정	m o̞ː ŋ d͡ʑ ʌ̹ ŋ
몽타주	m o̞ ŋ tʰ a̠ d͡ʑ u
묘미	m j oː m i
묘사	m j oː sʰ a̠
묘사하다	m j oː sʰ a̠ ɦ a̠ d a̠
묘지	m j oː d͡ʑ i
무겁다	m u ɡ ʌ̹ p̚ t͈ a̠
무게	m u ɡ e̞
무국적	m u ɡ u k̚ t͡ɕ͈ ʌ̹ k̚
무궁화	m u ɡ u ŋ β w a̠
무기고	m uː ɡ i ɡ o̞
무너지다	m u n ʌ̹ d͡ʑ i d a̠
무능	m u n ɯ ŋ
무늬	m u n i
무당	m uː d a̠ ŋ
무덥다	m u d ʌ̹ p̚ t͈ a̠
무디다	m u d i d a̠
무뚝뚝하다	m u t͈ u k̚ t͈ u kʰ a̠ d a̠
무려	m u ɾ j ʌ̹
무력	m u ɾ j ʌ̹ k̚
무렵	m u ɾ j ʌ̹ p̚
무례	m u ɾ j e̞
무료	m u ɾ j o
무르다	m u ɾ ɯ d a̠
무릇	m u ɾ ɯ t̚
무릎	m u ɾ ɯ p̚
무리	m u ɾ i
무리하다	m u ɾ i ɦ a̠ d a̠
무마	m u m a̠
무명	m u m j ʌ̹ ŋ
무모하다	m u m o̞ ɦ a̠ d a̠
무빙워크	m u b i ŋ w ʌ̹ k x ɯ
무서움	m u sʰ ʌ̹ u m
무선	m u sʰ ʌ̹ n
무선전화	m u sʰ ʌ̹ ɲ d͡ʑ ʌ̹ n β w a̠
무섭다	m u sʰ ʌ̹ p̚ t͈ a̠
무속	m uː sʰ o̞ k̚
무속인	m uː sʰ o̞ ɡ i n
무쇠	m u sʰ w e̞
무술	m uː sʰ u ɭ
무스카트	m u sʰ ɯ kʰ a̠ tʰ ɯ
무승부	m u sʰ ɯ ŋ b u
무시하다	m u ɕʰ i ɦ a̠ d a̠
무신론	m u ɕʰ i n n o̞ n
무언가	m u ʌ̹ n ɡ a̠
무언증	m u ʌ̹ ɲ t͡ɕ͈ ɯ ŋ
무얼	m u ʌ̹ ɭ
무엇	m u ʌ̹ t̚
무역	m uː j ʌ̹ k̚
무예	m uː j e̞
무인도	m u i n d o̞
무인점포	m u i ɲ d͡ʑ ʌ̹ m pʰ o̞
무장하다	m uː d͡ʑ a̠ ŋ ɦ a̠ d a̠
무정부주의	m u d͡ʑ ʌ̹ ŋ b u d͡ʑ u ɰ i
무제한	m u d͡ʑ e̞ ɦ a̠ n
무조건	m u d͡ʑ o̞ k͈ ʌ̹ n
무죄	m u d͡ʑ w e̞
무중력	m u d͡ʑ u ŋ ɲ j ʌ̹ k̚
무지하다	m u d͡ʑ i ɦ a̠ d a̠
무진	m u d͡ʑ i n
무진장	m u d͡ʑ i ɲ d͡ʑ a̠ ŋ
무찌르다	m u t͡ɕ͈ i ɾ ɯ d a̠
무척	m u t͡ɕʰ ʌ̹ k̚
무치다	m u t͡ɕʰ i d a̠
무쿠리	m u kʰ u ɾ i
무탈	m u tʰ a̠ ɭ
무한	m u ɦ a̠ n
무화과	m u β w a̠ ɡ w a̠
묵가	m u k̚ k͈ a̠
묵은지	m u ɡ ɯ ɲ d͡ʑ i
묶음	m u k͈ ɯ m
문과	m u n k͈ w a̠
문구	m u n ɡ u
문둥이	m u n d u ŋ i
문란	m uː ɭ ɭ a̠ n
문명	m u n m j ʌ̹ ŋ
문바람	m u n b a̠ ɾ a̠ m
문방	m u n b a̠ ŋ
문법	m u n p͈ ʌ̹ p̚
문어	m u n ʌ̹
문제	m uː ɲ d͡ʑ e̞
문제점	m u ɲ d͡ʑ e̞ d͡ʑ ʌ̹ m
문진	m u ɲ d͡ʑ i n
문턱	m u n tʰ ʌ̹ k̚
문학	m u n ɦ a̠ k̚
문헌	m u n ɦ ʌ̹ n
문혁	m u n ʝ j ʌ̹ k̚
문화	m u n β w a̠
문화어	m u n β w a̠ ʌ̹
문화적	m u n β w a̠ d͡ʑ ʌ̹ k̚
물가	m u ɭ k͈ a̠
물건	m u ɭ ɡ ʌ̹ n
물결길이	m u ɭ ɡ j ʌ̹ ɭ ɡ i ɾ i
물고기알	m u ɭ ɡ o̞ ɡ i a̠ ɭ
물기	m u ɭ k͈ i
물놀이장	m u ɭ ɭ o̞ ɾ i d͡ʑ a̠ ŋ
물들다	m u ɭ d ɯ ɭ d a̠
물들이다	m u ɭ d ɯ ɾ i d a̠
물러나다	m u ɭ ɭ ʌ̹ n a̠ d a̠
물러서다	m u ɭ ɭ ʌ̹ sʰ ʌ̹ d a̠
물레	m u ɭ ɭ e̞
물리학	m u ʎ ʎ i ɦ a̠ k̚
물리학자	m u ʎ ʎ i ɦ a̠ k̚ t͡ɕ͈ a̠
물리화학	m u ʎ ʎ i β w a̠ ɦ a̠ k̚
물만두	m u ɭ m a̠ n d u
물망초	m u ɭ m a̠ ŋ t͡ɕʰ o̞
물방울	m u ɭ p͈ a̠ ŋ u ɭ
물범	m u ɭ b ʌ̹ m
물소	m u ɭ s͈ o̞
물수리	m u ɭ s͈ u ɾ i
물시계	m u ɭ ɕ͈ i ɡ j e̞
물어뜯다	m u ɾ ʌ̹ t͈ ɯ t̚ t͈ a̠
물어보다	m u ɾ ʌ̹ b o̞ d a̠
물음	m u ɾ ɯ m
물증	m u ʎ d͡ʑ ɯ ŋ
물질	m u ʎ t͡ɕ͈ i ɭ
물체	m u ʎ t͡ɕʰ e̞
물통	m u ɭ tʰ o̞ ŋ
물푸레나무	m u ɭ pʰ u ɾ e̞ n a̠ m u
묽다	m u k̚ t͈ a̠
뭄바이	m u m b a̠ i
뮌헨	m ɥ i n ɦ e̞ n
미각	m i ɡ a̠ k̚
미국	m i ɡ u k̚
미국오리	m i ɡ u ɡ o̞ ɾ i
미국인	m i ɡ u ɡ i n
미꾸라지	m i k͈ u ɾ a̠ d͡ʑ i
미끄럽다	m i k͈ ɯ ɾ ʌ̹ p̚ t͈ a̠
미나리	m i n a̠ ɾ i
미남	m iː n a̠ m
미녀	m iː ɲ j ʌ̹
미니버스	m i n i b ʌ̹ sʰ ɯ
미니스커트	m i n i sʰ ɯ kʰ ʌ̹ tʰ ɯ
미덕	m iː d ʌ̹ k̚
미디어	m i d i ʌ̹
미라	m i ɾ a̠
미루다	m i ɾ u d a̠
미르	m i ɾ ɯ
미륵	m i ɾ ɯ k̚
미리보기	m i ɾ i b o̞ ɡ i
미모	m iː m o̞
미분	m i b u n
미사	m i sʰ a̠
미사일	m i sʰ a̠ i ɭ
미상	m iː sʰ a̠ ŋ
미성	m iː sʰ ʌ̹ ŋ
미성숙하다	m iː sʰ ʌ̹ ŋ sʰ u kʰ a̠ d a̠
미소녀	m iː sʰ o̞ ɲ j ʌ̹
미소짓다	m i sʰ o̞ d͡ʑ i t̚ t͈ a̠
미수	m i sʰ u
미술	m iː sʰ u ɭ
미술관	m iː sʰ u ɭ ɡ w a̠ n
미스	m i sʰ ɯ
미스터	m i sʰ ɯ tʰ ʌ̹
미아	m i a̠
미안	m i a̠ n
미얀마	m i j a̠ n m a̠
미어	m i ʌ̹
미어지다	m i ʌ̹ d͡ʑ i d a̠
미역	m i j ʌ̹ k̚
미역국	m i j ʌ̹ k̚ k͈ u k̚
미용실	m iː j o ŋ ɕʰ i ɭ
미적분	m i d͡ʑ ʌ̹ k̚ p͈ u n
미적지근하다	m i d͡ʑ ʌ̹ k̚ t͡ɕ͈ i ɡ ɯ n ɦ a̠ d a̠
미주	m i d͡ʑ u
미주알	m i d͡ʑ u a̠ ɭ
미주알고주알	m i d͡ʑ u a̠ ɭ ɡ o̞ d͡ʑ u a̠ ɭ
미지수	m iː d͡ʑ i sʰ u
미처	m i t͡ɕʰ ʌ̹
미치광이	m i t͡ɕʰ i ɡ w a̠ ŋ i
미치다	m i t͡ɕʰ i d a̠
미카엘	m i kʰ a̠ e̞ ɭ
미터	m i tʰ ʌ̹
미팅	m i tʰ i ŋ
미학	m iː ɦ a̠ k̚
미합중국	m i ɦ a̠ p̚ t͡ɕ͈ u ŋ ɡ u k̚
미혼모	m iː β o̞ n m o̞
민간	m i n ɡ a̠ n
민감	m i n ɡ a̠ m
민감하다	m i n ɡ a̠ m ɦ a̠ d a̠
민국	m i n ɡ u k̚
민낯	m i n n a̠ t̚
민망	m i n m a̠ ŋ
민병	m i n b j ʌ̹ ŋ
민서	m i n s͈ ʌ̹
민속	m i n sʰ o̞ k̚
민요	m i ɲ j o
민족주의	m i ɲ d͡ʑ o̞ k̚ t͡ɕ͈ u ɰ i
민주	m i ɲ d͡ʑ u
민주주의	m i ɲ d͡ʑ u d͡ʑ u ɰ i
민중	m i ɲ d͡ʑ u ŋ
민화	m i n β w a̠
믿다	m i t̚ t͈ a̠
믿음	m i d ɯ m
밀가루	m i ɭ k͈ a̠ ɾ u
밀도	m i ɭ t͈ o̞
밀랍	m i ɭ ɭ a̠ p̚
밀리다	m i ʎ ʎ i d a̠
밀리미터	m i ʎ ʎ i m i tʰ ʌ̹
밀림	m i ʎ ʎ i m
밀어	m i ɾ ʌ̹
밀월	m i ɾ w ʌ̹ ɭ
밀치다	m iː ʎ t͡ɕʰ i d a̠
밀크	m i ɭ k x ɯ
밉다	m iː p̚ t͈ a̠
바게트	p͈ a̠ ɡ e̞ tʰ ɯ
바곤	p a̠ ɡ o̞ n
바구니	p a̠ ɡ u n i
바그다드	p a̠ ɡ ɯ d a̠ d ɯ
바그르르	p a̠ ɡ ɯ ɾ ɯ ɾ ɯ
바글바글	p a̠ ɡ ɯ ɭ b a̠ ɡ ɯ ɭ
바깥	p a̠ k͈ a̠ t̚
바깥어른	p a̠ k͈ a̠ d ʌ̹ ɾ ɯ n
바깥쪽	p a̠ k͈ a̠ t̚ t͡ɕ͈ o̞ k̚
바뀌다	p a̠ k͈ ɥ i d a̠
바누아투	p a̠ n u a̠ tʰ u
바늘	p a̠ n ɯ ɭ
바다	p a̠ d a̠
바다사자	p a̠ d a̠ sʰ a̠ d͡ʑ a̠
바다코끼리	p a̠ d a̠ kʰ o̞ k͈ i ɾ i
바다표범	p a̠ d a̠ pʰ j o b ʌ̹ m
바닷가	p a̠ d a̠ t̚ k͈ a̠
바닷물	p a̠ d a̠ n m u ɭ
바둑	p a̠ d u k̚
바라다	p a̠ ɾ a̠ d a̠
바라보다	p a̠ ɾ a̠ b o̞ d a̠
바람	p a̠ ɾ a̠ m
바람둥이	p a̠ ɾ a̠ m d u ŋ i
바람직하다	p a̠ ɾ a̠ m d͡ʑ i kʰ a̠ d a̠
바레인	p a̠ ɾ e̞ i n
바로	p a̠ ɾ o̞
바로잡다	p a̠ ɾ o̞ d͡ʑ a̠ p̚ t͈ a̠
바륨	p a̠ ɾ j u m
바르다	p a̠ ɾ ɯ d a̠
바르샤바	p a̠ ɾ ɯ ɕʰ a̠ b a̠
바리	p a̠ ɾ i
바마코	p a̠ m a̠ kʰ o̞
바베이도스	p a̠ b e̞ i d o̞ sʰ ɯ
바보	p a̠ː b o̞
바쁘다	p a̠ p͈ ɯ d a̠
바수다	p a̠ sʰ u d a̠
바스라기	p a̠ sʰ ɯ ɾ a̠ ɡ i
바스락바스락	p a̠ sʰ ɯ ɾ a̠ k̚ p͈ a̠ sʰ ɯ ɾ a̠ k̚
바싹	p a̠ s͈ a̠ k̚
바알	p a̠ a̠ ɭ
바오로	p a̠ o̞ ɾ o̞
바오즈	p a̠ o̞ d͡ʑ ɯ
바위	p a̠ ɥ i
바이든	p a̠ i d ɯ n
바이러스	p a̠ i ɾ ʌ̹ sʰ ɯ
바이블	p a̠ i b ɯ ɭ
바이슨	p a̠ i sʰ ɯ n
바이오	p a̠ i o̞
바이올린	p a̠ i o̞ ʎ ʎ i n
바이트	p a̠ i tʰ ɯ
바자회	p a̠ d͡ʑ a̠ β w e̞
바지	p a̠ d͡ʑ i
바지락	p a̠ d͡ʑ i ɾ a̠ k̚
바질	p a̠ d͡ʑ i ɭ
바쿠	p a̠ kʰ u
바퀴	p a̠ kʰ ɥ i
바탕	p a̠ tʰ a̠ ŋ
바텐더	p a̠ tʰ e̞ n d ʌ̹
바티칸	p a̠ tʰ i kʰ a̠ n
바하마	p a̠ ɦ a̠ m a̠
박동	p a̠ k̚ t͈ o̞ ŋ
박람회	p a̠ ŋ n a̠ m β w e̞
박물관	p a̠ ŋ m u ɭ ɡ w a̠ n
박사	p a̠ k s͈ a̠
박수	p a̠ k s͈ u
박스	p a̠ k s͈ ɯ
박이	p a̠ ɡ i
박제	p a̠ k̚ t͡ɕ͈ e̞
박쥐	p a̠ː k̚ t͡ɕ͈ ɥ i
박차	p a̠ k̚ t͡ɕʰ a̠
박치기	p a̠ k̚ t͡ɕʰ i ɡ i
박테리아	p a̠ k̚ tʰ e̞ ɾ i a̠
박하	p a̠ kʰ a̠
밖에	p a̠ k͈ e̞
반경	p a̠ː n ɡ j ʌ̹ ŋ
반구	p a̠ː n ɡ u
반년	p a̠ː n ɲ j ʌ̹ n
반도	p a̠ː n d o̞
반도체	p a̠ː n d o̞ t͡ɕʰ e̞
반드시	p a̠ n d ɯ ɕʰ i
반듯이	p a̠ n d ɯ ɕʰ i
반듯하다	p a̠ n d ɯ tʰ a̠ d a̠
반딧불	p a̠ n d i t̚ p͈ u ɭ
반딧불이	p a̠ n d i t̚ p͈ u ɾ i
반려	p a̠ː ʎ ʎ j ʌ̹
반말	p a̠ n m a̠ ɭ
반면	p a̠ː n m j ʌ̹ n
반바지	p a̠ː n b a̠ d͡ʑ i
반박	p a̠ː n b a̠ k̚
반반	p a̠ː n b a̠ n
반발	p a̠ː n b a̠ ɭ
반복	p a̠ː n b o̞ k̚
반복하다	p a̠ n b o̞ kʰ a̠ d a̠
반사	p a̠ː n sʰ a̠
반시옷	p a̠ n ɕʰ i o̞ t̚
반시읏	p a̠ː n ɕʰ i ɯ t̚
반신반인	p a̠ː n ɕʰ i n b a̠ n i n
반역	p a̠ː ɲ j ʌ̹ k̚
반영	p a̠ː ɲ j ʌ̹ ŋ
반올림	p a̠ː n o̞ ʎ ʎ i m
반응	p a̠ː n ɯ ŋ
반의어	p a̠ː n ɰ i ʌ̹
반장	p a̠ ɲ d͡ʑ a̠ ŋ
반절	p a̠ː ɲ d͡ʑ ʌ̹ ɭ
반죽	p a̠ ɲ d͡ʑ u k̚
반지름	p a̠ː ɲ d͡ʑ i ɾ ɯ m
반지하	p a̠ː ɲ d͡ʑ i ɦ a̠
반짝	p a̠ ɲ t͡ɕ͈ a̠ k̚
반짝반짝	p a̠ ɲ t͡ɕ͈ a̠ k̚ p͈ a̠ ɲ t͡ɕ͈ a̠ k̚
반짝이다	p a̠ ɲ t͡ɕ͈ a̠ ɡ i d a̠
반찬	p a̠ ɲ t͡ɕʰ a̠ n
반창고	p a̠ ɲ t͡ɕʰ a̠ ŋ ɡ o̞
반추	p a̠ː ɲ t͡ɕʰ u
반치음	p a̠ː ɲ t͡ɕʰ i ɯ m
반포	p a̠ n pʰ o̞
반품	p a̠ː n pʰ u m
반항하다	p a̠ n ɦ a̠ ŋ ɦ a̠ d a̠
받다	p a̠ t̚ t͈ a̠
받아들이다	p a̠ d a̠ d ɯ ɾ i d a̠
받아쓰기	p a̠ d a̠ s͈ ɯ ɡ i
받침	p a̠ t̚ t͡ɕʰ i m
발가락	p a̠ ɭ k͈ a̠ ɾ a̠ k̚
발간	p a̠ ɭ ɡ a̠ n
발견	p a̠ ɭ ɡ j ʌ̹ n
발견되다	p a̠ ɭ ɡ j ʌ̹ n d w e̞ d a̠
발견하다	p a̠ ɭ ɡ j ʌ̹ n ɦ a̠ d a̠
발기	p a̠ ɭ ɡ i
발기부전	p a̠ ɭ ɡ i b u d͡ʑ ʌ̹ n
발꿈치	p a̠ ɭ k͈ u m t͡ɕʰ i
발끝	p a̠ ɭ k͈ ɯ t̚
발뒤꿈치	p a̠ ɭ t͈ ɥ i k͈ u m t͡ɕʰ i
발라드	p a̠ ɭ ɭ a̠ d ɯ
발란	p a̠ː ɭ ɭ a̠ n
발레	p a̠ ɭ ɭ e̞
발리볼	p a̠ ʎ ʎ i b o̞ ɭ
발명	p a̠ ɭ m j ʌ̹ ŋ
발목	p a̠ ɭ m o̞ k̚
발바닥	p a̠ ɭ p͈ a̠ d a̠ k̚
발열	p a̠ ɾ j ʌ̹ ɭ
발음	p a̠ ɾ ɯ m
발음하다	p a̠ ɾ ɯ m ɦ a̠ d a̠
발인	p a̠ ɾ i n
발자국	p a̠ ʎ t͡ɕ͈ a̠ ɡ u k̚
발전하다	p a̠ ʎ t͡ɕ͈ ʌ̹ n ɦ a̠ d a̠
발정	p a̠ ʎ t͡ɕ͈ ʌ̹ ŋ
발코니	p a̠ ɭ kʰ o̞ n i
발탁	p a̠ ɭ tʰ a̠ k̚
발톱	p a̠ ɭ tʰ o̞ p̚
발표	p a̠ ɭ pʰ j o
발효	p a̠ ɾ ʝ j o
발휘하다	p a̠ ɾ ɦ ɥ i ɦ a̠ d a̠
밝다	p a̠ k̚ t͈ a̠
밤낮	p a̠ m n a̠ t̚
밤하늘	p a̠ m ɦ a̠ n ɯ ɭ
밥벌이	p a̠ p̚ p͈ ʌ̹ ɾ i
밥상	p a̠ p s͈ a̠ ŋ
밥솥	p a̠ p s͈ o̞ t̚
밥집	p a̠ p̚ t͡ɕ͈ i p̚
방과후	p a̠ː ŋ ɡ w a̠ β u
방광	p a̠ ŋ ɡ w a̠ ŋ
방광암	p a̠ ŋ ɡ w a̠ ŋ a̠ m
방광염	p a̠ ŋ ɡ w a̠ ŋ ɲ j ʌ̹ m
방구	p a̠ ŋ ɡ u
방귀	p a̠ː ŋ ɡ ɥ i
방글라데시	p a̠ ŋ ɡ ɯ ɭ ɭ a̠ d e̞ ɕʰ i
방금	p a̠ ŋ ɡ ɯ m
방망이	p a̠ ŋ m a̠ ŋ i
방면	p a̠ ŋ m j ʌ̹ n
방문	p a̠ː ŋ m u n
방법	p a̠ ŋ b ʌ̹ p̚
방법론	p a̠ ŋ b ʌ̹ m n o̞ n
방사능	p a̠ː ŋ sʰ a̠ n ɯ ŋ
방사선	p a̠ː ŋ sʰ a̠ sʰ ʌ̹ n
방석집	p a̠ ŋ sʰ ʌ̹ k̚ t͡ɕ͈ i p̚
방송	p a̠ː ŋ sʰ o̞ ŋ
방송간섭	p a̠ː ŋ sʰ o̞ ŋ ɡ a̠ n sʰ ʌ̹ p̚
방송국	p a̠ː ŋ sʰ o̞ ŋ ɡ u k̚
방송원	p a̠ː ŋ sʰ o̞ ŋ w ʌ̹ n
방숭이	p a̠ː ŋ sʰ u ŋ i
방식	p a̠ ŋ ɕʰ i k̚
방심	p a̠ ŋ ɕʰ i m
방아	p a̠ ŋ a̠
방아쇠	p a̠ ŋ a̠ sʰ w e̞
방앗간	p a̠ ŋ a̠ t̚ k͈ a̠ n
방어	p a̠ ŋ ʌ̹
방어하다	p a̠ ŋ ʌ̹ ɦ a̠ d a̠
방언	p a̠ ŋ ʌ̹ n
방역	p a̠ ŋ j ʌ̹ k̚
방영	p a̠ː ŋ j ʌ̹ ŋ
방위각	p a̠ ŋ ɥ i ɡ a̠ k̚
방위산업체	p a̠ ŋ ɥ i sʰ a̠ n ʌ̹ p̚ t͡ɕʰ e̞
방점	p a̠ ŋ t͡ɕ͈ ʌ̹ m
방정식	p a̠ ŋ d͡ʑ ʌ̹ ŋ ɕʰ i k̚
방조	p a̠ ŋ d͡ʑ o̞
방주	p a̠ ŋ d͡ʑ u
방지	p a̠ ŋ d͡ʑ i
방출	p a̠ː ŋ t͡ɕʰ u ɭ
방탄	p a̠ ŋ tʰ a̠ n
방편	p a̠ ŋ pʰ j ʌ̹ n
방학	p a̠ ŋ ɦ a̠ k̚
방향	p a̠ ŋ ʝ j a̠ ŋ
배경	p ɛː ɡ j ʌ̹ ŋ
배교	p ɛː ɡ j o
배낭	p ɛː n a̠ ŋ
배다	p ɛː d a̠
배달	p ɛː d a̠ ɭ
배당	p ɛː d a̠ ŋ
배반하다	p ɛː b a̠ n ɦ a̠ d a̠
배부	p ɛː b u
배송	p ɛː sʰ o̞ ŋ
배수관	p ɛː sʰ u ɡ w a̠ n
배신	p ɛː ɕʰ i n
배신하다	p ɛː ɕʰ i n ɦ a̠ d a̠
배심	p ɛː ɕʰ i m
배심원	p ɛː ɕʰ i m w ʌ̹ n
배우자	p ɛː u d͡ʑ a̠
배추	p ɛː t͡ɕʰ u
뱀장어	p ɛː m d͡ʑ a̠ ŋ ʌ̹
뱅어	p ɛː ŋ ʌ̹
뱉다	p ɛː t̚ t͈ a̠
버거	p ʌ̹ ɡ ʌ̹
버그	p ʌ̹ ɡ ɯ
버그르르	p ʌ̹ ɡ ɯ ɾ ɯ ɾ ɯ
버들가지	p ʌ̹ d ɯ ɭ ɡ a̠ d͡ʑ i
버들붕어	p ʌ̹ d ɯ ɭ b u ŋ ʌ̹
버러지	p ʌ̹ ɾ ʌ̹ d͡ʑ i
버리다	p ʌ̹ ɾ i d a̠
버마	p ʌ̹ m a̠
버무리다	p ʌ̹ m u ɾ i d a̠
버미	p ɘː m i
버버리	p ʌ̹ b ʌ̹ ɾ i
버선	p ʌ̹ sʰ ʌ̹ n
버섯	p ʌ̹ sʰ ʌ̹ t̚
버전	p ʌ̹ d͡ʑ ʌ̹ n
버지니아	p ʌ̹ d͡ʑ i n i a̠
버클	p ʌ̹ k x ɯ ɭ
버티다	p ʌ̹ tʰ i d a̠
버팔로	p ʌ̹ pʰ a̠ ɭ ɭ o̞
벅차다	p ʌ̹ k̚ t͡ɕʰ a̠ d a̠
번데기	p ʌ̹ n d e̞ ɡ i
번역	p ʌ̹ ɲ j ʌ̹ k̚
번역가	p ʌ̹ ɲ j ʌ̹ k̚ k͈ a̠
번영	p ʌ̹ ɲ j ʌ̹ ŋ
번쩍번쩍	p ʌ̹ ɲ t͡ɕ͈ ʌ̹ k̚ p͈ ʌ̹ ɲ t͡ɕ͈ ʌ̹ k̚
번호	p ʌ̹ n β o̞
벌거벗다	p ʌ̹ ɭ ɡ ʌ̹ b ʌ̹ t̚ t͈ a̠
벌꿀	p ɘː ɭ k͈ u ɭ
벌다	p ɘː ɭ d a̠
벌떡	p ʌ̹ ɭ t͈ ʌ̹ k̚
벌써	p ʌ̹ ɭ s͈ ʌ̹
벌어지다	p ɘː ɾ ʌ̹ d͡ʑ i d a̠
범부	p ɘː m b u
범아귀	p ɘː m a̠ ɡ ɥ i
범위	p ɘː m ɥ i
범인	p ɘː m i n
범죄	p ɘː m d͡ʑ w e̞
범죄자	p ɘː m d͡ʑ w e̞ d͡ʑ a̠
범주	p ɘː m d͡ʑ u
법가	p ʌ̹ p̚ k͈ a̠
법관	p ʌ̹ p̚ k͈ w a̠ n
법랑질	p ʌ̹ m n a̠ ŋ d͡ʑ i ɭ
법령	p ʌ̹ m ɲ j ʌ̹ ŋ
법륜	p ʌ̹ m ɲ j u n
법률	p ʌ̹ m ɲ j u ɭ
법률학	p ʌ̹ m ɲ j u ɾ ɦ a̠ k̚
법무부	p ʌ̹ m m u b u
법안	p ʌ̹ b a̠ n
법원	p ʌ̹ b w ʌ̹ n
법인	p ʌ̹ b i n
법정	p ʌ̹ p̚ t͡ɕ͈ ʌ̹ ŋ
법학	p ʌ̹ pʰ a̠ k̚
벗겨지다	p ʌ̹ t̚ k͈ j ʌ̹ d͡ʑ i d a̠
벙어리	p ʌ̹ ŋ ʌ̹ ɾ i
벚꽃	p ʌ̹ t̚ k͈ o̞ t̚
베네수엘라	p e̞ n e̞ sʰ u e̞ ɭ ɭ a̠
베니스	p e̞ n i sʰ ɯ
베닌	p e̞ n i n
베드로	p e̞ d ɯ ɾ o̞
베를린	p e̞ ɾ ɯ ʎ ʎ i n
베스트셀러	p e̞ sʰ ɯ tʰ ɯ sʰ e̞ ɭ ɭ ʌ̹
베스푸치	p e̞ sʰ ɯ pʰ u t͡ɕʰ i
베오그라드	p e̞ o̞ ɡ ɯ ɾ a̠ d ɯ
베이루트	p e̞ i ɾ u tʰ ɯ
베이징	p e̞ i d͡ʑ i ŋ
베이컨	p e̞ i kʰ ʌ̹ n
베짱이	p e̞ t͡ɕ͈ a̠ ŋ i
베트남	p e̞ tʰ ɯ n a̠ m
베트남어	p e̞ tʰ ɯ n a̠ m ʌ̹
베풀다	p e̞ pʰ u ɭ d a̠
벤젠	p e̞ ɲ d͡ʑ e̞ n
벤질기	p e̞ ɲ d͡ʑ i ɭ ɡ i
벤치	p e̞ ɲ t͡ɕʰ i
벨기에	p e̞ ɭ ɡ i e̞
벨라루스	p e̞ ɭ ɭ a̠ ɾ u sʰ ɯ
벨리즈	p e̞ ʎ ʎ i d͡ʑ ɯ
벨모판	p e̞ ɭ m o̞ pʰ a̠ n
벨벳	p e̞ ɭ b e̞ t̚
벨트	p e̞ ɭ tʰ ɯ
벼락	p j ʌ̹ ɾ a̠ k̚
벼락부자	p j ʌ̹ ɾ a̠ k̚ p͈ u d͡ʑ a̠
벼랑	p j ʌ̹ ɾ a̠ ŋ
벼리다	p j ʌ̹ ɾ i d a̠
벼슬	p j ʌ̹ sʰ ɯ ɭ
벽자	p j ʌ̹ k̚ t͡ɕ͈ a̠
벽장	p j ʌ̹ k̚ t͡ɕ͈ a̠ ŋ
변기	p j ʌ̹ n ɡ i
변동	p j ɘː n d o̞ ŋ
변변하다	p j ʌ̹ n b j ʌ̹ n ɦ a̠ d a̠
변비	p j ʌ̹ n b i
변소	p j ʌ̹ n sʰ o̞
변수	p j ɘː n sʰ u
변압기	p j ʌ̹ n a̠ p̚ k͈ i
변이하다	p j ɘː n i ɦ a̠ d a̠
변한	p j ɘː n ɦ a̠ n
변형	p j ɘː n ʝ j ʌ̹ ŋ
변호사	p j ɘː n β o̞ sʰ a̠
변화	p j ɘː n β w a̠
변환	p j ɘː n β w a̠ n
별거	p j ʌ̹ ɭ ɡ ʌ̹
별다르다	p j ʌ̹ ɭ d a̠ ɾ ɯ d a̠
별도	p j ʌ̹ ɭ t͈ o̞
별명	p j ʌ̹ ɭ m j ʌ̹ ŋ
별별	p j ʌ̹ ɭ b j ʌ̹ ɭ
별빛	p j ɘː ɭ p͈ i t̚
별세	p j ʌ̹ ɭ s͈ e̞
별세하다	p j ʌ̹ ɭ s͈ e̞ ɦ a̠ d a̠
별실	p j ʌ̹ ɭ ɕ͈ i ɭ
별일	p j ʌ̹ ɾ i ɭ
별표	p j ɘː ɭ pʰ j o
볏짚	p j ʌ̹ t̚ t͡ɕ͈ i p̚
병기고	p j ʌ̹ ŋ ɡ i ɡ o̞
병들다	p j ɘː ŋ d ɯ ɭ d a̠
병리학	p j ɘː ŋ n i ɦ a̠ k̚
병법	p j ʌ̹ ŋ p͈ ʌ̹ p̚
병사	p j ʌ̹ ŋ sʰ a̠
병신	p j ɘː ŋ ɕʰ i n
병아리	p j ʌ̹ ŋ a̠ ɾ i
병역	p j ʌ̹ ŋ j ʌ̹ k̚
병원	p j ɘː ŋ w ʌ̹ n
병풍	p j ʌ̹ ŋ pʰ u ŋ
병합	p j ɘː ŋ ɦ a̠ p̚
보건	p o̞ː ɡ ʌ̹ n
보건소	p o̞ː ɡ ʌ̹ n sʰ o̞
보고	p o̞ː ɡ o̞
보고서	p o̞ː ɡ o̞ sʰ ʌ̹
보고타	p o̞ ɡ o̞ tʰ a̠
보고하다	p o̞ː ɡ o̞ ɦ a̠ d a̠
보관	p o̞ː ɡ w a̠ n
보그르르	p o̞ ɡ ɯ ɾ ɯ ɾ ɯ
보글보글	p o̞ ɡ ɯ ɭ b o̞ ɡ ɯ ɭ
보기	p o̞ ɡ i
보너스	p o̞ n ʌ̹ sʰ ɯ
보닛	p o̞ n i t̚
보다	p o̞ d a̠
보다도	p o̞ d a̠ d o̞
보드	p o̞ d ɯ
보드카	p o̞ d ɯ kʰ a̠
보디빌딩	p o̞ d i b i ɭ d i ŋ
보따리	p o̞ t͈ a̠ ɾ i
보라	p o̞ ɾ a̠
보람	p o̞ ɾ a̠ m
보름	p o̞ ɾ ɯ m
보름날	p o̞ ɾ ɯ m n a̠ ɭ
보리	p o̞ ɾ i
보물	p o̞ː m u ɭ
보병	p o̞ː b j ʌ̹ ŋ
보복	p o̞ː b o̞ k̚
보사삭	p o̞ sʰ a̠ sʰ a̠ k̚
보살	p o̞ sʰ a̠ ɭ
보살피다	p o̞ sʰ a̠ ɭ pʰ i d a̠
보상	p o̞ː sʰ a̠ ŋ
보상하다	p o̞ː sʰ a̠ ŋ ɦ a̠ d a̠
보석	p o̞ː sʰ ʌ̹ k̚
보수주의	p o̞ː sʰ u d͡ʑ u ɰ i
보스니아	p o̞ sʰ ɯ n i a̠
보슬보슬	p o̞ sʰ ɯ ɭ b o̞ sʰ ɯ ɭ
보신탕	p o̞ː ɕʰ i n tʰ a̠ ŋ
보안	p o̞ː a̠ n
보온병	p o̞ː o̞ n b j ʌ̹ ŋ
보일러	p o̞ i ɭ ɭ ʌ̹
보잉	p o̞ i ŋ
보잘것없다	p o̞ d͡ʑ a̠ ɭ k͈ ʌ̹ sʰ ʌ̹ p̚ t͈ a̠
보증	p o̞ d͡ʑ ɯ ŋ
보지	p o̞ː d͡ʑ i
보충하다	p o̞ː t͡ɕʰ u ŋ ɦ a̠ d a̠
보츠와나	p o̞ t͡ɕʰ ɯ w a̠ n a̠
보통	p o̞ː tʰ o̞ ŋ
보편적	p o̞ː pʰ j ʌ̹ ɲ d͡ʑ ʌ̹ k̚
보험	p o̞ː ɦ ʌ̹ m
보호	p o̞ː β o̞
보호하다	p o̞ː β o̞ ɦ a̠ d a̠
복건성	p o̞ k̚ k͈ ʌ̹ n sʰ ʌ̹ ŋ
복권	p o̞ k̚ k͈ w ʌ̹ n
복날	p o̞ ŋ n a̠ ɭ
복도	p o̞ k̚ t͈ o̞
복력	p o̞ ŋ ɲ j ʌ̹ k̚
복병	p o̞ k̚ p͈ j ʌ̹ ŋ
복불복	p o̞ k̚ p͈ u ɭ b o̞ k̚
복사	p o̞ k s͈ a̠
복사기	p o̞ k s͈ a̠ ɡ i
복선	p o̞ k s͈ ʌ̹ n
복소수	p o̞ k s͈ o̞ s͈ u
복수	p o̞ k s͈ u
복수전	p o̞ k s͈ u d͡ʑ ʌ̹ n
복수하다	p o̞ k s͈ u ɦ a̠ d a̠
복숭아	p o̞ k s͈ u ŋ a̠
복스럽다	p o̞ k s͈ ɯ ɾ ʌ̹ p̚ t͈ a̠
복습	p o̞ k s͈ ɯ p̚
복싱	p o̞ k ɕ͈ i ŋ
복엽기	p o̞ ɡ j ʌ̹ p̚ k͈ i
복음서	p o̞ ɡ ɯ m sʰ ʌ̹
복잡	p o̞ k̚ t͡ɕ͈ a̠ p̚
복제	p o̞ k̚ t͡ɕ͈ e̞
복호	p o̞ kʰ o̞
볶다	p o̞ k̚ t͈ a̠
본능	p o̞ n n ɯ ŋ
본문	p o̞ n m u n
본사	p o̞ n sʰ a̠
본성	p o̞ n sʰ ʌ̹ ŋ
본질	p o̞ ɲ d͡ʑ i ɭ
본토	p o̞ n tʰ o̞
볼리비아	p o̞ ʎ ʎ i b i a̠
볼링	p o̞ ʎ ʎ i ŋ
볼일	p o̞ː ʎ ʎ i ɭ
볼트	p o̞ ɭ tʰ ɯ
볼펜	p o̞ ɭ pʰ e̞ n
봄바람	p o̞ m p͈ a̠ ɾ a̠ m
봄철	p o̞ m t͡ɕʰ ʌ̹ ɭ
봉건	p o̞ ŋ ɡ ʌ̹ n
봉급	p o̞ː ŋ ɡ ɯ p̚
봉기	p o̞ ŋ ɡ i
봉사	p o̞ː ŋ sʰ a̠
봉우리	p o̞ ŋ u ɾ i
봉지	p o̞ ŋ d͡ʑ i
봉착	p o̞ ŋ t͡ɕʰ a̠ k̚
봉착하다	p o̞ ŋ t͡ɕʰ a̠ kʰ a̠ d a̠
봉투	p o̞ ŋ tʰ u
봐주다	p w a̠ː d͡ʑ u d a̠
부검	p uː ɡ ʌ̹ m
부근	p uː ɡ ɯ n
부끄러움	p u k͈ ɯ ɾ ʌ̹ u m
부끄러워하다	p u k͈ ɯ ɾ ʌ̹ w ʌ̹ ɦ a̠ d a̠
부끄리다	p u k͈ ɯ ɾ i d a̠
부농	p uː n o̞ ŋ
부다페스트	p u d a̠ pʰ e̞ sʰ ɯ tʰ ɯ
부담하다	p uː d a̠ m ɦ a̠ d a̠
부동산	p u d o̞ ŋ sʰ a̠ n
부두	p u d u
부드럽다	p u d ɯ ɾ ʌ̹ p̚ t͈ a̠
부들	p u d ɯ ɭ
부딪다	p u d i t̚ t͈ a̠
부러뜨리다	p u ɾ ʌ̹ t͈ ɯ ɾ i d a̠
부러움	p u ɾ ʌ̹ u m
부럼없다	p u ɾ ʌ̹ m ʌ̹ p̚ t͈ a̠
부럽다	p u ɾ ʌ̹ p̚ t͈ a̠
부록	p uː ɾ o̞ k̚
부룬디	p u ɾ u n d i
부류	p u ɾ j u
부르다	p u ɾ ɯ d a̠
부르죠아	p u ɾ ɯ d͡ʑ o a̠
부르짖다	p u ɾ ɯ d͡ʑ i t̚ t͈ a̠
부르트다	p u ɾ ɯ tʰ ɯ d a̠
부름	p u ɾ ɯ m
부리	p u ɾ i
부리나케	p u ɾ i n a̠ kʰ e̞
부리다	p u ɾ i d a̠
부모	p u m o̞
부모님	p u m o̞ n i m
부부	p u b u
부분	p u b u n
부분적	p u b u ɲ d͡ʑ ʌ̹ k̚
부사	p uː sʰ a̠
부산	p u sʰ a̠ n
부상자	p uː sʰ a̠ ŋ d͡ʑ a̠
부서	p u sʰ ʌ̹
부서석	p u sʰ ʌ̹ sʰ ʌ̹ k̚
부서지다	p u sʰ ʌ̹ d͡ʑ i d a̠
부수	p u sʰ u
부스러기	p u sʰ ɯ ɾ ʌ̹ ɡ i
부스럭부스럭	p u sʰ ɯ ɾ ʌ̹ k̚ p͈ u sʰ ɯ ɾ ʌ̹ k̚
부슬부슬	p u sʰ ɯ ɭ b u sʰ ɯ ɭ
부신	p uː ɕʰ i n
부썩	p u s͈ ʌ̹ k̚
부썩부썩	p u s͈ ʌ̹ k̚ p͈ u s͈ ʌ̹ k̚
부아	p u a̠
부아소리	p u a̠ sʰ o̞ ɾ i
부엉이	p u ʌ̹ ŋ i
부에노스아이레스	p u e̞ n o̞ sʰ ɯ a̠ i ɾ e̞ sʰ ɯ
부여	p u j ʌ̹
부여하다	p uː j ʌ̹ ɦ a̠ d a̠
부위	p u ɥ i
부유	p uː j u
부유하다	p uː j u ɦ a̠ d a̠
부이온	p u i o̞ n
부인하다	p uː i n ɦ a̠ d a̠
부임	p uː i m
부임하다	p u i m ɦ a̠ d a̠
부작용	p uː d͡ʑ a̠ ɡ j o ŋ
부장	p u d͡ʑ a̠ ŋ
부적	p uː d͡ʑ ʌ̹ k̚
부전자전	p u d͡ʑ ʌ̹ ɲ d͡ʑ a̠ d͡ʑ ʌ̹ n
부정관사	p u d͡ʑ ʌ̹ ŋ ɡ w a̠ n sʰ a̠
부정적분	p u d͡ʑ ʌ̹ ŋ d͡ʑ ʌ̹ k̚ p͈ u n
부제	p uː d͡ʑ e̞
부조리	p u d͡ʑ o̞ ɾ i
부족	p u d͡ʑ o̞ k̚
부족하다	p u d͡ʑ o̞ kʰ a̠ d a̠
부처	p u t͡ɕʰ ʌ̹
부처님	p u t͡ɕʰ ʌ̹ n i m
부추	p uː t͡ɕʰ u
부쿠레슈티	p u kʰ u ɾ e̞ ɕʰ u tʰ i
부탁	p uː tʰ a̠ k̚
부탁하다	p uː tʰ a̠ kʰ a̠ d a̠
부탄	p u tʰ a̠ n
부터	p u tʰ ʌ̹
부통령	p uː tʰ o̞ ŋ ɲ j ʌ̹ ŋ
부티크	p u tʰ i k x ɯ
부품	p u pʰ u m
부피	p u pʰ i
부호	p uː β o̞
부화	p u β w a̠
부활	p uː β w a̠ ɭ
부회장	p uː β w e̞ d͡ʑ a̠ ŋ
북경	p u k̚ k͈ j ʌ̹ ŋ
북극곰	p u k̚ k͈ ɯ k̚ k͈ o̞ m
북돋다	p u k̚ t͈ o̞ t̚ t͈ a̠
북돋우다	p u k̚ t͈ o̞ d u d a̠
북두칠성	p u k̚ t͈ u t͡ɕʰ i ɭ sʰ ʌ̹ ŋ
북마케도니아	p u ŋ m a̠ kʰ e̞ d o̞ n i a̠
북마크	p u ŋ m a̠ k x ɯ
북미	p u ŋ m i
북반구	p u k̚ p͈ a̠ n ɡ u
북방	p u k̚ p͈ a̠ ŋ
북방흰뺨오리	p u k̚ p͈ a̠ ŋ ʝ i n p͈ j a̠ m o̞ ɾ i
북부	p u k̚ p͈ u
북서	p u k s͈ ʌ̹
북송	p u k s͈ o̞ ŋ
북숲쥐	p u k s͈ u p̚ t͡ɕ͈ ɥ i
북아메리카	p u ɡ a̠ m e̞ ɾ i kʰ a̠
북위	p u ɡ ɥ i
북쪽	p u k̚ t͡ɕ͈ o̞ k̚
북측	p u k̚ t͡ɕʰ ɯ k̚
북한말	p u kʰ a̠ n m a̠ ɭ
북한어	p u kʰ a̠ n ʌ̹
분광기	p u n ɡ w a̠ ŋ ɡ i
분권	p u n k͈ w ʌ̹ n
분노	p uː n n o̞
분단	p u n d a̠ n
분량	p uː ʎ ʎ j a̠ ŋ
분류	p u ʎ ʎ j u
분리	p u ʎ ʎ i
분리주의	p u ʎ ʎ i d͡ʑ u ɰ i
분말	p u n m a̠ ɭ
분명	p u n m j ʌ̹ ŋ
분명하다	p u n m j ʌ̹ ŋ ɦ a̠ d a̠
분모	p u n m o̞
분묘	p u n m j o
분사	p u n sʰ a̠
분석자	p u n sʰ ʌ̹ k̚ t͡ɕ͈ a̠
분석하다	p u n sʰ ʌ̹ kʰ a̠ d a̠
분수령	p u n sʰ u ɾ j ʌ̹ ŋ
분야	p u ɲ j a̠
분위기	p u n ɥ i ɡ i
분자	p u ɲ d͡ʑ a̠
분점	p u ɲ d͡ʑ ʌ̹ m
분주하다	p u ɲ d͡ʑ u ɦ a̠ d a̠
분투	p uː n tʰ u
분포하다	p u n pʰ o̞ ɦ a̠ d a̠
분필	p u n pʰ i ɭ
분홍빛	p uː n β o̞ ŋ p͈ i t̚
붇다	p uː t̚ t͈ a̠
불가결	p u ɭ ɡ a̠ ɡ j ʌ̹ ɭ
불가능하다	p u ɭ ɡ a̠ n ɯ ŋ ɦ a̠ d a̠
불가리아	p u ɭ ɡ a̠ ɾ i a̠
불가사리	p u ɭ ɡ a̠ sʰ a̠ ɾ i
불가피하다	p u ɭ ɡ a̠ pʰ i ɦ a̠ d a̠
불경	p u ɭ ɡ j ʌ̹ ŋ
불고기	p u ɭ ɡ o̞ ɡ i
불곰국	p u ɭ ɡ o̞ m ɡ u k̚
불과	p u ɭ ɡ w a̠
불과하다	p u ɭ ɡ w a̠ ɦ a̠ d a̠
불구속	p u ɭ ɡ u sʰ o̞ k̚
불구하다	p u ɭ ɡ u ɦ a̠ d a̠
불꽃	p u ɭ k͈ o̞ t̚
불꽃놀이	p u ɭ k͈ o̞ n n o̞ ɾ i
불다	p uː ɭ d a̠
불닭	p u ɭ d a̠ k̚
불도	p u ɭ t͈ o̞
불도저	p u ɭ d o̞ d͡ʑ ʌ̹
불량	p u ʎ ʎ j a̠ ŋ
불륜	p u ʎ ʎ j u n
불륜하다	p u ʎ ʎ j u n ɦ a̠ d a̠
불만	p u ɭ m a̠ n
불만족	p u ɭ m a̠ ɲ d͡ʑ o̞ k̚
불면증	p u ɭ m j ʌ̹ ɲ t͡ɕ͈ ɯ ŋ
불멸	p u ɭ m j ʌ̹ ɭ
불바다	p u ɭ b a̠ d a̠
불법	p u ɭ b ʌ̹ p̚
불변	p u ɭ b j ʌ̹ n
불복	p u ɭ b o̞ k̚
불빛	p u ɭ p͈ i t̚
불사조	p u ɭ s͈ a̠ d͡ʑ o̞
불상	p u ɭ sʰ a̠ ŋ
불쌍	p u ɭ s͈ a̠ ŋ
불쌍하다	p u ɭ s͈ a̠ ŋ ɦ a̠ d a̠
불안	p u ɾ a̠ n
불안하다	p u ɾ a̠ n ɦ a̠ d a̠
불야성	p u ɾ j a̠ sʰ ʌ̹ ŋ
불어	p u ɾ ʌ̹
불장난	p u ʎ d͡ʑ a̠ ŋ n a̠ n
불철주야	p u ʎ t͡ɕʰ ʌ̹ ʎ d͡ʑ u j a̠
불치병	p u ʎ t͡ɕʰ i p͈ j ʌ̹ ŋ
불친절	p u ʎ t͡ɕʰ i ɲ d͡ʑ ʌ̹ ɭ
불친절하다	p u ʎ t͡ɕʰ i ɲ d͡ʑ ʌ̹ ɾ ɦ a̠ d a̠
불타	p u ɭ tʰ a̠
불편	p u ɭ pʰ j ʌ̹ n
불편하다	p u ɭ pʰ j ʌ̹ n ɦ a̠ d a̠
불평	p u ɭ pʰ j ʌ̹ ŋ
불포화	p u ɭ pʰ o̞ β w a̠
불필요하다	p u ɭ pʰ i ɾ j o ɦ a̠ d a̠
불현듯	p u ɾ ʝ j ʌ̹ n d ɯ t̚
불화	p u ɾ β w a̠
불황	p u ɾ β w a̠ ŋ
붉어지다	p u ɭ ɡ ʌ̹ d͡ʑ i d a̠
붓글씨	p u t̚ k͈ ɯ ɭ ɕ͈ i
붕소	p u ŋ sʰ o̞
붕어	p uː ŋ ʌ̹
붕어빵	p u ŋ ʌ̹ p͈ a̠ ŋ
붙이다	p u t͡ɕʰ i d a̠
브금	p ɯ ɡ ɯ m
브라더	p ɯ ɾ a̠ d ʌ̹
브라우저	p ɯ ɾ a̠ u d͡ʑ ʌ̹
브라이언	p ɯ ɾ a̠ i ʌ̹ n
브라질리아	p ɯ ɾ a̠ d͡ʑ i ʎ ʎ i a̠
브라티슬라바	p ɯ ɾ a̠ tʰ i sʰ ɯ ɭ ɭ a̠ b a̠
브러시	p ɯ ɾ ʌ̹ ɕʰ i
브로치	p ɯ ɾ o̞ t͡ɕʰ i
브로커	p ɯ ɾ o̞ kʰ ʌ̹
브로콜리	p ɯ ɾ o̞ kʰ o̞ ʎ ʎ i
브루나이	p ɯ ɾ u n a̠ i
브뤼셀	p ɯ ɾ ɥ i sʰ e̞ ɭ
브리핑	p ɯ ɾ i pʰ i ŋ
블라디보스토크	p ɯ ɭ ɭ a̠ d i b o̞ sʰ ɯ tʰ o̞ k x ɯ
블라우스	p ɯ ɭ ɭ a̠ u sʰ ɯ
블라지보스또크	p ɯ ɭ ɭ a̠ d͡ʑ i b o̞ sʰ ɯ t͈ o̞ k x ɯ
블럭	p ɯ ɭ ɭ ʌ̹ k̚
블로그	p ɯ ɭ ɭ o̞ ɡ ɯ
블루길	p ɯ ɭ ɭ u ɡ i ɭ
블링블링	p ɯ ʎ ʎ i ŋ b ɯ ʎ ʎ i ŋ
비각	p i ɡ a̠ k̚
비고	p iː ɡ o̞
비골	p iː ɡ o̞ ɭ
비교급	p iː ɡ j o k͈ ɯ p̚
비교적	p iː ɡ j o d͡ʑ ʌ̹ k̚
비교하다	p iː ɡ j o ɦ a̠ d a̠
비구니	p iː ɡ u n i
비구름	p i ɡ u ɾ ɯ m
비극	p iː ɡ ɯ k̚
비기다	p i ɡ i d a̠
비난	p iː n a̠ n
비난하다	p iː n a̠ n ɦ a̠ d a̠
비눗방울	p i n u t̚ p͈ a̠ ŋ u ɭ
비늘	p i n ɯ ɭ
비닐	p i n i ɭ
비다	p i d a̠
비단길	p iː d a̠ n k͈ i ɭ
비데오	p i d e̞ o̞
비둘기	p i d u ɭ ɡ i
비듬	p i d ɯ m
비디오	p i d i o̞
비디오테이프	p i d i o̞ tʰ e̞ i pʰ ɯ
비로소	p i ɾ o̞ sʰ o̞
비롯되다	p i ɾ o̞ t̚ t͈ w e̞ d a̠
비료	p iː ɾ j o
비망록	p iː m a̠ ŋ n o̞ k̚
비밀	p iː m i ɭ
비밀리	p iː m i ʎ ʎ i
비밀번호	p iː m i ɭ b ʌ̹ n β o̞
비밀스럽다	p iː m i ɭ sʰ ɯ ɾ ʌ̹ p̚ t͈ a̠
비방	p i b a̠ ŋ
비버	p i b ʌ̹
비법	p iː p͈ ʌ̹ p̚
비사우	p i sʰ a̠ u
비서	p iː sʰ ʌ̹
비소	p i sʰ o̞
비수	p iː sʰ u
비슈케크	p i ɕʰ u kʰ e̞ k x ɯ
비스켓	p i sʰ ɯ kʰ e̞ t̚
비약하다	p i j a̠ kʰ a̠ d a̠
비엔나	p i e̞ n n a̠
비용	p iː j o ŋ
비우다	p i u d a̠
비유	p iː j u
비율	p iː j u ɭ
비자	p i d͡ʑ a̠
비잔티움	p i d͡ʑ a̠ n tʰ i u m
비중	p iː d͡ʑ u ŋ
비추다	p i t͡ɕʰ u d a̠
비취	p iː t͡ɕʰ ɥ i
비치발리볼	p i t͡ɕʰ i b a̠ ʎ ʎ i b o̞ ɭ
비타민	p i tʰ a̠ m i n
비트	p i tʰ ɯ
비트박스	p i tʰ ɯ b a̠ k s͈ ɯ
비트코인	p i tʰ ɯ kʰ o̞ i n
비파나무	p i pʰ a̠ n a̠ m u
비판	p iː pʰ a̠ n
비판적	p iː pʰ a̠ ɲ d͡ʑ ʌ̹ k̚
비판하다	p iː pʰ a̠ n ɦ a̠ d a̠
비평가	p iː pʰ j ʌ̹ ŋ ɡ a̠
비하다	p iː ɦ a̠ d a̠
빅토리아	p i k̚ tʰ o̞ ɾ i a̠
빈곤	p i n ɡ o̞ n
빈뇨	p i n ɲ j o
빈도	p i n d o̞
빈부	p i n b u
빈자	p i ɲ d͡ʑ a̠
빈칸	p iː n kʰ a̠ n
빈트후크	p i n tʰ ɯ β u k x ɯ
빈틈	p iː n tʰ ɯ m
빌뉴스	p i ʎ ʎ j u sʰ ɯ
빌딩	p i ɭ d i ŋ
빗금	p i t̚ k͈ ɯ m
빗물	p i n m u ɭ
빗자루	p i t̚ t͡ɕ͈ a̠ ɾ u
빗장뼈	p i t̚ t͡ɕ͈ a̠ ŋ p͈ j ʌ̹
빙고	p i ŋ ɡ o̞
빙빙	p i ŋ b i ŋ
빙산	p i ŋ sʰ a̠ n
빙상관	p i ŋ sʰ a̠ ŋ ɡ w a̠ n
빙수	p i ŋ sʰ u
빙점	p i ŋ d͡ʑ ʌ̹ m
빙하	p i ŋ ɦ a̠
빚다	p i t̚ t͈ a̠
빛나다	p i n n a̠ d a̠
빠다	p͈ a̠ d a̠
빠듯하다	p͈ a̠ d ɯ tʰ a̠ d a̠
빠리	p͈ a̠ ɾ i
빠져나오다	p͈ a̠ː d͡ʑ ʌ̹ n a̠ o̞ d a̠
빤스	p͈ a̠ n sʰ ɯ
빤짝	p͈ a̠ ɲ t͡ɕ͈ a̠ k̚
빨강	p͈ a̠ ɭ ɡ a̠ ŋ
빨갛다	p͈ a̠ ɭ ɡ a̠ tʰ a̠
빨리	p͈ a̠ ʎ ʎ i
빨리빨리	p͈ a̠ ʎ ʎ i p͈ a̠ ʎ ʎ i
빨아먹다	p͈ a̠ ɾ a̠ m ʌ̹ k̚ t͈ a̠
빼다	p͈ ɛː d a̠
뺄셈	p͈ ɛː ɭ sʰ e̞ m
뻔쩍뻔쩍	p͈ ʌ̹ ɲ t͡ɕ͈ ʌ̹ k̚ p͈ ʌ̹ ɲ t͡ɕ͈ ʌ̹ k̚
뻗다	p͈ ʌ̹ t̚ t͈ a̠
뻘떡	p͈ ʌ̹ ɭ t͈ ʌ̹ k̚
뽀르뚜갈	p͈ o̞ ɾ ɯ t͈ u ɡ a̠ ɭ
뽀뽀	p͈ o̞ p͈ o̞
뽀사삭	p͈ o̞ sʰ a̠ sʰ a̠ k̚
뽈스카	p͈ o̞ ɭ sʰ ɯ kʰ a̠
뽐프	p͈ o̞ m pʰ ɯ
뽑다	p͈ o̞ p̚ t͈ a̠
뾰족하다	p͈ j o d͡ʑ o̞ kʰ a̠ d a̠
뿌리다	p͈ u ɾ i d a̠
뿌서석	p͈ u sʰ ʌ̹ sʰ ʌ̹ k̚
뿌석	p͈ u sʰ ʌ̹ k̚
뿌셔뿌셔	p͈ u ɕʰ ʌ̹ p͈ u ɕʰ ʌ̹
뿌옇다	p͈ uː j ʌ̹ tʰ a̠
뿔논병아리	p͈ u ɭ ɭ o̞ n b j ʌ̹ ŋ a̠ ɾ i
뿜다	p͈ uː m t͈ a̠
삐딱하다	p͈ i t͈ a̠ kʰ a̠ d a̠
삐침	p͈ i t͡ɕʰ i m
삥궐	p͈ i ŋ ɡ w ʌ̹ ɭ
삥삥	p͈ i ŋ p͈ i ŋ
사거리	sʰ a̠ː ɡ ʌ̹ ɾ i
사건	sʰ a̠ː k͈ ʌ̹ n
사계	sʰ a̠ː ɡ j e̞
사골	sʰ a̠ː ɡ o̞ ɭ
사과하다	sʰ a̠ː ɡ w a̠ ɦ a̠ d a̠
사구	sʰ a̠ ɡ u
사기꾼	sʰ a̠ ɡ i k͈ u n
사기죄	sʰ a̠ ɡ i d͡ʑ w e̞
사나	sʰ a̠ n a̠
사나이	sʰ a̠ n a̠ i
사냥	sʰ a̠ ɲ j a̠ ŋ
사냥꾼	sʰ a̠ ɲ j a̠ ŋ k͈ u n
사다리	sʰ a̠ d a̠ ɾ i
사단	sʰ a̠ d a̠ n
사라예보	sʰ a̠ ɾ a̠ j e̞ b o̞
사라지다	sʰ a̠ ɾ a̠ d͡ʑ i d a̠
사랑	sʰ a̠ ɾ a̠ ŋ
사랑니	sʰ a̠ ɾ a̠ ŋ n i
사랑스럽다	sʰ a̠ ɾ a̠ ŋ sʰ ɯ ɾ ʌ̹ p̚ t͈ a̠
사령부	sʰ a̠ ɾ j ʌ̹ ŋ b u
사로잡다	sʰ a̠ ɾ o̞ d͡ʑ a̠ p̚ t͈ a̠
사르르	sʰ a̠ ɾ ɯ ɾ ɯ
사리원	sʰ a̠ ɾ i w ʌ̹ n
사립	sʰ a̠ ɾ i p̚
사립문	sʰ a̠ ɾ i m m u n
사마귀	sʰ a̠ː m a̠ ɡ ɥ i
사마륨	sʰ a̠ m a̠ ɾ j u m
사마리아	sʰ a̠ m a̠ ɾ i a̠
사막	sʰ a̠ m a̠ k̚
사막화	sʰ a̠ m a̠ kʰ w a̠
사망	sʰ a̠ː m a̠ ŋ
사면	sʰ a̠ː m j ʌ̹ n
사모	sʰ a̠ m o̞
사모아	sʰ a̠ m o̞ a̠
사무라이	sʰ a̠ m u ɾ a̠ i
사무소	sʰ a̠ː m u sʰ o̞
사무치다	sʰ a̠ m u t͡ɕʰ i d a̠
사물	sʰ a̠ː m u ɭ
사방	sʰ a̠ː b a̠ ŋ
사법	sʰ a̠ b ʌ̹ p̚
사본	sʰ a̠ b o̞ n
사뿐	sʰ a̠ p͈ u n
사뿐사뿐	sʰ a̠ p͈ u n sʰ a̠ p͈ u n
사상	sʰ a̠ː sʰ a̠ ŋ
사설	sʰ a̠ sʰ ʌ̹ ɭ
사스	sʰ a̠ sʰ ɯ
사슴	sʰ a̠ sʰ ɯ m
사시	sʰ a̠ ɕʰ i
사신	sʰ a̠ː ɕʰ i n
사실	sʰ a̠ː ɕʰ i ɭ
사악	sʰ a̠ a̠ k̚
사악하다	sʰ a̠ a̠ kʰ a̠ d a̠
사안	sʰ a̠ː a̠ n
사양	sʰ a̠ j a̠ ŋ
사업	sʰ a̠ː ʌ̹ p̚
사업가	sʰ a̠ː ʌ̹ p̚ k͈ a̠
사업주	sʰ a̠ː ʌ̹ p̚ t͡ɕ͈ u
사업차	sʰ a̠ ʌ̹ p̚ t͡ɕʰ a̠
사용되다	sʰ a̠ː j o ŋ d w e̞ d a̠
사용자	sʰ a̠ː j o ŋ d͡ʑ a̠
사용하다	sʰ a̠ː j o ŋ ɦ a̠ d a̠
사우나	s͈ a̠ u n a̠
사우디아라비아	sʰ a̠ u d i a̠ ɾ a̠ b i a̠
사울	sʰ a̠ u ɭ
사원	sʰ a̠ w ʌ̹ n
사월	sʰ a̠ː w ʌ̹ ɭ
사이다	sʰ a̠ i d a̠
사이렌	s͈ a̠ i ɾ e̞ n
사이보그	s͈ a̠ i b o̞ ɡ ɯ
사이비	sʰ a̠ː i b i
사이즈	s͈ a̠ i d͡ʑ ɯ
사이클링	sʰ a̠ i k x ɯ ʎ ʎ i ŋ
사이트	s͈ a̠ i tʰ ɯ
사자고추	sʰ a̠ d͡ʑ a̠ ɡ o̞ t͡ɕʰ u
사제	sʰ a̠ d͡ʑ e̞
사증	sʰ a̠ t͡ɕ͈ ɯ ŋ
사직	sʰ a̠ d͡ʑ i k̚
사진	sʰ a̠ d͡ʑ i n
사진사	sʰ a̠ d͡ʑ i n sʰ a̠
사진술	sʰ a̠ d͡ʑ i n sʰ u ɭ
사창	sʰ a̠ t͡ɕʰ a̠ ŋ
사천	sʰ a̠ː t͡ɕʰ ʌ̹ n
사철	sʰ a̠ t͡ɕʰ ʌ̹ ɭ
사철나무	sʰ a̠ː t͡ɕʰ ʌ̹ ɭ ɭ a̠ m u
사촌	sʰ a̠ː t͡ɕʰ o̞ n
사춘기	sʰ a̠ t͡ɕʰ u n ɡ i
사치품	sʰ a̠ t͡ɕʰ i pʰ u m
사쿠라	sʰ a̠ kʰ u ɾ a̠
사타구니	sʰ a̠ tʰ a̠ ɡ u n i
사탄	sʰ a̠ tʰ a̠ n
사탕	sʰ a̠ tʰ a̠ ŋ
사탕수수	sʰ a̠ tʰ a̠ ŋ sʰ u sʰ u
사투리	sʰ a̠ː tʰ u ɾ i
사파리	sʰ a̠ pʰ a̠ ɾ i
사하다	sʰ a̠ ɦ a̠ d a̠
사하라	sʰ a̠ ɦ a̠ ɾ a̠
사학	sʰ a̠ː ɦ a̠ k̚
사할린	sʰ a̠ ɦ a̠ ʎ ʎ i n
사항	sʰ a̠ː ɦ a̠ ŋ
사향	sʰ a̠ː ʝ j a̠ ŋ
사형	sʰ a̠ː ʝ j ʌ̹ ŋ
사회적	sʰ a̠ β w e̞ d͡ʑ ʌ̹ k̚
사회주의	sʰ a̠ β w e̞ d͡ʑ u ɰ i
사회학	sʰ a̠ β w e̞ ɦ a̠ k̚
사흘	sʰ a̠ ɣ ɯ ɭ
산골	sʰ a̠ n ɡ o̞ ɭ
산동	sʰ a̠ n d o̞ ŋ
산마리노	s͈ a̠ n m a̠ ɾ i n o̞
산문	sʰ a̠ː n m u n
산보	sʰ a̠ː n p͈ o̞
산봉우리	sʰ a̠ n p͈ o̞ ŋ u ɾ i
산불	sʰ a̠ n b u ɭ
산서	sʰ a̠ n sʰ ʌ̹
산술	sʰ a̠ː n sʰ u ɭ
산시	sʰ a̠ n ɕʰ i
산양	sʰ a̠ ɲ j a̠ ŋ
산장	sʰ a̠ ɲ d͡ʑ a̠ ŋ
산전	sʰ a̠ ɲ d͡ʑ ʌ̹ n
산천	sʰ a̠ ɲ t͡ɕʰ ʌ̹ n
산토끼	sʰ a̠ n tʰ o̞ k͈ i
산티아고	sʰ a̠ n tʰ i a̠ ɡ o̞
산호	sʰ a̠ n β o̞
산호초	sʰ a̠ n β o̞ t͡ɕʰ o̞
살결물	sʰ a̠ ɭ k͈ j ʌ̹ ɭ m u ɭ
살그머니	sʰ a̠ ɭ ɡ ɯ m ʌ̹ n i
살금살금	sʰ a̠ ɭ ɡ ɯ m sʰ a̠ ɭ ɡ ɯ m
살다	sʰ a̠ː ɭ d a̠
살롱	sʰ a̠ ɭ ɭ o̞ ŋ
살리다	sʰ a̠ ʎ ʎ i d a̠
살며시	sʰ a̠ ɭ m j ʌ̹ ɕʰ i
살살	sʰ a̠ ɭ sʰ a̠ ɭ
살아오다	sʰ a̠ ɾ a̠ o̞ d a̠
살인자	sʰ a̠ ɾ i ɲ d͡ʑ a̠
살짝살짝	sʰ a̠ ʎ t͡ɕ͈ a̠ k s͈ a̠ ʎ t͡ɕ͈ a̠ k̚
살펴보다	sʰ a̠ ɭ pʰ j ʌ̹ b o̞ d a̠
살피다	sʰ a̠ ɭ pʰ i d a̠
삶다	sʰ a̠ː m t͈ a̠
삼겹살	sʰ a̠ m ɡ j ʌ̹ p s͈ a̠ ɭ
삼계탕	sʰ a̠ m ɡ j e̞ tʰ a̠ ŋ
삼국	sʰ a̠ m ɡ u k̚
삼나무	sʰ a̠ m n a̠ m u
삼다	sʰ a̠ː m t͈ a̠
삼루수	sʰ a̠ m n u sʰ u
삼림	sʰ a̠ m n i m
삼바	sʰ a̠ m b a̠
삼성	sʰ a̠ m sʰ ʌ̹ ŋ
삼수	sʰ a̠ m sʰ u
삼십	sʰ a̠ m ɕʰ i p̚
삼십육계	sʰ a̠ m ɕʰ i b j u k̚ k͈ j e̞
삼월	sʰ a̠ m w ʌ̹ ɭ
삼족	sʰ a̠ m d͡ʑ o̞ k̚
삼촌	sʰ a̠ m t͡ɕʰ o̞ n
삼춘	sʰ a̠ m t͡ɕʰ u n
삼한	sʰ a̠ m ɦ a̠ n
삽입	sʰ a̠ b i p̚
삽입곡	sʰ a̠ b i p̚ k͈ o̞ k̚
상념	sʰ a̠ː ŋ ɲ j ʌ̹ m
상놈	sʰ a̠ ŋ n o̞ m
상담	sʰ a̠ ŋ d a̠ m
상담하다	sʰ a̠ ŋ d a̠ m ɦ a̠ d a̠
상당	sʰ a̠ ŋ d a̠ ŋ
상당하다	sʰ a̠ ŋ d a̠ ŋ ɦ a̠ d a̠
상록수	sʰ a̠ ŋ n o̞ k s͈ u
상사병	sʰ a̠ ŋ sʰ a̠ p͈ j ʌ̹ ŋ
상상	sʰ a̠ː ŋ sʰ a̠ ŋ
상상력	sʰ a̠ː ŋ sʰ a̠ ŋ ɲ j ʌ̹ k̚
상성	sʰ a̠ː ŋ sʰ ʌ̹ ŋ
상세하다	sʰ a̠ ŋ sʰ e̞ ɦ a̠ d a̠
상속	sʰ a̠ ŋ sʰ o̞ k̚
상속인	sʰ a̠ ŋ sʰ o̞ ɡ i n
상식	sʰ a̠ ŋ ɕʰ i k̚
상아	sʰ a̠ ŋ a̠
상어	sʰ a̠ ŋ ʌ̹
상원	sʰ a̠ː ŋ w ʌ̹ n
상응	sʰ a̠ ŋ ɯ ŋ
상의	sʰ a̠ ŋ ɰ i
상이하다	sʰ a̠ ŋ i ɦ a̠ d a̠
상인	sʰ a̠ ŋ i n
상자	sʰ a̠ ŋ d͡ʑ a̠
상점	sʰ a̠ ŋ d͡ʑ ʌ̹ m
상처	sʰ a̠ ŋ t͡ɕʰ ʌ̹
상추	sʰ a̠ ŋ t͡ɕʰ u
상표	sʰ a̠ ŋ pʰ j o
상하이	sʰ a̠ ŋ ɦ a̠ i
상호	sʰ a̠ ŋ β o̞
상환되다	sʰ a̠ ŋ β w a̠ n d w e̞ d a̠
상황	sʰ a̠ ŋ β w a̠ ŋ
색시	sʰ ɛː k ɕ͈ i
샛별	sʰ ɛː t̚ p͈ j ʌ̹ ɭ
샤발	ɕʰ a̠ b a̠ ɭ
샤워	ɕʰ a̠ w ʌ̹
샴페인	ɕʰ a̠ m pʰ e̞ i n
샴푸	ɕʰ a̠ m pʰ u
샹들리에	ɕʰ a̠ ŋ d ɯ ʎ ʎ i e̞
서강	sʰ ʌ̹ ɡ a̠ ŋ
서거	sʰ ɘː ɡ ʌ̹
서고	sʰ ʌ̹ ɡ o̞
서구	sʰ ʌ̹ ɡ u
서귀포	sʰ ʌ̹ ɡ ɥ i pʰ o̞
서남	sʰ ʌ̹ n a̠ m
서넛	sʰ ʌ̹ n ʌ̹ t̚
서다	sʰ ʌ̹ d a̠
서당	sʰ ʌ̹ d a̠ ŋ
서두르다	sʰ ʌ̹ d u ɾ ɯ d a̠
서랍	sʰ ʌ̹ ɾ a̠ p̚
서럽다	sʰ ɘː ɾ ʌ̹ p̚ t͈ a̠
서로	sʰ ʌ̹ ɾ o̞
서른	sʰ ʌ̹ ɾ ɯ n
서리	sʰ ʌ̹ ɾ i
서명	sʰ ɘː m j ʌ̹ ŋ
서문	sʰ ɘː m u n
서민	sʰ ɘː m i n
서밋	sʰ ʌ̹ m i t̚
서방	sʰ ʌ̹ b a̠ ŋ
서벌	sʰ ʌ̹ b ʌ̹ ɭ
서법	sʰ ʌ̹ p͈ ʌ̹ p̚
서부	sʰ ʌ̹ b u
서비스	s͈ ʌ̹ b i sʰ ɯ
서뿐서뿐	sʰ ʌ̹ p͈ u n sʰ ʌ̹ p͈ u n
서서히	sʰ ɘː sʰ ʌ̹ ʝ i
서술	sʰ ɘː sʰ u ɭ
서술하다	sʰ ɘː sʰ u ɾ ɦ a̠ d a̠
서양	sʰ ʌ̹ j a̠ ŋ
서양인	sʰ ʌ̹ j a̠ ŋ i n
서양자두	sʰ ʌ̹ j a̠ ŋ d͡ʑ a̠ d u
서예	sʰ ʌ̹ j e̞
서원	sʰ ɘː w ʌ̹ n
서월	sʰ ʌ̹ w ʌ̹ ɭ
서장	sʰ ʌ̹ d͡ʑ a̠ ŋ
서점	sʰ ʌ̹ d͡ʑ ʌ̹ m
서쪽	sʰ ʌ̹ t͡ɕ͈ o̞ k̚
서체	sʰ ʌ̹ t͡ɕʰ e̞
서커스	sʰ ʌ̹ kʰ ʌ̹ sʰ ɯ
서클	s͈ ʌ̹ k x ɯ ɭ
서툴다	sʰ ɘː tʰ u ɭ d a̠
서표	sʰ ʌ̹ pʰ j o
서푼	sʰ ʌ̹ pʰ u n
석가모니	sʰ ʌ̹ k̚ k͈ a̠ m o̞ n i
석관	sʰ ʌ̹ k̚ k͈ w a̠ n
석류	sʰ ʌ̹ ŋ ɲ j u
석류석	sʰ ʌ̹ ŋ ɲ j u sʰ ʌ̹ k̚
석방	sʰ ʌ̹ k̚ p͈ a̠ ŋ
석순	sʰ ʌ̹ k s͈ u n
석유	sʰ ʌ̹ ɡ j u
석의	sʰ ʌ̹ ɡ ɰ i
석탄	sʰ ʌ̹ k̚ tʰ a̠ n
석탄산	sʰ ʌ̹ k̚ tʰ a̠ n sʰ a̠ n
섞다	sʰ ʌ̹ k̚ t͈ a̠
선거	sʰ ɘː n ɡ ʌ̹
선거인	sʰ ɘː n ɡ ʌ̹ i n
선거통	sʰ ɘː n ɡ ʌ̹ tʰ o̞ ŋ
선교	sʰ ʌ̹ n ɡ j o
선교사	sʰ ʌ̹ n ɡ j o sʰ a̠
선글라스	s͈ ʌ̹ n ɡ ɯ ɭ ɭ a̠ sʰ ɯ
선동하다	sʰ ʌ̹ n d o̞ ŋ ɦ a̠ d a̠
선렬	sʰ ʌ̹ ʎ ʎ j ʌ̹ ɭ
선로	sʰ ʌ̹ ɭ ɭ o̞
선물	sʰ ɘː n m u ɭ
선박	sʰ ʌ̹ n b a̠ k̚
선상	sʰ ʌ̹ n sʰ a̠ ŋ
선수	sʰ ɘː n sʰ u
선술집	sʰ ʌ̹ n sʰ u ʎ t͡ɕ͈ i p̚
선실	sʰ ʌ̹ n ɕʰ i ɭ
선언	sʰ ʌ̹ n ʌ̹ n
선우	sʰ ʌ̹ n u
선원	sʰ ʌ̹ n w ʌ̹ n
선율	sʰ ʌ̹ ɲ j u ɭ
선인장	sʰ ʌ̹ n i ɲ d͡ʑ a̠ ŋ
선장	sʰ ʌ̹ ɲ d͡ʑ a̠ ŋ
선지	sʰ ʌ̹ ɲ d͡ʑ i
선지자	sʰ ʌ̹ ɲ d͡ʑ i d͡ʑ a̠
선진국	sʰ ʌ̹ ɲ d͡ʑ i n ɡ u k̚
선착장	sʰ ʌ̹ ɲ t͡ɕʰ a̠ k̚ t͡ɕ͈ a̠ ŋ
선창	sʰ ʌ̹ ɲ t͡ɕʰ a̠ ŋ
선화	sʰ ʌ̹ n β w a̠
설거지하다	sʰ ʌ̹ ɭ ɡ ʌ̹ d͡ʑ i ɦ a̠ d a̠
설교	sʰ ʌ̹ ɭ ɡ j o
설교자	sʰ ʌ̹ ɭ ɡ j o d͡ʑ a̠
설날	sʰ ɘː ɭ ɭ a̠ ɭ
설더구하다	sʰ ʌ̹ ɭ d ʌ̹ ɡ u ɦ a̠ d a̠
설렁탕	sʰ ʌ̹ ɭ ɭ ʌ̹ ŋ tʰ a̠ ŋ
설레이다	sʰ ʌ̹ ɭ ɭ e̞ i d a̠
설립하다	sʰ ʌ̹ ʎ ʎ i pʰ a̠ d a̠
설마	sʰ ʌ̹ ɭ m a̠
설명하다	sʰ ʌ̹ ɭ m j ʌ̹ ŋ ɦ a̠ d a̠
설문	sʰ ʌ̹ ɭ m u n
설문지	sʰ ʌ̹ ɭ m u ɲ d͡ʑ i
설비	sʰ ʌ̹ ɭ b i
설사	sʰ ʌ̹ ɭ s͈ a̠
설산	sʰ ʌ̹ ɭ s͈ a̠ n
설설	sʰ ʌ̹ ɭ sʰ ʌ̹ ɭ
설정	sʰ ʌ̹ ʎ t͡ɕ͈ ʌ̹ ŋ
설치	sʰ ʌ̹ ʎ t͡ɕʰ i
설치다	sʰ ʌ̹ ʎ t͡ɕʰ i d a̠
설치류	sʰ ʌ̹ ʎ t͡ɕʰ i ɾ j u
설탕	sʰ ʌ̹ ɭ tʰ a̠ ŋ
설포닐기	sʰ ʌ̹ ɭ pʰ o̞ n i ɭ ɡ i
설폰	sʰ ʌ̹ ɭ pʰ o̞ n
설화	sʰ ʌ̹ ɾ β w a̠
섬네일	sʰ ʌ̹ m n e̞ i ɭ
섭씨	sʰ ʌ̹ p ɕ͈ i
성가	sʰ ɘː ŋ ɡ a̠
성격	sʰ ɘː ŋ k͈ j ʌ̹ k̚
성경	sʰ ɘː ŋ ɡ j ʌ̹ ŋ
성공	sʰ ʌ̹ ŋ ɡ o̞ ŋ
성과	sʰ ʌ̹ ŋ k͈ w a̠
성곽	sʰ ʌ̹ ŋ ɡ w a̠ k̚
성교	sʰ ɘː ŋ ɡ j o
성교하다	sʰ ɘː ŋ ɡ j o ɦ a̠ d a̠
성냥	sʰ ʌ̹ ŋ ɲ j a̠ ŋ
성당	sʰ ɘː ŋ d a̠ ŋ
성립	sʰ ʌ̹ ŋ n i p̚
성명	sʰ ɘː ŋ m j ʌ̹ ŋ
성문	sʰ ʌ̹ ŋ m u n
성별	sʰ ɘː ŋ b j ʌ̹ ɭ
성병	sʰ ɘː ŋ p͈ j ʌ̹ ŋ
성부	sʰ ɘː ŋ b u
성분	sʰ ʌ̹ ŋ b u n
성사	sʰ ɘː ŋ sʰ a̠
성상	sʰ ɘː ŋ sʰ a̠ ŋ
성스럽다	sʰ ɘː ŋ sʰ ɯ ɾ ʌ̹ p̚ t͈ a̠
성실	sʰ ʌ̹ ŋ ɕʰ i ɭ
성심	sʰ ʌ̹ ŋ ɕʰ i m
성씨	sʰ ɘː ŋ ɕ͈ i
성어	sʰ ʌ̹ ŋ ʌ̹
성욕	sʰ ɘː ŋ j o k̚
성우	sʰ ʌ̹ ŋ u
성운	sʰ ʌ̹ ŋ u n
성의	sʰ ʌ̹ ŋ ɰ i
성장하다	sʰ ʌ̹ ŋ d͡ʑ a̠ ŋ ɦ a̠ d a̠
성적표	sʰ ʌ̹ ŋ d͡ʑ ʌ̹ k̚ pʰ j o
성조	sʰ ʌ̹ ŋ d͡ʑ o̞
성지	sʰ ɘː ŋ d͡ʑ i
성질	sʰ ɘː ŋ d͡ʑ i ɭ
성차별	sʰ ɘː ŋ t͡ɕʰ a̠ b j ʌ̹ ɭ
성찬	sʰ ɘː ŋ t͡ɕʰ a̠ n
성취	sʰ ʌ̹ ŋ t͡ɕʰ ɥ i
성하	sʰ ɘː ŋ ɦ a̠
성함	sʰ ɘː ŋ ɦ a̠ m
세계	sʰ e̞ː ɡ j e̞
세계관	sʰ e̞ː ɡ j e̞ ɡ w a̠ n
세계적	sʰ e̞ː ɡ j e̞ d͡ʑ ʌ̹ k̚
세계평화	sʰ e̞ ɡ j e̞ pʰ j ʌ̹ ŋ β w a̠
세균	sʰ e̞ː ɡ j u n
세금	sʰ e̞ː ɡ ɯ m
세기	sʰ e̞ː ɡ i
세네갈	s͈ e̞ n e̞ ɡ a̠ ɭ
세뇌	sʰ e̞ː n w e̞
세력	sʰ e̞ː ɾ j ʌ̹ k̚
세례	sʰ e̞ː ɾ j e̞
세로	sʰ e̞ː ɾ o̞
세르비아	s͈ e̞ ɾ ɯ b i a̠
세모꼴	sʰ e̞ː m o̞ k͈ o̞ ɭ
세미나	sʰ e̞ m i n a̠
세미콜론	sʰ e̞ m i kʰ o̞ ɭ ɭ o̞ n
세상	sʰ e̞ː sʰ a̠ ŋ
세상에	sʰ e̞ː sʰ a̠ ŋ e̞
세수하다	sʰ e̞ː sʰ u ɦ a̠ d a̠
세요	sʰ e̞ j o
세우다	sʰ e̞ u d a̠
세워지다	sʰ e̞ w ʌ̹ d͡ʑ i d a̠
세일	s͈ e̞ i ɭ
세입자	sʰ e̞ː i p̚ t͡ɕ͈ a̠
세제	sʰ e̞ː d͡ʑ e̞
세종	sʰ e̞ː d͡ʑ o̞ ŋ
세차	sʰ e̞ː t͡ɕʰ a̠
세척	sʰ e̞ː t͡ɕʰ ʌ̹ k̚
세탁	sʰ e̞ː tʰ a̠ k̚
세탁기	sʰ e̞ː tʰ a̠ k̚ k͈ i
세탁하다	sʰ e̞ː tʰ a̠ kʰ a̠ d a̠
세트	sʰ e̞ tʰ ɯ
세포	sʰ e̞ː pʰ o̞
세포학	sʰ e̞ː pʰ o̞ ɦ a̠ k̚
섹션	sʰ e̞ k ɕ͈ ʌ̹ n
섹스	s͈ e̞ k s͈ ɯ
섹스하다	s͈ e̞ k s͈ ɯ ɦ a̠ d a̠
센터	s͈ e̞ n tʰ ʌ̹
센트	s͈ e̞ n tʰ ɯ
센티미터	s͈ e̞ n tʰ i m i tʰ ʌ̹
셀레늄	sʰ e̞ ɭ ɭ e̞ ɲ j u m
셀로판	sʰ e̞ ɭ ɭ o̞ pʰ a̠ n
셀카	s͈ e̞ ɭ kʰ a̠
셔벗	ɕʰ ʌ̹ b ʌ̹ t̚
셔츠	ɕʰ ʌ̹ t͡ɕʰ ɯ
셔터	ɕʰ ʌ̹ tʰ ʌ̹
소고기	sʰ o̞ ɡ o̞ ɡ i
소금	sʰ o̞ ɡ ɯ m
소나기	sʰ o̞ n a̠ ɡ i
소나무	sʰ o̞ n a̠ m u
소나타	sʰ o̞ n a̠ tʰ a̠
소낙비	sʰ o̞ n a̠ k̚ p͈ i
소녀	sʰ o̞ː ɲ j ʌ̹
소년	sʰ o̞ː ɲ j ʌ̹ n
소년궁전	sʰ o̞ː ɲ j ʌ̹ n ɡ u ŋ d͡ʑ ʌ̹ n
소독제	sʰ o̞ d o̞ k̚ t͡ɕ͈ e̞
소득	sʰ o̞ː d ɯ k̚
소련	sʰ o̞ ɾ j ʌ̹ n
소령	sʰ o̞ː ɾ j ʌ̹ ŋ
소리	sʰ o̞ ɾ i
소말리아	s͈ o̞ m a̠ ʎ ʎ i a̠
소멸	sʰ o̞ m j ʌ̹ ɭ
소모전	sʰ o̞ m o̞ d͡ʑ ʌ̹ n
소문	sʰ o̞ː m u n
소방관	sʰ o̞ b a̠ ŋ ɡ w a̠ n
소방서	sʰ o̞ b a̠ ŋ sʰ ʌ̹
소방수	sʰ o̞ b a̠ ŋ sʰ u
소방차	sʰ o̞ b a̠ ŋ t͡ɕʰ a̠
소변	sʰ o̞ː b j ʌ̹ n
소비에트	sʰ o̞ b i e̞ tʰ ɯ
소비자	sʰ o̞ b i d͡ʑ a̠
소비하다	sʰ o̞ b i ɦ a̠ d a̠
소속	sʰ o̞ː sʰ o̞ k̚
소송	sʰ o̞ sʰ o̞ ŋ
소수민족	sʰ o̞ː sʰ u m i ɲ d͡ʑ o̞ k̚
소스	sʰ o̞ sʰ ɯ
소시지	s͈ o̞ ɕʰ i d͡ʑ i
소식	sʰ o̞ ɕʰ i k̚
소용	sʰ o̞ː j o ŋ
소용돌이	sʰ o̞ j o ŋ d o̞ ɾ i
소위	sʰ o̞ː ɥ i
소유	sʰ o̞ː j u
소유자	sʰ o̞ː j u d͡ʑ a̠
소유하다	sʰ o̞ː j u ɦ a̠ d a̠
소음	sʰ o̞ ɯ m
소음순	sʰ o̞ː ɯ m sʰ u n
소제	sʰ o̞ː d͡ʑ e̞
소주	s͈ o̞ d͡ʑ u
소중화	sʰ o̞ː d͡ʑ u ŋ β w a̠
소지품	sʰ o̞ː d͡ʑ i pʰ u m
소파	s͈ o̞ pʰ a̠
소포	sʰ o̞ː pʰ o̞
소품	sʰ o̞ː pʰ u m
소풍	sʰ o̞ pʰ u ŋ
소프트볼	sʰ o̞ pʰ ɯ tʰ ɯ b o̞ ɭ
소피아	sʰ o̞ pʰ i a̠
소형	sʰ o̞ː ʝ j ʌ̹ ŋ
소화	sʰ o̞ β w a̠
소화기	sʰ o̞ β w a̠ ɡ i
소환	sʰ o̞ β w a̠ n
속견	sʰ o̞ k̚ k͈ j ʌ̹ n
속눈썹	sʰ o̞ː ŋ n u n s͈ ʌ̹ p̚
속담	sʰ o̞ k̚ t͈ a̠ m
속도	sʰ o̞ k̚ t͈ o̞
속삭임	sʰ o̞ k s͈ a̠ ɡ i m
속세	sʰ o̞ k s͈ e̞
속속	sʰ o̞ k s͈ o̞ k̚
속속들이	sʰ o̞ k s͈ o̞ k̚ t͈ ɯ ɾ i
속쓰림	sʰ o̞ː k s͈ ɯ ɾ i m
속어	sʰ o̞ ɡ ʌ̹
속옷	sʰ o̞ː ɡ o̞ t̚
속이다	sʰ o̞ ɡ i d a̠
속자	sʰ o̞ k̚ t͡ɕ͈ a̠
손가락	sʰ o̞ n k͈ a̠ ɾ a̠ k̚
손가락질	sʰ o̞ n ɡ a̠ ɾ a̠ k̚ t͡ɕ͈ i ɭ
손가방	sʰ o̞ n ɡ a̠ b a̠ ŋ
손녀	sʰ o̞ n ɲ j ʌ̹
손님	sʰ o̞ n n i m
손바닥	sʰ o̞ n p͈ a̠ d a̠ k̚
손뼉	sʰ o̞ n p͈ j ʌ̹ k̚
손상	sʰ o̞ː n sʰ a̠ ŋ
손상하다	sʰ o̞ː n sʰ a̠ ŋ ɦ a̠ d a̠
손수건	sʰ o̞ n s͈ u ɡ ʌ̹ n
손아귀	sʰ o̞ː n a̠ ɡ ɥ i
손자	sʰ o̞ ɲ d͡ʑ a̠
손전등	sʰ o̞ ɲ t͡ɕ͈ ʌ̹ n d ɯ ŋ
손전화	sʰ o̞ ɲ d͡ʑ ʌ̹ n β w a̠
손주	sʰ o̞ ɲ d͡ʑ u
손질	sʰ o̞ ɲ d͡ʑ i ɭ
손톱	sʰ o̞ n tʰ o̞ p̚
솔까말	sʰ o̞ ɭ k͈ a̠ m a̠ ɭ
솔로몬	sʰ o̞ ɭ ɭ o̞ m o̞ n
솔선수범	sʰ o̞ ɭ s͈ ʌ̹ n sʰ u b ʌ̹ m
솔직하다	sʰ o̞ ʎ t͡ɕ͈ i kʰ a̠ d a̠
솔크	s͈ o̞ ɭ k x ɯ
솜사탕	sʰ o̞ m sʰ a̠ tʰ a̠ ŋ
솜씨	sʰ o̞ m ɕ͈ i
솜털	sʰ o̞ m tʰ ʌ̹ ɭ
송과선	sʰ o̞ ŋ ɡ w a̠ sʰ ʌ̹ n
송구	sʰ o̞ː ŋ ɡ u
송년회	sʰ o̞ː ŋ ɲ j ʌ̹ n β w e̞
송도	sʰ o̞ ŋ d o̞
송림	sʰ o̞ ŋ n i m
송사리	sʰ o̞ː ŋ sʰ a̠ ɾ i
송어	sʰ o̞ ŋ ʌ̹
송이	sʰ o̞ ŋ i
송이송이	sʰ o̞ ŋ i sʰ o̞ ŋ i
송편	sʰ o̞ ŋ pʰ j ʌ̹ n
쇠가마우지	sʰ w e̞ ɡ a̠ m a̠ u d͡ʑ i
쇠고기	sʰ w e̞ ɡ o̞ ɡ i
쇠기러기	sʰ w e̞ ɡ i ɾ ʌ̹ ɡ i
쇠붙이	sʰ w e̞ b u t͡ɕʰ i
쇠풀	sʰ w e̞ pʰ u ɭ
쇳돌	sʰ w e̞ t̚ t͈ o̞ ɭ
쇼룸	ɕʰ o ɾ u m
쇼츠	ɕʰ o t͡ɕʰ ɯ
쇼케이스	ɕʰ o kʰ e̞ i sʰ ɯ
쇼크	ɕʰ o k x ɯ
쇼트닝	ɕʰ o tʰ ɯ n i ŋ
수간	sʰ u ɡ a̠ n
수갑	sʰ u ɡ a̠ p̚
수고	sʰ uː ɡ o̞
수괴	sʰ u ɡ w e̞
수납장	sʰ u n a̠ p̚ t͡ɕ͈ a̠ ŋ
수녀	sʰ u ɲ j ʌ̹
수능	sʰ u n ɯ ŋ
수다	sʰ uː d a̠
수달	sʰ u d a̠ ɭ
수도	sʰ u d o̞
수도권	sʰ u d o̞ k͈ w ʌ̹ n
수도꼭지	sʰ u d o̞ k͈ o̞ k̚ t͡ɕ͈ i
수도사	sʰ u d o̞ sʰ a̠
수도원	sʰ u d o̞ w ʌ̹ n
수라	sʰ u ɾ a̠
수량	sʰ uː ɾ j a̠ ŋ
수레	sʰ u ɾ e̞
수력	sʰ u ɾ j ʌ̹ k̚
수련	sʰ u ɾ j ʌ̹ n
수렴	sʰ u ɾ j ʌ̹ m
수로	sʰ u ɾ o̞
수록	sʰ u ɾ o̞ k̚
수류탄	sʰ u ɾ j u tʰ a̠ n
수리남	sʰ u ɾ i n a̠ m
수말	sʰ u m a̠ ɭ
수면제	sʰ u m j ʌ̹ ɲ d͡ʑ e̞
수명	sʰ u m j ʌ̹ ŋ
수문학	sʰ u m u n ɦ a̠ k̚
수바	sʰ u b a̠
수박	sʰ uː b a̠ k̚
수법	sʰ u p͈ ʌ̹ p̚
수병	sʰ u b j ʌ̹ ŋ
수사학	sʰ u sʰ a̠ ɦ a̠ k̚
수산	sʰ u sʰ a̠ n
수상	sʰ u sʰ a̠ ŋ
수상하다	sʰ u sʰ a̠ ŋ ɦ a̠ d a̠
수서	sʰ u sʰ ʌ̹
수석	sʰ u sʰ ʌ̹ k̚
수선	sʰ u sʰ ʌ̹ n
수성	sʰ u sʰ ʌ̹ ŋ
수소	sʰ u sʰ o̞
수소폭탄	sʰ u sʰ o̞ pʰ o̞ k̚ tʰ a̠ n
수송	sʰ u sʰ o̞ ŋ
수수	sʰ u sʰ u
수수께끼	sʰ u sʰ u k͈ e̞ k͈ i
수수미꾸리	sʰ u sʰ u m i k͈ u ɾ i
수술	sʰ u sʰ u ɭ
수습	sʰ u sʰ ɯ p̚
수시로	sʰ u ɕʰ i ɾ o̞
수식어	sʰ u ɕʰ i ɡ ʌ̹
수심	sʰ u ɕʰ i m
수십	sʰ uː ɕʰ i p̚
수염	sʰ u j ʌ̹ m
수염수리	sʰ u j ʌ̹ m sʰ u ɾ i
수영	sʰ u j ʌ̹ ŋ
수영복	sʰ u j ʌ̹ ŋ b o̞ k̚
수영장	sʰ u j ʌ̹ ŋ d͡ʑ a̠ ŋ
수요	sʰ u j o
수요일	sʰ u j o i ɭ
수원	sʰ u w ʌ̹ n
수은	sʰ u ɯ n
수음하다	sʰ u ɯ m ɦ a̠ d a̠
수의사	sʰ u ɰ i sʰ a̠
수입	sʰ u i p̚
수저	sʰ u d͡ʑ ʌ̹
수적	sʰ uː t͡ɕ͈ ʌ̹ k̚
수전	sʰ u d͡ʑ ʌ̹ n
수정란	sʰ u d͡ʑ ʌ̹ ŋ n a̠ n
수정체	sʰ u d͡ʑ ʌ̹ ŋ t͡ɕʰ e̞
수조	sʰ u d͡ʑ o̞
수족관	sʰ u d͡ʑ o̞ k̚ k͈ w a̠ n
수준	sʰ u d͡ʑ u n
수줍다	sʰ u d͡ʑ u p̚ t͈ a̠
수질	sʰ u d͡ʑ i ɭ
수집하다	sʰ u d͡ʑ i pʰ a̠ d a̠
수축	sʰ u t͡ɕʰ u k̚
수출	sʰ u t͡ɕʰ u ɭ
수출품	sʰ u t͡ɕʰ u ɭ pʰ u m
수치	sʰ u t͡ɕʰ i
수칙	sʰ u t͡ɕʰ i k̚
수컷	sʰ u kʰ ʌ̹ t̚
수평	sʰ u pʰ j ʌ̹ ŋ
수평선	sʰ u pʰ j ʌ̹ ŋ sʰ ʌ̹ n
수포자	sʰ uː pʰ o̞ d͡ʑ a̠
수표	sʰ u pʰ j o
수프	sʰ u pʰ ɯ
수필	sʰ u pʰ i ɭ
수학자	sʰ uː ɦ a̠ k̚ t͡ɕ͈ a̠
수호	sʰ u β o̞
수호신	sʰ u β o̞ ɕʰ i n
수화	sʰ u β w a̠
수화기	sʰ u β w a̠ ɡ i
숙답	sʰ u k̚ t͈ a̠ p̚
숙명	sʰ u ŋ m j ʌ̹ ŋ
숙어	sʰ u ɡ ʌ̹
숙제	sʰ u k̚ t͡ɕ͈ e̞
숙주나물	sʰ u k̚ t͡ɕ͈ u n a̠ m u ɭ
순간	sʰ u n ɡ a̠ n
순결	sʰ u n ɡ j ʌ̹ ɭ
순교	sʰ u n ɡ j o
순교자	sʰ u n ɡ j o d͡ʑ a̠
순두부	sʰ u n d u b u
순례	sʰ u ʎ ʎ j e̞
순박	sʰ u n b a̠ k̚
순박하다	sʰ u n b a̠ kʰ a̠ d a̠
순서	sʰ uː n sʰ ʌ̹
순수	sʰ u n sʰ u
순수하다	sʰ u n sʰ u ɦ a̠ d a̠
순양함	sʰ u ɲ j a̠ ŋ ɦ a̠ m
순천	sʰ uː ɲ t͡ɕʰ ʌ̹ n
순회심판소	sʰ u n β w e̞ ɕʰ i m pʰ a̠ n sʰ o̞
순흥	sʰ u n ɣ ɯ ŋ
숟가락	sʰ u t̚ k͈ a̠ ɾ a̠ k̚
술독	sʰ u ɭ d o̞ k̚
술병	sʰ u ɭ p͈ j ʌ̹ ŋ
술어	sʰ u ɾ ʌ̹
술집	sʰ u ʎ t͡ɕ͈ i p̚
숨기다	sʰ u m ɡ i d a̠
숨쉬다	sʰ u m ʃʰ ɥ i d a̠
숨통	sʰ u m tʰ o̞ ŋ
숫자	sʰ uː t̚ t͡ɕ͈ a̠
숭늉	sʰ u ŋ ɲ j u ŋ
숭어	sʰ uː ŋ ʌ̹
쉬다	ʃʰ ɥ iː d a̠
쉽게	ʃʰ ɥ i p̚ k͈ e̞
쉽다	ʃʰ ɥ iː p̚ t͈ a̠
슈크림	ɕʰ u k x ɯ ɾ i m
슈퍼마켓	ɕʰ u pʰ ʌ̹ m a̠ kʰ e̞ t̚
스노보드	sʰ ɯ n o̞ b o̞ d ɯ
스님	sʰ ɯ n i m
스도쿠	sʰ ɯ d o̞ kʰ u
스라소니	sʰ ɯ ɾ a̠ sʰ o̞ n i
스럽다	sʰ ɯ ɾ ʌ̹ p̚ t͈ a̠
스르르	sʰ ɯ ɾ ɯ ɾ ɯ
스리랑카	sʰ ɯ ɾ i ɾ a̠ ŋ kʰ a̠
스마트폰	sʰ ɯ m a̠ tʰ ɯ pʰ o̞ n
스며들다	sʰ ɯ m j ʌ̹ d ɯ ɭ d a̠
스모	s͈ ɯ m o̞
스모그	sʰ ɯ m o̞ ɡ ɯ
스몰렌스크	sʰ ɯ m o̞ ɭ ɭ e̞ n sʰ ɯ k x ɯ
스무니다	sʰ ɯ m u n i d a̠
스스로	sʰ ɯ sʰ ɯ ɾ o̞
스스이	sʰ ɯ sʰ ɯ i
스승	sʰ ɯ sʰ ɯ ŋ
스시	sʰ ɯ ɕʰ i
스시국	sʰ ɯ ɕʰ i ɡ u k̚
스웨덴	sʰ ɯ w e̞ d e̞ n
스웨리예	sʰ ɯ w e̞ ɾ i j e̞
스웨터	sʰ ɯ w e̞ tʰ ʌ̹
스위스	sʰ ɯ ɥ i sʰ ɯ
스위치	sʰ ɯ ɥ i t͡ɕʰ i
스카이	sʰ ɯ kʰ a̠ i
스카프	sʰ ɯ kʰ a̠ pʰ ɯ
스커트	sʰ ɯ kʰ ʌ̹ tʰ ɯ
스컹크	sʰ ɯ kʰ ʌ̹ ŋ k x ɯ
스케이트	sʰ ɯ kʰ e̞ i tʰ ɯ
스케이트보드	sʰ ɯ kʰ e̞ i tʰ ɯ b o̞ d ɯ
스케줄	sʰ ɯ kʰ e̞ d͡ʑ u ɭ
스쿠터	sʰ ɯ kʰ u tʰ ʌ̹
스쿼시	sʰ ɯ kʰ w ʌ̹ ɕʰ i
스크린	sʰ ɯ k x ɯ ɾ i n
스타	sʰ ɯ tʰ a̠
스타디움	sʰ ɯ tʰ a̠ d i u m
스타벅스	sʰ ɯ tʰ a̠ b ʌ̹ k s͈ ɯ
스타일	sʰ ɯ tʰ a̠ i ɭ
스테아린	sʰ ɯ tʰ e̞ a̠ ɾ i n
스테이크	sʰ ɯ tʰ e̞ i k x ɯ
스테이플러	sʰ ɯ tʰ e̞ i pʰ ɯ ɭ ɭ ʌ̹
스텝	sʰ ɯ tʰ e̞ p̚
스토브	sʰ ɯ tʰ o̞ b ɯ
스톤헨지	sʰ ɯ tʰ o̞ n ɦ e̞ ɲ d͡ʑ i
스튜디오	s͈ ɯ tʰ j u d i o̞
스튜어디스	sʰ ɯ tʰ j u ʌ̹ d i sʰ ɯ
스트레스	sʰ ɯ tʰ ɯ ɾ e̞ s͈ ɯ
스트레이트	sʰ ɯ tʰ ɯ ɾ e̞ i tʰ ɯ
스트로	sʰ ɯ tʰ ɯ ɾ o̞
스트론튬	sʰ ɯ tʰ ɯ ɾ o̞ n tʰ j u m
스트리크닌	sʰ ɯ tʰ ɯ ɾ i k x ɯ n i n
스티커	sʰ ɯ tʰ i kʰ ʌ̹
스파게티	sʰ ɯ pʰ a̠ ɡ e̞ tʰ i
스파이	sʰ ɯ pʰ a̠ i
스파이웨어	sʰ ɯ pʰ a̠ i w e̞ ʌ̹
스펀지	sʰ ɯ pʰ ʌ̹ ɲ d͡ʑ i
스페인	sʰ ɯ pʰ e̞ i n
스페인어	sʰ ɯ pʰ e̞ i n ʌ̹
스펙트럼	sʰ ɯ pʰ e̞ k̚ tʰ ɯ ɾ ʌ̹ m
스포일러	s͈ ɯ pʰ o̞ i ɭ ɭ ʌ̹
스포츠	sʰ ɯ pʰ o̞ t͡ɕʰ ɯ
스푸트니크	sʰ ɯ pʰ u tʰ ɯ n i k x ɯ
스푼	sʰ ɯ pʰ u n
스프링클러	sʰ ɯ pʰ ɯ ɾ i ŋ k x ɯ ɭ ɭ ʌ̹
스피커	s͈ ɯ pʰ i kʰ ʌ̹
슬금슬금	sʰ ɯ ɭ ɡ ɯ m sʰ ɯ ɭ ɡ ɯ m
슬기	sʰ ɯ ɭ ɡ i
슬라브	sʰ ɯ ɭ ɭ a̠ b ɯ
슬로건	s͈ ɯ ɭ ɭ o̞ ɡ ʌ̹ n
슬로베니아	sʰ ɯ ɭ ɭ o̞ b e̞ n i a̠
슬로베니아어	sʰ ɯ ɭ ɭ o̞ b e̞ n i a̠ ʌ̹
슬로벤스꼬	sʰ ɯ ɭ ɭ o̞ b e̞ n sʰ ɯ k͈ o̞
슬리퍼	sʰ ɯ ʎ ʎ i pʰ ʌ̹
슬며시	sʰ ɯ ɭ m j ʌ̹ ɕʰ i
슬쩍슬쩍	sʰ ɯ ʎ t͡ɕ͈ ʌ̹ k s͈ ɯ ʎ t͡ɕ͈ ʌ̹ k̚
슬프다	sʰ ɯ ɭ pʰ ɯ d a̠
슬픔	sʰ ɯ ɭ pʰ ɯ m
습격	sʰ ɯ p̚ k͈ j ʌ̹ k̚
습기	sʰ ɯ p̚ k͈ i
습니까	s͈ ɯ m n i k͈ a̠
습니다	s͈ ɯ m n i d a̠
습도	sʰ ɯ p̚ t͈ o̞
습득	sʰ ɯ p̚ t͈ ɯ k̚
승강기	sʰ ɯ ŋ ɡ a̠ ŋ ɡ i
승계	sʰ ɯ ŋ ɡ j e̞
승냥이	sʰ ɯ ŋ ɲ j a̠ ŋ i
승려	sʰ ɯ ŋ ɲ j ʌ̹
승리	sʰ ɯ ŋ n i
승무원	sʰ ɯ ŋ m u w ʌ̹ n
승부	sʰ ɯ ŋ b u
승진	sʰ ɯ ŋ d͡ʑ i n
승하하다	sʰ ɯ ŋ ɦ a̠ ɦ a̠ d a̠
승화	sʰ ɯ ŋ β w a̠
시가	ɕʰ i ɡ a̠
시가전차	ɕʰ i ɡ a̠ d͡ʑ ʌ̹ ɲ t͡ɕʰ a̠
시간표	ɕʰ i ɡ a̠ n pʰ j o
시계	ɕʰ iː ɡ j e̞
시골	ɕʰ i ɡ o̞ ɭ
시궁쥐	ɕʰ i ɡ u ŋ d͡ʑ ɥ i
시금치	ɕʰ i ɡ ɯ m t͡ɕʰ i
시꺼멓다	ɕʰ i k͈ ʌ̹ m ʌ̹ tʰ a̠
시끄럽다	ɕʰ i k͈ ɯ ɾ ʌ̹ p̚ t͈ a̠
시나브로	ɕʰ i n a̠ b ɯ ɾ o̞
시누이	ɕʰ i n u i
시다	ɕʰ i d a̠
시도	ɕʰ iː d o̞
시도하다	ɕʰ iː d o̞ ɦ a̠ d a̠
시드니	ɕʰ i d ɯ n i
시디	ɕʰ i d i
시럽	ɕʰ i ɾ ʌ̹ p̚
시력	ɕʰ iː ɾ j ʌ̹ k̚
시루	ɕʰ i ɾ u
시름	ɕʰ i ɾ ɯ m
시리다	ɕʰ i ɾ i d a̠
시물	ɕʰ i m u ɭ
시민	ɕʰ iː m i n
시방	ɕʰ i b a̠ ŋ
시베리아	ɕʰ i b e̞ ɾ i a̠
시보	ɕʰ i b o̞
시부모	ɕʰ i b u m o̞
시비	ɕʰ i b i
시상	ɕʰ iː sʰ a̠ ŋ
시상하부	ɕʰ iː sʰ a̠ ŋ h a̠ b u
시선	ɕʰ iː sʰ ʌ̹ n
시스터	ɕʰ i sʰ ɯ tʰ ʌ̹
시스템	ɕ͈ i sʰ ɯ tʰ e̞ m
시심마	ɕʰ iː ɕʰ i m m a̠
시아버지	ɕʰ i a̠ b ʌ̹ d͡ʑ i
시어머니	ɕʰ i ʌ̹ m ʌ̹ n i
시에라리온	ɕ͈ i e̞ ɾ a̠ ɾ i o̞ n
시원하다	ɕʰ i w ʌ̹ n ɦ a̠ d a̠
시위	ɕʰ iː ɥ i
시읏	ɕʰ i ɯ t̚
시작되다	ɕʰ iː d͡ʑ a̠ k̚ t͈ w e̞ d a̠
시작하다	ɕʰ iː d͡ʑ a̠ kʰ a̠ d a̠
시장하시다	ɕʰ i d͡ʑ a̠ ŋ ɦ a̠ ɕʰ i d a̠
시절	ɕʰ i d͡ʑ ʌ̹ ɭ
시제	ɕʰ i d͡ʑ e̞
시주	ɕʰ iː d͡ʑ u
시중	ɕʰ iː d͡ʑ u ŋ
시즌	ɕʰ i d͡ʑ ɯ n
시짱	ɕʰ i t͡ɕ͈ a̠ ŋ
시찰	ɕʰ i t͡ɕʰ a̠ ɭ
시청	ɕʰ iː t͡ɕʰ ʌ̹ ŋ
시청자	ɕʰ iː t͡ɕʰ ʌ̹ ŋ d͡ʑ a̠
시체	ɕʰ iː t͡ɕʰ e̞
시치미	ɕʰ i t͡ɕʰ i m i
시카고	ɕʰ i kʰ a̠ ɡ o̞
시토회	ɕʰ i tʰ o̞ β w e̞
시편	ɕʰ i pʰ j ʌ̹ n
시합	ɕʰ i ɦ a̠ p̚
시험	ɕʰ i ɦ ʌ̹ m
시험하다	ɕʰ i ɦ ʌ̹ m ɦ a̠ d a̠
식구	ɕʰ i k̚ k͈ u
식기세척기	ɕʰ i k̚ k͈ i sʰ e̞ t͡ɕʰ ʌ̹ k̚ k͈ i
식량	ɕʰ i ŋ ɲ j a̠ ŋ
식료품	ɕʰ i ŋ ɲ j o pʰ u m
식료품점	ɕʰ i ŋ ɲ j o pʰ u m d͡ʑ ʌ̹ m
식물	ɕʰ i ŋ m u ɭ
식물학	ɕʰ i ŋ m u ɾ ɦ a̠ k̚
식민지	ɕʰ i ŋ m i ɲ d͡ʑ i
식빵	ɕʰ i k̚ p͈ a̠ ŋ
식사	ɕʰ i k s͈ a̠
식욕	ɕʰ i ɡ j o k̚
식용유	ɕʰ i ɡ j o ŋ ɲ j u
식자	ɕʰ i k̚ t͡ɕ͈ a̠
식전	ɕʰ i k̚ t͡ɕ͈ ʌ̹ n
식중독	ɕʰ i k̚ t͡ɕ͈ u ŋ d o̞ k̚
식초	ɕʰ i k̚ t͡ɕʰ o̞
식탁	ɕʰ i k̚ tʰ a̠ k̚
식품	ɕʰ i k̚ pʰ u m
식품보존료	ɕʰ i k̚ pʰ u m b o̞ d͡ʑ o̞ ʎ ʎ j o
신경전달물질	ɕʰ i n ɡ j ʌ̹ ŋ d͡ʑ ʌ̹ n d a̠ ɭ m u ʎ t͡ɕ͈ i ɭ
신곡	ɕʰ i n ɡ o̞ k̚
신교도	ɕʰ i n ɡ j o d o̞
신규	ɕʰ i n ɡ j u
신기	ɕʰ i n ɡ i
신기루	ɕʰ iː n ɡ i ɾ u
신기하다	ɕʰ iː n ɡ i ɦ a̠ d a̠
신념	ɕʰ iː n ɲ j ʌ̹ m
신다	ɕʰ iː n t͈ a̠
신도	ɕʰ i n d o̞
신라	ɕʰ i ɭ ɭ a̠
신랑	ɕʰ i ɭ ɭ a̠ ŋ
신뢰	ɕʰ iː ɭ ɭ w e̞
신문	ɕʰ i n m u n
신미	ɕʰ i n m i
신발	ɕʰ i n b a̠ ɭ
신부	ɕʰ i n b u
신부님	ɕʰ i n b u n i m
신분	ɕʰ i n b u n
신비	ɕʰ i n b i
신사	ɕʰ iː n sʰ a̠
신선	ɕʰ i n sʰ ʌ̹ n
신선하다	ɕʰ i n sʰ ʌ̹ n ɦ a̠ d a̠
신성	ɕʰ i n sʰ ʌ̹ ŋ
신세계	ɕʰ i n sʰ e̞ ɡ j e̞
신속	ɕʰ iː n sʰ o̞ k̚
신수	ɕʰ i n sʰ u
신시사이저	ɕʰ i n ɕʰ i sʰ a̠ i d͡ʑ ʌ̹
신시아	ɕʰ i n ɕʰ i a̠
신앙	ɕʰ iː n a̠ ŋ
신용	ɕʰ iː ɲ j o ŋ
신의주	ɕʰ i n ɰ i d͡ʑ u
신임	ɕʰ iː n i m
신임하다	ɕʰ iː n i m ɦ a̠ d a̠
신자	ɕʰ iː ɲ d͡ʑ a̠
신장위	ɕʰ i ɲ d͡ʑ a̠ ŋ ɥ i
신조어	ɕʰ i ɲ d͡ʑ o̞ ʌ̹
신종	ɕʰ iː ɲ d͡ʑ o̞ ŋ
신주	ɕʰ i ɲ d͡ʑ u
신중하다	ɕʰ iː ɲ d͡ʑ u ŋ ɦ a̠ d a̠
신청	ɕʰ i ɲ t͡ɕʰ ʌ̹ ŋ
신청자	ɕʰ i ɲ t͡ɕʰ ʌ̹ ŋ d͡ʑ a̠
신체	ɕʰ i ɲ t͡ɕʰ e̞
신칸센	ɕʰ i n kʰ a̠ n sʰ e̞ n
신탁통치	ɕʰ i n tʰ a̠ k̚ tʰ o̞ ŋ t͡ɕʰ i
신학	ɕʰ i n ɦ a̠ k̚
신형	ɕʰ iː n ʝ j ʌ̹ ŋ
신형코로나비루스감염증	ɕʰ i n ʝ j ʌ̹ ŋ kʰ o̞ ɾ o̞ n a̠ b i ɾ u sʰ ɯ ɡ a̠ m j ʌ̹ m d͡ʑ ɯ ŋ
신호	ɕʰ iː n β o̞
신호등	ɕʰ iː n β o̞ d ɯ ŋ
신호총	ɕʰ i n β o̞ t͡ɕʰ o̞ ŋ
신화	ɕʰ i n β w a̠
실력	ɕʰ i ʎ ʎ j ʌ̹ k̚
실례	ɕʰ i ʎ ʎ j e̞
실로	ɕʰ i ɭ ɭ o̞
실로폰	ɕʰ i ɭ ɭ o̞ pʰ o̞ n
실록	ɕʰ i ɭ ɭ o̞ k̚
실마리	ɕʰ iː ɭ m a̠ ɾ i
실망	ɕʰ i ɭ m a̠ ŋ
실망하다	ɕʰ i ɭ m a̠ ŋ ɦ a̠ d a̠
실명	ɕʰ i ɭ m j ʌ̹ ŋ
실수	ɕʰ i ɭ s͈ u
실습	ɕʰ i ɭ s͈ ɯ p̚
실시	ɕʰ i ɭ ɕ͈ i
실업	ɕʰ i ɾ ʌ̹ p̚
실업가	ɕʰ i ɾ ʌ̹ p̚ k͈ a̠
실장	ɕʰ i ʎ t͡ɕ͈ a̠ ŋ
실정	ɕʰ i ʎ t͡ɕ͈ ʌ̹ ŋ
실제	ɕʰ i ʎ t͡ɕ͈ e̞
실제로	ɕʰ i ʎ t͡ɕ͈ e̞ ɾ o̞
실존주의	ɕʰ i ʎ t͡ɕ͈ o̞ ɲ d͡ʑ u ɰ i
실천	ɕʰ i ʎ t͡ɕʰ ʌ̹ n
실체	ɕʰ i ʎ t͡ɕʰ e̞
실컷	ɕʰ i ɭ kʰ ʌ̹ t̚
실험	ɕʰ i ɾ ɦ ʌ̹ m
실현	ɕʰ i ɾ ʝ j ʌ̹ n
싫다	ɕʰ i ɭ tʰ a̠
싫어하다	ɕʰ i ɾ ʌ̹ ɦ a̠ d a̠
심각하다	ɕʰ iː m ɡ a̠ kʰ a̠ d a̠
심다	ɕʰ iː m t͈ a̠
심란하다	ɕʰ i m n a̠ n ɦ a̠ d a̠
심리학	ɕʰ i m n i ɦ a̠ k̚
심마니	ɕʰ i m m a̠ n i
심마니말	ɕʰ i m m a̠ n i m a̠ ɭ
심부름	ɕʰ iː m b u ɾ ɯ m
심사	ɕʰ i m sʰ a̠
심사숙고	ɕʰ iː m sʰ a̠ sʰ u k̚ k͈ o̞
심성	ɕʰ i m sʰ ʌ̹ ŋ
심심하다	ɕʰ i m ɕʰ i m ɦ a̠ d a̠
심정	ɕʰ i m d͡ʑ ʌ̹ ŋ
심지	ɕʰ i m d͡ʑ i
심포지엄	ɕʰ i m pʰ o̞ d͡ʑ i ʌ̹ m
십삼	ɕʰ i p s͈ a̠ m
십오	ɕʰ i b o̞
십이	ɕʰ i b i
십일월	ɕʰ i b i ɾ w ʌ̹ ɭ
십자	ɕʰ i p̚ t͡ɕ͈ a̠
십자가	ɕʰ i p̚ t͡ɕ͈ a̠ ɡ a̠
싱가포르	ɕʰ i ŋ ɡ a̠ pʰ o̞ ɾ ɯ
싱글싱글	ɕʰ i ŋ ɡ ɯ ɭ ɕʰ i ŋ ɡ ɯ ɭ
싶다	ɕʰ i p̚ t͈ a̠
싸다	s͈ a̠ d a̠
싸리	s͈ a̠ ɾ i
싸우다	s͈ a̠ u d a̠
쌀국수	s͈ a̠ ɭ ɡ u k s͈ u
쌀미꾸리	s͈ a̠ ɭ m i k͈ u ɾ i
쌀밥	s͈ a̠ ɭ b a̠ p̚
쌀쌀	s͈ a̠ ɭ s͈ a̠ ɭ
쌀쌀하다	s͈ a̠ ɭ s͈ a̠ ɾ ɦ a̠ d a̠
쌀쌀히	s͈ a̠ ɭ s͈ a̠ ɾ ʝ i
쌍꺼풀	s͈ a̠ ŋ k͈ ʌ̹ pʰ u ɭ
쌍둥이	s͈ a̠ ŋ d u ŋ i
쌍디귿	s͈ a̠ ŋ d i ɡ ɯ t̚
쌍안경	s͈ a̠ ŋ a̠ n ɡ j ʌ̹ ŋ
쌓다	s͈ a̠ tʰ a̠
써리다	s͈ ɘː ɾ i d a̠
써우지	s͈ ʌ̹ u d͡ʑ i
쎈터	s͈ e̞ n tʰ ʌ̹
쏘가리	s͈ o̞ ɡ a̠ ɾ i
쏘다	s͈ o̞ː d a̠
쏜살같이	s͈ o̞ n sʰ a̠ ɭ ɡ a̠ t͡ɕʰ i
쏟아지다	s͈ o̞ d a̠ d͡ʑ i d a̠
쐐기	s͈ w ɛː ɡ i
쐬다	s͈ w e̞ː d a̠
쑤시다	s͈ u ɕʰ i d a̠
쑥갓	s͈ u k̚ k͈ a̠ t̚
쓰다	s͈ ɯ d a̠
쓰다듬다	s͈ ɯ d a̠ d ɯ m t͈ a̠
쓰딸로바야	s͈ ɯ t͈ a̠ ɭ ɭ o̞ b a̠ j a̠
쓰러지다	s͈ ɯ ɾ ʌ̹ d͡ʑ i d a̠
쓰레기	s͈ ɯ ɾ e̞ ɡ i
쓰리	s͈ ɯ ɾ i
쓰이다	s͈ ɯ i d a̠
쓰푸	s͈ ɯ pʰ u
쓸데	s͈ ɯ ɭ t͈ e̞
쓸모	s͈ ɯ ɭ m o̞
씌우다	ɕ͈ i u d a̠
씨름	ɕ͈ i ɾ ɯ m
씨앗	ɕ͈ i a̠ t̚
씹거웃	ɕ͈ i p̚ k͈ ʌ̹ u t̚
씹다	ɕ͈ i p̚ t͈ a̠
씹덕	ɕ͈ i p̚ t͈ ʌ̹ k̚
씻다	ɕ͈ i t̚ t͈ a̠
아가미	a̠ ɡ a̠ m i
아가씨	a̠ ɡ a̠ ɕ͈ i
아군	a̠ː ɡ u n
아궁이	a̠ ɡ u ŋ i
아기	a̠ ɡ i
아나운서	a̠ n a̠ u n sʰ ʌ̹
아냐	a̠ ɲ j a̠
아니	a̠ n i
아니다	a̠ n i d a̠
아니메	a̠ n i m e̞
아니면	a̠ n i m j ʌ̹ n
아니야	a̠ n i j a̠
아담	a̠ d a̠ m
아동	a̠ d o̞ ŋ
아들딸	a̠ d ɯ ɭ t͈ a̠ ɭ
아디스아바바	a̠ d i sʰ ɯ a̠ b a̠ b a̠
아라	a̠ ɾ a̠
아라비아	a̠ ɾ a̠ b i a̠
아라한	a̠ ɾ a̠ ɦ a̠ n
아랍	a̠ ɾ a̠ p̚
아랍어	a̠ ɾ a̠ b ʌ̹
아랍에미리트	a̠ ɾ a̠ b e̞ m i ɾ i tʰ ɯ
아련	a̠ ɾ j ʌ̹ n
아련히	a̠ ɾ j ʌ̹ n ʝ i
아론	a̠ ɾ o̞ n
아롱아롱	a̠ ɾ o̞ ŋ a̠ ɾ o̞ ŋ
아르메니아	a̠ ɾ ɯ m e̞ n i a̠
아르메니아어	a̠ ɾ ɯ m e̞ n i a̠ ʌ̹
아르바이트	a̠ ɾ ɯ b a̠ i tʰ ɯ
아름답다	a̠ ɾ ɯ m d a̠ p̚ t͈ a̠
아리	a̠ ɾ i
아리랑	a̠ ɾ i ɾ a̠ ŋ
아리수	a̠ ɾ i sʰ u
아마	a̠ m a̠
아마도	a̠ m a̠ d o̞
아마존	a̠ m a̠ d͡ʑ o̞ n
아마추어	a̠ m a̠ t͡ɕʰ u ʌ̹
아메리카	a̠ m e̞ ɾ i kʰ a̠
아메바	a̠ m e̞ b a̠
아멘	a̠ m e̞ n
아몬드	a̠ m o̞ n d ɯ
아무	a̠ː m u
아무런	a̠ː m u ɾ ʌ̹ n
아무리	a̠ː m u ɾ i
아미노산	a̠ m i n o̞ sʰ a̠ n
아미타불	a̠ m i tʰ a̠ b u ɭ
아민	a̠ m i n
아바나	a̠ b a̠ n a̠
아버님	a̠ b ʌ̹ n i m
아보카도	a̠ b o̞ kʰ a̠ d o̞
아부다비	a̠ b u d a̠ b i
아부자	a̠ b u d͡ʑ a̠
아브라함	a̠ b ɯ ɾ a̠ ɦ a̠ m
아비	a̠ b i
아빠트	a̠ p͈ a̠ tʰ ɯ
아뿔싸	a̠ p͈ u ɭ s͈ a̠
아서	a̠ sʰ ʌ̹
아수라	a̠ː sʰ u ɾ a̠
아순시온	a̠ sʰ u n ɕʰ i o̞ n
아쉬움	a̠ ʃʰ ɥ i u m
아쉽다	a̠ ʃʰ ɥ i p̚ t͈ a̠
아스타나	a̠ sʰ ɯ tʰ a̠ n a̠
아스타틴	a̠ sʰ ɯ tʰ a̠ tʰ i n
아스텍	a̠ sʰ ɯ tʰ e̞ k̚
아스파라거스	a̠ sʰ ɯ pʰ a̠ ɾ a̠ ɡ ʌ̹ sʰ ɯ
아시아	a̠ ɕʰ i a̠
아시타비	a̠ː ɕʰ i tʰ a̠ b i
아악	a̠ː a̠ k̚
아야	a̠ j a̠
아야겠	a̠ j a̠ ɡ e̞ t̚
아연	a̠ j ʌ̹ n
아예	a̠ j e̞
아오자이	a̠ o̞ d͡ʑ a̠ i
아요	a̠ j o
아우구스투스	a̠ u ɡ u sʰ ɯ tʰ u sʰ ɯ
아웃	a̠ u t̚
아유	a̠ j u
아이	a̠ i
아이가	a̠ i ɡ a̠
아이고	a̠ i ɡ o̞
아이다	a̠ i d a̠
아이돌	a̠ i d o̞ ɭ
아이들	a̠ i d ɯ ɭ
아이디	a̠ i d i
아이쇼핑	a̠ i ɕ͈ o pʰ i ŋ
아이슬란드	a̠ i sʰ ɯ ɭ ɭ a̠ n d ɯ
아이콘	a̠ i kʰ o̞ n
아이템	a̠ i tʰ e̞ m
아이티	a̠ i tʰ i
아이폰	a̠ i pʰ o̞ n
아자	a̠ d͡ʑ a̠
아저씨	a̠ d͡ʑ ʌ̹ ɕ͈ i
아점	a̠ d͡ʑ ʌ̹ m
아제르바이잔	a̠ d͡ʑ e̞ ɾ ɯ b a̠ i d͡ʑ a̠ n
아제티딘	a̠ d͡ʑ e̞ tʰ i d i n
아주	a̠ d͡ʑ u
아주머니	a̠ d͡ʑ u m ʌ̹ n i
아줄렌	a̠ d͡ʑ u ɭ ɭ e̞ n
아즈바이	a̠ d͡ʑ ɯ b a̠ i
아지트	a̠ d͡ʑ i tʰ ɯ
아직	a̠ d͡ʑ i k̚
아체쥐	a̠ t͡ɕʰ e̞ d͡ʑ ɥ i
아카데미	a̠ kʰ a̠ d e̞ m i
아코디언	a̠ kʰ o̞ d i ʌ̹ n
아크라	a̠ k x ɯ ɾ a̠
아크리딘	a̠ k x ɯ ɾ i d i n
아테네	a̠ tʰ e̞ n e̞
아틀리에	a̠ tʰ ɯ ʎ ʎ i e̞
아티초크	a̠ tʰ i t͡ɕʰ o̞ k x ɯ
아파르트헤이트	a̠ pʰ a̠ ɾ ɯ tʰ ɯ ɦ e̞ i tʰ ɯ
아파트	a̠ pʰ a̠ tʰ ɯ
아편	a̠ pʰ j ʌ̹ n
아프가니스탄	a̠ pʰ ɯ ɡ a̠ n i sʰ ɯ tʰ a̠ n
아프다	a̠ pʰ ɯ d a̠
아프로디테	a̠ pʰ ɯ ɾ o̞ d i tʰ e̞
아프리카	a̠ pʰ ɯ ɾ i kʰ a̠
아휴	a̠ ʝ j u
아흐레	a̠ ɣ ɯ ɾ e̞
악곡	a̠ k̚ k͈ o̞ k̚
악단	a̠ k̚ t͈ a̠ n
악당	a̠ k̚ t͈ a̠ ŋ
악동	a̠ k̚ t͈ o̞ ŋ
악력	a̠ ŋ ɲ j ʌ̹ k̚
악마	a̠ ŋ m a̠
악몽	a̠ ŋ m o̞ ŋ
악성	a̠ k s͈ ʌ̹ ŋ
악수	a̠ k s͈ u
악습	a̠ k s͈ ɯ p̚
악어	a̠ ɡ ʌ̹
악영향	a̠ ɡ j ʌ̹ ŋ ʝ j a̠ ŋ
악인	a̠ ɡ i n
악취	a̠ k̚ t͡ɕʰ ɥ i
악평	a̠ k̚ pʰ j ʌ̹ ŋ
악한	a̠ kʰ a̠ n
안경	a̠ː n ɡ j ʌ̹ ŋ
안과	a̠ː n k͈ w a̠
안녕	a̠ n ɲ j ʌ̹ ŋ
안녕히	a̠ n ɲ j ʌ̹ ŋ ʝ i
안다	a̠ː n t͈ a̠
안도라	a̠ n d o̞ ɾ a̠
안되다	a̠ n d w e̞ d a̠
안드레아	a̠ n d ɯ ɾ e̞ a̠
안드로이드	a̠ n d ɯ ɾ o̞ i d ɯ
안락사	a̠ ɭ ɭ a̠ k s͈ a̠
안락의자	a̠ ɭ ɭ a̠ ɡ ɰ i d͡ʑ a̠
안마	a̠ː n m a̠
안면승마	a̠ n m j ʌ̹ n sʰ ɯ ŋ m a̠
안방	a̠ n b a̠ ŋ
안부	a̠ n b u
안심	a̠ n ɕʰ i m
안심하다	a̠ n ɕʰ i m ɦ a̠ d a̠
안전	a̠ ɲ d͡ʑ ʌ̹ n
안전제일	a̠ ɲ d͡ʑ ʌ̹ ɲ d͡ʑ e̞ i ɭ
안절부절	a̠ ɲ d͡ʑ ʌ̹ ɭ b u d͡ʑ ʌ̹ ɭ
안절부절못하다	a̠ ɲ d͡ʑ ʌ̹ ɭ b u d͡ʑ ʌ̹ ɭ m o̞ tʰ a̠ d a̠
안주	a̠ ɲ d͡ʑ u
안쪽	a̠ ɲ t͡ɕ͈ o̞ k̚
안타	a̠ n tʰ a̠
안타나나리보	a̠ n tʰ a̠ n a̠ n a̠ ɾ i b o̞
안티	a̠ n tʰ i
안후이	a̠ n β u i
안휘	a̠ n ɦ ɥ i
알거지	a̠ ɭ ɡ ʌ̹ d͡ʑ i
알고리즘	a̠ ɭ ɡ o̞ ɾ i d͡ʑ ɯ m
알곡	a̠ ɭ ɡ o̞ k̚
알까기	a̠ ɭ k͈ a̠ ɡ i
알다	a̠ː ɭ d a̠
알데히드	a̠ ɭ d e̞ ʝ i d ɯ
알라	a̠ ɭ ɭ a̠
알레르기	a̠ ɭ ɭ e̞ ɾ ɯ ɡ i
알렉산드리아	a̠ ɭ ɭ e̞ k s͈ a̠ n d ɯ ɾ i a̠
알려지다	a̠ ʎ ʎ j ʌ̹ d͡ʑ i d a̠
알력	a̠ ʎ ʎ j ʌ̹ k̚
알루미늄	a̠ ɭ ɭ u m i ɲ j u m
알리고	a̠ ʎ ʎ i ɡ o̞
알리다	a̠ ʎ ʎ i d a̠
알맞다	a̠ ɭ m a̠ t̚ t͈ a̠
알바니아	a̠ ɭ b a̠ n i a̠
알바니아어	a̠ ɭ b a̠ n i a̠ ʌ̹
알아보다	a̠ ɾ a̠ b o̞ d a̠
알약	a̠ ʎ ʎ j a̠ k̚
알제	a̠ ʎ d͡ʑ e̞
알제리	a̠ ʎ d͡ʑ e̞ ɾ i
알칸	a̠ ɭ kʰ a̠ n
알칼로이드	a̠ ɭ kʰ a̠ ɭ ɭ o̞ i d ɯ
알칼리	a̠ ɭ kʰ a̠ ʎ ʎ i
알켄	a̠ ɭ kʰ e̞ n
알콜	a̠ ɭ kʰ o̞ ɭ
알타이	a̠ ɭ tʰ a̠ i
알파	a̠ ɭ pʰ a̠
알판	a̠ ɭ pʰ a̠ n
알현	a̠ ɾ ʝ j ʌ̹ n
앓다	a̠ ɭ tʰ a̠
앓이	a̠ ɾ i
암만	a̠ m m a̠ n
암말	a̠ m m a̠ ɭ
암벽	a̠ m b j ʌ̹ k̚
암살	a̠ m sʰ a̠ ɭ
암스테르담	a̠ m sʰ ɯ tʰ e̞ ɾ ɯ d a̠ m
암시	a̠ː m ɕʰ i
암실	a̠ː m ɕʰ i ɭ
암자	a̠ m d͡ʑ a̠
암초	a̠ː m t͡ɕʰ o̞
암컷	a̠ m kʰ ʌ̹ t̚
암탉	a̠ m tʰ a̠ k̚
암향	a̠ː m ʝ j a̠ ŋ
암호	a̠ː m β o̞
암흑	a̠ː m ɣ ɯ k̚
압도	a̠ p̚ t͈ o̞
압또부스	a̠ p̚ t͈ o̞ b u sʰ ɯ
압력	a̠ m ɲ j ʌ̹ k̚
압박	a̠ p̚ p͈ a̠ k̚
앙골라	a̠ ŋ ɡ o̞ ɭ ɭ a̠
앙상블	a̠ ŋ sʰ a̠ ŋ b ɯ ɭ
앙숙	a̠ ŋ sʰ u k̚
앙심	a̠ ŋ ɕʰ i m
앙이다	a̠ ŋ i d a̠
앙카라	a̠ ŋ kʰ a̠ ɾ a̠
앙케트	a̠ ŋ kʰ e̞ tʰ ɯ
앞다리	a̠ p̚ t͈ a̠ ɾ i
앞뒤	a̠ p̚ t͈ ɥ i
앞면	a̠ m m j ʌ̹ n
앞서	a̠ p s͈ ʌ̹
앞서다	a̠ p s͈ ʌ̹ d a̠
앞에서	a̠ pʰ e̞ sʰ ʌ̹
앞으로	a̠ pʰ ɯ ɾ o̞
애교	ɛː ɡ j o
애국심	ɛː ɡ u k ɕ͈ i m
애국자	ɛː ɡ u k̚ t͡ɕ͈ a̠
애국주의	ɛː ɡ u k̚ t͡ɕ͈ u ɰ i
애쓰다	ɛː s͈ ɯ d a̠
애완동물	ɛː w a̠ n d o̞ ŋ m u ɭ
애인	ɛː i n
애정	ɛː d͡ʑ ʌ̹ ŋ
애칭	ɛː t͡ɕʰ i ŋ
야경	j a̠ː ɡ j ʌ̹ ŋ
야구장	j a̠ː ɡ u d͡ʑ a̠ ŋ
야당	j a̠ː d a̠ ŋ
야마토	j a̠ m a̠ tʰ o̞
야무수크로	j a̠ m u sʰ u k x ɯ ɾ o̞
야민정음	j a̠ m i ɲ d͡ʑ ʌ̹ ŋ ɯ m
야식	j a̠ː ɕʰ i k̚
야자나무	j a̠ː d͡ʑ a̠ n a̠ m u
야자수	j a̠ː d͡ʑ a̠ sʰ u
야쿠자	j a̠ kʰ u d͡ʑ a̠
야하다	j a̠ː ɦ a̠ d a̠
야한	j a̠ː ɦ a̠ n
야훼	j a̠ β w e̞
약국	j a̠ k̚ k͈ u k̚
약도	j a̠ k̚ t͈ o̞
약력	j a̠ ŋ ɲ j ʌ̹ k̚
약사	j a̠ k s͈ a̠
약속	j a̠ k s͈ o̞ k̚
약식	j a̠ k ɕ͈ i k̚
약실	j a̠ k ɕ͈ i ɭ
약자	j a̠ k̚ t͡ɕ͈ a̠
약점	j a̠ k̚ t͡ɕ͈ ʌ̹ m
약주	j a̠ k̚ t͡ɕ͈ u
약칭	j a̠ k̚ t͡ɕʰ i ŋ
약탈	j a̠ k̚ tʰ a̠ ɭ
약품	j a̠ k̚ pʰ u m
약하다	j a̠ kʰ a̠ d a̠
약학	j a̠ kʰ a̠ k̚
약혼	j a̠ kʰ o̞ n
양곤	j a̠ ŋ ɡ o̞ n
양국	j a̠ ŋ ɡ u k̚
양귀비	j a̠ ŋ ɡ ɥ i b i
양귀자	j a̠ ŋ ɡ ɥ i d͡ʑ a̠
양념	j a̠ ŋ ɲ j ʌ̹ m
양다리	j a̠ ŋ d a̠ ɾ i
양동이	j a̠ ŋ d o̞ ŋ i
양력	j a̠ ŋ ɲ j ʌ̹ k̚
양말	j a̠ ŋ m a̠ ɭ
양면	j a̠ ŋ m j ʌ̹ n
양반	j a̠ ŋ b a̠ n
양복	j a̠ ŋ b o̞ k̚
양봉	j a̠ː ŋ b o̞ ŋ
양상	j a̠ ŋ sʰ a̠ ŋ
양성자	j a̠ ŋ sʰ ʌ̹ ŋ d͡ʑ a̠
양수사	j a̠ ŋ sʰ u sʰ a̠
양식	j a̠ ŋ ɕʰ i k̚
양심	j a̠ ŋ ɕʰ i m
양유	j a̠ ŋ j u
양조장	j a̠ː ŋ d͡ʑ o̞ d͡ʑ a̠ ŋ
양주	j a̠ ŋ d͡ʑ u
양즈	j a̠ ŋ d͡ʑ ɯ
양쪽	j a̠ː ŋ t͡ɕ͈ o̞ k̚
양초	j a̠ ŋ t͡ɕʰ o̞
양파	j a̠ ŋ pʰ a̠
양피지	j a̠ ŋ pʰ i d͡ʑ i
얕다	j a̠ t̚ t͈ a̠
얘기	j ɛː ɡ i
어간	ɘː ɡ a̠ n
어감	ɘː ɡ a̠ m
어구	ɘː ɡ u
어그러지다	ʌ̹ ɡ ɯ ɾ ʌ̹ d͡ʑ i d a̠
어근	ɘː ɡ ɯ n
어금니	ʌ̹ ɡ ɯ m n i
어긋나다	ʌ̹ ɡ ɯ n n a̠ d a̠
어느	ʌ̹ n ɯ
어둡다	ʌ̹ d u p̚ t͈ a̠
어드벤처	ʌ̹ d ɯ b e̞ ɲ t͡ɕʰ ʌ̹
어디	ʌ̹ d i
어딘가	ʌ̹ d i n ɡ a̠
어떡하다	ʌ̹ t͈ ʌ̹ kʰ a̠ d a̠
어떻게	ʌ̹ t͈ ʌ̹ kʰ e̞
어떻다	ʌ̹ t͈ ʌ̹ tʰ a̠
어란	ʌ̹ ɾ a̠ n
어려움	ʌ̹ ɾ j ʌ̹ u m
어렴풋이	ʌ̹ ɾ j ʌ̹ m pʰ u ɕʰ i
어렵다	ʌ̹ ɾ j ʌ̹ p̚ t͈ a̠
어뢰	ʌ̹ ɾ w e̞
어름치	ʌ̹ ɾ ɯ m t͡ɕʰ i
어리다	ʌ̹ ɾ i d a̠
어리석다	ʌ̹ ɾ i sʰ ʌ̹ k̚ t͈ a̠
어린아이	ʌ̹ ɾ i n a̠ i
어린이	ʌ̹ ɾ i n i
어린이집	ʌ̹ ɾ i n i d͡ʑ i p̚
어머	ʌ̹ m ʌ̹
어머나	ɘː m ʌ̹ n a̠
어머니	ʌ̹ m ʌ̹ n i
어머님	ʌ̹ m ʌ̹ n i m
어묵	ʌ̹ m u k̚
어버이	ʌ̹ b ʌ̹ i
어부	ʌ̹ b u
어서	ʌ̹ sʰ ʌ̹
어여머리	ʌ̹ j ʌ̹ m ʌ̹ ɾ i
어요	ʌ̹ j o
어울리다	ʌ̹ u ʎ ʎ i d a̠
어원	ɘː w ʌ̹ n
어이	ʌ̹ i
어장관리	ʌ̹ d͡ʑ a̠ ŋ ɡ w a̠ ʎ ʎ i
어제	ʌ̹ d͡ʑ e̞
어젯밤	ʌ̹ d͡ʑ e̞ t̚ p͈ a̠ m
어족	ɘː d͡ʑ o̞ k̚
어줍잖다	ʌ̹ d͡ʑ u p̚ t͡ɕ͈ a̠ n tʰ a̠
어즈버	ʌ̹ d͡ʑ ɯ b ʌ̹
어지럽다	ʌ̹ d͡ʑ i ɾ ʌ̹ p̚ t͈ a̠
어쩌다	ʌ̹ t͡ɕ͈ ʌ̹ d a̠
어쩌면	ʌ̹ t͡ɕ͈ ʌ̹ m j ʌ̹ n
어쭙잖다	ʌ̹ t͡ɕ͈ u p̚ t͡ɕ͈ a̠ n tʰ a̠
어차피	ʌ̹ t͡ɕʰ a̠ pʰ i
어치	ʌ̹ t͡ɕʰ i
어형	ʌ̹ ʝ j ʌ̹ ŋ
어휘소	ʌ̹ ɦ ɥ i sʰ o̞
어휘장	ɘː ɦ ɥ i d͡ʑ a̠ ŋ
억류	ʌ̹ ŋ ɲ j u
억수	ʌ̹ k s͈ u
억압	ʌ̹ ɡ a̠ p̚
억울하다	ʌ̹ ɡ u ɾ ɦ a̠ d a̠
억지	ʌ̹ k̚ t͡ɕ͈ i
언간	ʌ̹ n ɡ a̠ n
언니	ʌ̹ n n i
언덕	ʌ̹ n d ʌ̹ k̚
언론학	ʌ̹ ɭ ɭ o̞ n ɦ a̠ k̚
언론학자	ʌ̹ ɭ ɭ o̞ n ɦ a̠ k̚ t͡ɕ͈ a̠
언문	ɘː n m u n
언어	ʌ̹ n ʌ̹
언어학	ʌ̹ n ʌ̹ ɦ a̠ k̚
언제	ɘː ɲ d͡ʑ e̞
언제나	ɘː ɲ d͡ʑ e̞ n a̠
언젠가	ɘː ɲ d͡ʑ e̞ n ɡ a̠
얼룩말	ʌ̹ ɭ ɭ u ŋ m a̠ ɭ
얼른	ʌ̹ ɭ ɭ ɯ n
얼리다	ʌ̹ ʎ ʎ i d a̠
얼마나	ʌ̹ ɭ m a̠ n a̠
얼쑤	ʌ̹ ɭ s͈ u
얼어붙다	ʌ̹ ɾ ʌ̹ b u t̚ t͈ a̠
얼음과자	ʌ̹ ɾ ɯ m ɡ w a̠ d͡ʑ a̠
얼짱	ʌ̹ ʎ t͡ɕ͈ a̠ ŋ
얼핏	ʌ̹ ɭ pʰ i t̚
엄격	ʌ̹ m k͈ j ʌ̹ k̚
엄격하다	ʌ̹ m k͈ j ʌ̹ kʰ a̠ d a̠
엄니	ɘː m n i
엄마	ʌ̹ m m a̠
엄습	ɘː m sʰ ɯ p̚
엄습하다	ɘː m sʰ ɯ pʰ a̠ d a̠
엄지	ʌ̹ m d͡ʑ i
엄지손가락	ʌ̹ m d͡ʑ i sʰ o̞ n ɡ a̠ ɾ a̠ k̚
엄청	ʌ̹ m t͡ɕʰ ʌ̹ ŋ
엄청나다	ʌ̹ m t͡ɕʰ ʌ̹ ŋ n a̠ d a̠
업그레이드	ʌ̹ p̚ k͈ ɯ ɾ e̞ i d ɯ
업다	ʌ̹ p̚ t͈ a̠
업동이	ʌ̹ p̚ t͈ o̞ ŋ i
업소	ʌ̹ p s͈ o̞
업종	ʌ̹ p̚ t͡ɕ͈ o̞ ŋ
없어지다	ɘː p s͈ ʌ̹ d͡ʑ i d a̠
없었다	ʌ̹ p s͈ ʌ̹ t̚ t͈ a̠
없이	ɘː p ɕ͈ i
엇비슷하다	ʌ̹ t̚ p͈ i sʰ ɯ tʰ a̠ d a̠
엉겁결에	ʌ̹ ŋ ɡ ʌ̹ p̚ k͈ j ʌ̹ ɾ e̞
엉뚱하다	ʌ̹ ŋ t͈ u ŋ ɦ a̠ d a̠
엉망진창	ʌ̹ ŋ m a̠ ŋ d͡ʑ i ɲ t͡ɕʰ a̠ ŋ
엉엉	ʌ̹ ŋ ʌ̹ ŋ
엉큼하다	ʌ̹ ŋ k x ɯ m ɦ a̠ d a̠
엊그제	ʌ̹ t̚ k͈ ɯ d͡ʑ e̞
에게	e̞ ɡ e̞
에너지	e̞ n ʌ̹ d͡ʑ i
에네르기	e̞ n e̞ ɾ ɯ ɡ i
에는	e̞ n ɯ n
에러	e̞ ɾ ʌ̹
에리트레아	e̞ ɾ i tʰ ɯ ɾ e̞ a̠
에멜무지로	e̞ m e̞ ɭ m u d͡ʑ i ɾ o̞
에뮤	e̞ m j u
에미리트	e̞ m i ɾ i tʰ ɯ
에스컬레이터	e̞ sʰ ɯ kʰ ʌ̹ ɭ ɭ e̞ i tʰ ʌ̹
에스터	e̞ sʰ ɯ tʰ ʌ̹
에스토니아	e̞ sʰ ɯ tʰ o̞ n i a̠
에스토니아어	e̞ sʰ ɯ tʰ o̞ n i a̠ ʌ̹
에스파냐	e̞ sʰ ɯ pʰ a̠ ɲ j a̠
에어컨	e̞ ʌ̹ kʰ ʌ̹ n
에어컨디셔너	e̞ ʌ̹ kʰ ʌ̹ n d i ɕʰ ʌ̹ n ʌ̹
에이즈	e̞ i d͡ʑ ɯ
에잇	e̞ i t̚
에콰도르	e̞ kʰ w a̠ d o̞ ɾ ɯ
에탄	e̞ tʰ a̠ n
에터	e̞ tʰ ʌ̹
에테르	e̞ tʰ e̞ ɾ ɯ
에티오피아	e̞ tʰ i o̞ pʰ i a̠
에티켓	e̞ tʰ i kʰ e̞ t̚
에피소드	e̞ pʰ i sʰ o̞ d ɯ
엔진	e̞ ɲ d͡ʑ i n
엘리베이터	e̞ ʎ ʎ i b e̞ i tʰ ʌ̹
엘리트	e̞ ʎ ʎ i tʰ ɯ
엘살바도르	e̞ ɭ sʰ a̠ ɭ b a̠ d o̞ ɾ ɯ
엥가노쥐	e̞ ŋ ɡ a̠ n o̞ d͡ʑ ɥ i
여가	j ʌ̹ ɡ a̠
여건	j ɘː k͈ ʌ̹ n
여겨지다	j ʌ̹ ɡ j ʌ̹ d͡ʑ i d a̠
여과	j ɘː ɡ w a̠
여과기	j ɘː ɡ w a̠ ɡ i
여관	j ʌ̹ ɡ w a̠ n
여권	j ʌ̹ k͈ w ʌ̹ n
여기	j ʌ̹ ɡ i
여기다	j ʌ̹ ɡ i d a̠
여기저기	j ʌ̹ ɡ i d͡ʑ ʌ̹ ɡ i
여뀌	j ʌ̹ k͈ ɥ i
여남은	j ʌ̹ n a̠ m ɯ n
여당	j ɘː d a̠ ŋ
여덟	j ʌ̹ d ʌ̹ ɭ
여돌	j ʌ̹ d o̞ ɭ
여드레	j ʌ̹ d ɯ ɾ e̞
여든	j ʌ̹ d ɯ n
여러분	j ʌ̹ ɾ ʌ̹ b u n
여럿	j ʌ̹ ɾ ʌ̹ t̚
여론	j ɘː ɾ o̞ n
여름	j ʌ̹ ɾ ɯ m
여보	j ʌ̹ b o̞
여보세요	j ʌ̹ b o̞ sʰ e̞ j o
여섯	j ʌ̹ sʰ ʌ̹ t̚
여성	j ʌ̹ sʰ ʌ̹ ŋ
여성주의	j ʌ̹ sʰ ʌ̹ ŋ d͡ʑ u ɰ i
여신	j ʌ̹ ɕʰ i n
여와	j ʌ̹ w a̠
여왕	j ʌ̹ w a̠ ŋ
여우비	j ʌ̹ u b i
여인	j ʌ̹ i n
여자	j ʌ̹ d͡ʑ a̠
여자아이	j ʌ̹ d͡ʑ a̠ a̠ i
여자친구	j ʌ̹ d͡ʑ a̠ t͡ɕʰ i n ɡ u
여장	j ʌ̹ d͡ʑ a̠ ŋ
여전하다	j ʌ̹ d͡ʑ ʌ̹ n ɦ a̠ d a̠
여정	j ʌ̹ d͡ʑ ʌ̹ ŋ
여제	j ʌ̹ d͡ʑ e̞
여진	j ʌ̹ d͡ʑ i n
여쭈다	j ɘː t͡ɕ͈ u d a̠
여체	j ʌ̹ t͡ɕʰ e̞
여초	j ʌ̹ t͡ɕʰ o̞
여하	j ʌ̹ ɦ a̠
역겹다	j ʌ̹ k̚ k͈ j ʌ̹ p̚ t͈ a̠
역경	j ʌ̹ k̚ k͈ j ʌ̹ ŋ
역사	j ʌ̹ k s͈ a̠
역사가	j ʌ̹ k s͈ a̠ ɡ a̠
역시	j ʌ̹ k ɕ͈ i
역학	j ʌ̹ kʰ a̠ k̚
연가	j ɘː n ɡ a̠
연간	j ʌ̹ n ɡ a̠ n
연감	j ʌ̹ n ɡ a̠ m
연결	j ʌ̹ n ɡ j ʌ̹ ɭ
연결되다	j ʌ̹ n ɡ j ʌ̹ ɭ d w e̞ d a̠
연결하다	j ʌ̹ n ɡ j ʌ̹ ɾ ɦ a̠ d a̠
연고	j ɘː n ɡ o̞
연구	j ɘː n ɡ u
연구되다	j ʌ̹ n ɡ u d w e̞ d a̠
연구소	j ʌ̹ n ɡ u sʰ o̞
연구실	j ʌ̹ n ɡ u ɕʰ i ɭ
연구자	j ɘː n ɡ u d͡ʑ a̠
연극	j ɘː n ɡ ɯ k̚
연근	j ʌ̹ n ɡ ɯ n
연금	j ʌ̹ n ɡ ɯ m
연기자	j ɘː n ɡ i d͡ʑ a̠
연꽃	j ʌ̹ n k͈ o̞ t̚
연락처	j ʌ̹ ɭ ɭ a̠ k̚ t͡ɕʰ ʌ̹
연령	j ʌ̹ ʎ ʎ j ʌ̹ ŋ
연말	j ʌ̹ n m a̠ ɭ
연못	j ʌ̹ n m o̞ t̚
연방	j ʌ̹ n b a̠ ŋ
연설	j ɘː n sʰ ʌ̹ ɭ
연설자	j ɘː n sʰ ʌ̹ ʎ t͡ɕ͈ a̠
연세	j ʌ̹ n sʰ e̞
연속	j ʌ̹ n sʰ o̞ k̚
연속극	j ʌ̹ n sʰ o̞ k̚ k͈ ɯ k̚
연습	j ɘː n sʰ ɯ p̚
연습하다	j ɘː n sʰ ɯ pʰ a̠ d a̠
연안	j ʌ̹ n a̠ n
연어	j ʌ̹ n ʌ̹
연옥	j ɘː n o̞ k̚
연월일	j ʌ̹ n w ʌ̹ ɾ i ɭ
연장	j ʌ̹ ɲ d͡ʑ a̠ ŋ
연적	j ɘː ɲ d͡ʑ ʌ̹ k̚
연주	j ɘː ɲ d͡ʑ u
연주하다	j ɘː ɲ d͡ʑ u ɦ a̠ d a̠
연초	j ʌ̹ ɲ t͡ɕʰ o̞
연필	j ʌ̹ n pʰ i ɭ
연필깎이	j ʌ̹ n pʰ i ɭ k͈ a̠ k͈ i
연하다	j ɘː n ɦ a̠ d a̠
연합	j ʌ̹ n ɦ a̠ p̚
연혁	j ɘː n ʝ j ʌ̹ k̚
연휴	j ʌ̹ n ʝ j u
엳아홉	j ʌ̹ d a̠ β o̞ p̚
열다	j ɘː ɭ d a̠
열다섯	j ʌ̹ ɭ t͈ a̠ sʰ ʌ̹ t̚
열도	j ʌ̹ ɭ t͈ o̞
열동갈문절	j ʌ̹ ɭ t͈ o̞ ŋ ɡ a̠ ɭ m u ɲ d͡ʑ ʌ̹ ɭ
열둘	j ʌ̹ ɭ t͈ u ɭ
열등	j ʌ̹ ɭ d ɯ ŋ
열등감	j ʌ̹ ɭ t͈ ɯ ŋ ɡ a̠ m
열량	j ʌ̹ ʎ ʎ j a̠ ŋ
열리다	j ʌ̹ ʎ ʎ i d a̠
열반	j ʌ̹ ɭ b a̠ n
열방	j ʌ̹ ɭ b a̠ ŋ
열셋	j ʌ̹ ɭ s͈ e̞ t̚
열쇠	j ɘː ɭ s͈ w e̞
열심히	j ʌ̹ ɭ ɕ͈ i m ʝ i
열아홉	j ʌ̹ ɾ a̠ β o̞ p̚
열여덟	j ʌ̹ ʎ ʎ j ʌ̹ d ʌ̹ ɭ
열여섯	j ʌ̹ ʎ ʎ j ʌ̹ sʰ ʌ̹ t̚
열역학	j ʌ̹ ʎ ʎ j ʌ̹ kʰ a̠ k̚
열일곱	j ʌ̹ ʎ ʎ i ɭ ɡ o̞ p̚
열정	j ʌ̹ ʎ d͡ʑ ʌ̹ ŋ
열차	j ʌ̹ ʎ t͡ɕʰ a̠
열화학	j ʌ̹ ɾ β w a̠ ɦ a̠ k̚
열흘	j ʌ̹ ɾ ɣ ɯ ɭ
염기	j ʌ̹ m ɡ i
염료	j ɘː m ɲ j o
염복	j ɘː m b o̞ k̚
염세주의	j ɘː m sʰ e̞ d͡ʑ u ɰ i
염소	j ʌ̹ m sʰ o̞
염장	j ʌ̹ m d͡ʑ a̠ ŋ
염주	j ɘː m d͡ʑ u
염증	j ʌ̹ m t͡ɕ͈ ɯ ŋ
염통	j ʌ̹ m tʰ o̞ ŋ
엿기름	j ʌ̹ t̚ k͈ i ɾ ɯ m
엿보다	j ɘː t̚ p͈ o̞ d a̠
영광	j ʌ̹ ŋ ɡ w a̠ ŋ
영광스럽다	j ʌ̹ ŋ ɡ w a̠ ŋ sʰ ɯ ɾ ʌ̹ p̚ t͈ a̠
영구	j ɘː ŋ ɡ u
영국	j ʌ̹ ŋ ɡ u k̚
영국인	j ʌ̹ ŋ ɡ u ɡ i n
영도자	j ʌ̹ ŋ d o̞ d͡ʑ a̠
영리하다	j ɘː ŋ n i ɦ a̠ d a̠
영묘	j ʌ̹ ŋ m j o
영문	j ʌ̹ ŋ m u n
영미권	j ʌ̹ ŋ m i k͈ w ʌ̹ n
영본	j ʌ̹ ŋ b o̞ n
영사	j ʌ̹ ŋ sʰ a̠
영사관	j ʌ̹ ŋ sʰ a̠ ɡ w a̠ n
영성	j ʌ̹ ŋ sʰ ʌ̹ ŋ
영성체	j ɘː ŋ sʰ ʌ̹ ŋ t͡ɕʰ e̞
영수증	j ʌ̹ ŋ sʰ u d͡ʑ ɯ ŋ
영양	j ʌ̹ ŋ j a̠ ŋ
영양실조	j ʌ̹ ŋ j a̠ ŋ ɕʰ i ʎ d͡ʑ o̞
영양제	j ʌ̹ ŋ j a̠ ŋ d͡ʑ e̞
영어	j ʌ̹ ŋ ʌ̹
영업	j ʌ̹ ŋ ʌ̹ p̚
영역	j ʌ̹ ŋ j ʌ̹ k̚
영예	j ʌ̹ ŋ j e̞
영웅	j ʌ̹ ŋ u ŋ
영원히	j ɘː ŋ w ʌ̹ n ʝ i
영적	j ʌ̹ ŋ t͡ɕ͈ ʌ̹ k̚
영지	j ʌ̹ ŋ d͡ʑ i
영춘권	j ɘː ŋ t͡ɕʰ u n ɡ w ʌ̹ n
영토	j ʌ̹ ŋ tʰ o̞
영하	j ʌ̹ ŋ ɦ a̠
영향	j ɘː ŋ ʝ j a̠ ŋ
영향력	j ɘː ŋ ʝ j a̠ ŋ ɲ j ʌ̹ k̚
영혼	j ʌ̹ ŋ β o̞ n
영화관	j ʌ̹ ŋ β w a̠ ɡ w a̠ n
옅다	j ʌ̹ t̚ t͈ a̠
옆얼굴	j ʌ̹ b ʌ̹ ɭ ɡ u ɭ
옆집	j ʌ̹ p̚ t͡ɕ͈ i p̚
예감	j e̞ː ɡ a̠ m
예능	j e̞ː n ɯ ŋ
예니레	j e̞ n i ɾ e̞
예닐곱	j e̞ n i ɭ ɡ o̞ p̚
예다	j e̞ː d a̠
예레반	j e̞ ɾ e̞ b a̠ n
예멘	j e̞ m e̞ n
예명	j e̞ m j ʌ̹ ŋ
예문	j e̞ː m u n
예물	j e̞ m u ɭ
예방	j e̞ː b a̠ ŋ
예산	j e̞ː sʰ a̠ n
예수	j e̞ sʰ u
예수회	j e̞ sʰ u β w e̞
예순	j e̞ sʰ u n
예술가	j e̞ː sʰ u ɭ ɡ a̠
예식	j e̞ ɕʰ i k̚
예약하다	j e̞ː j a̠ kʰ a̠ d a̠
예언	j e̞ː ʌ̹ n
예언자	j e̞ː ʌ̹ ɲ d͡ʑ a̠
예외	j e̞ː w e̞
예의	j e̞ ɰ i
예일	j e̞ i ɭ
예절	j e̞ d͡ʑ ʌ̹ ɭ
예정	j e̞ː d͡ʑ ʌ̹ ŋ
예카테린부르크	j e̞ kʰ a̠ tʰ e̞ ɾ i n b u ɾ ɯ k x ɯ
예후	j e̞ː β u
옛날	j e̞ː n n a̠ ɭ
옛말	j e̞ː n m a̠ ɭ
옛적	j e̞ː t̚ t͡ɕ͈ ʌ̹ k̚
오글오글	o̞ ɡ ɯ ɾ o̞ ɡ ɯ ɭ
오금	o̞ ɡ ɯ m
오누이	o̞ n u i
오늘	o̞ n ɯ ɭ
오다	o̞ d a̠
오답	o̞ː d a̠ p̚
오데사	o̞ d e̞ sʰ a̠
오드콜로뉴	o̞ d ɯ kʰ o̞ ɭ ɭ o̞ ɲ j u
오디	o̞ d i
오라버님	o̞ ɾ a̠ b ʌ̹ n i m
오락	o̞ː ɾ a̠ k̚
오락실	o̞ː ɾ a̠ k ɕ͈ i ɭ
오랑우탄	o̞ ɾ a̠ ŋ u tʰ a̠ n
오렌지	o̞ ɾ e̞ ɲ d͡ʑ i
오로지	o̞ː ɾ o̞ d͡ʑ i
오롯하다	o̞ ɾ o̞ tʰ a̠ d a̠
오류	o̞ː ɾ j u
오르가슴	o̞ ɾ ɯ ɡ a̠ sʰ ɯ m
오르다	o̞ ɾ ɯ d a̠
오르되브르	o̞ ɾ ɯ d w e̞ b ɯ ɾ ɯ
오른	o̞ ɾ ɯ n
오른손잡이	o̞ ɾ ɯ n sʰ o̞ ɲ d͡ʑ a̠ b i
오리나무	o̞ ɾ i n a̠ m u
오리무중	o̞ː ɾ i m u d͡ʑ u ŋ
오물	o̞ː m u ɭ
오물오물	o̞ m u ɾ o̞ m u ɭ
오므라이스	o̞ m ɯ ɾ a̠ i sʰ ɯ
오믈렛	o̞ m ɯ ɭ ɭ e̞ t̚
오버클럭	o̞ b ʌ̹ k x ɯ ɭ ɭ ʌ̹ k̚
오븐	o̞ b ɯ n
오빠	o̞ p͈ a̠
오사존	o̞ sʰ a̠ d͡ʑ o̞ n
오사카	o̞ sʰ a̠ kʰ a̠
오소리	o̞ sʰ o̞ ɾ i
오십	o̞ː ɕʰ i p̚
오아시스	o̞ a̠ ɕʰ i sʰ ɯ
오염	o̞ː j ʌ̹ m
오염되다	o̞ː j ʌ̹ m d w e̞ d a̠
오온	o̞ː o̞ n
오옴	o̞ o̞ m
오월	o̞ː w ʌ̹ ɭ
오이	o̞ i
오적어	o̞ d͡ʑ ʌ̹ ɡ ʌ̹
오전	o̞ː d͡ʑ ʌ̹ n
오존	o̞ d͡ʑ o̞ n
오줌	o̞ d͡ʑ u m
오직	o̞ d͡ʑ i k̚
오징어	o̞ d͡ʑ i ŋ ʌ̹
오촌	o̞ː t͡ɕʰ o̞ n
오케스트라	o̞ kʰ e̞ sʰ ɯ tʰ ɯ ɾ a̠
오타	o̞ː tʰ a̠
오타와	o̞ tʰ a̠ w a̠
오타쿠	o̞ tʰ a̠ kʰ u
오토바이	o̞ tʰ o̞ b a̠ i
오트밀	o̞ tʰ ɯ m i ɭ
오페라	o̞ pʰ e̞ ɾ a̠
오페레타	o̞ pʰ e̞ ɾ e̞ tʰ a̠
오후	o̞ː β u
오히려	o̞ ʝ i ɾ j ʌ̹
옥상	o̞ k s͈ a̠ ŋ
옥석	o̞ k s͈ ʌ̹ k̚
옥수수	o̞ k s͈ u sʰ u
옥시토신	o̞ k ɕ͈ i tʰ o̞ ɕʰ i n
옥중	o̞ k̚ t͡ɕ͈ u ŋ
옥탑	o̞ k̚ tʰ a̠ p̚
옥테인	o̞ k̚ tʰ e̞ i n
온갖	o̞ː n ɡ a̠ t̚
온돌	o̞ n d o̞ ɭ
온라인	o̞ n n a̠ i n
온몸	o̞ː n m o̞ m
온수	o̞ n sʰ u
온실	o̞ n ɕʰ i ɭ
온종일	o̞ː ɲ d͡ʑ o̞ ŋ i ɭ
온천	o̞ ɲ t͡ɕʰ ʌ̹ n
온통	o̞ː n tʰ o̞ ŋ
올겨울	o̞ ɭ k͈ j ʌ̹ u ɭ
올라가다	o̞ ɭ ɭ a̠ ɡ a̠ d a̠
올려놓다	o̞ ʎ ʎ j ʌ̹ n o̞ tʰ a̠
올리고	o̞ ʎ ʎ i ɡ o̞
올리다	o̞ ʎ ʎ i d a̠
올리브	o̞ ʎ ʎ i b ɯ
올림말	o̞ ʎ ʎ i m m a̠ ɭ
올림픽	o̞ ʎ ʎ i m pʰ i k̚
올바르다	o̞ ɭ b a̠ ɾ ɯ d a̠
올여름	o̞ ʎ ʎ j ʌ̹ ɾ ɯ m
올통볼통	o̞ ɭ tʰ o̞ ŋ b o̞ ɭ tʰ o̞ ŋ
옳다	o̞ ɭ tʰ a̠
옳아	o̞ ɾ a̠
옴스크	o̞ m sʰ ɯ k x ɯ
옷감	o̞ t̚ k͈ a̠ m
옷걸이	o̞ t̚ k͈ ʌ̹ ɾ i
옷고름	o̞ t̚ k͈ o̞ ɾ ɯ m
옷장	o̞ t̚ t͡ɕ͈ a̠ ŋ
와그르르	w a̠ ɡ ɯ ɾ ɯ ɾ ɯ
와글와글	w a̠ ɡ ɯ ɾ w a̠ ɡ ɯ ɭ
와사비	w a̠ sʰ a̠ b i
와이셔츠	w a̠ i ɕʰ ʌ̹ t͡ɕʰ ɯ
와이파이	w a̠ i pʰ a̠ i
와이프	w a̠ i pʰ ɯ
와인	w a̠ i n
와타시	w a̠ tʰ a̠ ɕʰ i
완곡하다	w a̠ː n ɡ o̞ kʰ a̠ d a̠
완두	w a̠ n d u
완벽	w a̠ n b j ʌ̹ k̚
완비	w a̠ n b i
완성	w a̠ n sʰ ʌ̹ ŋ
완성하다	w a̠ n sʰ ʌ̹ ŋ ɦ a̠ d a̠
완전	w a̠ ɲ d͡ʑ ʌ̹ n
완전히	w a̠ ɲ d͡ʑ ʌ̹ n ʝ i
왈가왈부	w a̠ ɭ ɡ a̠ w a̠ ɭ b u
왈츠	w a̠ ʎ t͡ɕʰ ɯ
왕가	w a̠ ŋ ɡ a̠
왕관	w a̠ ŋ ɡ w a̠ n
왕국	w a̠ ŋ ɡ u k̚
왕복	w a̠ː ŋ b o̞ k̚
왕성	w a̠ː ŋ sʰ ʌ̹ ŋ
왕실	w a̠ ŋ ɕʰ i ɭ
왕자	w a̠ ŋ d͡ʑ a̠
왕조	w a̠ ŋ d͡ʑ o̞
왕후	w a̠ ŋ β u
왜서	w ɛː sʰ ʌ̹
외계어	w e̞ː ɡ j e̞ ʌ̹
외과	w e̞ː k͈ w a̠
외교	w e̞ː ɡ j o
외교관	w e̞ː ɡ j o ɡ w a̠ n
외국	w e̞ː ɡ u k̚
외국어	w e̞ː ɡ u ɡ ʌ̹
외국인	w e̞ː ɡ u ɡ i n
외딸	w e̞ t͈ a̠ ɭ
외롭다	w e̞ ɾ o̞ p̚ t͈ a̠
외면	w e̞ː m j ʌ̹ n
외모	w e̞ː m o̞
외복사근	w e̞ b o̞ k s͈ a̠ ɡ ɯ n
외부	w e̞ː b u
외삼촌	w e̞ː sʰ a̠ m t͡ɕʰ o̞ n
외설	w e̞ː sʰ ʌ̹ ɭ
외손녀	w e̞ː sʰ o̞ n ɲ j ʌ̹
외손자	w e̞ː sʰ o̞ ɲ d͡ʑ a̠
외식	w e̞ː ɕʰ i k̚
외아들	w e̞ a̠ d ɯ ɭ
외야수	w e̞ː j a̠ sʰ u
외인	w e̞ː i n
외지	w e̞ d͡ʑ i
외치다	w e̞ t͡ɕʰ i d a̠
외투	w e̞ː tʰ u
외할머니	w e̞ ɦ a̠ ɭ m ʌ̹ n i
외할아버지	w e̞ ɦ a̠ ɾ a̠ b ʌ̹ d͡ʑ i
외환	w e̞ː β w a̠ n
왼손잡이	w e̞ː n sʰ o̞ ɲ d͡ʑ a̠ b i
왼쪽	w e̞ː ɲ t͡ɕ͈ o̞ k̚
요격	j o ɡ j ʌ̹ k̚
요괴	j o ɡ w e̞
요구	j o ɡ u
요구되다	j o ɡ u d w e̞ d a̠
요구하다	j o ɡ u ɦ a̠ d a̠
요녕	j o ɲ j ʌ̹ ŋ
요도	j o d o̞
요람	j o ɾ a̠ m
요령	j o ɾ j ʌ̹ ŋ
요르단	j o ɾ ɯ d a̠ n
요리	j o ɾ i
요리하다	j o ɾ i ɦ a̠ d a̠
요법	j o p͈ ʌ̹ p̚
요사이	j o sʰ a̠ i
요소	j o sʰ o̞
요술	j o sʰ u ɭ
요약하다	j o j a̠ kʰ a̠ d a̠
요오드	j o o̞ d ɯ
요일	j o i ɭ
요절	j oː d͡ʑ ʌ̹ ɭ
요즈음	j o d͡ʑ ɯ ɯ m
요즘	j o d͡ʑ ɯ m
요지	j o d͡ʑ i
요청	j o t͡ɕʰ ʌ̹ ŋ
요크셔	j o k x ɯ ɕʰ ʌ̹
요하다	j o ɦ a̠ d a̠
요한	j o ɦ a̠ n
욕실	j o k ɕ͈ i ɭ
욕조	j o k̚ t͡ɕ͈ o̞
용감하다	j oː ŋ ɡ a̠ m ɦ a̠ d a̠
용과	j o ŋ ɡ w a̠
용도	j oː ŋ d o̞
용돈	j oː ŋ t͈ o̞ n
용모	j o ŋ m o̞
용병	j o ŋ b j ʌ̹ ŋ
용비어천가	j o ŋ b i ʌ̹ t͡ɕʰ ʌ̹ n ɡ a̠
용서하다	j o ŋ sʰ ʌ̹ ɦ a̠ d a̠
용언	j oː ŋ ʌ̹ n
용역	j oː ŋ j ʌ̹ k̚
용의자	j o ŋ ɰ i d͡ʑ a̠
용이	j o ŋ i
용이하다	j o ŋ i ɦ a̠ d a̠
용접	j o ŋ d͡ʑ ʌ̹ p̚
용지	j oː ŋ d͡ʑ i
용케	j oː ŋ kʰ e̞
우간다	u ɡ a̠ n d a̠
우그르르	u ɡ ɯ ɾ ɯ ɾ ɯ
우동	u d o̞ ŋ
우두커니	u d u kʰ ʌ̹ n i
우렁각시	u ɾ ʌ̹ ŋ ɡ a̠ k ɕ͈ i
우렁이	u ɾ ʌ̹ ŋ i
우롱차	u ɾ o̞ ŋ t͡ɕʰ a̠
우루과이	u ɾ u ɡ w a̠ i
우리나라	u ɾ i n a̠ ɾ a̠
우리들	u ɾ i d ɯ ɭ
우리말	u ɾ i m a̠ ɭ
우리집	u ɾ i d͡ʑ i p̚
우마	u m a̠
우먼	u m ʌ̹ n
우물	u m u ɭ
우물우물	u m u ɾ u m u ɭ
우산	uː sʰ a̠ n
우상	uː sʰ a̠ ŋ
우선	u sʰ ʌ̹ n
우세	u sʰ e̞
우수리	u sʰ u ɾ i
우습다	uː sʰ ɯ p̚ t͈ a̠
우승	u sʰ ɯ ŋ
우아	u a̠
우아하다	u a̠ ɦ a̠ d a̠
우엉	u ʌ̹ ŋ
우연	u j ʌ̹ n
우연히	u j ʌ̹ n ʝ i
우울증	u u ʎ t͡ɕ͈ ɯ ŋ
우울하다	u u ɾ ɦ a̠ d a̠
우웩	u w e̞ k̚
우유	u j u
우익수	uː i k s͈ u
우주선	uː d͡ʑ u sʰ ʌ̹ n
우체국	u t͡ɕʰ e̞ ɡ u k̚
우체부	uː t͡ɕʰ e̞ b u
우크라이나어	u k x ɯ ɾ a̠ i n a̠ ʌ̹
우편	u pʰ j ʌ̹ n
우편번호	u pʰ j ʌ̹ n b ʌ̹ n β o̞
우편함	u pʰ j ʌ̹ n ɦ a̠ m
우표	u pʰ j o
우한	u ɦ a̠ n
우화	uː β w a̠
운동	uː n d o̞ ŋ
운동공원	u n d o̞ ŋ ɡ o̞ ŋ w ʌ̹ n
운동복	uː n d o̞ ŋ b o̞ k̚
운동장	uː n d o̞ ŋ d͡ʑ a̠ ŋ
운동하다	uː n d o̞ ŋ ɦ a̠ d a̠
운동화	uː n d o̞ ŋ β w a̠
운명	uː n m j ʌ̹ ŋ
운명론	uː n m j ʌ̹ ŋ n o̞ n
운수	u n sʰ u
운전	u ɲ d͡ʑ ʌ̹ n
운전기사	uː ɲ d͡ʑ ʌ̹ n ɡ i sʰ a̠
운전사	uː ɲ d͡ʑ ʌ̹ n sʰ a̠
운전자	uː ɲ d͡ʑ ʌ̹ ɲ d͡ʑ a̠
운하	uː n ɦ a̠
울다	uː ɭ d a̠
울란바토르	u ɭ ɭ a̠ n b a̠ tʰ o̞ ɾ ɯ
울리다	u ʎ ʎ i d a̠
울리짜	u ʎ ʎ i t͡ɕ͈ a̠
울버린	u ɭ b ʌ̹ ɾ i n
울산	u ɭ s͈ a̠ n
울음	u ɾ ɯ m
울음소리	u ɾ ɯ m s͈ o̞ ɾ i
움직이다	u m d͡ʑ i ɡ i d a̠
움직임	u m d͡ʑ i ɡ i m
움짤	u m t͡ɕ͈ a̠ ɭ
웃기다	u t̚ k͈ i d a̠
웃다	uː t̚ t͈ a̠
웃음	u sʰ ɯ m
웅덩이	u ŋ d ʌ̹ ŋ i
웅데	u ŋ d e̞
웅어	u ŋ ʌ̹
워그르르	w ʌ̹ ɡ ɯ ɾ ɯ ɾ ɯ
워낙	w ʌ̹ n a̠ k̚
워석버석	w ʌ̹ sʰ ʌ̹ k̚ p͈ ʌ̹ sʰ ʌ̹ k̚
워싱턴	w ʌ̹ ɕʰ i ŋ tʰ ʌ̹ n
원고	w ʌ̹ n ɡ o̞
원기둥	w ʌ̹ n ɡ i d u ŋ
원료	w ʌ̹ ʎ ʎ j o
원룸	w ʌ̹ n n u m
원리	w ʌ̹ ʎ ʎ i
원망	w ʌ̹ n m a̠ ŋ
원망하다	w ɘː n m a̠ ŋ ɦ a̠ d a̠
원반	w ʌ̹ n b a̠ n
원본	w ʌ̹ n b o̞ n
원산	w ʌ̹ n sʰ a̠ n
원석	w ʌ̹ n sʰ ʌ̹ k̚
원시	w ɘː n ɕʰ i
원앙	w ʌ̹ n a̠ ŋ
원인	w ʌ̹ n i n
원자	w ʌ̹ ɲ d͡ʑ a̠
원자력발전소	w ʌ̹ ɲ d͡ʑ a̠ ɾ j ʌ̹ k̚ p͈ a̠ ʎ d͡ʑ ʌ̹ n sʰ o̞
원장	w ʌ̹ ɲ d͡ʑ a̠ ŋ
원조	w ɘː ɲ d͡ʑ o̞
원조교제	w ʌ̹ ɲ d͡ʑ o̞ ɡ j o d͡ʑ e̞
원족	w ʌ̹ ɲ d͡ʑ o̞ k̚
원천	w ʌ̹ ɲ t͡ɕʰ ʌ̹ n
원칙	w ʌ̹ ɲ t͡ɕʰ i k̚
원통	w ʌ̹ n tʰ o̞ ŋ
원폭	w ʌ̹ n pʰ o̞ k̚
원피스	w ʌ̹ n pʰ i sʰ ɯ
월경	w ʌ̹ ɭ ɡ j ʌ̹ ŋ
월남	w ʌ̹ ɭ ɭ a̠ m
월세	w ʌ̹ ɭ s͈ e̞
월식	w ʌ̹ ɭ ɕ͈ i k̚
월요일	w ʌ̹ ɾ j o i ɭ
웨브페지	w e̞ b ɯ pʰ e̞ d͡ʑ i
웨이터	w e̞ i tʰ ʌ̹
웬일	w e̞ː n n i ɭ
웹사이트	w e̞ p s͈ a̠ i tʰ ɯ
위구르어	ɥ i ɡ u ɾ ɯ ʌ̹
위굴말	ɥ i ɡ u ɭ m a̠ ɭ
위글말	ɥ i ɡ ɯ ɭ m a̠ ɭ
위기	ɥ i ɡ i
위력	ɥ i ɾ j ʌ̹ k̚
위반	ɥ i b a̠ n
위선자	ɥ i sʰ ʌ̹ ɲ d͡ʑ a̠
위안부	ɥ i a̠ n b u
위업	ɥ i ʌ̹ p̚
위원장	ɥ i w ʌ̹ ɲ d͡ʑ a̠ ŋ
위원회	ɥ i w ʌ̹ n β w e̞
위조	ɥ iː d͡ʑ o̞
위주	ɥ i d͡ʑ u
위증	ɥ i d͡ʑ ɯ ŋ
위치	ɥ i t͡ɕʰ i
위탁	ɥ i tʰ a̠ k̚
위험	ɥ i ɦ ʌ̹ m
위협	ɥ i ʝ j ʌ̹ p̚
위화감	ɥ i β w a̠ ɡ a̠ m
위훈	ɥ i β u n
윅셔너리	ɥ i k ɕ͈ ʌ̹ n ʌ̹ ɾ i
윈난	ɥ i n n a̠ n
윈도	ɥ i n d o̞
윈도우	ɥ i n d o̞ u
유가	j u ɡ a̠
유가증권	j uː ɡ a̠ d͡ʑ ɯ ŋ k͈ w ʌ̹ n
유감	j u ɡ a̠ m
유격수	j u ɡ j ʌ̹ k s͈ u
유고슬라비아	j u ɡ o̞ sʰ ɯ ɭ ɭ a̠ b i a̠
유곽	j u ɡ w a̠ k̚
유괴	j u ɡ w e̞
유교	j u ɡ j o
유권자	j uː ɡ w ʌ̹ ɲ d͡ʑ a̠
유기견	j u ɡ i ɡ j ʌ̹ n
유난히	j uː n a̠ n ʝ i
유년	j u ɲ j ʌ̹ n
유능하다	j u n ɯ ŋ ɦ a̠ d a̠
유니폼	j u n i pʰ o̞ m
유도	j u d o̞
유도탄	j u d o̞ tʰ a̠ n
유독	j uː d o̞ k̚
유라시아	j u ɾ a̠ ɕʰ i a̠
유량	j u ɾ j a̠ ŋ
유럽	j u ɾ ʌ̹ p̚
유령	j u ɾ j ʌ̹ ŋ
유로비트	j u ɾ o̞ b i tʰ ɯ
유르트	j u ɾ ɯ tʰ ɯ
유리기	j u ɾ i ɡ i
유릿조각	j u ɾ i t̚ t͡ɕ͈ o̞ ɡ a̠ k̚
유머	j u m ʌ̹
유명	j uː m j ʌ̹ ŋ
유명하다	j uː m j ʌ̹ ŋ ɦ a̠ d a̠
유목민	j u m o̞ ŋ m i n
유물	j u m u ɭ
유민	j u m i n
유사하다	j uː sʰ a̠ ɦ a̠ d a̠
유서	j u sʰ ʌ̹
유성	j u sʰ ʌ̹ ŋ
유스호스텔	j u sʰ ɯ β o̞ sʰ ɯ tʰ e̞ ɭ
유아	j u a̠
유아원	j u a̠ w ʌ̹ n
유언	j u ʌ̹ n
유언비어	j u ʌ̹ n b i ʌ̹
유엔	j u e̞ n
유역	j u j ʌ̹ k̚
유용하다	j uː j o ŋ ɦ a̠ d a̠
유월	j u w ʌ̹ ɭ
유의어	j uː ɰ i ʌ̹
유익하다	j u i kʰ a̠ d a̠
유인원	j uː i n w ʌ̹ n
유입	j u i p̚
유적	j u d͡ʑ ʌ̹ k̚
유전자	j u d͡ʑ ʌ̹ ɲ d͡ʑ a̠
유제품	j u d͡ʑ e̞ pʰ u m
유죄	j uː d͡ʑ w e̞
유지	j u d͡ʑ i
유지하다	j u d͡ʑ i ɦ a̠ d a̠
유진	j u d͡ʑ i n
유출	j u t͡ɕʰ u ɭ
유충	j u t͡ɕʰ u ŋ
유탄	j u tʰ a̠ n
유통	j u tʰ o̞ ŋ
유튜브	j u tʰ j u b ɯ
유학	j u ɦ a̠ k̚
유형	j uː ʝ j ʌ̹ ŋ
유혹	j u β o̞ k̚
유희	j u ʝ i
육군	j u k̚ k͈ u n
육분의	j u k̚ p͈ u n ɰ i
육서	j u k s͈ ʌ̹
육수	j u k s͈ u
육자진언	j u k̚ t͡ɕ͈ a̠ d͡ʑ i n ʌ̹ n
육지	j u k̚ t͡ɕ͈ i
육체	j u k̚ t͡ɕʰ e̞
육회	j u kʰ w e̞
윤곽	j u n ɡ w a̠ k̚
윤리	j u ʎ ʎ i
윤리학	j u ʎ ʎ i ɦ a̠ k̚
융자	j u ŋ d͡ʑ a̠
융합	j u ŋ ɦ a̠ p̚
윷놀이	j uː n n o̞ ɾ i
윷짝	j uː t̚ t͡ɕ͈ a̠ k̚
으로	ɯ ɾ o̞
으쌰	ɯ ɕ͈ a̠
은근	ɯ n ɡ ɯ n
은근히	ɯ n ɡ ɯ n ʝ i
은어	ɯ n ʌ̹
은유	ɯ ɲ j u
은인	ɯ n i n
은퇴하다	ɯ n tʰ w e̞ ɦ a̠ d a̠
은하단	ɯ n ɦ a̠ d a̠ n
은하수	ɯ n ɦ a̠ sʰ u
은혜	ɯ n ʝ j e̞
을게	ɯ ɭ k͈ e̞
음경	ɯ m ɡ j ʌ̹ ŋ
음독	ɯ m d o̞ k̚
음량	ɯ m ɲ j a̠ ŋ
음력	ɯ m ɲ j ʌ̹ k̚
음료	ɯː m ɲ j o
음모론	ɯ m m o̞ ɾ o̞ n
음문	ɯ m m u n
음반	ɯ m b a̠ n
음성	ɯ m sʰ ʌ̹ ŋ
음소	ɯ m sʰ o̞
음소문자	ɯ m sʰ o̞ m u ɲ d͡ʑ a̠
음식	ɯː m ɕʰ i k̚
음식값	ɯː m ɕʰ i k̚ k͈ a̠ p̚
음식점	ɯː m ɕʰ i k̚ t͡ɕ͈ ʌ̹ m
음쓰	ɯː m s͈ ɯ
음악	ɯ m a̠ k̚
음악가	ɯ m a̠ k̚ k͈ a̠
음악학	ɯ m a̠ kʰ a̠ k̚
음양	ɯ m j a̠ ŋ
음역자	ɯ m j ʌ̹ k̚ t͡ɕ͈ a̠
음운론	ɯ m u n n o̞ n
음절	ɯ m d͡ʑ ʌ̹ ɭ
음표	ɯ m pʰ j o
음향	ɯ m ʝ j a̠ ŋ
음훈	ɯ m β u n
응답	ɯː ŋ d a̠ p̚
응당	ɯː ŋ d a̠ ŋ
응용	ɯː ŋ j o ŋ
응원	ɯː ŋ w ʌ̹ n
응집력	ɯː ŋ d͡ʑ i m ɲ j ʌ̹ k̚
응징하다	ɯ ŋ d͡ʑ i ŋ ɦ a̠ d a̠
의거하다	ɰ i ɡ ʌ̹ ɦ a̠ d a̠
의견	ɰ iː ɡ j ʌ̹ n
의논	ɰ i n o̞ n
의료	ɰ i ɾ j o
의리	ɰ iː ɾ i
의문	ɰ i m u n
의문사	ɰ i m u n sʰ a̠
의미	ɰ iː m i
의복	ɰ i b o̞ k̚
의상	ɰ i sʰ a̠ ŋ
의성어	ɰ i sʰ ʌ̹ ŋ ʌ̹
의식	ɰ iː ɕʰ i k̚
의식하다	ɰ iː ɕʰ i kʰ a̠ d a̠
의심	ɰ i ɕʰ i m
의심쩍다	ɰ i ɕʰ i m t͡ɕ͈ ʌ̹ k̚ t͈ a̠
의심하다	ɰ i ɕʰ i m ɦ a̠ d a̠
의의	ɰ iː ɰ i
의인화	ɰ i i n β w a̠
의자	ɰ i d͡ʑ a̠
의장	ɰ i d͡ʑ a̠ ŋ
의제	ɰ i d͡ʑ e̞
의존증	ɰ i d͡ʑ o̞ ɲ t͡ɕ͈ ɯ ŋ
의존하다	ɰ i d͡ʑ o̞ n ɦ a̠ d a̠
의향	ɰ iː ʝ j a̠ ŋ
의협심	ɰ i ʝ j ʌ̹ p ɕ͈ i m
의형제	ɰ iː ʝ j ʌ̹ ŋ d͡ʑ e̞
의혹	ɰ i β o̞ k̚
의회	ɰ i β w e̞
이거	i ɡ ʌ̹
이것	i ɡ ʌ̹ t̚
이게	i ɡ e̞
이곳	i ɡ o̞ t̚
이과	iː k͈ w a̠
이교도	iː ɡ j o d o̞
이글	i ɡ ɯ ɭ
이글이글	i ɡ ɯ ɾ i ɡ ɯ ɭ
이기다	i ɡ i d a̠
이기적	iː ɡ i d͡ʑ ʌ̹ k̚
이기주의	iː ɡ i d͡ʑ u ɰ i
이끌다	i k͈ ɯ ɭ d a̠
이끼	i k͈ i
이나	i n a̠
이날	i n a̠ ɭ
이념	iː ɲ j ʌ̹ m
이다	i d a̠
이데올로기	i d e̞ o̞ ɭ ɭ o̞ ɡ i
이도	i d o̞
이동	i d o̞ ŋ
이듬	i d ɯ m
이디시어	i d i ɕʰ i ʌ̹
이따가	i t͈ a̠ ɡ a̠
이라크	i ɾ a̠ k x ɯ
이란	i ɾ a̠ n
이란어	i ɾ a̠ n ʌ̹
이랑	i ɾ a̠ ŋ
이러다	i ɾ ʌ̹ d a̠
이런	i ɾ ʌ̹ n
이렇다	i ɾ ʌ̹ tʰ a̠
이력서	iː ɾ j ʌ̹ k s͈ ʌ̹
이론	iː ɾ o̞ n
이롭다	iː ɾ o̞ p̚ t͈ a̠
이루다	i ɾ u d a̠
이르다	i ɾ ɯ d a̠
이름	i ɾ ɯ m
이리	i ɾ i
이마	i m a̠
이맘	i m a̠ m
이메일	i m e̞ i ɭ
이며	i m j ʌ̹
이명	iː m j ʌ̹ ŋ
이모	i m o̞
이모부	i m o̞ b u
이목구비	iː m o̞ k̚ k͈ u b i
이물	i m u ɭ
이미	iː m i
이미다졸	i m i d a̠ d͡ʑ o̞ ɭ
이미지	i m i d͡ʑ i
이민	i m i n
이발	iː b a̠ ɭ
이발사	iː b a̠ ɭ sʰ a̠
이발소	iː b a̠ ɭ s͈ o̞
이번	i b ʌ̹ n
이벤트	i b e̞ n tʰ ɯ
이별	iː b j ʌ̹ ɭ
이분	i b u n
이불	i b u ɭ
이빨	i p͈ a̠ ɭ
이사야	i sʰ a̠ j a̠
이사회	iː sʰ a̠ β w e̞
이산화탄소	iː sʰ a̠ n β w a̠ tʰ a̠ n sʰ o̞
이삼	iː sʰ a̠ m
이상	iː sʰ a̠ ŋ
이상하다	iː sʰ a̠ ŋ ɦ a̠ d a̠
이성	iː sʰ ʌ̹ ŋ
이스라엘	i sʰ ɯ ɾ a̠ e̞ ɭ
이스마엘	i sʰ ɯ m a̠ e̞ ɭ
이스탄불	i sʰ ɯ tʰ a̠ n b u ɭ
이슬라마바드	i sʰ ɯ ɭ ɭ a̠ m a̠ b a̠ d ɯ
이슬람	i sʰ ɯ ɭ ɭ a̠ m
이슬람교	i sʰ ɯ ɭ ɭ a̠ m ɡ j o
이슬람국가	i sʰ ɯ ɭ ɭ a̠ m ɡ u k̚ k͈ a̠
이승	i sʰ ɯ ŋ
이신론	i ɕʰ i n n o̞ n
이심전심	iː ɕʰ i m d͡ʑ ʌ̹ n ɕʰ i m
이십	iː ɕʰ i p̚
이야	i j a̠
이야기	i j a̠ ɡ i
이야기하다	i j a̠ ɡ i ɦ a̠ d a̠
이어	i ʌ̹
이어지다	i ʌ̹ d͡ʑ i d a̠
이어폰	i ʌ̹ pʰ o̞ n
이엉	i ʌ̹ ŋ
이외	iː w e̞
이용	iː j o ŋ
이용되다	iː j o ŋ d w e̞ d a̠
이용자	iː j o ŋ d͡ʑ a̠
이용하다	iː j o ŋ ɦ a̠ d a̠
이웃	i u t̚
이웃집	i u t̚ t͡ɕ͈ i p̚
이윽고	i ɯ k̚ k͈ o̞
이익	iː i k̚
이자	i d͡ʑ a̠
이장	i d͡ʑ a̠ ŋ
이전	iː d͡ʑ ʌ̹ n
이점	iː d͡ʑ ʌ̹ m
이제	i d͡ʑ e̞
이주	i d͡ʑ u
이진법	iː d͡ʑ i n p͈ ʌ̹ p̚
이질	iː d͡ʑ i ɭ
이집트	i d͡ʑ i p̚ tʰ ɯ
이쪽	i t͡ɕ͈ o̞ k̚
이체	iː t͡ɕʰ e̞
이탈	iː tʰ a̠ ɭ
이튿날	i tʰ ɯ n n a̠ ɭ
이틀	i tʰ ɯ ɭ
이하	iː ɦ a̠
이혼	iː β o̞ n
이화우	i β w a̠ u
익룡	i ŋ ɲ j o ŋ
익명	i ŋ m j ʌ̹ ŋ
익사	i k s͈ a̠
익숙하다	i k s͈ u kʰ a̠ d a̠
인간	i n ɡ a̠ n
인격	i n k͈ j ʌ̹ k̚
인공지능	i n ɡ o̞ ŋ d͡ʑ i n ɯ ŋ
인구조사	i n ɡ u d͡ʑ o̞ sʰ a̠
인근	i n ɡ ɯ n
인니	i n n i
인도	i n d o̞
인도네시아	i n d o̞ n e̞ ɕʰ i a̠
인도네시아어	i n d o̞ n e̞ ɕʰ i a̠ ʌ̹
인도양	i n d o̞ j a̠ ŋ
인도차이나	i n d o̞ t͡ɕʰ a̠ i n a̠
인돌	i n d o̞ ɭ
인력거	i ʎ ʎ j ʌ̹ k̚ k͈ ʌ̹
인류	i ʎ ʎ j u
인명	i n m j ʌ̹ ŋ
인문학	i n m u n ɦ a̠ k̚
인사	i n sʰ a̠
인삼	i n sʰ a̠ m
인성	i n sʰ ʌ̹ ŋ
인수	i n sʰ u
인식	i n ɕʰ i k̚
인식론	i n ɕʰ i ŋ n o̞ n
인식표	i n ɕʰ i k̚ pʰ j o
인어	i n ʌ̹
인연	i ɲ j ʌ̹ n
인용하다	i ɲ j o ŋ ɦ a̠ d a̠
인자	i ɲ d͡ʑ a̠
인절미	i ɲ d͡ʑ ʌ̹ ɭ m i
인제	i ɲ d͡ʑ e̞
인종	i ɲ d͡ʑ o̞ ŋ
인종차별	i ɲ d͡ʑ o̞ ŋ t͡ɕʰ a̠ b j ʌ̹ ɭ
인중	i ɲ d͡ʑ u ŋ
인증	i ɲ d͡ʑ ɯ ŋ
인질	i ɲ d͡ʑ i ɭ
인천	i ɲ t͡ɕʰ ʌ̹ n
인출	i ɲ t͡ɕʰ u ɭ
인치	i ɲ t͡ɕʰ i
인터네트	i n tʰ ʌ̹ n e̞ tʰ ɯ
인터뷰	i n tʰ ʌ̹ b j u
인터페이스	i n tʰ ʌ̹ pʰ e̞ i sʰ ɯ
인텔리겐치아	i n tʰ e̞ ʎ ʎ i ɡ e̞ ɲ t͡ɕʰ i a̠
인티파다	i n tʰ i pʰ a̠ d a̠
인플레이션	i n pʰ ɯ ɭ ɭ e̞ i ɕʰ ʌ̹ n
인플루엔자	i n pʰ ɯ ɭ ɭ u e̞ ɲ d͡ʑ a̠
인하	i n ɦ a̠
인하다	i n ɦ a̠ d a̠
인형	i n ʝ j ʌ̹ ŋ
인화지	i n β w a̠ d͡ʑ i
인후	i n β u
일각수	i ɭ ɡ a̠ k s͈ u
일견	i ɭ ɡ j ʌ̹ n
일고여덟	i ɭ ɡ o̞ j ʌ̹ d ʌ̹ ɭ
일광	i ɭ ɡ w a̠ ŋ
일국	i ɭ ɡ u k̚
일군	i ɭ k͈ u n
일그러지다	i ɭ ɡ ɯ ɾ ʌ̹ d͡ʑ i d a̠
일기	i ɭ ɡ i
일꾼	i ɭ k͈ u n
일년	i ʎ ʎ j ʌ̹ n
일단	i ɭ t͈ a̠ n
일동	i ɭ t͈ o̞ ŋ
일러두기	i ɭ ɭ ʌ̹ d u ɡ i
일문	i ɭ m u n
일반	i ɭ b a̠ n
일반인	i ɭ b a̠ n i n
일반적	i ɭ b a̠ ɲ d͡ʑ ʌ̹ k̚
일보	i ɭ b o̞
일본어	i ɭ b o̞ n ʌ̹
일본인	i ɭ b o̞ n i n
일본주	i ɭ b o̞ ɲ d͡ʑ u
일본학	i ɭ b o̞ n ɦ a̠ k̚
일부	i ɭ b u
일부러	iː ɭ b u ɾ ʌ̹
일사천리	i ɭ s͈ a̠ t͡ɕʰ ʌ̹ ʎ ʎ i
일시적	i ɭ ɕʰ i d͡ʑ ʌ̹ k̚
일쑤	i ɭ s͈ u
일어나다	i ɾ ʌ̹ n a̠ d a̠
일어서다	i ɾ ʌ̹ sʰ ʌ̹ d a̠
일왕	i ɾ w a̠ ŋ
일요일	i ɾ j o i ɭ
일원	i ɾ w ʌ̹ n
일월	i ɾ w ʌ̹ ɭ
일이	i ɾ i
일인칭	i ɾ i ɲ t͡ɕʰ i ŋ
일자	i ʎ t͡ɕ͈ a̠
일정	i ʎ t͡ɕ͈ ʌ̹ ŋ
일정하다	i ʎ d͡ʑ ʌ̹ ŋ ɦ a̠ d a̠
일종	i ʎ t͡ɕ͈ o̞ ŋ
일주일	i ʎ t͡ɕ͈ u i ɭ
일찍이	i ʎ t͡ɕ͈ i ɡ i
일천	i ʎ t͡ɕʰ ʌ̹ n
일체	i ʎ t͡ɕʰ e̞
일출	i ʎ t͡ɕʰ u ɭ
일취월장	i ʎ t͡ɕʰ ɥ i w ʌ̹ ʎ d͡ʑ a̠ ŋ
일치	i ʎ t͡ɕʰ i
일치하다	i ʎ t͡ɕʰ i ɦ a̠ d a̠
일하다	iː ɾ ɦ a̠ d a̠
일흔	i ɾ ɣ ɯ n
읽다	i k̚ t͈ a̠
잃다	i ɭ tʰ a̠
임기	i m ɡ i
임마누엘	i m m a̠ n u e̞ ɭ
임명	i m m j ʌ̹ ŋ
임무	iː m m u
임부	iː m b u
임시	i m ɕʰ i
임신	iː m ɕʰ i n
임신부	iː m ɕʰ i n b u
임실납자루	i m ɕʰ i ɭ ɭ a̠ p̚ t͡ɕ͈ a̠ ɾ u
임자	iː m d͡ʑ a̠
임질	i m d͡ʑ i ɭ
입구	i p̚ k͈ u
입금	i p̚ k͈ ɯ m
입다	i p̚ t͈ a̠
입덧	i p̚ t͈ ʌ̹ t̚
입력	i m ɲ j ʌ̹ k̚
입법	i p̚ p͈ ʌ̹ p̚
입빠이	i p̚ p͈ a̠ i
입성	i p s͈ ʌ̹ ŋ
입술	i p s͈ u ɭ
입시	i p ɕ͈ i
입양	i b j a̠ ŋ
입장	i p̚ t͡ɕ͈ a̠ ŋ
입장료	i p̚ t͡ɕ͈ a̠ ŋ ɲ j o
잇다	iː t̚ t͈ a̠
있다	i t̚ t͈ a̠
있어	i s͈ ʌ̹
잉부	iː ŋ b u
잉어	iː ŋ ʌ̹
잉여	iː ŋ j ʌ̹
잊어버리다	i d͡ʑ ʌ̹ b ʌ̹ ɾ i d a̠
잊히다	i t͡ɕʰ i d a̠
자가사리	t͡ɕ a̠ ɡ a̠ sʰ a̠ ɾ i
자가용차	t͡ɕ a̠ ɡ a̠ j o ŋ t͡ɕʰ a̠
자갈	t͡ɕ a̠ ɡ a̠ ɭ
자강도	t͡ɕ a̠ ɡ a̠ ŋ d o̞
자격	t͡ɕ a̠ ɡ j ʌ̹ k̚
자그레브	t͡ɕ a̠ ɡ ɯ ɾ e̞ b ɯ
자극	t͡ɕ a̠ː ɡ ɯ k̚
자기절로	t͡ɕ a̠ ɡ i d͡ʑ ʌ̹ ɭ ɭ o̞
자꾸	t͡ɕ a̠ k͈ u
자꾸만	t͡ɕ a̠ k͈ u m a̠ n
자낳괴	t͡ɕ a̠ n a̠ ɡ w e̞
자네	t͡ɕ a̠ n e̞
자다	t͡ɕ a̠ d a̠
자동	t͡ɕ a̠ d o̞ ŋ
자동차	t͡ɕ a̠ d o̞ ŋ t͡ɕʰ a̠
자동화	t͡ɕ a̠ d o̞ ŋ β w a̠
자두나무	t͡ɕ a̠ d u n a̠ m u
자라다	t͡ɕ a̠ ɾ a̠ d a̠
자랑	t͡ɕ a̠ ɾ a̠ ŋ
자랑스럽다	t͡ɕ a̠ ɾ a̠ ŋ sʰ ɯ ɾ ʌ̹ p̚ t͈ a̠
자료	t͡ɕ a̠ ɾ j o
자리	t͡ɕ a̠ ɾ i
자막	t͡ɕ a̠ m a̠ k̚
자만	t͡ɕ a̠ m a̠ n
자메이카	t͡ɕ a̠ m e̞ i kʰ a̠
자명금	t͡ɕ a̠ m j ʌ̹ ŋ ɡ ɯ m
자명종	t͡ɕ a̠ m j ʌ̹ ŋ d͡ʑ o̞ ŋ
자몽	t͡ɕ a̠ m o̞ ŋ
자물쇠	t͡ɕ a̠ m u ɭ s͈ w e̞
자본	t͡ɕ a̠ b o̞ n
자본주의	t͡ɕ a̠ b o̞ ɲ d͡ʑ u ɰ i
자비	t͡ɕ a̠ b i
자뻑	t͡ɕ a̠ p͈ ʌ̹ k̚
자산	t͡ɕ a̠ sʰ a̠ n
자살	t͡ɕ a̠ sʰ a̠ ɭ
자석	t͡ɕ a̠ː sʰ ʌ̹ k̚
자세	t͡ɕ a̠ sʰ e̞
자세하다	t͡ɕ a̠ sʰ e̞ ɦ a̠ d a̠
자세히	t͡ɕ a̠ sʰ e̞ ʝ i
자손	t͡ɕ a̠ sʰ o̞ n
자시다	t͡ɕ a̠ː ɕʰ i d a̠
자식	t͡ɕ a̠ ɕʰ i k̚
자신	t͡ɕ a̠ ɕʰ i n
자아	t͡ɕ a̠ a̠
자업자득	t͡ɕ a̠ ʌ̹ p̚ t͡ɕ͈ a̠ d ɯ k̚
자연	t͡ɕ a̠ j ʌ̹ n
자연스럽다	t͡ɕ a̠ j ʌ̹ n sʰ ɯ ɾ ʌ̹ p̚ t͈ a̠
자연환경	t͡ɕ a̠ j ʌ̹ n β w a̠ n ɡ j ʌ̹ ŋ
자외	t͡ɕ a̠ w e̞
자원	t͡ɕ a̠ w ʌ̹ n
자유적	t͡ɕ a̠ j u d͡ʑ ʌ̹ k̚
자유주의	t͡ɕ a̠ j u d͡ʑ u ɰ i
자유지상주의	t͡ɕ a̠ j u d͡ʑ i sʰ a̠ ŋ d͡ʑ u ɰ i
자율	t͡ɕ a̠ j u ɭ
자음	t͡ɕ a̠ ɯ m
자작	t͡ɕ a̠ d͡ʑ a̠ k̚
자장가	t͡ɕ a̠ d͡ʑ a̠ ŋ ɡ a̠
자장면	t͡ɕ a̠ d͡ʑ a̠ ŋ m j ʌ̹ n
자전거	t͡ɕ a̠ d͡ʑ ʌ̹ n ɡ ʌ̹
자제	t͡ɕ a̠ d͡ʑ e̞
자존감	t͡ɕ a̠ d͡ʑ o̞ n ɡ a̠ m
자존심	t͡ɕ a̠ d͡ʑ o̞ n ɕʰ i m
자지	t͡ɕ a̠ː d͡ʑ i
자진	t͡ɕ a̠ d͡ʑ i n
자진하다	t͡ɕ a̠ d͡ʑ i n ɦ a̠ d a̠
자체	t͡ɕ a̠ t͡ɕʰ e̞
자취	t͡ɕ a̠ t͡ɕʰ ɥ i
자칫하면	t͡ɕ a̠ t͡ɕʰ i tʰ a̠ m j ʌ̹ n
자칼	t͡ɕ a̠ kʰ a̠ ɭ
자타공인	t͡ɕ a̠ tʰ a̠ ɡ o̞ ŋ i n
자판	t͡ɕ a̠ pʰ a̠ n
자판기	t͡ɕ a̠ pʰ a̠ n ɡ i
자폐증	t͡ɕ a̠ pʰ j e̞ t͡ɕ͈ ɯ ŋ
작가	t͡ɕ a̠ k̚ k͈ a̠
작곡	t͡ɕ a̠ k̚ k͈ o̞ k̚
작곡가	t͡ɕ a̠ k̚ k͈ o̞ k̚ k͈ a̠
작곡자	t͡ɕ a̠ k̚ k͈ o̞ k̚ t͡ɕ͈ a̠
작년	t͡ɕ a̠ ŋ ɲ j ʌ̹ n
작다	t͡ɕ a̠ː k̚ t͈ a̠
작렬	t͡ɕ a̠ ŋ ɲ j ʌ̹ ɭ
작별	t͡ɕ a̠ k̚ p͈ j ʌ̹ ɭ
작심삼일	t͡ɕ a̠ k ɕ͈ i m sʰ a̠ m i ɭ
작업복	t͡ɕ a̠ ɡ ʌ̹ p̚ p͈ o̞ k̚
작업실	t͡ɕ a̠ ɡ ʌ̹ p ɕ͈ i ɭ
작용	t͡ɕ a̠ ɡ j o ŋ
작은	t͡ɕ a̠ ɡ ɯ n
작은관코박쥐	t͡ɕ a̠ ɡ ɯ n ɡ w a̠ n kʰ o̞ b a̠ k̚ t͡ɕ͈ ɥ i
작은땃쥐	t͡ɕ a̠ ɡ ɯ n t͈ a̠ t̚ t͡ɕ͈ ɥ i
작은아버지	t͡ɕ a̠ ɡ ɯ n a̠ b ʌ̹ d͡ʑ i
작전	t͡ɕ a̠ k̚ t͡ɕ͈ ʌ̹ n
작품	t͡ɕ a̠ k̚ pʰ u m
잔나비	t͡ɕ a̠ n n a̠ b i
잔돈	t͡ɕ a̠ n d o̞ n
잔디	t͡ɕ a̠ n d i
잔디밭	t͡ɕ a̠ n d i b a̠ t̚
잔류	t͡ɕ a̠ ʎ ʎ j u
잔소리	t͡ɕ a̠ n sʰ o̞ ɾ i
잔잔하다	t͡ɕ a̠ ɲ d͡ʑ a̠ n ɦ a̠ d a̠
잔칫집	t͡ɕ a̠ ɲ t͡ɕʰ i t̚ t͡ɕ͈ i p̚
잔혹	t͡ɕ a̠ n β o̞ k̚
잘못	t͡ɕ a̠ ɭ m o̞ t̚
잘못되다	t͡ɕ a̠ ɭ m o̞ t̚ t͈ w e̞ d a̠
잘잘못	t͡ɕ a̠ ʎ d͡ʑ a̠ ɭ m o̞ t̚
잠그다	t͡ɕ a̠ m ɡ ɯ d a̠
잠깐	t͡ɕ a̠ m k͈ a̠ n
잠두	t͡ɕ a̠ m d u
잠들다	t͡ɕ a̠ m d ɯ ɭ d a̠
잠망경	t͡ɕ a̠ m m a̠ ŋ ɡ j ʌ̹ ŋ
잠바	t͡ɕ a̠ m b a̠
잠비아	t͡ɕ a̠ m b i a̠
잠수함	t͡ɕ a̠ m sʰ u ɦ a̠ m
잠시	t͡ɕ a̠ː m ɕʰ i
잠열	t͡ɕ a̠ m j ʌ̹ ɭ
잠자다	t͡ɕ a̠ m d͡ʑ a̠ d a̠
잠자코	t͡ɕ a̠ m d͡ʑ a̠ kʰ o̞
잡년	t͡ɕ a̠ m ɲ j ʌ̹ n
잡다	t͡ɕ a̠ p̚ t͈ a̠
잡수시다	t͡ɕ a̠ p s͈ u ɕʰ i d a̠
잡종	t͡ɕ a̠ p̚ t͡ɕ͈ o̞ ŋ
잡지	t͡ɕ a̠ p̚ t͡ɕ͈ i
잡초	t͡ɕ a̠ p̚ t͡ɕʰ o̞
장관	t͡ɕ a̠ː ŋ ɡ w a̠ n
장교	t͡ɕ a̠ː ŋ ɡ j o
장군	t͡ɕ a̠ ŋ ɡ u n
장군석	t͡ɕ a̠ ŋ ɡ u n sʰ ʌ̹ k̚
장난	t͡ɕ a̠ ŋ n a̠ n
장난감	t͡ɕ a̠ ŋ n a̠ n k͈ a̠ m
장려금	t͡ɕ a̠ː ŋ ɲ j ʌ̹ ɡ ɯ m
장로교	t͡ɕ a̠ː ŋ n o̞ ɡ j o
장로교회	t͡ɕ a̠ː ŋ n o̞ ɡ j o β w e̞
장면	t͡ɕ a̠ ŋ m j ʌ̹ n
장모	t͡ɕ a̠ː ŋ m o̞
장모님	t͡ɕ a̠ː ŋ m o̞ n i m
장물	t͡ɕ a̠ ŋ m u ɭ
장미	t͡ɕ a̠ ŋ m i
장보다	t͡ɕ a̠ ŋ b o̞ d a̠
장비	t͡ɕ a̠ ŋ b i
장사	t͡ɕ a̠ ŋ sʰ a̠
장석	t͡ɕ a̠ ŋ sʰ ʌ̹ k̚
장소	t͡ɕ a̠ ŋ sʰ o̞
장승	t͡ɕ a̠ ŋ sʰ ɯ ŋ
장식하다	t͡ɕ a̠ ŋ ɕʰ i kʰ a̠ d a̠
장쑤	t͡ɕ a̠ ŋ s͈ u
장어	t͡ɕ a̠ ŋ ʌ̹
장작	t͡ɕ a̠ ŋ d͡ʑ a̠ k̚
장정	t͡ɕ a̠ ŋ d͡ʑ ʌ̹ ŋ
장치	t͡ɕ a̠ ŋ t͡ɕʰ i
장학금	t͡ɕ a̠ː ŋ ɦ a̠ k̚ k͈ ɯ m
잦다	t͡ɕ a̠ t̚ t͈ a̠
재작년	t͡ɕ ɛː d͡ʑ a̠ ŋ ɲ j ʌ̹ n
저거	t͡ɕ ʌ̹ ɡ ʌ̹
저것	t͡ɕ ʌ̹ ɡ ʌ̹ t̚
저고리	t͡ɕ ʌ̹ ɡ o̞ ɾ i
저곳	t͡ɕ ʌ̹ ɡ o̞ t̚
저금통	t͡ɕ ɘː ɡ ɯ m tʰ o̞ ŋ
저급	t͡ɕ ɘː ɡ ɯ p̚
저기	t͡ɕ ʌ̹ ɡ i
저널리스트	t͡ɕ ʌ̹ n ʌ̹ ʎ ʎ i sʰ ɯ tʰ ɯ
저렇게	t͡ɕ ʌ̹ ɾ ʌ̹ kʰ e̞
저력	t͡ɕ ɘː ɾ j ʌ̹ k̚
저분	t͡ɕ ʌ̹ b u n
저수지	t͡ɕ ɘː sʰ u d͡ʑ i
저승사자	t͡ɕ ʌ̹ sʰ ɯ ŋ sʰ a̠ d͡ʑ a̠
저작권	t͡ɕ ɘː d͡ʑ a̠ k̚ k͈ w ʌ̹ n
저장	t͡ɕ ʌ̹ d͡ʑ a̠ ŋ
저절로	t͡ɕ ʌ̹ d͡ʑ ʌ̹ ɭ ɭ o̞
저주	t͡ɕ ɘː d͡ʑ u
저지르다	t͡ɕ ʌ̹ d͡ʑ i ɾ ɯ d a̠
저지하다	t͡ɕ ʌ̹ d͡ʑ i ɦ a̠ d a̠
저쪽	t͡ɕ ʌ̹ t͡ɕ͈ o̞ k̚
저축	t͡ɕ ɘː t͡ɕʰ u k̚
저편	t͡ɕ ʌ̹ pʰ j ʌ̹ n
저항	t͡ɕ ɘː ɦ a̠ ŋ
저항기	t͡ɕ ʌ̹ ɦ a̠ ŋ ɡ i
저희	t͡ɕ ʌ̹ ʝ i
적군	t͡ɕ ʌ̹ k̚ k͈ u n
적극	t͡ɕ ʌ̹ k̚ k͈ ɯ k̚
적나라	t͡ɕ ʌ̹ ŋ n a̠ ɾ a̠
적당하다	t͡ɕ ʌ̹ k̚ t͈ a̠ ŋ ɦ a̠ d a̠
적도	t͡ɕ ʌ̹ k̚ t͈ o̞
적반하장	t͡ɕ ʌ̹ k̚ p͈ a̠ n ɦ a̠ d͡ʑ a̠ ŋ
적분	t͡ɕ ʌ̹ k̚ p͈ u n
적어도	t͡ɕ ɘː ɡ ʌ̹ d o̞
적외	t͡ɕ ʌ̹ ɡ w e̞
적외선	t͡ɕ ʌ̹ ɡ w e̞ sʰ ʌ̹ n
적용	t͡ɕ ʌ̹ ɡ j o ŋ
적용되다	t͡ɕ ʌ̹ ɡ j o ŋ d w e̞ d a̠
적용하다	t͡ɕ ʌ̹ ɡ j o ŋ ɦ a̠ d a̠
적응도	t͡ɕ ʌ̹ ɡ ɯ ŋ d o̞
적의	t͡ɕ ʌ̹ ɡ ɰ i
적자	t͡ɕ ʌ̹ k̚ t͡ɕ͈ a̠
적절하다	t͡ɕ ʌ̹ k̚ t͡ɕ͈ ʌ̹ ɾ ɦ a̠ d a̠
적포도주	t͡ɕ ʌ̹ k̚ pʰ o̞ d o̞ d͡ʑ u
전갈	t͡ɕ ʌ̹ n ɡ a̠ ɭ
전골	t͡ɕ ɘː n ɡ o̞ ɭ
전공	t͡ɕ ʌ̹ n ɡ o̞ ŋ
전구	t͡ɕ ɘː n ɡ u
전국적	t͡ɕ ʌ̹ n ɡ u k̚ t͡ɕ͈ ʌ̹ k̚
전기	t͡ɕ ɘː n ɡ i
전날	t͡ɕ ʌ̹ n n a̠ ɭ
전도서	t͡ɕ ʌ̹ n d o̞ sʰ ʌ̹
전등	t͡ɕ ɘː n d ɯ ŋ
전라남도	t͡ɕ ʌ̹ ɭ ɭ a̠ n a̠ m d o̞
전라도	t͡ɕ ʌ̹ ɭ ɭ a̠ d o̞
전람회	t͡ɕ ɘː ɭ ɭ a̠ m β w e̞
전략가	t͡ɕ ɘː ʎ ʎ j a̠ k̚ k͈ a̠
전력	t͡ɕ ɘː ʎ ʎ j ʌ̹ k̚
전례	t͡ɕ ʌ̹ ʎ ʎ j e̞
전류	t͡ɕ ɘː ʎ ʎ j u
전리품	t͡ɕ ɘː ʎ ʎ i pʰ u m
전무이사	t͡ɕ ʌ̹ n m u i sʰ a̠
전문	t͡ɕ ʌ̹ n m u n
전문가	t͡ɕ ʌ̹ n m u n ɡ a̠
전문일군	t͡ɕ ʌ̹ n m u n i ɭ ɡ u n
전문화	t͡ɕ ʌ̹ n m u n β w a̠
전반적	t͡ɕ ʌ̹ n b a̠ ɲ d͡ʑ ʌ̹ k̚
전보	t͡ɕ ɘː n b o̞
전복	t͡ɕ ʌ̹ n b o̞ k̚
전부	t͡ɕ ʌ̹ n b u
전상장골극	t͡ɕ ʌ̹ n sʰ a̠ ŋ d͡ʑ a̠ ŋ ɡ o̞ ɭ ɡ ɯ k̚
전설	t͡ɕ ɘː n sʰ ʌ̹ ɭ
전술	t͡ɕ ɘː n sʰ u ɭ
전신	t͡ɕ ɘː n ɕʰ i n
전신케블	t͡ɕ ɘː n ɕʰ i n kʰ e̞ b ɯ ɭ
전업	t͡ɕ ʌ̹ n ʌ̹ p̚
전역	t͡ɕ ɘː ɲ j ʌ̹ k̚
전염병	t͡ɕ ʌ̹ ɲ j ʌ̹ m p͈ j ʌ̹ ŋ
전우	t͡ɕ ʌ̹ n u
전율	t͡ɕ ɘː ɲ j u ɭ
전율하다	t͡ɕ ɘː ɲ j u ɾ ɦ a̠ d a̠
전이	t͡ɕ ɘː n i
전자	t͡ɕ ɘː ɲ d͡ʑ a̠
전자우편	t͡ɕ ʌ̹ ɲ d͡ʑ a̠ u pʰ j ʌ̹ n
전장	t͡ɕ ɘː ɲ d͡ʑ a̠ ŋ
전주	t͡ɕ ʌ̹ ɲ d͡ʑ u
전지	t͡ɕ ɘː ɲ d͡ʑ i
전진	t͡ɕ ʌ̹ ɲ d͡ʑ i n
전진하다	t͡ɕ ʌ̹ ɲ d͡ʑ i n ɦ a̠ d a̠
전차	t͡ɕ ɘː ɲ t͡ɕʰ a̠
전체	t͡ɕ ʌ̹ ɲ t͡ɕʰ e̞
전체주의	t͡ɕ ʌ̹ ɲ t͡ɕʰ e̞ d͡ʑ u ɰ i
전통	t͡ɕ ʌ̹ n tʰ o̞ ŋ
전투	t͡ɕ ʌ̹ n tʰ u
전하	t͡ɕ ʌ̹ n ɦ a̠
전하다	t͡ɕ ʌ̹ n ɦ a̠ d a̠
전학	t͡ɕ ɘː n ɦ a̠ k̚
전한	t͡ɕ ʌ̹ n ɦ a̠ n
전함	t͡ɕ ʌ̹ n ɦ a̠ m
전혀	t͡ɕ ʌ̹ n ʝ j ʌ̹
전화기	t͡ɕ ɘː n β w a̠ ɡ i
전화번호	t͡ɕ ʌ̹ n β w a̠ b ʌ̹ n β o̞
전환	t͡ɕ ɘː n β w a̠ n
전후	t͡ɕ ʌ̹ n β u
절감	t͡ɕ ʌ̹ ɭ ɡ a̠ m
절다	t͡ɕ ɘː ɭ d a̠
절로	t͡ɕ ʌ̹ ɭ ɭ o̞
절망	t͡ɕ ʌ̹ ɭ m a̠ ŋ
절반	t͡ɕ ʌ̹ ɭ b a̠ n
절벽	t͡ɕ ʌ̹ ɭ b j ʌ̹ k̚
절약	t͡ɕ ʌ̹ ɾ j a̠ k̚
절이다	t͡ɕ ʌ̹ ɾ i d a̠
절차	t͡ɕ ʌ̹ ʎ t͡ɕʰ a̠
젊다	t͡ɕ ɘː m t͈ a̠
젊은이	t͡ɕ ʌ̹ ɭ m ɯ n i
젊음	t͡ɕ ɘː ɭ m ɯ m
점검	t͡ɕ ʌ̹ m ɡ ʌ̹ m
점막	t͡ɕ ɘː m m a̠ k̚
점수	t͡ɕ ʌ̹ m s͈ u
점심	t͡ɕ ɘː m ɕʰ i m
점원	t͡ɕ ɘː m w ʌ̹ n
점입가경	t͡ɕ ɘː m i p̚ k͈ a̠ ɡ j ʌ̹ ŋ
점점	t͡ɕ ɘː m d͡ʑ ʌ̹ m
점주	t͡ɕ ʌ̹ m d͡ʑ u
점줄망둑	t͡ɕ ʌ̹ m d͡ʑ u ɭ m a̠ ŋ d u k̚
점차	t͡ɕ ɘː m t͡ɕʰ a̠
접골	t͡ɕ ʌ̹ p̚ k͈ o̞ ɭ
접근	t͡ɕ ʌ̹ p̚ k͈ ɯ n
접근하다	t͡ɕ ʌ̹ p̚ k͈ ɯ n ɦ a̠ d a̠
접미사	t͡ɕ ʌ̹ m m i sʰ a̠
접선	t͡ɕ ʌ̹ p s͈ ʌ̹ n
접속	t͡ɕ ʌ̹ p s͈ o̞ k̚
접수처	t͡ɕ ʌ̹ p s͈ u t͡ɕʰ ʌ̹
접수하다	t͡ɕ ʌ̹ p s͈ u ɦ a̠ d a̠
접시	t͡ɕ ʌ̹ p ɕ͈ i
접전	t͡ɕ ʌ̹ p̚ t͡ɕ͈ ʌ̹ n
접촉	t͡ɕ ʌ̹ p̚ t͡ɕʰ o̞ k̚
젓가락질	t͡ɕ ʌ̹ t̚ k͈ a̠ ɾ a̠ k̚ t͡ɕ͈ i ɭ
젓갈	t͡ɕ ʌ̹ t̚ k͈ a̠ ɭ
정가	t͡ɕ ɘː ŋ k͈ a̠
정거장	t͡ɕ ʌ̹ ŋ ɡ ʌ̹ d͡ʑ a̠ ŋ
정겹다	t͡ɕ ʌ̹ ŋ ɡ j ʌ̹ p̚ t͈ a̠
정관사	t͡ɕ ɘː ŋ ɡ w a̠ n sʰ a̠
정교회	t͡ɕ ɘː ŋ ɡ j o β w e̞
정구	t͡ɕ ʌ̹ ŋ ɡ u
정권	t͡ɕ ʌ̹ ŋ k͈ w ʌ̹ n
정규	t͡ɕ ɘː ŋ ɡ j u
정글	t͡ɕ ʌ̹ ŋ ɡ ɯ ɭ
정기	t͡ɕ ɘː ŋ ɡ i
정년	t͡ɕ ʌ̹ ŋ ɲ j ʌ̹ n
정녕	t͡ɕ ʌ̹ ŋ ɲ j ʌ̹ ŋ
정답	t͡ɕ ɘː ŋ d a̠ p̚
정답다	t͡ɕ ʌ̹ ŋ d a̠ p̚ t͈ a̠
정량	t͡ɕ ɘː ŋ ɲ j a̠ ŋ
정류장	t͡ɕ ʌ̹ ŋ ɲ j u d͡ʑ a̠ ŋ
정리	t͡ɕ ʌ̹ ŋ n i
정말	t͡ɕ ɘː ŋ m a̠ ɭ
정말로	t͡ɕ ɘː ŋ m a̠ ɭ ɭ o̞
정면	t͡ɕ ɘː ŋ m j ʌ̹ n
정보	t͡ɕ ʌ̹ ŋ b o̞
정부	t͡ɕ ʌ̹ ŋ b u
정비	t͡ɕ ɘː ŋ b i
정비공	t͡ɕ ɘː ŋ b i ɡ o̞ ŋ
정상치	t͡ɕ ɘː ŋ sʰ a̠ ŋ t͡ɕʰ i
정상회담	t͡ɕ ʌ̹ ŋ sʰ a̠ ŋ β w e̞ d a̠ m
정서	t͡ɕ ʌ̹ ŋ sʰ ʌ̹
정성	t͡ɕ ʌ̹ ŋ sʰ ʌ̹ ŋ
정수	t͡ɕ ʌ̹ ŋ sʰ u
정수리	t͡ɕ ʌ̹ ŋ sʰ u ɾ i
정식	t͡ɕ ɘː ŋ ɕʰ i k̚
정신	t͡ɕ ʌ̹ ŋ ɕʰ i n
정신병자	t͡ɕ ʌ̹ ŋ ɕʰ i n p͈ j ʌ̹ ŋ d͡ʑ a̠
정신분열증	t͡ɕ ʌ̹ ŋ ɕʰ i n p u ɲ j ʌ̹ ʎ t͡ɕ͈ ɯ ŋ
정신적	t͡ɕ ʌ̹ ŋ ɕʰ i ɲ d͡ʑ ʌ̹ k̚
정오	t͡ɕ ɘː ŋ o̞
정욕	t͡ɕ ʌ̹ ŋ j o k̚
정원	t͡ɕ ʌ̹ ŋ w ʌ̹ n
정월	t͡ɕ ʌ̹ ŋ w ʌ̹ ɭ
정유	t͡ɕ ʌ̹ ŋ j u
정육점	t͡ɕ ʌ̹ ŋ j u k̚ t͡ɕ͈ ʌ̹ m
정은	t͡ɕ ɘː ŋ ɯ n
정음	t͡ɕ ʌ̹ ŋ ɯ m
정장	t͡ɕ ɘː ŋ d͡ʑ a̠ ŋ
정적분	t͡ɕ ʌ̹ ŋ d͡ʑ ʌ̹ k̚ p͈ u n
정전	t͡ɕ ʌ̹ ŋ d͡ʑ ʌ̹ n
정제	t͡ɕ ʌ̹ ŋ d͡ʑ e̞
정조	t͡ɕ ʌ̹ ŋ d͡ʑ o̞
정주	t͡ɕ ɘː ŋ d͡ʑ u
정지	t͡ɕ ʌ̹ ŋ d͡ʑ i
정직	t͡ɕ ɘː ŋ d͡ʑ i k̚
정직하다	t͡ɕ ɘː ŋ d͡ʑ i kʰ a̠ d a̠
정치가	t͡ɕ ʌ̹ ŋ t͡ɕʰ i ɡ a̠
정치권	t͡ɕ ʌ̹ ŋ t͡ɕʰ i k͈ w ʌ̹ n
정치인	t͡ɕ ʌ̹ ŋ t͡ɕʰ i i n
정치판	t͡ɕ ʌ̹ ŋ t͡ɕʰ i pʰ a̠ n
정치학	t͡ɕ ʌ̹ ŋ t͡ɕʰ i ɦ a̠ k̚
정치학자	t͡ɕ ʌ̹ ŋ t͡ɕʰ i ɦ a̠ k̚ t͡ɕ͈ a̠
정크푸드	t͡ɕ ʌ̹ ŋ k x ɯ pʰ u d ɯ
정확하다	t͡ɕ ɘː ŋ β w a̠ kʰ a̠ d a̠
정황	t͡ɕ ʌ̹ ŋ β w a̠ ŋ
젖가공품	t͡ɕ ʌ̹ t̚ k͈ a̠ ɡ o̞ ŋ pʰ u m
젖꼭지	t͡ɕ ʌ̹ t̚ k͈ o̞ k̚ t͡ɕ͈ i
젖다	t͡ɕ ʌ̹ t̚ t͈ a̠
젖당못견딤증	t͡ɕ ʌ̹ t̚ t͈ a̠ ŋ m o̞ t̚ k͈ j ʌ̹ n d i m d͡ʑ ɯ ŋ
젖먹이	t͡ɕ ʌ̹ n m ʌ̹ ɡ i
젖통	t͡ɕ ʌ̹ t̚ tʰ o̞ ŋ
제거	t͡ɕ e̞ ɡ ʌ̹
제거하다	t͡ɕ e̞ ɡ ʌ̹ ɦ a̠ d a̠
제공	t͡ɕ e̞ ɡ o̞ ŋ
제공하다	t͡ɕ e̞ ɡ o̞ ŋ ɦ a̠ d a̠
제과점	t͡ɕ e̞ː ɡ w a̠ d͡ʑ ʌ̹ m
제국주의	t͡ɕ e̞ː ɡ u k̚ t͡ɕ͈ u ɰ i
제기랄	t͡ɕ e̞ː ɡ i ɾ a̠ ɭ
제기차기	t͡ɕ e̞ ɡ i t͡ɕʰ a̠ ɡ i
제노바	t͡ɕ e̞ n o̞ b a̠
제단	t͡ɕ e̞ː d a̠ n
제로	t͡ɕ e̞ ɾ o̞
제명	t͡ɕ e̞ m j ʌ̹ ŋ
제물	t͡ɕ e̞ m u ɭ
제발	t͡ɕ e̞ː b a̠ ɭ
제법	t͡ɕ e̞ b ʌ̹ p̚
제복	t͡ɕ e̞ː b o̞ k̚
제비	t͡ɕ e̞ː b i
제사	t͡ɕ e̞ː sʰ a̠
제설차	t͡ɕ e̞ sʰ ʌ̹ ʎ t͡ɕʰ a̠
제스처	t͡ɕ e̞ sʰ ɯ t͡ɕʰ ʌ̹
제시	t͡ɕ e̞ ɕʰ i
제안	t͡ɕ e̞ a̠ n
제안하다	t͡ɕ e̞ a̠ n ɦ a̠ d a̠
제약	t͡ɕ e̞ː j a̠ k̚
제왕	t͡ɕ e̞ː w a̠ ŋ
제우스	t͡ɕ e̞ u sʰ ɯ
제유	t͡ɕ e̞ j u
제육	t͡ɕ e̞ j u k̚
제의	t͡ɕ e̞ ɰ i
제일	t͡ɕ e̞ː i ɭ
제작	t͡ɕ e̞ː d͡ʑ a̠ k̚
제작자	t͡ɕ e̞ː d͡ʑ a̠ k̚ t͡ɕ͈ a̠
제작하다	t͡ɕ e̞ː d͡ʑ a̠ kʰ a̠ d a̠
제조	t͡ɕ e̞ː d͡ʑ o̞
제조업	t͡ɕ e̞ː d͡ʑ o̞ ʌ̹ p̚
제주	t͡ɕ e̞ː d͡ʑ u
제주도	t͡ɕ e̞ː d͡ʑ u d o̞
제주말	t͡ɕ e̞ː d͡ʑ u m a̠ ɭ
제주시	t͡ɕ e̞ː d͡ʑ u ɕʰ i
제쳐놓다	t͡ɕ e̞ t͡ɕʰ ʌ̹ n o̞ tʰ a̠
제출	t͡ɕ e̞ t͡ɕʰ u ɭ
제출하다	t͡ɕ e̞ t͡ɕʰ u ɾ ɦ a̠ d a̠
제탄	t͡ɕ e̞ː tʰ a̠ n
제트기	t͡ɕ e̞ tʰ ɯ ɡ i
제품	t͡ɕ e̞ː pʰ u m
제한	t͡ɕ e̞ː ɦ a̠ n
젠장	t͡ɕ e̞ː ɲ d͡ʑ a̠ ŋ
젤리	t͡ɕ e̞ ʎ ʎ i
조가비	t͡ɕ o̞ ɡ a̠ b i
조각	t͡ɕ o̞ ɡ a̠ k̚
조각상	t͡ɕ o̞ ɡ a̠ k s͈ a̠ ŋ
조건	t͡ɕ o̞ k͈ ʌ̹ n
조계종	t͡ɕ o̞ ɡ j e̞ d͡ʑ o̞ ŋ
조국	t͡ɕ o̞ ɡ u k̚
조금	t͡ɕ o̞ ɡ ɯ m
조금씩	t͡ɕ o̞ ɡ ɯ m ɕ͈ i k̚
조깅	t͡ɕ o̞ ɡ i ŋ
조끼	t͡ɕ o̞ k͈ i
조랑말	t͡ɕ o̞ ɾ a̠ ŋ m a̠ ɭ
조롱	t͡ɕ o̞ ɾ o̞ ŋ
조롱이	t͡ɕ o̞ ɾ o̞ ŋ i
조류	t͡ɕ o̞ ɾ j u
조림	t͡ɕ o̞ ɾ i m
조미료	t͡ɕ o̞ m i ɾ j o
조반	t͡ɕ o̞ː b a̠ n
조부모	t͡ɕ o̞ b u m o̞
조뼛	t͡ɕ o̞ p͈ j ʌ̹ t̚
조사	t͡ɕ o̞ sʰ a̠
조사하다	t͡ɕ o̞ sʰ a̠ ɦ a̠ d a̠
조산부	t͡ɕ o̞ː sʰ a̠ n b u
조상	t͡ɕ o̞ sʰ a̠ ŋ
조선말	t͡ɕ o̞ sʰ ʌ̹ n m a̠ ɭ
조선민주주의인민공화국	t͡ɕ o̞ sʰ ʌ̹ n m i ɲ d͡ʑ u d͡ʑ u ɰ i i n m i n k o̞ ŋ β w a̠ ɡ u k̚
조선어	t͡ɕ o̞ sʰ ʌ̹ n ʌ̹
조선인	t͡ɕ o̞ sʰ ʌ̹ n i n
조성	t͡ɕ o̞ sʰ ʌ̹ ŋ
조세	t͡ɕ o̞ sʰ e̞
조수	t͡ɕ o̞ː sʰ u
조식	t͡ɕ o̞ ɕʰ i k̚
조심	t͡ɕ o̞ː ɕʰ i m
조어	t͡ɕ o̞ ʌ̹
조예	t͡ɕ o̞ j e̞
조용	t͡ɕ o̞ j o ŋ
조용하다	t͡ɕ o̞ j o ŋ ɦ a̠ d a̠
조용히	t͡ɕ o̞ j o ŋ ʝ i
조우	t͡ɕ o̞ u
조의	t͡ɕ o̞ ɰ i
조이다	t͡ɕ o̞ i d a̠
조작	t͡ɕ o̞ː d͡ʑ a̠ k̚
조절	t͡ɕ o̞ d͡ʑ ʌ̹ ɭ
조종사	t͡ɕ o̞ d͡ʑ o̞ ŋ sʰ a̠
조지아	t͡ɕ o̞ d͡ʑ i a̠
조지아어	t͡ɕ o̞ d͡ʑ i a̠ ʌ̹
조지타운	t͡ɕ o̞ d͡ʑ i tʰ a̠ u n
조직	t͡ɕ o̞ d͡ʑ i k̚
조짐	t͡ɕ o̞ d͡ʑ i m
조차	t͡ɕ o̞ t͡ɕʰ a̠
조치	t͡ɕ o̞ t͡ɕʰ i
조카	t͡ɕ o̞ kʰ a̠
조피볼락	t͡ɕ o̞ pʰ i b o̞ ɭ ɭ a̠ k̚
조합	t͡ɕ o̞ ɦ a̠ p̚
조현병	t͡ɕ o̞ ʝ j ʌ̹ n b j ʌ̹ ŋ
조회	t͡ɕ o̞ː β w e̞
존경	t͡ɕ o̞ n ɡ j ʌ̹ ŋ
존맛	t͡ɕ o̞ n m a̠ t̚
존엄사	t͡ɕ o̞ n ʌ̹ m sʰ a̠
존중	t͡ɕ o̞ ɲ d͡ʑ u ŋ
존중하다	t͡ɕ o̞ ɲ d͡ʑ u ŋ ɦ a̠ d a̠
졸다	t͡ɕ o̞ː ɭ d a̠
졸업식	t͡ɕ o̞ ɾ ʌ̹ p ɕ͈ i k̚
졸음	t͡ɕ o̞ ɾ ɯ m
졸혼	t͡ɕ o̞ ɾ β o̞ n
좀비	t͡ɕ o̞ m b i
좀수수치	t͡ɕ o̞ m sʰ u sʰ u t͡ɕʰ i
좀처럼	t͡ɕ o̞ː m t͡ɕʰ ʌ̹ ɾ ʌ̹ m
좁다	t͡ɕ o̞ p̚ t͈ a̠
종교	t͡ɕ o̞ ŋ ɡ j o
종로	t͡ɕ o̞ ŋ n o̞
종료	t͡ɕ o̞ ŋ ɲ j o
종류	t͡ɕ o̞ː ŋ ɲ j u
종식	t͡ɕ o̞ ŋ ɕʰ i k̚
종아리뼈	t͡ɕ o̞ː ŋ a̠ ɾ i p͈ j ʌ̹
종양	t͡ɕ o̞ː ŋ j a̠ ŋ
종업원	t͡ɕ o̞ ŋ ʌ̹ b w ʌ̹ n
종유석	t͡ɕ o̞ ŋ j u sʰ ʌ̹ k̚
종이	t͡ɕ o̞ ŋ i
종일	t͡ɕ o̞ ŋ i ɭ
종자	t͡ɕ o̞ ŋ d͡ʑ a̠
종족	t͡ɕ o̞ ŋ d͡ʑ o̞ k̚
종종	t͡ɕ o̞ː ŋ d͡ʑ o̞ ŋ
종파	t͡ɕ o̞ ŋ pʰ a̠
종합	t͡ɕ o̞ ŋ ɦ a̠ p̚
종횡	t͡ɕ o̞ ŋ β w e̞ ŋ
좇다	t͡ɕ o̞ t̚ t͈ a̠
좋다	t͡ɕ o̞ː tʰ a̠
좋아지다	t͡ɕ o̞ː a̠ d͡ʑ i d a̠
좋아하다	t͡ɕ o̞ː a̠ ɦ a̠ d a̠
좌석	t͡ɕ w a̠ sʰ ʌ̹ k̚
좌우	t͡ɕ w a̠ː u
좌익수	t͡ɕ w a̠ː i k s͈ u
좌표	t͡ɕ w a̠ː pʰ j o
죄다	t͡ɕ w e̞ː d a̠
죄송	t͡ɕ w e̞ː sʰ o̞ ŋ
죄송하다	t͡ɕ w e̞ː sʰ o̞ ŋ ɦ a̠ d a̠
죄수	t͡ɕ w e̞ sʰ u
죄악	t͡ɕ w e̞ː a̠ k̚
죄인	t͡ɕ w e̞ː i n
주거	t͡ɕ uː ɡ ʌ̹
주고받다	t͡ɕ u ɡ o̞ b a̠ t̚ t͈ a̠
주교	t͡ɕ u ɡ j o
주교관	t͡ɕ u ɡ j o ɡ w a̠ n
주꾸미	t͡ɕ u k͈ u m i
주다	t͡ɕ u d a̠
주도	t͡ɕ u d o̞
주둔	t͡ɕ uː d u n
주로	t͡ɕ u ɾ o̞
주류	t͡ɕ u ɾ j u
주막	t͡ɕ u m a̠ k̚
주말	t͡ɕ u m a̠ ɭ
주머니	t͡ɕ u m ʌ̹ n i
주먹	t͡ɕ u m ʌ̹ k̚
주무르다	t͡ɕ u m u ɾ ɯ d a̠
주무시다	t͡ɕ u m u ɕʰ i d a̠
주문	t͡ɕ uː m u n
주민	t͡ɕ uː m i n
주방	t͡ɕ u b a̠ ŋ
주방장	t͡ɕ u b a̠ ŋ d͡ʑ a̠ ŋ
주사	t͡ɕ uː sʰ a̠
주사기	t͡ɕ uː sʰ a̠ ɡ i
주석	t͡ɕ u sʰ ʌ̹ k̚
주소	t͡ɕ uː sʰ o̞
주스	t͡ɕ u sʰ ɯ
주식	t͡ɕ u ɕʰ i k̚
주식회사	t͡ɕ u ɕʰ i kʰ w e̞ sʰ a̠
주어	t͡ɕ u ʌ̹
주연	t͡ɕ u j ʌ̹ n
주요하다	t͡ɕ u j o ɦ a̠ d a̠
주위	t͡ɕ u ɥ i
주유소	t͡ɕ uː j u sʰ o̞
주인	t͡ɕ u i n
주인공	t͡ɕ u i n ɡ o̞ ŋ
주장	t͡ɕ u d͡ʑ a̠ ŋ
주장하다	t͡ɕ u d͡ʑ a̠ ŋ ɦ a̠ d a̠
주저	t͡ɕ u d͡ʑ ʌ̹
주전자	t͡ɕ u d͡ʑ ʌ̹ ɲ d͡ʑ a̠
주정	t͡ɕ uː d͡ʑ ʌ̹ ŋ
주제	t͡ɕ u d͡ʑ e̞
주중	t͡ɕ u d͡ʑ u ŋ
주차	t͡ɕ uː t͡ɕʰ a̠
주차장	t͡ɕ uː t͡ɕʰ a̠ d͡ʑ a̠ ŋ
주체	t͡ɕ u t͡ɕʰ e̞
주체사상	t͡ɕ u t͡ɕʰ e̞ sʰ a̠ sʰ a̠ ŋ
죽마고우	t͡ɕ u ŋ m a̠ ɡ o̞ u
죽부인	t͡ɕ u k̚ p͈ u i n
죽순	t͡ɕ u k s͈ u n
죽음	t͡ɕ u ɡ ɯ m
죽지	t͡ɕ u k̚ t͡ɕ͈ i
준말	t͡ɕ uː n m a̠ ɭ
준비	t͡ɕ uː n b i
준비하다	t͡ɕ uː n b i ɦ a̠ d a̠
줄곧	t͡ɕ u ɭ ɡ o̞ t̚
줄공치	t͡ɕ u ɭ ɡ o̞ ŋ t͡ɕʰ i
줄기	t͡ɕ u ɭ ɡ i
줄다	t͡ɕ uː ɭ d a̠
줄어들다	t͡ɕ u ɾ ʌ̹ d ɯ ɭ d a̠
줄이다	t͡ɕ u ɾ i d a̠
줍다	t͡ɕ uː p̚ t͈ a̠
중간	t͡ɕ u ŋ ɡ a̠ n
중견수	t͡ɕ u ŋ ɡ j ʌ̹ n sʰ u
중경	t͡ɕ u ŋ ɡ j ʌ̹ ŋ
중계	t͡ɕ u ŋ ɡ j e̞
중고기	t͡ɕ uː ŋ ɡ o̞ ɡ i
중공	t͡ɕ u ŋ ɡ o̞ ŋ
중국어	t͡ɕ u ŋ ɡ u ɡ ʌ̹
중국인	t͡ɕ u ŋ ɡ u ɡ i n
중국학	t͡ɕ u ŋ ɡ u kʰ a̠ k̚
중국화	t͡ɕ u ŋ ɡ u kʰ w a̠
중년	t͡ɕ u ŋ ɲ j ʌ̹ n
중도	t͡ɕ u ŋ d o̞
중독	t͡ɕ u ŋ d o̞ k̚
중량	t͡ɕ uː ŋ ɲ j a̠ ŋ
중립	t͡ɕ u ŋ n i p̚
중문	t͡ɕ u ŋ m u n
중부	t͡ɕ u ŋ b u
중사	t͡ɕ u ŋ sʰ a̠
중성	t͡ɕ u ŋ sʰ ʌ̹ ŋ
중성자	t͡ɕ u ŋ sʰ ʌ̹ ŋ d͡ʑ a̠
중세	t͡ɕ u ŋ sʰ e̞
중심	t͡ɕ u ŋ ɕʰ i m
중앙	t͡ɕ u ŋ a̠ ŋ
중앙아메리카	t͡ɕ u ŋ a̠ ŋ a̠ m e̞ ɾ i kʰ a̠
중요	t͡ɕ uː ŋ j o
중요성	t͡ɕ uː ŋ j o s͈ ʌ̹ ŋ
중요하다	t͡ɕ uː ŋ j o ɦ a̠ d a̠
중위	t͡ɕ u ŋ ɥ i
중죄	t͡ɕ uː ŋ d͡ʑ w e̞
중증	t͡ɕ uː ŋ t͡ɕ͈ ɯ ŋ
중지	t͡ɕ u ŋ d͡ʑ i
중징계	t͡ɕ uː ŋ d͡ʑ i ŋ ɡ j e̞
중학교	t͡ɕ u ŋ ɦ a̠ k̚ k͈ j o
중화	t͡ɕ u ŋ β w a̠
중화민국	t͡ɕ u ŋ β w a̠ m i n ɡ u k̚
쥐창시	t͡ɕ ɥ i t͡ɕʰ a̠ ŋ ɕʰ i
즉시	t͡ɕ ɯ k ɕ͈ i
즐거움	t͡ɕ ɯ ɭ ɡ ʌ̹ u m
즐겁다	t͡ɕ ɯ ɭ ɡ ʌ̹ p̚ t͈ a̠
증가	t͡ɕ ɯ ŋ ɡ a̠
증가하다	t͡ɕ ɯ ŋ ɡ a̠ ɦ a̠ d a̠
증거	t͡ɕ ɯ ŋ ɡ ʌ̹
증권사	t͡ɕ ɯ ŋ k͈ w ʌ̹ n sʰ a̠
증기	t͡ɕ ɯ ŋ ɡ i
증명	t͡ɕ ɯ ŋ m j ʌ̹ ŋ
증명하다	t͡ɕ ɯ ŋ m j ʌ̹ ŋ ɦ a̠ d a̠
증상	t͡ɕ ɯ ŋ sʰ a̠ ŋ
증설	t͡ɕ ɯ ŋ sʰ ʌ̹ ɭ
증설하다	t͡ɕ ɯ ŋ sʰ ʌ̹ ɾ ɦ a̠ d a̠
증언	t͡ɕ ɯ ŋ ʌ̹ n
증여	t͡ɕ ɯ ŋ j ʌ̹
증오	t͡ɕ ɯ ŋ o̞
증오심	t͡ɕ ɯ ŋ o̞ ɕʰ i m
증인	t͡ɕ ɯ ŋ i n
증조	t͡ɕ ɯ ŋ d͡ʑ o̞
증조부	t͡ɕ ɯ ŋ d͡ʑ o̞ b u
증진하다	t͡ɕ ɯ ŋ d͡ʑ i n ɦ a̠ d a̠
증후군	t͡ɕ ɯ ŋ β u ɡ u n
지각	t͡ɕ i ɡ a̠ k̚
지갑	t͡ɕ i ɡ a̠ p̚
지게미	t͡ɕ i ɡ e̞ m i
지겹다	t͡ɕ i ɡ j ʌ̹ p̚ t͈ a̠
지경	t͡ɕ i ɡ j ʌ̹ ŋ
지구	t͡ɕ i ɡ u
지구의	t͡ɕ i ɡ u ɰ i
지국	t͡ɕ i ɡ u k̚
지금	t͡ɕ i ɡ ɯ m
지긋하다	t͡ɕ i ɡ ɯ tʰ a̠ d a̠
지껄이다	t͡ɕ i k͈ ʌ̹ ɾ i d a̠
지나	t͡ɕ i n a̠
지나다	t͡ɕ i n a̠ d a̠
지나치다	t͡ɕ i n a̠ t͡ɕʰ i d a̠
지난	t͡ɕ i n a̠ n
지난번	t͡ɕ i n a̠ n b ʌ̹ n
지난주	t͡ɕ i n a̠ ɲ d͡ʑ u
지니다	t͡ɕ i n i d a̠
지다	t͡ɕ i d a̠
지도자	t͡ɕ i d o̞ d͡ʑ a̠
지랄하다	t͡ɕ i ɾ a̠ ɾ ɦ a̠ d a̠
지렁이	t͡ɕ i ɾ ʌ̹ ŋ i
지뢰	t͡ɕ i ɾ w e̞
지루하다	t͡ɕ i ɾ u ɦ a̠ d a̠
지류	t͡ɕ i ɾ j u
지르코늄	t͡ɕ i ɾ ɯ kʰ o̞ ɲ j u m
지름	t͡ɕ i ɾ ɯ m
지름길	t͡ɕ i ɾ ɯ m ɡ i ɭ
지리산	t͡ɕ i ɾ i sʰ a̠ n
지리학	t͡ɕ i ɾ i ɦ a̠ k̚
지린	t͡ɕ i ɾ i n
지만	t͡ɕ i m a̠ n
지면	t͡ɕ i m j ʌ̹ n
지방	t͡ɕ i b a̠ ŋ
지방산	t͡ɕ i b a̠ ŋ sʰ a̠ n
지복직관	t͡ɕ iː b o̞ k̚ t͡ɕ͈ i k̚ k͈ w a̠ n
지불	t͡ɕ i b u ɭ
지붕	t͡ɕ i b u ŋ
지속적	t͡ɕ i sʰ o̞ k̚ t͡ɕ͈ ʌ̹ k̚
지시하다	t͡ɕ i ɕʰ i ɦ a̠ d a̠
지식	t͡ɕ i ɕʰ i k̚
지식인	t͡ɕ i ɕʰ i ɡ i n
지압	t͡ɕ i a̠ p̚
지역	t͡ɕ i j ʌ̹ k̚
지역사회	t͡ɕ i j ʌ̹ k s͈ a̠ β w e̞
지옥	t͡ɕ i o̞ k̚
지우다	t͡ɕ i u d a̠
지원	t͡ɕ i w ʌ̹ n
지원자	t͡ɕ i w ʌ̹ ɲ d͡ʑ a̠
지위	t͡ɕ i ɥ i
지은이	t͡ɕ i ɯ n i
지저분하다	t͡ɕ i d͡ʑ ʌ̹ b u n ɦ a̠ d a̠
지적하다	t͡ɕ i d͡ʑ ʌ̹ kʰ a̠ d a̠
지점	t͡ɕ i d͡ʑ ʌ̹ m
지정학	t͡ɕ i d͡ʑ ʌ̹ ŋ ɦ a̠ k̚
지줌	t͡ɕ i d͡ʑ u m
지지	t͡ɕ i d͡ʑ i
지진	t͡ɕ i d͡ʑ i n
지질	t͡ɕ i d͡ʑ i ɭ
지출	t͡ɕ i t͡ɕʰ u ɭ
지치다	t͡ɕ iː t͡ɕʰ i d a̠
지칭하다	t͡ɕ i t͡ɕʰ i ŋ ɦ a̠ d a̠
지팡이	t͡ɕ i pʰ a̠ ŋ i
지폐	t͡ɕ i pʰ j e̞
지푸라기	t͡ɕ i pʰ u ɾ a̠ ɡ i
지하	t͡ɕ i ɦ a̠
지하도	t͡ɕ i ɦ a̠ d o̞
지하드	t͡ɕ i ɦ a̠ d ɯ
지하실	t͡ɕ i ɦ a̠ ɕʰ i ɭ
지하철	t͡ɕ i ɦ a̠ t͡ɕʰ ʌ̹ ɭ
지하철역	t͡ɕ i ɦ a̠ t͡ɕʰ ʌ̹ ɾ j ʌ̹ k̚
지혈	t͡ɕ i ʝ j ʌ̹ ɭ
지협	t͡ɕ i ʝ j ʌ̹ p̚
지혜	t͡ɕ i ʝ j e̞
지휘자	t͡ɕ i ɦ ɥ i d͡ʑ a̠
직감	t͡ɕ i k̚ k͈ a̠ m
직관	t͡ɕ i k̚ k͈ w a̠ n
직기	t͡ɕ i k̚ k͈ i
직원	t͡ɕ i ɡ w ʌ̹ n
직위	t͡ɕ i ɡ ɥ i
직전	t͡ɕ i k̚ t͡ɕ͈ ʌ̹ n
직접	t͡ɕ i k̚ t͡ɕ͈ ʌ̹ p̚
직접적	t͡ɕ i k̚ t͡ɕ͈ ʌ̹ p̚ t͡ɕ͈ ʌ̹ k̚
직후	t͡ɕ i kʰ u
진공청소기	t͡ɕ i n ɡ o̞ ŋ t͡ɕʰ ʌ̹ ŋ sʰ o̞ ɡ i
진단	t͡ɕ iː n d a̠ n
진동	t͡ɕ i n d o̞ ŋ
진동수	t͡ɕ i n d o̞ ŋ sʰ u
진료소	t͡ɕ iː ʎ ʎ j o sʰ o̞
진루	t͡ɕ iː ɭ ɭ u
진리	t͡ɕ i ʎ ʎ i
진보	t͡ɕ iː n b o̞
진부하다	t͡ɕ i n b u ɦ a̠ d a̠
진실	t͡ɕ i n ɕʰ i ɭ
진실하다	t͡ɕ i n ɕʰ i ɾ ɦ a̠ d a̠
진압	t͡ɕ iː n a̠ p̚
진열장	t͡ɕ iː ɲ j ʌ̹ ʎ d͡ʑ a̠ ŋ
진주	t͡ɕ i ɲ d͡ʑ u
진지	t͡ɕ iː ɲ d͡ʑ i
진지하다	t͡ɕ i ɲ d͡ʑ i ɦ a̠ d a̠
진짜	t͡ɕ i ɲ t͡ɕ͈ a̠
진출	t͡ɕ iː ɲ t͡ɕʰ u ɭ
진한	t͡ɕ i n ɦ a̠ n
진화	t͡ɕ i n β w a̠
진흙	t͡ɕ i n ɣ ɯ k̚
질녀	t͡ɕ i ʎ ʎ j ʌ̹
질량	t͡ɕ i ʎ ʎ j a̠ ŋ
질리다	t͡ɕ i ʎ ʎ i d a̠
질문	t͡ɕ i ɭ m u n
질문하다	t͡ɕ i ɭ m u n ɦ a̠ d a̠
질병	t͡ɕ i ɭ b j ʌ̹ ŋ
질서	t͡ɕ i ɭ s͈ ʌ̹
질소	t͡ɕ i ɭ sʰ o̞
질타	t͡ɕ i ɭ tʰ a̠
질투	t͡ɕ i ɭ tʰ u
질풍노도	t͡ɕ i ɭ pʰ u ŋ n o̞ d o̞
짊다	t͡ɕ i m t͈ a̠
짐바브웨	t͡ɕ i m b a̠ b ɯ w e̞
짐승	t͡ɕ i m sʰ ɯ ŋ
짐작	t͡ɕ i m d͡ʑ a̠ k̚
집게	t͡ɕ i p̚ k͈ e̞
집결	t͡ɕ i p̚ k͈ j ʌ̹ ɭ
집계	t͡ɕ i p̚ k͈ j e̞
집권당	t͡ɕ i p̚ k͈ w ʌ̹ n d a̠ ŋ
집다	t͡ɕ i p̚ t͈ a̠
집단화	t͡ɕ i p̚ t͈ a̠ n β w a̠
집들	t͡ɕ i p̚ t͈ ɯ ɭ
집박쥐	t͡ɕ i p̚ p͈ a̠ k̚ t͡ɕ͈ ɥ i
집사	t͡ɕ i p s͈ a̠
집사람	t͡ɕ i p s͈ a̠ ɾ a̠ m
집안	t͡ɕ i b a̠ n
집어넣다	t͡ɕ i b ʌ̹ n ʌ̹ tʰ a̠
집중	t͡ɕ i p̚ t͡ɕ͈ u ŋ
집중되다	t͡ɕ i p̚ t͡ɕ͈ u ŋ d w e̞ d a̠
집쥐	t͡ɕ i p̚ t͡ɕ͈ ɥ i
집토끼	t͡ɕ i p̚ tʰ o̞ k͈ i
집필	t͡ɕ i p̚ pʰ i ɭ
집합	t͡ɕ i pʰ a̠ p̚
집회	t͡ɕ i pʰ w e̞
짓다	t͡ɕ iː t̚ t͈ a̠
징계	t͡ɕ i ŋ ɡ j e̞
징병	t͡ɕ i ŋ b j ʌ̹ ŋ
짙다	t͡ɕ i t̚ t͈ a̠
짙푸르다	t͡ɕ i t̚ pʰ u ɾ ɯ d a̠
짚다	t͡ɕ i p̚ t͈ a̠
짜다	t͡ɕ͈ a̠ d a̠
짜리	t͡ɕ͈ a̠ ɾ i
짜릿하다	t͡ɕ͈ a̠ ɾ i tʰ a̠ d a̠
짜장면	t͡ɕ͈ a̠ d͡ʑ a̠ ŋ m j ʌ̹ n
짜하다	t͡ɕ͈ a̠ː ɦ a̠ d a̠
짝사랑	t͡ɕ͈ a̠ k s͈ a̠ ɾ a̠ ŋ
짝짓기	t͡ɕ͈ a̠ k̚ t͡ɕ͈ i t̚ k͈ i
짠하다	t͡ɕ͈ a̠ː n ɦ a̠ d a̠
짧다	t͡ɕ͈ a̠ ɭ t͈ a̠
짬뽕	t͡ɕ͈ a̠ m p͈ o̞ ŋ
짭짤하다	t͡ɕ͈ a̠ p̚ t͡ɕ͈ a̠ ɾ ɦ a̠ d a̠
쩨마	t͡ɕ͈ e̞ m a̠
쪼다	t͡ɕ͈ o̞ d a̠
쪽발이	t͡ɕ͈ o̞ k̚ p͈ a̠ ɾ i
쫄면	t͡ɕ͈ o̞ ɭ m j ʌ̹ n
쫓기다	t͡ɕ͈ o̞ t̚ k͈ i d a̠
쫓다	t͡ɕ͈ o̞ t̚ t͈ a̠
쯔놈	t͡ɕ͈ ɯ n o̞ m
찌꺼기	t͡ɕ͈ i k͈ ʌ̹ ɡ i
찌르다	t͡ɕ͈ i ɾ ɯ d a̠
찌창	t͡ɕ͈ i t͡ɕʰ a̠ ŋ
찍소리	t͡ɕ͈ i k s͈ o̞ ɾ i
찐만두	t͡ɕ͈ i n m a̠ n d u
찐빵	t͡ɕ͈ i n p͈ a̠ ŋ
찜질방	t͡ɕ͈ i m d͡ʑ i ɭ b a̠ ŋ
차갑다	t͡ɕʰ a̠ ɡ a̠ p̚ t͈ a̠
차고	t͡ɕʰ a̠ ɡ o̞
차단	t͡ɕʰ a̠ː d a̠ n
차드	t͡ɕʰ a̠ d ɯ
차라리	t͡ɕʰ a̠ ɾ a̠ ɾ i
차량	t͡ɕʰ a̠ ɾ j a̠ ŋ
차례	t͡ɕʰ a̠ ɾ j e̞
차림	t͡ɕʰ a̠ ɾ i m
차림표	t͡ɕʰ a̠ ɾ i m pʰ j o
차마	t͡ɕʰ a̠ m a̠
차마당	t͡ɕʰ a̠ m a̠ d a̠ ŋ
차별	t͡ɕʰ a̠ b j ʌ̹ ɭ
차이	t͡ɕʰ a̠ i
차이나타운	t͡ɕʰ a̠ i n a̠ tʰ a̠ u n
차이니스	t͡ɕʰ a̠ i n i sʰ ɯ
차이다	t͡ɕʰ a̠ i d a̠
차장	t͡ɕʰ a̠ d͡ʑ a̠ ŋ
차지하다	t͡ɕʰ a̠ d͡ʑ i ɦ a̠ d a̠
차질	t͡ɕʰ a̠ d͡ʑ i ɭ
차츰	t͡ɕʰ a̠ t͡ɕʰ ɯ m
차트	t͡ɕʰ a̠ tʰ ɯ
착각	t͡ɕʰ a̠ k̚ k͈ a̠ k̚
착공	t͡ɕʰ a̠ k̚ k͈ o̞ ŋ
착석	t͡ɕʰ a̠ k s͈ ʌ̹ k̚
착용하다	t͡ɕʰ a̠ ɡ j o ŋ ɦ a̠ d a̠
착하다	t͡ɕʰ a̠ kʰ a̠ d a̠
찬가	t͡ɕʰ a̠ː n ɡ a̠
찬사	t͡ɕʰ a̠ː n sʰ a̠
찬스	t͡ɕʰ a̠ n sʰ ɯ
찬장	t͡ɕʰ a̠ː ɲ d͡ʑ a̠ ŋ
찰나	t͡ɕʰ a̠ ɭ ɭ a̠
찰스	t͡ɕʰ a̠ ɭ sʰ ɯ
찰흙	t͡ɕʰ a̠ ɾ ɣ ɯ k̚
참가자	t͡ɕʰ a̠ m ɡ a̠ d͡ʑ a̠
참고	t͡ɕʰ a̠ m ɡ o̞
참기름	t͡ɕʰ a̠ m ɡ i ɾ ɯ m
참다	t͡ɕʰ a̠ː m t͈ a̠
참되다	t͡ɕʰ a̠ m t͈ w e̞ d a̠
참말	t͡ɕʰ a̠ m m a̠ ɭ
참모장	t͡ɕʰ a̠ː m m o̞ d͡ʑ a̠ ŋ
참붕어	t͡ɕʰ a̠ m b u ŋ ʌ̹
참사	t͡ɕʰ a̠ m sʰ a̠
참석하다	t͡ɕʰ a̠ m sʰ ʌ̹ kʰ a̠ d a̠
참수리	t͡ɕʰ a̠ m sʰ u ɾ i
참여	t͡ɕʰ a̠ m j ʌ̹
참외	t͡ɕʰ a̠ m w e̞
참을성	t͡ɕʰ a̠ m ɯ ɭ sʰ ʌ̹ ŋ
참전	t͡ɕʰ a̠ m d͡ʑ ʌ̹ n
참조하다	t͡ɕʰ a̠ m d͡ʑ o̞ ɦ a̠ d a̠
참중고기	t͡ɕʰ a̠ m d͡ʑ u ŋ ɡ o̞ ɡ i
참회	t͡ɕʰ a̠ m β w e̞
찻집	t͡ɕʰ a̠ t̚ t͡ɕ͈ i p̚
창궐	t͡ɕʰ a̠ ŋ ɡ w ʌ̹ ɭ
창문	t͡ɕʰ a̠ ŋ m u n
창설	t͡ɕʰ a̠ː ŋ sʰ ʌ̹ ɭ
창세기	t͡ɕʰ a̠ː ŋ sʰ e̞ ɡ i
창업	t͡ɕʰ a̠ː ŋ ʌ̹ p̚
창원	t͡ɕʰ a̠ ŋ w ʌ̹ n
창자	t͡ɕʰ a̠ ŋ d͡ʑ a̠
창작	t͡ɕʰ a̠ ŋ d͡ʑ a̠ k̚
창제	t͡ɕʰ a̠ː ŋ d͡ʑ e̞
창조	t͡ɕʰ a̠ː ŋ d͡ʑ o̞
창조자	t͡ɕʰ a̠ː ŋ d͡ʑ o̞ d͡ʑ a̠
창조적	t͡ɕʰ a̠ː ŋ d͡ʑ o̞ d͡ʑ ʌ̹ k̚
창조하다	t͡ɕʰ a̠ː ŋ d͡ʑ o̞ ɦ a̠ d a̠
창턱	t͡ɕʰ a̠ ŋ tʰ ʌ̹ k̚
찾다	t͡ɕʰ a̠ t̚ t͈ a̠
찾아가다	t͡ɕʰ a̠ d͡ʑ a̠ ɡ a̠ d a̠
찾아보다	t͡ɕʰ a̠ d͡ʑ a̠ b o̞ d a̠
찾아오다	t͡ɕʰ a̠ d͡ʑ a̠ o̞ d a̠
채소	t͡ɕʰ ɛː sʰ o̞
채소밭	t͡ɕʰ ɛː sʰ o̞ b a̠ t̚
채식주의	t͡ɕʰ ɛː ɕʰ i k̚ t͡ɕ͈ u ɰ i
채식주의자	t͡ɕʰ ɛː ɕʰ i k̚ t͡ɕ͈ u ɰ i d͡ʑ a̠
채용하다	t͡ɕʰ ɛː j o ŋ ɦ a̠ d a̠
처가	t͡ɕʰ ʌ̹ ɡ a̠
처남	t͡ɕʰ ʌ̹ n a̠ m
처녀	t͡ɕʰ ɘː ɲ j ʌ̹
처녀막	t͡ɕʰ ɘː ɲ j ʌ̹ m a̠ k̚
처럼	t͡ɕʰ ʌ̹ ɾ ʌ̹ m
처리	t͡ɕʰ ɘː ɾ i
처방	t͡ɕʰ ʌ̹ b a̠ ŋ
처방전	t͡ɕʰ ɘː b a̠ ŋ d͡ʑ ʌ̹ n
처벌	t͡ɕʰ ɘː b ʌ̹ ɭ
처신	t͡ɕʰ ɘː ɕʰ i n
처음	t͡ɕʰ ʌ̹ ɯ m
처지	t͡ɕʰ ɘː d͡ʑ i
척결	t͡ɕʰ ʌ̹ k̚ k͈ j ʌ̹ ɭ
척수	t͡ɕʰ ʌ̹ k s͈ u
척추	t͡ɕʰ ʌ̹ k̚ t͡ɕʰ u
척추동물	t͡ɕʰ ʌ̹ k̚ t͡ɕʰ u d o̞ ŋ m u ɭ
천국	t͡ɕʰ ʌ̹ n ɡ u k̚
천당	t͡ɕʰ ʌ̹ n d a̠ ŋ
천도	t͡ɕʰ ɘː n d o̞
천둥	t͡ɕʰ ʌ̹ n d u ŋ
천리마	t͡ɕʰ ʌ̹ ʎ ʎ i m a̠
천리안	t͡ɕʰ ʌ̹ ʎ ʎ i a̠ n
천만	t͡ɕʰ ʌ̹ n m a̠ n
천만에요	t͡ɕʰ ʌ̹ n m a̠ n e̞ j o
천부적	t͡ɕʰ ʌ̹ n b u d͡ʑ ʌ̹ k̚
천사	t͡ɕʰ ʌ̹ n sʰ a̠
천성	t͡ɕʰ ʌ̹ n sʰ ʌ̹ ŋ
천안문	t͡ɕʰ ʌ̹ n a̠ n m u n
천왕성	t͡ɕʰ ʌ̹ n w a̠ ŋ sʰ ʌ̹ ŋ
천자문	t͡ɕʰ ʌ̹ ɲ d͡ʑ a̠ m u n
천장	t͡ɕʰ ʌ̹ ɲ d͡ʑ a̠ ŋ
천제	t͡ɕʰ ʌ̹ ɲ d͡ʑ e̞
천조국	t͡ɕʰ ʌ̹ ɲ d͡ʑ o̞ ɡ u k̚
천주교	t͡ɕʰ ʌ̹ ɲ d͡ʑ u ɡ j o
천지	t͡ɕʰ ʌ̹ ɲ d͡ʑ i
천지인	t͡ɕʰ ʌ̹ ɲ d͡ʑ i i n
천천히	t͡ɕʰ ɘː ɲ t͡ɕʰ ʌ̹ n ʝ i
천체	t͡ɕʰ ʌ̹ ɲ t͡ɕʰ e̞
천하	t͡ɕʰ ʌ̹ n ɦ a̠
천황	t͡ɕʰ ʌ̹ n β w a̠ ŋ
철갑	t͡ɕʰ ʌ̹ ɭ ɡ a̠ p̚
철도	t͡ɕʰ ʌ̹ ɭ t͈ o̞
철밥통	t͡ɕʰ ʌ̹ ɭ b a̠ p̚ tʰ o̞ ŋ
철부지	t͡ɕʰ ʌ̹ ɭ b u d͡ʑ i
철자법	t͡ɕʰ ʌ̹ ʎ t͡ɕ͈ a̠ p͈ ʌ̹ p̚
철저하다	t͡ɕʰ ʌ̹ ʎ t͡ɕ͈ ʌ̹ ɦ a̠ d a̠
철저히	t͡ɕʰ ʌ̹ ʎ t͡ɕ͈ ʌ̹ ʝ i
철쭉	t͡ɕʰ ʌ̹ ʎ t͡ɕ͈ u k̚
철퇴	t͡ɕʰ ʌ̹ ɭ tʰ w e̞
철판	t͡ɕʰ ʌ̹ ɭ pʰ a̠ n
철폐	t͡ɕʰ ʌ̹ ɭ pʰ j e̞
철학	t͡ɕʰ ʌ̹ ɾ ɦ a̠ k̚
첫날	t͡ɕʰ ʌ̹ n n a̠ ɭ
첫눈	t͡ɕʰ ʌ̹ n n u n
첫차	t͡ɕʰ ʌ̹ t̚ t͡ɕʰ a̠
청각	t͡ɕʰ ʌ̹ ŋ ɡ a̠ k̚
청결	t͡ɕʰ ʌ̹ ŋ ɡ j ʌ̹ ɭ
청국장	t͡ɕʰ ʌ̹ ŋ ɡ u k̚ t͡ɕ͈ a̠ ŋ
청남방	t͡ɕʰ ʌ̹ ŋ n a̠ m b a̠ ŋ
청년	t͡ɕʰ ʌ̹ ŋ ɲ j ʌ̹ n
청동	t͡ɕʰ ʌ̹ ŋ d o̞ ŋ
청둥오리	t͡ɕʰ ʌ̹ ŋ d u ŋ o̞ ɾ i
청량음료	t͡ɕʰ ʌ̹ ŋ ɲ j a̠ ŋ ɯ m ɲ j o
청바지	t͡ɕʰ ʌ̹ ŋ b a̠ d͡ʑ i
청소	t͡ɕʰ ʌ̹ ŋ sʰ o̞
청소년	t͡ɕʰ ʌ̹ ŋ sʰ o̞ ɲ j ʌ̹ n
청순	t͡ɕʰ ʌ̹ ŋ sʰ u n
청진	t͡ɕʰ ʌ̹ ŋ d͡ʑ i n
청천벽력	t͡ɕʰ ʌ̹ ŋ t͡ɕʰ ʌ̹ n b j ʌ̹ ŋ ɲ j ʌ̹ k̚
청첩장	t͡ɕʰ ɘː ŋ t͡ɕʰ ʌ̹ p̚ t͡ɕ͈ a̠ ŋ
청초하다	t͡ɕʰ ʌ̹ ŋ t͡ɕʰ o̞ ɦ a̠ d a̠
청춘	t͡ɕʰ ʌ̹ ŋ t͡ɕʰ u n
청탁	t͡ɕʰ ʌ̹ ŋ tʰ a̠ k̚
체결	t͡ɕʰ e̞ ɡ j ʌ̹ ɭ
체구	t͡ɕʰ e̞ ɡ u
체념	t͡ɕʰ e̞ ɲ j ʌ̹ m
체력	t͡ɕʰ e̞ ɾ j ʌ̹ k̚
체르노빌	t͡ɕʰ e̞ ɾ ɯ n o̞ b i ɭ
체리	t͡ɕʰ e̞ ɾ i
체면	t͡ɕʰ e̞ m j ʌ̹ n
체스	t͡ɕʰ e̞ sʰ ɯ
체스꼬슬로벤스꼬	t͡ɕʰ e̞ sʰ ɯ k͈ o̞ sʰ ɯ ɭ ɭ o̞ b e̞ n sʰ ɯ k͈ o̞
체온계	t͡ɕʰ e̞ o̞ n ɡ j e̞
체육	t͡ɕʰ e̞ j u k̚
체육관	t͡ɕʰ e̞ j u k̚ k͈ w a̠ n
체인	t͡ɕʰ e̞ i n
체제	t͡ɕʰ e̞ d͡ʑ e̞
체중	t͡ɕʰ e̞ d͡ʑ u ŋ
체질	t͡ɕʰ e̞ d͡ʑ i ɭ
체커	t͡ɕʰ e̞ kʰ ʌ̹
체코	t͡ɕʰ e̞ kʰ o̞
체포	t͡ɕʰ e̞ pʰ o̞
체험	t͡ɕʰ e̞ ɦ ʌ̹ m
쳐죽이다	t͡ɕʰ ʌ̹ d͡ʑ u ɡ i d a̠
초고속	t͡ɕʰ o̞ ɡ o̞ sʰ o̞ k̚
초고추장	t͡ɕʰ o̞ ɡ o̞ t͡ɕʰ u d͡ʑ a̠ ŋ
초능력	t͡ɕʰ o̞ n ɯ ŋ ɲ j ʌ̹ k̚
초등학교	t͡ɕʰ o̞ d ɯ ŋ ɦ a̠ k̚ k͈ j o
초딩	t͡ɕʰ o̞ d i ŋ
초로	t͡ɕʰ o̞ ɾ o̞
초록빛	t͡ɕʰ o̞ ɾ o̞ k̚ p͈ i t̚
초반	t͡ɕʰ o̞ b a̠ n
초밥	t͡ɕʰ o̞ b a̠ p̚
초순	t͡ɕʰ o̞ sʰ u n
초승달	t͡ɕʰ o̞ sʰ ɯ ŋ t͈ a̠ ɭ
초원	t͡ɕʰ o̞ w ʌ̹ n
초유	t͡ɕʰ o̞ j u
초음파	t͡ɕʰ o̞ ɯ m pʰ a̠
초인	t͡ɕʰ o̞ i n
초자연적	t͡ɕʰ o̞ d͡ʑ a̠ j ʌ̹ ɲ d͡ʑ ʌ̹ k̚
초점	t͡ɕʰ o̞ t͡ɕ͈ ʌ̹ m
초지	t͡ɕʰ o̞ d͡ʑ i
초콜렛	t͡ɕʰ o̞ kʰ o̞ ɭ ɭ e̞ t̚
초콜릿	t͡ɕʰ o̞ kʰ o̞ ʎ ʎ i t̚
초특급	t͡ɕʰ o̞ tʰ ɯ k̚ k͈ ɯ p̚
초판	t͡ɕʰ o̞ pʰ a̠ n
초하루	t͡ɕʰ o̞ ɦ a̠ ɾ u
초혼	t͡ɕʰ o̞ β o̞ n
촉각	t͡ɕʰ o̞ k̚ k͈ a̠ k̚
촉법소년	t͡ɕʰ o̞ k̚ p͈ ʌ̹ p s͈ o̞ ɲ j ʌ̹ n
촉수	t͡ɕʰ o̞ k s͈ u
촌극	t͡ɕʰ o̞ː n ɡ ɯ k̚
촌놈	t͡ɕʰ o̞ n n o̞ m
촌락	t͡ɕʰ o̞ː ɭ ɭ a̠ k̚
총각	t͡ɕʰ o̞ː ŋ ɡ a̠ k̚
총명	t͡ɕʰ o̞ ŋ m j ʌ̹ ŋ
총서	t͡ɕʰ o̞ ŋ sʰ ʌ̹
총영사관	t͡ɕʰ o̞ ŋ j ʌ̹ ŋ sʰ a̠ ɡ w a̠ n
총장	t͡ɕʰ o̞ː ŋ d͡ʑ a̠ ŋ
총체적	t͡ɕʰ o̞ ŋ t͡ɕʰ e̞ d͡ʑ ʌ̹ k̚
총총	t͡ɕʰ o̞ ŋ t͡ɕʰ o̞ ŋ
총통	t͡ɕʰ o̞ː ŋ tʰ o̞ ŋ
총화	t͡ɕʰ o̞ ŋ β w a̠
촬영	t͡ɕʰ w a̠ ɾ j ʌ̹ ŋ
최강	t͡ɕʰ w e̞ː ɡ a̠ ŋ
최근	t͡ɕʰ w e̞ː ɡ ɯ n
최상급	t͡ɕʰ w e̞ː sʰ a̠ ŋ ɡ ɯ p̚
최선	t͡ɕʰ w e̞ː sʰ ʌ̹ n
최소한	t͡ɕʰ w e̞ː sʰ o̞ ɦ a̠ n
최종	t͡ɕʰ w e̞ː d͡ʑ o̞ ŋ
최초	t͡ɕʰ w e̞ː t͡ɕʰ o̞
추가	t͡ɕʰ u ɡ a̠
추격	t͡ɕʰ u ɡ j ʌ̹ k̚
추구	t͡ɕʰ u ɡ u
추구하다	t͡ɕʰ u ɡ u ɦ a̠ d a̠
추락	t͡ɕʰ u ɾ a̠ k̚
추리닝	t͡ɕʰ u ɾ i n i ŋ
추밀원	t͡ɕʰ u m i ɾ w ʌ̹ n
추방	t͡ɕʰ u b a̠ ŋ
추석	t͡ɕʰ u sʰ ʌ̹ k̚
추수	t͡ɕʰ u sʰ u
추악하다	t͡ɕʰ u a̠ kʰ a̠ d a̠
추억	t͡ɕʰ u ʌ̹ k̚
추위	t͡ɕʰ u ɥ i
추적하다	t͡ɕʰ u d͡ʑ ʌ̹ kʰ a̠ d a̠
추진	t͡ɕʰ u d͡ʑ i n
추진하다	t͡ɕʰ u d͡ʑ i n ɦ a̠ d a̠
추천하다	t͡ɕʰ u t͡ɕʰ ʌ̹ n ɦ a̠ d a̠
추출	t͡ɕʰ u t͡ɕʰ u ɭ
추출물	t͡ɕʰ u t͡ɕʰ u ɭ m u ɭ
추측	t͡ɕʰ u t͡ɕʰ ɯ k̚
축복	t͡ɕʰ u k̚ p͈ o̞ k̚
축사	t͡ɕʰ u k s͈ a̠
축소	t͡ɕʰ u k s͈ o̞
축음기	t͡ɕʰ u ɡ ɯ m ɡ i
축제	t͡ɕʰ u k̚ t͡ɕ͈ e̞
축척	t͡ɕʰ u k̚ t͡ɕʰ ʌ̹ k̚
축하	t͡ɕʰ u kʰ a̠
춘하추동	t͡ɕʰ u n ɦ a̠ t͡ɕʰ u d o̞ ŋ
출구	t͡ɕʰ u ɭ ɡ u
출근	t͡ɕʰ u ɭ ɡ ɯ n
출근시간	t͡ɕʰ u ɭ ɡ ɯ n ɕʰ i ɡ a̠ n
출근하다	t͡ɕʰ u ɭ ɡ ɯ n ɦ a̠ d a̠
출금	t͡ɕʰ u ɭ ɡ ɯ m
출발하다	t͡ɕʰ u ɭ b a̠ ɾ ɦ a̠ d a̠
출산	t͡ɕʰ u ɭ s͈ a̠ n
출산율	t͡ɕʰ u ɭ sʰ a̠ ɲ j u ɭ
출석	t͡ɕʰ u ɭ s͈ ʌ̹ k̚
출신	t͡ɕʰ u ɭ ɕ͈ i n
출신성분	t͡ɕʰ u ɭ ɕ͈ i n sʰ ʌ̹ ŋ b u n
출연	t͡ɕʰ u ɾ j ʌ̹ n
출원자	t͡ɕʰ u ɾ w ʌ̹ ɲ d͡ʑ a̠
출전	t͡ɕʰ u ʎ d͡ʑ ʌ̹ n
출출하다	t͡ɕʰ u ʎ t͡ɕʰ u ɾ ɦ a̠ d a̠
출퇴근하다	t͡ɕʰ u ɭ tʰ w e̞ ɡ ɯ n ɦ a̠ d a̠
출판사	t͡ɕʰ u ɭ pʰ a̠ n sʰ a̠
출판하다	t͡ɕʰ u ɭ pʰ a̠ n ɦ a̠ d a̠
출혈	t͡ɕʰ u ɾ ʝ j ʌ̹ ɭ
춤꾼	t͡ɕʰ u m k͈ u n
춤추다	t͡ɕʰ u m t͡ɕʰ u d a̠
춥다	t͡ɕʰ u p̚ t͈ a̠
충격	t͡ɕʰ u ŋ ɡ j ʌ̹ k̚
충고	t͡ɕʰ u ŋ ɡ o̞
충돌	t͡ɕʰ u ŋ d o̞ ɭ
충분하다	t͡ɕʰ u ŋ b u n ɦ a̠ d a̠
충분히	t͡ɕʰ u ŋ b u n ʝ i
충성	t͡ɕʰ u ŋ sʰ ʌ̹ ŋ
충수	t͡ɕʰ u ŋ sʰ u
충실하다	t͡ɕʰ u ŋ ɕʰ i ɾ ɦ a̠ d a̠
충전기	t͡ɕʰ u ŋ d͡ʑ ʌ̹ n ɡ i
충청북도	t͡ɕʰ u ŋ t͡ɕʰ ʌ̹ ŋ b u k̚ t͈ o̞
충충	t͡ɕʰ u ŋ t͡ɕʰ u ŋ
충칭	t͡ɕʰ u ŋ t͡ɕʰ i ŋ
취급	t͡ɕʰ ɥ i ɡ ɯ p̚
취나물	t͡ɕʰ ɥ i n a̠ m u ɭ
취리히	t͡ɕʰ ɥ i ɾ i ʝ i
취미	t͡ɕʰ ɥ iː m i
취소	t͡ɕʰ ɥ iː sʰ o̞
취직	t͡ɕʰ ɥ iː d͡ʑ i k̚
취하다	t͡ɕʰ ɥ iː ɦ a̠ d a̠
취향	t͡ɕʰ ɥ iː ʝ j a̠ ŋ
측위	t͡ɕʰ ɯ ɡ ɥ i
층운	t͡ɕʰ ɯ ŋ u n
치는	t͡ɕʰ i n ɯ n
치다	t͡ɕʰ i d a̠
치료	t͡ɕʰ i ɾ j o
치료제	t͡ɕʰ i ɾ j o d͡ʑ e̞
치르다	t͡ɕʰ i ɾ ɯ d a̠
치마	t͡ɕʰ i m a̠
치아	t͡ɕʰ i a̠
치안	t͡ɕʰ i a̠ n
치어리더	t͡ɕʰ i ʌ̹ ɾ i d ʌ̹
치열	t͡ɕʰ i j ʌ̹ ɭ
치와와	t͡ɕʰ i w a̠ w a̠
치욕	t͡ɕʰ i j o k̚
치우	t͡ɕʰ i u
치즈	t͡ɕʰ i d͡ʑ ɯ
치타	t͡ɕʰ i tʰ a̠
치통	t͡ɕʰ i tʰ o̞ ŋ
치한	t͡ɕʰ i ɦ a̠ n
친구	t͡ɕʰ i n ɡ u
친근하다	t͡ɕʰ i n ɡ ɯ n ɦ a̠ d a̠
친밀	t͡ɕʰ i n m i ɭ
친삼촌	t͡ɕʰ i n sʰ a̠ m t͡ɕʰ o̞ n
친선	t͡ɕʰ i n sʰ ʌ̹ n
친일파	t͡ɕʰ i n i ɭ pʰ a̠
친절	t͡ɕʰ i ɲ d͡ʑ ʌ̹ ɭ
친족	t͡ɕʰ i ɲ d͡ʑ o̞ k̚
친척	t͡ɕʰ i ɲ t͡ɕʰ ʌ̹ k̚
칠레	t͡ɕʰ i ɭ ɭ e̞
칠리	t͡ɕʰ i ʎ ʎ i
칠면조	t͡ɕʰ i ɭ m j ʌ̹ ɲ d͡ʑ o̞
칠월	t͡ɕʰ i ɾ w ʌ̹ ɭ
칠판	t͡ɕʰ i ɭ pʰ a̠ n
침공	t͡ɕʰ iː m ɡ o̞ ŋ
침낭	t͡ɕʰ iː m n a̠ ŋ
침략	t͡ɕʰ iː m ɲ j a̠ k̚
침목	t͡ɕʰ i m m o̞ k̚
침묵	t͡ɕʰ i m m u k̚
침묵하다	t͡ɕʰ i m m u kʰ a̠ d a̠
침범	t͡ɕʰ iː m b ʌ̹ m
침술	t͡ɕʰ i m sʰ u ɭ
침실	t͡ɕʰ iː m ɕʰ i ɭ
침입	t͡ɕʰ iː m i p̚
칭찬	t͡ɕʰ i ŋ t͡ɕʰ a̠ n
칭찬하다	t͡ɕʰ i ŋ t͡ɕʰ a̠ n ɦ a̠ d a̠
칭하이	t͡ɕʰ i ŋ ɦ a̠ i
카나	kʰ a̠ n a̠
카나리아	kʰ a̠ n a̠ ɾ i a̠
카놀라유	kʰ a̠ n o̞ ɭ ɭ a̠ j u
카드	kʰ a̠ d ɯ
카드뮴	kʰ a̠ d ɯ m j u m
카라치	kʰ a̠ ɾ a̠ t͡ɕʰ i
카라카스	kʰ a̠ ɾ a̠ kʰ a̠ sʰ ɯ
카란	kʰ a̠ ɾ a̠ n
카르마	kʰ a̠ ɾ ɯ m a̠
카르복실기	kʰ a̠ ɾ ɯ b o̞ k ɕ͈ i ɭ ɡ i
카르빌아민	kʰ a̠ ɾ ɯ b i ɾ a̠ m i n
카르텔	kʰ a̠ ɾ ɯ tʰ e̞ ɭ
카메라	kʰ a̠ m e̞ ɾ a̠
카메룬	kʰ a̠ m e̞ ɾ u n
카멜레온	kʰ a̠ m e̞ ɭ ɭ e̞ o̞ n
카보베르데	kʰ a̠ b o̞ b e̞ ɾ ɯ d e̞
카복실산	kʰ a̠ b o̞ k ɕ͈ i ɭ sʰ a̠ n
카불	kʰ a̠ b u ɭ
카세트	kʰ a̠ sʰ e̞ tʰ ɯ
카옌	kʰ a̠ j e̞ n
카우보이	kʰ a̠ u b o̞ i
카우치	kʰ a̠ u t͡ɕʰ i
카운터	kʰ a̠ u n tʰ ʌ̹
카이로	kʰ a̠ i ɾ o̞
카이만	kʰ a̠ i m a̠ n
카자흐스탄	kʰ a̠ d͡ʑ a̠ ɣ ɯ sʰ ɯ tʰ a̠ n
카지노	kʰ a̠ d͡ʑ i n o̞
카타르	kʰ a̠ tʰ a̠ ɾ ɯ
카트	kʰ a̠ tʰ ɯ
카트만두	kʰ a̠ tʰ ɯ m a̠ n d u
카페	k͈ a̠ pʰ e̞
카페테리아	kʰ a̠ pʰ e̞ tʰ e̞ ɾ i a̠
칵테일	kʰ a̠ k̚ tʰ e̞ i ɭ
칼날	kʰ a̠ ɭ ɭ a̠ ɭ
칼라	kʰ a̠ ɭ ɭ a̠
칼로리	kʰ a̠ ɭ ɭ o̞ ɾ i
칼륨	kʰ a̠ ʎ ʎ j u m
칼리닌그라드	kʰ a̠ ʎ ʎ i n i n ɡ ɯ ɾ a̠ d ɯ
칼리파	kʰ a̠ ʎ ʎ i pʰ a̠
칼바람	kʰ a̠ ɭ b a̠ ɾ a̠ m
칼상어	kʰ a̠ ɭ sʰ a̠ ŋ ʌ̹
칼슘	kʰ a̠ ɭ ɕʰ u m
칼자루	kʰ a̠ ʎ d͡ʑ a̠ ɾ u
칼집	kʰ a̠ ʎ t͡ɕ͈ i p̚
칼파스	kʰ a̠ ɭ pʰ a̠ sʰ ɯ
캄보디아	kʰ a̠ m b o̞ d i a̠
캄팔라	kʰ a̠ m pʰ a̠ ɭ ɭ a̠
캐다	kʰ ɛː d a̠
커닝	kʰ ʌ̹ n i ŋ
커다랗다	kʰ ɘː d a̠ ɾ a̠ tʰ a̠
커리	kʰ ʌ̹ ɾ i
커뮤니케이션	kʰ ʌ̹ m j u n i kʰ e̞ i ɕʰ ʌ̹ n
커뮤니티	kʰ ʌ̹ m j u n i tʰ i
커미션	kʰ ʌ̹ m i ɕʰ ʌ̹ n
커밍아웃	kʰ ʌ̹ m i ŋ a̠ u t̚
커브	kʰ ʌ̹ b ɯ
커서	kʰ ʌ̹ sʰ ʌ̹
커지다	kʰ ʌ̹ d͡ʑ i d a̠
커튼	kʰ ʌ̹ tʰ ɯ n
커플	kʰ ʌ̹ pʰ ɯ ɭ
커피숍	kʰ ʌ̹ pʰ i ɕʰ o p̚
컴퓨터	kʰ ʌ̹ m pʰ j u tʰ ʌ̹
케더링	kʰ e̞ d ʌ̹ ɾ i ŋ
케바케	kʰ e̞ b a̠ kʰ e̞
케이블	kʰ e̞ i b ɯ ɭ
케이크	kʰ e̞ i k x ɯ
케이터링	kʰ e̞ i tʰ ʌ̹ ɾ i ŋ
케이프타운	kʰ e̞ i pʰ ɯ tʰ a̠ u n
케익	kʰ e̞ i k̚
케첩	kʰ e̞ t͡ɕʰ ʌ̹ p̚
케톤	kʰ e̞ tʰ o̞ n
켈빈	kʰ e̞ ɭ b i n
코끼리	kʰ o̞ k͈ i ɾ i
코냑	kʰ o̞ ɲ j a̠ k̚
코너	kʰ o̞ n ʌ̹
코드	kʰ o̞ d ɯ
코란	kʰ o̞ ɾ a̠ n
코로나	kʰ o̞ ɾ o̞ n a̠
코로나비루스	kʰ o̞ ɾ o̞ n a̠ b i ɾ u sʰ ɯ
코리아	kʰ o̞ ɾ i a̠
코린	kʰ o̞ ɾ i n
코린치쥐	kʰ o̞ ɾ i ɲ t͡ɕʰ i d͡ʑ ɥ i
코미디	kʰ o̞ m i d i
코발트	kʰ o̞ b a̠ ɭ tʰ ɯ
코브라	kʰ o̞ b ɯ ɾ a̠
코뿔소	kʰ o̞ p͈ u ɭ s͈ o̞
코소보	kʰ o̞ sʰ o̞ b o̞
코스	kʰ o̞ sʰ ɯ
코스모스	kʰ o̞ sʰ ɯ m o̞ sʰ ɯ
코스타리카	kʰ o̞ sʰ ɯ tʰ a̠ ɾ i kʰ a̠
코알라	kʰ o̞ a̠ ɭ ɭ a̠
코요테	kʰ o̞ j o tʰ e̞
코이	kʰ o̞ i
코카인	kʰ o̞ kʰ a̠ i n
코카콜라	kʰ o̞ kʰ a̠ kʰ o̞ ɭ ɭ a̠
코코넛	kʰ o̞ kʰ o̞ n ʌ̹ t̚
코크스	kʰ o̞ k x ɯ sʰ ɯ
코트	kʰ o̞ tʰ ɯ
코트디부아르	kʰ o̞ tʰ ɯ d i b u a̠ ɾ ɯ
코튼	kʰ o̞ tʰ ɯ n
코펜하겐	kʰ o̞ pʰ e̞ n ɦ a̠ ɡ e̞ n
코피	kʰ o̞ pʰ i
코헬렛	kʰ o̞ ɦ e̞ ɭ ɭ e̞ t̚
콘도미니엄	kʰ o̞ n d o̞ m i n i ʌ̹ m
콘돔	kʰ o̞ n d o̞ m
콘서트	kʰ o̞ n sʰ ʌ̹ tʰ ɯ
콘셉트	kʰ o̞ n sʰ e̞ p̚ tʰ ɯ
콘스탄티누스	kʰ o̞ n sʰ ɯ tʰ a̠ n tʰ i n u sʰ ɯ
콘크리트	kʰ o̞ n k x ɯ ɾ i tʰ ɯ
콜라	kʰ o̞ ɭ ɭ a̠
콜라보	kʰ o̞ ɭ ɭ a̠ b o̞
콜레스테롤	kʰ o̞ ɭ ɭ e̞ sʰ ɯ tʰ e̞ ɾ o̞ ɭ
콜록	kʰ o̞ ɭ ɭ o̞ k̚
콜록콜록	kʰ o̞ ɭ ɭ o̞ k̚ kʰ o̞ ɭ ɭ o̞ k̚
콜론	kʰ o̞ ɭ ɭ o̞ n
콜옵션	kʰ o̞ ɾ o̞ p ɕ͈ ʌ̹ n
콜카타	kʰ o̞ ɭ kʰ a̠ tʰ a̠
콜호스	kʰ o̞ ɾ β o̞ sʰ ɯ
콤바인	kʰ o̞ m b a̠ i n
콤퓨터	kʰ o̞ m pʰ j u tʰ ʌ̹
콤플렉스	kʰ o̞ m pʰ ɯ ɭ ɭ e̞ k s͈ ɯ
콧물	kʰ o̞ n m u ɭ
콩고	kʰ o̞ ŋ ɡ o̞
콩나물	kʰ o̞ ŋ n a̠ m u ɭ
콩자반	kʰ o̞ ŋ d͡ʑ a̠ b a̠ n
콩팥	kʰ o̞ ŋ pʰ a̠ t̚
쾨뻰하븐	kʰ w e̞ p͈ e̞ n ɦ a̠ b ɯ n
쾰른	kʰ w e̞ ɭ ɭ ɯ n
쿠데타	kʰ u d e̞ tʰ a̠
쿠션	kʰ u ɕʰ ʌ̹ n
쿠알라룸푸르	kʰ u a̠ ɭ ɭ a̠ ɾ u m pʰ u ɾ ɯ
쿨쿨	kʰ u ɭ kʰ u ɭ
쿵후	kʰ u ŋ β u
퀴나졸린	kʰ ɥ i n a̠ d͡ʑ o̞ ʎ ʎ i n
퀴즈	kʰ ɥ i d͡ʑ ɯ
크기	k x ɯ ɡ i
크다	k x ɯ d a̠
크레용	k x ɯ ɾ e̞ j o ŋ
크레인	k x ɯ ɾ e̞ i n
크레파스	k x ɯ ɾ e̞ pʰ a̠ sʰ ɯ
크로뮴	k x ɯ ɾ o̞ m j u m
크로스드레싱	k x ɯ ɾ o̞ sʰ ɯ d ɯ ɾ e̞ ɕʰ i ŋ
크로아티아	k x ɯ ɾ o̞ a̠ tʰ i a̠
크로켓	k x ɯ ɾ o̞ kʰ e̞ t̚
크롬	k x ɯ ɾ o̞ m
크리스마스이브	k x ɯ ɾ i sʰ ɯ m a̠ sʰ ɯ i b ɯ
크리스천	k x ɯ ɾ i sʰ ɯ t͡ɕʰ ʌ̹ n
크리켓	k x ɯ ɾ i kʰ e̞ t̚
크림반도	k x ɯ ɾ i m b a̠ n d o̞
크세논	k x ɯ sʰ e̞ n o̞ n
큰고니	k x ɯ n ɡ o̞ n i
큰기러기	k x ɯ n ɡ i ɾ ʌ̹ ɡ i
큰물	k x ɯ n m u ɭ
큰바다사자	k x ɯ n b a̠ d a̠ sʰ a̠ d͡ʑ a̠
큰아들	k x ɯ n a̠ d ɯ ɭ
큰아버지	k x ɯ n a̠ b ʌ̹ d͡ʑ i
큰일	k x ɯ n n i ɭ
클라리넷	k x ɯ ɭ ɭ a̠ ɾ i n e̞ t̚
클라우드	k x ɯ ɭ ɭ a̠ u d ɯ
클럽	k x ɯ ɭ ɭ ʌ̹ p̚
클로버	k x ɯ ɭ ɭ o̞ b ʌ̹
클리닝	k x ɯ ʎ ʎ i n i ŋ
클릭	k x ɯ ʎ ʎ i k̚
클립	k x ɯ ʎ ʎ i p̚
타나크	tʰ a̠ n a̠ k x ɯ
타다	tʰ a̠ d a̠
타밀어	tʰ a̠ m i ɾ ʌ̹
타슈켄트	tʰ a̠ ɕʰ u kʰ e̞ n tʰ ɯ
타워	tʰ a̠ w ʌ̹
타원	tʰ a̠ː w ʌ̹ n
타율	tʰ a̠ː j u ɭ
타이	tʰ a̠ i
타이가	tʰ a̠ i ɡ a̠
타이르다	tʰ a̠ i ɾ ɯ d a̠
타이머	tʰ a̠ i m ʌ̹
타이베이	tʰ a̠ i b e̞ i
타이어	tʰ a̠ i ʌ̹
타이타늄	tʰ a̠ i tʰ a̠ ɲ j u m
타이틀	tʰ a̠ i tʰ ɯ ɭ
타이페이	tʰ a̠ i pʰ e̞ i
타일	tʰ a̠ i ɭ
타자	tʰ a̠ː d͡ʑ a̠
타조	tʰ a̠ː d͡ʑ o̞
타협	tʰ a̠ː ʝ j ʌ̹ p̚
타협하다	tʰ a̠ː ʝ j ʌ̹ pʰ a̠ d a̠
탁구	tʰ a̠ k̚ k͈ u
탁아소	tʰ a̠ ɡ a̠ sʰ o̞
탁자	tʰ a̠ k̚ t͡ɕ͈ a̠
탁치	tʰ a̠ k̚ t͡ɕʰ i
탄로	tʰ a̠ː ɭ ɭ o̞
탄성	tʰ a̠ n sʰ ʌ̹ ŋ
탄소	tʰ a̠ː n sʰ o̞
탄수화물	tʰ a̠ː n sʰ u β w a̠ m u ɭ
탄압	tʰ a̠ː n a̠ p̚
탄약고	tʰ a̠ː ɲ j a̠ k̚ k͈ o̞
탄화	tʰ a̠ː n β w a̠
탄화수소	tʰ a̠ː n β w a̠ sʰ u sʰ o̞
탈락	tʰ a̠ ɭ ɭ a̠ k̚
탈륨	tʰ a̠ ʎ ʎ j u m
탈린	tʰ a̠ ʎ ʎ i n
탈북자	tʰ a̠ ɭ b u k̚ t͡ɕ͈ a̠
탈영병	tʰ a̠ ɾ j ʌ̹ ŋ b j ʌ̹ ŋ
탈영자	tʰ a̠ ɾ j ʌ̹ ŋ d͡ʑ a̠
탈의실	tʰ a̠ ɾ ɰ i ɕʰ i ɭ
탈출기	tʰ a̠ ʎ t͡ɕʰ u ɭ ɡ i
탈환	tʰ a̠ ɾ β w a̠ n
탐구	tʰ a̠ m ɡ u
탐라	tʰ a̠ m n a̠
탐사	tʰ a̠ m sʰ a̠
탐욕	tʰ a̠ m j o k̚
탐정	tʰ a̠ m d͡ʑ ʌ̹ ŋ
탐험	tʰ a̠ m ɦ ʌ̹ m
탐험가	tʰ a̠ m ɦ ʌ̹ m ɡ a̠
탑승권	tʰ a̠ p s͈ ɯ ŋ k͈ w ʌ̹ n
태도	tʰ ɛː d o̞
터덜터덜	tʰ ʌ̹ d ʌ̹ ɭ tʰ ʌ̹ d ʌ̹ ɭ
터미널	tʰ ʌ̹ m i n ʌ̹ ɭ
터빈	tʰ ʌ̹ b i n
턱뼈	tʰ ʌ̹ k̚ p͈ j ʌ̹
턱선	tʰ ʌ̹ k s͈ ʌ̹ n
턱수염	tʰ ʌ̹ k s͈ u j ʌ̹ m
털다	tʰ ɘː ɭ d a̠
털어놓다	tʰ ʌ̹ ɾ ʌ̹ n o̞ tʰ a̠
텅스텐	tʰ ʌ̹ ŋ sʰ ɯ tʰ e̞ n
테니스장	tʰ e̞ n i sʰ ɯ d͡ʑ a̠ ŋ
테러리스트	tʰ e̞ ɾ ʌ̹ ɾ i sʰ ɯ tʰ ɯ
테러범	tʰ e̞ ɾ ʌ̹ b ʌ̹ m
테레비	tʰ e̞ ɾ e̞ b i
테스트	tʰ e̞ sʰ ɯ tʰ ɯ
테이블	tʰ e̞ i b ɯ ɭ
테이프	tʰ e̞ i pʰ ɯ
테크네튬	tʰ e̞ k x ɯ n e̞ tʰ j u m
테헤란	tʰ e̞ ɦ e̞ ɾ a̠ n
텍스트	tʰ e̞ k s͈ ɯ tʰ ɯ
텐구	tʰ e̞ n ɡ u
텐트	tʰ e̞ n tʰ ɯ
텔레비	tʰ e̞ ɭ ɭ e̞ b i
텔레비전	tʰ e̞ ɭ ɭ e̞ b i d͡ʑ ʌ̹ n
텔루르	tʰ e̞ ɭ ɭ u ɾ ɯ
템플렛	tʰ e̞ m pʰ ɯ ɭ ɭ e̞ t̚
톈진	tʰ j e̞ ɲ d͡ʑ i n
토고	tʰ o̞ ɡ o̞
토끼	tʰ o̞ k͈ i
토네이도	tʰ o̞ n e̞ i d o̞
토란	tʰ o̞ ɾ a̠ n
토론	tʰ o̞ː ɾ o̞ n
토바고	tʰ o̞ b a̠ ɡ o̞
토성	tʰ o̞ sʰ ʌ̹ ŋ
토스터	tʰ o̞ sʰ ɯ tʰ ʌ̹
토스트	tʰ o̞ sʰ ɯ tʰ ɯ
토시	tʰ o̞ ɕʰ i
토요일	tʰ o̞ j o i ɭ
토욕혼	tʰ o̞ j o kʰ o̞ n
토우	tʰ o̞ u
토의하다	tʰ o̞ː ɰ i ɦ a̠ d a̠
토지	tʰ o̞ d͡ʑ i
토착	tʰ o̞ t͡ɕʰ a̠ k̚
토치	tʰ o̞ t͡ɕʰ i
토픽	tʰ o̞ pʰ i k̚
통가	tʰ o̞ ŋ ɡ a̠
통계	tʰ o̞ː ŋ ɡ j e̞
통계학	tʰ o̞ː ŋ ɡ j e̞ ɦ a̠ k̚
통과	tʰ o̞ ŋ ɡ w a̠
통과하다	tʰ o̞ ŋ ɡ w a̠ ɦ a̠ d a̠
통근	tʰ o̞ ŋ ɡ ɯ n
통근하다	tʰ o̞ ŋ ɡ ɯ n ɦ a̠ d a̠
통금	tʰ o̞ ŋ ɡ ɯ m
통념	tʰ o̞ ŋ ɲ j ʌ̹ m
통로	tʰ o̞ ŋ n o̞
통신	tʰ o̞ ŋ ɕʰ i n
통역사	tʰ o̞ ŋ j ʌ̹ k s͈ a̠
통일	tʰ o̞ː ŋ i ɭ
통제	tʰ o̞ː ŋ d͡ʑ e̞
통조림	tʰ o̞ ŋ d͡ʑ o̞ ɾ i m
통증	tʰ o̞ː ŋ t͡ɕ͈ ɯ ŋ
통찰력	tʰ o̞ː ŋ t͡ɕʰ a̠ ʎ ʎ j ʌ̹ k̚
통풍	tʰ o̞ː ŋ pʰ u ŋ
통하다	tʰ o̞ ŋ ɦ a̠ d a̠
통합	tʰ o̞ː ŋ ɦ a̠ p̚
통화	tʰ o̞ ŋ β w a̠
퇴비	tʰ w e̞ b i
퇴위	tʰ w e̞ ɥ i
퇴직금	tʰ w e̞ː d͡ʑ i k̚ k͈ ɯ m
퇴진	tʰ w e̞ː d͡ʑ i n
퇴폐	tʰ w e̞ pʰ j e̞
퇴학	tʰ w e̞ː ɦ a̠ k̚
투구	tʰ u ɡ u
투기	tʰ u ɡ i
투명하다	tʰ u m j ʌ̹ ŋ ɦ a̠ d a̠
투수	tʰ u sʰ u
투옥	tʰ u o̞ k̚
투척	tʰ u t͡ɕʰ ʌ̹ k̚
투탕카멘	tʰ u tʰ a̠ ŋ kʰ a̠ m e̞ n
투표	tʰ u pʰ j o
투표자	tʰ u pʰ j o d͡ʑ a̠
투표함	tʰ u pʰ j o ɦ a̠ m
투항	tʰ u ɦ a̠ ŋ
퉁명스럽다	tʰ u ŋ m j ʌ̹ ŋ sʰ ɯ ɾ ʌ̹ p̚ t͈ a̠
튀기다	tʰ ɥ i ɡ i d a̠
튀김	tʰ ɥ i ɡ i m
튀니지	tʰ ɥ i n i d͡ʑ i
튀다	tʰ ɥ i d a̠
튤립	tʰ j u ʎ ʎ i p̚
트다	tʰ ɯ d a̠
트러스트	tʰ ɯ ɾ ʌ̹ sʰ ɯ tʰ ɯ
트럼펫	tʰ ɯ ɾ ʌ̹ m pʰ e̞ t̚
트럼프	tʰ ɯ ɾ ʌ̹ m pʰ ɯ
트렁크	tʰ ɯ ɾ ʌ̹ ŋ k x ɯ
트레이너	tʰ ɯ ɾ e̞ i n ʌ̹
트로트	tʰ ɯ ɾ o̞ tʰ ɯ
트로피	tʰ ɯ ɾ o̞ pʰ i
트로필륨	tʰ ɯ ɾ o̞ pʰ i ʎ ʎ j u m
트롤리	tʰ ɯ ɾ o̞ ʎ ʎ i
트롱프뢰유	tʰ ɯ ɾ o̞ ŋ pʰ ɯ ɾ w e̞ j u
트리케라톱스	tʰ ɯ ɾ i kʰ e̞ ɾ a̠ tʰ o̞ p s͈ ɯ
트림	tʰ ɯː ɾ i m
트빌리시	tʰ ɯ b i ʎ ʎ i ɕʰ i
트이다	tʰ ɯ i d a̠
특권	tʰ ɯ k̚ k͈ w ʌ̹ n
특급시	tʰ ɯ k̚ k͈ ɯ p ɕ͈ i
특기	tʰ ɯ k̚ k͈ i
특례	tʰ ɯ ŋ ɲ j e̞
특별하다	tʰ ɯ k̚ p͈ j ʌ̹ ɾ ɦ a̠ d a̠
특별히	tʰ ɯ k̚ p͈ j ʌ̹ ɾ ʝ i
특성	tʰ ɯ k s͈ ʌ̹ ŋ
특유	tʰ ɯ ɡ j u
특정	tʰ ɯ k̚ t͡ɕ͈ ʌ̹ ŋ
특정하다	tʰ ɯ k̚ t͡ɕ͈ ʌ̹ ŋ ɦ a̠ d a̠
특징	tʰ ɯ k̚ t͡ɕ͈ i ŋ
튼튼하다	tʰ ɯ n tʰ ɯ n ɦ a̠ d a̠
틀다	tʰ ɯ ɭ d a̠
틀리다	tʰ ɯ ʎ ʎ i d a̠
틀림없다	tʰ ɯ ʎ ʎ i m ʌ̹ p̚ t͈ a̠
틀림없이	tʰ ɯ ʎ ʎ i m ʌ̹ p ɕ͈ i
티끌	tʰ i k͈ ɯ ɭ
티라나	tʰ i ɾ a̠ n a̠
티라노사우루스	tʰ i ɾ a̠ n o̞ sʰ a̠ u ɾ u sʰ ɯ
티베트	tʰ i b e̞ tʰ ɯ
티브이	tʰ i b ɯ i
티셔츠	tʰ i ɕʰ ʌ̹ t͡ɕʰ ɯ
티슈	tʰ i ɕʰ u
티아졸	tʰ i a̠ d͡ʑ o̞ ɭ
티오펜	tʰ i o̞ pʰ e̞ n
티읕	tʰ i ɯ t̚
티켓	tʰ i kʰ e̞ t̚
티탄	tʰ i tʰ a̠ n
팅팅	tʰ i ŋ tʰ i ŋ
파고다	pʰ a̠ ɡ o̞ d a̠
파괴	pʰ a̠ː ɡ w e̞
파나마	pʰ a̠ n a̠ m a̠
파다	pʰ a̠ d a̠
파동	pʰ a̠ d o̞ ŋ
파동함수	pʰ a̠ d o̞ ŋ ɦ a̠ m sʰ u
파드닥	pʰ a̠ d ɯ d a̠ k̚
파라과이	pʰ a̠ ɾ a̠ ɡ w a̠ i
파라솔	pʰ a̠ ɾ a̠ sʰ o̞ ɭ
파라오	pʰ a̠ ɾ a̠ o̞
파랑	pʰ a̠ ɾ a̠ ŋ
파렴치하다	pʰ a̠ː ɾ j ʌ̹ m t͡ɕʰ i ɦ a̠ d a̠
파리	pʰ a̠ ɾ i
파리하다	pʰ a̠ ɾ i ɦ a̠ d a̠
파문	pʰ a̠ː m u n
파벌	pʰ a̠ b ʌ̹ ɭ
파사삭	pʰ a̠ sʰ a̠ sʰ a̠ k̚
파삭	pʰ a̠ sʰ a̠ k̚
파삭파삭	pʰ a̠ sʰ a̠ k̚ pʰ a̠ sʰ a̠ k̚
파산	pʰ a̠ː sʰ a̠ n
파슈토어	pʰ a̠ ɕʰ u tʰ o̞ ʌ̹
파스타	pʰ a̠ sʰ ɯ tʰ a̠
파스텔	pʰ a̠ sʰ ɯ tʰ e̞ ɭ
파슬리	pʰ a̠ sʰ ɯ ʎ ʎ i
파시스트	pʰ a̠ ɕʰ i sʰ ɯ tʰ ɯ
파시즘	pʰ a̠ ɕʰ i d͡ʑ ɯ m
파업	pʰ a̠ː ʌ̹ p̚
파운데이션	pʰ a̠ u n d e̞ i ɕʰ ʌ̹ n
파운드	pʰ a̠ u n d ɯ
파이	pʰ a̠ i
파이프	pʰ a̠ i pʰ ɯ
파이프오르간	pʰ a̠ i pʰ ɯ o̞ ɾ ɯ ɡ a̠ n
파인더	pʰ a̠ i n d ʌ̹
파일	pʰ a̠ i ɭ
파자마	pʰ a̠ d͡ʑ a̠ m a̠
파장	pʰ a̠ d͡ʑ a̠ ŋ
파출소	pʰ a̠ t͡ɕʰ u ɭ sʰ o̞
파친코	pʰ a̠ t͡ɕʰ i n kʰ o̞
파탄	pʰ a̠ː tʰ a̠ n
파트너	pʰ a̠ tʰ ɯ n ʌ̹
파트타임	pʰ a̠ tʰ ɯ tʰ a̠ i m
파파라치	pʰ a̠ pʰ a̠ ɾ a̠ t͡ɕʰ i
파파야	pʰ a̠ pʰ a̠ j a̠
판결	pʰ a̠ n ɡ j ʌ̹ ɭ
판공실	pʰ a̠ n ɡ o̞ ŋ ɕʰ i ɭ
판권	pʰ a̠ n k͈ w ʌ̹ n
판다	pʰ a̠ n d a̠
판도	pʰ a̠ n d o̞
판도라	pʰ a̠ n d o̞ ɾ a̠
판문점	pʰ a̠ n m u ɲ d͡ʑ ʌ̹ m
판소리	pʰ a̠ n s͈ o̞ ɾ i
판자	pʰ a̠ ɲ d͡ʑ a̠
판지	pʰ a̠ ɲ d͡ʑ i
판판하다	pʰ a̠ n pʰ a̠ n ɦ a̠ d a̠
팔각	pʰ a̠ ɭ ɡ a̠ k̚
팔걸이	pʰ a̠ ɭ ɡ ʌ̹ ɾ i
팔극권	pʰ a̠ ɭ ɡ ɯ k̚ k͈ w ʌ̹ n
팔꿈치	pʰ a̠ ɭ k͈ u m t͡ɕʰ i
팔다	pʰ a̠ ɭ d a̠
팔다리	pʰ a̠ ɭ d a̠ ɾ i
팔딱	pʰ a̠ ɭ t͈ a̠ k̚
팔뚝	pʰ a̠ ɭ t͈ u k̚
팔라듐	pʰ a̠ ɭ ɭ a̠ d j u m
팔라우	pʰ a̠ ɭ ɭ a̠ u
팔랑귀	pʰ a̠ ɭ ɭ a̠ ŋ ɡ ɥ i
팔레스타인	pʰ a̠ ɭ ɭ e̞ sʰ ɯ tʰ a̠ i n
팔목	pʰ a̠ ɭ m o̞ k̚
팔미트산	pʰ a̠ ɭ m i tʰ ɯ sʰ a̠ n
팔방미인	pʰ a̠ ɭ b a̠ ŋ m i i n
팔팔하다	pʰ a̠ ɭ pʰ a̠ ɾ ɦ a̠ d a̠
팝콘	pʰ a̠ p̚ kʰ o̞ n
팥빙수	pʰ a̠ t̚ p͈ i ŋ sʰ u
패권	pʰ ɛː k͈ w ʌ̹ n
패전	pʰ ɛː d͡ʑ ʌ̹ n
퍼센트	pʰ ʌ̹ sʰ e̞ n tʰ ɯ
펄떡	pʰ ʌ̹ ɭ t͈ ʌ̹ k̚
펄럭펄럭	pʰ ʌ̹ ɭ ɭ ʌ̹ k̚ pʰ ʌ̹ ɭ ɭ ʌ̹ k̚
페놀	pʰ e̞ n o̞ ɭ
페니	pʰ e̞ n i
페닐기	pʰ e̞ n i ɭ ɡ i
페달	pʰ e̞ d a̠ ɭ
페르샤어	pʰ e̞ ɾ ɯ ɕʰ a̠ ʌ̹
페르시아	pʰ e̞ ɾ ɯ ɕʰ i a̠
페미니즘	pʰ e̞ m i n i d͡ʑ ɯ m
페샤와르	pʰ e̞ ɕʰ a̠ w a̠ ɾ ɯ
페스트	pʰ e̞ sʰ ɯ tʰ ɯ
페이지	pʰ e̞ i d͡ʑ i
펜션	pʰ e̞ n ɕʰ ʌ̹ n
펠리컨	pʰ e̞ ʎ ʎ i kʰ ʌ̹ n
펩타이드	pʰ e̞ p̚ tʰ a̠ i d ɯ
펩티드	pʰ e̞ p̚ tʰ i d ɯ
펭귄	pʰ e̞ ŋ ɡ ɥ i n
펴다	pʰ j ʌ̹ d a̠
편견	pʰ j ʌ̹ n ɡ j ʌ̹ n
편경	pʰ j ʌ̹ n ɡ j ʌ̹ ŋ
편도	pʰ j ʌ̹ n d o̞
편람	pʰ j ʌ̹ ɭ ɭ a̠ m
편리하다	pʰ j ʌ̹ ʎ ʎ i ɦ a̠ d a̠
편린	pʰ j ʌ̹ ʎ ʎ i n
편복	pʰ j ʌ̹ n b o̞ k̚
편성	pʰ j ʌ̹ n sʰ ʌ̹ ŋ
편안하다	pʰ j ʌ̹ n a̠ n ɦ a̠ d a̠
편의	pʰ j ʌ̹ n ɰ i
편의점	pʰ j ʌ̹ n ɰ i d͡ʑ ʌ̹ m
편자	pʰ j ʌ̹ ɲ d͡ʑ a̠
편종	pʰ j ʌ̹ ɲ d͡ʑ o̞ ŋ
편중	pʰ j ʌ̹ ɲ d͡ʑ u ŋ
편지	pʰ j ɘː ɲ d͡ʑ i
편집	pʰ j ʌ̹ ɲ d͡ʑ i p̚
편집자	pʰ j ʌ̹ ɲ d͡ʑ i p̚ t͡ɕ͈ a̠
편찮다	pʰ j ʌ̹ ɲ t͡ɕʰ a̠ n tʰ a̠
편찮으시다	pʰ j ʌ̹ ɲ t͡ɕʰ a̠ n ɯ ɕʰ i d a̠
편하다	pʰ j ʌ̹ n ɦ a̠ d a̠
펼쳐지다	pʰ j ʌ̹ ʎ t͡ɕʰ ʌ̹ d͡ʑ i d a̠
펼치다	pʰ j ʌ̹ ʎ t͡ɕʰ i d a̠
폄하	pʰ j ɘː m ɦ a̠
폄훼	pʰ j ɘː m β w e̞
평가	pʰ j ɘː ŋ k͈ a̠
평균	pʰ j ʌ̹ ŋ ɡ j u n
평면	pʰ j ʌ̹ ŋ m j ʌ̹ n
평민	pʰ j ʌ̹ ŋ m i n
평범하다	pʰ j ʌ̹ ŋ b ʌ̹ m ɦ a̠ d a̠
평상	pʰ j ʌ̹ ŋ sʰ a̠ ŋ
평성	pʰ j ʌ̹ ŋ sʰ ʌ̹ ŋ
평소	pʰ j ʌ̹ ŋ sʰ o̞
평수	pʰ j ʌ̹ ŋ s͈ u
평안남도	pʰ j ʌ̹ ŋ a̠ n n a̠ m d o̞
평야	pʰ j ʌ̹ ŋ j a̠
평양	pʰ j ʌ̹ ŋ j a̠ ŋ
평온	pʰ j ʌ̹ ŋ o̞ n
평의회	pʰ j ɘː ŋ ɰ i β w e̞
평일	pʰ j ʌ̹ ŋ i ɭ
평정	pʰ j ʌ̹ ŋ d͡ʑ ʌ̹ ŋ
평창	pʰ j ʌ̹ ŋ t͡ɕʰ a̠ ŋ
평판	pʰ j ɘː ŋ pʰ a̠ n
평형	pʰ j ʌ̹ ŋ ʝ j ʌ̹ ŋ
평화	pʰ j ʌ̹ ŋ β w a̠
폐경	pʰ j e̞ː ɡ j ʌ̹ ŋ
폐급	pʰ j e̞ː k͈ ɯ p̚
폐기종	pʰ j e̞ː ɡ i d͡ʑ o̞ ŋ
폐단	pʰ j e̞ː d a̠ n
폐렴	pʰ j e̞ː ɾ j ʌ̹ m
폐어	pʰ j e̞ː ʌ̹
폐지	pʰ j e̞ː d͡ʑ i
폐회식	pʰ j e̞ː β w e̞ ɕʰ i k̚
포도	pʰ o̞ d o̞
포도주	pʰ o̞ d o̞ d͡ʑ u
포럼	pʰ o̞ ɾ ʌ̹ m
포르투갈어	pʰ o̞ ɾ ɯ tʰ u ɡ a̠ ɾ ʌ̹
포름알데히드	pʰ o̞ ɾ ɯ m a̠ ɭ d e̞ ʝ i d ɯ
포부	pʰ o̞ː b u
포삭	pʰ o̞ sʰ a̠ k̚
포스터	pʰ o̞ sʰ ɯ tʰ ʌ̹
포슬포슬	pʰ o̞ sʰ ɯ ɭ pʰ o̞ sʰ ɯ ɭ
포옹	pʰ o̞ː o̞ ŋ
포옹하다	pʰ o̞ː o̞ ŋ ɦ a̠ d a̠
포유류	pʰ o̞ː j u ɾ j u
포인트	pʰ o̞ i n tʰ ɯ
포자	pʰ o̞ d͡ʑ a̠
포치	pʰ o̞ t͡ɕʰ i
포크	pʰ o̞ k x ɯ
포탈	pʰ o̞ tʰ a̠ ɭ
포트	pʰ o̞ tʰ ɯ
포트루이스	pʰ o̞ tʰ ɯ ɾ u i sʰ ɯ
포플러	pʰ o̞ pʰ ɯ ɭ ɭ ʌ̹
포피	pʰ o̞ pʰ i
포함	pʰ o̞ ɦ a̠ m
포화	pʰ o̞ː β w a̠
폭격기	pʰ o̞ k̚ k͈ j ʌ̹ k̚ k͈ i
폭넓다	pʰ o̞ ŋ n ʌ̹ ɭ t͈ a̠
폭동	pʰ o̞ k̚ t͈ o̞ ŋ
폭력	pʰ o̞ ŋ ɲ j ʌ̹ k̚
폭발	pʰ o̞ k̚ p͈ a̠ ɭ
폭정	pʰ o̞ k̚ t͡ɕ͈ ʌ̹ ŋ
폭탄	pʰ o̞ k̚ tʰ a̠ n
폭파	pʰ o̞ k̚ pʰ a̠
폭풍	pʰ o̞ k̚ pʰ u ŋ
폭풍우	pʰ o̞ k̚ pʰ u ŋ u
폴란드	pʰ o̞ ɭ ɭ a̠ n d ɯ
폴란드인	pʰ o̞ ɭ ɭ a̠ n d ɯ i n
폴로	pʰ o̞ ɭ ɭ o̞
폴로늄	pʰ o̞ ɭ ɭ o̞ ɲ j u m
폴리프로필렌	pʰ o̞ ʎ ʎ i pʰ ɯ ɾ o̞ pʰ i ɭ ɭ e̞ n
퐁뒤	pʰ o̞ ŋ d ɥ i
표고	pʰ j o ɡ o̞
표고버섯	pʰ j o ɡ o̞ b ʌ̹ sʰ ʌ̹ t̚
표면	pʰ j o m j ʌ̹ n
표절	pʰ j o d͡ʑ ʌ̹ ɭ
표제	pʰ j o d͡ʑ e̞
표제어	pʰ j o d͡ʑ e̞ ʌ̹
표준어	pʰ j o d͡ʑ u n ʌ̹
표준화	pʰ j oː d͡ʑ u n β w a̠
표지	pʰ j o d͡ʑ i
표지판	pʰ j o d͡ʑ i pʰ a̠ n
표하다	pʰ j oː ɦ a̠ d a̠
표현	pʰ j o ʝ j ʌ̹ n
표현하다	pʰ j o ʝ j ʌ̹ n ɦ a̠ d a̠
푸껫	pʰ u k͈ e̞ t̚
푸다	pʰ u d a̠
푸르다	pʰ u ɾ ɯ d a̠
푸르스름하다	pʰ u ɾ ɯ sʰ ɯ ɾ ɯ m ɦ a̠ d a̠
푸서석푸서석	pʰ u sʰ ʌ̹ sʰ ʌ̹ k̚ pʰ u sʰ ʌ̹ sʰ ʌ̹ k̚
푸석	pʰ u sʰ ʌ̹ k̚
푸젠	pʰ u d͡ʑ e̞ n
푸짐하다	pʰ u d͡ʑ i m ɦ a̠ d a̠
풀네임	pʰ u ɭ ɭ e̞ i m
풀발	pʰ u ɭ b a̠ ɭ
풀이	pʰ u ɾ i
품갚음하다	pʰ u m ɡ a̠ pʰ ɯ m ɦ a̠ d a̠
품격	pʰ uː m k͈ j ʌ̹ k̚
품다	pʰ uː m t͈ a̠
품목	pʰ uː m m o̞ k̚
풋볼	pʰ u t̚ p͈ o̞ ɭ
풋옵션	pʰ u d o̞ p ɕ͈ ʌ̹ n
풍경	pʰ u ŋ ɡ j ʌ̹ ŋ
풍금	pʰ u ŋ ɡ ɯ m
풍덩풍덩	pʰ u ŋ d ʌ̹ ŋ pʰ u ŋ d ʌ̹ ŋ
풍력단지	pʰ u ŋ ɲ j ʌ̹ k̚ t͈ a̠ ɲ d͡ʑ i
풍미	pʰ u ŋ m i
풍부	pʰ u ŋ b u
풍부하다	pʰ u ŋ b u ɦ a̠ d a̠
풍선	pʰ u ŋ sʰ ʌ̹ n
풍속	pʰ u ŋ sʰ o̞ k̚
풍수	pʰ u ŋ sʰ u
풍습	pʰ u ŋ sʰ ɯ p̚
풍요	pʰ u ŋ j o
풍자문	pʰ u ŋ d͡ʑ a̠ m u n
퓨라잔	pʰ j u ɾ a̠ d͡ʑ a̠ n
퓨마	pʰ j u m a̠
프디	pʰ ɯ d i
프라하	pʰ ɯ ɾ a̠ ɦ a̠
프랑스	pʰ ɯ ɾ a̠ ŋ sʰ ɯ
프랑스빵	pʰ ɯ ɾ a̠ ŋ sʰ ɯ p͈ a̠ ŋ
프랑스어	pʰ ɯ ɾ a̠ ŋ sʰ ɯ ʌ̹
프러포즈	pʰ ɯ ɾ ʌ̹ pʰ o̞ d͡ʑ ɯ
프런트	pʰ ɯ ɾ ʌ̹ n tʰ ɯ
프레젠테이션	pʰ ɯ ɾ e̞ d͡ʑ e̞ n tʰ e̞ i ɕʰ ʌ̹ n
프로	pʰ ɯ ɾ o̞
프로세서	pʰ ɯ ɾ o̞ sʰ e̞ sʰ ʌ̹
프로세스	pʰ ɯ ɾ o̞ sʰ e̞ sʰ ɯ
프로젝트	pʰ ɯ ɾ o̞ d͡ʑ e̞ k̚ tʰ ɯ
프로트악티늄	pʰ ɯ ɾ o̞ tʰ ɯ a̠ k̚ tʰ i ɲ j u m
프로파길	pʰ ɯ ɾ o̞ pʰ a̠ ɡ i ɭ
프로판	pʰ ɯ ɾ o̞ pʰ a̠ n
프로펠러	pʰ ɯ ɾ o̞ pʰ e̞ ɭ ɭ ʌ̹
프로필렌	pʰ ɯ ɾ o̞ pʰ i ɭ ɭ e̞ n
프리즘	pʰ ɯ ɾ i d͡ʑ ɯ m
프리지어	pʰ ɯ ɾ i d͡ʑ i ʌ̹
프리토리아	pʰ ɯ ɾ i tʰ o̞ ɾ i a̠
프린터	pʰ ɯ ɾ i n tʰ ʌ̹
프탈라진	pʰ ɯ tʰ a̠ ɭ ɭ a̠ d͡ʑ i n
플라스마	pʰ ɯ ɭ ɭ a̠ sʰ ɯ m a̠
플라스틱	pʰ ɯ ɭ ɭ a̠ sʰ ɯ tʰ i k̚
플러그	pʰ ɯ ɭ ɭ ʌ̹ ɡ ɯ
플러그인	pʰ ɯ ɭ ɭ ʌ̹ ɡ ɯ i n
플러스	pʰ ɯ ɭ ɭ ʌ̹ sʰ ɯ
플루오렌	pʰ ɯ ɭ ɭ u o̞ ɾ e̞ n
플루토늄	pʰ ɯ ɭ ɭ u tʰ o̞ ɲ j u m
플루트	pʰ ɯ ɭ ɭ u tʰ ɯ
플립플롭	pʰ ɯ ʎ ʎ i p̚ pʰ ɯ ɭ ɭ o̞ p̚
피고	pʰ iː ɡ o̞
피난	pʰ iː n a̠ n
피난처	pʰ iː n a̠ ɲ t͡ɕʰ ʌ̹
피다	pʰ i d a̠
피라미드	pʰ i ɾ a̠ m i d ɯ
피란	pʰ i ɾ a̠ n
피롤	pʰ i ɾ o̞ ɭ
피리딘	pʰ i ɾ i d i n
피망	pʰ i m a̠ ŋ
피부	pʰ i b u
피스타치오	pʰ i sʰ ɯ tʰ a̠ t͡ɕʰ i o̞
피시	pʰ i ɕ͈ i
피시방	pʰ i ɕ͈ i b a̠ ŋ
피아니스트	pʰ i a̠ n i sʰ ɯ tʰ ɯ
피에로	pʰ i e̞ ɾ o̞
피우다	pʰ i u d a̠
피워	pʰ i w ʌ̹
피임	pʰ iː i m
피임약	pʰ iː i m j a̠ k̚
피지	pʰ i d͡ʑ i
피크닉	pʰ i k x ɯ n i k̚
피페리딘	pʰ i pʰ e̞ ɾ i d i n
피폭자	pʰ i pʰ o̞ k̚ t͡ɕ͈ a̠
피하다	pʰ iː ɦ a̠ d a̠
피혁	pʰ i ʝ j ʌ̹ k̚
픽업	pʰ i ɡ ʌ̹ p̚
핀란드	pʰ i ɭ ɭ a̠ n d ɯ
핀셋	pʰ i n sʰ e̞ t̚
필름	pʰ i ɭ ɭ ɯ m
필리핀	pʰ i ʎ ʎ i pʰ i n
필수	pʰ i ɭ sʰ u
필수적	pʰ i ɭ s͈ u d͡ʑ ʌ̹ k̚
필승	pʰ i ɭ s͈ ɯ ŋ
필요	pʰ i ɾ j o
필요성	pʰ i ɾ j o s͈ ʌ̹ ŋ
필요하다	pʰ i ɾ j o ɦ a̠ d a̠
필자	pʰ i ʎ t͡ɕ͈ a̠
필터	pʰ i ɭ tʰ ʌ̹
필통	pʰ i ɭ tʰ o̞ ŋ
필획	pʰ i ɾ β w e̞ k̚
핍박	pʰ i p̚ p͈ a̠ k̚
핑계	pʰ i ŋ ɡ j e̞
핑퐁	pʰ i ŋ pʰ o̞ ŋ
하강	h a̠ː ɡ a̠ ŋ
하고	h a̠ ɡ o̞
하극상	h a̠ː ɡ ɯ k s͈ a̠ ŋ
하나	h a̠ n a̠
하나님	h a̠ n a̠ n i m
하남	h a̠ n a̠ m
하녀	h a̠ː ɲ j ʌ̹
하느님	h a̠ n ɯ n i m
하느작	h a̠ n ɯ d͡ʑ a̠ k̚
하늘	h a̠ n ɯ ɭ
하늘나라	h a̠ n ɯ ɭ ɭ a̠ ɾ a̠
하다	h a̠ d a̠
하도	h a̠ d o̞
하루빨리	h a̠ ɾ u p͈ a̠ ʎ ʎ i
하루살이	h a̠ ɾ u sʰ a̠ ɾ i
하마	h a̠ m a̠
하수도	h a̠ː sʰ u d o̞
하숙집	h a̠ː sʰ u k̚ t͡ɕ͈ i p̚
하시다	h a̠ ɕʰ i d a̠
하양	h a̠ j a̠ ŋ
하얗다	h a̠ː j a̠ tʰ a̠
하여간	h a̠ j ʌ̹ ɡ a̠ n
하와	h a̠ w a̠
하원	h a̠ː w ʌ̹ n
하위	h a̠ ɥ i
하이난	h a̠ i n a̠ n
하이드라진	h a̠ i d ɯ ɾ a̠ d͡ʑ i n
하이에나	h a̠ i e̞ n a̠
하이퍼	h a̠ i pʰ ʌ̹
하인	h a̠ː i n
하자	h a̠ d͡ʑ a̠
하즈	h a̠ d͡ʑ ɯ
하지만	h a̠ d͡ʑ i m a̠ n
하천	h a̠ t͡ɕʰ ʌ̹ n
하퇴삼두근	h a̠ tʰ w e̞ sʰ a̠ m d u ɡ ɯ n
하트	h a̠ tʰ ɯ
하품	h a̠ pʰ u m
하프	h a̠ pʰ ɯ
하플로그룹	h a̠ pʰ ɯ ɭ ɭ o̞ ɡ ɯ ɾ u p̚
하필	h a̠ pʰ i ɭ
학과	h a̠ k̚ k͈ w a̠
학교	h a̠ k̚ k͈ j o
학구	h a̠ k̚ k͈ u
학급	h a̠ k̚ k͈ ɯ p̚
학기	h a̠ k̚ k͈ i
학년	h a̠ ŋ ɲ j ʌ̹ n
학력	h a̠ ŋ ɲ j ʌ̹ k̚
학명	h a̠ ŋ m j ʌ̹ ŋ
학문	h a̠ ŋ m u n
학번	h a̠ k̚ p͈ ʌ̹ n
학벌	h a̠ k̚ p͈ ʌ̹ ɭ
학사	h a̠ k s͈ a̠
학살	h a̠ k s͈ a̠ ɭ
학설	h a̠ k s͈ ʌ̹ ɭ
학술	h a̠ k s͈ u ɭ
학습	h a̠ k s͈ ɯ p̚
학식	h a̠ k ɕ͈ i k̚
학원	h a̠ ɡ w ʌ̹ n
학자	h a̠ k̚ t͡ɕ͈ a̠
학회	h a̠ kʰ w e̞
한가	h a̠ n ɡ a̠
한가위	h a̠ n ɡ a̠ ɥ i
한겨레	h a̠ n ɡ j ʌ̹ ɾ e̞
한국	h a̠ː n ɡ u k̚
한국말	h a̠ː n ɡ u ŋ m a̠ ɭ
한국인	h a̠ː n ɡ u ɡ i n
한국학	h a̠ː n ɡ u kʰ a̠ k̚
한글	h a̠ː n ɡ ɯ ɭ
한글날	h a̠ː n ɡ ɯ ɭ ɭ a̠ ɭ
한꺼번에	h a̠ n k͈ ʌ̹ b ʌ̹ n e̞
한도	h a̠ː n d o̞
한동안	h a̠ n d o̞ ŋ a̠ n
한두	h a̠ n d u
한둘	h a̠ n d u ɭ
한라산	h a̠ː ɭ ɭ a̠ sʰ a̠ n
한림원	h a̠ ʎ ʎ i m w ʌ̹ n
한마디	h a̠ n m a̠ d i
한물	h a̠ n m u ɭ
한민족	h a̠ː n m i ɲ d͡ʑ o̞ k̚
한반도	h a̠ː n b a̠ n d o̞
한복	h a̠ː n b o̞ k̚
한사군	h a̠ː n sʰ a̠ ɡ u n
한성	h a̠ː n sʰ ʌ̹ ŋ
한숨	h a̠ n sʰ u m
한시름	h a̠ n ɕʰ i ɾ ɯ m
한식집	h a̠ n ɕ͈ i k̚ t͡ɕ͈ i p̚
한약	h a̠ː ɲ j a̠ k̚
한양	h a̠ː ɲ j a̠ ŋ
한어	h a̠ː n ʌ̹
한여름	h a̠ n ɲ j ʌ̹ ɾ ɯ m
한영	h a̠ː ɲ j ʌ̹ ŋ
한자어	h a̠ː ɲ t͡ɕ͈ a̠ ʌ̹
한잔	h a̠ ɲ d͡ʑ a̠ n
한정되다	h a̠ ɲ d͡ʑ ʌ̹ ŋ d w e̞ d a̠
한중	h a̠ː ɲ d͡ʑ u ŋ
한참	h a̠ ɲ t͡ɕʰ a̠ m
한테	h a̠ n tʰ e̞
한편	h a̠ n pʰ j ʌ̹ n
할라페뇨	h a̠ ɭ ɭ a̠ pʰ e̞ ɲ j o
할로윈	h a̠ ɭ ɭ o̞ ɥ i n
할머니	h a̠ ɭ m ʌ̹ n i
할머님	h a̠ ɭ m ʌ̹ n i m
할미꽃	h a̠ ɭ m i k͈ o̞ t̚
할아버지	h a̠ ɾ a̠ b ʌ̹ d͡ʑ i
할인	h a̠ ɾ i n
할퀴다	h a̠ ɭ kʰ ɥ i d a̠
함경	h a̠ m ɡ j ʌ̹ ŋ
함경남도	h a̠ m ɡ j ʌ̹ ŋ n a̠ m d o̞
함경북도	h a̠ m ɡ j ʌ̹ ŋ b u k̚ t͈ o̞
함구증	h a̠ m ɡ u t͡ɕ͈ ɯ ŋ
함께	h a̠ m k͈ e̞
함께하다	h a̠ m k͈ e̞ ɦ a̠ d a̠
함량	h a̠ m ɲ j a̠ ŋ
함묵증	h a̠ m m u k̚ t͡ɕ͈ ɯ ŋ
함부로	h a̠ m b u ɾ o̞
함성	h a̠ m sʰ ʌ̹ ŋ
함수	h a̠ː m s͈ u
함흥	h a̠ m ɣ ɯ ŋ
합격	h a̠ p̚ k͈ j ʌ̹ k̚
합계	h a̠ p̚ k͈ j e̞
합금	h a̠ p̚ k͈ ɯ m
합기도	h a̠ p̚ k͈ i d o̞
합법	h a̠ p̚ p͈ ʌ̹ p̚
합법화	h a̠ p̚ p͈ ʌ̹ pʰ w a̠
합법화되다	h a̠ p̚ p͈ ʌ̹ pʰ w a̠ d w e̞ d a̠
합성록음하다	h a̠ p s͈ ʌ̹ ŋ n o̞ ɡ ɯ m ɦ a̠ d a̠
합성어	h a̠ p s͈ ʌ̹ ŋ ʌ̹
합스부르크	h a̠ p s͈ ɯ b u ɾ ɯ k x ɯ
합작	h a̠ p̚ t͡ɕ͈ a̠ k̚
합중국	h a̠ p̚ t͡ɕ͈ u ŋ ɡ u k̚
합창	h a̠ p̚ t͡ɕʰ a̠ ŋ
합창단	h a̠ p̚ t͡ɕʰ a̠ ŋ d a̠ n
합체	h a̠ p̚ t͡ɕʰ e̞
핫도그	h a̠ t̚ t͈ o̞ ɡ ɯ
항공기	h a̠ː ŋ ɡ o̞ ŋ ɡ i
항공사	h a̠ː ŋ ɡ o̞ ŋ sʰ a̠
항복	h a̠ ŋ b o̞ k̚
항상	h a̠ ŋ sʰ a̠ ŋ
항성	h a̠ ŋ sʰ ʌ̹ ŋ
항아리	h a̠ ŋ a̠ ɾ i
항암제	h a̠ː ŋ a̠ m d͡ʑ e̞
항의	h a̠ː ŋ ɰ i
항일	h a̠ː ŋ i ɭ
항체	h a̠ ŋ t͡ɕʰ e̞
해결	h ɛː ɡ j ʌ̹ ɭ
해결되다	h ɛː ɡ j ʌ̹ ɭ d w e̞ d a̠
해고	h ɛː ɡ o̞
해고하다	h ɛː ɡ o̞ ɦ a̠ d a̠
해군	h ɛː ɡ u n
해금	h ɛː ɡ ɯ m
해녀	h ɛː ɲ j ʌ̹
해달	h ɛː d a̠ ɭ
해도	h ɛː d o̞
해리	h ɛː ɾ i
해마	h ɛː m a̠
해면	h ɛː m j ʌ̹ n
해물	h ɛː m u ɭ
해변	h ɛː b j ʌ̹ n
해병	h ɛː b j ʌ̹ ŋ
해부학	h ɛː b u ɦ a̠ k̚
해산물	h ɛː sʰ a̠ n m u ɭ
해삼	h ɛː sʰ a̠ m
해상도	h ɛː sʰ a̠ ŋ d o̞
해석하다	h ɛː sʰ ʌ̹ kʰ a̠ d a̠
해소	h ɛː sʰ o̞
해안	h ɛː a̠ n
해열	h ɛː j ʌ̹ ɭ
해왕성	h ɛː w a̠ ŋ sʰ ʌ̹ ŋ
해외	h ɛː w e̞
해일	h ɛː i ɭ
해장	h ɛː d͡ʑ a̠ ŋ
해저	h ɛː d͡ʑ ʌ̹
해제	h ɛː d͡ʑ e̞
해주	h ɛː d͡ʑ u
해파리	h ɛː pʰ a̠ ɾ i
행복	h ɛː ŋ b o̞ k̚
행운	h ɛː ŋ u n
행운아	h ɛː ŋ u n a̠
행인	h ɛː ŋ i n
허가	h ʌ̹ ɡ a̠
허락	h ʌ̹ ɾ a̠ k̚
허락하다	h ʌ̹ ɾ a̠ kʰ a̠ d a̠
허리	h ʌ̹ ɾ i
허리띠	h ʌ̹ ɾ i t͈ i
허리케인	h ʌ̹ ɾ i kʰ e̞ i n
허무주의	h ʌ̹ m u d͡ʑ u ɰ i
허물다	h ʌ̹ m u ɭ d a̠
허베이	h ʌ̹ b e̞ i
허브티	h ʌ̹ b ɯ tʰ i
허수	h ʌ̹ sʰ u
허술하다	h ʌ̹ sʰ u ɾ ɦ a̠ d a̠
허영심	h ʌ̹ j ʌ̹ ŋ ɕʰ i m
허용	h ʌ̹ j o ŋ
허허	h ʌ̹ ɦ ʌ̹
헌금	h ɘː n ɡ ɯ m
헌법	h ɘː n p͈ ʌ̹ p̚
헌팅	h ʌ̹ n tʰ i ŋ
험담	h ɘː m d a̠ m
헛걸음	h ʌ̹ t̚ k͈ ʌ̹ ɾ ɯ m
헛방귀	h ʌ̹ t̚ p͈ a̠ ŋ ɡ ɥ i
헝가리	h ʌ̹ ŋ ɡ a̠ ɾ i
헤드폰	h e̞ d ɯ pʰ o̞ n
헤로인	h e̞ ɾ o̞ i n
헤르메스	h e̞ ɾ ɯ m e̞ sʰ ɯ
헤르츠	h e̞ ɾ ɯ t͡ɕʰ ɯ
헤모글로빈	h e̞ m o̞ ɡ ɯ ɭ ɭ o̞ b i n
헤아리다	h e̞ː a̠ ɾ i d a̠
헤어지다	h e̞ ʌ̹ d͡ʑ i d a̠
헤엄치다	h e̞ ʌ̹ m t͡ɕʰ i d a̠
헤파이스토스	h e̞ pʰ a̠ i sʰ ɯ tʰ o̞ sʰ ɯ
헬기	h e̞ ɭ ɡ i
헬륨	h e̞ ʎ ʎ j u m
헬리콥터	h e̞ ʎ ʎ i kʰ o̞ p̚ tʰ ʌ̹
헬멧	h e̞ ɭ m e̞ t̚
헬스클럽	h e̞ ɭ sʰ ɯ k x ɯ ɭ ɭ ʌ̹ p̚
헵테인	h e̞ p̚ tʰ e̞ i n
호기심	ɸʷ o̞ː ɡ i ɕʰ i m
호남	ɸʷ o̞ n a̠ m
호놀룰루	ɸʷ o̞ n o̞ ɭ ɭ u ɭ ɭ u
호두	ɸʷ o̞ d u
호떡	ɸʷ o̞ t͈ ʌ̹ k̚
호랑	ɸʷ o̞ ɾ a̠ ŋ
호랑나비	ɸʷ o̞ː ɾ a̠ ŋ n a̠ b i
호랑이	ɸʷ o̞ː ɾ a̠ ŋ i
호러	ɸʷ o̞ ɾ ʌ̹
호루라기	ɸʷ o̞ ɾ u ɾ a̠ ɡ i
호르몬	ɸʷ o̞ ɾ ɯ m o̞ n
호밀	ɸʷ o̞ m i ɭ
호박	ɸʷ o̞ː b a̠ k̚
호소	ɸʷ o̞ sʰ o̞
호숫가	ɸʷ o̞ sʰ u t̚ k͈ a̠
호스	ɸʷ o̞ sʰ ɯ
호전	ɸʷ o̞ː d͡ʑ ʌ̹ n
호주	ɸʷ o̞ d͡ʑ u
호주머니	ɸʷ o̞ d͡ʑ u m ʌ̹ n i
호주인	ɸʷ o̞ d͡ʑ u i n
호지명	ɸʷ o̞ d͡ʑ i m j ʌ̹ ŋ
호텔	ɸʷ o̞ tʰ e̞ ɭ
호평	ɸʷ o̞ː pʰ j ʌ̹ ŋ
호흡하다	ɸʷ o̞ ɣ ɯ pʰ a̠ d a̠
혹성	ɸʷ o̞ k s͈ ʌ̹ ŋ
혹시	ɸʷ o̞ k ɕ͈ i
혹시나	ɸʷ o̞ k ɕ͈ i n a̠
혹여	ɸʷ o̞ ɡ j ʌ̹
혹여나	ɸʷ o̞ ɡ j ʌ̹ n a̠
혹은	ɸʷ o̞ ɡ ɯ n
혼돈	ɸʷ o̞ n d o̞ n
혼란	ɸʷ o̞ː ɭ ɭ a̠ n
혼령	ɸʷ o̞ ʎ ʎ j ʌ̹ ŋ
혼례	ɸʷ o̞ ʎ ʎ j e̞
혼례식	ɸʷ o̞ ʎ ʎ j e̞ ɕʰ i k̚
혼수	ɸʷ o̞ n sʰ u
혼약	ɸʷ o̞ ɲ j a̠ k̚
혼자	ɸʷ o̞ ɲ d͡ʑ a̠
혼합	ɸʷ o̞ n ɦ a̠ p̚
혼혈	ɸʷ o̞ː n ʝ j ʌ̹ ɭ
홀로	ɸʷ o̞ ɭ ɭ o̞
홀소리어울림	ɸʷ o̞ ɭ s͈ o̞ ɾ i ʌ̹ u ʎ ʎ i m
홀아비	ɸʷ o̞ ɾ a̠ b i
홀어미	ɸʷ o̞ ɾ ʌ̹ m i
홈페이지	ɸʷ o̞ m pʰ e̞ i d͡ʑ i
홈페지	ɸʷ o̞ m pʰ e̞ d͡ʑ i
홋카이도	ɸʷ o̞ t̚ kʰ a̠ i d o̞
홍길동	ɸʷ o̞ ŋ ɡ i ɭ d o̞ ŋ
홍당무	ɸʷ o̞ ŋ d a̠ ŋ m u
홍머리오리	ɸʷ o̞ ŋ m ʌ̹ ɾ i o̞ ɾ i
홍보	ɸʷ o̞ ŋ b o̞
홍송어	ɸʷ o̞ ŋ sʰ o̞ ŋ ʌ̹
홍수	ɸʷ o̞ ŋ sʰ u
홍시	ɸʷ o̞ ŋ ɕʰ i
홍어	ɸʷ o̞ ŋ ʌ̹
홍어회	ɸʷ o̞ ŋ ʌ̹ β w e̞
홍역	ɸʷ o̞ ŋ j ʌ̹ k̚
홍차	ɸʷ o̞ ŋ t͡ɕʰ a̠
홍콩	ɸʷ o̞ ŋ kʰ o̞ ŋ
홍합	ɸʷ o̞ ŋ ɦ a̠ p̚
화가	ɸ w a̠ː ɡ a̠
화강암	ɸ w a̠ ɡ a̠ ŋ a̠ m
화기	ɸ w a̠ː ɡ i
화단	ɸ w a̠ d a̠ n
화물	ɸ w a̠ː m u ɭ
화보	ɸ w a̠ː b o̞
화분	ɸ w a̠ b u n
화사하다	ɸ w a̠ sʰ a̠ ɦ a̠ d a̠
화산학	ɸ w a̠ː sʰ a̠ n ɦ a̠ k̚
화살	ɸ w a̠ sʰ a̠ ɭ
화살표	ɸ w a̠ sʰ a̠ ɭ pʰ j o
화석	ɸ w a̠ː sʰ ʌ̹ k̚
화신	ɸ w a̠ː ɕʰ i n
화약	ɸ w a̠ː j a̠ k̚
화염병	ɸ w a̠ː j ʌ̹ m p͈ j ʌ̹ ŋ
화요일	ɸ w a̠ j o i ɭ
화음	ɸ w a̠ ɯ m
화이자	ɸ w a̠ i d͡ʑ a̠
화이팅	ɸ w a̠ i tʰ i ŋ
화장장	ɸ w a̠ː d͡ʑ a̠ ŋ d͡ʑ a̠ ŋ
화장지	ɸ w a̠ d͡ʑ a̠ ŋ d͡ʑ i
화지	ɸ w a̠ d͡ʑ i
화차	ɸ w a̠ː t͡ɕʰ a̠
화창하다	ɸ w a̠ t͡ɕʰ a̠ ŋ ɦ a̠ d a̠
화폐	ɸ w a̠ː pʰ j e̞
화학	ɸ w a̠ː ɦ a̠ k̚
화학자	ɸ w a̠ː ɦ a̠ k̚ t͡ɕ͈ a̠
화합물	ɸ w a̠ː ɦ a̠ m m u ɭ
확률	ɸ w a̠ ŋ ɲ j u ɭ
확립	ɸ w a̠ ŋ n i p̚
확산	ɸ w a̠ k s͈ a̠ n
확성기	ɸ w a̠ k s͈ ʌ̹ ŋ ɡ i
확신	ɸ w a̠ k ɕ͈ i n
확실하다	ɸ w a̠ k ɕ͈ i ɾ ɦ a̠ d a̠
확인	ɸ w a̠ ɡ i n
확인하다	ɸ w a̠ ɡ i n ɦ a̠ d a̠
확장	ɸ w a̠ k̚ t͡ɕ͈ a̠ ŋ
환경	ɸ w a̠ n ɡ j ʌ̹ ŋ
환경오염	ɸ w a̠ n ɡ j ʌ̹ ŋ o̞ j ʌ̹ m
환관	ɸ w a̠ n ɡ w a̠ n
환멸	ɸ w a̠ː n m j ʌ̹ ɭ
환불	ɸ w a̠ n b u ɭ
환상	ɸ w a̠ː n sʰ a̠ ŋ
환상적	ɸ w a̠ n sʰ a̠ ŋ d͡ʑ ʌ̹ k̚
환승	ɸ w a̠ː n sʰ ɯ ŋ
환전	ɸ w a̠ ɲ d͡ʑ ʌ̹ n
환절기	ɸ w a̠ː ɲ d͡ʑ ʌ̹ ɭ ɡ i
환하다	ɸ w a̠ː n ɦ a̠ d a̠
활기	ɸ w a̠ ɭ ɡ i
활동	ɸ w a̠ ɭ t͈ o̞ ŋ
활동가	ɸ w a̠ ɭ t͈ o̞ ŋ ɡ a̠
활동사진	ɸ w a̠ ɭ t͈ o̞ ŋ sʰ a̠ d͡ʑ i n
활동적	ɸ w a̠ ɭ t͈ o̞ ŋ d͡ʑ ʌ̹ k̚
활동하다	ɸ w a̠ ɭ t͈ o̞ ŋ ɦ a̠ d a̠
활발	ɸ w a̠ ɭ b a̠ ɭ
활발하다	ɸ w a̠ ɭ b a̠ ɾ ɦ a̠ d a̠
활성	ɸ w a̠ ɭ s͈ ʌ̹ ŋ
활성탄	ɸ w a̠ ɭ s͈ ʌ̹ ŋ tʰ a̠ n
활용	ɸ w a̠ ɾ j o ŋ
활자	ɸ w a̠ ʎ t͡ɕ͈ a̠
황금	ɸ w a̠ ŋ ɡ ɯ m
황도	ɸ w a̠ː ŋ d o̞
황동	ɸ w a̠ ŋ d o̞ ŋ
황량	ɸ w a̠ ŋ ɲ j a̠ ŋ
황량하다	ɸ w a̠ ŋ ɲ j a̠ ŋ ɦ a̠ d a̠
황로	ɸ w a̠ ŋ n o̞
황어	ɸ w a̠ ŋ ʌ̹
황제	ɸ w a̠ ŋ d͡ʑ e̞
황조롱이	ɸ w a̠ ŋ d͡ʑ o̞ ɾ o̞ ŋ i
황하	ɸ w a̠ ŋ ɦ a̠
황혼	ɸ w a̠ ŋ β o̞ n
황후	ɸ w a̠ ŋ β u
회계사	ɸ w e̞ː ɡ j e̞ sʰ a̠
회계학	ɸ w e̞ː ɡ j e̞ ɦ a̠ k̚
회관	ɸ w e̞ː ɡ w a̠ n
회교	ɸ w e̞ ɡ j o
회귀	ɸ w e̞ ɡ ɥ i
회담	ɸ w e̞ː d a̠ m
회랑	ɸ w e̞ ɾ a̠ ŋ
회령	ɸ w e̞ː ɾ j ʌ̹ ŋ
회복하다	ɸ w e̞ b o̞ kʰ a̠ d a̠
회비	ɸ w e̞ː b i
회사	ɸ w e̞ː sʰ a̠
회사원	ɸ w e̞ː sʰ a̠ w ʌ̹ n
회상	ɸ w e̞ sʰ a̠ ŋ
회원	ɸ w e̞ː w ʌ̹ n
회음	ɸ w e̞ː ɯ m
회장	ɸ w e̞ː d͡ʑ a̠ ŋ
회전	ɸ w e̞ d͡ʑ ʌ̹ n
회전목마	ɸ w e̞ d͡ʑ ʌ̹ n m o̞ ŋ m a̠
회합	ɸ w e̞ː ɦ a̠ p̚
횡단	ɸ w e̞ ŋ d a̠ n
횡단보도	ɸ w e̞ ŋ d a̠ n b o̞ d o̞
횡적	ɸ w e̞ ŋ t͡ɕ͈ ʌ̹ k̚
횡파	ɸ w e̞ ŋ pʰ a̠
후견인	ɸʷ uː ɡ j ʌ̹ n i n
후계자	ɸʷ uː ɡ j e̞ d͡ʑ a̠
후뇌	ɸʷ u n w e̞
후두	ɸʷ u d u
후드	ɸʷ u d ɯ
후레이크	ɸʷ u ɾ e̞ i k x ɯ
후베이	ɸʷ u b e̞ i
후보자	ɸʷ u b o̞ d͡ʑ a̠
후식	ɸʷ uː ɕʰ i k̚
후예	ɸʷ uː j e̞
후유증	ɸʷ uː j u t͡ɕ͈ ɯ ŋ
후작	ɸʷ u d͡ʑ a̠ k̚
후조	ɸʷ u d͡ʑ o̞
후지	ɸʷ u d͡ʑ i
후추	ɸʷ u t͡ɕʰ u
후춧가루	ɸʷ u t͡ɕʰ u t̚ k͈ a̠ ɾ u
후쿠시마	ɸʷ u kʰ u ɕʰ i m a̠
훈독	ɸʷ uː n d o̞ k̚
훈민정음	ɸʷ uː n m i ɲ d͡ʑ ʌ̹ ŋ ɯ m
훈장	ɸʷ u ɲ d͡ʑ a̠ ŋ
훈제	ɸʷ u ɲ d͡ʑ e̞
훈주음종	ɸʷ uː ɲ d͡ʑ u ɯ m d͡ʑ o̞ ŋ
훑어보다	ɸʷ u ɭ tʰ ʌ̹ b o̞ d a̠
휘파람	h ɥ i pʰ a̠ ɾ a̠ m
휠체어	h ɥ i ʎ t͡ɕʰ e̞ ʌ̹
흐느적	x ɯ n ɯ d͡ʑ ʌ̹ k̚
흐르다	x ɯ ɾ ɯ d a̠
흐름	x ɯ ɾ ɯ m
흐릿하다	x ɯ ɾ i tʰ a̠ d a̠
흐지부지	x ɯ d͡ʑ i b u d͡ʑ i
흑두루미	x ɯ k̚ t͈ u ɾ u m i
흑로	x ɯ ŋ n o̞
흑설탕	x ɯ k s͈ ʌ̹ ɭ tʰ a̠ ŋ
흑인	x ɯ ɡ i n
흑체	x ɯ k̚ t͡ɕʰ e̞
흑흑	x ɯ k x ɯ k̚
흔들다	x ɯ n d ɯ ɭ d a̠
흔들리다	x ɯ n d ɯ ʎ ʎ i d a̠
흔적	x ɯ ɲ d͡ʑ ʌ̹ k̚
흔하다	x ɯ n ɦ a̠ d a̠
흔히	x ɯ n ʝ i
흘러가다	x ɯ ɭ ɭ ʌ̹ ɡ a̠ d a̠
흘리다	x ɯ ʎ ʎ i d a̠
흠결	x ɯ m ɡ j ʌ̹ ɭ
흠뻑	x ɯ m p͈ ʌ̹ k̚
흡사	x ɯ p s͈ a̠
흡수지	x ɯ p s͈ u d͡ʑ i
흡연	x ɯ b j ʌ̹ n
흡연자	x ɯ b j ʌ̹ ɲ d͡ʑ a̠
흡인력	x ɯ b i ʎ ʎ j ʌ̹ k̚
흡혈귀	x ɯ pʰ j ʌ̹ ɭ ɡ ɥ i
흥미	x ɯː ŋ m i
흥미롭다	x ɯː ŋ m i ɾ o̞ p̚ t͈ a̠
흥분	x ɯ ŋ b u n
흥분하다	x ɯ ŋ b u n ɦ a̠ d a̠
흥정	x ɯ ŋ d͡ʑ ʌ̹ ŋ
흥청망청	x ɯ ŋ t͡ɕʰ ʌ̹ ŋ m a̠ ŋ t͡ɕʰ ʌ̹ ŋ
흥하다	x ɯ ŋ ɦ a̠ d a̠
흩다	x ɯ t̚ t͈ a̠
흩어지다	x ɯ tʰ ʌ̹ d͡ʑ i d a̠
