աա	ɑ ɑ
աախ	ɑ ɑ χ ə
աած	ɑ ɑ t s ə
աահ	ɑ ɑ h ə
աապ	ɑ ɑ p ə
աբաջյան	ɑ b ɑ d ʒ j ɑ n
աբաս	ɑ b ɑ s
աբգար	ɑ b ɡ ɑ ɾ
աբել	ɑ b ɛ l
աբերդին	ɑ b ɛ ɾ d i n
աբխազական	ɑ pʰ χ ɑ z ɑ k ɑ n
աբխազիա	ɑ pʰ χ ɑ z j ɑ
աբոնեմենտային	ɑ b ɔ n ɛ m ɛ n t ɑ j i n
աբովյան	ɑ b ɔ v j ɑ n
աբսուրդ	ɑ pʰ s u ɾ d
աբստրակտ	ɑ pʰ s t ɾ ɑ k t
աբրահամյան	ɑ b ɾ ɑ h ɑ m j ɑ n
ագն	ɑ ɡ ə n ə
ագռավ	ɑ ɡ r ɑ v
ագրեսիա	ɑ ɡ ɾ ɛ s j ɑ
ադամանդ	ɑ d ɑ m ɑ n d
ադրբեջան	ɑ d ə ɾ b ɛ d͡ʒ ɑ n
ադրբեջանական	ɑ d ə ɾ b ɛ d͡ʒ ɑ n ɑ k ɑ n
ադրբեջաներեն	ɑ d ə ɾ b ɛ d͡ʒ ɑ n ɛ ɾ ɛ n
ադրբեջանցի	ɑ d ə ɾ b ɛ d͡ʒ ɑ n t͡sʰ i
ազատագրել	ɑ z ɑ t ɑ ɡ ɾ ɛ l
ազատագրում	ɑ z ɑ t ɑ ɡ ɾ u m
ազատագրվել	ɑ z ɑ t ɑ ɡ ə ɾ v ɛ l
ազատել	ɑ z ɑ t ɛ l
ազգ	ɑ z ɡ
ազգագրական	ɑ z ɡ ɑ ɡ ə ɾ ɑ k ɑ n
ազգական	ɑ z ɡ ɑ k ɑ n
ազգային	ɑ z ɡ ɑ j i n
ազգայնականություն	ɑ z ɡ ɑ j n ɑ k ɑ n u tʰ j u n
ազգասեր	ɑ z ɡ ɑ s ɛ ɾ
ազգեր	ɑ z ɡ ɛ ɾ
ազդանշան	ɑ z d ɑ n ə ʃ ɑ n
ազդարարել	ɑ z d ɑ ɾ ɑ ɾ ɛ l
ազդել	ɑ z d ɛ l
ազդեցիկ	ɑ z d ɛ t͡sʰ i k
ազդեցություն	ɑ z d ɛ t͡sʰ u tʰ j u n
ազդող	ɑ z d ɔ ʁ
ազերի	ɑ z ɛ ɾ i
ազիկ	ɑ z i k
ազնավուր	ɑ z n ɑ v u ɾ
ազնիվ	ɑ z n i v
ազոխ	ɑ z o χ
աթոռ	ɑ tʰ ɔ r
աժ	ɑ ʒ ə
ալ	ɑ l
ալավերդի	ɑ l ɑ v ɛ ɾ d i
ալբերտ	ɑ l b ɛ ɾ t
ալեքսանդր	ɑ l ɛ kʰ s ɑ n d ə ɾ
ալեքսանդրիա	ɑ l ɛ kʰ s ɑ n d ɾ j ɑ
ալի	ɑ l i
ալիք	ɑ l i kʰ
ալկոհոլ	ɑ l k ɔ h ɔ l
ալկոհոլային	ɑ l k o h o l ɑ j i n
ալտերնատիվ	ɑ l t ɛ ɾ n ɑ t i v
ախալցխա	ɑ χ ɑ l t͡sʰ ə χ ɑ
ախորժակ	ɑ χ ɔ ɾ ʒ ɑ k
ախուրյան	ɑ χ u ɾ j ɑ n
ախպեր	ɑ χ p ɛ ɾ
ախտորոշում	ɑ χ t ɔ ɾ ɔ ʃ u m
ածել	ɑ t͡s ɛ l
ածիկ	ɑ t͡s i k
ական	ɑ k ɑ n
ականավոր	ɑ k ɑ n ɑ v ɔ ɾ
ականի	ɑ k ɑ n i
ականջ	ɑ k ɑ n d͡ʒ
ականջակալ	ɑ k ɑ n d͡ʒ ɑ k ɑ l
ակնածանք	ɑ k n ɑ t͡s ɑ ŋ kʰ
ակներեւ	ɑ k n ɛ ɾ ɛ v
ակնթարթ	ɑ k ə n tʰ ɑ ɾ tʰ
ակնկալել	ɑ k ə ŋ k ɑ l ɛ l
ակնկալիք	ɑ k ə ŋ k ɑ l i kʰ
ակնհայտ	ɑ k ə n h ɑ j t
ակնոց	ɑ k n ɔ t͡sʰ
ակումբ	ɑ k u m b
ակունք	ɑ k u ŋ kʰ
ակրոպոլիս	ɑ k ɾ ɔ p ɔ l i s
ահ	ɑ h
ահաբեկել	ɑ h ɑ b ɛ k ɛ l
ահաբեկիչ	ɑ h ɑ b ɛ k i t͡ʃʰ
ահաբեկչական	ɑ h ɑ b ɛ k t ʃʰ ɑ k ɑ n
ահաբեկչություն	ɑ h ɑ b ɛ k t ʃʰ u t sʰ j u n
ահագին	ɑ h ɑ ɡ i n
ահազանգ	ɑ h ɑ z ɑ ŋ ɡ
ահազանգել	ɑ h ɑ z ɑ ŋ ɡ ɛ l
ահազանգում	ɑ h ɑ z ɑ ŋ ɡ u m
ահարոն	ɑ h ɑ ɾ o n
ահեղ	ɑ h ɛ ʁ
աղա	ɑ ʁ ɑ
աղանդավոր	ɑ ʁ ɑ n d ɑ v o ɾ
աղանդավորական	ɑ ʁ ɑ n d ɑ v o ɾ ɑ k ɑ n
աղասի	ɑ ʁ ɑ s i
աղավաղել	ɑ ʁ ɑ v ɑ ʁ ɛ l
աղավնի	ɑ ʁ ɑ v n i
աղբաման	ɑ ʁ b ɑ m ɑ n
աղեկ	ɑ ʁ ɛ k
աղետ	ɑ ʁ ɛ t
աղմուկ	ɑ ʁ m u k
աղյուսակ	ɑ ʁ j u s ɑ k
աղոտ	ɑ ʁ ɔ t
աղու	ɑ ʁ u
աղվան	ɑ ʁ v ɑ n
աղցան	ɑ ʁ t͡sʰ ɑ n
աղքատ	ɑ χ kʰ ɑ t
աճ	ɑ t͡ʃ
աճել	ɑ t͡ʃ ɛ l
աճեցնել	ɑ t͡ʃ ɛ t͡sʰ n ɛ l
ամ	ɑ m
ամայի	ɑ m ɑ j i
աման	ɑ m ɑ n
ամանորյա	ɑ m ɑ n ɔ ɾ j ɑ
ամառային	ɑ m ɑ r ɑ j i n
ամբաստանյալ	ɑ m b ɑ s t ɑ n j ɑ l
ամբարտավան	ɑ m b ɑ ɾ t ɑ v ɑ n
ամբողջ	ɑ m b ɔ χ t͡ʃʰ
ամբողջություն	ɑ m b o χ t ʃʰ u t sʰ j u n
ամեն	ɑ m ɛ n
ամենաբարձր	ɑ m ɛ n ɑ b ɑ ɾ t͡sʰ ə ɾ
ամենազոր	ɑ m ɛ n ɑ z ɔ ɾ
ամենալավ	ɑ m ɛ n ɑ l ɑ v
ամենայն	ɑ m ɛ n ɑ j n
ամենեւին	ɑ m ɛ n ɛ v i n
ամենուր	ɑ m ɛ n u ɾ
ամենուրեք	ɑ m ɛ n u ɾ ɛ kʰ
ամերիկա	ɑ m ɛ ɾ i k ɑ
ամերիկահայ	ɑ m ɛ ɾ i k ɑ h ɑ j
ամերիկայի	ɑ m ɛ ɾ i k ɑ j i
ամերիկացի	ɑ m ɛ ɾ i k ɑ t͡sʰ i
ամէ	ɑ m ə ɛ
ամիս	ɑ m i s
ամիրյան	ɑ m i ɾ j ɑ n
ամն	ɑ m ə n ə
ամոթ	ɑ m ɔ tʰ
ամուսնացած	ɑ m u s n ɑ t͡sʰ ɑ t͡s
ամուր	ɑ m u ɾ
ամպ	ɑ m p
ամպրոպ	ɑ m p ɾ ɔ p
ամսագիր	ɑ m s ɑ ɡ i ɾ
ամսական	ɑ m s ɑ k ɑ n
ամսեկան	ɑ m s ɛ k ɑ n
այբբենարան	ɑ j bː ɛ n ɑ ɾ ɑ n
այդ	ɑ j d
այժմ	ɑ j ʒ ə m
այլ	ɑ j l
այլեւայլ	ɑ j l ɛ v ɑ j l
այլեւս	ɑ j l ɛ v ə s
այլընտրանք	ɑ j l ə n t ɾ ɑ ŋ kʰ
այլընտրանքային	ɑ j l ə n t ɾ ɑ ŋ kʰ ɑ j i n
այծ	ɑ j t͡s
այն	ɑ j n
այնուամենայնիվ	ɑ j n u ɑ m ɛ n ɑ j n i v
այնուհետեւ	ɑ j n u h ɛ t ɛ v
այնտեղ	ɑ j n t ɛ ʁ
այս	ɑ j s
այսինքն	ɑ j s i ŋ kʰ ə n
այսու	ɑ j s u
այսուհետեւ	ɑ j s u h ɛ t ɛ v
այստեղ	ɑ j s t ɛ ʁ
այսօր	ɑ j s ɔ ɾ
այվազյան	ɑ ɪ̯ v ɑ z ɪ̯ ɑ n
այր	ɑ j ɾ
այրել	ɑ j ɾ ɛ l
այրի	ɑ j ɾ i
այրվել	ɑ j ɾ v ɛ l
այց	ɑ j t sʰ
այցելել	ɑ j t sʰ ɛ l ɛ l
այցելություն	ɑ j t͡sʰ ɛ l u tʰ j u n
անագորույն	ɑ n ɑ ɡ ɔ ɾ u j n
անակնկալ	ɑ n ɑ k ə ŋ k ɑ l
անաղարտ	ɑ n ɑ ʁ ɑ ɾ t
անարատ	ɑ n ɑ ɾ ɑ t
անարդար	ɑ n ɑ ɾ tʰ ɑ ɾ
անարդարություն	ɑ n ɑ ɾ tʰ ɑ ɾ u tʰ j u n
անբնակ	ɑ n b ə n ɑ k
անգլերեն	ɑ ŋ ɡ l ɛ ɾ ɛ n
անգլիական	ɑ ŋ ɡ l j ɑ k ɑ n
անգնահատելի	ɑ ŋ ɡ ə n ɑ h ɑ t ɛ l i
անգործ	ɑ ŋ ɡ ɔ ɾ t͡s
անդ	ɑ n d
անդամ	ɑ n tʰ ɑ m
անդրեաս	ɑ n d ɾ ɛ ɑ s
անդրշիրիմյան	ɑ n d ə ɾ ʃ i ɾ i m j ɑ n
անել	ɑ n ɛ l
անելիք	ɑ n ɛ l i kʰ
աներ	ɑ n ɛ ɾ
անզոր	ɑ n z ɔ ɾ
անընդհատ	ɑ n ə n d h ɑ t
անժելա	ɑ n ʒ ɛ l ɑ
անիծյալ	ɑ n i t͡s j ɑ l
անծանոթ	ɑ n t͡s ɑ n ɔ tʰ
անկախ	ɑ ŋ k ɑ χ
անկաշկանդ	ɑ ŋ k ɑ ʃ k ɑ n d
անկարա	ɑ ŋ k ɑ ɾ ɑ
անկյուն	ɑ ŋ k j u n
անկում	ɑ n k u m
անհամբեր	ɑ n h ɑ m pʰ ɛ ɾ
անհանգիստ	ɑ n h ɑ ŋ ɡ i s t
անհապաղ	ɑ n h ɑ p ɑ ʁ
անհավանական	ɑ n h ɑ v ɑ n ɑ k ɑ n
անհատ	ɑ n h ɑ t
անհատականություն	ɑ n h ɑ t ɑ k ɑ n u tʰ j u n
անհեթեթ	ɑ n h ɛ tʰ ɛ tʰ
անհետ	ɑ n h ɛ t
անհերքելի	ɑ n h ɛ ɾ kʰ ɛ l i
անհնար	ɑ n h ə n ɑ ɾ
անհույս	ɑ n h u ɪ̯ s
անձ	ɑ n d͡z
անձավ	ɑ n d͡z ɑ v
անձեռոց	ɑ n d͡z ɛ r ɔ t͡sʰ
անձեռոցիկ	ɑ n d͡z ɛ r ɔ t͡sʰ i k
անձինք	ɑ n d͡z i ŋ kʰ
անձիք	ɑ n d͡z i kʰ
անձնագիր	ɑ n d z n ɑ ɡ i ɾ
անձրեւ	ɑ n d͡z ɾ ɛ v
անմահ	ɑ n m ɑ h
անմարդաբնակ	ɑ n m ɑ ɾ tʰ ɑ b ə n ɑ k
անմեղ	ɑ n m ɛ ʁ
անմեռ	ɑ n m ɛ r
անմիջականորեն	ɑ n m i t͡ʃʰ ɑ k ɑ n ɔ ɾ ɛ n
անմիջապես	ɑ n m i t͡ʃʰ ɑ p ɛ s
անմիտ	ɑ n m i t
անշարժ	ɑ n ʃ ɑ ɾ ʒ
անոթի	ɑ n o tʰ i
անորոշ	ɑ n ɔ ɾ ɔ ʃ
անորոշություն	ɑ n ɔ ɾ ɔ ʃ u tʰ j u n
անուն	ɑ n u n
անուշ	ɑ n u ʃ
անուշավան	ɑ n u ʃ ɑ v ɑ n
անպատասխանատու	ɑ n p ɑ t ɑ s χ ɑ n ɑ t u
անպիտան	ɑ n p i t ɑ n
անջատել	ɑ n d͡ʒ ɑ t ɛ l
անսովոր	ɑ n s o v o ɾ
անվադող	ɑ n v ɑ d ɔ ʁ
անվանի	ɑ n v ɑ n i
անվավեր	ɑ n v ɑ v ɛ ɾ
անվտանգ	ɑ n v ə t ɑ ŋ ɡ
անվտանգության	ɑ n v ə t ɑ ŋ ɡ u tʰ j ɑ n
անվտանգություն	ɑ n v ə t ɑ ŋ ɡ u tʰ j u n
անվրդով	ɑ n v ə ɾ tʰ ɔ v
անտանելի	ɑ n t ɑ n ɛ l i
անտեղյակ	ɑ n t ɛ ʁ j ɑ k
անտիկ	ɑ n t i k
անտիպ	ɑ n t i p
անտուն	ɑ n t u n
անց	ɑ n t͡sʰ
անցած	ɑ n t͡sʰ ɑ t͡s
անցկացնել	ɑ n t͡sʰ k ɑ t͡sʰ n ɛ l
անցյալ	ɑ n t͡sʰ j ɑ l
անցնել	ɑ n t͡sʰ n ɛ l
անցք	ɑ n t͡sʰ kʰ
անօգնական	ɑ n ɔ kʰ n ɑ k ɑ n
աշխատակազմ	ɑ ʃ χ ɑ t ɑ k ɑ z m
աշխատակից	ɑ ʃ χ ɑ t ɑ k i t͡sʰ
աշխարհ	ɑ ʃ χ ɑ ɾ
աշխարհաքաղաքական	ɑ ʃ χ ɑ ɾ ɑ kʰ ɑ ʁ ɑ kʰ ɑ k ɑ n
աշխեն	ɑ ʃ χ ɛ n
աշխույժ	ɑ ʃ χ u j ʒ
աշոտ	ɑ ʃ ɔ t
աշուղ	ɑ ʃ u ʁ
աչալուրջ	ɑ t͡ʃʰ ɑ l u ɾ d͡ʒ
աչք	ɑ t͡ʃʰ kʰ
ապագա	ɑ p ɑ ɡ ɑ
ապակի	ɑ p ɑ k i
ապահով	ɑ p ɑ h ɔ v
ապահովել	ɑ p ɑ h ɔ v ɛ l
ապահովում	ɑ p ɑ h ɔ v u m
ապահովվել	ɑ p ɑ h ɔ vː ɛ l
ապաստան	ɑ p ɑ s t ɑ n
ապավինել	ɑ p ɑ v i n ɛ l
ապարան	ɑ p ɑ ɾ ɑ n
ապարատ	ɑ p ɑ ɾ ɑ t
ապացույց	ɑ p ɑ t͡sʰ u j t͡sʰ
ապացուցել	ɑ p ɑ t͡sʰ u t͡sʰ ɛ l
ապացուցում	ɑ p ɑ t͡sʰ u t͡sʰ u m
ապեր	ɑ p ɛ ɾ
ապերախտ	ɑ p ɛ ɾ ɑ χ t
ապհ	ɑ p ə h ə
ապշել	ɑ p ʃ ɛ l
ապուշ	ɑ p u ʃ
ապստամբ	ɑ pʰ s t ɑ m b
ապտակ	ɑ p t ɑ k
ապրանք	ɑ p ɾ ɑ ŋ kʰ
ապրիլյան	ɑ p ɾ i l j ɑ n
աջ	ɑ t͡ʃʰ
աջակցել	ɑ t͡ʃʰ ɑ k t͡sʰ ɛ l
աջարական	ɑ d ʒ ɑ ɾ ɑ k ɑ n
առ	ɑ r
առագաստ	ɑ r ɑ ɡ ɑ s t
առած	ɑ r ɑ t͡s
առակ	ɑ r ɑ k
առանց	ɑ r ɑ n t͡sʰ
առաջ	ɑ r ɑ t͡ʃʰ
առաջադեմ	ɑ r ɑ t͡ʃʰ ɑ d ɛ m
առաջադիմել	ɑ r ɑ t͡ʃʰ ɑ d i m ɛ l
առաջադիմություն	ɑ r ɑ t͡ʃʰ ɑ d i m u tʰ j u n
առաջադրանք	ɑ r ɑ t͡ʃʰ ɑ d ɾ ɑ ŋ kʰ
առաջավոր	ɑ r ɑ t͡ʃʰ ɑ v ɔ ɾ
առաջատար	ɑ r ɑ t͡ʃʰ ɑ t ɑ ɾ
առաջարկ	ɑ r ɑ t͡ʃʰ ɑ ɾ k
առաջարկություն	ɑ r ɑ t͡ʃʰ ɑ ɾ k u t͡sʰ j u n
առաջընթաց	ɑ r ɑ t͡ʃʰ ə n tʰ ɑ t͡sʰ
առաջիկա	ɑ r ɑ t͡ʃʰ i k ɑ
առաջին	ɑ r ɑ t͡ʃʰ i n
առաջնորդ	ɑ r ɑ t͡ʃʰ n ɔ ɾ tʰ
առասպել	ɑ r ɑ s p ɛ l
առավել	ɑ r ɑ v ɛ l
առավելագույն	ɑ r ɑ v ɛ l ɑ ɡ u j n
առավելություն	ɑ r ɑ v ɛ l u tʰ j u n
առավոտ	ɑ r ɑ v ɔ t
առատ	ɑ r ɑ t
առաքելյան	ɑ r ɑ kʰ ɛ l j ɑ n
առաքելություն	ɑ r ɑ kʰ ɛ l u tʰ j u n
առաքինի	ɑ r ɑ kʰ i n i
առիթ	ɑ r i tʰ
առկա	ɑ r k ɑ
առկախ	ɑ r k ɑ χ
առձեռն	ɑ r d͡z ɛ r ə n
առյուծ	ɑ r j u t͡s
առնական	ɑ r n ɑ k ɑ n
առնանդամ	ɑ r n ɑ n tʰ ɑ m
առնել	ɑ r n ɛ l
առնո	ɑ r n o
առնչություն	ɑ r ə n t͡ʃʰ u tʰ j u n
առնվազն	ɑ r n ə v ɑ z n
առողջ	ɑ r ɔ χ t͡ʃʰ
առողջանալ	ɑ r ɔ χ t͡ʃʰ ɑ n ɑ l
առույգ	ɑ r u j ɡ
առջեւ	ɑ r t͡ʃʰ ɛ v
ասած	ɑ s ɑ t͡s
ասատրյան	ɑ s ɑ t ə ɾ j ɑ n
ասացվածք	ɑ s ɑ t͡sʰ v ɑ t͡s kʰ
ասել	ɑ s ɛ l
ասեղ	ɑ s ɛ ʁ
ասիական	ɑ s j ɑ k ɑ n
ասորերեն	ɑ s ɔ ɾ ɛ ɾ ɛ n
ասորի	ɑ s ɔ ɾ i
ասոցիացիա	ɑ s ɔ t͡sʰ j ɑ t͡sʰ j ɑ
ասուլիս	ɑ s u l i s
ասպարեզ	ɑ s p ɑ ɾ ɛ z
ասպետ	ɑ s p ɛ t
աստիճան	ɑ s t i t͡ʃ ɑ n
աստիճաններ	ɑ s t i t͡ʃ ɑ nː ɛ ɾ
աստղ	ɑ s t ə ʁ
աստղիկ	ɑ s t ʁ i k
աստված	ɑ s t v ɑ t͡s
աստվածաբանական	ɑ s t v ɑ t͡s ɑ b ɑ n ɑ k ɑ n
աստվածատուր	ɑ s t v ɑ t͡s ɑ t u ɾ
աստրախան	ɑ s t ɾ ɑ χ ɑ n
ասք	ɑ s kʰ
ավագ	ɑ v ɑ kʰ
ավագանի	ɑ v ɑ kʰ ɑ n i
ավազ	ɑ v ɑ z
ավանակ	ɑ v ɑ n ɑ k
ավանդական	ɑ v ɑ n d ɑ k ɑ n
ավար	ɑ v ɑ ɾ
ավարտ	ɑ v ɑ ɾ t
ավարտել	ɑ v ɑ ɾ t ɛ l
ավարտում	ɑ v ɑ ɾ t u m
ավարտվել	ɑ v ɑ ɾ t v ɛ l
ավել	ɑ v ɛ l
ավելացնել	ɑ v ɛ l ɑ t͡sʰ n ɛ l
ավելի	ɑ v ɛ l i
ավելորդ	ɑ v ɛ l ɔ ɾ tʰ
ավետ	ɑ v ɛ t
ավետարան	ɑ v ɛ t ɑ ɾ ɑ n
ավետիսյան	ɑ v ɛ t i s j ɑ n
ավետիք	ɑ v ɛ t i kʰ
ավերել	ɑ v ɛ ɾ ɛ l
ավտոբուս	ɑ f t ɔ b u s
ավտոմեքենա	ɑ f t ɔ m ɛ kʰ ɛ n ɑ
ավտոտնակ	ɑ f t ɔ t ə n ɑ k
ատամ	ɑ t ɑ m
ատամնաբույժ	ɑ t ɑ m n ɑ b u j ʒ
ատամնային	ɑ t ɑ m n ɑ j i n
ատամները	ɑ t ɑ m n ɛ ɾ ə
ատելություն	ɑ t ɛ l u tʰ j u n
ատենախոսություն	ɑ t ɛ n ɑ χ ɔ s u tʰ j u n
ատյան	ɑ t j ɑ n
ատոմ	ɑ t o m
ատրճանակ	ɑ t ə ɾ t͡ʃ ɑ n ɑ k
ար	ɑ ɾ
արաբ	ɑ ɾ ɑ b
արաբական	ɑ ɾ ɑ b ɑ k ɑ n
արագ	ɑ ɾ ɑ ɡ
արած	ɑ ɾ ɑ t͡s
արական	ɑ ɾ ɑ k ɑ n
արամ	ɑ ɾ ɑ m
արամյան	ɑ ɾ ɑ m j ɑ n
արայիկ	ɑ ɾ ɑ j i k
արարած	ɑ ɾ ɑ ɾ ɑ t͡s
արարատ	ɑ ɾ ɑ ɾ ɑ t
արարել	ɑ ɾ ɑ ɾ ɛ l
արարողություն	ɑ ɾ ɑ ɾ ɔ ʁ u tʰ j u n
արարք	ɑ ɾ ɑ ɾ kʰ
արաքս	ɑ ɾ ɑ kʰ s
արգավանդ	ɑ ɾ ɡ ɑ v ɑ n d
արգելել	ɑ ɾ kʰ ɛ l ɛ l
արգելք	ɑ ɾ kʰ ɛ l kʰ
արդար	ɑ ɾ tʰ ɑ ɾ
արդարադատություն	ɑ ɾ tʰ ɑ ɾ ɑ d ɑ t u tʰ j u n
արդարացի	ɑ ɾ tʰ ɑ ɾ ɑ t͡sʰ i
արդարացնել	ɑ ɾ tʰ ɑ ɾ ɑ t͡sʰ n ɛ l
արդարություն	ɑ ɾ tʰ ɑ ɾ u tʰ j u n
արդիականացում	ɑ ɾ d i j ɑ k ɑ n ɑ t͡sʰ u m
արդյունավետ	ɑ ɾ tʰ j u n ɑ v ɛ t
արդյունք	ɑ ɾ tʰ j u ŋ kʰ
արդուկ	ɑ ɾ d u k
արեգակնային	ɑ ɾ ɛ ɡ ɑ k n ɑ j i n
արեւելյան	ɑ ɾ ɛ v ɛ l j ɑ n
արեւմտյան	ɑ ɾ ɛ v m ə t j ɑ n
արթնանալ	ɑ ɾ tʰ n ɑ n ɑ l
արթնացնել	ɑ ɾ tʰ n ɑ t͡sʰ n ɛ l
արթուն	ɑ ɾ tʰ u n
արթուր	ɑ ɾ tʰ u ɾ
արժանի	ɑ ɾ ʒ ɑ n i
արժենալ	ɑ ɾ ʒ ɛ n ɑ l
արժեք	ɑ ɾ ʒ ɛ kʰ
արժույթ	ɑ ɾ ʒ u j tʰ
արի	ɑ ɾ i
արիություն	ɑ ɾ i j u tʰʲ u n
արխիվ	ɑ ɾ χ i v
արծաթ	ɑ ɾ t͡s ɑ tʰ
արծաթի	ɑ ɾ t͡s ɑ tʰ i
արհեստ	ɑ ɾ v ɛ s t
արհեստական	ɑ ɾ h ɛ s t ɑ k ɑ n
արհեստավոր	ɑ ɾ h ɛ s t ɑ v ɔ ɾ
արձագանք	ɑ ɾ d͡z ɑ ɡ ɑ ŋ kʰ
արձագանքել	a ɾ d͡z a ɡ a n kʰ ɛ l
արմ	ɑ ɾ m
արմավիր	ɑ ɾ m ɑ v i ɾ
արմեն	ɑ ɾ m ɛ n
արմենակ	ɑ ɾ m ɛ n ɑ k
արմին	ɑ ɾ m i n
արյուն	ɑ ɾ j u n
արշալույս	ɑ ɾ ʃ ɑ l u j s
արշակունյաց	ɑ ɾ ʃ ɑ k u n j ɑ t͡sʰ
արշավ	ɑ ɾ ʃ ɑ v
արշավանք	ɑ ɾ ʃ ɑ v ɑ ŋ kʰ
արոնյան	ɑ ɾ ɔ n j ɑ n
արու	ɑ ɾ u
արջ	ɑ ɾ t͡ʃʰ
արսեն	ɑ ɾ s ɛ n
արսենի	ɑ ɾ s ɛ n i
արվեստ	ɑ ɾ v ɛ s t
արվեստագետ	ɑ ɾ v ɛ s t ɑ ɡ ɛ t
արտագաղթ	ɑ ɾ t ɑ ɡ ɑ χ tʰ
արտագաղթել	ɑ ɾ t ɑ ɡ ɑ χ tʰ ɛ l
արտադրող	ɑ ɾ t ɑ d ɾ ɔ ʁ
արտադրություն	ɑ ɾ t ɑ d ɾ u tʰ j u n
արտահանում	ɑ ɾ t ɑ h ɑ n u m
արտահերթ	ɑ ɾ t ɑ h ɛ ɾ tʰ
արտաշատ	ɑ ɾ t ɑ ʃ ɑ t
արտասահման	ɑ ɾ t ɑ s ɑ h m ɑ n
արտասովոր	ɑ ɾ t ɑ s ɔ v ɔ ɾ
արտասուք	ɑ ɾ t ɑ s u kʰ
արտասվել	ɑ ɾ t ɑ s v ɛ l
արտարժույթ	ɑ ɾ t ɑ ɾ ʒ u j tʰ
արտոնագիր	ɑ ɾ t ɔ n ɑ ɡ i ɾ
արցախյան	ɑ ɾ t͡sʰ ɑ χ j ɑ n
արցունք	ɑ ɾ t͡sʰ u ŋ kʰ
արփի	ɑ ɾ pʰ i
արքա	ɑ ɾ kʰ ɑ
արքայադուստր	ɑ ɾ kʰ ɑ j ɑ d u s t ə ɾ
արքայազն	ɑ ɾ kʰ ɑ j ɑ z ə n
արքունի	ɑ ɾ kʰ u n i
ափ	ɑ pʰ
ափի	ɑ pʰ i
ափսոս	ɑ pʰ s ɔ s
աքիլլես	ɑ kʰ i lː ɛ s
աֆղանստան	ɑ f ʁ ɑ n ə s t ɑ n
աֆրիկա	ɑ f ɾ i k ɑ
բաբայան	b ɑ b ɑ j ɑ n
բաբաջանյան	b ɑ b ɑ d͡ʒ ɑ n j ɑ n
բազա	b ɑ z ɑ
բազազ	b ɑ z ɑ z
բազալտ	b ɑ z ɑ l t
բազմերանգ	b ɑ z m ɛ ɾ ɑ ŋ ɡ
բազմոց	b ɑ z m ɔ t͡sʰ
բազմություն	b ɑ z m u t sʰ j u n
բազում	b ɑ z u m
բաթումի	b ɑ tʰ u m i
բաժակ	b ɑ ʒ ɑ k
բաժանորդ	b ɑ ʒ ɑ n ɔ ɾ tʰ
բաժանում	b ɑ ʒ ɑ n u m
բաժին	b ɑ ʒ i n
բալիկ	b ɑ l i k
բախում	b ɑ χ u m
բախտ	b ɑ χ t
բակ	b ɑ k
բակո	b ɑ k ɔ
բաղդասարյան	b ɑ ʁ d ɑ s ɑ ɾ j ɑ n
բաճկոն	b ɑ t͡ʃ k ɔ n
բամբակ	b ɑ m b ɑ k
բայց	b ɑ j t͡sʰ
բան	b ɑ n
բանակ	b ɑ n ɑ k
բանաձեւ	b ɑ n ɑ d z ɛ v
բանան	b ɑ n ɑ n
բանաստեղծ	b ɑ n ɑ s t ɛ χ t͡s
բանաստեղծություն	b ɑ n ɑ s t ɛ ʁ t͡s u tʰ j u n
բանավեճ	b ɑ n ɑ v ɛ t͡ʃ
բանբեր	b ɑ n b ɛ ɾ
բանեցնել	b ɑ n ɛ t͡sʰ n ɛ l
բանկ	b ɑ n k
բանկային	b ɑ ŋ k ɑ j i n
բանսարկու	b ɑ n s ɑ ɾ k u
բանվոր	b ɑ n v o ɾ
բանտ	b ɑ n t
բանտարկություն	b ɑ n t ɑ ɾ k u t sʰ j u n
բաշխել	b ɑ ʃ χ ɛ l
բառապաշար	b ɑ r ɑ p ɑ ʃ ɑ ɾ
բառարան	b ɑ r ɑ ɾ ɑ n
բառացանկ	b ɑ r ɑ t sʰ ɑ n k
բառացի	b ɑ r ɑ t͡sʰ i
բավական	b ɑ v ɑ k ɑ n
բավարար	b ɑ v ɑ ɾ ɑ ɾ
բավարարել	b ɑ v ɑ ɾ ɑ ɾ ɛ l
բարակ	b ɑ ɾ ɑ k
բարաք	b ɑ ɾ ɑ kʰ
բարգավաճ	b ɑ ɾ ɡ ɑ v ɑ t͡ʃ
բարդացնել	b ɑ ɾ tʰ ɑ t͡sʰ n ɛ l
բարեգործական	b ɑ ɾ ɛ ɡ ɔ ɾ t͡s ɑ k ɑ n
բարեգործություն	b ɑ ɾ ɛ ɡ ɔ ɾ t͡s u tʰ j u n
բարելավել	b ɑ ɾ ɛ l ɑ v ɛ l
բարեկենդան	b ɑ ɾ ɛ k ɛ n tʰ ɑ n
բարեւ	b ɑ ɾ ɛ v
բարձ	b ɑ ɾ t͡sʰ
բարձր	b ɑ ɾ t͡sʰ ə ɾ
բարձրագույն	b ɑ ɾ t͡sʰ ɾ ɑ ɡ u j n
բարձրաձայն	b ɑ ɾ t͡sʰ ɾ ɑ d͡z ɑ j n
բարձրանալ	b ɑ ɾ t͡sʰ ɾ ɑ n ɑ l
բարձրացնել	b ɑ ɾ t͡sʰ ɾ ɑ t͡sʰ n ɛ l
բարձրացում	b ɑ ɾ t͡sʰ ɾ ɑ t͡sʰ u m
բարձրություն	b ɑ ɾ t͡sʰ ɾ u tʰ j u n
բարոն	b ɑ ɾ ɔ n
բարով	b ɑ ɾ ɔ v
բարսեղյան	b ɑ ɾ s ɛ ʁ j ɑ n
բարվոք	b ɑ ɾ v o kʰ
բաց	b ɑ t͡sʰ
բացակա	b ɑ t͡sʰ ɑ k ɑ
բացականչում	b ɑ t͡sʰ ɑ k ɑ n t͡ʃʰ u m
բացահայտ	b ɑ t͡sʰ ɑ h ɑ j t
բացառապես	b ɑ t͡sʰ ɑ r ɑ p ɛ s
բացառել	b ɑ t͡sʰ ɑ r ɛ l
բացառիկ	b ɑ t͡sʰ ɑ r i k
բացառություն	b ɑ t͡sʰ ɑ r u tʰ j u n
բացասական	b ɑ t͡sʰ ɑ s ɑ k ɑ n
բացատրական	b ɑ t͡sʰ ɑ t ɾ ɑ k ɑ n
բացատրել	b ɑ t͡sʰ ɑ t ɾ ɛ l
բացարձակ	b ɑ t͡sʰ ɑ ɾ t͡sʰ ɑ k
բացել	b ɑ t͡sʰ ɛ l
բացի	b ɑ t͡sʰ i
բացում	b ɑ t͡sʰ u m
բաքու	b ɑ kʰ u
բեթհովեն	b ɛ tʰ h ɔ v ɛ n
բելառուս	b ɛ l ɑ r u s
բելուջստան	b ɛ l u d͡ʒ s t ɑ n
բեղ	b ɛ ʁ
բեղուն	b ɛ ʁ u n
բեն	b ɛ n
բենգալերեն	b ɛ n ɡ ɑ l ɛ ɾ ɛ n
բենզին	b ɛ n z i n
բեռ	b ɛ r
բեռն	b ɛ r n
բեռնատար	b ɛ r n ɑ t ɑ ɾ
բերան	b ɛ ɾ ɑ n
բերանի	b ɛ ɾ ɑ n i
բերել	b ɛ ɾ ɛ l
բերման	b ɛ ɾ m ɑ n
բերրի	b ɛ ɾː i
բժշկություն	b ə ʒ ə ʃ k u tʰ j u n
բիզնես	b i z n ɛ s
բիլ	b i l
բիծ	b i t͡s
բլիթ	b ə l i tʰ
բլոգ	b l o ɡ
բլոգեր	b ə l ɔ ɡ ɛ ɾ
բլոկադա	b l ɔ k ɑ d ɑ
բլուր	b ə l u ɾ
բխել	b ə χ ɛ l
բհկ	b ə h ə k ə
բղավել	b ə ʁ ɑ v ɛ l
բյուջետային	b j u d͡ʒ ɛ t ɑ j i n
բնական	b ə n ɑ k ɑ n
բնակարան	b ə n ɑ k ɑ ɾ ɑ n
բնակչություն	b ə n ɑ k t͡ʃʰ u t͡sʰ j u n
բնակվել	b ə n ɑ k v ɛ l
բնորոշ	b ə n ɔ ɾ ɔ ʃ
բնորոշել	b ə n ɔ ɾ ɔ ʃ ɛ l
բնութագրել	b ə n u tʰ ɑ ɡ ə ɾ ɛ l
բնույթ	b ə n u j tʰ
բոբիկ	b ɔ b i k
բոլոնիա	b ɔ l ɔ n j ɑ
բոլոր	b ɔ l ɔ ɾ
բոլորը	b ɔ l ɔ ɾ ə
բոլորովին	b ɔ l ɔ ɾ ɔ v i n
բողկ	b ɔ χ k
բողոք	b ɔ ʁ ɔ kʰ
բողոքարկել	b ɔ ʁ ɔ kʰ ɑ ɾ k ɛ l
բողոքել	b o ʁ o kʰ ɛ l
բոնուս	b ɔ n u s
բովանդակություն	b ɔ v ɑ n d ɑ k u tʰ j u n
բորենի	b ɔ ɾ ɛ n i
բորոտ	b ɔ ɾ ɔ t
բուդ	b u d
բութ	b u tʰ
բուժել	b u ʒ ɛ l
բուլղարացի	b u l ʁ ɑ ɾ ɑ t͡sʰ i
բուխարեստ	b u χ ɑ ɾ ɛ s t
բույր	b u j ɾ
բուն	b u n
բուռն	b u r ə n
բուսական	b u s ɑ k ɑ n
բուստ	b u s t
բուրդ	b u ɾ tʰ
բջիջ	b ə d͡ʒ i d͡ʒ
բջջային	b ə d͡ʒ ə d͡ʒ ɑ j i n
բռնաբար	b ə r n ɑ b ɑ ɾ
բռնաբարել	b ə r n ɑ b ɑ ɾ ɛ l
բռնակալ	b ə r n ɑ k ɑ l
բռնապետ	b ə r n ɑ p ɛ t
բռնություն	b ə r n u tʰ j u n
բրազիլիա	b ɾ ɑ z i l j ɑ
բրատիսլավա	b ɾ ɑ t i s l ɑ v ɑ
բրիտանական	b ɾ i t ɑ n ɑ k ɑ n
բրիտանացի	b ɾ i t ɑ n ɑ t͡sʰ i
բրիտանիա	b ɾ i t ɑ n j ɑ
բրյուսել	b ɾ j u s ɛ l
բրոնզ	b ə ɾ ɔ n z
բրուցելոզ	b ɾ u t sʰ ɛ l o z
գագաթ	ɡ ɑ ɡ ɑ tʰ
գազ	ɡ ɑ z
գազայի	ɡ ɑ z ɑ j i
գաթա	ɡ ɑ tʰ ɑ
գալ	ɡ ɑ l
գալիս	ɡ ɑ l i s
գալուստ	ɡ ɑ l u s t
գալստյան	ɡ ɑ l ə s t j ɑ n
գաղափար	ɡ ɑ ʁ ɑ pʰ ɑ ɾ
գաղտնաբառ	ɡ ɑ χ t n ɑ b ɑ r
գաղտնի	ɡ ɑ χ t n i
գաղտնիք	ɡ ɑ χ t n i kʰ
գայանե	ɡ ɑ j ɑ n ɛ
գայթակղել	ɡ ɑ j tʰ ɑ k ə ʁ ɛ l
գայլ	ɡ ɑ j l
գանձ	ɡ ɑ n d͡z
գանձակ	ɡ ɑ n d͡z ɑ k
գառնարած	ɡ ɑ r n ɑ ɾ ɑ t͡s
գառնիկ	ɡ ɑ r n i k
գավաթ	ɡ ɑ v ɑ tʰ
գավառ	ɡ ɑ v ɑ r
գարեգին	ɡ ɑ ɾ ɛ ɡ i n
գարեջուր	ɡ ɑ ɾ ɛ d͡ʒ u ɾ
գարիկ	ɡ ɑ ɾ i k
գարնանային	ɡ ɑ ɾ n ɑ n ɑ j i n
գարուն	ɡ ɑ ɾ u n
գգվել	ɡ ə kʰ v ɛ l
գդալ	ɡ ə tʰ ɑ l
գել	ɡ ɛ l
գեղ	ɡ ɛ ʁ
գեղամ	ɡ ɛ ʁ ɑ m
գեղամյան	ɡ ɛ ʁ ɑ m j ɑ n
գեղարդ	ɡ ɛ ʁ ɑ ɾ tʰ
գեղարվեստական	ɡ ɛ ʁ ɑ ɾ v ɛ s t ɑ k ɑ n
գեղարքունիք	ɡ ɛ ʁ ɑ ɾ kʰ u n i kʰ
գեղեցկություն	ɡ ɛ ʁ ɛ t͡sʰ k u tʰ j u n
գեղձի	ɡ ɛ ʁ d͡z i
գեներալ	ɡ ɛ n ɛ ɾ ɑ l
գեշ	ɡ ɛ ʃ
գետ	ɡ ɛ t
գետին	ɡ ɛ t i n
գեր	ɡ ɛ ɾ
գերագնահատել	ɡ ɛ ɾ ɑ ɡ ə n ɑ h ɑ t ɛ l
գերագույն	ɡ ɛ ɾ ɑ ɡ u j n
գերազանցություն	ɡ ɛ ɾ ɑ z ɑ n t͡sʰ u tʰ j u n
գերանդի	ɡ ɛ ɾ ɑ n d i
գերել	ɡ ɛ ɾ ɛ l
գերի	ɡ ɛ ɾ i
գերմանական	ɡ ɛ ɾ m ɑ n ɑ k ɑ n
գերմանացի	ɡ ɛ ɾ m ɑ n ɑ t͡sʰ i
գերմաներեն	ɡ ɛ ɾ m ɑ n ɛ ɾ ɛ n
գերմանիա	ɡ ɛ ɾ m ɑ n j ɑ
գերմանիայի	ɡ ɛ ɾ m ɑ n j ɑ j i
գեւորգ	ɡ ɛ v ɔ ɾ kʰ
գիժ	ɡ i ʒ
գինի	ɡ i n i
գիշերային	ɡ i ʃ ɛ ɾ ɑ j i n
գիսակ	ɡ i s ɑ k
գիսաստղ	ɡ i s ɑ s t ə ʁ
գիտական	ɡ i t ɑ k ɑ n
գիտակից	ɡ i t ɑ k i t͡sʰ
գիտակցական	ɡ i t ɑ k t͡sʰ ɑ k ɑ n
գիտակցել	ɡ i t ɑ k t͡sʰ ɛ l
գիտակցում	ɡ i t ɑ k t͡sʰ u m
գիտեմ	ɡ i t ɛ m
գիտենալ	ɡ i t ɛ n ɑ l
գիտնական	ɡ i t n ɑ k ɑ n
գիտություն	ɡ i t u tʰ j u n
գիր	ɡ i ɾ
գիրուկ	ɡ i ɾ u k
գիրք	ɡ i ɾ kʰ
գիրքը	ɡ i ɾ kʰ ə
գիրքն	ɡ i ɾ kʰ n
գլխավոր	ɡ ə l χ ɑ v ɔ ɾ
գլխարկ	ɡ ə l χ ɑ ɾ k
գլորել	ɡ ə l o ɾ ɛ l
գլուխ	ɡ ə l u χ
գմբեթ	ɡ ə m b ɛ tʰ
գյուղապետ	ɡ j u ʁ ɑ p ɛ t
գյուղատնտեսական	ɡ j u ʁ ɑ t ə n t ɛ s ɑ k ɑ n
գյուղացի	ɡ j u ʁ ɑ t͡sʰ i
գյումրի	ɡ j u m ɾ i
գնալ	ɡ ə n ɑ l
գնալով	ɡ ə n ɑ l ɔ v
գնաճ	ɡ ə n ɑ t͡ʃ
գնդակ	ɡ ə n d ɑ k
գնդապետ	ɡ ə n d ɑ p ɛ t
գնդացիր	ɡ ə n d ɑ t͡sʰ i ɾ
գնել	ɡ ə n ɛ l
գնում	ɡ ə n u m
գոլ	ɡ ɔ l
գողանալ	ɡ ɔ ʁ ɑ n ɑ l
գոմ	ɡ ɔ m
գոյանալ	ɡ ɔ j ɑ n ɑ l
գոյություն	ɡ o j u tʰ j u n
գոչում	ɡ o t͡ʃʰ u m
գոռ	ɡ ɔ r
գործ	ɡ ɔ ɾ t͡s
գործադուլ	ɡ ɔ ɾ t͡s ɑ d u l
գործառույթ	ɡ ɔ ɾ t͡s ɑ r u j tʰ
գործառույթը	ɡ ɔ ɾ t͡s ɑ r u j tʰ ə
գործարան	ɡ ɔ ɾ t͡s ɑ ɾ ɑ n
գործարար	ɡ ɔ ɾ t͡s ɑ ɾ ɑ ɾ
գործարկել	ɡ ɔ ɾ t͡s ɑ ɾ k ɛ l
գործարք	ɡ ɔ ɾ t͡s ɑ ɾ kʰ
գործել	ɡ ɔ ɾ t͡s ɛ l
գործելաոճ	ɡ ɔ ɾ t͡s ɛ l ɑ v ɔ t͡ʃ
գործի	ɡ ɔ ɾ t͡s i
գործող	ɡ ɔ ɾ t͡s ɔ ʁ
գործողություն	ɡ ɔ ɾ t͡s ɔ ʁ u tʰ j u n
գործում	ɡ o ɾ t s u m
գործունեություն	ɡ ɔ ɾ t͡s u n ɛ u tʰ j u n
գորկի	ɡ o ɾ k i
գորշ	ɡ ɔ ɾ ʃ
գորշուկ	ɡ ɔ ɾ ʃ u k
գութ	ɡ u tʰ
գումար	ɡ u m ɑ ɾ
գումարում	ɡ u m ɑ ɾ u m
գույք	ɡ u j kʰ
գուշակ	ɡ u ʃ ɑ k
գուրգուրել	ɡ u ɾ ɡ u ɾ ɛ l
գուցե	ɡ u t͡sʰ ɛ
գռեհիկ	ɡ ə r ɛ h i k
գտնել	ɡ ə t n ɛ l
գտնվել	ɡ ə t n ə v ɛ l
գրագետ	ɡ ə ɾ ɑ ɡ ɛ t
գրազ	ɡ ə ɾ ɑ z
գրականագետ	ɡ ə ɾ ɑ k ɑ n ɑ ɡ ɛ t
գրամ	ɡ ə ɾ ɑ m
գրանցել	ɡ ə ɾ ɑ n t͡sʰ ɛ l
գրասենյակ	ɡ ə ɾ ɑ s ɛ n j ɑ k
գրավ	ɡ ə ɾ ɑ v
գրեթե	ɡ ə ɾ ɛ tʰ ɛ
գրել	ɡ ə ɾ ɛ l
գրենական	ɡ ɾ ɛ n ɑ k ɑ n
գրիգորի	ɡ ɾ i ɡ ɔ ɾ i
գրիպ	ɡ ɾ i p
գրկել	ɡ ə ɾ k ɛ l
գրկում	ɡ ə ɾ k u m
գրող	ɡ ə ɾ ɔ ʁ
դա	d ɑ
դագաղ	d ɑ ɡ ɑ ʁ
դագուր	d ɑ ɡ u ɾ
դադարել	d ɑ tʰ ɑ ɾ ɛ l
դադարեցվել	d ɑ tʰ ɑ ɾ ɛ t͡sʰ v ɛ l
դալար	d ɑ l ɑ ɾ
դահիճ	d ɑ h i t͡ʃ
դահլիճ	d ɑ h l i t͡ʃ
դահուկ	d ɑ h u k
դամբարան	d ɑ m b ɑ ɾ ɑ n
դանակ	d ɑ n ɑ k
դանդաղ	d ɑ n d ɑ ʁ
դաշնամուր	d ɑ ʃ n ɑ m u ɾ
դաշնային	d ɑ ʃ n ɑ j i n
դաշնություն	d ɑ ʃ n u tʰ j u n
դաշտ	d ɑ ʃ t
դաշտային	d ɑ ʃ t ɑ j i n
դաշտերը	d ɑ ʃ t ɛ ɾ ə
դաշտերի	d ɑ ʃ t ɛ ɾ i
դաշտերից	d ɑ ʃ t ɛ ɾ i t͡sʰ
դաշտերն	d ɑ ʃ t ɛ ɾ n
դաշտերում	d ɑ ʃ t ɛ ɾ u m
դաշտին	d ɑ ʃ t i n
դաշտից	d ɑ ʃ t i t͡sʰ
դաշտն	d ɑ ʃ t ə n
դաշտում	d ɑ ʃ t u m
դաջվածք	d ɑ d͡ʒ v ɑ t͡s kʰ
դառը	d ɑ r ə
դառն	d ɑ r ə n
դաս	d ɑ s
դասադուլ	d ɑ s ɑ d u l
դասախոս	d ɑ s ɑ χ ɔ s
դասախոսություն	d ɑ s ɑ χ ɔ s u tʰ j u n
դասական	d ɑ s ɑ k ɑ n
դասատու	d ɑ s ɑ t u
դասարան	d ɑ s ɑ ɾ ɑ n
դավադիր	d ɑ v ɑ d i ɾ
դավադրություն	d ɑ v ɑ d ɾ u tʰ j u n
դավաճան	d ɑ v ɑ t͡ʃ ɑ n
դավաճանել	d ɑ v ɑ t͡ʃ ɑ n ɛ l
դավիթ	d ɑ v i tʰ
դատ	d ɑ t
դատախազ	d ɑ t ɑ χ ɑ z
դատական	d ɑ t ɑ k ɑ n
դատապարտել	d ɑ t ɑ p ɑ ɾ t ɛ l
դատարկ	d ɑ t ɑ ɾ k
դատարկել	d ɑ t ɑ ɾ k ɛ l
դար	d ɑ ɾ
դարաշրջան	d ɑ ɾ ɑ ʃ ə ɾ d͡ʒ ɑ n
դարեր	d ɑ ɾ ɛ ɾ
դարձյալ	d ɑ ɾ t͡sʰ j ɑ l
դարման	d ɑ ɾ m ɑ n
դարչին	d ɑ ɾ t͡ʃʰ i n
դարպաս	d ɑ ɾ p ɑ s
դարպասապահ	d ɑ ɾ p ɑ s ɑ p ɑ h
դափնեկիր	d ɑ pʰ n ɛ k i ɾ
դե	d ɛ
դեբիլ	d ɛ b i l
դելի	d ɛ l i
դեկտեմբեր	d ɛ k t ɛ m b ɛ ɾ
դեղ	d ɛ ʁ
դեղատոմս	d ɛ ʁ ɑ t ɔ m s
դեղատուն	d ɛ ʁ ɑ t u n
դեղին	d ɛ ʁ i n
դեղնավուն	d ɛ ʁ n ɑ v u n
դեղորայք	d ɛ ʁ ɔ ɾ ɑ j kʰ
դեմ	d ɛ m
դեմիրճյան	d ɛ m i ɾ t͡ʃ j ɑ n
դեմոկրատ	d ɛ m ɔ k ɾ ɑ t
դեմոկրատական	d ɛ m ɔ k ɾ ɑ t ɑ k ɑ n
դեմք	d ɛ m kʰ
դեպի	d ɛ p i
դեպք	d ɛ p kʰ
դեռ	d ɛ r
դեռեւս	d ɛ r ɛ v ə s
դեսպան	d ɛ s p ɑ n
դեսպանատուն	d ɛ s p ɑ n ɑ t u n
դեր	d ɛ ɾ
դերասան	d ɛ ɾ ɑ s ɑ n
դերասանուհի	d ɛ ɾ ɑ s ɑ n u h i
դժբախտություն	d ə ʒ b ɑ χ t u tʰ j u n
դժգոհություն	d ə ʒ ɡ ɔ h u tʰ j u n
դժոխք	d ə ʒ ɔ χ kʰ
դժվար	d ə ʒ v ɑ ɾ
դի	d i
դիակ	d i j ɑ k
դիետա	d i j ɛ t ɑ
դիլիջան	d i l i d͡ʒ ɑ n
դիմակ	d i m ɑ k
դիմանկար	d i m ɑ n ə k ɑ ɾ
դիմավորել	d i m ɑ v ɔ ɾ ɛ l
դիմացկուն	d i m ɑ t͡sʰ k u n
դիմել	d i m ɛ l
դիմորդ	d i m ɔ ɾ tʰ
դիսկոտեկ	d i s k o t ɛ k
դիվանագիտություն	d i v ɑ n ɑ ɡ i t u tʰ j u n
դիտել	d i t ɛ l
դիտորդ	d i t o ɾ tʰ
դիտորդական	d i t o ɾ tʰ ɑ k ɑ n
դիտվել	d i t v ɛ l
դիրք	d i ɾ kʰ
դիցուք	d i t͡sʰ u kʰ
դհոլ	d ə h ɔ l
դնել	d ə n ɛ l
դնեպրոպետրովսկ	d n ɛ p ɾ o p ɛ t ɾ o v s k
դնթ	d ə n ə tʰ ə
դոլար	d ɔ l ɑ ɾ
դոլլար	d ɔ lː ɑ ɾ
դոն	d o n
դոնեցկ	d ɔ n ɛ t͡sʰ k
դոցենտ	d ɔ t͡sʰ ɛ n t
դուբայ	d u b ɑ j
դուռ	d u r
դուստր	d u s t ə ɾ
դուրգարյան	d u ɾ ɡ ɑ ɾ j ɑ n
դուրս	d u ɾ s
դպրոց	d ə p ɾ ɔ t͡sʰ
դպրոցական	d ə p ɾ ɔ t͡sʰ ɑ k ɑ n
դռնփակ	d ə r ə n pʰ ɑ k
դրամ	d ə ɾ ɑ m
դրամապանակ	d ɾ ɑ m ɑ p ɑ n ɑ k
դրամատուրգիական	d ɾ ɑ m ɑ t u ɾ ɡ j ɑ k ɑ n
դրոշ	d ə ɾ ɔ ʃ
դրություն	d ə ɾ u tʰ j u n
դրսեւորվել	d ɾ ə s ɛ v ɔ ɾ v ɛ l
դրվագ	d ə ɾ v ɑ ɡ
եահկ	j ɛ ɑ h ə k ə
եատմ	j ɛ ɑ t ə m ə
եգիպտացորեն	j ɛ ɡ i p t ɑ t͡sʰ ɔ ɾ ɛ n
եգիպտոս	j ɛ ɡ i p t ɔ s
եդեսացի	j ɛ d ɛ s ɑ t͡sʰ i
եզակի	j ɛ z ɑ k i
եզր	j ɛ z ə ɾ
եզրափակիչ	j ɛ z ɾ ɑ pʰ ɑ k i t͡ʃʰ
եթեր	j ɛ tʰ ɛ ɾ
ել	j ɛ l
ելակ	j ɛ l ɑ k
ելենա	j ɛ l ɛ n ɑ
ելույթ	j ɛ l u j tʰ
ելք	j ɛ l kʰ
եխ	j ɛ χ ə
եկամուտ	j ɛ k ɑ m u t
եկեղեցական	j ɛ k ɛ ʁ ɛ t sʰ a k a n
եկեղեցի	j ɛ k ɛ ʁ ɛ t͡sʰ i
եղած	j ɛ ʁ ɑ t s
եղանակ	j ɛ ʁ ɑ n ɑ k
եղբայրական	j ɛ χ p ɑ j ɾ ɑ k ɑ n
եղիա	j ɛ ʁ ɪ ɑ
եղիշե	j ɛ ʁ i ʃ ɛ
եղիսաբեթ	j ɛ ʁ i s ɑ b ɛ tʰ
եղիր	j ɛ ʁ i ɾ
եղն	j ɛ ʁ ə n
եղունգ	j ɛ ʁ u n ɡ
ենթադրել	j ɛ n tʰ ɑ d ɾ ɛ l
ենթադրելի	j ɛ n tʰ ɑ d ɾ ɛ l i
ենթադրյալ	j ɛ n tʰ ɑ d ə ɾ j ɑ l
ենթակա	j ɛ n tʰ ɑ k ɑ
ենթարկել	j ɛ n tʰ ɑ ɾ k ɛ l
ենթարկվել	j ɛ n tʰ ɑ ɾ k v ɛ l
եպիսկոպոս	j ɛ p i s k ɔ p ɔ s
եռանդ	j ɛ r ɑ n d
եռանդուն	j ɛ r ɑ n d u n
եսայան	j ɛ s ɑ j ɑ n
եսայի	j ɛ s ɑ j i
եվգենի	j ɛ v ɡ ɛ n i
եվրահանձնաժողով	j ɛ v ɾ ɑ h ɑ n d͡z n ɑ ʒ ɔ ʁ ɔ v
եվրամիություն	j ɛ v ɾ ɑ m i u tʰ j u n
եվրասիա	j ɛ v ɾ ɑ s j ɑ
եվրասիական	j ɛ v ɾ ɑ s j ɑ k ɑ n
եվրոպա	j ɛ v ɾ ɔ p ɑ
եվրոպական	j ɛ v ɾ ɔ p ɑ k ɑ n
եվրոպայի	j ɛ v ɾ ɔ p ɑ j i
եվրոպացի	j ɛ v ɾ ɔ p ɑ t͡sʰ i
ետին	j ɛ t i n
ետմ	j ɛ t ə m ə
երազանք	j ɛ ɾ ɑ z ɑ ŋ kʰ
երաժիշտ	j ɛ ɾ ɑ ʒ i ʃ t
երախտագիտություն	j ɛ ɾ ɑ χ t ɑ ɡ i t u tʰ j u n
երախտիք	j ɛ ɾ ɑ χ t i kʰ
երանգ	j ɛ ɾ ɑ n ɡ
երանի	j ɛ ɾ ɑ n i
երաշխավորում	j ɛ ɾ ɑ ʃ χ ɑ v ɔ ɾ u m
երաշխիք	j ɛ ɾ ɑ ʃ χ i kʰ
երբ	j ɛ ɾ pʰ
երբեմն	j ɛ ɾ pʰ ɛ m ə n
երբեմնի	j ɛ ɾ pʰ ɛ m n i
երբեք	j ɛ ɾ pʰ ɛ kʰ
երգ	j ɛ ɾ kʰ
երգել	j ɛ ɾ kʰ ɛ l
երգի	j ɛ ɾ kʰ i
երգիչ	j ɛ ɾ kʰ i t͡ʃʰ
երգչուհի	j ɛ ɾ kʰ t ʃʰ u h i
երդում	j ɛ ɾ tʰ u m
երդվյալ	j ɛ ɾ tʰ v j ɑ l
երեկո	j ɛ ɾ ɛ k ɔ
երեկոյան	j ɛ ɾ ɛ k o j ɑ n
երես	j ɛ ɾ ɛ s
երեսուն	j ɛ ɾ ɛ s u n
երեւակայություն	j ɛ ɾ ɛ v ɑ k ɑ j u tʰ j u n
երեւան	j ɛ ɾ ɛ v ɑ n
երեւում	j ɛ ɾ ɛ v u m
երեւույթ	j ɛ ɾ ɛ v u j tʰ
երեք	j ɛ ɾ ɛ kʰ
երեքշաբթի	j ɛ ɾ ɛ kʰ ʃ ɑ pʰ tʰ i
երթ	j ɛ ɾ tʰ
երթուղային	j ɛ ɾ tʰ u ʁ ɑ j i n
երիտասարդ	j ɛ ɾ i t ɑ s ɑ ɾ tʰ
երիցս	j ɛ ɾ i t͡sʰ ə s
երկ	j ɛ ɾ k
երկաթ	j ɛ ɾ k ɑ tʰ
երկաթե	j ɛ ɾ k ɑ tʰ ɛ
երկաթուղի	j ɛ ɾ k ɑ tʰ u ʁ i
երկար	j ɛ ɾ k ɑ ɾ
երկարաժամկետ	j ɛ ɾ k ɑ ɾ ɑ ʒ ɑ m k ɛ t
երկարավուն	j ɛ ɾ k ɑ ɾ ɑ v u n
երկինք	j ɛ ɾ k i ŋ kʰ
երկիր	j ɛ ɾ k i ɾ
երկխոսություն	j ɛ ɾ k χ ɔ s u tʰ j u n
երկյուղ	j ɛ ɾ k j u ʁ
երկյուղած	j ɛ ɾ k j u ʁ ɑ t͡s
երկնագույն	j ɛ ɾ k n ɑ ɡ u j n
երկնաքար	j ɛ ɾ k n ɑ kʰ ɑ ɾ
երկու	j ɛ ɾ k u
երկուշաբթի	j ɛ ɾ k u ʃ ɑ pʰ tʰ i
երկսայրի	j ɛ ɾ k s ɑ j ɾ i
երկրագունդ	j ɛ ɾ k ɾ ɑ ɡ u n d
երկրաշարժ	j ɛ ɾ k ɾ ɑ ʃ ɑ ɾ ʒ
երկրպագու	j ɛ ɾ k ə ɾ p ɑ ɡ u
երուսաղեմ	j ɛ ɾ u s ɑ ʁ ɛ m
երջանիկ	j ɛ ɾ d͡ʒ ɑ n i k
երջանկություն	j ɛ ɾ d͡ʒ ɑ ŋ k u tʰ j u n
երվանդ	j ɛ ɾ v ɑ n d
երրորդ	j ɛ ɾː ɔ ɾ tʰ
եւս	j ɛ v ə s
եփրատ	j ɛ pʰ ɾ ɑ t
զամբյուղ	z ɑ m b j u ʁ
զանազան	z ɑ n ɑ z ɑ n
զանգ	z ɑ ŋ ɡ
զանգահարել	z ɑ n ɡ ɑ h ɑ ɾ ɛ l
զանգել	z ɑ ŋ ɡ ɛ l
զանգի	z ɑ ŋ ɡ i
զանգվածային	z ɑ ŋ ɡ v ɑ t͡s ɑ j i n
զավեն	z ɑ v ɛ n
զավեշտ	z ɑ v ɛ ʃ t
զավեշտական	z ɑ v ɛ ʃ t ɑ k ɑ n
զավթել	z ɑ f tʰ ɛ l
զատ	z ɑ t
զարգացում	z ɑ ɾ ɡ ɑ t͡sʰ u m
զարդարել	z ɑ ɾ tʰ ɑ ɾ ɛ l
զարեհ	z ɑ ɾ ɛ h
զարմանալ	z ɑ ɾ m ɑ n ɑ l
զարմանք	z ɑ ɾ m ɑ n kʰ
զարմացնել	z ɑ ɾ m ɑ t͡sʰ n ɛ l
զարուհի	z ɑ ɾ u h i
զաքարյան	z ɑ kʰ ɑ ɾ j ɑ n
զբաղվել	z b ɑ ʁ v ɛ l
զգոն	z ɡ ɔ n
զգուշանալ	z ɡ u ʃ ɑ n ɑ l
զեղչ	z ɛ χ t͡ʃʰ
զեյթուն	z ɛ j tʰ u n
զենք	z ɛ ŋ kʰ
զզվել	z ə z v ɛ l
զզվելի	z ə z v ɛ l i
զիբիլ	z i b i l
զինամթերք	z i n ɑ m ə tʰ ɛ ɾ kʰ
զինել	z i n ɛ l
զինված	z i n v ɑ t͡s
զինվոր	z i n v ɔ ɾ
զոհ	z ɔ h
զոհվել	z ɔ h v ɛ l
զոհրաբ	z ɔ h ɾ ɑ b
զոյա	z ɔ j ɑ
զոռով	z o r o v
զով	z o v
զորավար	z o ɾ ɑ v ɑ ɾ
զորավարժություն	z ɔ ɾ ɑ v ɑ ɾ ʒ u tʰ j u n
զորավոր	z ɔ ɾ ɑ v ɔ ɾ
զորեղ	z ɔ ɾ ɛ ʁ
զորիկ	z ɔ ɾ i k
զուգահեռ	z u ɡ ɑ h ɛ r
զուլու	z u l u
զույգ	z u j kʰ
զուտ	z u t
զուր	z u ɾ
զուրկ	z u ɾ k
զվարթ	z ə v ɑ ɾ tʰ
զվարճություն	z ə v ɑ ɾ t͡ʃ u tʰ j u n
զրո	z ə ɾ ɔ
էակ	ɛ j ɑ k
էական	ɛ j ɑ k ɑ n
էդ	ɛ d
էդգար	ɛ d ɡ ɑ ɾ
էդմոն	ɛ d m ɔ n
էդվարդ	ɛ d v ɑ ɾ tʰ
էժան	ɛ ʒ ɑ n
էլեկտրական	ɛ l ɛ k t ɾ ɑ k ɑ n
էլեմենտար	ɛ l ɛ m ɛ n t ɑ ɾ
էլիպս	ɛ l i p s
էկրան	ɛ k ɾ ɑ n
էմիր	ɛ m i ɾ
էմիրություններ	ɛ m i ɾ u tʰ j u nː ɛ ɾ
էն	ɛ n
էնֆիաջյան	ɛ n f i j ɑ d͡ʒ j ɑ n
էշ	ɛ ʃ
էս	ɛ s
էստոնիա	ɛ s t ɔ n j ɑ
էվոլյուցիոն	ɛ v o l j u t sʰ j o n
էրեբունի	ɛ ɾ ɛ b u n i
էրիկ	ɛ ɾ i k
էքսպերտ	ɛ kʰ s p ɛ ɾ t
ըլլալ	ə l l ɑ l
ըմբիշ	ə m b i ʃ
ըմբոստ	ə m b ɔ s t
ընդամենը	ə n tʰ ɑ m ɛ n ə
ընդարձակ	ə n tʰ ɑ ɾ t͡sʰ ɑ k
ընդգծել	ə n d ɡ ə t͡s ɛ l
ընդդեմ	ə n dː ɛ m
ընդլայնել	ə n d l ɑ j n ɛ l
ընդհանրական	ə n tʰ h ɑ n ɾ ɑ k ɑ n
ընդունել	ə n tʰ u n ɛ l
ընդունելի	ə n tʰ u n ɛ l i
ընդունված	ə n tʰ u n v ɑ t͡s
ընդօրինակել	ə n tʰ ɔ ɾ i n ɑ k ɛ l
ընթացակարգ	ə n tʰ ɑ t͡sʰ ɑ k ɑ ɾ kʰ
ընթացք	ə n tʰ ɑ t͡sʰ kʰ
ընթացքում	ə n tʰ ɑ t͡sʰ kʰ u m
ընթերցել	ə n tʰ ɛ ɾ t sʰ ɛ l
ընթերցում	ə n tʰ ɛ ɾ t͡sʰ u m
ընթրիք	ə n tʰ ɾ i kʰ
ընկեր	ə ŋ k ɛ ɾ
ընկերություն	ə ŋ k ɛ ɾ u tʰ j u n
ընկերուհի	ə ŋ k ɛ ɾ u h i
ընկնել	ə ŋ k n ɛ l
ընտանեկան	ə n t ɑ n ɛ k ɑ n
ընտրական	ə n t ɾ ɑ k ɑ n
ընտրել	ə n t ɾ ɛ l
ընտրյալ	ə n t ɾ j ɑ l
ընտրություն	ə n t ɾ u tʰ j u n
թագավոր	tʰ ɑ kʰ ɑ v ɔ ɾ
թագավորություն	tʰ ɑ ɡ ɑ v ɔ ɾ u tʰ j u n
թագուհի	tʰ ɑ kʰ u h i
թազա	tʰ ɑ z ɑ
թաթ	tʰ ɑ tʰ
թաթար	tʰ ɑ tʰ ɑ ɾ
թաթուլ	tʰ ɑ tʰ u l
թալիբան	tʰ ɑ l i b ɑ n
թակարդ	tʰ ɑ k ɑ ɾ d
թաղ	tʰ ɑ ʁ
թաղապետ	tʰ ɑ ʁ ɑ p ɛ t
թաղել	tʰ ɑ ʁ ɛ l
թաղում	tʰ ɑ ʁ u m
թամադա	tʰ ɑ m ɑ d ɑ
թանգարան	tʰ ɑ ŋ ɡ ɑ ɾ ɑ n
թանկ	tʰ ɑ ŋ k
թանկարժեք	tʰ ɑ ŋ k ɑ ɾ ʒ ɛ kʰ
թառ	tʰ ɑ r
թավալ	tʰ ɑ v ɑ l
թավջութակ	tʰ ɑ v d͡ʒ u tʰ ɑ k
թատերական	tʰ ɑ t ɛ ɾ ɑ k ɑ n
թատրոն	tʰ ɑ t ɾ ɔ n
թարգմանել	tʰ ɑ ɾ kʰ m ɑ n ɛ l
թարգմանիչ	tʰ ɑ ɾ kʰ m ɑ n i t ʃʰ
թարմ	tʰ ɑ ɾ m
թարմացնել	tʰ ɑ ɾ m ɑ t͡sʰ n ɛ l
թաց	tʰ ɑ t͡sʰ
թափ	tʰ ɑ pʰ
թափել	tʰ ɑ pʰ ɛ l
թափուր	tʰ ɑ pʰ u ɾ
թաքնվել	tʰ ɑ kʰ n ə v ɛ l
թաքցնել	tʰ ɑ kʰ t͡sʰ ə n ɛ l
թբիլիսի	tʰ ə b i l i s i
թե	tʰ ɛ
թեեւ	tʰ ɛ j ɛ v
թեթեւ	tʰ ɛ tʰ ɛ v
թել	tʰ ɛ l
թեկնածու	tʰ ɛ k n ɑ t s u
թեկուզ	tʰ ɛ k u z
թեմ	tʰ ɛ m
թեմա	tʰ ɛ m ɑ
թեյ	tʰ ɛ j
թենեդոս	tʰ ɛ n ɛ d ɔ s
թենիս	tʰ ɛ n i s
թենիսիստ	tʰ ɛ n i s i s t
թեր	tʰ ɛ ɾ
թերթ	tʰ ɛ ɾ tʰ
թերի	tʰ ɛ ɾ i
թեւ	tʰ ɛ v
թեքել	tʰ ɛ kʰ ɛ l
թեքում	tʰ ɛ kʰ u m
թեքվել	tʰ ɛ kʰ v ɛ l
թի	tʰ i
թիթեռ	tʰ i tʰ ɛ r
թիմ	tʰ i m
թիմային	tʰ i m ɑ j i n
թիվ	tʰ i v
թիրախ	tʰ i ɾ ɑ χ
թիրախային	tʰ i ɾ ɑ χ ɑ j i n
թիքա	tʰ i kʰ ɑ
թիֆլիս	tʰ i f l i s
թխել	tʰ ə χ ɛ l
թմբկահար	tʰ ə m b k ɑ h ɑ ɾ
թյուրիմացություն	tʰ j u ɾ i m ɑ t͡sʰ u tʰ j u n
թնդանոթ	tʰ ə n d ɑ n ɔ tʰ
թշվառ	t ə ʃ v ɑ r
թողարկել	tʰ ɔ ʁ ɑ ɾ k ɛ l
թողել	tʰ ɔ ʁ ɛ l
թողնել	tʰ ɔ ʁ n ɛ l
թողություն	tʰ ɔ ʁ u tʰ j u n
թոշակառու	tʰ ɔ ʃ ɑ k ɑ r u
թոռ	tʰ ɔ r
թոռնիկ	tʰ ɔ r n i k
թովիչ	tʰ ɔ v i t͡ʃʰ
թորգոմ	tʰ o ɾ ɡ o m
թուզ	tʰ u z
թութակ	tʰ u tʰ ɑ k
թուլանալ	tʰ u l ɑ n ɑ l
թույլ	tʰ u j l
թույլատրել	tʰ u j l ɑ t ɾ ɛ l
թույլտվություն	tʰ u j l t v u tʰ j u n
թույն	tʰ u ɪ̯ n
թուր	tʰ u ɾ
թուրքիա	tʰ u ɾ kʰ j ɑ
թուրքմենական	tʰ u ɾ kʰ m ɛ n ɑ k ɑ n
թռիչք	tʰ ə r i t ʃ kʰ
թռնել	tʰ ə r n ɛ l
թռչել	tʰ ə r t ʃʰ ɛ l
թռչուն	tʰ ə r t ʃʰ u n
թվական	tʰ ə v ɑ k ɑ n
թվարկել	tʰ ə v ɑ ɾ k ɛ l
թվի	tʰ ə v i
թրամփ	tʰ ə ɾ ɑ m pʰ
թրջել	tʰ ə ɾ t͡ʃʰ ɛ l
ժամ	ʒ ɑ m
ժամանակավոր	ʒ ɑ m ɑ n ɑ k ɑ v ɔ ɾ
ժամանել	ʒ ɑ m ɑ n ɛ l
ժամանում	ʒ ɑ m ɑ n u m
ժամանց	ʒ ɑ m ɑ n t͡sʰ
ժամացույց	ʒ ɑ m ɑ t͡sʰ u j t͡sʰ
ժամկետ	ʒ ɑ m k ɛ t
ժանտ	ʒ ɑ n t
ժառանգ	ʒ ɑ r ɑ ŋ ɡ
ժառանգել	ʒ ɑ r ɑ ŋ ɡ ɛ l
ժառանգորդ	ʒ ɑ r ɑ ŋ ɡ ɔ ɾ tʰ
ժե	ʒ ɛ
ժլատ	ʒ ə l ɑ t
ժողով	ʒ ɔ ʁ ɔ v
ժողովածու	ʒ ɔ ʁ ɔ v ɑ t͡s u
ժողովուրդ	ʒ ɔ ʁ ɔ v u ɾ tʰ
ժողովրդական	ʒ o ʁ o v ə ɾ tʰ ɑ k ɑ n
ժողովրդավարական	ʒ ɔ ʁ ɔ v ə ɾ tʰ ɑ v ɑ ɾ ɑ k ɑ n
ժողովրդավարություն	ʒ ɔ ʁ ɔ v ə ɾ tʰ ɑ v ɑ ɾ u tʰ j u n
ժուռնալիստ	ʒ u r n ɑ l i s t
իբր	i pʰ ə ɾ
իգական	i kʰ ɑ k ɑ n
իզոտոպ	i z o t o p
իիհ	i i h ə
իլհամ	i l h ɑ m
իմանալ	i m ɑ n ɑ l
իմաստություն	i m ɑ s t u t sʰ j u n
իմաստուն	i m ɑ s t u n
ինադ	i n ɑ d
ինադու	i n ɑ d u
ինգա	i ŋ ɡ ɑ
ինձ	i n d͡z
ինձնից	i n d z n i t sʰ
ինձնով	i n d z n o v
իններորդ	i nː ɛ ɾ o ɾ tʰ
իննսուն	i nː ə s u n
ինչ	i n t͡ʃʰ
ինչի	i n t͡ʃʰ i
ինչու	i n t͡ʃʰ u
ինչպես	i n t͡ʃʰ p ɛ s
ինստագրամ	i n s t ɑ ɡ ɾ ɑ m
ինստիտուտ	i n s t i t u t
ինտելիգենցիա	i n t ɛ l i ɡ ɛ n t͡sʰ j ɑ
ինտերնետ	i n t ɛ ɾ n ɛ t
ինտերնետային	i n t ɛ ɾ n ɛ t ɑ j i n
ինքը	i ŋ kʰ ə
ինքն	i ŋ kʰ ə n
ինքնաթիռ	i ŋ kʰ n ɑ tʰ i r
ինքնասպանություն	i ŋ kʰ n ɑ s p ɑ n u t͡sʰ j u n
ինքնավար	i ŋ kʰ n ɑ v ɑ ɾ
ինքնին	i ŋ kʰ n i n
ինքնություն	i ŋ kʰ n u tʰ j u n
իշխան	i ʃ χ ɑ n
իշխանափոխություն	i ʃ χ ɑ n ɑ pʰ ɔ χ u tʰ j u n
իշխանյան	i ʃ χ ɑ n j ɑ n
իռացիոնալ	i r ɑ t͡sʰ i ɔ n ɑ l
իռլանդացի	i r l ɑ n d ɑ t͡sʰ i
իսահակ	i s ɑ h ɑ k
իսլամ	i s l ɑ m
իսլամական	i s l ɑ m ɑ k ɑ n
իսլանդիա	i s l ɑ n d j ɑ
իսկ	i s k
իսկական	i s k ɑ k ɑ n
իսկապես	i s k ɑ p ɛ s
իսկույն	i s k u j n
իսմայիլի	i s m ɑ j i l i
իսպանական	i s p ɑ n ɑ k ɑ n
իսպանացի	i s p ɑ n ɑ t͡sʰ i
իսպաներեն	i s p ɑ n ɛ ɾ ɛ n
իսպանիա	i s p ɑ n j ɑ
իսպառ	i s p ɑ r
իսրայել	i s ɾ ɑ j ɛ l
իվան	i v ɑ n
իտալացի	i t ɑ l ɑ t͡sʰ i
իտալիա	i t ɑ l j ɑ
իր	i ɾ
իրադարձություն	i ɾ ɑ d ɑ ɾ t͡sʰ u tʰ j u n
իրազեկ	i ɾ ɑ z ɛ k
իրական	i ɾ ɑ k ɑ n
իրականացնել	i ɾ ɑ k ɑ n ɑ t͡sʰ n ɛ l
իրականում	i ɾ ɑ k ɑ n u m
իրան	i ɾ ɑ n
իրավ	i ɾ ɑ v
իրավամբ	i ɾ ɑ v ɑ m pʰ
իրավունք	i ɾ ɑ v u ŋ kʰ
իրարանցում	i ɾ ɑ ɾ ɑ n t͡sʰ u m
իրաք	i ɾ ɑ kʰ
իրենք	i ɾ ɛ ŋ kʰ
իրիկուն	i ɾ i k u n
իրողություն	i ɾ ɔ ʁ u tʰ j u n
իրոք	i ɾ o kʰ
լազերային	l ɑ z ɛ ɾ ɑ j i n
լայն	l ɑ j n
լավ	l ɑ v
լատինական	l ɑ t i n ɑ k ɑ n
լատիներեն	l ɑ t i n ɛ ɾ ɛ n
լարի	l ɑ ɾ i
լարում	l ɑ ɾ u m
լեզու	l ɛ z u
լեզվաբան	l ɛ z v ɑ b ɑ n
լեհ	l ɛ h
լեհական	l ɛ h ɑ k ɑ n
լեյտենանտ	l ɛ j t ɛ n ɑ n t
լեռնագնաց	l ɛ r n ɑ ɡ ə n ɑ t͡sʰ
լեռնային	l ɛ r n ɑ j i n
լեւոն	l ɛ v ɔ n
լիագումար	l i j ɑ ɡ u m ɑ ɾ
լիազոր	l j ɑ z ɔ ɾ
լիազորագիր	l j ɑ z ɔ ɾ ɑ ɡ i ɾ
լիազորել	l j ɑ z ɔ ɾ ɛ l
լիազորություն	l j ɑ z ɔ ɾ u tʰ j u n
լիազորված	l j ɑ z ɔ ɾ v ɑ t͡s
լիանա	l j ɑ n ɑ
լիարժեք	l j ɑ ɾ ʒ ɛ kʰ
լիբանան	l i b ɑ n ɑ n
լիգա	l i ɡ ɑ
լիճ	l i t͡ʃ
լինել	l i n ɛ l
լիովին	l i ɔ v i n
լիուլի	l i u l i
լիտր	l i t ə ɾ
լիր	l i ɾ
լկտի	l ə k t i
լղհ	l ə ʁ ə h ə
լճաշեն	l ə t͡ʃ ɑ ʃ ɛ n
լոգանք	l ɔ ɡ ɑ ŋ kʰ
լոգարան	l ɔ ɡ ɑ ɾ ɑ n
լոկ	l o k
լող	l ɔ ʁ
լողալ	l ɔ ʁ ɑ l
լոնդոն	l ɔ n d ɔ n
լոռի	l ɔ r i
լոս	l o s
լորի	l ɔ ɾ i
լորձ	l ɔ ɾ d͡z
լու	l u
լուծել	l u t͡s ɛ l
լուծում	l u t͡s u m
լումա	l u m ɑ
լույս	l u j s
լուռ	l u r
լուսանկար	l u s ɑ n ə k ɑ ɾ
լուսանկարել	l u s ɑ n ə k ɑ ɾ ɛ l
լուսանկարիչ	l u s ɑ n ə k ɑ ɾ i t͡ʃʰ
լուսավոր	l u s ɑ v ɔ ɾ
լուսին	l u s i n
լուսինե	l u s i n ɛ
լուսնկա	l u s ə n k ɑ
լուվական	l u v ɑ k ɑ n
լուր	l u ɾ
լուրեր	l u ɾ ɛ ɾ
լուրջ	l u ɾ d͡ʒ
լուցկի	l u t͡sʰ k i
լռություն	l ə r u tʰ j u n
լսել	l ə s ɛ l
լվանալ	l ə v ɑ n ɑ l
լվով	l v ɔ v
լրագրող	l ə ɾ ɑ ɡ ə ɾ ɔ ʁ
լրահոս	l ə ɾ ɑ h ɔ s
լրատու	l ə ɾ ɑ t u
լրացնել	l ə ɾ ɑ t͡sʰ n ɛ l
լրիվ	l ə ɾ i v
լրտես	l ə ɾ t ɛ s
լցնել	l ə t͡sʰ n ɛ l
խաբար	χ ɑ b ɑ ɾ
խախտել	χ ɑ χ t ɛ l
խաղ	χ ɑ ʁ
խաղաթուղթ	χ ɑ ʁ ɑ tʰ u χ tʰ
խաղալ	χ ɑ ʁ ɑ l
խաղալիք	χ ɑ ʁ ɑ l i kʰ
խաղաղ	χ ɑ ʁ ɑ ʁ
խաղաղություն	χ ɑ ʁ ɑ ʁ u tʰ j u n
խաղամոլ	χ ɑ ʁ ɑ m o l
խաղող	χ ɑ ʁ ɔ ʁ
խամոն	χ ɑ m ɔ n
խայտառակություն	χ ɑ j t ɑ r ɑ k u tʰ j u n
խանդավառ	χ ɑ n d ɑ v ɑ r
խանդոտ	χ ɑ n d ɔ t
խանութ	χ ɑ n u tʰ
խաշ	χ ɑ ʃ
խաչ	χ ɑ t͡ʃʰ
խաչատուր	χ ɑ t͡ʃʰ ɑ t u ɾ
խաչիկ	χ ɑ t͡ʃʰ i k
խաչմերուկ	χ ɑ t͡ʃʰ m ɛ ɾ u k
խառնել	χ ɑ r n ɛ l
խառնուրդ	χ ɑ r n u ɾ tʰ
խավար	χ ɑ v ɑ ɾ
խարիսխ	χ ɑ ɾ i s χ
խարույկ	χ ɑ ɾ u j k
խելագար	χ ɛ l ɑ ɡ ɑ ɾ
խելացի	χ ɛ l ɑ t sʰ i
խելոք	χ ɛ l o kʰ
խելք	χ ɛ l kʰ
խեղդել	χ ɛ χ t ɛ l
խենթ	χ ɛ n tʰ
խզել	χ ə z ɛ l
խթան	χ ə tʰ ɑ n
խթանել	χ ə tʰ ɑ n ɛ l
խի	χ i
խիզախ	χ i z ɑ χ
խիղճ	χ i χ t͡ʃ
խինդ	χ i n d
խիտ	χ i t
խմած	χ ə m ɑ t s
խմբագրել	x ə m b ɑ ɡ ɾ ɛ l
խմբաքանակ	χ ə m b ɑ kʰ ɑ n ɑ k
խմել	χ ə m ɛ l
խմիչք	χ ə m i t͡ʃʰ kʰ
խնամք	χ ə n ɑ m kʰ
խնայել	χ ə n ɑ j ɛ l
խնդրանք	χ ə n tʰ ɾ ɑ ŋ kʰ
խնդրեմ	χ ə n tʰ ɾ ɛ m
խնձոր	χ ə n d͡z ɔ ɾ
խոհանոց	χ ɔ h ɑ n ɔ t͡sʰ
խոհարար	χ o h ɑ ɾ ɑ ɾ
խոհարարական	χ ɔ h ɑ ɾ ɑ ɾ ɑ k ɑ n
խոհեմ	χ ɔ h ɛ m
խոնավ	χ ɔ n ɑ v
խոնավանալ	χ ɔ n ɑ v ɑ n ɑ l
խոնարհում	χ ɔ n ɑ ɾ u m
խոշոր	χ ɔ ʃ ɔ ɾ
խոշտանգել	χ ɔ ʃ t ɑ ŋ ɡ ɛ l
խոչընդոտ	χ ɔ t͡ʃʰ ə n d ɔ t
խոչընդոտել	χ ɔ t͡ʃʰ ə n d ɔ t ɛ l
խոպան	χ ɔ p ɑ n
խոսել	χ ɔ s ɛ l
խոսնակ	χ ɔ s n ɑ k
խոսուն	χ ɔ s u n
խոստանալ	χ ɔ s t ɑ n ɑ l
խոստում	χ ɔ s t u m
խոսրով	χ ɔ s ɾ ɔ v
խոսք	χ ɔ s kʰ
խոտ	χ ɔ t
խոր	χ ɔ ɾ
խորամանկ	χ o ɾ ɑ m ɑ ŋ k
խորանարդ	χ ɔ ɾ ɑ n ɑ ɾ tʰ
խորեն	χ o ɾ ɛ n
խորենացի	χ o ɾ ɛ n ɑ t sʰ i
խորը	χ o ɾ ə
խորթ	χ o ɾ tʰ
խորհել	χ o ɾ h ɛ l
խորհուրդ	χ ɔ ɾ u ɾ tʰ
խորհրդանիշ	χ ɔ ɾ ə ɾ tʰ ɑ n i ʃ
խորհրդանշական	χ ɔ ɾ ə ɾ tʰ ɑ n ə ʃ ɑ k ɑ n
խորհրդանշել	χ ɔ ɾ ə ɾ tʰ ɑ n ə ʃ ɛ l
խորհրդավոր	χ ɔ ɾ ə ɾ tʰ ɑ v ɔ ɾ
խորհրդարանական	χ ɔ ɾ ə ɾ tʰ ɑ ɾ ɑ n ɑ k ɑ n
խորն	χ o ɾ n
խորոված	χ ɔ ɾ ɔ v ɑ t͡s
խորվաթ	χ o ɾ v ɑ tʰ
խորտակել	χ ɔ ɾ t ɑ k ɛ l
խուզել	χ u z ɛ l
խուլ	χ u l
խուճապ	χ u t͡ʃ ɑ p
խումբ	χ u m b
խուսափել	χ u s ɑ pʰ ɛ l
խուց	χ u t͡sʰ
խստիվ	χ ə s t i v
խտրականություն	χ ə t ɾ ɑ k ɑ n u tʰ j u n
խրախուսել	χ ə ɾ ɑ χ u s ɛ l
խրթին	χ ə ɾ tʰ i n
խրոխտ	χ ə ɾ ɔ χ t
խրոխտանք	χ ə ɾ ɔ χ t ɑ ŋ kʰ
խփել	χ ə pʰ ɛ l
ծագել	t͡s ɑ kʰ ɛ l
ծագում	t͡s ɑ kʰ u m
ծախ	t͡s ɑ χ
ծախսային	t͡s ɑ χ s ɑ j i n
ծախսում	t͡s ɑ χ s u m
ծախսվել	t͡s ɑ χ s v ɛ l
ծախված	t͡s ɑ χ v ɑ t͡s
ծախվել	t͡s ɑ χ v ɛ l
ծածանել	t͡s ɑ t͡s ɑ n ɛ l
ծաղիկ	t͡s ɑ ʁ i k
ծաղկունք	t s ɑ ʁ k u n kʰ
ծաղրել	t͡s ɑ ʁ ɾ ɛ l
ծայրահեղ	t͡s ɑ j ɾ ɑ h ɛ ʁ
ծայրահեղական	t͡s ɑ j ɾ ɑ h ɛ ʁ ɑ k ɑ n
ծանոթ	t͡s ɑ n ɔ tʰ
ծանոթացնել	t͡s ɑ n o tʰ ɑ t͡sʰ n ɛ l
ծանոթություն	t͡s ɑ n ɔ tʰ u tʰ j u n
ծանրորդ	c ɑ n ɾ o ɾ tʰ
ծանրություն	t s ɑ n ɾ u tʰ j u n
ծառ	t͡s ɑ r
ծառուկյան	t͡s ɑ r u k j ɑ n
ծավալել	t͡s ɑ v ɑ l ɛ l
ծարավ	t s ɑ ɾ ɑ v
ծափահարել	t͡s ɑ pʰ ɑ h ɑ ɾ ɛ l
ծափահարում	t͡s ɑ pʰ ɑ h ɑ ɾ u m
ծեծ	t͡s ɛ t͡s
ծեծել	t͡s ɛ t͡s ɛ l
ծեր	t͡s ɛ ɾ
ծերություն	t͡s ɛ ɾ u t͡sʰ j u n
ծիածան	t͡s i j ɑ t͡s ɑ n
ծիծ	t͡s i t͡s
ծիծաղ	t͡s i t͡s ɑ ʁ
ծիծաղել	t͡s i t͡s ɑ ʁ ɛ l
ծիրան	t͡s i ɾ ɑ n
ծիրանի	t͡s i ɾ ɑ n i
ծխախոտ	t͡s ə χ ɑ χ ɔ t
ծխել	t s ə χ ɛ l
ծծել	t͡s ə t͡s ɛ l
ծղուկ	t͡s ə ʁ u k
ծնել	t͡s ə n ɛ l
ծնող	t͡s ə n o ʁ
ծնված	t͡s ə n v ɑ t͡s
ծնվել	t͡s ə n v ɛ l
ծոմ	t͡s ɔ m
ծով	t͡s ɔ v
ծովեզերք	t͡s ɔ v ɛ z ɛ ɾ kʰ
ծուխ	t͡s u χ
ծուռ	t͡s u r
ծրագիր	t͡s ə ɾ ɑ ɡ i ɾ
ծրագրավորել	t͡s ə ɾ ɑ ɡ ɾ ɑ v ɔ ɾ ɛ l
ծրագրավորում	t͡s ə ɾ ɑ ɡ ɾ ɑ v ɔ ɾ u m
կադրային	k ɑ d ɾ ɑ j i n
կազմ	k ɑ z m
կազմակերպել	k ɑ z m ɑ k ɛ ɾ p ɛ l
կազմակերպիչ	k ɑ z m ɑ k ɛ ɾ p i t͡ʃʰ
կազմակերպություն	k ɑ z m ɑ k ɛ ɾ p u tʰ j u n
կազմակերպում	k ɑ z m ɑ k ɛ ɾ p u m
կազմավորել	k ɑ z m ɑ v ɔ ɾ ɛ l
կազմավորում	k ɑ z m ɑ v ɔ ɾ u m
կազմավորվել	k ɑ z m ɑ v ɔ ɾ v ɛ l
կազմել	k ɑ z m ɛ l
կաթ	k ɑ tʰ
կաթոլիկ	k ɑ tʰ ɔ l i k
կաթողիկոս	k ɑ tʰ ɔ ʁ i k ɔ s
կալկաթա	k ɑ l k ɑ tʰ ɑ
կալվածք	k ɑ l v ɑ t s kʰ
կախ	k ɑ χ
կախաղան	k ɑ χ ɑ ʁ ɑ n
կախարդական	k ɑ χ ɑ ɾ d ɑ k ɑ n
կախարդվածություն	k ɑ χ ɑ ɾ d v ɑ t͡s u tʰ j u n
կախել	k ɑ χ ɛ l
կախվածություն	k ɑ χ v ɑ t͡s u tʰ j u n
կախվել	k ɑ χ v ɛ l
կահիրե	k ɑ h i ɾ ɛ
կաղամբ	k ɑ ʁ ɑ m b
կաղապար	k ɑ ʁ ɑ p ɑ ɾ
կամ	k ɑ m
կամա	k ɑ m ɑ
կամակոր	k ɑ m ɑ k ɔ ɾ
կամավոր	k ɑ m ɑ v ɔ ɾ
կամուրջ	k ɑ m u ɾ d͡ʒ
կամք	k ɑ m kʰ
կայանալ	k ɑ j ɑ n ɑ l
կայանում	k ɑ j ɑ n u m
կային	k ɑ j i n
կայուն	k ɑ j u n
կայսր	k ɑ j s ə ɾ
կայսրություն	k ɑ j s ɾ u tʰ j u n
կայք	k ɑ j kʰ
կան	k ɑ n
կանադական	k ɑ n ɑ d ɑ k ɑ n
կանաչ	k ɑ n ɑ t͡ʃʰ
կանաչապատ	k ɑ n ɑ t͡ʃʰ ɑ p ɑ t
կանգառ	k ɑ ŋ ɡ ɑ r
կանգնել	k ɑ ŋ ɡ n ɛ l
կանգնեցնել	k ɑ ŋ ɡ n ɛ t͡sʰ n ɛ l
կանգուն	k ɑ ŋ ɡ u n
կանխատեսել	k ɑ ŋ χ ɑ t ɛ s ɛ l
կանխել	k ɑ ŋ χ ɛ l
կանոնավոր	k ɑ n ɔ n ɑ v ɔ ɾ
կանուխ	k ɑ n u χ
կանչ	k ɑ n t͡ʃʰ
կանչել	k ɑ n t͡ʃʰ ɛ l
կաշառել	k ɑ ʃ ɑ r ɛ l
կաշառված	k ɑ ʃ ɑ r v ɑ t͡s
կաշառք	k ɑ ʃ ɑ r kʰ
կաշկանդել	k ɑ ʃ k ɑ n d ɛ l
կաչաղակ	k ɑ t͡ʃʰ ɑ ʁ ɑ k
կապան	k ɑ p ɑ n
կապել	k ɑ p ɛ l
կապիկ	k ɑ p i k
կապիտալիստական	k ɑ p i t ɑ l i s t ɑ k ɑ n
կապիտոլիում	k ɑ p i t ɔ l i j u m
կապված	k ɑ p v ɑ t͡s
կապվել	k ɑ p v ɛ l
կառավարել	k ɑ r ɑ v ɑ ɾ ɛ l
կառավարիչ	k ɑ r ɑ v ɑ ɾ i t͡ʃʰ
կառավարություն	k ɑ r ɑ v ɑ ɾ u tʰ j u n
կառավարում	k ɑ r ɑ v ɑ ɾ u m
կառույց	k ɑ r u j t͡sʰ
կառուցել	k ɑ r u t͡sʰ ɛ l
կառուցողական	k ɑ r u t͡sʰ ɔ ʁ ɑ k ɑ n
կառուցվածք	k ɑ r u t͡sʰ v ɑ t͡s kʰ
կաս	k ɑ s
կասեցնել	k ɑ s ɛ t͡sʰ n ɛ l
կասկածել	k ɑ s k ɑ t͡s ɛ l
կասկածյալ	k ɑ s k ɑ t͡s j ɑ l
կասպարյան	k ɑ s p ɑ ɾ j ɑ n
կաստայական	k ɑ s t ɑ j ɑ k ɑ n
կավեղեն	k ɑ v ɛ ʁ ɛ n
կատակ	k ɑ t ɑ k
կատակել	k ɑ t ɑ k ɛ l
կատաղի	k ɑ t ɑ ʁ i
կատաղություն	k ɑ t ɑ ʁ u tʰ j u n
կատաստրոֆա	k ɑ t ɑ s t ɾ ɔ f ɑ
կատար	k ɑ t ɑ ɾ
կատարել	k ɑ t ɑ ɾ ɛ l
կատարյալ	k ɑ t ɑ ɾ j ɑ l
կատեգորիա	k ɑ t ɛ ɡ o ɾ ɪ ɑ
կատու	k ɑ t u
կար	k ɑ ɾ
կարագ	k ɑ ɾ ɑ kʰ
կարանտին	k ɑ ɾ ɑ n t i n
կարապ	k ɑ ɾ ɑ p
կարապետ	k ɑ ɾ ɑ p ɛ t
կարապետյան	k ɑ ɾ ɑ p ɛ t j ɑ n
կարգ	k ɑ ɾ kʰ
կարգադրել	k ɑ ɾ kʰ ɑ d ɾ ɛ l
կարգավիճակ	k ɑ ɾ kʰ ɑ v i t͡ʃ ɑ k
կարդալ	k ɑ ɾ tʰ ɑ l
կարել	k ɑ ɾ ɛ l
կարելի	k ɑ ɾ ɛ l i
կարեկցել	k ɑ ɾ ɛ k t͡sʰ ɛ l
կարեն	k ɑ ɾ ɛ n
կարեւոր	k ɑ ɾ ɛ v ɔ ɾ
կարիճ	k ɑ ɾ i t͡ʃ
կարծել	k ɑ ɾ t͡s ɛ l
կարծիք	k ɑ ɾ t͡s i kʰ
կարկուտ	k ɑ ɾ k u t
կարճաժամկետ	k ɑ ɾ t͡ʃ ɑ ʒ ɑ m k ɛ t
կարճամետրաժ	k ɑ ɾ t͡ʃ ɑ m ɛ t ɾ ɑ ʒ
կարո	k ɑ ɾ ɔ
կարող	k ɑ ɾ ɔ ʁ
կարողանալ	k ɑ ɾ o ʁ ɑ n ɑ l
կարոտ	k ɑ ɾ ɔ t
կարոտել	k ɑ ɾ ɔ t ɛ l
կարս	k ɑ ɾ s
կարտոֆիլ	k ɑ ɾ t ɔ f i l
կաֆե	k ɑ f ɛ
կգան	k ə ɡ ɑ n
կելտական	k ɛ l t ɑ k ɑ n
կեղեքել	k ɛ ʁ ɛ kʰ ɛ l
կեղծ	k ɛ χ t͡s
կեղծիք	k ɛ χ t͡s i kʰ
կեղտոտ	k ɛ χ t ɔ t
կեն	k ɛ n
կենարար	k ɛ n ɑ ɾ ɑ ɾ
կենդանաբանություն	k ɛ n tʰ ɑ n ɑ b ɑ n u tʰ j u n
կենդանակերպի	k ɛ n tʰ ɑ n ɑ k ɛ ɾ p i
կենդանանալ	k ɛ n tʰ ɑ n ɑ n ɑ l
կենդանի	k ɛ n tʰ ɑ n i
կենսական	k ɛ n s ɑ k ɑ n
կենսունակ	k ɛ n s u n ɑ k
կենտրոն	k ɛ n t ɾ ɔ n
կենտրոնական	k ɛ n t ɾ ɔ n ɑ k ɑ n
կենցաղ	k ɛ n t͡sʰ ɑ ʁ
կետ	k ɛ t
կեր	k ɛ ɾ
կերակուր	k ɛ ɾ ɑ k u ɾ
կերակրել	k ɛ ɾ ɑ k ə ɾ ɛ l
կերպար	k ɛ ɾ p ɑ ɾ
կերտել	k ɛ ɾ t ɛ l
կեցցե	k ɛ t͡sʰː ɛ
կզակ	k ə z ɑ k
կը	ɡ ə
կըհ	k ə ə h ə
կիթառ	k i tʰ ɑ r
կիլո	k i l o
կիլոգրամ	k i l ɔ ɡ ɾ ɑ m
կիլոմետր	k i l ɔ m ɛ t ə ɾ
կին	k i n
կինո	k i n ɔ
կիպրոս	k i p ɾ o s
կիսապաշտպան	k i s ɑ p ɑ ʃ t p ɑ n
կիսել	k i s ɛ l
կիրակի	k i ɾ ɑ k i
կիրակնօրյա	k i ɾ ɑ k n ɔ ɾ j ɑ
կիրառել	k i ɾ ɑ r ɛ l
կիրառվել	k i ɾ ɑ r v ɛ l
կիրթ	k i ɾ tʰ
կիրք	k i ɾ kʰ
կից	k i t͡sʰ
կլարա	k l ɑ ɾ ɑ
կլոր	k ə l ɔ ɾ
կլորավուն	k ə l ɔ ɾ ɑ v u n
կլրտոց	k ə l ə ɾ t o t͡sʰ
կծել	k ə t s ɛ l
կծու	k ə t͡s u
կղզի	k ə ʁ z i
կղզիներ	k ə ʁ z i n ɛ ɾ
կյանք	k j ɑ ŋ kʰ
կնիք	k ə n i kʰ
կնքել	k ə n kʰ ɛ l
կշռադատել	k ə ʃ r ɑ d ɑ t ɛ l
կշռել	k ə ʃ r ɛ l
կոալիցիա	k ɔ ɑ l i t͡sʰ j ɑ
կոլեգա	k ɔ l ɛ ɡ ɑ
կոլոլիկ	k o l o l i k
կոլումբիա	k ɔ l u m b j ɑ
կոկիկ	k ɔ k i k
կոկորդ	k ɔ k ɔ ɾ tʰ
կողմ	k ɔ ʁ m
կողմից	k ɔ ʁ m i t͡sʰ
կողմնակի	k o ʁ m n ɑ k i
կողոպտել	k ɔ ʁ ɔ p t ɛ l
կողք	k o χ kʰ
կողքիս	k ɔ χ kʰ i s
կոճակ	k ɔ t͡ʃ ɑ k
կոմիտե	k ɔ m i t ɛ
կոմունիզմ	k o m u n i z m
կոմունիստ	k o m u n i s t
կոմունիստական	k o m u n i s t ɑ k ɑ n
կոնյակ	k o n j ɑ k
կոնստրուկտիվ	k ɔ n s t ɾ u k t i v
կոնֆերանս	k ɔ n f ɛ ɾ ɑ n s
կոշիկ	k ɔ ʃ i k
կոշտ	k ɔ ʃ t
կոչ	k ɔ t͡ʃʰ
կոչում	k o t ʃʰ u m
կոպիտ	k ɔ p i t
կոռուպցիա	k ɔ r u p t͡sʰ j ɑ
կոսմոպոլիտ	k ɔ s m ɔ p ɔ l i t
կով	k ɔ v
կովկաս	k ɔ f k ɑ s
կովկասյան	k ɔ f k ɑ s j ɑ n
կոտայք	k ɔ t ɑ j kʰ
կոտրել	k o t ɾ ɛ l
կորել	k ɔ ɾ ɛ l
կորիզ	k ɔ ɾ i z
կործանել	k ɔ ɾ t͡s ɑ n ɛ l
կործանում	k ɔ ɾ t͡s ɑ n u m
կորուստ	k ɔ ɾ u s t
կորչել	k ɔ ɾ t͡ʃʰ ɛ l
կորտ	k ɔ ɾ t
կորցնել	k ɔ ɾ t͡sʰ n ɛ l
կուլ	k u l
կույս	k u j s
կույր	k u j ɾ
կուչ	k u t͡ʃʰ
կուռ	k u r
կուսակցություն	k u s ɑ k t͡sʰ u tʰ j u n
կպչուն	k ə p t ʃʰ u n
կռիվ	k ə r i v
կտակել	k ə t ɑ k ɛ l
կտոր	k ə t ɔ ɾ
կտրականապես	k ə t ɾ ɑ k ɑ n ɑ p ɛ s
կտրել	k ə t ɾ ɛ l
կտրուկ	k ə t ɾ u k
կրակ	k ə ɾ ɑ k
կրակել	k ə ɾ ɑ k ɛ l
կրասնոդար	k ɾ ɑ s n o d ɑ ɾ
կրեատիվ	k ɾ ɛ ɑ t i v
կրետե	k ə ɾ ɛ t ɛ
կրթություն	k ə ɾ tʰ u tʰ j u n
կրկես	k ə ɾ k ɛ s
կրկին	k ə ɾ k i n
կրկնել	k ə ɾ k n ɛ l
կրկնություն	k ə ɾ k n u tʰ j u n
կրճատում	k ə ɾ t͡ʃ ɑ t u m
կրպակ	k ə ɾ p ɑ k
կրտսեր	k ə ɾ t s ɛ ɾ
կցել	k ə t͡sʰ ɛ l
կցորդ	k ə t͡sʰ o ɾ tʰ
հա	h ɑ
հաբ	h ɑ b
հագել	h ɑ ɡ ɛ l
հագեցնել	h ɑ ɡ ɛ t͡sʰ n ɛ l
հագնել	h ɑ kʰ n ɛ l
հագնվել	h a kʰ n ə v ɛ l
հագուստ	h ɑ kʰ u s t
հագցնել	h ɑ kʰ t͡sʰ ə n ɛ l
հազ	h ɑ z
հազար	h ɑ z ɑ ɾ
հազարամյակ	h ɑ z ɑ ɾ ɑ m j ɑ k
հազիվ	h ɑ z i v
հալեպ	h ɑ l ɛ p
հալվա	h ɑ l v ɑ
հալվե	h ɑ l v ɛ
հակ	h ɑ k
հակազդել	h ɑ k ɑ z d ɛ l
հակահարված	h ɑ k ɑ h ɑ ɾ v ɑ t͡s
հակառակ	h ɑ k ɑ r ɑ k
հակոբ	h ɑ k ɔ pʰ
հակոբյան	h ɑ k ɔ pʰ j ɑ n
հահ	h ɑ h
հաղթական	h ɑ χ tʰ ɑ k ɑ n
հաղթանակ	h ɑ χ tʰ ɑ n ɑ k
հաղթել	h ɑ χ tʰ ɛ l
հաղորդագրություն	h ɑ ʁ ɔ ɾ tʰ ɑ ɡ ɾ u tʰ j u n
հաղորդել	h ɑ ʁ ɔ ɾ tʰ ɛ l
հաղորդում	h ɑ ʁ ɔ ɾ tʰ u m
հաճախ	h ɑ t͡ʃ ɑ χ
հաճախել	h ɑ t͡ʃ ɑ χ ɛ l
հաճախորդ	h ɑ t͡ʃ ɑ χ ɔ ɾ tʰ
հաճելի	h ɑ t͡ʃ ɛ l i
հաճո	h ɑ t͡ʃ ɔ
հաճույք	h ɑ t͡ʃ u j kʰ
համ	h ɑ m
համագործակցել	h ɑ m ɑ ɡ ɔ ɾ t͡s ɑ k t͡sʰ ɛ l
համագործակցության	h ɑ m ɑ ɡ ɔ ɾ t͡s ɑ k t͡sʰ u tʰ j ɑ n
համագործակցություն	h ɑ m ɑ ɡ ɔ ɾ t͡s ɑ k t͡sʰ u tʰ j u n
համադրություն	h ɑ m ɑ d ə ɾ u tʰ j u n
համաժողով	h ɑ m ɑ ʒ ɔ ʁ ɔ v
համալիր	h ɑ m ɑ l i ɾ
համալսարան	h ɑ m ɑ l s ɑ ɾ ɑ n
համալրել	h ɑ m ɑ l ɾ ɛ l
համակարգ	h ɑ m ɑ k ɑ ɾ kʰ
համակարգել	h ɑ m ɑ k ɑ ɾ kʰ ɛ l
համակարգիչ	h ɑ m ɑ k ɑ ɾ kʰ i t͡ʃʰ
համակարգող	h ɑ m ɑ k ɑ ɾ kʰ ɔ ʁ
համակրանք	h ɑ m ɑ k ɾ ɑ ŋ kʰ
համակրելի	h ɑ m ɑ k ɾ ɛ l i
համաձայն	h ɑ m ɑ d͡z ɑ j n
համաձայնել	h ɑ m ɑ d͡z ɑ j n ɛ l
համամարդկային	h ɑ m ɑ m ɑ ɾ tʰ k ɑ j i n
համամիութենական	h ɑ m ɑ m i u tʰ ɛ n ɑ k ɑ n
համայնք	h ɑ m ɑ j ŋ kʰ
համաշխարհային	h ɑ m ɑ ʃ χ ɑ ɾ ɑ j i n
համաչափ	h ɑ m ɑ t͡ʃʰ ɑ pʰ
համապատասխան	h ɑ m ɑ p ɑ t ɑ s χ ɑ n
համառոտ	h ɑ m ɑ r o t
համատարած	h ɑ m ɑ t ɑ ɾ ɑ t͡s
համատեքստ	h ɑ m ɑ t ɛ kʰ s t
համար	h ɑ m ɑ ɾ
համարել	h ɑ m ɑ ɾ ɛ l
համարժեք	h ɑ m ɑ ɾ ʒ ɛ kʰ
համարյա	h ɑ m ɑ ɾ j ɑ
համացանցային	h ɑ m ɑ t͡sʰ ɑ n t͡sʰ ɑ j i n
համբավ	h ɑ m b ɑ v
համբարձում	h ɑ m b ɑ ɾ t͡sʰ u m
համբարձումյան	h ɑ m b ɑ ɾ t͡sʰ u m j ɑ n
համբերել	h ɑ m pʰ ɛ ɾ ɛ l
համբերություն	h ɑ m pʰ ɛ ɾ u t sʰ j u n
համբույր	h ɑ m pʰ u j ɾ
համբուրել	h ɑ m pʰ u ɾ ɛ l
համեմատել	h ɑ m ɛ m ɑ t ɛ l
համեստ	h ɑ m ɛ s t
համերգ	h ɑ m ɛ ɾ ɡ
համերգասրահ	h ɑ m ɛ ɾ ɡ ɑ s ə ɾ ɑ h
համեցեք	h ɑ m ɛ t͡sʰ ɛ kʰ
համոզել	h ɑ m o z ɛ l
համոզված	h ɑ m ɔ z v ɑ t͡s
համով	h ɑ m o v
համր	h ɑ m ə ɾ
հայ	h ɑ j
հայագետ	h ɑ j ɑ ɡ ɛ t
հայաշատ	h ɑ j ɑ ʃ ɑ t
հայաստանի	h ɑ j ɑ s t ɑ n i
հայելի	h ɑ j ɛ l i
հայեր	h ɑ j ɛ ɾ
հայերեն	h ɑ j ɛ ɾ ɛ n
հայհոյել	h ɑ j h o j ɛ l
հայտարարել	h ɑ j t ɑ ɾ ɑ ɾ ɛ l
հայտարարում	h ɑ j t ɑ ɾ ɑ ɾ u m
հայտարարվել	h ɑ j t ɑ ɾ ɑ ɾ v ɛ l
հայտնի	h ɑ j t n i
հայր	h ɑ j ɾ
հայրական	h ɑ j ɾ ɑ k ɑ n
հայրապետյան	h ɑ j ɾ ɑ p ɛ t j ɑ n
հայրենակից	h ɑ j ɾ ɛ n ɑ k i t͡sʰ
հայրենասեր	h ɑ j ɾ ɛ n ɑ s ɛ ɾ
հայրենասիրական	h ɑ j ɾ ɛ n ɑ s i ɾ ɑ k ɑ n
հայրենի	h ɑ j ɾ ɛ n i
հայրենիք	h ɑ j ɾ ɛ n i kʰ
հայրենյաց	h ɑ ɪ̯ ɾ ɛ n ɪ̯ ɑ t sʰ
հայրիկյան	h ɑ j ɾ i k j ɑ n
հայց	h ɑ j t͡sʰ
հայցական	h ɑ j t͡sʰ ɑ k ɑ n
հայֆա	h ɑ j f ɑ
հանգամանք	h ɑ ŋ ɡ ɑ m ɑ ŋ kʰ
հանգույց	h ɑ n ɡ u j t sʰ
հանդեպ	h ɑ n d ɛ p
հանդես	h ɑ n d ɛ s
հանդերձ	h ɑ n d ɛ ɾ t͡sʰ
հանդիպում	h ɑ n d i p u m
հանդիսանալ	h ɑ n d i s ɑ n ɑ l
հանդիսավոր	h ɑ n d i s ɑ v ɔ ɾ
հանդիսացող	h ɑ n d i s ɑ t͡sʰ ɔ ʁ
հանդուրժել	h ɑ n d u ɾ ʒ ɛ l
հանդուրժող	h ɑ n d u ɾ ʒ ɔ ʁ
հանդուրժողականություն	h ɑ n d u ɾ ʒ ɔ ʁ ɑ k ɑ n u tʰ j u n
հանել	h ɑ n ɛ l
հանելուկ	h ɑ n ɛ l u k
հանի	h ɑ n i
հանձնաժողով	h ɑ n d͡z n ɑ ʒ ɔ ʁ ɔ v
հանձնակատար	h ɑ n d͡z n ɑ k ɑ t ɑ ɾ
հանձնել	h ɑ n d͡z n ɛ l
հանճար	h ɑ n t͡ʃ ɑ ɾ
հանճարեղ	h ɑ n t͡ʃ ɑ ɾ ɛ ʁ
հանվել	h ɑ n v ɛ l
հանրագիտարան	h ɑ n ɾ ɑ ɡ i t ɑ ɾ ɑ n
հանրապետական	h ɑ n ɾ ɑ p ɛ t ɑ k ɑ n
հանրաքվե	h ɑ n ɾ ɑ kʰ ə v ɛ
հանցագործ	h ɑ n t sʰ ɑ ɡ o ɾ t s
հանցանք	h ɑ n t sʰ ɑ n kʰ
հանք	h ɑ ŋ kʰ
հանքային	h ɑ ŋ kʰ ɑ j i n
հաշիվ	h ɑ ʃ i v
հաշվապահ	h ɑ ʃ v ɑ p ɑ h
հաշվապահական	h ɑ ʃ v ɑ p ɑ h ɑ k ɑ n
հաշվապահություն	h ɑ ʃ v ɑ p ɑ h u tʰ j u n
հաշվեկշիռ	h ɑ ʃ v ɛ k ə ʃ i r
հաշվիչ	h ɑ ʃ v i t͡ʃʰ
հաշվում	h ɑ ʃ v u m
հաշտ	h ɑ ʃ t
հաշտեցում	h ɑ ʃ t ɛ t͡sʰ u m
հապաղել	h ɑ p ɑ ʁ ɛ l
հապաղում	h ɑ p ɑ ʁ u m
հապկ	h ɑ p k
հաջող	h ɑ d͡ʒ o ʁ
հաջողություն	h ɑ d͡ʒ o ʁ u t͡sʰ j u n
հաջորդ	h ɑ d͡ʒ ɔ ɾ tʰ
հասարակ	h ɑ s ɑ ɾ ɑ k
հասարակական	h ɑ s ɑ ɾ ɑ k ɑ k ɑ n
հասարակություն	h ɑ s ɑ ɾ ɑ k u tʰ j u n
հասկանալ	h ɑ s k ɑ n ɑ l
հասկանում	h ɑ s k ɑ n u m
հասմիկ	h ɑ s m i k
հասնել	h ɑ s n ɛ l
հասու	h ɑ s u
հասուն	h ɑ s u n
հաստ	h ɑ s t
հաստատակամ	h ɑ s t ɑ t ɑ k ɑ m
հաստատել	h ɑ s t ɑ t ɛ l
հաստատություն	h ɑ s t ɑ t u tʰ j u n
հաստատուն	h ɑ s t ɑ t u n
հասցե	h ɑ s t͡sʰ ɛ
հասցեատեր	h ɑ s t͡sʰ ɛ ɑ t ɛ ɾ
հասցնել	h ɑ s t͡sʰ n ɛ l
հավ	h ɑ v
հավակնոտ	h ɑ v ɑ k n ɔ t
հավակնորդ	h ɑ v ɑ k n ɔ ɾ tʰ
հավանական	h ɑ v ɑ n ɑ k ɑ n
հավանել	h ɑ v ɑ n ɛ l
հավասար	h ɑ v ɑ s ɑ ɾ
հավաստի	h ɑ v ɑ s t i
հավատարիմ	h ɑ v ɑ t ɑ ɾ i m
հավատարմություն	h ɑ v ɑ t ɑ ɾ m u tʰ j u n
հավատք	h ɑ v ɑ t kʰ
հավաք	h ɑ v ɑ kʰ
հավաքածու	h ɑ v ɑ kʰ ɑ t͡s u
հավաքական	h ɑ v ɑ kʰ ɑ k ɑ n
հավելել	h ɑ v ɛ l ɛ l
հավելված	h ɑ v ɛ l v ɑ t͡s
հավես	h ɑ v ɛ s
հավետ	h ɑ v ɛ t
հավերժ	h ɑ v ɛ ɾ ʒ
հավիտյան	h ɑ v i t j ɑ n
հատիկ	h ɑ t i k
հատկացնել	h ɑ t k ɑ t͡sʰ n ɛ l
հատոր	h ɑ t ɔ ɾ
հատուկ	h ɑ t u k
հատուցել	h ɑ t u t͡sʰ ɛ l
հատուցում	h ɑ t u t͡sʰ u m
հատված	h ɑ t v ɑ t͡s
հարազատ	h ɑ ɾ ɑ z ɑ t
հարավ	h ɑ ɾ ɑ f
հարբած	h ɑ ɾ pʰ ɑ t͡s
հարգել	h ɑ ɾ ɡ ɛ l
հարել	h ɑ ɾ ɛ l
հարեւան	h a ɾ ɛ v a n
հարթ	h ɑ ɾ tʰ
հարթակ	h ɑ ɾ tʰ ɑ k
հարկ	h ɑ ɾ k
հարկային	h ɑ ɾ k ɑ j i n
հարձակում	h ɑ ɾ t͡sʰ ɑ k u m
հարմար	h ɑ ɾ m ɑ ɾ
հարյուր	h ɑ ɾ j u ɾ
հարոյան	h ɑ ɾ ɔ j ɑ n
հարս	h ɑ ɾ s
հարսանեկան	h ɑ ɾ s ɑ n ɛ k ɑ n
հարսանյաց	h ɑ ɾ s ɑ n j ɑ t͡sʰ
հարստություն	h ɑ ɾ ə s t u tʰ j u n
հարվածել	h ɑ ɾ v ɑ t͡s ɛ l
հարց	h ɑ ɾ t͡sʰ
հարցնել	h ɑ ɾ t sʰ n ɛ l
հաց	h ɑ t͡sʰ
հացադուլ	h ɑ t͡sʰ ɑ d u l
հեգ	h ɛ ɡ
հեզ	h ɛ z
հեթում	h ɛ tʰ u m
հեծանիվ	h ɛ t͡s ɑ n i v
հեկտար	h ɛ k t ɑ ɾ
հեղաշրջում	h ɛ ʁ ɑ ʃ ə ɾ d͡ʒ u m
հեղափոխություն	h ɛ ʁ ɑ pʰ ɔ χ u tʰ j u n
հեղել	h ɛ ʁ ɛ l
հեղինակ	h ɛ ʁ i n ɑ k
հեղինակություն	h ɛ ʁ i n ɑ k u tʰ j u n
հեղինե	h ɛ ʁ i n ɛ
հեղուկ	h ɛ ʁ u k
հենրիկ	h ɛ n ɾ i k
հեռագիր	h ɛ r ɑ ɡ i ɾ
հեռախոս	h ɛ r ɑ χ ɔ s
հեռահաղորդակցություն	h ɛ r ɑ h ɑ ʁ ɔ ɾ tʰ ɑ k t͡sʰ u tʰ j u n
հեռանկար	h ɛ r ɑ n ə k ɑ ɾ
հեռավոր	h ɛ r ɑ v o ɾ
հեռավորություն	h ɛ r ɑ v ɔ ɾ u tʰ j u n
հեռատես	h ɛ r ɑ t ɛ s
հեռու	h ɛ r u
հեռուստատեսություն	h ɛ r u s t ɑ t ɛ s u tʰ j u n
հեռուստացույց	h ɛ r u s t ɑ t͡sʰ u j t͡sʰ
հետադարձ	h ɛ t ɑ d ɑ ɾ t͡sʰ
հետազոտել	h ɛ t ɑ z ɔ t ɛ l
հետազոտող	h ɛ t ɑ z ɔ t ɔ ʁ
հետաձգել	h ɛ t ɑ d͡z ə kʰ ɛ l
հետամուտ	h ɛ t ɑ m u t
հետաքրքիր	h ɛ t ɑ kʰ ə ɾ kʰ i ɾ
հետեւել	h ɛ t ɛ v ɛ l
հետին	h ɛ t i n
հետխորհրդային	h ɛ t χ ɔ ɾ ə ɾ tʰ ɑ j i n
հետո	h ɛ t ɔ
հետույք	h ɛ t u j kʰ
հետք	h ɛ t kʰ
հերթ	h ɛ ɾ tʰ
հերոս	h ɛ ɾ ɔ s
հերոսաբար	h ɛ ɾ ɔ s ɑ b ɑ ɾ
հեքիաթ	h ɛ kʰ j ɑ tʰ
հզոր	h ə z ɔ ɾ
հիանալ	h i j ɑ n ɑ l
հիանալի	h i j ɑ n ɑ l i
հիասթափություն	h i j ɑ s tʰ ɑ pʰ u tʰ j u n
հիասթափված	h i j ɑ s tʰ ɑ pʰ v ɑ t͡s
հիասթափվել	h i j ɑ s tʰ ɑ pʰ v ɛ l
հիասքանչ	h i j ɑ s kʰ ɑ n t͡ʃʰ
հիմա	h i m ɑ
հիմար	h i m ɑ ɾ
հիմն	h i m ə n
հիմնադիր	h i m n ɑ d i ɾ
հիմնադրամ	h i m n ɑ d ɾ ɑ m
հիմնադրել	h i m n ɑ d ɾ ɛ l
հիմնադրվել	h i m n ɑ d ə ɾ v ɛ l
հիմնականում	h i m n ɑ k ɑ n u m
հիմնավորել	h i m n ɑ v ɔ ɾ ɛ l
հիմք	h i m kʰ
հինավուրց	h i n ɑ v u ɾ t͡sʰ
հինգ	h i ŋ ɡ
հիշատակ	h i ʃ ɑ t ɑ k
հիշեցնել	h i ʃ ɛ t͡sʰ n ɛ l
հիշողություն	h i ʃ ɔ ʁ u tʰ j u n
հիսուս	h i s u s
հիվանդ	h i v ɑ n d
հիվանդանոց	h i v ɑ n d ɑ n ɔ t͡sʰ
հիվանդություն	h i v ɑ n d u tʰ j u n
հիտլեր	h i t l ɛ ɾ
հհ	h ə h ə
հղել	h ə ʁ ɛ l
հղիանալ	h ə ʁ i j ɑ n ɑ l
հղում	h ə ʁ u m
հմայք	h ə m ɑ j kʰ
հմուտ	h ə m u t
հմտություն	h ə m t u tʰ j u n
հյութ	h j u tʰ
հյուպատոս	h j u p ɑ t ɔ s
հյուպատոսություն	h j u p ɑ t o s u t͡sʰ j u n
հյուսիս	h j u s i s
հյուսիսային	h j u s i s ɑ j i n
հյուր	h j u ɾ
հյուրանոց	h j u ɾ ɑ n ɔ t͡sʰ
հյուրեր	h ɪ̯ u ɾ ɛ ɾ
հյուրերը	h ɪ̯ u ɾ ɛ ɾ ə
հյուրերի	h ɪ̯ u ɾ ɛ ɾ i
հյուրերին	h ɪ̯ u ɾ ɛ ɾ i n
հյուրերից	h ɪ̯ u ɾ ɛ ɾ i t sʰ
հյուրին	h ɪ̯ u ɾ i n
հյուրիս	h ɪ̯ u ɾ i s
հյուրն	h j u ɾ n
հնազանդություն	h ə n ɑ z ɑ n d u tʰ j u n
հնամյա	h ə n ɑ m j ɑ
հնար	h ə n ɑ ɾ
հնարավոր	h ə n ɑ ɾ ɑ v ɔ ɾ
հնարավորություն	h ə n ɑ ɾ ɑ v ɔ ɾ u tʰ j u n
հնացած	h ə n ɑ t͡sʰ ɑ t͡s
հնգամյա	h ə ŋ ɡ ɑ m j ɑ
հնդեվրոպական	h ə n d ɛ v ɾ ɔ p ɑ k ɑ n
հնդիկ	h ə n d i k
հնդկական	h ə n d k ɑ k ɑ n
հնչել	h ə n t͡ʃʰ ɛ l
հոբելյանական	h o b ɛ l j ɑ n ɑ k ɑ n
հոգալ	h ɔ kʰ ɑ l
հոգատար	h o kʰ ɑ t ɑ ɾ
հոգեբան	h ɔ kʰ ɛ b ɑ n
հոգեբանական	h ɔ kʰ ɛ b ɑ n ɑ k ɑ n
հոգի	h ɔ kʰ i
հոգնակի	h ɔ kʰ n ɑ k i
հոգնել	h ɔ kʰ n ɛ l
հոլանդական	h o l ɑ n d ɑ k ɑ n
հոլանդիա	h ɔ l ɑ n d j ɑ
հոլանի	h o l ɑ n i
հոլով	h ɔ l ɔ v
հոլովակ	h ɔ l ɔ v ɑ k
հող	h ɔ ʁ
հոյակապ	h o j ɑ k ɑ p
հոն	h o n
հոշոտել	h ɔ ʃ ɔ t ɛ l
հոպար	h o p ɑ ɾ
հոսանք	h ɔ s ɑ ŋ kʰ
հոսք	h ɔ s kʰ
հով	h o v
հովանի	h o v ɑ n i
հովիտ	h ɔ v i t
հովհար	h ɔ v h ɑ ɾ
հոտ	h ɔ t
հոտաղ	h o t ɑ ʁ
հոր	h o ɾ
հորդանան	h ɔ ɾ d ɑ n ɑ n
հորեղբոր	h ɔ ɾ ɛ χ p ɔ ɾ
հորթ	h ɔ ɾ tʰ
հորիզոնական	h ɔ ɾ i z ɔ n ɑ k ɑ n
հորս	h ɔ ɾ s
հու	h u
հուզել	h u z ɛ l
հուզիչ	h u z i t͡ʃʰ
հուզող	h u z ɔ ʁ
հուլիս	h u l i s
հումանիտար	h u m ɑ n i t ɑ ɾ
հույն	h u j n
հուն	h u n
հունական	h u n ɑ k ɑ n
հունան	h u n ɑ n
հունաստան	h u n ɑ s t ɑ n
հունիս	h u n i s
հունվար	h u n v ɑ ɾ
հուշ	h u ʃ
հուշարձան	h u ʃ ɑ ɾ d͡z ɑ n
հուսալի	h u s ɑ l i
հուսահատ	h u s ɑ h ɑ t
հուսիկ	h u s i k
հպարտ	h ə p ɑ ɾ t
հռիփսիմե	h r i pʰ s i m ɛ
հռչակավոր	h ə r t͡ʃʰ ɑ k ɑ v ɔ ɾ
հսկա	h ə s k ɑ
հսկայական	h ə s k ɑ j ɑ k ɑ n
հրազդան	h ə ɾ ɑ z d ɑ n
հրաժարական	h ə ɾ ɑ ʒ ɑ ɾ ɑ k ɑ n
հրաժեշտ	h ə ɾ ɑ ʒ ɛ ʃ t
հրամայական	h ə ɾ ɑ m ɑ j ɑ k ɑ n
հրամայել	h ə ɾ ɑ m ɑ j ɛ l
հրաման	h ə ɾ ɑ m ɑ n
հրամանատար	h ə ɾ ɑ m ɑ n ɑ t ɑ ɾ
հրայր	h ə ɾ ɑ j ɾ
հրանտ	h ə ɾ ɑ n t
հրաշք	h ə ɾ ɑ ʃ kʰ
հրաչ	h ə ɾ ɑ t͡ʃʰ
հրաչյա	h ə ɾ ɑ t͡ʃʰ j ɑ
հրապատ	h ə ɾ ɑ p ɑ t
հրապարակ	h ə ɾ ɑ p ɑ ɾ ɑ k
հրապարակավ	h ɾ ɑ p ɑ ɾ ɑ k ɑ v
հրապարակել	h ə ɾ ɑ p ɑ ɾ ɑ k ɛ l
հրավեր	h ə ɾ ɑ v ɛ ɾ
հրատապ	h ə ɾ ɑ t ɑ p
հրատարակել	h ə ɾ ɑ t ɑ ɾ ɑ k ɛ l
հրատարակում	h ə ɾ ɑ t ɑ ɾ ɑ k u m
հրացան	h ə ɾ ɑ t͡sʰ ɑ n
հրդեհ	h ə ɾ d ɛ h
հրել	h ə ɾ ɛ l
հրեղեն	h ə ɾ ɛ ʁ ɛ n
հրեշ	h ə ɾ ɛ ʃ
հրեշտակ	h ə ɾ ɛ ʃ t ɑ k
հրետանի	h ə ɾ ɛ t ɑ n i
հրթիռ	h ə ɾ tʰ i r
հրկիզել	h ə ɾ k i z ɛ l
հրճվանք	h ə ɾ t͡ʃ v ɑ ŋ kʰ
հրովարտակ	h ə ɾ ɔ v ɑ ɾ t ɑ k
ձախ	d͡z ɑ χ
ձայն	d͡z ɑ j n
ձանձրալի	d z ɑ n d z ɾ ɑ l i
ձգտել	d͡z ə kʰ t ɛ l
ձեն	d͡z ɛ n
ձեռ	d͡z ɛ r
ձեռագիր	d͡z ɛ r ɑ ɡ i ɾ
ձեռնարկ	d͡z ɛ r n ɑ ɾ k
ձեռնպահ	d͡z ɛ r ə n p ɑ h
ձեռք	d͡z ɛ r kʰ
ձեռքի	d͡z ɛ r kʰ i
ձերբակալել	d͡z ɛ ɾ pʰ ɑ k ɑ l ɛ l
ձեւ	d͡z ɛ v
ձեւավորել	d͡z ɛ v ɑ v ɔ ɾ ɛ l
ձիաուժ	d͡z i j ɑ u ʒ
ձիգ	d͡z i kʰ
ձիթայուղ	d͡z i tʰ ɑ j u ʁ
ձկնորս	d z ə k n o ɾ s
ձմեռ	d͡z ə m ɛ r
ձմեռային	d z ə m ɛ r ɑ j i n
ձմռանը	d z ə m r ɑ n ə
ձոր	d͡z ɔ ɾ
ձու	d͡z u
ձուկ	d͡z u k
ձվաբջիջ	d z ə v ɑ b ə d ʒ i d ʒ
ձվածեղ	d͡z ə v ɑ t͡s ɛ ʁ
ղազախստան	ʁ ɑ z ɑ χ s t ɑ n
ղազար	ʁ ɑ z ɑ ɾ
ղազարյան	ʁ ɑ z ɑ ɾ j ɑ n
ղալաթ	ʁ ɑ l ɑ tʰ
ղարաբաղ	ʁ ɑ ɾ ɑ b ɑ ʁ
ղարաբաղյան	ʁ ɑ ɾ ɑ b ɑ ʁ j ɑ n
ղափան	ʁ ɑ pʰ ɑ n
ղեկ	ʁ ɛ k
ղեկավար	ʁ ɛ k ɑ v ɑ ɾ
ղրիմ	ʁ ə ɾ i m
ղրղզստան	ʁ ə ɾ ʁ ə z s t ɑ n
ճակատ	t͡ʃ ɑ k ɑ t
ճակատամարտ	t͡ʃ ɑ k ɑ t ɑ m ɑ ɾ t
ճամպրուկ	t͡ʃ ɑ m p ɾ u k
ճամփորդ	t͡ʃ ɑ m pʰ ɔ ɾ tʰ
ճանապարհային	t͡ʃ ɑ n ɑ p ɑ ɾ ɑ j i n
ճանապարհորդություն	t͡ʃ ɑ n ɑ p ɑ ɾ ɔ ɾ tʰ u tʰ j u n
ճաշ	t͡ʃ ɑ ʃ
ճաշակ	t͡ʃ ɑ ʃ ɑ k
ճաշասեղան	t ʃ ɑ ʃ ɑ s ɛ ʁ ɑ n
ճապոնական	t͡ʃ ɑ p ɔ n ɑ k ɑ n
ճապոնիա	t͡ʃ ɑ p ɔ n j ɑ
ճառ	t͡ʃ ɑ r
ճար	t͡ʃ ɑ ɾ
ճարահատյալ	t͡ʃ ɑ ɾ ɑ h ɑ t j ɑ l
ճարել	t͡ʃ ɑ ɾ ɛ l
ճարտարապետ	t͡ʃ ɑ ɾ t ɑ ɾ ɑ p ɛ t
ճաք	t͡ʃ ɑ kʰ
ճգնաժամ	t͡ʃ ə kʰ n ɑ ʒ ɑ m
ճեղքել	t͡ʃ ɛ χ kʰ ɛ l
ճեղքում	t͡ʃ ɛ χ kʰ u m
ճերմակ	t͡ʃ ɛ ɾ m ɑ k
ճիշտ	t͡ʃ i ʃ t
ճկուն	t͡ʃ ə k u n
ճյուղ	t͡ʃ j u ʁ
ճնճղուկ	t͡ʃ ə n t͡ʃ ə ʁ u k
ճնշում	t ʃ ə n ʃ u m
ճշգրտել	t͡ʃ ə ʃ ɡ ə ɾ t ɛ l
ճշմարիտ	t͡ʃ ə ʃ m ɑ ɾ i t
ճշմարտություն	t͡ʃ ə ʃ m ɑ ɾ t u tʰ j u n
ճոխ	t͡ʃ ɔ χ
ճրագ	t͡ʃ ə ɾ ɑ kʰ
մա	m ɑ
մագլցել	m ɑ ɡ ə l t͡sʰ ɛ l
մադրիդ	m ɑ d ɾ i d
մադրիդյան	m ɑ d ɾ i d j ɑ n
մազ	m ɑ z
մաթեմատիկա	m ɑ tʰ ɛ m ɑ t i k ɑ
մաթեմատիկոս	m ɑ tʰ ɛ m ɑ t i k ɔ s
մալթա	m ɑ l tʰ ɑ
մածուկ	m ɑ t͡s u k
մակ	m ɑ k
մականուն	m ɑ k ɑ n u n
մակարդակ	m ɑ k ɑ ɾ d ɑ k
մակերես	m ɑ k ɛ ɾ ɛ s
մակրոտնտեսական	m ɑ k ɾ ɔ t ə n t ɛ s ɑ k ɑ n
մահ	m ɑ h
մահակ	m ɑ h ɑ k
մահանալ	m ɑ h ɑ n ɑ l
մահապատիժ	m ɑ h ɑ p ɑ t i ʒ
մահացու	m ɑ h ɑ t͡sʰ u
մահմեդական	m ɑ h m ɛ d ɑ k ɑ n
մաղադանոս	m ɑ ʁ ɑ d ɑ n ɔ s
մաղթանք	m ɑ χ tʰ ɑ n kʰ
մաղթել	m ɑ χ tʰ ɛ l
մամ	m ɑ m
մամա	m ɑ m ɑ
մամուլ	m ɑ m u l
մամուլի	m ɑ m u l i
մայա	m ɑ j ɑ
մայիս	m ɑ j i s
մայր	m ɑ j ɾ
մայրական	m ɑ j ɾ ɑ k ɑ n
մայրաքաղաք	m ɑ j ɾ ɑ kʰ ɑ ʁ ɑ kʰ
մայրենի	m ɑ j ɾ ɛ n i
մայրուղի	m ɑ j ɾ u ʁ i
մանանա	m ɑ n ɑ n ɑ
մանե	m ɑ n ɛ
մանեթ	m ɑ n ɛ tʰ
մանուկ	m ɑ n u k
մանվել	m ɑ n v ɛ l
մանրակրկիտ	m ɑ n ɾ ɑ k ə ɾ k i t
մաշկ	m ɑ ʃ k
մառախուղ	m ɑ r ɑ χ u ʁ
մաս	m ɑ s
մասամբ	m ɑ s ɑ m pʰ
մասնագիտություն	m ɑ s n ɑ ɡ i t u tʰ j u n
մասնակից	m ɑ s n ɑ k i t͡sʰ
մասնակցել	m ɑ s n ɑ k t͡sʰ ɛ l
մասնաճյուղ	m ɑ s n ɑ t͡ʃ j u ʁ
մասնավոր	m ɑ s n ɑ v ɔ ɾ
մատ	m ɑ t
մատակարար	m ɑ t ɑ k ɑ ɾ ɑ ɾ
մատաղ	m ɑ t ɑ ʁ
մատթեոս	m ɑ t tʰ ɛ ɔ s
մատիտ	m ɑ t i t
մատնել	m ɑ t n ɛ l
մատուցող	m ɑ t u t͡sʰ ɔ ʁ
մարատ	m ɑ ɾ ɑ t
մարգար	m ɑ ɾ kʰ ɑ ɾ
մարգարիտ	m ɑ ɾ kʰ ɑ ɾ i t
մարգարյան	m ɑ ɾ kʰ ɑ ɾ j ɑ n
մարդ	m ɑ ɾ tʰ
մարդահամար	m ɑ ɾ tʰ ɑ h ɑ m ɑ ɾ
մարդաշատ	m ɑ ɾ tʰ ɑ ʃ ɑ t
մարդիկ	m ɑ ɾ tʰ i k
մարդկային	m ɑ ɾ tʰ k ɑ j i n
մարդկանց	m ɑ ɾ tʰ k ɑ n t͡sʰ
մարզադաշտ	m ɑ ɾ z ɑ d ɑ ʃ t
մարզասրահ	m ɑ ɾ z ɑ s ə ɾ ɑ h
մարզիկ	m ɑ ɾ z i k
մարիամ	m ɑ ɾ j ɑ m
մարջան	m ɑ ɾ d͡ʒ ɑ n
մարս	m ɑ ɾ s
մարսել	m ɑ ɾ s ɛ l
մարտ	m ɑ ɾ t
մարտական	m ɑ ɾ t ɑ k ɑ n
մարտահրավեր	m ɑ ɾ t ɑ h ə ɾ ɑ v ɛ ɾ
մարտավարություն	m ɑ ɾ t ɑ v ɑ ɾ u tʰ j u n
մարտին	m ɑ ɾ t i n
մարտիրոս	m ɑ ɾ t i ɾ ɔ s
մարտկոց	m ɑ ɾ t k o t sʰ
մաքուր	m ɑ kʰ u ɾ
մաքրել	m ɑ kʰ ɾ ɛ l
մաքրում	m ɑ kʰ ɾ u m
մեթոդ	m ɛ tʰ ɔ d
մելիքյան	m ɛ l i kʰ j ɑ n
մեխ	m ɛ χ
մեխակ	m ɛ χ ɑ k
մեծագույն	m ɛ t͡s ɑ ɡ u j n
մեծամասնություն	m ɛ t͡s ɑ m ɑ s n u tʰ j u n
մեծանուն	m ɛ t͡s ɑ n u n
մեծապես	m ɛ t͡s ɑ p ɛ s
մեծարել	m ɛ t͡s ɑ ɾ ɛ l
մեծաքանակ	m ɛ t͡s ɑ kʰ ɑ n ɑ k
մեկին	m ɛ k i n
մեկնաբանություն	m ɛ k n ɑ b ɑ n u tʰ j u n
մեկնել	m ɛ k n ɛ l
մեկնում	m ɛ k n u m
մեղադրանք	m ɛ ʁ ɑ d ə ɾ ɑ ŋ kʰ
մեղավոր	m ɛ ʁ ɑ v ɔ ɾ
մեղմ	m ɛ ʁ m
մեղր	m ɛ ʁ ə ɾ
մեղրի	m ɛ ʁ ɾ i
մեղք	m ɛ χ kʰ
մեղքեր	m ɛ χ kʰ ɛ ɾ
մեն	m ɛ n
մենակ	m ɛ n ɑ k
մենամարտ	m ɛ n ɑ m ɑ ɾ t
մենաշնորհ	m ɛ n ɑ ʃ ə n ɔ ɾ
մենուա	m ɛ n u ɑ
մենք	m ɛ ŋ kʰ
մեջ	m ɛ t͡ʃʰ
մեռած	m ɛ r ɑ t͡s
մեռնել	m ɛ r n ɛ l
մեսիջ	m ɛ s i d͡ʒ
մետաղ	m ɛ t ɑ ʁ
մետաքս	m ɛ t ɑ kʰ s
մետաքսյա	m ɛ t ɑ kʰ s j ɑ
մերժել	m ɛ ɾ ʒ ɛ l
մերժում	m ɛ ɾ ʒ u m
մերի	m ɛ ɾ i
մերկ	m ɛ ɾ k
մերկասառույց	m ɛ ɾ k ɑ s ɑ r u j t͡sʰ
մերուժան	m ɛ ɾ u ʒ ɑ n
մերսի	m ɛ r s i
մերսում	m ɛ ɾ s u m
մեքսիկա	m ɛ kʰ s i k ɑ
մթամ	m ə tʰ ɑ m
մթնշաղ	m ə tʰ ə n ʃ ɑ ʁ
մթնոլորտ	m ə tʰ n o l o ɾ t
մի	m i
միահամուռ	m j ɑ h ɑ m u r
միամտություն	m i j ɑ m ə t u tʰ j u n
միայն	m i j ɑ j n
միայնակ	m i j ɑ j n ɑ k
միասեռական	m i j ɑ s ɛ r ɑ k ɑ n
միասին	m j ɑ s i n
միասնաբար	m j ɑ s n ɑ b ɑ ɾ
միավորում	m i j ɑ v ɔ ɾ u m
միավորված	m i j ɑ v ɔ ɾ v ɑ t͡s
միացյալ	m i j ɑ t͡sʰ j ɑ l
միացում	m i j ɑ t͡sʰ u m
միգուցե	m i ɡ u t͡sʰ ɛ
միլան	m i l ɑ n
միլիարդ	m i l j ɑ ɾ d
միլիմետր	m i l i m ɛ t ə ɾ
միլիոնատեր	m i l j ɔ n ɑ t ɛ ɾ
միկոյան	m i k ɔ j ɑ n
միհրան	m i h ɾ ɑ n
մինասյան	m i n ɑ s j ɑ n
մինչդեռ	m i n t͡ʃʰ d ɛ r
միշտ	m i ʃ t
միության	m i u tʰ j ɑ n
միություն	m i u tʰ j u n
միջազգային	m i t͡ʃʰ ɑ z ɡ ɑ j i n
միջամտել	m i t͡ʃʰ ɑ m ə t ɛ l
միջանցք	m i t͡ʃʰ ɑ n t͡sʰ kʰ
միջերկրական	m i t͡ʃʰ ɛ ɾ k ɾ ɑ k ɑ n
միջեւ	m i t͡ʃʰ ɛ v
միջնադարյան	m i t͡ʃʰ n ɑ d ɑ ɾ j ɑ n
միջնորդ	m i t͡ʃʰ n ɔ ɾ tʰ
միջով	m i t͡ʃʰ ɔ v
միջոցառում	m i t͡ʃʰ ɔ t͡sʰ ɑ r u m
միջուկային	m i t͡ʃʰ u k ɑ j i n
միս	m i s
միտում	m i t u m
միտք	m i t kʰ
միտքը	m i t kʰ ə
միրգ	m i ɾ kʰ
միրզոյան	m i ɾ z ɔ j ɑ n
միքայել	m i kʰ ɑ j ɛ l
մխիթար	m ə χ i tʰ ɑ ɾ
մխիթարյան	m ə χ i tʰ ɑ ɾ j ɑ n
մխրճվել	m ə χ ə ɾ t͡ʃ v ɛ l
մկան	m ə k ɑ n
մկրատ	m ə k ɾ ɑ t
մկրտիչ	m ə k ə ɾ t i t͡ʃʰ
մղել	m ə ʁ ɛ l
մյուս	m j u s
մշակ	m ə ʃ ɑ k
մշակել	m ə ʃ ɑ k ɛ l
մշակութային	m ə ʃ ɑ k u tʰ ɑ j i n
մշակույթ	m ə ʃ ɑ k u j tʰ
մշտապես	m ə ʃ t ɑ p ɛ s
մոդա	m ɔ d ɑ
մոդել	m ɔ d ɛ l
մոդուլ	m ɔ d u l
մոլեկուլային	m ɔ l ɛ k u l ɑ j i n
մոլորակ	m o l o ɾ ɑ k
մոլորվել	m ɔ l ɔ ɾ v ɛ l
մոխրագույն	m ɔ χ ɾ ɑ ɡ u j n
մոմ	m ɔ m
մոնիտոր	m o n i t o ɾ
մոռ	m o r
մոռանալ	m o r ɑ n ɑ l
մոսկվա	m ɔ s k v ɑ
մովսես	m ɔ f s ɛ s
մովսիսյան	m ɔ f s i s j ɑ n
մոտ	m ɔ t
մոտալուտ	m ɔ t ɑ l u t
մոտակա	m ɔ t ɑ k ɑ
մոտավորապես	m ɔ t ɑ v ɔ ɾ ɑ p ɛ s
մոտենալ	m ɔ t ɛ n ɑ l
մոտեցում	m ɔ t ɛ t͡sʰ u m
մոր	m ɔ ɾ
մորեխ	m ɔ ɾ ɛ χ
մորթել	m ɔ ɾ tʰ ɛ l
մորուք	m o ɾ u kʰ
մուգ	m u kʰ
մութ	m u tʰ
մուկ	m u k
մունջ	m u n d͡ʒ
մուշեղ	m u ʃ ɛ ʁ
մուռ	m u r
մուտք	m u t kʰ
մուրադյան	m u ɾ ɑ d j ɑ n
մուրացկան	m u ɾ ɑ t͡sʰ k ɑ n
մռայլ	m ə r ɑ j l
մտաբերել	m ə t ɑ b ɛ ɾ ɛ l
մտադիր	m ə t ɑ d i ɾ
մտադրություն	m ə t ɑ d ɾ u tʰ j u n
մտածել	m ə t ɑ t͡s ɛ l
մտածող	m ə t ɑ t͡s ɔ ʁ
մտահոգ	m ə t ɑ h ɔ ɡ
մտահոգություն	m ə t ɑ h ɔ kʰ u tʰ j u n
մտահոգված	m ə t ɑ h ɔ kʰ v ɑ t͡s
մտավոր	m ə t ɑ v ɔ ɾ
մտավորականություն	m ə t ɑ v o ɾ ɑ k ɑ n u t sʰ j u n
մտիկ	m ə t i k
մտնել	m ə t n ɛ l
մտորել	m ə t ɔ ɾ ɛ l
մրցակից	m ə ɾ t͡sʰ ɑ k i t͡sʰ
մրցակցություն	m ə ɾ t͡sʰ ɑ k t͡sʰ u tʰ j u n
մրցավազք	m ə ɾ t͡sʰ ɑ v ɑ z kʰ
մրցավար	m ə ɾ t͡sʰ ɑ v ɑ ɾ
մրցել	m ə ɾ t͡sʰ ɛ l
մրցում	m ə ɾ t͡sʰ u m
յալթա	j ɑ l tʰ ɑ
յոդ	j o d
յոթ	j ɔ tʰ
յոթանասուն	j o tʰ ɑ n ɑ s u n
յոթերորդ	j o tʰ ɛ ɾ o ɾ tʰ
յուլյա	j u l j ɑ
յուրահատուկ	j u ɾ ɑ h ɑ t u k
յուրաքանչյուր	j u ɾ ɑ kʰ ɑ n t͡ʃʰ j u ɾ
յուրովի	j u ɾ o v i
յուրօրինակ	j u ɾ ɔ ɾ i n ɑ k
նա	n ɑ
նաեւ	n ɑ j ɛ v
նազ	n ɑ z
նազարեթ	n ɑ z ɑ ɾ ɛ tʰ
նազարյան	n ɑ z ɑ ɾ j ɑ n
նալբանդյան	n ɑ l b ɑ n d j ɑ n
նախ	n ɑ χ
նախագահ	n ɑ χ ɑ ɡ ɑ h
նախագահական	n ɑ χ ɑ ɡ ɑ h ɑ k ɑ n
նախագիծ	n ɑ χ ɑ ɡ i t͡s
նախադասություն	n ɑ χ ɑ d ɑ s u tʰ j u n
նախադեպ	n ɑ χ ɑ d ɛ p
նախաձեռնություն	n ɑ χ ɑ d͡z ɛ r n u tʰ j u n
նախաճաշել	n ɑ χ ɑ t ʃ ɑ ʃ ɛ l
նախանձ	n ɑ χ ɑ n d͡z
նախանձել	n ɑ χ ɑ n d͡z ɛ l
նախապես	n ɑ χ ɑ p ɛ s
նախատեսել	n ɑ χ ɑ t ɛ s ɛ l
նախատեսում	n ɑ χ ɑ t ɛ s u m
նախատեսվել	n ɑ χ ɑ t ɛ s v ɛ l
նախարար	n ɑ χ ɑ ɾ ɑ ɾ
նախարարություն	n ɑ χ ɑ ɾ ɑ ɾ u tʰ j u n
նախընտրել	n ɑ χ ə n t ɾ ɛ l
նախկին	n ɑ χ k i n
նախորդ	n ɑ χ ɔ ɾ tʰ
նամազ	n ɑ m ɑ z
նամակ	n ɑ m ɑ k
նայած	n ɑ j ɑ t͡s
նայել	n ɑ j ɛ l
նայվածք	n ɑ j v ɑ t͡s kʰ
նատօ	n ɑ t ɔ
նարդի	n ɑ ɾ d i
նացիստ	n ɑ t͡sʰ i s t
նեապոլ	n ɛ j ɑ p o l
նեխել	n ɛ χ ɛ l
նեղ	n ɛ ʁ
նեղանալ	n ɛ ʁ ɑ n ɑ l
նենգ	n ɛ ŋ ɡ
նետել	n ɛ t ɛ l
ներ	n ɛ ɾ
ներածություն	n ɛ ɾ ɑ t͡s u tʰ j u n
ներբեռնել	n ɛ ɾ b ɛ r n ɛ l
ներբող	n ɛ ɾ pʰ o ʁ
ներգաղթ	n ɛ ɾ ɡ ɑ χ tʰ
ներդաշնակ	n ɛ ɾ d ɑ ʃ n ɑ k
ներդաշնակություն	n ɛ ɾ d ɑ ʃ n ɑ k u tʰ j u n
ներդնել	n ɛ ɾ d ə n ɛ l
ներդրում	n ɛ ɾ d ə ɾ u m
ներել	n ɛ ɾ ɛ l
ներխուժել	n ɛ ɾ χ u ʒ ɛ l
ներխուժում	n ɛ ɾ χ u ʒ u m
ներկայացում	n ɛ ɾ k ɑ j ɑ t͡sʰ u m
ներկայացուցիչ	n ɛ ɾ k ɑ j ɑ t͡sʰ u t͡sʰ i t͡ʃʰ
ներկայացուցչություն	n ɛ ɾ k ɑ j ɑ t͡sʰ u t͡sʰ t͡ʃʰ u tʰ j u n
ներկել	n ɛ ɾ k ɛ l
ներողություն	n ɛ ɾ o ʁ u t͡sʰ j u n
ներում	n ɛ ɾ u m
ներս	n ɛ ɾ s
ներսես	n ɛ ɾ s ɛ s
ներսիսյան	n ɛ ɾ s i s j ɑ n
ներքեւ	n ɛ ɾ kʰ ɛ v
ներքին	n ɛ ɾ kʰ i n
ներքնազգեստ	n ɛ ɾ kʰ n ɑ z ɡ ɛ s t
ներքո	n ɛ ɾ kʰ ɔ
ներքուստ	n ɛ ɾ kʰ u s t
նժդեհ	n ə ʒ d ɛ h
նիկոլ	n i k ɔ l
նիկողայոս	n i k ɔ ʁ ɑ j ɔ s
նիհար	n i h ɑ ɾ
նկատմամբ	n ə k ɑ t m ɑ m b
նկար	n ə k ɑ ɾ
նկարագրել	n ə k ɑ ɾ ɑ ɡ ɾ ɛ l
նկարագրություն	n ə k ɑ ɾ ɑ ɡ ɾ u tʰ j u n
նկարահանել	n ə k ɑ ɾ ɑ h ɑ n ɛ l
նկարահանում	n ə k ɑ ɾ ɑ h ɑ n u m
նկարահանվել	n ə k ɑ ɾ ɑ h ɑ n v ɛ l
նկարել	n ə k ɑ ɾ ɛ l
նկարիչ	n ə k ɑ ɾ i t͡ʃʰ
նկուղային	n ə k u ʁ ɑ j i n
նման	n ə m a n
նմուշ	n ə m u ʃ
նյութ	n j u tʰ
նշանավոր	n ə ʃ ɑ n ɑ v ɔ ɾ
նշանվել	n ə ʃ ɑ n v ɛ l
նշել	n ə ʃ ɛ l
նոխազ	n o χ ɑ z
նոյեմբեր	n o j ɛ m b ɛ ɾ
նոր	n ɔ ɾ
նորածին	n ɔ ɾ ɑ t͡s i n
նորայր	n ɔ ɾ ɑ j ɾ
նորմատիվ	n o ɾ m ɑ t i v
նորոգ	n o ɾ o kʰ
նորություն	n ɔ ɾ u tʰ j u n
նորություններ	n ɔ ɾ u tʰ j u nː ɛ ɾ
նորույթ	n ɔ ɾ u j tʰ
նորվեգական	n ɔ ɾ v ɛ ɡ ɑ k ɑ n
նույն	n u ɪ̯ n
նույնականացման	n u j n ɑ k ɑ n ɑ t͡sʰ m ɑ n
նույնիսկ	n u j n i s k
նույնպես	n u j n p ɛ s
նույնքան	n u j n kʰ ɑ n
նուրբ	n u ɾ pʰ
նպաստ	n ə p ɑ s t
նպաստել	n ə p ɑ s t ɛ l
նպատակ	n ə p ɑ t ɑ k
նվազ	n ə v ɑ z
նվարդ	n ə v ɑ ɾ tʰ
նվեր	n ə v ɛ ɾ
նվիրել	n ə v i ɾ ɛ l
նրան	n ə ɾ ɑ n
նրանով	n ɾ ɑ n o v
նրանում	n ɾ ɑ n u m
նրանց	n ə ɾ ɑ n t͡sʰ
նրանք	n ə ɾ ɑ ŋ kʰ
շաբաթվա	ʃ ɑ pʰ ɑ tʰ v ɑ
շագանակագույն	ʃ ɑ ɡ ɑ n ɑ k ɑ ɡ u j n
շալվար	ʃ ɑ l v ɑ ɾ
շախ	ʃ ɑ χ
շախմատ	ʃ ɑ χ m ɑ t
շախմատի	ʃ ɑ χ m ɑ t i
շախմատիստ	ʃ ɑ χ m ɑ t i s t
շահավետ	ʃ ɑ h ɑ v ɛ t
շահեկան	ʃ ɑ h ɛ k ɑ n
շահեն	ʃ ɑ h ɛ n
շաղ	ʃ ɑ ʁ
շամախի	ʃ ɑ m ɑ χ i
շամիրամ	ʃ ɑ m i ɾ ɑ m
շամպայն	ʃ ɑ m p ɑ j n
շանթ	ʃ ɑ n tʰ
շապիկ	ʃ ɑ p i k
շավարշ	ʃ ɑ v ɑ ɾ ʃ
շատ	ʃ ɑ t
շարադրություն	ʃ ɑ ɾ ɑ d ɾ u tʰ j u n
շարժ	ʃ ɑ ɾ ʒ
շարժական	ʃ ɑ ɾ ʒ ɑ k ɑ n
շարժել	ʃ ɑ ɾ ʒ ɛ l
շարժիչ	ʃ ɑ ɾ ʒ i t ʃʰ
շարժում	ʃ ɑ ɾ ʒ u m
շարքային	ʃ ɑ ɾ kʰ ɑ j i n
շաքար	ʃ ɑ kʰ ɑ ɾ
շաքարավազ	ʃ ɑ kʰ ɑ ɾ ɑ v ɑ z
շեղանկյուն	ʃ ɛ ʁ ɑ ŋ k j u n
շենք	ʃ ɛ ŋ kʰ
շեշտել	ʃ ɛ ʃ t ɛ l
շերեփուկ	ʃ ɛ ɾ ɛ pʰ u k
շեքսպիր	ʃ ɛ kʰ s p i ɾ
շեֆ	ʃ ɛ f
շիճուկ	ʃ i t͡ʃ u k
շինարար	ʃ i n ɑ ɾ ɑ ɾ
շիրակ	ʃ i ɾ ɑ k
շիրինյան	ʃ i ɾ i n j ɑ n
շղթա	ʃ ə χ tʰ ɑ
շղթայական	ʃ ə χ tʰ ɑ j ɑ k ɑ n
շնորհակալ	ʃ ə n ɔ ɾ ɑ k ɑ l
շնորհավոր	ʃ ə n ɔ ɾ ɑ v ɔ ɾ
շնորհավորում	ʃ n ɔ ɾ ɑ v ɔ ɾ u m
շնորհել	ʃ ə n ɔ ɾ ɛ l
շնորհիվ	ʃ ə n ɔ ɾ i v
շնորհք	ʃ ə n ɔ ɾ kʰ
շնչառություն	ʃ ə n t͡ʃʰ ɑ r u tʰ j u n
շոկոլադ	ʃ ɔ k ɔ l ɑ d
շոր	ʃ ɔ ɾ
շուկա	ʃ u k ɑ
շուն	ʃ u n
շուշան	ʃ u ʃ ɑ n
շուշանիկ	ʃ u ʃ ɑ n i k
շուշի	ʃ u ʃ i
շուշտ	ʃ u ʃ t
շուտ	ʃ u t
շուտափույթ	ʃ u t ɑ pʰ u j tʰ
շուտով	ʃ u t ɔ v
շուրջ	ʃ u ɾ d͡ʒ
շպրտել	ʃ ə p ə ɾ t ɛ l
շվեդ	ʃ ə v ɛ d
շվեդական	ʃ v ɛ d ɑ k ɑ n
շվեյցարիա	ʃ v ɛ j t͡sʰ ɑ ɾ j ɑ
շտաբ	ʃ t ɑ b
շտեմարան	ʃ t ɛ m ɑ ɾ ɑ n
շտկել	ʃ ə t k ɛ l
շրջան	ʃ ə ɾ d͡ʒ ɑ n
շրջանակ	ʃ ə ɾ d͡ʒ ɑ n ɑ k
շրջանակում	ʃ ə ɾ d͡ʒ ɑ n ɑ k u m
շրջանառություն	ʃ ə ɾ d͡ʒ ɑ n ɑ r u tʰ j u n
շրջիկ	ʃ ə ɾ d͡ʒ i k
շփոթել	ʃ ə pʰ ɔ tʰ ɛ l
շփոթություն	ʃ ə pʰ ɔ tʰ u tʰ j u n
շքեղ	ʃ ə kʰ ɛ ʁ
շքերթ	ʃ ə kʰ ɛ ɾ tʰ
ոգեշնչել	v ɔ kʰ ɛ ʃ ə n t͡ʃʰ ɛ l
ոլորապտույտ	v ɔ l ɔ ɾ ɑ p ə t u j t
ոլորուն	v ɔ l ɔ ɾ u n
ոլորտ	v ɔ l ɔ ɾ t
ող	v ɔ ʁ
ողբ	v ɔ χ p
ողբերգություն	v ɔ χ p ɛ ɾ ɡ u tʰ j u n
ողողել	v ɔ ʁ ɔ ʁ ɛ l
ողորմածիկ	v ɔ ʁ ɔ ɾ m ɑ t͡s i k
ողորմություն	v ɔ ʁ ɔ ɾ m u tʰ j u n
ողջ	v ɔ χ t͡ʃʰ
ողջամիտ	v ɔ χ t͡ʃʰ ɑ m i t
ողջույն	v ɔ χ t͡ʃʰ u j n
ողջունել	v ɔ χ t͡ʃʰ u n ɛ m
ոճ	v ɔ t͡ʃ
ոմն	v o m ə n
ոնց	v ɔ n t͡sʰ
ոչ	v ɔ t͡ʃʰ
ոչխար	v ɔ t͡ʃʰ χ ɑ ɾ
ոչնչացում	v ɔ t͡ʃʰ ə n t͡ʃʰ ɑ t͡sʰ u m
ոսկանյան	v ɔ s k ɑ n j ɑ n
ոսկե	v ɔ s k ɛ
ոսկեզօծ	v o s k ɛ z o t s
ոսկի	v ɔ s k i
ոսկյա	v ɔ s k j ɑ
ոսկու	v ɔ s k u
ոսկր	v ɔ s k ə ɾ
ոստանիկ	v ɔ s t ɑ n i k
ոստիկան	v ɔ s t i k ɑ n
ոստիկանապետ	v ɔ s t i k ɑ n ɑ p ɛ t
ոստիկանություն	v ɔ s t i k ɑ n u tʰ j u n
ով	ɔ v
ոտ	v ɔ t
ոտք	v ɔ t kʰ
որ	v ɔ ɾ
որակական	v ɔ ɾ ɑ k ɑ k ɑ n
որբ	v ɔ ɾ pʰ
որբանալ	v o ɾ pʰ ɑ n ɑ l
որդ	v ɔ ɾ tʰ
որդի	v ɔ ɾ tʰ i
որեւէ	v ɔ ɾ ɛ v ɛ
որի	v ɔ ɾ i
որոնում	v ɔ ɾ ɔ n u m
որոշակի	v ɔ ɾ ɔ ʃ ɑ k i
որոշում	v ɔ ɾ ɔ ʃ u m
որոտ	v ɔ ɾ ɔ t
որոր	v ɔ ɾ ɔ ɾ
որս	v ɔ ɾ s
որսալ	v ɔ ɾ s ɑ l
որտեղ	v ɔ ɾ t ɛ ʁ
որքան	v ɔ ɾ kʰ ɑ n
ութերորդ	uʰ ɛ ɾ o ɾ tʰ
ուժ	u ʒ
ուժգին	u ʒ ɡ i n
ուլ	u l
ուլունք	u l u n kʰ
ուկրաինա	u k ɾ ɑ j i n ɑ
ուկրաինական	u k ɾ ɑ i n ɑ k ɑ n
ուկրաինացի	u k ɾ ɑ i n ɑ t͡sʰ i
ուղարկել	u ʁ ɑ ɾ k ɛ l
ուղեկցել	u ʁ ə k t͡sʰ ɛ l
ուղեղ	u ʁ ɛ ʁ
ուղերձ	u ʁ ɛ ɾ t͡sʰ
ուղի	u ʁ i
ուղիղ	u ʁ i ʁ
ուղղաթիռ	u ʁː ɑ tʰ i r
ուղղակի	u ʁː ɑ k i
ումպ	u m p
ունակ	u n ɑ k
ունակություն	u n ɑ k u tʰ j u n
ունեմ	u n ɛ m
ունենալ	u n ɛ n a l
ուշ	u ʃ
ուշադիր	u ʃ ɑ d i ɾ
ուշանալ	u ʃ ɑ n ɑ l
ուշիմ	u ʃ i m
ուշք	u ʃ kʰ
ուռուցքաբանական	u r u t͡sʰ kʰ ɑ b ɑ n ɑ k ɑ n
ուս	u s
ուսանել	u s ɑ n ɛ l
ուսանող	u s ɑ n ɔ ʁ
ուսապարկ	u s ɑ p ɑ ɾ k
ուսում	u s u m
ուսուցանել	u s u t͡sʰ ɑ n ɛ l
ուսուցչուհի	u s u t sʰ t ʃʰ u h i
ուստի	u s t i
ուտել	u t ɛ l
ուր	u ɾ
ուրախացնել	u ɾ ɑ χ ɑ t͡sʰ n ɛ l
ուրարտական	u ɾ ɑ ɾ t ɑ k ɑ n
ուրբաթ	u ɾ pʰ ɑ tʰ
ուրիշ	u ɾ i ʃ
ուրվական	u ɾ v ɑ k ɑ n
ոք	v ɔ kʰ
չամիչ	t͡ʃʰ ɑ m i t͡ʃʰ
չար	t͡ʃʰ ɑ ɾ
չարաշահել	t͡ʃʰ ɑ ɾ ɑ ʃ ɑ h ɛ l
չարբախ	t͡ʃʰ ɑ ɾ b ɑ χ
չարիք	t ʃʰ ɑ ɾ i kʰ
չարխ	t͡ʃʰ ɑ ɾ χ
չարչարել	t͡ʃʰ ɑ ɾ t͡ʃʰ ɑ ɾ ɛ l
չափազանց	t͡ʃʰ ɑ pʰ ɑ z ɑ n t͡sʰ
չափահաս	t͡ʃʰ ɑ pʰ ɑ h ɑ s
չգիտեմ	t͡ʃʰ ə ɡ i t ɛ m
չեզոք	t͡ʃʰ ɛ z ɔ kʰ
չեխիա	t͡ʃʰ ɛ χ j ɑ
չեղարկել	t͡ʃʰ ɛ ʁ ɑ ɾ k ɛ l
չեմպիոն	t͡ʃʰ ɛ m p j ɔ n
չեռնոգորիա	t͡ʃʰ ɛ r n ɔ ɡ ɔ ɾ j ɑ
չէ	t͡ʃʰ ɛ
չի	t͡ʃʰ i
չիլինգարյան	t͡ʃʰ i l i ŋ ɡ ɑ ɾ j ɑ n
չինաստան	t͡ʃʰ i n ɑ s t ɑ n
չինար	t͡ʃʰ i n ɑ ɾ
չինարի	t͡ʃʰ i n ɑ ɾ i
չինացի	t͡ʃʰ i n ɑ t͡sʰ i
չինգաչունգ	t ʃʰ i n ɡ ɑ t ʃʰ u n ɡ
չիր	t͡ʃʰ i ɾ
չիք	t ʃʰ i kʰ
չնայած	t͡ʃʰ ə n ɑ j ɑ t͡s
չոր	t͡ʃʰ o ɾ
չորացնել	t ʃʰ o ɾ ɑ t sʰ n ɛ l
չորս	t͡ʃʰ ɔ ɾ s
չվերթ	t ʃ ə v ɛ ɾ tʰ
պալատական	p ɑ l ɑ t ɑ k ɑ n
պակասել	p ɑ k ɑ s ɛ l
պակասուրդ	p ɑ k ɑ s u ɾ tʰ
պահ	p ɑ h
պահանջ	p ɑ h ɑ n d͡ʒ
պահանջարկ	p ɑ h ɑ n d͡ʒ ɑ ɾ k
պահանջել	p ɑ h ɑ n d͡ʒ ɛ l
պահել	p ɑ h ɛ l
պահեստ	p ɑ h ɛ s t
պահպանողական	p ɑ h p ɑ n ɔ ʁ ɑ k ɑ n
պահք	p ɑ h kʰ
պաղպաղակ	p ɑ χ p ɑ ʁ ɑ k
պայթել	p ɑ j tʰ ɛ l
պայթյուն	p ɑ j tʰ j u n
պայծառ	p ɑ j t͡s ɑ r
պայմանավորել	p ɑ j m ɑ n ɑ v ɔ ɾ ɛ l
պայմանավորվածություն	p ɑ j m ɑ n ɑ v ɔ ɾ v ɑ t͡s u tʰ j u n
պայմանավորվել	p ɑ j m ɑ n ɑ v ɔ ɾ v ɛ l
պայքար	p ɑ j kʰ ɑ ɾ
պանթեոն	p ɑ n tʰ ɛ o n
պանիր	p ɑ n i ɾ
պաշար	p ɑ ʃ ɑ ɾ
պաշտել	p ɑ ʃ t ɛ l
պաշտոն	p ɑ ʃ t ɔ n
պաշտոնակից	p ɑ ʃ t ɔ n ɑ k i t͡sʰ
պաշտոնյա	p ɑ ʃ t o n j ɑ
պապ	p ɑ p
պապա	p ɑ p ɑ
պապական	p ɑ p ɑ k ɑ n
պապի	p ɑ p i
պապիկ	p ɑ p i k
պառլամենտ	p ɑ r l ɑ m ɛ n t
պառկել	p ɑ r k ɛ l
պաստառ	p ɑ s t ɑ r
պատահար	p ɑ t ɑ h ɑ ɾ
պատահել	p ɑ t ɑ h ɛ l
պատանդ	p ɑ t ɑ n d
պատառ	p ɑ t ɑ r
պատասխան	p ɑ t ɑ s χ ɑ n
պատասխանատու	p ɑ t ɑ s χ ɑ n ɑ t u
պատասխանատվությամբ	p ɑ t ɑ s χ ɑ n ɑ t v u tʰ j ɑ m b
պատասխանատվություն	p ɑ t ɑ s χ ɑ n ɑ t v u tʰ j u n
պատարագ	p ɑ t ɑ ɾ ɑ kʰ
պատերազմ	p ɑ t ɛ ɾ ɑ z m
պատժել	p ɑ t ʒ ɛ l
պատիվ	p ɑ t i v
պատկանել	p ɑ t k ɑ n ɛ l
պատկառանք	p ɑ t k ɑ r ɑ ŋ kʰ
պատկառելի	p ɑ t k ɑ r ɛ l i
պատկեր	p ɑ t k ɛ ɾ
պատկերասրահ	p ɑ t k ɛ ɾ ɑ s ə ɾ ɑ h
պատկերել	p ɑ t k ɛ ɾ ɛ l
պատճառ	p ɑ t t͡ʃ ɑ r
պատմական	p ɑ t m ɑ k ɑ n
պատմել	p ɑ t m ɛ l
պատշգամբ	p ɑ t ə ʃ ɡ ɑ m b
պատուհան	p ɑ t u h ɑ n
պատվաստել	p ɑ t v ɑ s t ɛ l
պատվեր	p ɑ t v ɛ ɾ
պատվիրել	p ɑ t v i ɾ ɛ l
պատվոգիր	p ɑ t v ɔ ɡ i ɾ
պատրաստակամ	p ɑ t ɾ ɑ s t ɑ k ɑ m
պատրաստել	p ɑ t ɾ ɑ s t ɛ l
պատրաստվել	p ɑ t ɾ ɑ s t v ɛ l
պարան	p ɑ ɾ ɑ n
պարարտ	p ɑ ɾ ɑ ɾ t
պարարտանյութ	p ɑ ɾ ɑ ɾ t ɑ n j u tʰ
պարգեւ	p ɑ ɾ kʰ ɛ v
պարել	p ɑ ɾ ɛ l
պարզ	p ɑ ɾ z
պարզաբանում	p ɑ ɾ z ɑ b ɑ n u m
պարզապես	p ɑ ɾ z ɑ p ɛ s
պարզունակ	p ɑ ɾ z u n ɑ k
պարկ	p ɑ ɾ k
պարկեշտ	p ɑ ɾ k ɛ ʃ t
պարույր	p ɑ ɾ u j ɾ
պարսկական	p ɑ ɾ s k ɑ k ɑ n
պարսք	p ɑ ɾ s kʰ
պարտիա	p ɑ ɾ t j ɑ
պարտիզան	p a ɾ t i z a n
պարտություն	p ɑ ɾ t u tʰ j u n
պարտվել	p ɑ ɾ t v ɛ l
պեկ	p ɛ k
պես	p ɛ s
պետ	p ɛ t
պետական	p ɛ t ɑ k ɑ n
պետերբուրգ	p ɛ t ɛ ɾ b u ɾ ɡ
պետություն	p ɛ t u tʰ j u n
պետք	p ɛ t kʰ
պինդ	p i n d
պիվա	p i v ɑ
պիրենեյան	p i ɾ ɛ n ɛ j ɑ n
պիցցա	p i t͡sʰː ɑ
պլաստիկ	p l ɑ s t i k
պլենար	p l ɛ n a ɾ
պնդել	p ə n d ɛ l
պոզիտիվ	p ɔ z i t i v
պոկել	p ɔ k ɛ l
պոկեր	p o k ɛ ɾ
պող	p ɔ ʁ
պողոս	p ɔ ʁ ɔ s
պողոտա	p ɔ ʁ ɔ t ɑ
պոչ	p ɔ t͡ʃʰ
պոպուլիստ	p ɔ p u l i s t
պոռոտախոս	p ɔ r ɔ t ɑ χ ɔ s
պորտ	p ɔ ɾ t
պորտուգալացի	p ɔ ɾ t u ɡ ɑ l ɑ t͡sʰ i
պորտուգալիա	p ɔ ɾ t u ɡ ɑ l j ɑ
պուճուր	p u t͡ʃ u ɾ
պտղատու	p ə t ʁ ɑ t u
պտույտ	p ə t u j t
պրակտիկ	p ɾ ɑ k t i k
պրիմիտիվ	p ɾ i m i t i v
պրոցես	p ɾ ɔ t͡sʰ ɛ s
պրոֆեսիոնալ	p ɾ ɔ f ɛ s i ɔ n ɑ l
պրոֆեսոր	p ɾ ɔ f ɛ s ɔ ɾ
ջազ	d͡ʒ ɑ z
ջահել	d͡ʒ ɑ h ɛ l
ջահուկյան	d͡ʒ ɑ h u k j ɑ n
ջան	d͡ʒ ɑ n
ջանասիրաբար	d͡ʒ ɑ n ɑ s i ɾ ɑ b ɑ ɾ
ջանք	d͡ʒ ɑ ŋ kʰ
ջերմ	d͡ʒ ɛ ɾ m
ջերմաստիճան	d͡ʒ ɛ ɾ m ɑ s t i t͡ʃ ɑ n
ջերմություն	d ʒ ɛ ɾ m u t sʰ j u n
ջերմուկ	d͡ʒ ɛ ɾ m u k
ջիլ	d͡ʒ i l
ջիմ	d͡ʒ i m
ջինս	d͡ʒ i n s
ջնջել	d͡ʒ ə n d͡ʒ ɛ l
ջորջիա	d͡ʒ o ɾ d͡ʒ i a
ջուր	d͡ʒ u ɾ
ջրածնային	d ʒ ə ɾ ɑ t s n ɑ j i n
ջրատար	d͡ʒ ə ɾ ɑ t ɑ ɾ
ջրի	d͡ʒ ə ɾ i
ջրհեղեղ	d͡ʒ ə ɾ h ɛ ʁ ɛ ʁ
ջրվեժ	d͡ʒ ə ɾ v ɛ ʒ
ռադիոկայան	r ɑ d i ɔ k ɑ j ɑ n
ռազմական	r ɑ z m ɑ k ɑ n
ռազմավարական	r ɑ z m ɑ v ɑ ɾ ɑ k ɑ n
ռազմավարություն	r ɑ z m ɑ v ɑ ɾ u tʰ j u n
ռակ	r ɑ k
ռացիոնալ	r ɑ t͡sʰ i ɔ n ɑ l
ռաֆայել	r ɑ f ɑ j ɛ l
ռեալ	r ɛ ɑ l
ռեկտոր	r ɛ k t ɔ ɾ
ռեյտինգ	r ɛ j t i ŋ ɡ
ռեպ	r ɛ p
ռեսուրս	r ɛ s u ɾ s
ռեստորան	r ɛ s t o ɾ ɑ n
ռեֆորմ	r ɛ f ɔ ɾ m
ռինգ	r i n ɡ
ռիչարդ	r i t͡ʃʰ ɑ ɾ d
ռիսկ	r i s k
ռոբերտ	r ɔ b ɛ ɾ t
ռոման	r o m ɑ n
ռոն	r ɔ n
ռուբեն	r u b ɛ n
ռուբլի	r u b l i
ռումբ	r u m b
ռումինիա	r u m i n ɪ̯ ɑ
ռուս	r u s
ռուսաստան	r u s ɑ s t ɑ n
ռուսերեն	r u s ɛ ɾ ɛ n
սա	s ɑ
սադրանք	s ɑ d ɾ ɑ ŋ kʰ
սաթենիկ	s ɑ tʰ ɛ n i k
սալաթ	s ɑ l ɑ tʰ
սալվադոր	s ɑ l v ɑ d ɔ ɾ
սակայն	s ɑ k ɑ j n
սակավաթիվ	s ɑ k ɑ v ɑ tʰ i v
սահակ	s ɑ h ɑ k
սահակյան	s ɑ h ɑ k j ɑ n
սահել	s ɑ h ɛ l
սահման	s ɑ h m ɑ n
սահմանադրական	s ɑ h m ɑ n ɑ d ɾ ɑ k ɑ n
սահմանադրություն	s ɑ h m ɑ n ɑ d ə ɾ u tʰ j u n
սահմանապահ	s ɑ h m ɑ n ɑ p ɑ h
սահմանափակ	s ɑ h m ɑ n ɑ pʰ ɑ k
սահմանափակել	s ɑ h m ɑ n ɑ pʰ ɑ k ɛ l
սահմանափակում	s ɑ h m ɑ n ɑ pʰ ɑ k u m
սահմանափակվել	s ɑ h m ɑ n ɑ pʰ ɑ k v ɛ l
սահմանել	s ɑ h m ɑ n ɛ l
սահմանվել	s ɑ h m ɑ n v ɛ l
սաղ	s ɑ ʁ
սաղմ	s ɑ ʁ m
սաղմոս	s ɑ ʁ m ɔ s
սամարիա	s ɑ m ɑ ɾ j ɑ
սամվել	s ɑ m v ɛ l
սայթաքել	s ɑ j tʰ ɑ kʰ ɛ l
սայլակ	s ɑ j l ɑ k
սան	s ɑ n
սանսկրիտ	s ɑ n s k ɾ i t
սանրվածք	s ɑ n ə ɾ v ɑ t s kʰ
սաունա	s ɑ u n ɑ
սառը	s ɑ r ə
սառն	s ɑ r ə n
սառնարան	s ɑ r n ɑ ɾ ɑ n
սաստիկ	s ɑ s t i k
սատարել	s ɑ t ɑ ɾ ɛ l
սատուրն	s ɑ t u ɾ n
սար	s ɑ ɾ
սարգիս	s ɑ ɾ kʰ i s
սարգսյան	s ɑ ɾ kʰ ə s j ɑ n
սարդոստայն	s ɑ ɾ d ɔ s t ɑ j n
սարկավագ	s ɑ ɾ k ɑ v ɑ ɡ
սարոյան	s ɑ ɾ ɔ j ɑ n
սարսափ	s ɑ ɾ s ɑ pʰ
սարսափազդու	s ɑ ɾ s ɑ pʰ ɑ z d u
սարսափահար	s ɑ ɾ s ɑ pʰ ɑ h ɑ ɾ
սարսափելի	s ɑ ɾ s ɑ pʰ ɛ l i
սարսափեցում	s ɑ ɾ s ɑ pʰ ɛ t͡sʰ u m
սարսափեցուցիչ	s ɑ ɾ s ɑ pʰ ɛ t͡sʰ u t͡sʰ i t͡ʃʰ
սարսափում	s ɑ ɾ s ɑ pʰ u m
սարք	s ɑ ɾ kʰ
սարքավորում	s ɑ ɾ kʰ ɑ v ɔ ɾ u m
սարքել	s ɑ ɾ kʰ ɛ l
սաֆարյան	s ɑ f ɑ ɾ j ɑ n
սդ	s ə d ə
սեդա	s ɛ d ɑ
սեդրակ	s ɛ tʰ ɾ ɑ k
սեզոն	s ɛ z ɔ n
սեխ	s ɛ χ
սեղան	s ɛ ʁ ɑ n
սեմ	s ɛ m
սեյրան	s ɛ j ɾ ɑ n
սեն	s ɛ n
սենյակ	s ɛ n j ɑ k
սեպ	s ɛ p
սեռ	s ɛ r
սեռական	s ɛ r ɑ k ɑ n
սեր	s ɛ ɾ
սերգեյ	s ɛ ɾ ɡ ɛ j
սերժ	s ɛ ɾ ʒ
սերունդ	s ɛ ɾ u n d
սեւ	s ɛ v
սեւակ	s ɛ v ɑ k
սեւամորթ	s ɛ v ɑ m ɔ ɾ tʰ
սեփականություն	s ɛ pʰ ɑ k ɑ n u tʰ j u n
սիգ	s i ɡ
սիգարետ	s i ɡ ɑ ɾ ɛ t
սիմոն	s i m ɔ n
սիմոնյան	s i m ɔ n j ɑ n
սին	s i n
սինգապուր	s i ŋ ɡ ɑ p u ɾ
սիստեմ	s i s t ɛ m
սիրած	s i ɾ ɑ t͡s
սիրահար	s i ɾ ɑ h ɑ ɾ
սիրել	s i ɾ ɛ l
սիրելի	s i ɾ ɛ l i
սիրիա	s i ɾ j ɑ
սիրող	s i ɾ ɔ ʁ
սիրում	s i ɾ u m
սիրուն	s i ɾ u n
սիրտ	s i ɾ t
սիրտն	s i ɾ t n
սխալ	s ə χ ɑ l
սխտոր	s ə χ t ɔ ɾ
սկաներ	s k ɑ n ɛ ɾ
սկզբնաղբյուր	s k ə z b n ɑ χ p j u ɾ
սկզբունք	s k ə z b u n kʰ
սկզբունքայնություն	s k ə z b u ŋ kʰ ɑ j n u tʰ j u n
սմարթֆոն	s m ɑ ɾ tʰ f ɔ n
սմբատ	s ə m b ɑ t
սնանկացում	s ə n ɑ ŋ k ɑ t͡sʰ u m
սննդամթերք	s ə n ə n d ɑ m ə tʰ ɛ ɾ kʰ
սնունդ	s ə n u n d
սոխ	s ɔ χ
սոկրատես	s o k ɾ ɑ t ɛ s
սողուն	s o ʁ u n
սոնա	s ɔ n ɑ
սոուս	s ɔ u s
սոսինձ	s ɔ s i n d͡z
սոսկ	s ɔ s k
սով	s ɔ v
սովալլուկ	s ɔ v ɑ lː u k
սոված	s ɔ v ɑ t͡s
սովոր	s ɔ v ɔ ɾ
սովորաբար	s o v o ɾ ɑ b ɑ ɾ
սովորել	s ɔ v ɔ ɾ ɛ l
սովորեցնել	s ɔ v ɔ ɾ ɛ t͡sʰ n ɛ l
սովորություն	s ɔ v ɔ ɾ u tʰ j u n
սովորույթ	s o v o ɾ u j tʰ
սոցիալական	s ɔ t͡sʰ j ɑ l ɑ k ɑ n
սոցիալիզմ	s o t sʰ j ɑ l i z m
սոցիալիստական	s ɔ t͡sʰ j ɑ l i s t ɑ k ɑ n
սոցիոլոգիա	s o t sʰ j o l o ɡ j ɑ
սուգ	s u kʰ
սուլել	s u l ɛ l
սուլթան	s u l tʰ ɑ n
սույն	s u j n
սուշի	s u ʃ i
սուպերմարկետ	s u p ɛ ɾ m ɑ ɾ k ɛ t
սուտ	s u t
սուր	s u ɾ
սուրբ	s u ɾ pʰ
սուրճ	s u ɾ t͡ʃ
սոֆիա	s ɔ f i ɑ
սպանդանոց	s p ɑ n d ɑ n ɔ t͡sʰ
սպանել	s p ɑ n ɛ l
սպանվել	s p ɑ n v ɛ l
սպառազինության	s p ɑ r ɑ z i n u tʰ j ɑ n
սպառազինություն	s p ɑ r ɑ z i n u tʰ j u n
սպառազինությունների	s p ɑ r ɑ z i n u tʰ j u nː ɛ ɾ i
սպասք	s p ɑ s kʰ
սպարապետ	s p ɑ ɾ ɑ p ɛ t
սպը	s ə p ə ə
սպիտակամորթ	s p i t ɑ k ɑ m ɔ ɾ tʰ
ստադիոն	s t ɑ d i ɔ n
ստալին	s t ɑ l i n
ստատուս	s t ɑ t u s
ստել	s ə t ɛ l
ստեղնաշար	s t ɛ ʁ n ɑ ʃ ɑ ɾ
ստեփան	s t ɛ pʰ ɑ n
ստեփանակերտ	s t ɛ pʰ ɑ n ɑ k ɛ ɾ t
ստիպել	s t i p ɛ l
ստոկհոլմ	s t ɔ k h ɔ l m
ստորգետնյա	s t ɔ ɾ ɡ ɛ t n j ɑ
ստորին	s t o ɾ i n
ստուգել	s t u ɡ ɛ l
ստուգում	s t u ɡ u m
ստվեր	s t ə v ɛ ɾ
ստրիպտիզ	s t ɾ i p t i z
սրահ	s ə ɾ ɑ h
սրամտել	s ə ɾ ɑ m ə t ɛ l
սրանք	s ə ɾ ɑ ŋ kʰ
սրբազան	s ə ɾ pʰ ɑ z ɑ n
սրբուհի	s ə ɾ pʰ u h i
սրել	s ə ɾ ɛ l
սրընթաց	s ə ɾ ə n tʰ ɑ t͡sʰ
սրճարան	s ə ɾ t͡ʃ ɑ ɾ ɑ n
սրտային	s ə ɾ t ɑ j i n
սրտանց	s ə ɾ t ɑ n t͡sʰ
սցենար	s t͡sʰ ɛ n ɑ ɾ
սցենարիստ	s t͡sʰ ɛ n ɑ ɾ i s t
վագոն	v ɑ ɡ o n
վագր	v ɑ ɡ ə ɾ
վազգեն	v ɑ z ɡ ɛ n
վազել	v ɑ z ɛ l
վաթսուն	v ɑ t sʰ u n
վախ	v ɑ χ
վախենալ	v ɑ χ ɛ n ɑ l
վախեցած	v ɑ χ ɛ t͡sʰ ɑ t͡s
վախճան	v ɑ χ t͡ʃ ɑ n
վախճանվել	v ɑ χ t͡ʃ ɑ n v ɛ l
վահե	v ɑ h ɛ
վահրամ	v ɑ h ɾ ɑ m
վաղարշակ	v ɑ ʁ ɑ ɾ ʃ ɑ k
վաճառել	v ɑ t͡ʃ ɑ r ɛ l
վաճառք	v ɑ t͡ʃ ɑ r kʰ
վայելել	v ɑ j ɛ l ɛ l
վայելուչ	v ɑ j ɛ l u t͡ʃʰ
վայելք	v ɑ j ɛ l kʰ
վայր	v ɑ j ɾ
վայրենի	v ɑ j ɾ ɛ n i
վայրի	v ɑ j ɾ i
վայք	v ɑ ɪ̯ kʰ
վան	v ɑ n
վանական	v ɑ n ɑ k ɑ n
վանաձոր	v ɑ n ɑ d͡z ɔ ɾ
վանկարկում	v ɑ ŋ k ɑ ɾ k u m
վանո	v ɑ n ɔ
վանք	v ɑ ŋ kʰ
վաշինգտոն	v ɑ ʃ i ŋ ɡ t ɔ n
վառ	v ɑ r
վառել	v ɑ r ɛ l
վառելիք	v ɑ r ɛ l i kʰ
վասակ	v ɑ s ɑ k
վավերագրական	v ɑ v ɛ ɾ ɑ ɡ ə ɾ ɑ k ɑ n
վավերացում	v ɑ v ɛ ɾ ɑ t͡sʰ u m
վատ	v ɑ t
վատիկան	v ɑ t i k ɑ n
վարակ	v ɑ ɾ ɑ k
վարանում	v ɑ ɾ ɑ n u m
վարդագույն	v ɑ ɾ tʰ ɑ ɡ u j n
վարդանյան	v ɑ ɾ tʰ ɑ n j ɑ n
վարել	v ɑ ɾ ɛ l
վարժ	v ɑ ɾ ʒ
վարիչ	v ɑ ɾ i t͡ʃʰ
վարկած	v ɑ ɾ k ɑ t͡s
վարկանիշ	v ɑ ɾ k ɑ n i ʃ
վարունգ	v ɑ ɾ u ŋ ɡ
վարպետ	v ɑ ɾ p ɛ t
վարվել	v ɑ ɾ v ɛ l
վարք	v ɑ ɾ kʰ
վեհ	v ɛ h
վեճ	v ɛ t͡ʃ
վեմ	v ɛ m
վեպ	v ɛ p
վերադարձ	v ɛ ɾ ɑ d ɑ ɾ t͡sʰ
վերակառուցում	v ɛ ɾ ɑ k ɑ r u t͡sʰ u m
վերահաս	v ɛ ɾ ɑ h ɑ s
վերարտադրություն	v ɛ ɾ ɑ ɾ t ɑ d ɾ u t͡sʰ j u n
վերաքննիչ	v ɛ ɾ ɑ kʰ ə nː i t͡ʃʰ
վերելակ	v ɛ ɾ ɛ l ɑ k
վերլուծական	v ɛ ɾ l u t͡s ɑ k ɑ n
վերլուծել	v ɛ ɾ l u t͡s ɛ l
վերլուծություն	v ɛ ɾ l u t͡s u tʰ j u n
վերմուտ	v ɛ ɾ m u t
վերջ	v ɛ ɾ t͡ʃʰ
վերջաբան	v ɛ ɾ t͡ʃʰ ɑ b ɑ n
վերջակետ	v ɛ ɾ t͡ʃʰ ɑ k ɛ t
վերջապես	v ɛ ɾ t͡ʃʰ ɑ p ɛ s
վերջացնել	v ɛ ɾ t͡ʃʰ ɑ t͡sʰ n ɛ l
վերջերս	v ɛ ɾ t͡ʃʰ ɛ ɾ ə s
վերջի	v ɛ ɾ t͡ʃʰ i
վերջին	v ɛ ɾ t͡ʃʰ i n
վերջնագիր	v ɛ ɾ t͡ʃʰ n ɑ ɡ i ɾ
վերջնական	v ɛ ɾ t͡ʃʰ n ɑ k ɑ n
վերջնականորեն	v ɛ ɾ t͡ʃʰ n ɑ k ɑ n ɔ ɾ ɛ n
վերցնել	v ɛ ɾ t sʰ n ɛ l
վեց	v ɛ t sʰ
վեցերորդ	v ɛ t sʰ ɛ ɾ o ɾ tʰ
վիգեն	v i ɡ ɛ n
վիեննա	v i j ɛ nː ɑ
վիզա	v i z ɑ
վիճակ	v i t͡ʃ ɑ k
վիճակագրական	v i t͡ʃ ɑ k ɑ ɡ ɾ ɑ k ɑ n
վիճակագրություն	v i t͡ʃ ɑ k ɑ ɡ ɾ u tʰ j u n
վիճել	v i t͡ʃ ɛ l
վիշտ	v i ʃ t
վիրաբուժություն	v i ɾ ɑ b u ʒ u tʰ j u n
վիրակապ	v i ɾ ɑ k ɑ p
վիրուս	v i ɾ u s
վիքի	v i kʰ i
վլադիմիր	v l ɑ d i m i ɾ
վլադիվոստոկ	v l ɑ d i v o s t o k
վկա	v ə k ɑ
վկայական	v ə k ɑ j ɑ k ɑ n
վկայություն	v ə k ɑ j u t sʰ j u n
վճարել	v ə t͡ʃ ɑ ɾ ɛ l
վճիտ	v ə t͡ʃ i t
վճռել	v ə t͡ʃ r ɛ l
վնաս	v ə n ɑ s
վնասել	v ə n ɑ s ɛ l
վնասված	v ə n ɑ s v ɑ t͡s
վնասվածք	v ə n ɑ s v ɑ t͡s kʰ
վնասվել	v ə n ɑ s v ɛ l
վստահ	v ə s t ɑ h
վստահելի	v ə s t ɑ h ɛ l i
վտանգ	v ə t ɑ ŋ ɡ
վտանգավոր	v ə t ɑ ŋ ɡ ɑ v ɔ ɾ
վտանգել	v ə t ɑ ŋ ɡ ɛ l
վտանգում	v ə t ɑ ŋ ɡ u m
վրա	v ə ɾ ɑ
վրան	v ə ɾ ɑ n
վրաստան	v ə ɾ ɑ s t ɑ n
վրաց	v ə ɾ ɑ t͡sʰ
վրացական	v ə ɾ ɑ t sʰ ɑ k ɑ n
վրացերեն	v ə ɾ ɑ t͡sʰ ɛ ɾ ɛ n
վրացի	v ə ɾ ɑ t͡sʰ i
վրեժ	v ə ɾ ɛ ʒ
վրթանես	v ə ɾ tʰ ɑ n ɛ s
վրիպակ	v ə ɾ i p ɑ k
վրձին	v ə ɾ t͡sʰ i n
տագնապ	t ɑ ɡ n ɑ p
տալ	t ɑ l
տախտակ	t ɑ χ t ɑ k
տակ	t ɑ k
տաղանդ	t ɑ ʁ ɑ n d
տաճար	t ɑ t͡ʃ ɑ ɾ
տանել	t ɑ n ɛ l
տանը	t ɑ n ə
տանիք	t ɑ n i kʰ
տանձ	t ɑ n d͡z
տանջել	t ɑ n d ʒ ɛ l
տանտեր	t ɑ n t ɛ ɾ
տաշտ	t ɑ ʃ t
տապ	t ɑ p
տապալել	t ɑ p ɑ l ɛ l
տաջիկ	t ɑ d͡ʒ i k
տառապանք	t ɑ r ɑ p ɑ ŋ kʰ
տառապել	t ɑ r ɑ p ɛ l
տառատեսակ	t ɑ r ɑ t ɛ s ɑ k
տաս	t ɑ s
տասը	t ɑ s ə
տասնամյակ	t ɑ s n ɑ m j ɑ k
տասներկու	t ɑ s n e ɹ k u
տասնհինգ	t ɑ s n ə h i n ɡ
տասնմեկ	t ɑ s n ə m ɛ k
տասնչորս	t ɑ s n ə t ʃʰ o ɹ s
տավուշ	t ɑ v u ʃ
տատիկ	t ɑ t i k
տար	t ɑ ɾ
տարա	t ɑ ɾ ɑ
տարադրամի	t ɑ ɾ ɑ d ə ɾ ɑ m i
տարածել	t ɑ ɾ ɑ t s ɛ l
տարածություն	t ɑ ɾ ɑ t͡s u tʰ j u n
տարածված	t ɑ ɾ ɑ t͡s v ɑ t͡s
տարածք	t ɑ ɾ ɑ t͡s kʰ
տարատեսակ	t ɑ ɾ ɑ t ɛ s ɑ k
տարբեր	t ɑ ɾ b ɛ ɾ
տարբերակ	t ɑ ɾ b ɛ ɾ ɑ k
տարբերել	t ɑ ɾ b ɛ ɾ ɛ l
տարբերություն	t ɑ ɾ b ɛ ɾ u tʰ j u n
տարելից	t ɑ ɾ ɛ l i t͡sʰ
տարեց	t ɑ ɾ ɛ t͡sʰ
տարի	t ɑ ɾ i
տարկետում	t ɑ ɾ k ɛ t u m
տարվել	t ɑ ɾ v ɛ l
տարրական	t ɑ ɾ ɾ ɑ k ɑ n
տարօրինակ	t ɑ ɾ o ɾ i n ɑ k
տափակ	t ɑ pʰ ɑ k
տափաստանային	t ɑ pʰ ɑ s t ɑ n ɑ j i n
տաք	t ɑ kʰ
տգեղ	t ə ɡ ɛ ʁ
տգետ	t ə ɡ ɛ t
տեխնիկա	t ɛ χ n i k ɑ
տեխնոլոգիա	t ɛ χ n ɔ l ɔ ɡ j ɑ
տեխնոլոգիաներ	t ɛ χ n ɔ l ɔ ɡ j ɑ n ɛ ɾ
տեղադրում	t ɛ ʁ ɑ d ɾ u m
տեղակալ	t ɛ ʁ ɑ k ɑ l
տեղափոխել	t ɛ ʁ ɑ pʰ ɔ χ ɛ l
տեղեկանալ	t ɛ ʁ ɛ k ɑ n ɑ l
տեղեկատու	t ɛ ʁ ɛ k ɑ t u
տեղեկատվական	t ɛ ʁ ɛ k ɑ t v ɑ k ɑ n
տեղեկատվություն	t ɛ ʁ ɛ k ɑ t v u tʰ j u n
տեղեկացնել	t ɛ ʁ ɛ k ɑ t sʰ n ɛ l
տեղեկություն	t ɛ ʁ ɛ k u tʰ j u n
տեղի	t ɛ ʁ i
տեղյակ	t ɛ ʁ j ɑ k
տեսախցիկ	t ɛ s ɑ χ ə t͡sʰ i k
տեսակ	t ɛ s ɑ k
տեսական	t ɛ s ɑ k ɑ n
տեսահոլովակ	t ɛ s ɑ h ɔ l ɔ v ɑ k
տեսանյութ	t ɛ s ɑ n j u tʰ
տեսարան	t ɛ s ɑ ɾ ɑ n
տեսարժան	t ɛ s ɑ ɾ ʒ ɑ n
տեսնել	t ɛ s n ɛ l
տեսություն	t ɛ s u tʰ j u n
տեսուչ	t ɛ s u t͡ʃʰ
տեսք	t ɛ s kʰ
տեր	t ɛ ɾ
տերություն	t ɛ ɾ u t͡sʰ j u n
տեւել	t ɛ v ɛ l
տեքստ	t ɛ kʰ s t
տի	t i
տիբեր	t i b ɛ ɾ
տիկ	t i k
տիկին	t i k i n
տխուր	t ə χ u ɾ
տխրություն	t ə χ ɾ u t͡sʰ j u n
տկար	t ə k ɑ ɾ
տղա	t ə ʁ ɑ
տղամարդ	t ə ʁ ɑ m ɑ ɾ tʰ
տղամարդիկ	t ə ʁ ɑ m ɑ ɾ tʰ i k
տնակ	t ə n ɑ k
տնական	t ə n ɑ k ɑ n
տնային	t ə n ɑ j i n
տնտեսագետ	t ə n t ɛ s ɑ ɡ ɛ t
տնտեսագիտական	t ə n t ɛ s ɑ ɡ i t ɑ k ɑ n
տնտեսական	t ə n t ɛ s ɑ k ɑ n
տնտեսություն	t ə n t ɛ s u t͡sʰ j u n
տնօրեն	t ə n ɔ ɾ ɛ n
տոկոս	t ɔ k ɔ s
տող	t ɔ ʁ
տոն	t ɔ n
տոնածառ	t o n ɑ t s ɑ r
տոնել	t ɔ n ɛ l
տորթ	t ɔ ɾ tʰ
տուգանք	t u ɡ ɑ ŋ kʰ
տույժ	t u j ʒ
տուն	t u n
տուր	t u ɾ
տուրին	t u ɾ i n
տուրք	t u ɾ kʰ
տուփ	t u pʰ
տպագրություն	t ə p ɑ ɡ ɾ u tʰ j u n
տպավորիչ	t ə p ɑ v ɔ ɾ i t͡ʃʰ
տպավորված	t ə p ɑ v ɔ ɾ v ɑ t͡s
տպավորվել	t ə p ɑ v ɔ ɾ v ɛ l
տպարան	t ə p ɑ ɾ ɑ n
տվյալ	t ə v j ɑ l
տտ	t ə t ə
տրակտոր	t ɾ ɑ k t o ɾ
տրամաբանություն	t ɾ ɑ m ɑ b ɑ n u tʰ j u n
տրամադրել	t ɾ ɑ m ɑ d ɾ ɛ l
տրանսգենդեր	t ɾ ɑ n s ɡ ɛ n d ɛ ɾ
տրապիզոն	t ɾ ɑ p i z ɔ n
րոպե	ɾ ɔ p ɛ
ցած	t sʰ ɑ t s
ցածր	t͡sʰ ɑ t͡s ə ɾ
ցածրահասակ	t sʰ ɑ t s ɾ ɑ h ɑ s ɑ k
ցայգ	t͡sʰ ɑ j ɡ
ցանել	t͡sʰ ɑ n ɛ l
ցանկ	t͡sʰ ɑ ŋ k
ցանկանալ	t sʰ ɑ n k ɑ n ɑ l
ցանկություն	t͡sʰ ɑ ŋ k u tʰ j u n
ցանց	t͡sʰ ɑ n t͡sʰ
ցավ	t͡sʰ ɑ v
ցավակցություն	t͡sʰ ɑ v ɑ k t͡sʰ u tʰ j u n
ցավել	t͡sʰ ɑ v ɛ l
ցավոք	t sʰ ɑ v o kʰ
ցարական	t sʰ ɑ ɾ ɑ k ɑ n
ցեղասպանություն	t͡sʰ ɛ ʁ ɑ s p ɑ n u tʰ j u n
ցերեկ	t͡sʰ ɛ ɾ ɛ k
ցիկլոն	t sʰ i k l o n
ցխինվալ	t sʰ χ i n v ɑ l
ցնծալ	t sʰ ə n t s ɑ l
ցնծություն	t͡sʰ ə n t͡s u tʰ j u n
ցոլակ	t͡sʰ ɔ l ɑ k
ցորեն	t͡sʰ ɔ ɾ ɛ n
ցուրտ	t͡sʰ u ɾ t
ցուցակ	t͡sʰ u t͡sʰ ɑ k
ցուցակում	t͡sʰ u t͡sʰ ɑ k u m
ցուցահանդես	t͡sʰ u t͡sʰ ɑ h ɑ n d ɛ s
ցուցանակ	t͡sʰ u t͡sʰ ɑ n ɑ k
ցուցասրահ	t sʰ u t sʰ ɑ s ə ɾ ɑ h
ցուցարար	t͡sʰ u t͡sʰ ɑ ɾ ɑ ɾ
փաթեթավորում	pʰ ɑ tʰ ɛ tʰ ɑ v ɔ ɾ u m
փալաս	pʰ ɑ l ɑ s
փախստական	pʰ ɑ χ s t ɑ k ɑ n
փակ	pʰ ɑ k
փակել	pʰ ɑ k ɛ l
փամփուշտ	pʰ ɑ m pʰ u ʃ t
փայլ	pʰ ɑ j l
փայլակ	pʰ ɑ j l ɑ k
փայլատակել	pʰ ɑ j l ɑ t ɑ k ɛ l
փայլել	pʰ ɑ j l ɛ l
փայլում	pʰ ɑ j l u m
փայլուն	pʰ ɑ j l u n
փայտ	pʰ ɑ j t
փայտիկ	pʰ ɑ j t i k
փայտյա	pʰ ɑ j t j ɑ
փաշա	pʰ ɑ ʃ ɑ
փաշինյան	pʰ ɑ ʃ i n j ɑ n
փառահեղ	pʰ ɑ r ɑ h ɛ ʁ
փառասեր	pʰ ɑ r ɑ s ɛ ɾ
փառք	pʰ ɑ r kʰ
փաստաբան	pʰ ɑ s t ɑ b ɑ n
փաստացի	pʰ ɑ s t ɑ t͡sʰ i
փաստել	pʰ ɑ s t ɛ l
փաստորեն	pʰ ɑ s t o ɾ ɛ n
փարիզ	pʰ ɑ ɾ i z
փարիսեցիական	pʰ ɑ ɾ i s ɛ t͡sʰ j ɑ k ɑ n
փափազյան	pʰ ɑ pʰ ɑ z j ɑ n
փափուկ	pʰ ɑ pʰ u k
փեսա	pʰ ɛ s ɑ
փետրվարյան	pʰ ɛ t ə ɾ v ɑ ɾ j ɑ n
փերի	pʰ ɛ ɾ i
փիլիսոփա	pʰ i l i s ɔ pʰ ɑ
փղոսկր	pʰ ə ʁ ɔ s k ɾ
փնթի	pʰ ə n tʰ i
փնտրել	pʰ ə n t ɾ ɛ l
փշրել	pʰ ə ʃ ɾ ɛ l
փոթորիկ	pʰ ɔ tʰ ɔ ɾ i k
փոխ	pʰ o χ
փոխանակ	pʰ ɔ χ ɑ n ɑ k
փոխանակել	pʰ o χ ɑ n ɑ k ɛ l
փոխանցել	pʰ ɔ χ ɑ n t͡sʰ ɛ l
փոխարեն	pʰ o χ ɑ ɾ ɛ n
փոխարինում	pʰ o χ ɑ ɾ i n u m
փոխել	pʰ ɔ χ ɛ l
փոխնախարար	pʰ ɔ χ n ɑ χ ɑ ɾ ɑ ɾ
փոխվարչապետ	pʰ ɔ χ v ɑ ɾ t͡ʃʰ ɑ p ɛ t
փող	pʰ ɔ ʁ
փողոց	pʰ o ʁ o t sʰ
փոշի	pʰ o ʃ i
փոստային	pʰ ɔ s t ɑ j i n
փորձառություն	pʰ o ɾ t sʰ ɑ r u t sʰ j u n
փորձարկել	pʰ ɔ ɾ t͡sʰ ɑ ɾ k ɛ l
փորձարկում	pʰ ɔ ɾ t͡sʰ ɑ ɾ k u m
փորձել	pʰ ɔ ɾ t͡sʰ ɛ l
փուլ	pʰ u l
փուչ	pʰ u t͡ʃʰ
փուչիկ	pʰ u t ʃʰ i k
փոփոխություն	pʰ ɔ pʰ ɔ χ u tʰ j u n
փոքր	pʰ ɔ kʰ ə ɾ
փոքրիկ	pʰ ɔ kʰ ɾ i k
փչացած	pʰ ə t͡ʃʰ ɑ t͡sʰ ɑ t͡s
փչել	pʰ ə t͡ʃʰ ɛ l
փրկել	pʰ ə ɾ k ɛ l
քահանա	kʰ ɑ h ɑ n ɑ
քաղաք	kʰ ɑ ʁ ɑ kʰ
քաղաքագետ	kʰ ɑ ʁ ɑ kʰ ɑ ɡ ɛ t
քաղաքական	kʰ ɑ ʁ ɑ kʰ ɑ k ɑ n
քաղաքականություն	kʰ ɑ ʁ ɑ kʰ ɑ k ɑ n u tʰ j u n
քաղաքապետ	kʰ ɑ ʁ ɑ kʰ ɑ p ɛ t
քաղաքավարի	kʰ ɑ ʁ ɑ kʰ ɑ v ɑ ɾ i
քաղաքացի	kʰ ɑ ʁ ɑ kʰ ɑ t͡sʰ i
քաղաքացիական	kʰ ɑ ʁ ɑ kʰ ɑ t͡sʰ i j ɑ k ɑ n
քաղաքացիություն	kʰ ɑ ʁ ɑ kʰ ɑ t͡sʰ i u tʰ j u n
քաղբանտարկյալ	kʰ ɑ ʁ b ɑ n t ɑ ɾ k j ɑ l
քաղց	kʰ ɑ χ t͡sʰ
քաղցր	kʰ ɑ χ t͡sʰ ə ɾ
քաղցրահամ	kʰ ɑ χ t͡sʰ ɾ ɑ h ɑ m
քամի	kʰ ɑ m i
քայլ	kʰ ɑ j l
քայլերթ	kʰ ɑ j l ɛ ɾ tʰ
քան	kʰ ɑ n
քանակական	kʰ ɑ n ɑ k ɑ k ɑ n
քանակություն	kʰ ɑ n ɑ k u tʰ j u n
քանդակագործ	kʰ ɑ n d ɑ k ɑ ɡ ɔ ɾ t͡s
քանդել	kʰ ɑ n d ɛ l
քանզի	kʰ ɑ n z i
քանի	kʰ ɑ n i
քանիցս	kʰ ɑ n i t͡sʰ ə s
քաշել	kʰ ɑ ʃ ɛ l
քաոսային	kʰ ɑ o s ɑ j i n
քաջ	kʰ ɑ d͡ʒ
քաջալերել	kʰ ɑ d͡ʒ ɑ l ɛ ɾ ɛ l
քաջություն	kʰ ɑ d ʒ u t sʰ j u n
քառակուսի	kʰ ɑ r ɑ k u s i
քառասուն	kʰ ɑ r ɑ s u n
քառյակ	kʰ ɑ r j ɑ k
քառորդ	kʰ ɑ r ɔ ɾ tʰ
քավության	kʰ ɑ v u tʰ j ɑ n
քար	kʰ ɑ ɾ
քարանձավ	kʰ ɑ ɾ ɑ n d z ɑ v
քարոզել	kʰ ɑ ɾ o z ɛ l
քարոզչություն	kʰ ɑ ɾ ɔ z t͡ʃʰ u tʰ j u n
քարտ	kʰ ɑ ɾ t
քարտեզ	kʰ ɑ ɾ t ɛ z
քարտուղար	kʰ ɑ ɾ t u ʁ ɑ ɾ
քեռու	kʰ ɛ r u
քերականական	kʰ ɛ ɾ ɑ k ɑ n ɑ k ɑ n
քեֆ	kʰ ɛ f
քիմիա	kʰ i m j ɑ
քիմիական	kʰ i m j ɑ k ɑ n
քիմիապես	kʰ i m j ɑ p ɛ s
քիմմաքրում	kʰ i mː ɑ kʰ ɾ u m
քիչ	kʰ i t ʃʰ
քլինթոն	kʰ l i n tʰ o n
քնած	kʰ ə n ɑ t͡s
քնար	kʰ ə n ɑ ɾ
քննադատել	kʰ ə nː ɑ d ɑ t ɛ l
քննադատություն	kʰ ə nː ɑ d ɑ t u tʰ j u n
քննարկել	kʰ ə nː ɑ ɾ k ɛ l
քննարկում	kʰ ə nː ɑ ɾ k u m
քննարկվել	kʰ ə nː ɑ ɾ k v ɛ l
քննել	kʰ ə nː ɛ l
քշել	kʰ ə ʃ ɛ l
քո	kʰ o
քոչարյան	kʰ ɔ t͡ʃʰ ɑ ɾ j ɑ n
քոռ	kʰ ɔ r
քուրդ	kʰ u ɾ d
քոքոբելյան	kʰ ɔ kʰ ɔ b ɛ l j ɑ n
քսան	kʰ ə s ɑ n
քսել	kʰ ə s ɛ l
քսուք	kʰ ə s u kʰ
քվե	kʰ ə v ɛ
քվեարկել	kʰ ə v ɛ ɑ ɾ k ɛ l
քրիստոնյա	kʰ ɾ i s t ɔ n j ɑ
քրիստոս	kʰ ɾ i s t ɔ s
քրտնել	kʰ ə ɾ t n ɛ l
քրքրել	kʰ ə ɾ kʰ ə ɾ ɛ l
օբամա	ɔ b ɑ m ɑ
օբյեկտիվություն	ɔ b j ɛ k t i v u tʰ j u n
օգնական	ɔ kʰ n ɑ k ɑ n
օգնություն	ɔ kʰ n u tʰ j u n
օգտագործել	ɔ kʰ t ɑ ɡ ɔ ɾ t͡s ɛ l
օգտագործվել	ɔ kʰ t ɑ ɡ ɔ ɾ t͡s v ɛ l
օգտակար	ɔ kʰ t ɑ k ɑ ɾ
օգտատեր	ɔ kʰ t ɑ t ɛ ɾ
օդ	ɔ tʰ
օդային	o tʰ ɑ j i n
օդանավ	ɔ tʰ ɑ n ɑ v
օդանավակայան	ɔ tʰ ɑ n ɑ v ɑ k ɑ j ɑ n
օդաչու	ɔ tʰ ɑ t͡ʃʰ u
օդերեւութաբանական	o tʰ ɛ ɾ ɛ v u tʰ ɑ b ɑ n ɑ k ɑ n
օդորակիչ	ɔ tʰ ɔ ɾ ɑ k i t͡ʃʰ
օեկ	o j ɛ k
օժանդակ	o ʒ ɑ n d ɑ k
օծանելիք	o t s ɑ n ɛ l i kʰ
օհանյան	ɔ h ɑ n j ɑ n
օձ	ɔ t͡sʰ
օղի	ɔ ʁ i
օման	ɔ m ɑ n
օմար	ɔ m ɑ ɾ
օպերա	ɔ p ɛ ɾ ɑ
օպերային	o p ɛ ɾ ɑ j i n
օջախ	ɔ d͡ʒ ɑ χ
օս	ɔ s
օսլո	o s l o
օսկանյան	ɔ s k ɑ n j ɑ n
օսման	ɔ s m ɑ n
օսմանյան	ɔ s m ɑ n j ɑ n
օսմանցի	ɔ s m ɑ n t͡sʰ i
օտարագիր	ɔ t ɑ ɾ ɑ ɡ i ɾ
օր	ɔ ɾ
օրագիր	ɔ ɾ ɑ ɡ i ɾ
օրակարգ	ɔ ɾ ɑ k ɑ ɾ kʰ
օրգանիզմ	ɔ ɾ ɡ ɑ n i z m
օրենք	ɔ ɾ ɛ ŋ kʰ
օրենքով	ɔ ɾ ɛ ŋ kʰ ɔ v
օրինակ	ɔ ɾ i n ɑ k
օրիորդ	ɔ ɾ j ɔ ɾ tʰ
օրհնյալ	o ɾ h n j ɑ l
ֆակուլտետ	f ɑ k u l t ɛ t
ֆաշիստական	f ɑ ʃ i s t ɑ k ɑ n
ֆեյսբուք	f ɛ j s b u kʰ
ֆեյսբուքյան	f ɛ j s b u kʰ j ɑ n
ֆեյք	f ɛ j kʰ
ֆիզիկա	f i z i k ɑ
ֆիզիկական	f i z i k ɑ k ɑ n
ֆիզիկապես	f i z i k ɑ p ɛ s
ֆիզիկոս	f i z i k ɔ s
ֆիզիոլոգիական	f i z i ɔ l ɔ ɡ j ɑ k ɑ n
ֆիլիպ	f i l i p
ֆիլմ	f i l m
ֆինանսական	f i n ɑ n s ɑ k ɑ n
ֆինանսներ	f i n ɑ n s n ɛ ɾ
ֆինլանդիա	f i n l ɑ n d j ɑ
ֆլամենկո	f l ɑ m ɛ n k o
ֆոն	f ɔ n
ֆոտոխցիկ	f ɔ t ɔ χ ə t͡sʰ i k
ֆոտոն	f o t o n
ֆունտ	f u n t
ֆրանսերեն	f ɾ ɑ n s ɛ ɾ ɛ n
ֆրանսիա	f ə ɾ ɑ n s j ɑ
ֆրանսիացի	f ɾ ɑ n s j ɑ t͡sʰ i
