aadje	aː t j ə
aagje	aː x j ə
aai	aː i̯
aaibaarheidsfactor	aː i̯ b aː r ɦ ɛ i̯ t s f ɑ k t ɔ r
aalbessenstruik	aː l b ɛ s ə n s t r œ y̯ k
aalderik	aː l d ə r ɪ k
aaldert	aː l d ə r t
aalput	aː l p ʏ t
aalscholver	aː l s x ɔ l v ə r
aalt	aː l t
aalvork	aː l v ɔ r k
aambeeld	aː m b eː l t
aanbakken	aː n b ɑ k ə n
aanbetalen	aː n b ə t aː l ə n
aanbevelingscomité	aː n b ə v eː l ɪ ŋ s k ɔ m i t eː
aanbidden	aː m b ɪ d ə n
aanbieding	aː n b i d ɪ ŋ
aanblaffen	aː n b l ɑ f ə n
aanblazing	aː n b l aː z ɪ ŋ
aanblijven	aː m b l ɛ i̯ v ə n
aanblik	aː n b l ɪ k
aanbodbeleid	aː n b ɔ t b ə l ɛ i̯ t
aanbodelasticiteit	aː n b ɔ t eː l ɑ s t i s i t ɛ i̯ t
aanbouwen	aː m b ɑ u̯ ə n
aanbraken	aː m b r aː k ə n
aanbreke	aː m b r eː k ə
aanbrekend	aː m b r eː k ə n t
aanbrengpremie	aː n b r ɛ ŋ p r eː m i
aandacht	aː n d ɑ x t
aandachtigheid	aː n d ɑ x t ə x ɦ ɛ i̯ t
aandachtstrekker	aː n d ɑ x t s t r ɛ k ə r
aandachttrekker	aː n d ɑ x t r ɛ k ə r
aandeel	aː n d eː l
aandeelbewijs	aː n d eː l b ə ʋ ɛ i̯ s
aandelenbelegger	aː n d eː l ə n b ə l ɛ ɣ ə r
aandelenuitgifte	aː n d eː l ə n œ y̯ t x ɪ f t ə
aandenken	aː n d ɛ ŋ k ə n
aandrang	aː n d r ɑ ŋ
aandrentelen	aː n d r ɛ n t ə l ə n
aandribbelen	aː n d r ɪ b ə l ə n
aanduiding	aː n d œ y̯ d ɪ ŋ
aaneendraaien	aː n eː n d r aː i̯ ə n
aanfluiten	aː n f l œ y̯ t ə n
aangeefster	aː n ɣ eː f s t ə r
aangelegenheid	aː ŋ ɣ ə l eː ɣ ə n ɦ ɛ i̯ t
aangeschoten	aː n ɣ ə s x oː t ə n
aangezicht	aː n ɣ ə z ɪ x t
aanglijden	aː n ɣ l ɛ i̯ d ə n
aangrijpen	aː ŋ ɣ r ɛ i̯ p ə n
aangrijpende	aː ŋ ɣ r ɛ i̯ p ə n d ə
aanhalingsteken	aː n ɦ aː l ɪ ŋ s t eː k ə n
aanhelpen	aː n ɦ ɛ l p ə n
aanhijgen	aː n ɦ ɛ i̯ ɣ ə n
aanhoudelijk	aː n ɦ ɑ u̯ d ə l ə k
aankakken	aː n k ɑ k ə n
aankloppen	aː ŋ k l ɔ p ə n
aankwispelen	aː n k ʋ ɪ s p ə l ə n
aanlappen	aː n l ɑ p ə n
aanlonken	aː n l ɔ ŋ k ə n
aanmelden	aː m ɛ l d ə n
aanmeren	aː m eː r ə n
aanmoedigen	aː m u d ə ɣ ə n
aanmoediging	aː n m u d ə ɣ ɪ ŋ
aannaderen	aː n n aː d ə r ə n
aannemer	aː n eː m ə r
aanpakken	aː m p ɑ k ə n
aanraakscherm	aː n r aː k s x ɛ r m
aanrechtbank	aː n r ɛ x t b ɑ ŋ k
aanschaffen	aː n s x ɑ f ə n
aanscherpen	aː n s x ɛ r p ə n
aanschouwelijk	aː n s x ɑ u̯ ə l ə k
aanschouwend	aː n s x ɑ u̯ ʋ ə n t
aanschroeven	aː n s x r u v ə n
aansluiten	aː n s l œ y̯ t ə n
aansmelten	aː n s m ɛ l t ə n
aanspelden	aː n s p ɛ l d ə n
aanstekelijk	aː n s t eː k ə l ə k
aansteken	aː n s t eː k ə n
aanstoken	aː n s t oː k ə n
aanstonds	aː n s t ɔ n t s
aantokkelen	aː n t ɔ k ə l ə n
aantreden	aː n t r eː d ə n
aanvaarden	aː n v aː r d ə n
aanvaarding	aː n v aː r d ɪ ŋ
aanvallig	aː n v ɑ l ə x
aanvangen	aː n v ɑ ŋ ə n
aanvankelijk	aː n v ɑ ŋ k ə l ə k
aanvechten	aː n v ɛ x t ə n
aanvliegen	aː n v l i ɣ ə n
aanvoer	aː n v uː r
aanvoeren	aː n v uː r ə n
aanvraag	aː n v r aː x
aanvuren	aː n v yː r ə n
aanwakkeren	aː n ʋ ɑ k ə r ə n
aanwezig	aː n ʋ eː z ə x
aanwezige	aː n ʋ eː z ə ɣ ə
aanwijzing	aː n ʋ ɛ i z ɪ ŋ
aanwortelen	aː n ʋ ɔ r t ə l ə n
aanzien	aː n z i n
aanzouten	aː n z ɑ u̯ t ə n
aapmens	aː p m ɛ n s
aardbeving	aː r t b eː v ɪ ŋ
aardbodem	aː r t b oː d ə m
aarde	aː r d ə
aardig	aː r d ə x
aardkunde	aː r t k ʏ n d ə
aardoppervlak	aː r t ɔ p ə r v l ɑ k
aardrijksbeschrijving	aː r t r ɛ i̯ k s b ə s x r ɛ i̯ v ɪ ŋ
aarnout	aː r n ɑ u̯ t
aars	aː r s
aarsmade	aː r s m aː d ə
aarzeling	aː r z ə l ɪ ŋ
aasvretend	aː s f r eː t ə n t
abbatiaal	ɑ b aː t ʃ aː l
abces	ɑ p s ɛ s
abchazisch	ɑ p x aː z i s
abortorium	aː b ɔ r t oː r i ʏ m
abrikoos	aː b r i k oː s
accentueren	ɑ k s ɛ n t y eː r ə n
accessie	ɑ k s ɛ s i
achtbaan	ɑ x t b aː n
achteloosheid	ɑ x t ə l oː s ɦ ɛ i̯ t
achten	ɑ x t ə n
achtentachtig	ɑ x t ə n t ɑ x t ə x
achteraan	ɑ x t ə r aː n
achterdenken	ɑ x t ə r d ɛ ŋ k ə n
achterin	ɑ x t ə r ɪ n
achterkamertjespolitiek	ɑ x t ə r k aː m ə r t j ə s p oː l i t i k
achterleen	ɑ x t ə r l eː n
achterna	ɑ x t ə r n aː
achternaam	ɑ x t ə r n aː m
achterpoort	ɑ x t ə r p oː r t
achterruitenwisser	ɑ x t ə r r œ y̯ t ə n ʋ ɪ s ə r
achterste	ɑ x t ə r s t ə
achtkantmolen	ɑ x t k ɑ n t m oː l ə n
achtmotorig	ɑ x t m oː t oː r ə x
achttiende	ɑ x t i n d ə
achtvoudig	ɑ x t f ɑ u̯ d ə x
acoliet	aː k oː l i t
acrobaat	ɑ k r oː b aː t
acryl	ɑ k r i l
actinium	ɑ k t i n i ʏ m
activistisch	ɑ k t i v ɪ s t i s
adderbeet	ɑ d ə r b eː t
addictie	ɑ d ɪ k s i
adellijk	aː d ə l ə k
ademtocht	aː d ə m t ɔ x t
adequaat	aː d ə k ʋ aː t
aderlaten	aː d ə r l aː t ə n
aderrijk	aː d ə r r ɛ i̯ k
admiraliteit	ɑ t m i r aː l i t ɛ i̯ t
adolescentie	aː d oː l ə s ɛ n t s i
adoptief	aː d ɔ p t i f
adri	aː d r i
adventskalender	ɑ t f ɛ n t s k aː l ɛ n d ə r
advies	ɑ t f i s
advocatuur	ɑ t f oː k aː t yː r
afbakbrood	ɑ f b ɑ k b r oː t
afbakening	ɑ f b aː k ə n ɪ ŋ
afbeitelen	ɑ f b ɛ i̯ t ə l ə n
afbellen	ɑ f b ɛ l ə n
afbetalen	ɑ f b ə t aː l ə n
afbottelen	ɑ f b ɔ t ə l ə n
afbouwen	ɑ f b ɑ u̯ ə n
afdalen	ɑ f d aː l ə n
afdijken	ɑ f d ɛ i̯ k ə n
afdragen	ɑ f d r aː ɣ ə n
afdrijving	ɑ f d r ɛ i̯ v ɪ ŋ
afdrukte	ɑ v d r ʏ k t ə
afdrukvoorbeeld	ɑ f d r ʏ k f oː r b eː l t
afgave	ɑ f x aː v ə
afgeleide	ɑ f x ə l ɛ i̯ d ə
afgevaardigde	ɑ f x ə v aː r d ə x d ə
afgodes	ɑ f x oː d ɛ s
afgodsslang	ɑ f x ɔ t s l ɑ ŋ
afhalen	ɑ f ɦ aː l ə n
afhankelijkere	ɑ f ɦ ɑ ŋ k ə l ə k ə r
afhuren	ɑ f ɦ yː r ə n
afjagen	ɑ f j aː ɣ ə n
afknauwen	ɑ f k n ɑ u̯ ə n
afko	ɑ f k oː
afkocht	ɑ f k ɔ x t
afkope	ɑ f k oː p ə
afkorten	ɑ f k ɔ r t ə n
afkraken	ɑ f k r aː k ə n
afmergelen	ɑ f m ɛ r ɣ ə l ə n
afmeting	ɑ f m eː t ɪ ŋ
afmikken	ɑ f m ɪ k ə n
afnaaien	ɑ f n aː i̯ ə n
afpakken	ɑ f p ɑ k ə n
afplatten	ɑ f p l ɑ t ə n
afraspen	ɑ f r ɑ s p ə n
afrijten	ɑ f r ɛ i̯ t ə n
afritsbroek	ɑ f r ɪ t s b r u k
afro	aː f r oː
afschaffen	ɑ f s x ɑ f ə n
afscheren	ɑ f s x eː r ə n
afscherming	ɑ f s x ɛ r m ɪ ŋ
afsluiter	ɑ f s l œ y̯ t ə r
afspeellijst	ɑ f s p eː l ɛ i̯ s t
afspoelen	ɑ f s p u l ə n
afstammen	ɑ f s t ɑ m ə n
afstamming	ɑ f s t ɑ m ɪ ŋ
afstandelijk	ɑ f s t ɑ n d ə l ə k
afstellen	ɑ f s t ɛ l ə n
aft	ɑ f t
afte	ɑ f t ə
aftroggelen	ɑ f t r ɔ ɣ ə l ə n
afvinken	ɑ f ɪ ŋ k ə n
afwendbaar	ɑ f ʋ ɛ n t b aː r
afwennen	ɑ f ʋ ɛ n ə n
afweren	ɑ f ʋ eː r ə n
afwezig	ɑ f ʋ eː z ə x
afwisseling	ɑ f ʋ ɪ s ə l ɪ ŋ
afwoekeren	ɑ f ʋ u k ə r ə n
afzegging	ɑ f s ɛ ɣ ɪ ŋ
afzetmarkt	ɑ f z ɛ t m ɑ r k t
afzettingsgesteente	ɑ f s ɛ t ɪ ŋ s x ə s t eː n t ə
afzinkbaar	ɑ f s ɪ ŋ k b aː r
agatha	aː ɣ aː t aː
agendaatje	ɑ ɣ ɛ n d aː t j ə
agente	aː ɣ ɛ n t ə
agglomeratie	ɑ ɣ l oː m ə r aː t s i
agitator	aː ɣ i t aː t ɔ r
agogiek	aː ɣ oː ɣ i k
aids	eː t s
aju	aː j y
ajuinachtig	aː j œ y̯ n ɑ x t ə x
akkadisch	ɑ k aː d i s
akkefietje	ɑ k ə f i t j ə
aktetas	ɑ k t ə t ɑ s
alarmeren	aː l ɑ r m eː r ə n
alarmsignaal	ɑ l ɑ r m s ɪ n j aː l
albanees	ɑ l b aː n eː s
albedil	ɑ l b ə d ɪ l
alcoholisch	ɑ l k oː ɦ oː l i s
alcoholtest	ɑ l k oː ɦ ɔ l t ɛ s t
alfons	ɑ l f ɔ n s
algerijns	ɑ l ɣ ə r ɛ i̯ n s
alhoewel	ɑ l ɦ u ʋ ɛ l
alida	aː l i d aː
alkaan	ɑ l k aː n
allang	ɑ l ɑ ŋ
alleraardigst	ɑ l ə r aː r d ə x s t
allerhande	ɑ l ə r ɦ ɑ n d ə
allerminst	ɑ l ə r m ɪ n s t
allerzielen	ɑ l ə r z i l ə n
alligator	ɑ l i ɣ aː t ɔ r
allooi	ɑ l oː i̯
alomtegenwoordigheid	ɑ l ɔ m t eː ɣ ə n ʋ oː r d ə x ɦ ɛ i̯ t
alpengloed	ɑ l p ə n ɣ l u t
alsmede	ɑ l s m eː d ə
alternatieveling	ɑ l t ə r n aː t i v ə l ɪ ŋ
alternativo	ɑ l t ə r n aː t i v oː
amalekiet	aː m aː l ɛ k i t
amandel	aː m ɑ n d ə l
ambacht	ɑ m b ɑ x t
ambachtelijk	ɑ m b ɑ x t ə l ə k
amber	ɑ m b ə r
ambitie	ɑ m b i t s i
ambteloos	ɑ m p t ə l oː s
ambulance	ɑ m b y l ɑ n s ə
amfoor	ɑ m f oː r
aminozuur	aː m i n oː z yː r
ammoniak	ɑ m oː n i ɑ k
amoebedysenterie	aː m øː b ə d i s ɛ n t ə r i
amorf	aː m ɔ r f
amyotrofisch	aː m i oː t r oː f i s
analfabeet	ɑ n ɑ l f aː b eː t
analist	aː n aː l ɪ s t
analoog	aː n aː l oː x
analytisch	aː n aː l i t i s s
ananas	ɑ n aː n ɑ s
anapest	aː n aː p ɛ s t
anarchistisch	ɑ n ɑ r x ɪ s t i s
anatolië	aː n aː t oː l i ə
anderszins	ɑ n d ə r s ɪ n s
andijvie	ɑ n d ɛ i̯ v i
andré	ɑ n d r eː
anesthesie	ɑ n ɛ s t eː z i
angina	ɑ ŋ ɣ i n aː
anglicaan	ɑ ŋ ɣ l i k aː n
angsthaas	ɑ ŋ s t ɦ aː s
anijs	aː n ɛ i̯ s
animo	aː n i m oː
anjer	ɑ n j ə r
ankerplaats	ɑ ŋ k ə r p l aː t s
anode	aː n oː d ə
anomalie	aː n oː m aː l i
antecedentjes	ɑ n t ə s ə d ɛ n t j ə s
antedateren	ɑ n t ə d aː t eː r ə n
antependium	ɑ n t ə p ɛ n d i ʏ m
antiheldin	ɑ n t i ɦ ɛ l d ɪ n
antimonium	ɑ n t i m oː n i ʏ m
antimoon	ɑ n t i m oː n
antisemiet	ɑ n t i s eː m i t
antithese	ɑ n t i t eː z ə
antraxbrief	ɑ n t r ɑ k s b r i f
antropologie	ɑ n t r oː p oː l oː ɣ i
antwerpenaar	ɑ n t ʋ ɛ r p ə n aː r
apenarend	aː p ə n aː r ə n t
apennijnen	aː p ə n ɛ i̯ n ə n
apennoot	aː p ə n oː t
apenstaart	aː p ə n s t aː r t
apin	aː p ɪ n
apostolaat	aː p ɔ s t oː l aː t
apostolisch	aː p ɔ s t oː l i s
apotheek	ɑ p oː t eː k
apotheose	aː p oː t eː oː z ə
apparaat	ɑ p aː r aː t
appartement	ɑ p ɑ r t ə m ɛ n t
appelmans	ɑ p ə l m ɑ n s
appelpunt	ɑ p ə l p ʏ n t
appelschel	ɑ p ə l s x ɛ l
appeltaart	ɑ p ə l t aː r t
appelwijn	ɑ p ə l ʋ ɛ i̯ n
appositie	ɑ p oː z i t s i
aquatisch	aː k ʋ aː t i s
arabisch	ɑ r aː b i s
arabië	aː r aː b i ə
arachnofauna	aː r ɑ x n oː f ɑ u̯ n aː
arbeid	ɑ r b ɛ i̯ t
arbeidskracht	ɑ r b ɛ i̯ t s k r ɑ x t
arbeidster	ɑ r b ɛ i̯ t s t ə r
arcadehal	ɑ r k aː d ə ɦ ɑ l
archeologie	ɑ r x eː j oː l oː ɣ i
architectuur	ɑ r x i t ɛ k t y r
arduinsteen	ɑ r d œ y̯ n s t eː n
armando	ɑ r m ɑ n d oː
armleuning	ɑ r m l øː n ɪ ŋ
armoediglijk	ɑ r m u d ə x l ə k
arnout	ɑ r n ɑ u̯ t
aroma	aː r oː m aː
arrenslede	ɑ r ə n s l eː d ə
arresteren	ɑ r ɛ s t eː r ə n
arrogantie	ɑ r oː ɣ ɑ n t s i
arrè	ɑ r ɛː
artiestennaam	ɑ r t i s t ə n aː m
artikel	ɑ r t i k ə l
artikelsgewijs	ɑ r t i k ə l s x ə ʋ ɛ i̯ s
artse	ɑ r t s ə
as	ɑ s
ascese	ɑ s eː z ə
ascetisme	ɑ s eː t ɪ s m ə
aseksueel	aː s ɛ k s y eː l
asielzoekerscentrum	aː z i l z u k ə r s ɛ n t r ʏ m
asla	ɑ s l aː
aspect	ɑ s p ɛ k t
aspirine	ɑ s p i r i n ə
aspisslang	ɑ s p ɪ s l ɑ ŋ
assam	ɑ s ɑ m
assamees	ɑ s ɑ m eː s
assassijn	ɑ s ɑ s ɛ i̯ n
assen	ɑ s ə n
assimilatie	ɑ s i m i l aː t s i
assistente	ɑ s i s t ɛ n t ə
assisteren	ɑ s i s t eː r ə n
astrant	ɑ s t r ɑ n t
astrid	ɑ s t r ɪ t
astronaut	ɑ s t r oː n ɑ u̯ t
aten	aː t ə n
atheneum	ɑ t ə n eː ʏ m
atlantisch	ɑ t l ɑ n t i s
atol	aː t ɔ l
atoombom	aː t oː m b ɔ m
atoommodel	aː t oː m oː d ɛ l
atoomnummer	ɑ t oː m n ʏ m ə r
atoomtheorie	aː t oː m t eː oː r i
atoomtijdperk	aː t oː m t ɛ i t p ɛ r k
atten	ɑ t ə n
attractie	ɑ t r ɑ k s i
auerhaan	ɑ u̯ ə r ɦ aː n
autoloos	ɑ u̯ t oː l oː s
automatisch	ɑ u̯ t oː m aː t i s
automatisering	ɑ u̯ t oː m aː t i z eː r ɪ ŋ
avegaar	aː v ə ɣ aː r
avg	aː v eː ɣ eː
avitaminose	aː v i t aː m i n oː z ə
avondschemer	aː v ɔ n t s x eː m ə r
avondstond	aː v ɔ n t s t ɔ n t
aziaten	aː z i j aː t ə n
azijnaal	aː z ɛ i̯ n aː l
azië	aː z i j ə
azn	aː z ɛ t ɛ n
baaierd	b aː i̯ ə r t
baan	b aː n
baardaap	b aː r t aː p
baardig	b aː r d ə x
baardigheid	b aː r d ə x ɦ ɛ i̯ t
baardloos	b aː r t l oː s
baarkleed	b aː r k l eː t
baars	b aː r s
baat	b aː t
babbelkous	b ɑ b ə l k ɑ u̯ s
baboe	b aː b u
baby	b eː b i
babyboom	b eː b i b uː m
babypoeder	b eː b i p u d ə r
backslash	b ɛ k s l ɛ ʃ
bacterie	b ɑ k t eː r i
bacteriën	b ɑ k t eː r i ə n
badjuf	b ɑ t j ʏ f
badjuffrouw	b ɑ t j ʏ f r ɑ u̯
badmeester	b ɑ t m eː s t ə r
bakbanaan	b ɑ k b aː n aː n
bakboord	b ɑ k b oː r t
baker	b aː k ə r
bakeren	b aː k ə r ə n
bakplaat	b ɑ k p l aː t
bakvis	b ɑ k f ɪ s
balanceren	b aː l ɑ n s eː r ə n
baleinwalvis	b aː l ɛ i̯ n ʋ ɑ l v ɪ s
baljuw	b ɑ l j y u̯
balken	b ɑ l k ə n
bamboesriet	b ɑ m b u s r i t
bandeloos	b ɑ n d ə l oː s
banen	b aː n ə n
banjo	b ɑ n j oː
bank	b ɑ ŋ k
bankbreuk	b ɑ ŋ k b r øː k
bankensector	b ɑ ŋ k ə n s ɛ k t ɔ r
banketspijs	b ɑ ŋ k ɛ t s p ɛ i̯ s
bankoverval	b ɑ ŋ k oː v ə r v ɑ l
bannissement	b ɑ n ɪ s ə m ɛ n t
baptist	b ɑ p t ɪ s t
barbecue	b ɑ r b ə k j u
baret	b aː r ɛ t
barg	b ɑ r x
bariet	b aː r i t
barkas	b ɑ r k ɑ s
barkruk	b ɑ r k r ʏ k
barmhartig	b ɑ r m ɦ ɑ r t ə x
barneveld	b ɑ r n ə v ɛ l t
barrevoets	b ɑ r ə v u t s
barricade	b ɑ r i k aː d ə
barricaderen	b ɑ r i k aː d eː r ə n
barvoets	b ɑ r v u t s
basaal	b aː z aː l
basalten	b aː z ɑ l t ə n
baskisch	b ɑ s k i s
basson	b ɑ s ɔ n
bastaardarend	b ɑ s t aː r t aː r ə n t
bataafs	b aː t aː f s
bavarois	b aː v aː r ʋ aː
bazin	b aː z ɪ n
bazooka	b aː z u k aː
beademing	b ə aː d ə m ɪ ŋ
beantwoorden	b ə ɑ n t ʋ oː r d ə n
beatrijs	b eː aː t r ɛ i̯ s
beauty	b j uː t i
bebossen	b ə b ɔ s ə n
bebroeden	b ə b r u d ə n
bedankte	b ə d ɑ ŋ k t ə
beddegoed	b ɛ d ə ɣ u t
bede	b eː d ə
bededag	b eː d ə d ɑ x
bedeesd	b ə d eː s t
bederfzwam	b ə d ɛ r f s ʋ ɑ m
bedevaartsoord	b eː d ə v aː r t s oː r t
bedied	b ə d i t
bedienen	b ə d i n ə n
bediening	b ə d i n ɪ ŋ
bedieningspaneel	b ə d i n ɪ ŋ s p aː n eː l
bedierf	b ə d i r f
bedilziek	b ə d ɪ l z i k
bedingen	b ə d ɪ ŋ ə n
bedleger	b ɛ t l eː ɣ ə r
bedoelen	b ə d u l ə n
bedoeïen	b eː d u i n
bedonderen	b ə d ɔ n d ə r ə n
bedopen	b ə d oː p ə n
bedrag	b ə d r ɑ x
bedreigen	b ə d r ɛ i̯ ɣ ə n
bedriegster	b ə d r i x s t ə r
beduidsel	b ə d œ y̯ t s ə l
beduimelen	b ə d œ y̯ m ə l ə n
bedvriend	b ɛ t f r i n t
beeldschrift	b eː l t s x r ɪ f t
been	b eː n
beenderhuis	b eː n d ə r ɦ œ y̯ s
beenpijp	b eː n p ɛ i̯ p
beenvlies	b eː n v l i s
beetwortel	b eː t ʋ ɔ r t ə l
begaan	b ə ɣ aː n
begeleiding	b ə ɣ ə l ɛ i̯ d ɪ ŋ
begin	b ə ɣ ɪ n
beginletter	b ə ɣ ɪ n l ɛ t ə r
beginner	b ə ɣ ɪ n ə r
beginnerscursus	b ə ɣ ɪ n ə r s k ʏ r z ʏ s
begint	b ə ɣ ɪ n t
begonne	b ə ɣ ɔ n ə
begoocheling	b ə ɣ oː x ə l ɪ ŋ
begrafenis	b ə ɣ r aː f ə n ɪ s
begrippenkader	b ə ɣ r ɪ p ə n k aː d ə r
begroeien	b ə ɣ r u i̯ ə n
begroeiing	b ə ɣ r u j ɪ ŋ
begroeten	b ə ɣ r u t ə n
begrotingskort	b ə ɣ r oː t ɪ ŋ s k ɔ r t
behang	b ə ɦ ɑ ŋ
behangselpapier	b ə ɦ ɑ ŋ s ə l p aː p iː r
beheerbaar	b ə ɦ eː r b aː r
behelzen	b ə ɦ ɛ l z ə n
beheren	b ə ɦ eː r ə n
behinderd	b ə ɦ ɪ n d ə r t
behoeder	b ə ɦ u d ə r
behoeftig	b ə ɦ u f t ə x
behoorlijk	b ə ɦ oː r l ə k
behoudens	b ə ɦ ɑ u̯ d ə n s
behuwdvader	b ə ɦ y u̯ t f aː d ə r
bejaarde	b ə j aː r d ə
bejaardenhuis	b ə j aː r d ə n ɦ œ y̯ s
bekant	b ə k ɑ n t
bekennen	b ə k ɛ n ə n
bekering	b ə k eː r ɪ ŋ
bekertoernooi	b eː k ə r t u r n oː i̯
bekeuring	b ə k øː r ɪ ŋ
bekijken	b ə k ɛ i̯ k ə n
bekkentrekken	b ɛ k ə n t r ɛ k ə n
beklemmen	b ə k l ɛ m ə n
bekokstoven	b ə k ɔ k s t oː v ə n
bekransen	b ə k r ɑ n s ə n
belagen	b ə l aː ɣ ə n
belager	b ə l aː ɣ ə r
belanden	b ə l ɑ n d ə n
belastingaangifte	b ə l ɑ s t ɪ ŋ aː n ɣ ɪ f t ə
belastinginner	b ə l ɑ s t ɪ ŋ ɪ n ə r
belastingovereenkomst	b ə l ɑ s t ɪ ŋ oː v ə r eː n k ɔ m s t
belebberen	b ə l ɛ b ə r ə n
belediging	b ə l eː d ə ɣ ɪ ŋ
belegeren	b ə l eː ɣ ə r ə n
beleid	b ə l ɛ i̯ t
belemmering	b ə l ɛ m ə r ɪ ŋ
belfort	b ɛ l f ɔ r t
belgisch	b ɛ l ɣ i s
belijder	b ə l ɛ i̯ d ə r
belopen	b ə l oː p ə n
belt	b ɛ l t
bemanning	b ə m ɑ n ɪ ŋ
bemiddelaar	b ə m ɪ d ə l aː r
bemoeilijken	b ə m u j l ə k ə n
bemoeizucht	b ə m u i̯ z ʏ x t
benaderen	b ə n aː d ə r ə n
benedenbuur	b ə n eː d ə n b yː r
benedenstad	b ə n eː d ə n s t ɑ t
benedictijn	b eː n ə d ɪ k t ɛ i̯ n
benen	b eː n ə n
bengelen	b ɛ ŋ ə l ə n
benieuwd	b ə n i u̯ t
benig	b eː n ə x
benin	b eː n i n
benoemen	b ə n u m ə n
beoosten	b ə oː s t ə n
bepaling	b ə p aː l ɪ ŋ
beplakken	b ə p l ɑ k ə n
berd	b ɛ r t
berechten	b ə r ɛ x t ə n
bereidheid	b ə r ɛ i̯ t ɦ ɛ i̯ t
bereikbaar	b ə r ɛ i̯ k b aː r
bereiken	b ə r ɛ i̯ k ə n
berenleider	b eː r ə n l ɛ i̯ d ə r
bergachtig	b ɛ r x ɑ x t ə x
bergamotboom	b ɛ r ɣ aː m ɔ t b oː m
bergen	b ɛ r ɣ ə n
berghoen	b ɛ r x ɦ u n
bergketen	b ɛ r x k eː t ə n
bergvrede	b ɛ r x f r eː d ə
bergweide	b ɛ r x ʋ ɛ i̯ d ə
berkoen	b ɛ r k u n
berliner	b ɛ r l i n ə r
beroeren	b ə r u r ə n
beroerte	b ə r uː r t ə
berusten	b ə r ʏ s t ə n
beryllium	b eː r i l i ʏ m
beschaamd	b ə s x aː m t
beschamen	b ə s x aː m ə n
bescheid	b ə s x ɛ i̯ t
bescherming	b ə s x ɛ r m ɪ ŋ
beschermster	b ə s x ɛ r m s t ə r
beschikbaar	b ə s x ɪ k b aː r
beschilderd	b ə s x ɪ l d ə r t
beschimping	b ə s x ɪ m p ɪ ŋ
beschonken	b ə s x ɔ ŋ k ə n
beschoren	b ə s x oː r ə n
beschroomd	b ə s x r oː m t
beslapen	b ə s l aː p ə n
besparing	b ə s p aː r ɪ ŋ
bespeuren	b ə s p øː r ə n
bespiegelen	b ə s p i ɣ ə l ə n
bespioneren	b ə s p i oː n eː r ə n
bespringen	b ə s p r ɪ ŋ ə n
bestand	b ə s t ɑ n t
besteden	b ə s t eː d ə n
bestelen	b ə s t eː l ə n
bestemoer	b ɛ s t ə m uː r
bestendig	b ə s t ɛ n d ə x
bestieren	b ə s t iː r ə n
bestormen	b ə s t ɔ r m ə n
bestraten	b ə s t r aː t ə n
bestrijding	b ə s t r ɛ i̯ d ɪ ŋ
besturing	b ə s t yː r ɪ ŋ
bestuur	b ə s t yː r
betaalbaar	b ə t aː l b aː r
betaalmiddel	b ə t aː l m ɪ d ə l
betaalmuur	b ə t aː l m yː r
betekenend	b ə t eː k ə n ə n t
betekenisloos	b ə t eː k ə n ɪ s l oː s
betoging	b ə t oː ɣ ɪ ŋ
betonneren	b ə t ɔ n eː r ə n
betoverend	b ə t oː v ə r ə n t
betrachten	b ə t r ɑ x t ə n
betrappen	b ə t r ɑ p ə n
betrouwbaar	b ə t r ɑ u̯ b aː r
betrouwbaarheidsinterval	b ə t r ɑ u̯ b aː r ɦ ɛ i̯ t s ɪ n t ə r v ɑ l
betuiging	b ə t œ y̯ ɣ ɪ ŋ
betwisten	b ə t ʋ ɪ s t ə n
beu	b øː
beug	b øː x
beugeltas	b øː ɣ ə l t ɑ s
beuger	b øː ɣ ə r
beukenboom	b øː k ə n b oː m
beukseks	b øː k s ɛ k s
beulin	b øː l ɪ n
beunhaas	b øː n ɦ aː s
beuningen	b øː n ɪ ŋ ə n
beuren	b øː r ə n
beurtbalk	b øː r t b ɑ l k
beurtbalkje	b øː r t b ɑ l k j ə
beurtschip	b øː r t s x ɪ p
bevallig	b ə v ɑ l ə x
bevattelijk	b ə v ɑ t ə l ə k
beveiliger	b ə v ɛ i̯ l ə ɣ ə r
bevekom	b eː v ə k ɔ m
bevel	b ə v ɛ l
beverrat	b eː v ə r ɑ t
bevestigen	b ə v ɛ s t ə ɣ ə n
bevindingen	b ə v ɪ n d ɪ ŋ ə n
bevoegd	b ə v u x t
bevoegdheid	b ə v u x t ɦ ɛ i̯ t
bevoelen	b ə v u l ə n
bevragen	b ə v r aː ɣ ə n
bevreemding	b ə v r eː m d ɪ ŋ
bevriezen	b ə v r i z ə n
bevrijding	b ə v r ɛ i̯ d ɪ ŋ
bevrijdingsdag	b ə v r ɛ i̯ d ɪ ŋ s d ɑ x
bevrouwen	b ə v r ɑ u̯ ə n
bewering	b ə ʋ eː r ɪ ŋ
bewerpen	b ə ʋ ɛ r p ə n
bewonderen	b ə ʋ ɔ n d ə r ə n
bewonderenswaardig	b ə ʋ ɔ n d ə r ə n s ʋ aː r d ə x
bewoning	b ə ʋ oː n ɪ ŋ
bewoonbaar	b ə ʋ oː n b aː r
bewustmaken	b ə ʋ ʏ s t m aː k ə n
bezanding	b ə z ɑ n d ɪ ŋ
bezant	b ə z ɑ n t
bezatten	b ə z ɑ t ə n
bezeerd	b ə z eː r t
bezem	b eː z ə m
bezeten	b ə z eː t ə n
bezetene	b ə z eː t ə n ə
bezetteling	b ə z ɛ t ə l ɪ ŋ
bezieling	b ə z i l ɪ ŋ
bezig	b eː z ə x
bezigheid	b eː z ə x ɦ ɛ i̯ t
bezingen	b ə z ɪ ŋ ə n
bezuinigen	b ə z œ y̯ n ə ɣ ə n
bezwaren	b ə z ʋ aː r ə n
bezwendelen	b ə z ʋ ɛ n d ə l ə n
bezweren	b ə z ʋ eː r ə n
bezwijken	b ə z ʋ ɛ i̯ k ə n
bezwijmen	b ə z ʋ ɛ i̯ m ə n
bibberen	b ɪ b ə r ə n
bibliograaf	b i b l i oː ɣ r aː f
bidden	b ɪ d ə n
bier	b i r
bierfiets	b iː r f i t s
bierfles	b iː r f l ɛ s
bierpul	b iː r p ʏ l
biervlieg	b iː r v l i x
bieslook	b i s l oː k
biggelen	b ɪ ɣ ɛ l ə n
bijbelhaak	b ɛ i̯ b ə l ɦ aː k
bijbelneuker	b ɛ i̯ b ə l n øː k ə r
bijdragen	b ɛ i̯ d r aː ɣ ə n
bijdrukken	b ɛ i̯ d r ʏ k ə n
bijendrom	b ɛ i̯ ə n d r ɔ m
bijenkorven	b ɛ i̯ j ə ŋ k ɔ r v ə n
bijkomstig	b ɛ i̯ k ɔ m s t ə x
bijlage	b ɛ i̯ l aː ɣ ə
bijlbundel	b ɛ i̯ l b ʏ n d ə l
bijlmermeer	b ɛ i̯ l m ə r m eː r
bijna	b ɛ i̯ n aː
bijnier	b ɛ i n iː r
bijschaduw	b ɛ i̯ s x aː d y u̯
bijschieten	b ɛ i̯ s x i t ə n
bijstand	b ɛ i̯ s t ɑ n t
bijstellen	b ɛ i̯ s t ɛ l ə n
bijtijds	b ɛ i̯ t ɛ i̯ t s
bijvoeglijk	b ɛ i̯ v u x l ə k
bijvoorbeeld	b ɛ i̯ v oː r b eː l t
bijvrouw	b ɛ i̯ v r ɑ u̯
bijvullen	b ɛ i̯ v ʏ l ə n
bijwerkinkje	b ɛ i ʋ ɛ r k ɪ ŋ k j ə
bijwonen	b ɛ i̯ ʋ oː n ə n
bijwoordelijk	b ɛ i̯ ʋ oː r d ə l ə k
bijzettafel	b ɛ i̯ z ɛ t t aː f ə l
bijzit	b ɛ i̯ z ɪ t
biljartbal	b ɪ l j ɑ r t b ɑ l
bilstuk	b ɪ l s t ʏ k
biltong	b ɪ l t ɔ ŋ
bima	b i m aː
bingoën	b ɪ ŋ ɡ oː ə n
binnen	b ɪ n ə n
binnenband	b ɪ n ə n b ɑ n t
binnenbrengen	b ɪ n ə n b r ɛ ŋ ə n
binnengaan	b ɪ n ə n ɣ aː n
binnenkoorts	b ɪ n ə n k oː r t s
binnenmens	b ɪ n ə n m ɛ n s
binnenmuur	b ɪ n ə n m yː r
binnenschans	b ɪ n ə n s x ɑ n s
binnenzak	b ɪ n ə n z ɑ k
bintoerong	b ɪ n t u r ɔ ŋ
biofysicus	b i oː f i z i k ʏ s
biofysisch	b i oː f i z i s
biopsie	b i ɔ p s i
bisjaar	b i s j aː r
bislama	b ɪ s l aː m aː
bismut	b ɪ s m ʏ t
bisschoppelijk	b ɪ s s x ɔ p ə l ə k
bisschopsmijter	b ɪ s x ɔ p s m ɛ i̯ t ə r
bisschopswijn	b ɪ s x ɔ p s ʋ ɛ i̯ n
bit	b ɪ t
bitterwortel	b ɪ t ə r ʋ ɔ r t ə l
blaas	b l aː s
blaasspeeltuig	b l aː s s p eː l t œ y̯ x
bladder	b l ɑ d ə r
bladerdeeg	b l aː d ə r d eː x
bladgoud	b l ɑ t x ɑ u̯ t
bladzij	b l ɑ t s ɛ i̯
blank	b l ɑ ŋ k
blanke	b l ɑ ŋ k ə
blasfemisch	b l ɑ s f eː m i s
blasphemisch	b l ɑ s f eː m i s
blauw	b l ɑ u̯
blauwachtig	b l ɑ u̯ ɑ x t ə x
blauwschuit	b l ɑ u̯ s x œ y̯ t
bled	b l ɛ t
bleekveld	b l eː k f ɛ l t
blessuretijd	b l ɛ s y r ə t ɛ i̯ t
blijmoedig	b l ɛ i̯ m u d ə x
blijvend	b l ɛ i̯ v ə n t
blindheid	b l ɪ n d ɦ ɛ ɪ t
blinken	b l ɪ ŋ k ə n
bloedbad	b l u t b ɑ t
bloeddruk	b l u t d r ʏ k
bloederziekte	b l u d ə r z i k t ə
bloedsneeuw	b l u t s n eː u̯
bloedspat	b l u t s p ɑ t
bloedsprookje	b l u t s p r oː k j ə
bloedstroom	b l u t s t r oː m
bloem	b l u m
bloemen	b l u m ə n
bloemenkwekerij	b l u m ə n k ʋ eː k ə r ɛ i̯
bloempotkapsel	b l u m p ɔ t k ɑ p s ə l
bloes	b l u s
blèren	b l ɛː r ə n
bod	b ɔ t
bodemloos	b oː d ə m l oː s
bodemonderzoek	b oː d ə m ɔ n d ə r z u k
body	b ɔ d i
bodybuildster	b ɔ d i b ɪ l t s t ə r
boedel	b u d ə l
boedelscheiding	b u d ə l s x ɛ i̯ d ɪ ŋ
boeg	b u x
boegseren	b u x s eː r ə n
boegspriet	b u x s p r i t
boekdeel	b u k d eː l
boekenliefhebberij	b u k ə n l i f ɦ ɛ b ə r ɛ i̯
boekenwurm	b u k ə n ʋ ʏ r m
boeklong	b u k l ɔ ŋ
boekmaag	b u k m aː x
boekwinkel	b u k ʋ i ŋ k ə l
boeler	b u l ə r
boeman	b u m ɑ n
boemel	b u m ə l
boender	b u n d ə r
boerenkool	b uː r ə n k oː l
boerenland	b uː r ə n l ɑ n t
boetseren	b u t s eː r ə n
boezemvriendin	b u z ə m v r i n d ɪ n
bogen	b oː ɣ ə n
bokse	b ɔ k s ə
bolder	b ɔ l d ə r
bolvormig	b ɔ l v ɔ r m ə x
bombardeerkever	b ɔ m b ɑ r d eː r k eː v ə r
bombardementsvliegtuig	b ɔ m b ɑ r d ə m ɛ n t s f l i x t œ y̯ x
bombardon	b ɔ m b ɑ r d ɔ n
bomma	b ɔ m aː
bon	b ɔ n
bonenstaak	b oː n ə n s t aː k
bonken	b ɔ ŋ k ə n
bonten	b ɔ n t ə n
bonzen	b ɔ n z ə n
boomgeld	b oː m ɣ ɛ l t
boomgrens	b oː m ɣ r ɛ n s
boomhoen	b oː m ɦ u n
boomkor	b oː m k ɔ r
boomrijk	b oː m r ɛ i̯ k
boormossel	b oː r m ɔ s ə l
boos	b oː s
boothuis	b oː t ɦ œ y̯ s
borduren	b ɔ r d y r ə n
boren	b oː r ə n
borgen	b ɔ r ɣ ə n
borrelen	b ɔ r ə l ə n
borst	b ɔ r s t
borstelig	b ɔ r s t ə l ə x
borstrok	b ɔ r s t r ɔ k
borstwapen	b ɔ r s t ʋ aː p ə n
borstwering	b ɔ r s t ʋ eː r ɪ ŋ
bosch	b ɔ s
boskoe	b ɔ s k u
boswachter	b ɔ s ʋ ɑ x t ə r
botanica	b oː t aː n i k aː
bottelarij	b ɔ t ə l aː r ɛ i̯
boutkogel	b ɑ u̯ t k oː ɣ ə l
bouwen	b ɑ u̯ ə n
bouwlamp	b ɑ u̯ l ɑ m p
bovengrens	b oː v ə n ɣ r ɛ n s
bovenhalen	b oː v ə n ɦ aː l ə n
bovenleiding	b oː v ə n l ɛ i̯ d ɪ ŋ
boycotten	b ɔ i̯ k ɔ t ə n
braakakker	b r aː k ɑ k ə r
braakbal	b r aː k b ɑ l
braakdrank	b r aː k d r ɑ ŋ k
brandewijn	b r ɑ n d ə ʋ ɛ i̯ n
brandschoon	b r ɑ n t s x oː n
brandspuit	b r ɑ n t s p œ y̯ t
brandstichtster	b r ɑ n t s t ɪ x t s t ə r
brandwond	b r ɑ n t ʋ ɔ n t
breedsprakig	b r eː t s p r aː k ə x
breidelen	b r ɛ i̯ d ə l ə n
breiklos	b r ɛ i̯ k l ɔ s
brein	b r ɛ i̯ n
breinloos	b r ɛ i̯ n l oː s
breisel	b r ɛ i̯ s ə l
brengen	b r ɛ ŋ ə n
bretel	b r ə t ɛ l
breukstreep	b r øː k s t r eː p
brillenglas	b r ɪ l ə n ɣ l ɑ s
broddelen	b r ɔ d ə l ə n
broederloos	b r u d ə r l oː s
broedermoord	b r u d ə r m oː r t
broedpaar	b r u t p aː r
broeibak	b r u i̯ b ɑ k
broeihoop	b r u i̯ ɦ oː p
brokkelen	b r ɔ k ə l ə n
brommer	b r ɔ m ə r
bromvlieg	b r ɔ m v l i x
broodhaan	b r oː t ɦ aː n
broodroof	b r oː t r oː f
broodrooster	b r oː t r oː s t ə r
broodtrommel	b r oː t r ɔ m ə l
brouillage	b r u j aː ʒ ə
brouwhuis	b r ɑ u̯ ɦ œ y̯ s
brugwachter	b r ʏ x ʋ ɑ x t ə r
bruiker	b r œ y̯ k ə r
bruiloft	b r œ y̯ l ɔ f t
bruin	b r œ y̯ n
bruinhemd	b r œ y̯ n ɦ ɛ m t
bruinogig	b r œ y̯ n oː ɣ ə x
bruinvis	b r œ y̯ n v ɪ s
brunchen	b r ʏ n ʃ ə n
brunet	b r y n ɛ t
brunette	b r y n ɛ t ə
brutaal	b r y t aː l
bruto	b r y t oː
buidelhaas	b œ y̯ d ə l ɦ aː s
buidelmol	b œ y̯ d ə l m ɔ l
buigen	b œ y̯ ɣ ə n
buikdans	b œ y̯ k d ɑ n s
buikdanseres	b œ y̯ k d ɑ n s ə r ɛ s
buikvloed	b œ y̯ k f l u t
bullebak	b ʏ l ə b ɑ k
bulleboer	b ʏ l ə b uː r
bumperkleven	b ʏ m p ə r k l eː v ə n
bumperklever	b ʏ m p ə r k l eː v ə r
bundel	b ʏ n d ə l
bundelen	b ʏ n d ə l ə n
bungelen	b ʏ ŋ ə l ə n
bureaustoel	b ʏ r oː s t u l
buren	b y r ə n
burenhulp	b yː r ə n ɦ ʏ l p
burgerbevolking	b ʏ r ɣ ə r b ə v ɔ l k ɪ ŋ
burgerschapsonderwijs	b ʏ r ɣ ə r s x ɑ p s ɔ n d ə r ʋ ɛ i̯ s
burgerzin	b ʏ r ɣ ə r z ɪ n
burgwal	b ʏ r x ʋ ɑ l
bus	b ʏ s
bussen	b ʏ s ə n
butten	b ʏ t ə n
buurmeisje	b yː r m ɛ i̯ ʃ ə
buurtkind	b yː r t k ɪ n t
buxus	b ʏ k s ʏ s
cabaleur	k aː b aː l øː r
cabriolet	k aː b r i oː l ɛ t
cacaoboter	k ɑ k ɑ u̯ b oː t ə r
cadeau	k ɑ d oː
cadeautip	k aː d oː t ɪ p
cafetaria	k aː f eː t aː r i aː
cahier	k aː j eː
calciumoxide	k ɑ l s i ʏ m ɔ k s i d ə
calvijn	k ɑ l v ɛ i̯ n
campagne	k ɑ m p ɑ n j ə
cartotheek	k ɑ r t oː t eː k
casuïstiek	k aː z y ɪ s t i k
catalonisch	k aː t aː l oː n i s
categoriseren	k ɑ t ə ɣ oː r i z eː r ə n
cel	s ɛ l
centime	s ɛ n t i m ə
certificeren	s ɛ r t i f i s eː r ə n
cervix	s ɛ r v ɪ k s
chanteren	ʃ ɑ n t eː r ə n
chaos	x aː ɔ s
chapeau	ʃ aː p oː
cheffin	ʃ ɛ f ɪ n
chemie	x eː m i
chemisch	x eː m i s
cherubijn	x eː r y b ɛ i̯ n
chicaneren	ʃ i k aː n eː r ə n
chinese	ʃ i n eː s ə
chinezen	ʃ i n eː z ə n
chloor	x l oː r
chocolademelk	ʃ oː k oː l aː d ə m ɛ l k
cholera	x oː l ə r aː
chordadier	x ɔ r d aː d iː r
christiaan	k r ɪ s t i j aː n
cijferschrift	s ɛ i̯ f ə r s x r ɪ f t
cimbaal	s ɪ m b aː l
circuitje	s ɪ r k ʋ i t j j ə
cirkelen	s ɪ r k ə l ə n
cisvrouw	s ɪ s f r ɑ u̯
citroensap	s i t r u n s ɑ p
cladistiek	k l aː d ɪ s t i k
cloaca	k l oː aː k aː
clownvis	k l ɑ u̯ n v ɪ s
club	k l ʏ p
clubhuis	k l ʏ p ɦ œ y̯ s
coach	k oː t ʃ
cocktail	k ɔ k t eː l
cocon	k oː k ɔ n
cognaat	k ɔ x n aː t
collatie	k ɔ l aː t s i
columbarium	k oː l ʏ m b aː r i ʏ m
combi	k ɔ m b i
combineren	k ɔ m b i n eː r ə n
comeback	k ɑ m b ɛ k
commentariaat	k ɔ m ɛ n t aː r i j aː t
commerçant	k ɔ m ɛ r s ɑ n t
communie	k ɔ m y n i
compileren	k ɔ m p i l eː r ə n
concentreren	k ɔ n s ɛ n t r eː r ə n
concipiëren	k ɔ n s i p i eː r ə n
condenseren	k ɔ n d ɛ n s eː r ə n
confinatie	k ɔ n f i n aː t s i
confiscatie	k ɔ n f ɪ s k aː t s i
conflagratie	k ɔ n f l aː ɣ r aː t s i
conjugeren	k ɔ n j y ɣ eː r ə n
constante	k ɔ n s t ɑ n t ə
constatering	k ɔ n s t aː t eː r ɪ ŋ
consumeren	k ɔ n s y m eː r ə n
consumptiemaatschappij	k ɔ n z ʏ m p s i m aː t s x ɑ p ɛ i̯
contact	k ɔ n t ɑ k t
contraheren	k ɔ n t r aː ɦ eː r ə n
converseren	k ɔ n v ɛ r z eː r ə n
cookie	k u k i
copula	k oː p y l aː
corpulent	k ɔ r p y l ɛ n t
corrector	k ɔ r ɛ k t ɔ r
coterie	k oː t ə r i
couperus	k u p eː r ʏ s
creatief	k r eː j aː t i f
creativiteit	k r eː j aː t i v i t ɛ i̯ t
crematorium	k r eː m aː t oː r i ʏ m
creool	k r eː oː l
crisette	k r i z ɛ t ə
cruiseboot	k r uː s b oː t
cultuurvolger	k ʏ l t yː r f ɔ l ɣ ə r
daadkrachtig	d aː t k r ɑ x t ə x
daalder	d aː l d ə r
dagactief	d ɑ x ɑ k t i f
dagboek	d ɑ ɣ b u k
dagdier	d ɑ x d iː r
dakgoot	d ɑ k x oː t
dakisolatie	d ɑ k i z oː l aː t s i
damhert	d ɑ m ɦ ɛ r t
dammen	d ɑ m ə n
damschijf	d ɑ m s x ɛ i̯ f
damspel	d ɑ m s p ɛ l
damstuk	d ɑ m s t ʏ k
dankloos	d ɑ ŋ k l oː s
danshuis	d ɑ n s ɦ œ y̯ s
dansplaat	d ɑ n s p l aː t
dapperheid	d ɑ p ə r ɦ ɛ i̯ t
darmbeen	d ɑ r m b eː n
darmsap	d ɑ r m s ɑ p
dassenhol	d ɑ s ə n ɦ ɔ l
dauwdruppel	d ɑ u̯ d r ʏ p ə l
david	d aː v ɪ t
decentraliseren	d eː s ɛ n t r aː l i z eː r ə n
decyl	d eː s i l
deed	d eː t
deelwoordelijk	d eː l ʋ oː r d ə l ə k
degenkrab	d eː ɣ ə n k r ɑ p
dekbedovertrek	d ɛ k b ɛ t oː v ə r t r ɛ k
delfstofkunde	d ɛ l f s t ɔ f k ʏ n d ə
delta	d ɛ l t aː
deltaplan	d ɛ l t aː p l ɑ n
dementeren	d eː m ɛ n t eː r ə n
democratisch	d eː m oː k r aː t i s
demonstreren	d eː m ɔ n s t r eː r ə n
denkpiste	d ɛ ŋ k p i s t ə
denkraam	d ɛ ŋ k r aː m
denneappel	d ɛ n ə ɑ p ə l
depri	d eː p r i
deren	d eː r ə n
desalniettemin	d ɛ z ɑ l n i t ə m ɪ n
deserteren	d eː z ə r t eː r ə n
desinformatie	d ɛ s ɪ n f ɔ r m aː t s i
destilleren	d ɛ s t i l eː r ə n
deugd	d øː x t
deugen	d øː ɣ ə n
deurhamer	d øː r ɦ aː m ə r
deva	d eː v aː
dextrogyr	d ɛ k s t r oː ɣ iː r
deïsmus	d eː ɪ s m ʏ s
diabetes	d i aː b eː t ə s
dichtbinden	d ɪ x t b ɪ n d ə n
dichter	d ɪ x t ə r
dictaat	d ɪ k t aː t
dienen	d i n ə n
dienstbode	d i n s t b oː d ə
dienstman	d i n s t m ɑ n
diepvries	d i p f r i s
diepvriezen	d i p f r i z ə n
dierenleed	d iː r ə n l eː t
dierenrechtenactivist	d iː r ə n r ɛ x t ə n ɑ k t i v ɪ s t
diergedicht	d iː r ɣ ə d ɪ x t
dieronterend	d iː r ɔ n t eː r ə n t
diesellocomotief	d i z ə l l oː k oː m oː t i f
differentiaalrekening	d ɪ f ə r ɛ n t ʃ aː l r eː k ə n ɪ ŋ
differentiatie	d ɪ f ə r ɛ n t ʃ aː t s i
digereren	d i ɣ ə r eː r ə n
dijkage	d ɛ i̯ k aː ʒ ə
dijker	d ɛ i̯ k ə r
dijkramp	d ɛ i̯ k r ɑ m p
dijn	d ɛ i̯ n
dikdarm	d ɪ k d ɑ r m
dikzakken	d ɪ k s ɑ k ə n
dingen	d ɪ ŋ ə n
dinsdag	d ɪ n z d ɑ x
dissel	d ɪ s ə l
distelvijg	d ɪ s t ə l v ɛ i̯ x
docu	d oː k y
documentatie	d oː k y m ɛ n t aː t s i
dodenmasker	d oː d ə n m ɑ s k ə r
dodentol	d oː d ə n t ɔ l
doelpunt	d u l p ʏ n t
doen	d u n
doenlijk	d u n l ə k
dof	d ɔ f
dokter	d ɔ k t ə r
dolleman	d ɔ l ə m ɑ n
dollemansrit	d ɔ l ə m ɑ n s r ɪ t
dolt	d ɔ l t
dom	d ɔ m
domein	d oː m ɛ i̯ n
dommekracht	d ɔ m ə k r ɑ x t
dommelen	d ɔ m ə l ə n
domper	d ɔ m p ə r
dompneus	d ɔ m p n øː s
domrechts	d ɔ m r ɛ x t s
donderdags	d ɔ n d ə r d ɑ x s
dondergod	d ɔ n d ə r ɣ ɔ t
donderroede	d ɔ n d ə r r u d ə
donderstraal	d ɔ n d ə r s t r aː l
donker	d ɔ ŋ k ə r
doodceel	d oː t s eː l
dooddoener	d oː t d u n ə r
doods	d oː t s
doodsbang	d oː t s b ɑ ŋ
doodsengel	d oː t s ɛ ŋ ə l
doof	d oː f
doop	d oː p
doopsgezinde	d oː p s x ə z ɪ n d ə
doorgeefluik	d oː r ɣ eː f l œ y̯ k
doorkijkblouse	d oː r k ɛ i̯ k b l u s
doorlatends	d oː r l aː t ə n t s
doorvochtigen	d oː r v ɔ x t ə ɣ ə n
doorzetten	d oː r z ɛ t ə n
doorzoeken	d oː r z u k ə n
dopeling	d oː p ə l ɪ ŋ
doperwt	d ɔ p ɛ r t
dopingarts	d oː p ɪ ŋ ɑ r t s
doppen	d ɔ p ə n
dormitorium	d ɔ r m ɪ t oː r i ʏ m
dorpsgenote	d ɔ r p s x ə n oː t ə
dorpshuis	d ɔ r p s ɦ œ y̯ s
doseren	d oː z eː r ə n
download	d ɑ u̯ n l oː t
draag	d r aː x
draagbaar	d r aː x b aː r
draai	d r aː i̯
draaiboek	d r aː i̯ b u k
draaideurcrimineel	d r aː i̯ d øː r k r i m i n eː l
draak	d r aː k
drankbestrijding	d r ɑ ŋ k b ə s t r ɛ i̯ d ɪ ŋ
dreigbrief	d r ɛ i̯ x b r i f
driecilinder	d r i s i l ɪ n d ə r
driehoek	d r i ɦ u k
driehonderd	d r i ɦ ɔ n d ə r t
drieëndertig	d r i ɛ n d ɛ r t ə x
drijfjacht	d r ɛ i̯ f j ɑ x t
dril	d r ɪ l
drillen	d r ɪ l ə n
drinkwater	d r i ŋ k ʋ aː t ə r
droeg	d r u x
droesem	d r u s ə m
drogen	d r oː ɣ ə n
dronk	d r ɔ ŋ k
dronkaard	d r ɔ ŋ k aː r d
droogmakerij	d r oː x m aː k ə r ɛ i̯
drop	d r ɔ p
drugsmisbruik	d r ʏ ɡ s m ɪ s b r œ y̯ k
drukpers	d r ʏ k p ɛ r s
druktoets	d r ʏ k t u t s
dualiteit	d y aː l i t ɛ i̯ t
dubbelklikken	d ʏ b ə l k l ɪ k ə n
dubben	d ʏ b ə n
duet	d y ɛ t
duffel	d ʏ f ə l
duikbril	d œ y̯ k b r ɪ l
duiken	d œ y̯ k ə n
duikschool	d œ y̯ k s x oː l
duitser	d œ y̯ t s ə r
duivel	d œ y̯ v ə l
duizendpoot	d œ y̯ z ə n t p oː t
dun	d ʏ n
dunk	d ʏ ŋ k
duppie	d ʏ p i
durven	d ʏ r v ə n
dwangbuis	d ʋ ɑ ŋ b œ y̯ s
dwarszitten	d ʋ ɑ r s ɪ t ə n
dweilorkest	d ʋ ɛ i̯ l ɔ r k ɛ s t
dwerg	d ʋ ɛ r x
dwergchimpansee	d ʋ ɛ r x ʃ ɪ m p ɑ n s eː
dwingeland	d ʋ ɪ ŋ ə l ɑ n t
dysfemisme	d ɪ s f eː m ɪ s m ə
echapperen	eː ʃ ɑ p eː r ə n
echt	ɛ x t
echtscheiding	ɛ x t s x ɛ i̯ d ɪ ŋ
eczeem	ɛ k s eː m
edik	eː d ɪ k
eendenmol	eː n d ə n m ɔ l
eendvliegtuig	eː n t f l i x t œ y̯ x
eenenzestig	eː n ə n s ɛ s t ə x
eenheidsuitgang	eː n ɦ ɛ i̯ t s œ y̯ t x ɑ ŋ
eerst	eː r s t
eest	eː s t
eeuwig	eː u̯ ə x
eeuwjaar	eː u̯ j aː r
egalitarisme	eː ɣ aː l i t aː r ɪ s m ə
egyptenaar	eː ɣ ɪ p t ə n aː r
eieren	ɛ i̯ j ə r ə n
eigen	ɛ i̯ ɣ ə n
eigenen	ɛ i̯ ɣ ə n ə n
eikvaren	ɛ i̯ k v aː r ə n
eilandstaat	ɛ i̯ l ɑ n t s t aː t
eindbestemming	ɛ i̯ n t b ə s t ɛ m ɪ ŋ
eisprong	ɛ i̯ s p r ɔ ŋ
el	ɛ l
elfen	ɛ l v ə n
elfstedentocht	ɛ l f s t eː d ə n t ɔ x t
eline	eː l i n ə
elitair	eː l i t ɛː r
ellerling	ɛ l ə r l ɪ ŋ
elpenbeen	ɛ l p ə n b eː n
elvin	ɛ l v ɪ n
emigreren	eː m i ɣ r eː r ə n
enkel	ɛ ŋ k ə l
enthousiasme	ɑ n t u ʒ ɑ s m ə
epiduraal	eː p i d y r aː l
epifauna	eː p i f ɑ u̯ n aː
eponiem	eː p oː n i m
erectie	eː r ɛ k s i
erelid	eː r ə l ɪ t
ereteken	eː r ə t eː k ə n
ergeren	ɛ r ɣ ə r ə n
ertoe	ɛ r t u
eschatologie	ɛ s x aː t oː l oː ɡ i
eskimo	ɛ s k i m oː
esthetisch	ɛ s t eː t i s
etaleren	eː t aː l eː r ə n
ethanol	eː t aː n ɔ l
etheen	eː t eː n
ethiek	eː t i k
etnologie	ɛ t n oː l oː ɣ i
evenaar	eː v ə n aː r
exerceren	ɛ k s ə r s eː r ə n
expanderen	ɛ k s p ɑ n d eː r ə n
exposeren	ɛ k s p oː z eː r ə n
extremofiel	ɛ k s t r eː m oː f i l
fabelleer	f aː b ə l l eː r
fabelwezen	f aː b ə l ʋ eː z ə n
fabrieksrijder	f aː b r i k s r ɛ i̯ d ə r
facetoog	f aː s ɛ t oː x
factotums	f ɑ k t o t ʏ m s
familie	f ɑ m i l i
familienaam	f aː m i l i n aː m
fanaal	f aː n aː l
fantasie	f ɑ n t aː z i
fasciatie	f ɑ s i aː t s i
fax	f ɑ k s
faxen	f ɑ k s ə n
femelaar	f eː m ə l aː r
ferrometaal	f ɛ r oː m eː t aː l
festival	f ɛ s t i v ɑ l
fierljeppen	f iː r ə l j ɛ p ə n
fietsendrager	f i t s ə n d r aː ɣ ə r
fietsenstalling	f i t s ə n s t ɑ l ɪ ŋ
fietsinfrastructuur	f i t s ɪ n f r aː s t r ʏ k t yː r
fietsstrook	f i t s t r oː k
fietst	f i t s t
figureren	f i ɣ y r eː r ə n
fikken	f ɪ k ə n
fiksen	f ɪ k s ə n
filharmonisch	f i l ɦ ɑ r m oː n i s
filmhuis	f ɪ l m ɦ œ y̯ s
filoloog	f i l oː l oː ɣ
fissa	f ɪ s aː
fjord	f j ɔ r t
flansen	f l ɑ n s ə n
flauwte	f l ɑ u̯ t ə
flexie	f l ɛ k s i
flikflooien	f l ɪ k f l oː i̯ ə n
flikkers	f l ɪ k ə r s
flinterdun	f l ɪ n t ə r d ʏ n
flippen	f l ɪ p ə n
floppen	f l ɔ p ə n
fluitschip	f l œ y̯ t s x ɪ p
fok	f ɔ k
fokken	f ɔ k ə n
fokschaap	f ɔ k s x aː p
formatteren	f ɔ r m ɑ t eː r ə n
fossielenbestand	f ɔ s i l ə n b ə s t ɑ n t
fotocamera	f oː t oː k aː m ə r aː
fragiliteit	f r aː ɣ i l i t ɛ i̯ t
fragmentenhypothese	f r ɑ x m ɛ n t ə n ɦ i p oː t eː z ə
frank	f r ɑ ŋ k
fraseur	f r aː z øː r
frederik	f r eː d ə r ɪ k
freon	f r eː ɔ n
frikandel	f r i k ɑ n d ɛ l
frituren	f r i t y r ə n
fêteren	f ɛ t eː r ə n
gaasvlieg	ɣ aː s f l i x
gade	ɣ aː d ə
gaden	ɣ aː d ə n
gaffel	ɣ ɑ f ə l
galaat	ɣ aː l aː t
galgenaas	ɣ ɑ l ɣ ə n aː s
galm	ɣ ɑ l m
garantie	ɣ a r ɑ n t s i
gasbeving	ɣ ɑ s b eː v ɪ ŋ
gassen	ɣ ɑ s ə n
gasthuis	ɣ ɑ s t ɦ œ y̯ s
gastvrouw	ɣ ɑ s t f r ɑ u̯
gauwdief	ɣ ɑ u̯ d i f
gaza	ɣ aː z aː
gazastrook	ɣ aː z aː s t r oː k
ge	ɣ ə
gebaard	ɣ ə b aː r t
gebed	ɣ ə b ɛ t
gebruikelijk	ɣ ə b r œ y̯ k ə l ə k
gebruiken	ɣ ə b r œ y̯ k ə n
gebruiksonvriendelijk	ɣ ə b r œ y̯ k s ɔ n v r i n d ə l ə k
gebruikt	ɣ ə b r œ y̯ k t
gedacht	ɣ ə d ɑ x t
gedachtenis	ɣ ə d ɑ x t ə n ɪ s
gedachtetrant	ɣ ə d ɑ x t ə t r ɑ n t
gedankt	ɣ ə d ɑ ŋ k t
gedenken	ɣ ə d ɛ ŋ k ə n
gedwee	ɣ ə d ʋ eː
geelzucht	ɣ eː l z ʏ x t
geesteskrank	ɣ eː s t ə s k r ɑ ŋ k
geestesziekte	ɣ eː s t ə s i k t ə
geeuwen	ɣ eː u̯ ə n
gegevensdrager	ɣ ə ɣ eː v ə n s d r aː ɣ ə r
geheelal	ɣ ə ɦ eː l ɑ l
geheimschrift	ɣ ə ɦ ɛ i̯ m s x r ɪ f t
geheimtaal	ɣ ə ɦ ɛ i̯ m t aː l
geheten	ɣ ə ɦ eː t ə n
geheugenstick	ɣ ə ɦ øː ɣ ə n s t ɪ k
gehoopt	ɣ ə ɦ oː p t
gehoorzaal	ɣ ə ɦ oː r z aː l
geilbek	ɣ ɛ i̯ l b ɛ k
gein	ɣ ɛ i̯ n
geitenherder	ɣ ɛ i̯ t ə n ɦ ɛ r d ə r
geitenmelker	ɣ ɛ i̯ t ə n m ɛ l k ə r
geldezel	ɣ ɛ l t eː z ə l
geldhandel	ɣ ɛ l t ɦ ɑ n d ə l
geldkraan	ɣ ɛ l t k r aː n
geldzorg	ɣ ɛ l t s ɔ r x
geleedpotige	ɣ ə l eː t p oː t ə ɣ ə
gelijk	ɣ ə l ɛ i k
gelijkstaat	ɣ ə l ɛ i̯ k s t aː t
geluidsoverlast	ɣ ə l œ y̯ t s oː v ə r l ɑ s t
geluksvogel	ɣ ə l ʏ k s f oː ɣ ə l
gelul	ɣ ə l ʏ l
gemaal	ɣ ə m aː l
gemakshalve	ɣ ə m ɑ k s ɦ ɑ l v ə
gematigdst	ɣ ə m a t ə x t s t
gemeenslachtig	ɣ ə m eː n s l ɑ x t ə x
genitivisch	ɡ eː n i t iː v i s
genoten	ɣ ə n oː t ə n
geograaf	ɣ eː oː ɣ r aː f
geografisch	ɣ eː oː ɣ r aː f i s
geschiedboek	ɣ ə s x i t b u k
geschut	ɣ ə s x ʏ t
geslachtsklier	ɣ ə s l ɑ x t s k l iː r
gespan	ɣ ə s p ɑ n
gespen	ɣ ɛ s p ə n
gesteun	ɣ ə s t øː n
gesticuleren	ɣ ɛ s t i k y l eː r ə n
geul	ɣ øː l
geur	ɣ øː r
geuren	ɣ øː r ə n
gevader	ɣ ə v aː d ə r
gevangenis	ɣ ə v ɑ ŋ ə n ɪ s
gevangenzetten	ɣ ə v ɑ ŋ ə n z ɛ t ə n
gevel	ɣ eː v ə l
gewaarworden	ɣ ə ʋ aː r ʋ ɔ r d ə n
gewas	ɣ ə ʋ ɑ s
gewei	ɣ ə ʋ ɛ i̯
gezegde	ɣ ə z ɛ x d ə
gezegende	ɣ ə z eː ɣ ə n d ə
gezin	ɣ ə z ɪ n
gibbon	ɣ ɪ b ɔ n
gids	ɣ ɪ t s
gierst	x iː r s t
gifslang	ɣ ɪ f s l ɑ ŋ
gifstof	ɣ ɪ f s t ɔ f
giftslang	ɣ ɪ f t s l ɑ ŋ
gij	ɣ ɛ i̯
gips	ɣ ɪ p s
giraf	ʒ i r ɑ f
gist	ɣ ɪ s t
gladneus	ɣ l ɑ t n øː s
glamping	ɡ l ɛ m p ɪ ŋ
glasmie	ɣ l ɑ s m i
gletser	ɣ l ɛ t s ə r
glijbaan	ɣ l ɛ i b aː n
glijboot	ɣ l ɛ i̯ b oː t
glimlach	ɣ l ɪ m l ɑ x
glimmen	ɣ l ɪ m ə n
glop	ɣ l ɔ p
godenzoon	ɣ oː d ə n z oː n
godsbewijs	ɣ ɔ t s b ə ʋ ɛ i̯ s
godsdienstoorlog	ɣ ɔ t s d i n s t oː r l ɔ x
godshuis	ɣ ɔ t s ɦ œ y̯ s
godslastering	ɣ ɔ t s l ɑ s t ə r ɪ ŋ
godzaligheid	ɣ ɔ t s aː l ə x ɦ ɛ i̯ t
goeddeels	ɣ u t d eː l s
goede	ɣ u d ə
goedkoop	ɣ u t k oː p
gom	ɣ ɔ m
googel	ɡ u ɡ ə l
googelden	ɡ u ɡ ə l d ə n
gooien	ɣ oː i̯ ə n
gootsteen	ɣ oː t s t eː n
gorgoon	ɣ ɔ r ɣ oː n
gorinchem	ɣ ɔ r k ə m
gothic	ɡ ɔ t ɪ k
gouda	ɣ ɑ u̯ d aː
goudsbloem	ɣ ɑ u̯ t s b l u m
goudvis	ɣ ɑ u̯ t f ɪ s
gouvernement	ɣ u v ɛ r n ə m ɛ n t
grachtenhuis	ɣ r ɑ x t ə n ɦ œ y̯ s
grafieten	ɣ r aː f i t ə n
gram	ɣ r ɑ m
gramschap	ɣ r ɑ m s x ɑ p
grasduin	ɣ r ɑ s d œ y̯ n ə n
grasland	ɣ r ɑ s l ɑ n t
gratie	ɣ r aː t s i
grauwblauw	ɣ r ɑ u̯ b l ɑ u̯
gravin	ɣ r aː v ɪ n
grensoorlog	ɣ r ɛ n s oː r l ɔ x
griek	ɣ r i k
griezel	ɣ r i z ə l
grijzig	ɣ r ɛ i̯ z ə x
gristen	ɣ r ɪ s t ə n
groenachtig	x r u nː ɑ xː t ə x
grondbloem	ɣ r ɔ n t b l u m
grondsap	ɣ r ɔ n t s ɑ p
grondvest	ɣ r ɔ n t f ɛ s t
grootgrondbezitter	ɣ r oː t x r ɔ n t b ə z ɪ t ə r
grootmoeder	ɣ r oː t m u d ə r
grootoosten	ɣ r oː t oː s t ə n
grootouder	ɣ r oː t ɑ u̯ d ə r
grootste	ɣ r oː t s t ə
gruis	ɣ r œ y̯ s
gruit	ɣ r œ y̯ t
guppie	ɣ ʏ p i
gutsje	ɣ ʏ t s j ə
gymp	ɣ ɪ m p
gênant	ʒ ə n ɑ n t
haak	ɦ aː k
haar	ɦ aː r
haarborstel	ɦ aː r b ɔ r s t ə l
haarlems	ɦ aː r l ɛ m s
haasachtige	ɦ aː s ɑ x t ə ɣ ə
habbekrats	ɦ ɑ b ə k r ɑ t s
hadden	ɦ ɑ d ə n
hagedis	ɦ aː ɣ ə d ɪ s
hagelstorm	ɦ aː ɣ ə l s t ɔ r m
haggada	ɦ ɑ ɡ aː d aː
hak	ɦ ɑ k
halachisch	ɦ aː l ɑ x i s
halal	ɦ aː l ɑ l
halfschaduw	ɦ ɑ l f s x aː d y u̯
hallo	ɦ ɑ l oː
halswender	ɦ ɑ l s ʋ ɛ n d ə r
halveren	ɦ ɑ l v eː r ə n
hamam	ɦ aː m ɑ m
hamel	ɦ aː m ə l
hamsteren	ɦ ɑ m s t ə r ə n
hamsterhaas	ɦ ɑ m s t ə r ɦ aː s
hamvraag	ɦ ɑ m v r aː x
handdoek	ɦ ɑ n d u k
handig	ɦ ɑ n d ɪ x
handschrift	ɦ ɑ n t s x r ɪ f t
handvuurwapen	ɦ ɑ n t f yː r ʋ aː p ə n
hangbrug	ɦ ɑ ŋ b r ʏ x
hans	ɦ ɑ n s
hansworst	ɦ ɑ n s ʋ ɔ r s t
hanzestad	ɦ ɑ n z ə s t ɑ t
haram	ɦ aː r aː m
hard	ɦ ɑ r t
hardnekkig	ɦ ɑ r t n ɛ k ə x
hardtin	ɦ ɑ r t ɪ n
harig	ɦ aː r ə x
harmonische	ɦ ɑ r m oː n i s ə
harmonischere	ɦ ɑ r m oː n i s ə r ə
harp	ɦ ɑ r p
hartritme	ɦ ɑ r t r ɪ t m ə
hartritmestoornis	ɦ ɑ r t r ɪ t m ə s t oː r n ɪ s
hartsvriendin	ɦ ɑ r t s f r i n d ɪ n
hasjiesj	ɦ ɑ ʃ i ʃ
hatsjie	ɦ ɑ t ʃ i
havenplaats	ɦ aː v ə n p l aː t s
heb	ɦ ɛ p
hebbend	ɦ ɛ b ə n t
hector	ɦ ɛ k t ɔ r
heelmeester	ɦ eː l m eː s t ə r
heem	ɦ eː m
heeroom	ɦ eː r oː m
heersen	ɦ eː r s ə n
heideblauwtje	ɦ ɛ i̯ d ə b l ɑ u̯ t j ə
heiden	ɦ ɛ i̯ d ə n
heinen	ɦ ɛ i̯ n ə n
heipaal	ɦ ɛ i̯ p aː l
hek	ɦ ɛ k
hekkensluiter	ɦ ɛ k ə n s l œ y̯ t ə r
helaba	ɦ e l ɑ b ɑ
heleboel	ɦ eː l ə b u l
heli	ɦ eː l i
helikopter	ɦ eː l i k ɔ p t ə r
helix	ɦ eː l ɪ k s
hellegebroed	ɦ ɛ l ə ɣ ə b r u t
helling	ɦ ɛ l ɪ ŋ
helrivier	ɦ ɛ l r i v iː r
helzen	ɦ ɛ l z ə n
hemelbestormer	ɦ eː m ə l b ə s t ɔ r m ə r
hemelen	ɦ eː m ə l ə n
hemeling	ɦ eː m ə l ɪ ŋ
hemisfeer	ɦ eː m i s f eː r
heng	ɦ ɛ ŋ
hengst	ɦ ɛ ŋ s t
herdenkingsmunt	ɦ ɛ r d ɛ ŋ k ɪ ŋ s m ʏ n t
herdruk	ɦ ɛ r d r ʏ k
hermafrodisme	ɦ ɛ r m aː f r oː d ɪ s m ə
hermelijn	ɦ ɛ r m ə l ɛ i̯ n
hermelijnkoorts	ɦ ɛ r m ə l ɛ i̯ n k oː r t s
hernhutter	ɦ ɛ r n ɦ ʏ t ə r
hersenpan	ɦ ɛ r s ə n p ɑ n
hersenschim	ɦ ɛ r s ə n s x ɪ m
hersenspinsel	ɦ ɛ r s ə n s p ɪ n s ə l
hersenvlies	ɦ ɛ r s ə n v l i s
herstel	ɦ ɛ r s t ɛ l
herstelbetaling	ɦ ɛ r s t ɛ l b ə t aː l ɪ ŋ
herstellingsoord	ɦ ɛ r s t ɛ l i ŋ s oː r t
heteluchtbad	ɦ eː t ə l ʏ x t b ɑ t
heten	ɦ eː t ə n
heulen	ɦ øː l ə n
heup	ɦ øː p
heuvel	ɦ øː v ə l
hexaan	ɦ ɛ k s aː n
hexeen	ɦ ɛ k s eː n
hiel	ɦ i l
hielenlikker	ɦ iː l ə n l ɪ k ə r
hiernumaals	ɦ iː r n y m aː l s
hindi	ɦ ɪ n d i
hindoestaan	ɦ ɪ n d u s t aː n
histologie	ɦ ɪ s t oː l oː ɣ i
historisch	ɦ ɪ s t oː r i s
hit	ɦ ɪ t
hitparade	ɦ ɪ t p aː r aː d ə
hockeyen	ɦ ɔ k i ə n
hoe	ɦ u
hoedanigheidswoord	ɦ u d aː n ə x ɦ ɛ i̯ t s ʋ oː r t
hoefijzermagneet	ɦ u f ɛ i̯ z ə r m ɑ x n eː t
hoefijzermeer	ɦ u f ɛ i̯ z ə r m eː r
hoenders	ɦ u n d ə r s
hoerendop	ɦ uː r ə n d ɔ p
hoest	ɦ u s t
hoeveel	ɦ u v eː l
hoeveelheid	ɦ u v eː l ɦ ɛ i̯ t
holbewoner	ɦ ɔ l b ə ʋ oː n ə r
hollands	ɦ ɔ l ɑ n t s
holrond	ɦ ɔ l r ɔ n t
holtetje	ɦ ɔ l t ə t j ə
hongarije	ɦ ɔ ŋ ɣ aː r ɛ i̯ j ə
hoofd	ɦ oː f t
hoofdgerecht	ɦ oː f t x ə r ɛ x t
hoofdpijndossier	ɦ oː f t p ɛ i̯ n d ɔ ʃ eː
hoofdreeks	ɦ oː f t r eː k s
hoofdrol	ɦ oː f t r ɔ l
hoofdstedelijk	ɦ oː f t s t eː d ə l ə k
hoofdtelwoord	ɦ oː f t ɛ l ʋ oː r t
hoofdvak	ɦ oː f t f ɑ k
hoogbejaarde	ɦ oː x b ə j aː r d ə
hoogtezon	ɦ oː x t ə z ɔ n
hoogzwanger	ɦ oː x z ʋ ɑ ŋ ə r
hooi	ɦ oː i̯
hooiberg	ɦ oː i̯ b ɛ r x
hooiwagenkrab	ɦ oː i̯ ʋ aː ɣ ə n k r ɑ p
hopliet	ɦ ɔ p l i t
horen	ɦ oː r ə n
horloge	ɦ ɔ r l oː ʒ ə
horlogemaker	ɦ ɔ r l oː ʒ ə m aː k ə r
hosselen	ɦ ɔ s ə l ə n
hot	ɦ ɔ t
hou	ɦ ɑ u̯
houdbaarheid	ɦ ɑ u̯ t b aː r ɦ ɛ i̯ t
houdt	ɦ ɑ u̯ t
houtsnijwerk	ɦ ɑ u̯ t s n ɛ i̯ ʋ ɛ r k
houwitser	ɦ ɑ u̯ ʋ i t s ə r
hoveling	ɦ oː v ə l ɪ ŋ
huilerig	ɦ œ y̯ l ə r ə x
huin	ɦ œ y̯ n
huisbrandolie	ɦ œ y̯ s b r ɑ n t oː l i
huishoudfolie	ɦ œ y̯ s ɦ ɑ u̯ t f oː l i
huiskamer	ɦ œ y̯ s k aː m ə r
huiskerk	ɦ œ y̯ s k ɛ r k
huisraad	ɦ œ y̯ s r aː t
huisvlijt	ɦ œ y̯ s f l ɛ i̯ t
huizenbezitter	ɦ œ y̯ z ə n b ə z ɪ t ə r
huizinga	ɦ œ y̯ z ɪ ŋ ɣ aː
hulpmiddel	ɦ ʏ l p m ɪ d ə l
hulpvaardigheid	ɦ ʏ l p f aː r d ə x ɦ ɛ i̯ t
humoraal	ɦ y m oː r aː l
humus	ɦ y m ʏ s
humusrijk	ɦ y m ʏ s r ɛ i̯ k
huns	ɦ ʏ n s
huwelijksdag	ɦ y ʋ ə l ə k s d ɑ x
hyena	ɦ i j eː n aː
hyperaldosteronisme	ɦ i p ə r ɑ l d ɔ s t ə r oː n ɪ s m ə
hypergamie	ɦ i p ə r ɣ aː m i
iberen	i b eː r ə n
icarus	i k aː r ʏ s
idee	i d eː
idioot	i d i j oː t
iel	i l
ieme	i m ə
ijsbergsla	ɛ i̯ s b ɛ r x s l aː
ijscokar	ɛ i̯ s k oː k ɑ r
ijsje	ɛ i̯ s j ə
ijssel	ɛ i̯ s ə l
ijzer	ɛ i̯ z ə r
ijzervreter	ɛ i̯ z ə r v r eː t ə r
imme	ɪ m ə
improvisatie	ɪ m p r oː v i z aː t s i
inbreken	ɪ n b r eː k ə n
inbreker	ɪ n b r eː k ə r
incalculeren	ɪ n k ɑ l k y l eː r ə n
incantatie	ɪ ŋ k ɑ n t aː t s i
inchecken	ɪ n t ʃ ɛ k ə n
inclusie	ɪ n k l y z i
indianenverhaal	ɪ n d i aː n ə n v ɛ r ɦ aː l
indommelen	ɪ n d ɔ m ə l ə n
indonesië	ɪ n d oː n eː z i j ə
inergatief	ɪ n ɛ r ɣ aː t i f
infaam	ɪ n f aː m
informatiebron	ɪ n f ɔ r m aː t s i b r ɔ n
ingeval	ɪ ŋ ɣ ə v ɑ l
inhoudsmaat	ɪ n ɦ ɑ u̯ t s m aː t
injectiespuit	ɪ n j ɛ k s i s p œ y̯ t
inleven	ɪ n l eː v ə n
inoculatie	ɪ n oː k y l aː t s i
insnijden	ɪ n s n ɛ i̯ d ə n
internetcafé	ɪ n t ə r n ɛ t k aː f eː
interval	ɪ n t ə r v ɑ l
interviewster	ɪ n t ə r v j u s t ə r
intimideren	ɪ n t i m i d eː r ə n
intonatie	ɪ n t oː n aː t s i
intraveneus	ɪ n t r aː v eː n øː s
intrusief	ɪ n t r y z i f
is	ɪ s
isolatie	i z oː l aː t s i
israëli	ɪ s r aː eː l i
iteratie	i t ə r aː t s i
itter	ɪ t ə r
ivoorsnavelspecht	i v oː r s n aː v ə l s p ɛ x t
jaar	j aː r
jaarboek	j aː r b u k
jaarmarkt	j aː r m ɑ r k t
jachthoorn	j ɑ x t ɦ oː r n
jachtklok	j ɑ x t k l ɔ k
jagen	j aː ɣ ə n
jaknikker	j aː k n ɪ k ə r
jaknikkers	j aː k n ɪ k ə r s
jammervol	j ɑ m ə r v ɔ l
japanner	j ɑ p ɑ n ə r
jappenkamp	j ɑ p ə n k ɑ m p
jargon	j ɑ r ɣ ɔ n
javaans	j aː v aː n s
jeker	j eː k ə r
jenever	j ə n eː v ə r
jeneverfles	j ə n eː v ə r f l ɛ s
jeremiëren	j eː r ə m i eː r ə n
jeugdpuist	j øː x t p œ y̯ s t
jezus	j eː z ʏ s
joet	j u t
jofel	j oː f ə l
jok	j ɔ k
joker	j oː k ə r
jokkebrok	j ɔ k ə b r ɔ k
jonas	j oː n ɑ s
jonassen	j oː n ɑ s ə n
jong	j ɔ ŋ
jonge	j ɔ ŋ ə
jonker	j ɔ ŋ k ə r
joop	j oː p
jota	j oː t aː
journalisme	ʒ uː r n aː l ɪ s m ə
jouwe	j ɑ u̯ ə
jouws	j ɑ u̯ s
jubelen	j y b ə l ə n
juichen	j œ y̯ x ə n
julienne	ʒ y l i ɛ n ə
kaag	k aː x
kaal	k aː l
kaaspiet	k aː s p i t
kadaster	k aː d ɑ s t ə r
kadaver	k aː d aː v ə r
kade	k aː d ə
kakkineus	k ɑ k i n øː s
kamer	k aː m ə r
kampeer	k ɑ m p eː r
kampen	k ɑ m p ə n
kampioen	k ɑ m p i j u n
kampong	k ɑ m p ɔ ŋ
kanarievogel	k aː n aː r i v oː ɣ ə l
kanaän	k aː n aː ɑ n
kandidaat	k ɑ n d i d aː t
kandidate	k ɑ n d i d aː t ə
kaneelsuiker	k aː n eː l s œ y̯ k ə r
kangoeroe	k ɑ ŋ ɣ u r u
kanjer	k ɑ n j ə r
kanker	k ɑ ŋ k ə r
kanonneren	k aː n ɔ n eː r ə n
kansloos	k ɑ n s l oː s
kant	k ɑ n t
kanten	k ɑ n t ə n
kantoorbediende	k ɑ n t oː r b ə d i n d ə
kantoortuin	k ɑ n t oː r t œ y̯ n
kaperbrief	k aː p ə r b r i f
kaping	k aː p ɪ ŋ
kapper	k ɑ p ə r
kapster	k ɑ p s t ə r
kapstok	k ɑ p s t ɔ k
karabach	k aː r aː b ɑ x
karabijn	k aː r aː b ɛ i̯ n
karakter	k aː r ɑ k t ə r
karavaan	k aː r aː v aː n
karel	k aː r ə l
karmisch	k ɑ r m i s
kartets	k ɑ r t ɛ t s
kasjroet	k ɑ ʃ r u t
kassen	k ɑ s ə n
katana	k aː t aː n aː
kathaai	k ɑ t ɦ aː i̯
kech	k ɛ x
keelzang	k eː l z ɑ ŋ
kehilla	k ə ɦ ɪ l aː
kehille	k ə ɦ ɪ l ə
kelt	k ɛ l t
kennel	k ɛ n ə l
kentaur	k ɛ n t ɑ u̯ ə r
kerkburcht	k ɛ r k b ʏ r x t
kerkdeur	k ɛ r k d øː r
kerkdienst	k ɛ r k d i n s t
kerkgenootschap	k ɛ r k x ə n oː t s x ɑ p
kerkorgel	k ɛ r k ɔ r ɣ ə l
kermen	k ɛ r m ə n
kermisklant	k ɛ r m ɪ s k l ɑ n t
kern	k ɛ r n
kerncentrale	k ɛ r n s ɛ n t r aː l ə
kerngezin	k ɛ r n ɣ ə z ɪ n
kernonderzeeboot	k ɛ r n ɔ n d ə r z eː b oː t
kerstmarkt	k ɛ r s t m ɑ r k t
kerstmuziek	k ɛ r s t m y z i k
kerststal	k ɛ r s t ɑ l
kerststol	k ɛ r s t ɔ l
ketel	k eː t ə l
ketting	k ɛ t ɪ ŋ
kettingkogel	k ɛ t ɪ ŋ k oː ɣ ə l
kettingroker	k ɛ t ɪ ŋ r oː k ə r
keur	k øː r
keurleger	k øː r l eː ɣ ə r
keus	k øː s
kever	k eː v ə r
kickbokser	k ɪ k b ɔ k s ə r
kielzog	k i l z ɔ x
kiev	k i j ɛ f
kim	k ɪ m
kinderkopje	k ɪ n d ə r k ɔ p j ə
kinderstoel	k ɪ n d ə r s t u l
kinderwagen	k ɪ n d ə r ʋ aː ɣ ə n
kindsoldaat	k ɪ n t s ɔ l d aː t
kinine	k i n i n ə
kinshasa	k ɪ n ʃ aː s aː
kippenborst	k ɪ p ə n b ɔ r s t
kippenbout	k ɪ p ə n b ɑ u̯ t
kippenren	k ɪ p ə n r ɛ n
kippensoep	k ɪ p ə n s u p
kippenvoeder	k ɪ p ə n v u d ə r
kippig	k ɪ p ə x
kits	k ɪ t s
klaas	k l aː s
klagen	k l aː ɣ ə n
klampen	k l ɑ m p ə n
klapperdief	k l ɑ p ə r d i f
klaver	k l aː v ə r
kleerkast	k l eː r k ɑ s t
kleingeld	k l ɛ i̯ n ɣ ɛ l t
kleinood	k l ɛ i̯ n oː t
kleintje	k l ɛ i̯ n t j ə
kleur	k l øː r
kleurentelevisie	k l øː r ə n t eː l ə v i z i
kleuterleidster	k l øː t ə r l ɛ i̯ t s t ə r
klier	k l iː r
klimaatcrimineel	k l i m aː t k r i m i n eː l
klimaatkanarie	k l i m aː t k aː n aː r i
klimaatschieten	k l i m aː t s x i t ə n
klimaatstaking	k l i m aː t s t aː k ɪ ŋ
klimplant	k l ɪ m p l ɑ n t
klinkerharmonie	k l ɪ ŋ k ə r ɦ ɑ r m oː n i
kloek	k l u k
klompendans	k l ɔ m p ə n d ɑ n s
klont	k l ɔ n t
kloosterling	k l oː s t ə r l ɪ ŋ
kloot	k l oː t
klootviool	k l oː t f i oː l
kloppen	k l ɔ p ə n
knaak	k n aː k
knagen	k n aː ɣ ə n
knaller	k n ɑ l ə r
knie	k n i
knisperen	k n ɪ s p ə r ə n
knoeperd	k n u p ə r d
knoert	k n u r t
knokfilm	k n ɔ k f ɪ l m
knolraap	k n ɔ l r aː p
knotwilg	k n ɔ t ʋ ɪ l x
knuffelbeer	k n ʏ f ə l b eː r
knuffeldier	k n ʏ f ə l d iː r
knurft	k n ʏ r f t
kocht	k ɔ x t
kochten	k ɔ x t ə n
koeienhandel	k u j ə n ɦ ɑ n d ə l
koeioneren	k u j oː n eː r ə n
koelkast	k u l k ɑ s t
koeltoren	k u l t oː r ə n
koets	k u t s
koetsier	k u t s iː r
koffieautomaat	k ɔ f i ɑ u̯ t oː m aː t
koffiedik	k ɔ f i d ɪ k
kofschip	k ɔ f s x ɪ p
koikarper	k ɔ i̯ k ɑ r p ə r
kokerworm	k oː k ə r ʋ ɔ r m
kokosbrood	k oː k ɔ s b r oː t
kokospalm	k oː k ɔ s p ɑ l m
koksmaat	k ɔ k s m aː t
kolengas	k oː l ə n ɣ ɑ s
kolken	k ɔ l k ə n
koloniaal	k oː l oː n i aː l
kolonie	k oː l oː n i
kompromat	k ɔ m p r oː m ɑ t
kondigen	k ɔ n d ə ɣ ə n
konijn	k oː n ɛ i̯ n
koningsmoord	k oː n ɪ ŋ s m oː r t
koolraap	k oː l r aː p
koop	k oː p
kopen	k oː p ə n
koptisch	k ɔ p t i s
kopvoorn	k ɔ p f oː r n
koraalrood	k oː r aː l r oː t
korea	k oː r eː aː
koreaan	k oː r eː aː n
korf	k ɔ r f
korporaal	k ɔ r p oː r aː l
kortharig	k ɔ r t ɦ aː r ə x
kortheid	k ɔ r t ɦ ɛ i̯ t
korvet	k ɔ r v ɛ t
kosmopolitisme	k ɔ s m oː p oː l i t ɪ s m ə
kosmopolitismus	k ɔ s m oː p oː l i t ɪ s m ʏ s
kosovo	k ɔ s oː v oː
kostelijk	k ɔ s t ə l ə k
kosteloost	k ɔ s t ə l oː s t
kostelozer	k ɔ s t ə l oː z ə r
kou	k ɑ u̯
kout	k ɑ u̯ t
kraamsterfte	k r aː m s t ɛ r f t ə
kraan	k r aː n
krachtdadig	k r ɑ x t d aː d ə x
krachtmeting	k r ɑ x t m eː t ɪ ŋ
krachtterm	k r ɑ x t ɛ r m
kraker	k r aː k ə r
kranssalie	k r ɑ n s aː l i
kregelig	k r eː ɣ ə l ə x
krent	k r ɛ n t
kreupel	k r øː p ə l
krieken	k r i k ə n
krielkip	k r i l k ɪ p
krijgsgod	k r ɛ i̯ x s x ɔ t
krijt	k r ɛ i̯ t
krijten	k r ɛ i̯ t ə n
krikken	k r ɪ k ə n
kristalsuiker	k r ɪ s t ɑ l s œ y̯ k ə r
kroatië	k r oː aː t s i j ə
krokusvakantie	k r oː k ʏ s f aː k ɑ n t s i
kronen	k r oː n ə n
kroon	k r oː n
kroondomein	k r oː n d oː m ɛ i̯ n
kruid	k r œ y̯ t
kruimeldief	k r œ y̯ m ə l d i f
kruin	k r œ y̯ n
kruipdier	k r œ y̯ p d iː r
kruisbes	k r œ y̯ s b ɛ s
kruispunt	k r œ y̯ s p ʏ n t
kruitschip	k r œ y̯ t s x ɪ p
krul	k r ʏ l
kuifeend	k œ y̯ f eː n t
kunstnier	k ʏ n s t n iː r
kunstrechterlijk	k ʏ n s t r ɛ x t ə r l ə k
kunstvlieg	k ʏ n s t f l i x
kunstwerk	k ʏ n s t ʋ ɛ r k
kurk	k ʏ r k
kurkdroog	k ʏ r k d r oː x
kussen	k ʏ s ə n
kustgebergte	k ʏ s t x ə b ɛ r x t ə
kustwater	k ʏ s t ʋ aː t ə r
kuur	k y r
kwaakschool	k ʋ aː k s x oː l
kwart	k ʋ ɑ r t
kwartierdrager	k ʋ ɑ r t iː r d r aː ɣ ə r
kweekhuis	k ʋ eː k ɦ œ y̯ s
kwelder	k ʋ ɛ l d ə r
kwibus	k ʋ i b ʏ s
kwitantie	k ʋ i t ɑ n t s i
laag	l aː x
laaggebergte	l aː x ə b ɛ r x t ə
laarst	l aː r s t
laatste	l aː t s t ə
labber	l ɑ b ə r
labradoedel	l aː b r aː d u d ə l
lager	l aː ɣ ə r
lakken	l ɑ k ə n
lam	l ɑ m
lamantijn	l aː m ɑ n t ɛ i̯ n
lamoen	l aː m u n
landdrost	l ɑ n t d r ɔ s t
lande	l ɑ n d ə
landelijk	l ɑ n d ə l ə k
landingsgestel	l ɑ n d ɪ ŋ s x ə s t ɛ l
landmijn	l ɑ n t m ɛ i̯ n
landname	l ɑ n t n aː m ə
landschap	l ɑ n t s x ɑ p
lange	l ɑ ŋ ə
langeafstandsrenner	l ɑ ŋ ə ɑ f s t ɑ n t s r ɛ n ə r
langlaufen	l ɑ ŋ l ɑ u̯ f ə n
langwerpig	l ɑ ŋ ʋ ɛ r p ə x
laptop	l ɛ p t ɔ p
larie	l aː r i
last	l ɑ s t
lastdier	l ɑ s d iː r
lastpak	l ɑ s t p ɑ k
latuw	l aː t y u̯
lauwer	l ɑ u̯ ə r
lavement	l aː v ə m ɛ n t
ledemaat	l eː d ə m aː t
leder	l eː d ə r
ledikant	l eː d i k ɑ n t
leedvermaak	l eː t f ə r m aː k
leefgebied	l eː f x ə b i t
leer	l eː r
leerstellig	l eː r s t ɛ l ə x
leeuwin	l eː u̯ ʋ ɪ n
lefgozer	l ɛ f x oː z ə r
leg	l ɛ x
legboor	l ɛ x b oː r
leidingwater	l ɛ i̯ d ɪ ŋ ʋ aː t ə r
lekentaal	l eː k ə n t aː l
lelijkerd	l eː l ə k ə r t
lelystad	l eː l i s t ɑ t
lepel	l eː p ə l
leraar	l eː r aː r
letten	l ɛ t ə n
lettervrucht	l ɛ t ə r v r ʏ x t
leugenliteratuur	l øː ɣ ə n l i t ə r aː t yː r
leuze	l øː z ə
levensbeschrijver	l eː v ə n s b ə s x r ɛ i̯ v ə r
levensgezel	l eː v ə n s x ə z ɛ l
levensmiddel	l eː v ə n s m ɪ d ə l
levensvatbaarheid	l eː v ə n s f ɑ t b aː r ɦ ɛ i̯ t
libel	l i b ɛ l
lichaamstaal	l ɪ x aː m s t aː l
lichtkroon	l ɪ x t k r oː n
lichtmis	l ɪ x t m ɪ s
liefhebben	l i f ɦ ɛ b ə n
lierhert	l iː r ɦ ɛ r t
lijd	l ɛ i̯ t
lijk	l ɛ i̯ k
lijkenpikker	l ɛ i̯ k ə n p ɪ k ə r
lijkenveld	l ɛ i̯ k ə n v ɛ l t
lijm	l ɛ i̯ m
lijnintegraal	l ɛ i̯ n ɪ n t ə ɣ r aː l
lijnolie	l ɛ i̯ n oː l i
lijvig	l ɛ i̯ v ə x
likker	l ɪ k ə r
limiet	l i m i t
limo	l i m oː
limoen	l i m u n
limonade	l i m oː n aː d ə
linda	l ɪ n d aː
lindeboom	l ɪ n d ə b oː m
liniaal	l i n i aː l
links	l ɪ ŋ k s
lionne	l i ɔ n ə
lippenstift	l ɪ p ə n s t ɪ f t
liquiditeitsval	l i k ʋ i d i t ɛ i̯ t s f ɑ l
living	l ɪ v ɪ ŋ
lobben	l ɔ b ə n
loebas	l u b ɑ s
logisch	l oː ɣ i s
lokoma	l ɔ k oː m aː
lol	l ɔ l
lontroer	l ɔ n t r uː r
looien	l oː i̯ ə n
loom	l oː m
loslaten	l ɔ s l aː t ə n
lover	l oː v ə r
luchtbel	l ʏ x t b ɛ l
luchthaven	l ʏ x t ɦ aː v ə n
luchtledig	l ʏ x t l eː d ə x
luchtvervuiling	l ʏ x t f ə r v œ y̯ l ɪ ŋ
lucifer	l y s i f ɛ r
luide	l œ y̯ d ə
luier	l œ y̯ ə r
luiken	l œ y̯ k ə n
luisteren	l œ y̯ s t ə r ə n
lullificatie	l ʏ l i f i k aː t s i
lullo	l ʏ l oː
lunchen	l ʏ n ʃ ə n
lustmoordenaar	l ʏ s t m oː r d ə n aː r
lustoord	l ʏ s t oː r t
luttel	l ʏ t ə l
maagzakdier	m aː x s ɑ k d iː r
maaien	m aː i̯ ə n
maakloon	m aː k l oː n
maakten	m aː k t ə n
maanvis	m aː n v ɪ s
maatpak	m aː t p ɑ k
machtiging	m ɑ x t ə ɣ ɪ ŋ
maffia	m ɑ f i aː
magneetkop	m ɑ x n eː t k ɔ p
magnolia	m ɑ x n oː l i aː
majemen	m aː j ə m ə n
majoor	m aː j oː r
makkelijk	m ɑ k ə l ə k
maldoenerij	m ɑ l d u n ə r ɛ i̯
mallemolen	m ɑ l ə m oː l ə n
mallotig	m ɑ l oː t ə x
malware	m ɑ l ʋ ɛː r
mamzer	m ɑ m z ə r
manbeer	m ɑ n b eː r
manchetknoop	m ɑ n ʃ ɛ t k n oː p
mandeïsme	m ɑ n d eː ɪ s m ə
maneschijn	m aː n ə s x ɛ i̯ n
manipel	m aː n i p ə l
mannenvoetbal	m ɑ n ə n v u t b ɑ l
mantelpak	m ɑ n t ə l p ɑ k
mantelzorger	m ɑ n t ə l z ɔ r ɣ ə r
mantiek	m ɑ n t i k
mantisch	m ɑ n t i s
manx	m ɑ ŋ k s
marije	m aː r ɛ i̯ ə
marionettenproces	m aː r i oː n ɛ t ə n p r oː s ɛ s
markermeer	m ɑ r k ə r m eː r
marktplaats	m ɑ r k t p l aː t s
marmiet	m ɑ r m i t
marmot	m ɑ r m ɔ t
marterachtige	m ɑ r t ə r ɑ x t ə ɣ ə
marva	m ɑ r v aː
marxistisch	m ɑ r k s ɪ s t i s
massavernietigingswapen	m ɑ s aː v ə r n i t ə ɣ ɪ ŋ s ʋ aː p ə n
mastkorf	m ɑ s t k ɔ r f
matglas	m ɑ t x l ɑ s
matglazen	m ɑ t x l aː z ə n
matrixbord	m aː t r ɪ x b ɔ r t
mavo	m aː v oː
maximum	m ɑ k s i m ʏ m
mazzelpik	m ɑ z ə l p ɪ k
maçonniek	m ɑ s ɔ n i k
maïzena	m ɑ i z eː n aː
mededinging	m eː d ə d ɪ ŋ ɪ ŋ
mededogen	m eː d ə d oː ɣ ə n
medeplichtig	m eː d ə p l ɪ x t ə x
mediageil	m eː d i aː ɣ ɛ i̯ l
medicatie	m eː d i k aː t s i
medicijn	m eː d i s ɛ i̯ n
mediëvist	m eː d i eː v ɪ s t
meerkoet	m eː r k u t
meertalig	m eː r t aː l ə x
meerwaarde	m eː r ʋ aː r d ə
meestervuurwerker	m eː s t ə r v yː r ʋ ɛ r k ə r
meeuwis	m eː u̯ ɪ s
mei	m ɛ i̯
meier	m ɛ i̯ j ə r
meike	m ɛ i̯ k ə
meikever	m ɛ i̯ k eː v ə r
melasse	m ə l ɑ s ə
melktand	m ɛ l k t ɑ n t
melkveehouderij	m ɛ l k f eː ɦ ɑ u̯ d ə r ɛ i̯
melkweg	m ɛ l k ʋ ɛ x
melodie	m eː l oː d i
meloen	m ə l u n
melomaan	m eː l oː m aː n
meningsuiting	m eː n ɪ ŋ s œ y̯ t ɪ ŋ
mens	m ɛ n s
mensenhaai	m ɛ n s ə n ɦ aː i̯
mensenrechtenactivist	m ɛ n s ə n r ɛ x t ə n ɑ k t i v ɪ s t
messing	m ɛ s ɪ ŋ
mesten	m ɛ s t ə n
metadata	m eː t aː d aː t aː
metempsychose	m eː t ɛ m p s i x oː z ə
metropool	m eː t r oː p oː l
metworst	m ɛ t ʋ ɔ r s t
middageten	m ɪ d ɑ x eː t ə n
middeleeuwen	m ɪ d ə l eː u̯ ə n
middenmoter	m ɪ d ə n m oː t ə r
mierenneuker	m iː r ə n øː k ə r
miezer	m i z ə r
mijl	m ɛ i̯ l
mijnenveld	m ɛ i̯ n ə n v ɛ l t
mijner	m ɛ i̯ n ə r
milieuambtenaar	m ɪ l j øː ɑ m p t ə n aː r
milieuheffing	m ɪ l j øː ɦ ɛ f ɪ ŋ
milieumisdrijf	m ɪ l j øː m ɪ s d r ɛ i̯ f
militarist	m i l i t aː r ɪ s t
militie	m i l i t s i
miltvuurbrief	m ɪ l t f yː r b r i f
minderen	m ɪ n d ə r ə n
mineraalarm	m i n ə r aː l ɑ r m
mirakel	m i r aː k ə l
mirjam	m ɪ r j ɑ m
misantroop	m i z ɑ n t r oː p
misbruik	m ɪ s b r œ y̯ k
mishandelen	m ɪ s ɦ ɑ n d ə l ə n
miskraam	m ɪ s k r aː m
missie	m ɪ s i
mobieltje	m oː b i l t j ə
modderbank	m ɔ d ə r b ɑ ŋ k
modderfiguur	m ɔ d ə r f i ɣ yː r
modern	m oː d ɛ r n
moeder	m u d ə r
moederbord	m u d ə r b ɔ r t
moederloog	m u d ə r l oː x
moedersterfte	m u d ə r s t ɛ r f t ə
moedertaalspreekster	m u d ə r t aː l s p r eː k s t ə r
moedertaalsprekers	m u d ə r t aː l s p r eː k ə r s
moeren	m uː r ə n
moerhoen	m uː r ɦ u n
moezel	m u z ə l
moffenhoer	m ɔ f ə n ɦ uː r
molen	m oː l ə n
molensteen	m oː l ə n s t eː n
mollen	m ɔ l ə n
molotovcocktail	m oː l oː t ɔ f k ɔ k t eː l
monarchisch	m oː n ɑ r x i s
monarchist	m oː n ɑ r x ɪ s t
mondvoorraad	m ɔ n t f oː r aː t
monica	m oː n i k aː
monocle	m oː n ɔ k l ə
monovolume	m oː n oː v oː l y m ə
monteren	m ɔ n t eː r ə n
mooist	m oː i̯ s t
morgen	m ɔ r ɣ ə n
morsig	m ɔ r s ə x
mortuarium	m ɔ r t y aː r i ʏ m
mos	m ɔ s
mosselhangcultuur	m ɔ s ə l ɦ ɑ ŋ k ʏ l t yː r
mottig	m ɔ t ə x
mozaïek	m oː z aː i k
muggenzifter	m ʏ ɣ ə n z ɪ f t ə r
muggezifter	m ʏ ɣ ə z ɪ f t ə r
muilpeer	m œ y̯ l p eː r
muntstuk	m ʏ n t s t ʏ k
muntunie	m ʏ n t y n i
murks	m ʏ r k s
museum	m y z eː ʏ m
muskuskat	m ʏ s k ʏ s k ɑ t
muskusrat	m ʏ s k ʏ s r ɑ t
muuranker	m yː r ɑ ŋ k ə r
muziekdoos	m y z i k d oː s
muzikaal	m y z i k aː l
myriameter	m iː r i aː m eː t ə r
mythisch	m i t i s
naald	n aː l t
naamwoordelijk	n aː m ʋ oː r d ə l ə k
naast	n aː s t
naaste	n aː s t ə
nablijven	n aː b l ɛ i̯ v ə n
naderen	n aː d ə r ə n
nadorst	n aː d ɔ r s t
nagaan	n aː ɣ aː n
nagras	n aː ɣ r ɑ s
nalever	n aː l eː v ə r
namen	n aː m ə n
nap	n ɑ p
napalm	n aː p ɑ l m
narrenschip	n ɑ r ə n s x ɪ p
nasaal	n aː z aː l
nat	n ɑ t
nathalie	n aː t aː l i
nationaal	n aː t ʃ oː n aː l
natuurgeweld	n aː t yː r ɣ ə ʋ ɛ l t
natuurschoon	n aː t yː r x oː n
natuurtalent	n aː t yː r t aː l ɛ n t
navalisme	n aː v aː l ɪ s m ə
navelpiercing	n aː v ə l p iː r s ɪ ŋ
navolgingen	n aː v ɔ l x ɪ ŋ ə n
necrose	n eː k r oː z ə
nederduits	n eː d ə r d œ y̯ t s
neeltje	n eː l t j ə
neem	n eː m
neerbeek	n eː r b eː k
neerdalen	n eː r d aː l ə n
nefast	n eː f ɑ s t
negen	n eː ɣ ə n
negenoog	n eː ɣ ə n oː x
negentien	n eː ɣ ə n t i n
negentig	n eː ɣ ə n t ə x
neger	n eː ɣ ə r
negerzoen	n eː ɣ ə r z u n
neonataal	n eː oː n aː t aː l
netwerk	n ɛ t ʋ ɛ r k
neukbaar	n øː k b aː r
neusaap	n øː s aː p
neusbeer	n øː s b eː r
neusklank	n øː s k l ɑ ŋ k
nicotine	n i k oː t i n ə
nietmachine	n i t m aː ʃ i n ə
nieuw	n i u̯
nieuweling	n i u̯ ə l ɪ ŋ
nieuws	n i u̯ s
nieuwsanker	n i u̯ s ɑ ŋ k ə r
nieuwsgier	n i u̯ s x iː r
nieuwslezer	n i u̯ s l eː z ə r
nieuwslezeres	n i u̯ s l eː z ə r ɛ s
nijdas	n ɛ i̯ d ɑ s
nijmegen	n ɛ i̯ m eː ɣ ə n
nikkel	n ɪ k ə l
nix	n ɪ k s
noach	n oː ɑ x
nol	n ɔ l
nonna	n ɔ n aː
noodlottig	n oː t l ɔ t ə x
noorden	n oː r d ə n
noordwestblok	n oː r t ʋ ɛ s t b l ɔ k
noordzeekrab	n oː r t s eː k r ɑ p
noot	n oː t
normaalvector	n ɔ r m aː l v ɛ k t ɔ r
nuffig	n ʏ f ə x
nul	n ʏ l
nutsbank	n ʏ t s b ɑ ŋ k
oceaan	oː s eː j aː n
oedipuscomplex	ɔ i̯ d i p u s k ɔ m p l ɛ k s
oefen	u f ə n
oelewapper	u l ə ʋ ɑ p ə r
oerle	uː r l ə
oersoep	uː r s u p
oersterk	uː r s t ɛ r k
oerstom	uː r s t ɔ m
oertekst	uː r t ɛ k s t
oesters	u s t ə r s
oezbeeks	u z b eː k s
oezbekistan	u z b eː k i s t ɑ n
oliedom	oː l i d ɔ m
olifantsvogel	oː l i f ɑ n t s f oː ɣ ə l
olijf	oː l ɛ i̯ f
olijfboom	oː l ɛ i̯ f b oː m
olijfgaard	oː l ɛ i̯ f ɣ aː r t
oma	oː m aː
ombudspersoon	ɔ m b ʏ t s p ɛ r s oː n
omcirkelen	ɔ m s ɪ r k ə l ə n
omgeven	ɔ m ɣ eː v ə n
omissie	oː m ɪ s i
omkijken	ɔ m k ɛ i̯ k ə n
omkleden	ɔ m k l eː d ə n
omkleed	ɔ m k l eː t
omslaan	ɔ m s l aː n
omvatten	ɔ m v ɑ t ə n
omzetting	ɔ m z ɛ t ɪ ŋ
omzien	ɔ m z i n
omzomen	ɔ m z oː m ə n
onbenul	ɔ n b ə n ʏ l
onbestaanbaar	ɔ m b ə s t aː n b aː r
onbeteugelbaar	ɔ n b ə t øː ɣ ə l b aː r
onderaanvoerder	ɔ n d ə r aː n v uː r d ə r
onderbenutting	ɔ n d ə r b ə n ʏ t ɪ ŋ
onderbouwen	ɔ n d ə r b ɑ u̯ ə n
onderduiker	ɔ n d ə r d œ y̯ k ə r
ondergrens	ɔ n d ə r ɣ r ɛ n s
onderhouden	ɔ n d ə r ɦ ɑ u̯ d ə n
onderjurk	ɔ n d ə r j ʏ r k
onderkennen	ɔ n d ə r k ɛ n ə n
ondermijnen	ɔ n d ə r m ɛ i̯ n ə n
onderscheidde	ɔ n d ə r s x ɛ i̯ d ə
onderscheide	ɔ n d ə r s x ɛ i̯ d ə
onderscheiding	ɔ n d ə r s x ɛ i̯ d ɪ ŋ
onderscheidt	ɔ n d ə r s x ɛ i̯ t
onderscheppen	ɔ n d ə r s x ɛ p ə n
onderschrijven	ɔ n d ə r s x r ɛ i̯ v ə n
ondervangen	ɔ n d ə r v ɑ ŋ ə n
onderwaterzicht	ɔ n d ə r ʋ aː t ə r z ɪ x t
onderwijzer	ɔ n d ə r ʋ ɛ i̯ z ə r
onderzeebootmoederschip	ɔ n d ə r z eː b oː t m u d ə r s x ɪ p
onderzoeksmethode	ɔ n d ə r z u k s m eː t oː d ə
onen	oː n ə n
ongelezen	ɔ̃ ŋ ɣ ə l eː z ə n
ongeloofwaardig	ɔ n ɣ ə l oː f ʋ aː r d ə x
ongelukkig	ɔ n ɣ ə l ʏ k ə x
onlogisch	ɔ n l oː ɣ i s
onoorbaar	ɔ n oː r b aː r
onpartijdig	ɔ m p ɑ r t ɛ i̯ d ə x
ontbijt	ɔ n t b ɛ i̯ t
ontbinden	ɔ n t b ɪ n d ə n
ontcijferen	ɔ n t s ɛ i̯ f ə r ə n
ontdubbelen	ɔ n t d ʏ b ə l ə n
ontginnen	ɔ n t x ɪ n ə n
ontgraten	ɔ n t ɣ r aː t ə n
ontgroening	ɔ n t x r u n ɪ ŋ
ontharden	ɔ n t ɦ ɑ r d ə n
onthoofd	ɔ n t ɦ oː f t
onthoofden	ɔ n t ɦ oː f d ə n
ontkiemen	ɔ n t k i m ə n
ontkleden	ɔ n t k l eː d ə n
ontkoppelen	ɔ n t k ɔ p ə l ə n
ontkurken	ɔ n t k ʏ r k ə n
ontmaagden	ɔ n t m aː x d ə n
ontmantelen	ɔ n t m ɑ n t ə l ə n
ontmaskeren	ɔ n t m ɑ s k ə r ə n
ontmythologiseren	ɔ n t m i t oː l oː ɣ i z eː r ə n
ontroeren	ɔ n t r u r ə n
ontsmetten	ɔ n t s m ɛ t ə n
ontspringen	ɔ n t s p r ɪ ŋ ə n
ontvang	ɔ n t f ɑ ŋ
ontvlammen	ɔ n t v l ɑ m ə n
ontvlooien	ɔ n t f l oː i̯ ə n
ontvreemden	ɔ n t v r eː m d ə n
ontwarren	ɔ n t ʋ ɑ r ə n
ontwijken	ɔ n t ʋ ɛ i̯ k ə n
ontwikkelen	ɔ n t ʋ ɪ k ə l ə n
ontwortelen	ɔ n t ʋ ɔ r t ə l ə n
oog	oː x
ooi	oː i̯
oomzegster	oː m z ɛ x s t ə r
oorbel	oː r b ɛ l
oordeel	oː r d eː l
oorlogsheld	oː r l ɔ ɣ s ɦ ɛ l t
oorlogsverleden	oː r l ɔ x s f ə r l eː d ə n
oorlogsverslaggever	oː r l ɔ x s f ə r s l ɑ x eː v ə r
oorsmeer	oː r s m eː r
opbouw	ɔ p b ɑ u̯
opdrinken	ɔ p d r i ŋ k ə n
openbaring	oː p ə n b aː r ɪ ŋ
operahuis	oː p ə r aː ɦ œ y̯ s
operatie	oː p ə r aː t s i
opfokken	ɔ p f ɔ k ə n
opgraven	ɔ p x r aː v ə n
ophaalbrug	ɔ p ɦ aː l b r ʏ x
ophokplicht	ɔ p ɦ ɔ k p l ɪ x t
opperhuid	ɔ p ə r ɦ œ y̯ t
oproer	ɔ p r uː r
oproerig	ɔ p r uː r ə x
opscheren	ɔ p s x eː r ə n
opstaan	ɔ p s t aː n
opstel	ɔ p s t ɛ l
optronisch	ɔ p t r oː n i s
opvanghuis	ɔ p f ɑ ŋ ɦ œ y̯ s
oratorium	oː r aː t oː r i ʏ m
orderidder	ɔ r d ə r ɪ d ə r
orgasme	ɔ r ɣ ɑ s m ə
orgelaar	ɔ r ɣ ə l aː r
orgelen	ɔ r ɣ ə l ə n
ork	ɔ r k
orthodontie	ɔ r t oː d ɔ n t s i
osso	ɔ s oː
osteoporose	ɔ s t eː oː p oː r oː z ə
oubollig	ɑ u b ɔ l ə x
oude	ɑ u̯ d ə
ouders	ɑ u̯ d ə r s
ouvreuse	u v r øː z ə
ouwe	ɑ u̯ ə
ovaal	oː v aː l
ovatie	o ʋ a t s i
oven	oː v ə n
ovenvers	oː v ə n v ɛ r s
ovenwant	oː v ə n ʋ ɑ n t
overbelichten	oː v ə r b ə l ɪ x t ə n
overdraagbaarheid	oː v ə r d r aː x b aː r ɦ ɛ i̯ t
overeten	oː v ə r eː t ə n
overhoren	oː v ə r ɦ oː r ə n
overijssel	oː v ə r ɛ i̯ s ə l
overleven	oː v ə r l eː v ə n
overnachten	oː v ə r n ɑ x t ə n
overpeinzen	oː v ə r p ɛ i̯ n z ə n
overrijden	oː v ə r ɛ i̯ d ə n
overschrijving	oː v ə r s x r ɛ ɪ v ɪ ŋ
oversekst	oː v ə r s ɛ k s t
overspannen	oː v ə r s p ɑ n ə n
overspelig	oː v ə r s p ɛ l ə x
overtreden	oː v ə r t r eː d ə n
overvragen	oː v ə r v r aː ɣ ə n
overwelven	oː v ə r ʋ ɛ l v ə n
overzetten	oː v ə r z ɛ t ə n
overzicht	oː v ə r z ɪ x t
ozonlaag	oː z ɔ n l aː x
paal	p aː l
paardenmiddel	p aː r d ə n m ɪ d ə l
paasbloem	p aː s b l u m
paasdag	p aː s d ɑ x
paasei	p aː s ɛ i̯
paasstol	p aː s t ɔ l
pafzak	p ɑ f s ɑ k
pagadder	p aː ɣ ɑ d ə r
pagode	p aː ɣ oː d ə
palladium	p ɑ l aː d i ʏ m
palm	p ɑ l m
palmkruis	p ɑ l m k r œ y̯ s
pamfletten	p ɑ m f l ɛ t ə n
pan	p ɑ n
panslavisme	p ɑ n s l aː v ɪ s m ə
pantheïsme	p ɑ n t eː ɪ s m ə
pantoffeldier	p ɑ n t ɔ f ə l d iː r
pantserjuffer	p ɑ n t s ə r j ʏ f ə r
pap	p ɑ p
pappa	p ɑ p aː
pappen	p ɑ p ə n
paraboolduin	p aː r aː b oː l d œ y̯ n
parachute	p aː r aː ʃ y t
parafilosoof	p aː r aː f i l oː s oː f
paramagnetisch	p aː r aː m ɑ x n eː t i s
parasiet	p aː r aː s i t
pardoes	p ɑ r d u s
pardon	p ɑ r d ɔ n
parelhoen	p aː r ə l ɦ u n
parlement	p ɑ r l ə m ɛ n t
parsec	p ɑ r s ɛ k
partijganger	p ɑ r t ɛ i̯ ɣ ɑ ŋ ə r
parvenu	p ɑ r v ə n y
pasfoto	p ɑ s f oː t oː
passement	p ɑ s ə m ɛ n t
passief	p ɑ s iː f
past	p ɑ s t
pastinaak	p ɑ s t i n aː k
patriarchaal	p aː t r i ɑ r x aː l
patrouille	p aː t r u j ə
patser	p ɑ t s ə r
peetvader	p eː t f aː d ə r
pendelbus	p ɛ n d ə l b ʏ s
penoze	p ə n oː z ə
pens	p ɛ n s
periost	p eː r i ɔ s t
peritoneum	p eː r i t oː n eː ʏ m
perzik	p ɛ r z ɪ k
peuzelen	p øː z ə l ə n
picknicken	p ɪ k n ɪ k ə n
pielemuis	p i l ə m œ y̯ s
pijl	p ɛ i̯ l
pijltjesmethode	p ɛ i̯ l t j ə s m eː t oː d ə
pijlworm	p ɛ i̯ l ʋ ɔ r m
pijp	p ɛ i̯ p
pijpaarde	p ɛ i̯ p aː r d ə
pijpeneren	p ɛ i̯ p ə n eː r ə n
pijpenkrul	p ɛ i̯ p ə n k r ʏ l
pikaks	p ɪ k ɑ k s
pilaar	p i l aː r
pilaster	p i l ɑ s t ə r
pin	p ɪ n
pincet	p ɪ n s ɛ t
pion	p i ɔ n
piraat	p i r aː t
pirateren	p i r aː t eː r ə n
pirouette	p i r u ɛ t ə
pissebed	p ɪ s ə b ɛ t
pistool	p i s t oː l
pitstraat	p ɪ t s t r aː t
pittig	p ɪ t ə x
plaag	p l aː x
plaatsnaam	p l aː t s n aː m
plaatwerk	p l aː t ʋ ɛ r k
plasma	p l ɑ s m aː
plasmide	p l ɑ s m i d ə
plattelander	p l ɑ t ə l ɑ n d ə r
plee	p l eː
plegen	p l eː ɣ ə n
pleinvrees	p l ɛ i̯ n v r eː s
pleiten	p l ɛ i̯ t ə n
pletterpet	p l ɛ t ə r p ɛ t
pleuritis	p l øː r i t ə s
plicht	p l ɪ x t
plichtsbesef	p l ɪ x t s b ə s ɛ f
ploeteren	p l u t ə r ə n
plofkip	p l ɔ f k ɪ p
plofklank	p l ɔ f k l ɑ ŋ k
ploten	p l oː t ə n
pluviograaf	p l y v i o ɣ r a f
poedel	p u d ə l
poedelnaakt	p u d ə l n aː k t
poeder	p u d ə r
poedersuiker	p u d ə r s œ y̯ k ə r
poeslief	p u s l i f
poet	p u t
polder	p ɔ l d ə r
pons	p ɔ n s
pook	p oː k
poolbeer	p oː l b eː r
poppenhuis	p ɔ p ə n ɦ œ y̯ s
porto	p ɔ r t oː
postbode	p ɔ s t b oː d ə
postzegel	p ɔ s t s eː ɣ ə l
potsierlijk	p ɔ t s i r l ə k
praatprogramma	p r aː t p r oː ɣ r ɑ m aː
praatziek	p r aː t s i k
praktisch	p r ɑ k t i s
prefix	p r eː f ɪ k s
preken	p r eː k ə n
premonstratenzer	p r eː m ɔ n s t r aː t ɛ n z ə r
presidentschap	p r eː z i d ɛ n t s x ɑ p
pretpakket	p r ɛ t p ɑ k ɛ t
priester	p r i s t ə r
primaat	p r i m aː t
prinsdom	p r ɪ n s d ɔ m
printer	p r ɪ n t ə r
procrustes	p r oː k r ʏ s t ə s
product	p r oː d ʏ k t
productiefactor	p r oː d ʏ k t s i f ɑ k t ɔ r
proefdier	p r u f d iː r
proefkonijn	p r u f k oː n ɛ i̯ n
progressief	p r oː ɣ r ɛ s i f
pronkziek	p r ɔ ŋ k s i k
prop	p r ɔ p
propaan	p r oː p aː n
propvol	p r ɔ p f ɔ l
protesteren	p r oː t ɛ s t eː r ə n
proteststem	p r oː t ɛ s t s t ɛ m
provider	p r oː v ɑ i̯ d ə r
pruikentijd	p r œ y̯ k ə n t ɛ i̯ t
prullen	p r ʏ l ə n
psychokinese	p s i x oː k i n eː z ə
publicatie	p y b l i k aː t s i
publiceren	p y b l i s eː r ə n
pugilistisch	p y ɣ i l ɪ s t i s
puin	p œ y̯ n
puinhoop	p œ y̯ n ɦ oː p
pulmonair	p ʏ l m oː n ɛː r
punjabi	p u n d ʒ aː b i
puntmuts	p ʏ n t m ʏ t s
puntzak	p ʏ n t s ɑ k
purist	p y r ɪ s t
putjesschepper	p ʏ t j ə s x ɛ p ə r
pvdd	p eː v eː d eː d eː
quarantaine	k aː r ɑ n t ɛː n ə
quasi	k ʋ aː z i
raadsel	r aː t s ə l
raadspensionaris	r aː t s p ɛ n ʃ oː n aː r ɪ s
raafgier	r aː f x iː r
raak	r aː k
race	r eː s
rad	r ɑ t
raderschip	r aː d ə r s x ɪ p
radijs	r aː d ɛ i̯ s
rakel	r aː k ə l
raken	r aː k ə n
ramptoerisme	r ɑ m p t u r ɪ s m ə
randcrimineel	r ɑ n t k r i m i n eː l
randidioot	r ɑ n t i d i oː t
rank	r ɑ ŋ k
ransomware	r ɛ n s ə m ʋ ɛː r
rape	r a p ə
rapier	r ɑ p i r
rare	r aː r ə
rassenleer	r ɑ s ə n l eː r
rationalistisch	r aː t ʃ oː n aː l ɪ s t i s
reaguursel	r eː aː ɣ yː r s ə l
recht	r ɛ x t
rechtens	r ɛ x t ə n s
recreant	r eː k r eː ɑ n t
redekunde	r eː d ə k ʏ n d ə
rederijker	r eː d ə r ɛ i̯ k ə r
reetveter	r eː t f eː t ə r
regenjas	r eː ɣ ə n j ɑ s
regenpijp	r eː ɣ ə n p ɛ i̯ p
regenval	r eː ɣ ə n v ɑ l
regenwater	r eː ɣ ə n ʋ aː t ə r
reis	r ɛ i̯ s
reisagent	r ɛ i̯ s aː ɣ ɛ n t
reizen	r ɛ i̯ z ə n
remlamp	r ɛ m l ɑ m p
remonstrant	r eː m ɔ n s t r ɑ n t
remonstrants	r e m ɔ n s t r ɑ n t s
remschoen	r ɛ m s x u n
remvloeistof	r ɛ m v l u i̯ s t ɔ f
rendiergewei	r ɛ n d iː r ɣ ə ʋ ɛ i̯
rennen	r ɛ n ə n
rent	r ɛ n t
repeteergeweer	r eː p ə t eː r ɣ ə ʋ eː r
reputatie	r eː p y t aː t s i
ressource	r eː s uː r s ə
reukwerkbrander	r øː k ʋ ɛ r k b r ɑ n d ə r
reuze	r øː z ə
reventer	r ə v ɛ n t ə r
revolutiebouw	r eː v oː l y t s i b ɑ u̯
ribstuk	r ɪ p s t ʏ k
rietkat	r i t k ɑ t
rijksambtenaar	r ɛ i̯ k s ɑ m p t ə n aː r
rijsttafel	r ɛ i̯ s t aː f ə l
rijwiel	r ɛ i̯ ʋ i l
rimboe	r ɪ m b u
riskant	r ɪ s k ɑ n t
rivierbed	r i v iː r b ɛ t
rivierkreeft	r i v iː r k r eː f t
rodekool	r oː d ə k oː l
roef	r u f
roeiboot	r u i̯ b oː t
roetsjen	r u t ʃ ə n
rokken	r ɔ k ə n
rol	r ɔ l
rolle	r ɔ l ə
rolmaat	r ɔ l m aː t
roltong	r ɔ l t ɔ ŋ
rond	r ɔ n t
ronde	r ɔ n d ə
rondhout	r ɔ n t ɦ ɑ u̯ t
rondvaart	r ɔ n t f aː r t
roodharige	r oː t ɦ aː r ə ɣ ə
roofgier	r oː f x iː r
roofmoord	r oː f m oː r t
roofvogel	r oː f oː ɣ ə l
rooien	r oː i̯ ə n
rookwerk	r oː k ʋ ɛ r k
roskam	r ɔ s k ɑ m
rosmolen	r ɔ s m oː l ə n
rosoliemolen	r ɔ s oː l i m oː l ə n
rotsblok	r ɔ t s b l ɔ k
rozerood	r ɔː z ə r oː t
rubriek	r y b r i k
ruggengraat	r ʏ ɣ ə ɣ r aː t
ruggenprik	r ʏ ɣ ə n p r ɪ k
ruikt	r œ y̯ k t
ruilhart	r œ y̯ l ɦ ɑ r t
ruilkaart	r œ y̯ l k aː r t
ruimte	r œ y̯ m t ə
ruimtevaart	r œ y̯ m t ə v aː r t
ruiterij	r œ y̯ t ə r ɛ i̯
ruiven	r œ y̯ v ə n
rundveehouderij	r ʏ n t f eː ɦ ɑ u̯ d ə r ɛ i̯
russenpol	r ʏ s ə n p ɔ l
rustoord	r ʏ s t oː r t
ruwaard	r y ʋ aː r t
ruïneren	r y i n eː r ə n
sabeldier	s aː b ə l d iː r
sabra	s aː b r aː
saks	s ɑ k s
saksen	s ɑ k s ə n
saldo	s ɑ l d oː
salie	s aː l i
samendrukken	s aː m ə n d r ʏ k ə n
samenspraak	s aː m ə n s p r aː k
samoa	s aː m oː aː
samoaans	s aː m oː aː n s
samoem	s aː m u m
samsam	s ɑ m s ɑ m
sander	s ɑ n d ə r
sarcoom	s ɑ r k oː m
sassenheim	s ɑ s ə n ɦ ɛ i̯ m
satanisme	s aː t aː n ɪ s m ə
satansboleet	s aː t ɑ n s b oː l eː t
sater	s aː t ə r
satirisch	s aː t iː r i s
sauna	s ɑ u̯ n aː
saus	s ɑ u̯ s
schaaf	s x aː f
schaamspleet	s x aː m s p l eː t
schaars	s x aː r s
schaduw	s x aː d y u̯
schaduwzijde	s x aː d y u̯ z ɛ i̯ d ə
schaffen	s x ɑ f ə n
schalks	s x ɑ l k s
schapen	s x aː p ə n
schapenkaas	s x aː p ə n k aː s
schapenvlies	s x aː p ə n v l i s
schaper	s x aː p ə r
schare	s x aː r ə
scharminkel	s x ɑ r m ɪ n k ə l
scharrelei	s x ɑ r ə l ɛ i̯
schatkamer	s x ɑ t k aː m ə r
schatlijst	s x ɑ t l ɛ i̯ s t
scheenbeen	s x eː n b eː n
scheepsanker	s x eː p s ɑ ŋ k ə r
scheepsblok	s x eː p s b l ɔ k
scheiden	s x ɛ i̯ d ə n
scheikunde	s x ɛ i̯ k ʏ n d ə
scheit	s x ɛ i̯ t
scheldproza	s x ɛ l t p r oː z aː
scheldziek	s x ɛ l t s i k
schelmstuk	s x ɛ l m s t ʏ k
schending	s x ɛ n d ɪ ŋ
schepen	s x eː p ə n
schermutseling	s x ɛ r m ʏ t s ə l ɪ ŋ
schets	s x ɛ t s
schetsen	s x ɛ t s ə n
schieten	s x i t ə n
schijftongkikker	s x ɛ i̯ f t ɔ ŋ k ɪ k ə r
schijnwerper	s x ɛ i̯ n ʋ ɛ r p ə r
schild	s x ɪ l t
schoeisel	s x u i̯ s ə l
schoelje	s x u l j ə
schoffel	s x ɔ f ə l
schol	s x ɔ l
scholekster	s x ɔ l ɛ k s t ə r
schommelen	s x ɔ m ə l ə n
schommelschip	s x ɔ m ə l s x ɪ p
schooier	s x oː i̯ ə r
schoon	s x oː n
schoonmaken	s x oː n m aː k ə n
schoonmaker	s x oː n m aː k ə r
schoorsteenmantel	s x oː r s t eː n m ɑ n t ə l
schoot	s x oː t
schorpioen	s x ɔ r p i u n
schreeuwerig	s x eː u̯ ə r ə x
schreeuwlelijk	s x r eː u̯ l eː l ə k
schrijftafel	s x r ɛ i̯ f t aː f ə l
schrijn	s x r ɛ i n
schroefhoorngeit	s x r u f ɦ oː r n ɣ ɛ i̯ t
schroeflijn	s x r u f l ɛ i̯ n
schrooien	s x r oː i̯ ə n
schudden	s x ʏ d ə n
schuier	s x œ y̯ ə r
schuilnaam	s x œ y̯ l n aː m
schuimkop	s x œ y̯ m k ɔ p
schuin	s x œ y̯ n
schuldcultuur	s x ʏ l t k ʏ l t yː r
schuldeiser	s x ʏ l t ɛ i̯ s ə r
schutten	s x ʏ t ə n
schuur	s x y r
scooter	s k u t ə r
scoren	s k oː r ə n
seintjes	s ɛ i̯ n t j ə s
seismisch	s ɛ i̯ s m i s
seksueel	s ɛ k s y eː l
selderie	s ɛ l d ə r i
sem	s ɛ m
seriemoord	s eː r i m oː r t
serpent	s ɛ r p ɛ n t
shag	ʃ ɛ k
sieraad	s i r aː t
sieren	s i r ə n
simpelweg	s ɪ m p ə l ʋ ɛ x
sindarijns	s ɪ n d aː r ɛ i̯ n s
sjabbes	ʃ ɑ b ə s
sjakie	ʃ aː k i
sjambok	ʃ ɑ m b ɔ k
sjwa	ʃ ʋ ɑ
skinhead	s k ɪ n ɦ ɛ d
slaapbank	s l aː p b ɑ ŋ k
slaapbol	s l aː p b ɔ l
slaappil	s l aː p ɪ l
slachter	s l ɑ x t ə r
slakkengang	s l ɑ k ə n ɣ ɑ ŋ
slakkenhuis	s l ɑ k ə n ɦ œ y̯ s
slangengift	s l ɑ ŋ ə n ɣ ɪ f t
slap	s l ɑ p
slaperig	s l aː p ə r ə x
slavenarbeid	s l aː v ə n ɑ r b ɛ i̯ t
slavenschip	s l aː v ə n s x ɪ p
slavin	s l aː v ɪ n
slavische	s l aː v i s ə
slechte	s l ɛ x t ə
slechtvalk	s l ɛ x t f ɑ l k
slechtziend	s l ɛ x t s i n t
sleg	s l ɛ x
sletvrees	s l ɛ t f r eː s
sleurgeloof	s l øː r ɣ ə l oː f
sleutelgat	s l øː t ə l ɣ ɑ t
slijk	s l ɛ i̯ k
slimheid	s l ɪ m ɦ ɛ i̯ t
slingerplant	s l ɪ ŋ ə r p l ɑ n t
sloeber	s l u b ə r
slok	s l ɔ k
sloop	s l oː p
slootjespringen	s l oː t j ə s p r ɪ ŋ ə n
slowakije	s l oː ʋ aː k ɛ i̯ j ə
slowen	s l oː ʋ ə n
slufter	s l ʏ f t ə r
sluipen	s l œ y̯ p ə n
sluit	s l œ y̯ t
sluw	s l y u̯
smaakzin	s m aː k s ɪ n
smeedblok	s m eː t b l ɔ k
smeekbede	s m eː k b eː d ə
smeerlap	s m eː r l ɑ p
smiecht	s m i x t
smoel	s m u l
snaphaan	s n ɑ p ɦ aː n
sneeuwbui	s n eː u̯ b œ y̯
sneeuwgans	s n eː u̯ ɣ ɑ n s
sneeuwgrens	s n eː u̯ ɣ r ɛ n s
sneeuwhut	s n eː u̯ ɦ ʏ t
sneeuwkleed	s n eː u̯ k l eː t
sneeuwkristal	s n eː u̯ k r ɪ s t ɑ l
sneeuwkroon	s n eː u̯ k r oː n
sneeuwploeg	s n eː u̯ p l u x
sneeuwpop	s n eː u̯ p ɔ p
sneeuwschuiver	s n eː u̯ s x œ y̯ v ə r
sneller	s n ɛ l ə r
snikken	s n ɪ k ə n
snip	s n ɪ p
snoek	s n u k
snoepen	s n u p ə n
snoeven	s n u v ə n
snoge	s n oː ɣ ə
snood	s n oː t
snotaap	s n ɔ t aː p
snuiverbedrijf	s n œ y̯ v ə r b ə d r ɛ i̯ f
sociaaldemocraat	s oː ʃ aː l d eː m oː k r aː t
socialistenvreter	s oː ʃ aː l ɪ s t ə n v r eː t ə r
soeplepel	s u p l eː p ə l
soepschildpad	s u p s x ɪ l t p ɑ t
sofa	s oː f aː
sokkel	s ɔ k ə l
soms	s ɔ m s
sonnettenbakker	s ɔ n ɛ t ə n b ɑ k ə r
sorbisch	s ɔ r b i s
souvenir	s u v ə n i r
spaanplaatschroef	s p aː n p l aː t s x r u f
spade	s p aː d ə
spanjaard	s p ɑ n j aː r t
spanje	s p ɑ n j ə
speedboot	s p i t b oː t
speelhal	s p eː l ɦ ɑ l
speels	s p eː l s
speeltje	s p eː l t j ə
speeltuig	s p eː l t œ y̯ x
speen	s p eː n
spekkoek	s p ɛ k u k
spelevaren	s p eː l ə v aː r ə n
spellen	s p ɛ l ə n
spellingvariant	s p ɛ l ɪ ŋ v aː r i ɑ n t
spenen	s p eː n ə n
spie	s p i
spilziek	s p ɪ l z i k
spin	s p ɪ n
spinnenweb	s p ɪ n ə n ʋ ɛ p
spinnijdig	s p ɪ n n ɛ i̯ d ə x
spintepel	s p ɪ n t eː p ə l
spiraal	s p i r aː l
splijtzwam	s p l ɛ i̯ t s ʋ ɑ m
spoed	s p u t
spoedig	s p u d ə x
spoelen	s p u l ə n
spog	s p ɔ x
spongat	s p ɔ n ɣ ɑ t
spookdorp	s p oː k d ɔ r p
spoorweg	s p oː r ʋ ɛ x
sporen	s p oː r ə n
sportbeha	s p ɔ r t b eː ɦ aː
sporten	s p ɔ r t ə n
sprachbund	s p r aː x b u n t
sprak	s p r ɑ k
spreekbuis	s p r eː k b œ y̯ s
spreekuur	s p r eː k yː r
spreidloopgeweer	s p r ɛ i̯ t l oː p x ə ʋ eː r
spreng	s p r ɛ ŋ
spreuk	s p r øː k
sprinkhanenplaag	s p r ɪ ŋ k ɦ aː n ə n p l aː x
sprinkhanenzwerm	s p r ɪ ŋ k ɦ aː n ə n z ʋ ɛ r m
sprookje	s p r oː k j ə
spruitkool	s p r œ y̯ t k oː l
spuitgast	s p œ y̯ t x ɑ s t
staalkaart	s t aː l k aː r t
staartploeg	s t aː r t p l u x
staatsingrijpen	s t aː t s ɪ n ɣ r ɛ i̯ p ə n
stadsstrand	s t ɑ t s t r ɑ n t
stal	s t ɑ l
stalles	s t ɑ l ə s
stamgast	s t ɑ m ɣ ɑ s t
stamppot	s t ɑ m p ɔ t
stamvader	s t ɑ m v aː d ə r
standvastig	s t ɑ n t v ɑ s t i ɡ ə x
startbaan	s t ɑ r t b aː n
statie	s t aː s i
statuszucht	s t aː t ʏ s s ʏ x t
statuur	s t aː t yː r
steeg	s t eː x
steekkaart	s t eː k aː r t
steekwagen	s t eː k ʋ aː ɣ ə n
steenbok	s t eː m b ɔ k
steenfruit	s t eː n f r œ y̯ t
steenkolengas	s t eː n k oː l ə n ɣ ɑ s
steenkolenveld	s t eː n k oː l ə n v ɛ l t
steenmot	s t eː n m ɔ t
steenwortel	s t eː n ʋ ɔ r t ə l
stekelig	s t eː k ə l ə x
stellen	s t ɛ l ə n
steltkluut	s t ɛ l t k l y t
stembiljet	s t ɛ m b ɪ l j ɛ t
stemvee	s t ɛ m v eː
stengelui	s t ɛ ŋ ə l œ y̯
step	s t ɛ p
steppenhoen	s t ɛ p ə n ɦ u n
ster	s t ɛ r
sterrenschot	s t ɛ r ə n s x ɔ t
sterrenzwerm	s t ɛ r ə n z ʋ ɛ r m
stethoscoop	s t eː t oː s k oː p
steunfort	s t øː n f ɔ r t
stibium	s t i b i ʏ m
stickie	s t ɪ k i
stierenvechten	s t iː r ə n v ɛ x t ə n
stikken	s t ɪ k ə n
stikstof	s t ɪ k s t ɔ f
stinkdier	s t ɪ ŋ k d iː r
stinkmarter	s t ɪ ŋ k m ɑ r t ə r
stinkvogel	s t ɪ ŋ k f oː ɣ ə l
stoefen	s t u f ə n
stoelen	s t u l ə n
stofzuig	s t ɔ f s œ y̯ x
stofzuiger	s t ɔ f s œ y̯ ɣ ə r
stofzuigerslang	s t ɔ f s œ y̯ ɣ ə r s l ɑ ŋ
stokaas	s t ɔ k aː s
stoken	s t oː k ə n
stokwachter	s t ɔ k ʋ ɑ x t ə r
stolpboerderij	s t ɔ l p b u r d ə r ɛ i̯
stommeling	s t ɔ m ə l ɪ ŋ
stoornis	s t oː r n ɪ s
stoorzender	s t oː r z ɛ n d ə r
stoottroep	s t oː t r u p
stopformulier	s t ɔ p f ɔ r m y l iː r
storen	s t oː r ə n
stormbandpinguïn	s t ɔ r m b ɑ n t p ɪ ŋ ɡ ʋ ɪ n
stout	s t ɑ u̯ t
straat	s t r aː t
straatlicht	s t r aː t l ɪ x t
straatmuzikant	s t r aː t m y z i k ɑ n t
straatsburg	s t r aː t s b ʏ r x
strafcorner	s t r ɑ f k ɔ r n ə r
strafkamp	s t r ɑ f k ɑ m p
strafschopgoal	s t r ɑ f s x ɔ p ɡ oː l
strafstudie	s t r ɑ f s t y d i
strafwerk	s t r ɑ f ʋ ɛ r k
strandkrab	s t r ɑ n t k r ɑ p
strandloper	s t r ɑ n t l oː p ə r
streek	s t r eː k
streektaal	s t r eː k t aː l
streepkleur	s t r eː p k l øː r
strijdbijl	s t r ɛ i̯ t b ɛ i̯ l
strijdlustig	s t r ɛ i̯ t l ʏ s t ə x
strijdperk	s t r ɛ i̯ t p ɛ r k
strijdtoneel	s t r ɛ i̯ t oː n eː l
strijkbout	s t r ɛ i̯ k b ɑ u̯ t
stripalbum	s t r ɪ p ɑ l b ʏ m
stripfiguur	s t r ɪ p f i ɣ yː r
stront	s t r ɔ n t
stronteigenwijs	s t r ɔ n t ɛ i̯ ɣ ə n ʋ ɛ i̯ s
strooien	s t r oː i̯ ə n
stroom	s t r oː m
stroombekken	s t r oː m b ɛ k ə n
stroomopwaarts	s t r oː m ɔ p ʋ aː r t s
stroopwafel	s t r oː p ʋ aː f ə l
stroopwafelpiet	s t r oː p ʋ aː f ə l p i t
strottenhoofd	s t r ɔ t ə n ɦ oː f t
struisvogelpolitiek	s t r œ y̯ s f oː ɣ ə l p oː l i t i k
stuurkunde	s t yː r k ʏ n d ə
stuurwiel	s t yː r ʋ i l
suatiekanaal	s y aː t s i k aː n aː l
subsidie	s ʏ p s i d i
substantie	s ʏ b s t ɑ n s i
suikerfeest	s œ y̯ k ə r f eː s t
suikeroom	s œ y̯ k ə r oː m
superreus	s y p ə r r øː s
surfplank	s ʏ r f p l ɑ ŋ k
swaffelen	s ʋ ɑ f ə l ə n
syfilis	s i f i l ɪ s
synecdoche	s i n ɛ k d oː x ə
synthetisch	s ɪ n t eː t i s
taaldood	t aː l d oː t
taalgevoel	t aː l ɣ ə v u l
taalgids	t aː l ɣ ɪ t s
taan	t aː n
taboriet	t aː b oː r i t
tafelpoot	t aː f ə l p oː t
tak	t ɑ k
taks	t ɑ k s
taling	t aː l ɪ ŋ
talisman	t aː l ɪ s m ɑ n
talrijk	t ɑ l r ɛ i̯ k
tamelijk	t aː m ə l ə k
tandarts	t ɑ n d ɑ r t s
tandem	t ɑ n d ɛ m
tandvlees	t ɑ n t f l eː s
tandzijde	t ɑ n t s ɛ i̯ d ə
tangconstructie	t ɑ ŋ k ɔ n s t r ʏ k s i
tappen	t ɑ p ə n
tasten	t ɑ s t ə n
tatoeëren	t ɑ t u eː r ə n
teamgeest	t iː m ɣ eː s t
teddybeer	t ɛ d i b eː r
teek	t eː k
tefilla	t ə f i l aː
tegen	t eː ɣ ə n
tegenpaus	t eː ɣ ə n p ɑ u̯ s
tegenspeler	t eː ɣ ə n s p eː l ə r
tegenspoed	t eː ɣ ə n s p u t
tegenstaatsgreep	t eː ɣ ə n s t aː t s x r eː p
tegenwicht	t eː ɣ ə n ʋ ɪ x t
tekenfilm	t eː k ə n f ɪ l m
tekstkritiek	t ɛ k s t k r i t i k
telefonisch	t eː l ə f oː n i s
teleologisch	t eː l eː oː l oː ɣ i s
telescoop	t eː l ə s k oː p
tempel	t ɛ m p ə l
tempelier	t ɛ m p ə l iː r
tempelwachter	t ɛ m p ə l ʋ ɑ x t ə r
ten	t ɛ n
tenen	t eː n ə n
tennisbal	t ɛ n ə s b ɑ l
tennisser	t ɛ n ɪ s ə r
terbeschikkingstelling	t ɛ r b ə s x ɪ k ɪ ŋ s t ɛ l ɪ ŋ
terugschrikken	t ə r ʏ x s x r ɪ k ə n
thans	t ɑ n s
theatraal	t eː aː t r aː l
theo	t eː j oː
thermodynamisch	t ɛ r m oː d i n aː m i s
thesorie	t eː s oː r i
tijdbom	t ɛ i̯ t b ɔ m
tijk	t ɛ i̯ k
tijken	t ɛ i̯ k ə n
tijm	t ɛ i̯ m
tijn	t ɛ i̯ n
tikken	t ɪ k ə n
toch	t ɔ x
tochtgenoot	t ɔ x t x ə n oː t
tochtig	t ɔ x t ə x
toedeledokie	t u d ə l ə d oː k i
toedeloe	t u d ə l u
toegangsgeld	t u ɣ ɑ ŋ s x ɛ l t
toegangskaart	t u ɣ ɑ ŋ s k aː r t
toegespeeld	t u ɣ ə s p eː l t
toegift	t u ɣ ɪ f t
toekomstverwachting	t u k ɔ m s t f ə r ʋ ɑ x t ɪ ŋ
toekruid	t u k r œ y̯ t
toereiken	t u r ɛ i̯ k ə n
toeslaan	t u s l aː n
toeslag	t u s l ɑ x
toewenden	t u ʋ ɛ n d ə n
toewerpen	t u ʋ ɛ r p ə n
toiletartikel	t ʋ aː l ɛ t ɑ r t i k ə l
toiletborstel	t ʋ aː l ɛ t b ɔ r s t ə l
token	t oː k ə n
tomatenketchup	t oː m aː t ə n k ɛ t ʃ ʏ p
tomatensaus	t oː m aː t ə n s ɑ u̯ s
tondel	t ɔ n d ə l
tondeldoos	t ɔ n d ə l d oː s
toneelkijker	t oː n eː l k ɛ i̯ k ə r
tonen	t oː n ə n
tong	t ɔ ŋ
toog	t oː x
toonaard	t oː n aː r t
toren	t oː r ə n
toupet	t u p ɛ t
touw	t ɑ u̯
toverdokter	t oː v ə r d ɔ k t ə r
toveren	t oː v ə r ə n
traag	t r aː x
tragischers	t r aː ɣ i s ə r s
transvrouw	t r ɑ n s f r ɑ u̯
trappenpiramide	t r ɑ p ə n p iː r aː m i d ə
travaat	t r aː v aː t
trede	t r eː d ə
treden	t r eː d ə n
trekpop	t r ɛ k p ɔ p
trendmatig	t r ɛ n t m aː t ə x
tresorie	t r eː s oː r i
treurdicht	t r øː r d ɪ x t
trichloormethaan	t r i x l oː r m eː t aː n
trilaal	t r ɪ l aː l
triloog	t r i l oː x
troffel	t r ɔ f ə l
trombone	t r ɔ m b ɔː n ə
troon	t r oː n
troonsbestijging	t r oː n s b ə s t ɛ i̯ ɣ ɪ ŋ
tropisch	t r oː p i s
truien	t r œ y̯ ə n
tuigleer	t œ y̯ x l eː r
tuinman	t œ y̯ n m ɑ n
tulp	t ʏ l p
tulpenboom	t ʏ l p ə n b oː m
tumor	t y m ɔ r
turbotaal	t ʏ r b oː t aː l
tureluur	t yː r ə l yː r
tussen	t ʏ s ə n
tussenpunt	t ʏ s ə n p ʏ n t
tussenstop	t ʏ s ə n s t ɔ p
tweebak	t ʋ eː b ɑ k
tweehonderd	t ʋ eː ɦ ɔ n d ə r t
tweepersoonsbed	t ʋ eː p ɛ r s oː n s b ɛ t
tweeënvijftig	t ʋ eː j ə n v ɛ i̯ f t ə x
twijfelachtig	t ʋ ɛ i̯ f ə l ɑ x t ə x
twijg	t ʋ ɛ i̯ x
twistziek	t ʋ ɪ s t s i k
typist	t i p ɪ s t
ufo	y f oː
uit	œ y̯ t
uitbuikwandeling	œ y̯ t b œ y̯ k ʋ ɑ n d ə l ɪ ŋ
uitdoven	œ y̯ d oː v ə n
uitdrijven	œ y̯ t d r ɛ i̯ v ə n
uitdrukken	œ y̯ d r ʏ k ə n
uitgebeeld	œ y̯ t x ə b eː l t
uitgeleverd	œ y̯ t x ə l eː v ə r t
uitgeslepen	œ y̯ t x ə s l eː p ə n
uitgestoken	œ y̯ t x ə s t oː k ə n
uithangen	œ y̯ t ɦ ɑ ŋ ə n
uitkijktoren	œ y̯ t k ɛ i̯ k t oː r ə n
uitmoorden	œ y̯ t m oː r d ə n
uitpakken	œ y̯ t p ɑ k ə n
uitprinten	œ y̯ t p r ɪ n t ə n
uitputten	œ y̯ t p ʏ t ə n
uitrijden	œ y̯ t r ɛ i̯ d ə n
uitruil	œ y̯ t r œ y̯ l
uitstekend	œ y̯ t s t eː k ə n t
uitstekende	œ y̯ t s t eː k ə n d ə
uitten	œ y̯ t ə n
uitvechten	œ y̯ t f ɛ x t ə n
uitvergroot	œ y̯ t f ə r ɣ r oː t
uitvergrootten	œ y̯ t f ə r ɣ r oː t ə n
uitvergroten	œ y̯ t f ə r ɣ r oː t ə n
uitvergrotend	œ y̯ t f ə r ɣ r oː t ə n t
uitvinding	œ y̯ t v ɪ n d ɪ ŋ
uitzaaiing	œ y̯ t z aː j ɪ ŋ
uitzwaaien	œ y̯ t z ʋ aː i̯ ə n
ultrageluid	ʏ l t r aː ɣ ə l œ y̯ t
undercover	ɑ n d ə r k ɑ v ə r
universitair	y n i v ɛ r z i t ɛː r
urdu	u r d u
urilift	yː r i l ɪ f t
utilisme	y t i l ɪ s m ə
uur	y r
uzi	uː z i
vaan	v aː n
vaardigen	v aː r d ə ɣ ə n
vaars	v aː r s
vaatweefsel	v aː t ʋ eː f s ə l
vaatwerk	v aː t ʋ ɛ r k
vacuümpje	v a k y y m p j ə
vagebond	v aː ɣ ə b ɔ n t
vak	v ɑ k
vakantiehuis	v aː k ɑ n t s i ɦ œ y̯ s
vakbond	v ɑ k b ɔ n t
vampier	v ɑ m p iː r
vandaag	v ɑ n d aː x
vanitasstilleven	v aː n i t ɑ s s t ɪ l l eː v ə n
vannacht	v ɑ n ɑ x t
var	v ɑ r
vara	v aː r aː
variatie	v aː r i aː t s i
vast	v ɑ s t
vatbaar	v ɑ t b aː r
vechtscheiding	v ɛ x t s x ɛ i̯ d ɪ ŋ
veder	v eː d ə r
veeg	v eː x
veegt	v eː x t
veehouder	v eː ɦ ɑ u̯ d ə r
veeleer	v eː l eː r
veels	v eː l s
veerconstante	v eː r k ɔ n s t ɑ n t ə
vegarestaurant	v eː ɣ aː r ɛ s t oː r ɑ n t
vegen	v eː ɣ ə n
veger	v eː ɣ ə r
vegetarisch	v eː ɣ ə t aː r i s
veiligheidsmaatregel	v ɛ i̯ l ɪ ɣ ɦ ɛ i̯ t s m aː t s r eː ɣ ə l
veiling	v ɛ i̯ l ɪ ŋ
veldsla	v ɛ l t s l aː
veldteken	v ɛ l t eː k ə n
velduil	v ɛ l t œ y̯ l
venerologisch	v eː n eː r oː l oː ɣ i s
vennootschap	v ɛ n oː t s x ɑ p
ventilator	v ɛ n t i l aː t ɔ r
veralgemeniseren	v ɛ r ɑ l ɣ ə m eː n i z eː r ə n
verandering	v ə r ɑ n d ə r ɪ ŋ
verbaal	v ɛ r b aː l
verbidden	v ə r b ɪ d ə n
verbroederen	v ə r b r u d ə r ə n
verders	v ɛ r d ə r s
verderven	v ə r d ɛ r v ə n
verdichtsel	v ɛ r d ɪ x t s ə l
verdieping	v ɛ r d i p ɪ ŋ
vergezicht	v ɛ r ɣ ə z ɪ x t
vergift	v ə r ɣ ɪ f t
vergissen	v ə r ɣ ɪ s ə n
vergrootglas	v ə r ɣ r oː t x l ɑ s
verhip	v ə r ɦ ɪ p
vering	v eː r ɪ ŋ
verkalken	v ə r k ɑ l k ə n
verkeerde	v ə r k eː r d ə
verkiezen	v ə r k i z ə n
verkopen	v ə r k oː p ə n
verliest	v ə r l i s t
vermogensbeheer	v ɛ r m oː ɣ ə n s b ə ɦ eː r
vernietigen	v ə r n i t ə ɣ ə n
verraad	v ə r aː t
verre	v ɛ r ə
verrekijker	v ɛ r ə k ɛ i̯ k ə r
verschillen	v ə r s x ɪ l ə n
verschillend	v ə r s x ɪ l ə n t
verschilt	v ə r s x ɪ l t
verschuive	v ə r s x œ y̯ v ə
verschuiven	v ə r s x œ y̯ v ə n
vertaalwoordenboek	v ə r t aː l ʋ oː r d ə n b u k
vertroebelen	v ə r t r u b ə l ə n
vervoer	v ə r v u r
vervroegt	v ɛ r v r u ɣ t
vervuiling	v ə r v œ y̯ l ɪ ŋ
verwelken	v ə r ʋ ɛ l k ə n
verzendkosten	v ə r z ɛ n t k ɔ s t ə n
vestigen	v ɛ s t ə ɣ ə n
veter	v eː t ə r
vief	v i f
vierhonderd	v iː r ɦ ɔ n d ə r t
vietnamoorlog	v j ɛ t n ɑ m oː r l ɔ x
vijandschap	v ɛ i̯ ɑ n t s x ɑ p
vijf	v ɛ i̯ f
vijfenveertig	v ɛ i̯ f ə n v eː r t ə x
vijfenvijftig	v ɛ i̯ f ə n v ɛ i̯ f t ə x
vijfenzeventig	v ɛ i̯ f ə n s eː v ə n t ə x
vinden	v ɪ n d ə n
virtuoos	v ɪ r t y oː s
vislijm	v ɪ s l ɛ i̯ m
vissterfte	v ɪ s t ɛ r f t ə
visum	v i z ʏ m
vitriool	v i t r i oː l
vlaams	v l aː m s
vledder	v l ɛ d ə r
vleerhond	v l eː r ɦ ɔ n t
vleesch	v l eː s
vleeshamer	v l eː s ɦ aː m ə r
vleeshouwer	v l eː s ɦ ɑ u̯ ə r
vleeswaar	v l eː s ʋ aː r
vleien	v l ɛ i̯ ə n
vleinaam	v l ɛ i̯ n aː m
vleselijk	v l eː s ə l ə k
vleugellam	v l øː ɣ ə l ɑ m
vliegende	v l i ɣ ə n d ə
vliegpark	v l i x p ɑ r k
vliegtoestel	v l i x t u s t ɛ l
vliegtuigbom	v l i x t œ y̯ x b ɔ m
vlinder	v l ɪ n d ə r
vlindermes	v l ɪ n d ə r m ɛ s
vlo	v l oː
vloek	v l u k
vlootbouw	v l oː t b ɑ u̯
vluchteling	v l ʏ x t ə l ɪ ŋ
vluchtheuvel	v l ʏ x t ɦ øː v ə l
voedster	v u t s t ə r
voetnoot	v u t n oː t
voetpad	v u t p ɑ t
voetstap	v u t s t ɑ p
vogel	v oː ɣ ə l
vogelhuis	v oː ɣ ə l ɦ œ y̯ s
vogelspin	v oː ɣ ə l s p ɪ n
vogelvrij	v oː ɣ ə l v r ɛ i̯
volgen	v ɔ l ɣ ə n
volksoploop	v ɔ l k s ɔ p l oː p
volkstaal	v ɔ l k s t aː l
volksvertegenwoordiging	v ɔ l k s f ə r t eː ɣ ə n ʋ oː r d ə ɣ ɪ ŋ
volvoeren	v ɔ l v u r ə n
vooral	v oː r ɑ l
voorbillen	v oː r b ɪ l ə n
voorkomst	v oː r k ɔ m s t
voorkoop	v oː r k oː p
voorlader	v oː r l aː d ə r
voorliefde	v oː r l i f d ə
voornemen	v oː r n eː m ə n
voorpret	v oː r p r ɛ t
voorschrijven	v oː r s x r ɛ i̯ v ə n
voorspoed	v oː r s p u t
voorstaan	v oː r s t aː n
voorstelling	v oː r s t ɛ l ɪ ŋ
voortrekken	v oː r t r ɛ k ə n
voorzetsel	v oː r z ɛ t s ə l
voorzichtig	v oː r z ɪ x t ə x
voorzienig	v oː r z i n ə x
vormenleer	v ɔ r m ə n l eː r
vorstenhuis	v ɔ r s t ə n ɦ œ y̯ s
vosch	v ɔ s
voshaai	v ɔ s ɦ aː i̯
vosrekel	v ɔ s r eː k ə l
vot	v ɔ t
vraagal	v r aː x ɑ l
vraagstuk	v r aː x s t ʏ k
vraagteken	v r aː x t eː k ə n
vredesonderhandeling	v r eː d ə s ɔ n d ə r ɦ ɑ n d ə l ɪ ŋ
vredig	v r eː d ə x
vreemdelingenhaat	v r eː m d ə l ɪ ŋ ə n ɦ aː t
vrek	v r ɛ k
vrijgevig	v r ɛ i̯ ɣ eː v ə x
vrijhaven	v r ɛ i̯ ɦ aː v ə n
vrijlaat	v r ɛ i̯ l aː t
vrijstaat	v r ɛ i̯ s t aː t
vroedmeesterpad	v r u t m eː s t ə r p ɑ t
vroeg	v r u x
vroeggeboorte	v r u x ə b oː r t ə
vroegpreek	v r u x p r eː k
vuilnisman	v œ y̯ l n ɪ s m ɑ n
vulkaanuitbarsting	v ʏ l k aː n œ y̯ t b ɑ r s t ɪ ŋ
vuurdoop	v yː r d oː p
vuurduivel	v yː r d œ y̯ v ə l
vuursteenpistool	v yː r s t eː n p i s t oː l
vuurtorenwachter	v yː r t oː r ə n ʋ ɑ x t ə r
vuurvogel	v yː r v oː ɣ ə l
waaien	ʋ aː i̯ ə n
waarachtig	ʋ aː r ɑ x t ə x
waardvogel	ʋ aː r t f oː ɣ ə l
waarin	ʋ aː r ɪ n
waas	ʋ aː s
wachtrij	v ɑ x t r ɛ i
walcheren	ʋ ɑ l x ə r ə n
walgvogel	ʋ ɑ l x f oː ɣ ə l
wallonië	ʋ ɑ l oː n i j ə
walvistraan	ʋ ɑ l v ɪ s t r aː n
wandaad	ʋ ɑ n d aː t
wandcontactdoos	ʋ ɑ n t k ɔ n t ɑ k t d oː s
wandrochtig	ʋ ɑ n d r ɔ x t ə x
wane	ʋ aː n ə
wangedrocht	ʋ ɑ n ɣ ə d r ɔ x t
wanhoop	ʋ ɑ n ɦ oː p
wapenen	ʋ aː p ə n ə n
warmwaterkruik	ʋ ɑ r m ʋ aː t ə r k r œ y̯ k
warschau	ʋ ɑ r ʃ ɑ u̯
waskeuken	ʋ ɑ s k øː k ə n
wasrek	ʋ ɑ s r ɛ k
wassenaar	ʋ ɑ s ə n aː r
wasser	ʋ ɑ s ə r
waterdicht	ʋ aː t ə r d ɪ x t
waterdier	ʋ aː t ə r d iː r
waterfiets	ʋ aː t ə r f i t s
waterkers	ʋ aː t ə r k ɛ r s
waterkip	ʋ aː t ə r k ɪ p
waterland	ʋ aː t ə r l ɑ n t
waterloo	ʋ aː t ə r l oː
watermeloen	ʋ aː t ə r m ə l u n
waterpartij	ʋ aː t ə r p ɑ r t ɛ i̯
waterplant	ʋ aː t ə r p l ɑ n t
waterpoel	ʋ aː t ə r p u l
waterpolo	ʋ aː t ə r p oː l oː
waterraaf	ʋ aː t ə r r aː f
waterree	ʋ aː t ə r r eː
waterschap	ʋ aː t ə r s x ɑ p
watersnip	ʋ aː t ə r s n ɪ p
waterstand	ʋ aː t ə r s t ɑ n t
waterverplaatsing	ʋ aː t ə r v ə r p l aː t s ɪ ŋ
waterwerper	ʋ aː t ə r ʋ ɛ r p ə r
web	ʋ ɛ p
weblog	ʋ ɛ p l ɔ x
wederdoper	ʋ eː d ə r d oː p ə r
wederliefde	ʋ eː d ə r l i f d ə
wederopbouwmissie	ʋ eː d ə r ɔ p b ɑ u̯ m ɪ s i
wederstreven	ʋ eː d ə r s t r eː v ə n
wederwraak	ʋ eː d ə r v r aː k
wedloop	ʋ ɛ t l oː p
weduw	ʋ eː d y u̯
weefgetouw	ʋ eː f x ə t ɑ u̯
weeg	ʋ eː x
weeral	ʋ eː r ɑ l
weergeld	ʋ eː r ɣ ɛ l t
weerglans	ʋ eː r ɣ l ɑ n s
weerspannig	ʋ eː r s p ɑ n ə x
weerwraak	ʋ eː r v r aː k
weetal	ʋ eː t ɑ l
weeuw	ʋ eː u̯
weeën	ʋ eː j ə n
weg	ʋ ɛ x
wegen	ʋ eː ɣ ə n
wegenbelasting	ʋ eː ɣ ə n b ə l ɑ s t ɪ ŋ
wegpiraat	ʋ ɛ x p i r aː t
weigerachtig	ʋ ɛ i̯ ɣ ə r ɑ x t ə x
weigeren	ʋ ɛ i̯ ɣ ə r ə n
weken	ʋ eː k ə n
welbespraaktheid	ʋ ɛ l b ə s p r aː k t ɦ ɛ i̯ t
weleer	ʋ ɛ l eː r
welletjes	ʋ ɛ l ə t j ə s
welluidend	ʋ ɛ l œ y̯ d ə n t
wenen	ʋ eː n ə n
wenkbrauwpotlood	ʋ ɛ ŋ k b r ɑ u̯ p ɔ t l oː t
wereldbeeld	ʋ eː r ə l t b eː l t
wereldoorlog	ʋ eː r ə l t oː r l ɔ x
wereldverbeteraar	ʋ eː r ə l t v ə r b eː t ə r aː r
werk	ʋ ɛ r k
werkbaar	ʋ ɛ r k b aː r
werkelijk	ʋ ɛ r k ə l ə k
werkeloos	ʋ ɛ r k ə l oː s
werken	ʋ ɛ r k ə n
werkplek	ʋ ɛ r k p l ɛ k
werkstellig	ʋ ɛ r k s t ɛ l ə x
werpen	ʋ ɛ r p ə n
werwaarts	ʋ ɛ r ʋ aː r t s
wespentaille	ʋ ɛ s p ə n t ɑ j ə
weten	ʋ eː t ə n
wichelarij	ʋ ɪ x ə l aː r ɛ i̯
wied	ʋ i t
wiegelied	ʋ i ɣ ə l i t
wiegendruk	ʋ i ɣ ə n d r ʏ k
wieler	ʋ i l ə r
wierf	ʋ i r f
wijdte	ʋ ɛ i̯ t ə
wijnboer	ʋ ɛ i m b uː r
wijnhuis	ʋ ɛ i̯ n ɦ œ y̯ s
wijnruit	ʋ ɛ i̯ n r œ y̯ t
wildebeest	ʋ ɪ l d ə b eː s t
wildgroei	ʋ ɪ l t x r u i̯
wildhout	ʋ ɪ l t ɦ ɑ u̯ t
wilhelmina	ʋ ɪ l ɦ ɛ l m i n aː
willemijn	ʋ ɪ l ə m ɛ i̯ n
win	ʋ ɪ n
winderig	ʋ ɪ n d ə r ə x
windhaan	ʋ ɪ n t ɦ aː n
winter	ʋ ɪ n t ə r
winterkleed	ʋ ɪ n t ə r k l eː t
winterkoning	ʋ ɪ n t ə r k oː n ɪ ŋ
winti	ʋ ɪ n t i
wipmolen	ʋ ɪ p m oː l ə n
wisse	ʋ ɪ s ə
witkopzeearend	ʋ ɪ t k ɔ p z eː aː r ə n t
witsel	ʋ ɪ t s ə l
woensdag	ʋ u n z d ɑ x
woerden	ʋ uː r d ə n
woest	ʋ u s t
woestijnbron	ʋ u s t ɛ i̯ n b r ɔ n
woestijngebergte	ʋ u s t ɛ i̯ n ɣ ə b ɛ r x t ə
wolfshond	ʋ ɔ l f s ɦ ɔ n t
woontoren	ʋ oː n t oː r ə n
woordje	ʋ oː r t ʃ ə
woordvoerder	ʋ oː r t f uː r d ə r
worging	ʋ ɔ r ɣ ɪ ŋ
worm	ʋ ɔ r m
woudreus	ʋ ɑ u̯ t r øː s
wrevelig	v r eː v ə l ə x
wrijven	v r ɛ i̯ v ə n
wrok	v r ɔ k
wurggreep	ʋ ʏ r x r eː p
xanten	k s ɑ n t ə n
xenofoob	k s eː n oː f oː p
xenongas	k s eː n ɔ n ɣ ɑ s
xyleem	k s i l eː m
yoga	j oː ɣ aː
zaadlob	z aː t l ɔ p
zaadlozing	z aː t l oː z ɪ ŋ
zaagdak	z aː x d ɑ k
zaaier	z aː i̯ ə r
zaaitijd	z aː i̯ t ɛ i̯ t
zaak	z aː k
zaal	z aː l
zaalvoetbal	z aː l v u t b ɑ l
zachtaardig	z ɑ x t aː r d ə x
zadel	z aː d ə l
zadelbuis	z aː d ə l b œ y̯ s
zadelsprinkhaan	z aː d ə l s p r ɪ ŋ k ɦ aː n
zag	z ɑ x
zakelijkheid	z aː k ə l ə k ɦ ɛ i̯ t
zakencijfer	z aː k ə n s ɛ i̯ f ə r
zakgeld	z ɑ k x ɛ l t
zakkenwasser	z ɑ k ə n ʋ ɑ s ə r
zakkerig	z ɑ k ə r ə x
zaligen	z aː l ə ɣ ə n
zalm	z ɑ l m
zandbank	z ɑ n t b ɑ ŋ k
zandgrond	z ɑ n t x r ɔ n t
zandhagedis	z ɑ n t ɦ aː ɣ ə d ɪ s
zandhoen	z ɑ n t ɦ u n
zandloper	z ɑ n t l oː p ə r
zandsculptuur	z ɑ n t s k ʏ l p t yː r
zandstenen	z ɑ n t s t eː n ə n
zandweg	z ɑ n t ʋ ɛ x
zandwoestijn	z ɑ n t ʋ u s t ɛ i̯ n
zangvogel	z ɑ ŋ v oː ɣ ə l
zaterdags	z aː t ə r d ɑ x s
zaterdagsochtends	z aː t ə r d ɑ x s ɔ x t ə n t s
zebrapad	z eː b r aː p ɑ t
zedendelict	z eː d ə n d eː l ɪ k t
zedenwet	z eː d ə n ʋ ɛ t
zeeanjelier	z eː ɑ n j ə l iː r
zeearend	z eː aː r ə n t
zeedahlia	z eː d aː l i aː
zeeheld	z eː ɦ ɛ l t
zeehond	z eː ɦ ɔ n t
zeeland	z eː l ɑ n t
zeelandbrug	z eː l ɑ n t b r ʏ x
zeelt	z eː l t
zeemacht	z eː m ɑ x t
zeeoor	z eː oː r
zeepaard	z eː p aː r t
zeereptiel	z eː r ɛ p t i l
zeesoldaat	z eː s ɔ l d aː t
zeevaarder	z eː v aː r d ə r
zeewier	z eː ʋ iː r
zeewolde	z eː ʋ ɔ l d ə
zeezout	z eː z ɑ u̯ t
zeeëgel	z eː eː ɣ ə l
zegen	z eː ɣ ə n
zegereeks	z eː ɣ ə r eː k s
zegevieren	z eː ɣ ə v i r ə n
zegsvrouw	z ɛ x s f r ɑ u̯
zegt	z ɛ x t
zeiknat	z ɛ i̯ k n ɑ t
zeilsteen	z ɛ i̯ l s t eː n
zeker	z eː k ə r
zelfbeheersing	z ɛ l f b ə ɦ eː r s ɪ ŋ
zelfbeschikking	z ɛ l f b ə s x ɪ k ɪ ŋ
zelfde	z ɛ l f d ə
zelfgenoegzaamheid	z ɛ l f x ə n u x s aː m ɦ ɛ i̯ t
zelfkennis	z ɛ l f k ɛ n ɪ s
zelfmedicatie	z ɛ l f m eː d i k aː t s i
zelfmoordpoging	z ɛ l f m oː r t p oː ɣ ɪ ŋ
zelfrijzend	z ɛ l f r ɛ i̯ z ə n t
zendamateur	z ɛ n t ɑ m aː t øː r
zendeling	z ɛ n d ə l ɪ ŋ
zenne	z ɛ n ə
zenuwinstorting	z eː n y u̯ ɪ n s t ɔ r t ɪ ŋ
zepen	z eː p ə n
zeperd	z eː p ə r t
zerp	z ɛ r p
zesenvijftig	z ɛ s ə n v ɛ i̯ f t ə x
zesenzestig	z ɛ s ə n s ɛ s t ə x
zesmotorig	z ɛ s m oː t oː r ə x
zesthalf	z ɛ s t ɦ ɑ l f
zetellift	z eː t ə l l ɪ f t
zetfeil	z ɛ t f ɛ i̯ l
zeur	z øː r
zeuven	z øː v ə n
zevenendertig	z eː v ə n ɛ n d ɛ r t ə x
zevenenveertig	z eː v ə n ə n v eː r t ə x
zevenslaper	z eː v ə n s l aː p ə r
zeventiende	z eː v ə n t i n d ə
zeventigste	s eː v ə n t ə x s t ə
zichzelf	z ɪ x z ɛ l f
ziederij	z i d ə r ɛ i̯
ziekenhuisbacterie	z i k ə n ɦ œ y̯ s b ɑ k t eː r i
zienswaardig	z i n s ʋ aː r d ə x
zierikzee	z i r ɪ k z eː
zigzag	z ɪ x z ɑ x
zijband	z ɛ i̯ b ɑ n t
zijd	z ɛ i̯ t
zijden	z ɛ i̯ d ə n
zijdevlinder	z ɛ i̯ d ə v l ɪ n d ə r
zijdgeweer	z ɛ i̯ t x ə ʋ eː r
zijkant	z ɛ i̯ k ɑ n t
zijlie	z ɛ i̯ l i
zijpad	z ɛ i̯ p ɑ t
zilver	z ɪ l v ə r
zilveren	z ɪ l v ə r ə n
zilverkleur	z ɪ l v ə r k l øː r
zilverkleurig	z ɪ l v ə r k l øː r ə x
zinnenprikkelend	z ɪ n ə p r ɪ k ə l ə n t
zinsbouw	z ɪ n s b ɑ u̯
zinspreuk	z ɪ n s p r øː k
zitkamer	z ɪ t k aː m ə r
zo'n	z oː n
zoals	z oː ɑ l s
zodoende	z oː d u n d ə
zoenverdrag	z u n v ə r d r ɑ x
zogeheten	z oː ɣ ə ɦ eː t ə n
zogen	z oː ɣ ə n
zogenoemd	z oː ɣ ə n u m t
zoiets	z oː i t s
zojuist	z oː j œ y̯ s t
zolang	z oː l ɑ ŋ
zolder	z ɔ l d ə r
zoldering	z ɔ l d ə r ɪ ŋ
zomen	z oː m ə n
zomerhuis	z oː m ə r ɦ œ y̯ s
zonaal	z oː n aː l
zonaanbidder	z ɔ n aː n b ɪ d ə r
zondagskind	z ɔ n d ɑ x s k ɪ n t
zondagsochtends	z ɔ n d ɑ x s ɔ x t ə n t s
zonde	z ɔ n d ə
zondervan	z ɔ n d ə r v ɑ n
zone	z ɔː n ə
zoneclips	z ɔ n eː k l ɪ p s
zoniet	z oː n i t
zonnedag	z ɔ n ə d ɑ x
zonneklaar	z ɔ n ə k l aː r
zonnescherm	z ɔ n ə s x ɛ r m
zonnestudio	z ɔ n ə s t y d i oː
zonnetempel	z ɔ n ə t ɛ m p ə l
zonnewind	z ɔ n ə ʋ ɪ n t
zonnig	z ɔ n ə x
zonsmassa	z ɔ n s m ɑ s aː
zonsopgang	z ɔ n s ɔ p x ɑ ŋ
zoogdier	z oː x d iː r
zoogt	z oː x t
zoolganger	z oː l ɣ ɑ ŋ ə r
zorgboerderij	z ɔ r x b u r d ə r ɛ i̯
zorgenkind	z ɔ r ɣ ə n k ɪ n t
zoroastrist	z oː r oː ɑ s t r ɪ s t
zoutloos	z ɑ u̯ t l oː s
zoutzuur	z ɑ u̯ t z yː r
zover	z oː v ɛ r
zoëven	z oː eː v ə n
zuchtmeisje	z ʏ x t m ɛ i̯ s j ə
zuid	z œ y̯ t
zuidelijk	z œ y̯ d ə l ə k
zuiderdriehoek	z œ y̯ d ə r d r i ɦ u k
zuidervis	z œ y̯ d ə r v ɪ s
zuidpoolkip	z œ y̯ t p oː l k ɪ p
zuidwestelijk	z œ y̯ t ʋ ɛ s t ə l ə k
zuigeling	z œ y̯ ɣ ə l ɪ ŋ
zuigfeest	z œ y̯ x f eː s t
zuilengalerij	z œ y̯ l ə n ɣ aː l ə r ɛ i̯
zuinigjes	z œ y̯ n ə x j ə s
zuipkop	z œ y̯ p k ɔ p
zuivel	z œ y̯ v ə l
zuiver	z œ y̯ v ə r
zuiverheid	z œ y̯ v ə r ɦ ɛ i̯ t
zuiveringseed	z œ y̯ v ə r ɪ ŋ s eː t
zusterschap	z ʏ s t ə r s x ɑ p
zuurkool	z yː r k oː l
zuurstofrijk	z yː r s t ɔ f r ɛ i̯ k
zuurstok	z yː r s t ɔ k
zwaardknop	z ʋ aː r t k n ɔ p
zwaarlijvig	z ʋ aː r l ɛ i̯ v ə x
zwade	z ʋ aː d ə
zwalken	z ʋ ɑ l k ə n
zwartmaken	z ʋ ɑ r t m aː k ə n
zwarts	z ʋ ɑ r t s
zwavelzuur	z ʋ aː v ə l z yː r
zweden	z ʋ eː d ə n
zweeftrein	z ʋ eː f t r ɛ i̯ n
zweefvliegen	z ʋ eː f f l i ɣ ə n
zweephaar	z ʋ eː p ɦ aː r
zweer	z ʋ eː r
zwelgpartij	z ʋ ɛ l x p ɑ r t ɛ i̯
zwelten	z ʋ ɛ l t ə n
zwemblaas	z ʋ ɛ m b l aː s
zwemmen	z ʋ ɛ m ə n
zwempak	z ʋ ɛ m p ɑ k
zwerfhonden	z ʋ ɛ r f ɦ ɔ n d ə n
zwerfkat	z ʋ ɛ r f k ɑ t
zwerfkei	z ʋ ɛ r f k ɛ i̯
zwerfvuil	z ʋ ɛ r f œ y̯ l
zwerfwoord	z ʋ ɛ r f ʋ oː r t
zwerk	z ʋ ɛ r k
zwerver	z ʋ ɛ r v ə r
zwezerik	z ʋ eː z ə r ɪ k
zwichten	z ʋ ɪ x t ə n
zwieren	z ʋ iː r ə n
zwijmen	z ʋ ɛ i̯ m ə n
zwijn	z ʋ ɛ i̯ n
zwik	z ʋ ɪ k
zwitsers	z ʋ ɪ t s ə r s
zwolle	z ʋ ɔ l ə
