abandonner	a b ɑ̃ d ɔ n e
abby	a b i
abidjan	a b i d ʒ ɑ̃
abject	a b ʒ ɛ k t
abolir	a b ɔ l i ʁ
abonnement	a b ɔ n m ɑ̃
abou	a b u
absence	a p s ɑ̃ s
absolument	a p s ɔ l y m ɑ̃
absolus	a p s ɔ l y
absurde	a p s y ʁ d
abusif	a b y z i f
académie	a k a d e m i
acceptation	a k s ɛ p t a s j ɔ̃
accepter	a k s ɛ p t e
accepté	a k s ɛ p t e
accessoire	a k s e s w a ʁ
accident	a k s i d ɑ̃
accompagner	a k ɔ̃ p a ɲ e
accorder	a k ɔ ʁ d e
accordé	a k ɔ ʁ d e
accroître	a k ʁ w a t ʁ
accrue	a k ʁ y
accueil	a k œ j
accusation	a k y z a s j ɔ̃
accusé	a k y z e
accès	a k s ɛ
acheter	a ʃ t e
achever	a ʃ v e
achevé	a ʃ v e
achèvement	a ʃ ɛ v m ɑ̃
acolyte	a k ɔ l i t
acquisition	a k i z i s j ɔ̃
acquérir	a k e ʁ i ʁ
acronyme	a k ʁ ɔ n i m
acte	a k t
actes	a k t
acteur	a k t œ ʁ
acteurs	a k t œ ʁ
actif	a k t i f
actifs	a k t i f
actionnaire	a k s j ɔ n ɛ ʁ
actives	a k t i v
actrice	a k t ʁ i s
actualité	a k t ɥ a l i t e
actualités	a k t ɥ a l i t e
actuel	a k t ɥ ɛ l
actuelle	a k t ɥ ɛ l
actuellement	a k t ɥ ɛ l m ɑ̃
adam	a d ɑ̃
adaptation	a d a p t a s j ɔ̃
adapter	a d a p t e
adapté	a d a p t e
adeline	a d l i n
adhérents	a d e ʁ ɑ̃
adhésion	a d e z j ɔ̃
adieu	a d j ø
adjoint	a d ʒ w ɛ̃
adjugeant	a d ʒ y ʒ ɑ̃
administration	a d m i n i s t ʁ a s j ɔ̃
admissions	a d m i s j ɔ̃
adolescent	a d ɔ l ɛ s ɑ̃
adolescente	a d ɔ l ɛ s ɑ̃ t
adopter	a d ɔ p t e
adoption	a d ɔ p s j ɔ̃
adresses	a d ʁ ɛ s
adversaire	a d v ɛ ʁ s ɛ ʁ
affiche	a f i ʃ
afficher	a f i ʃ e
affirmait	a f i ʁ m ɛ
affirmant	a f i ʁ m ɑ̃
affirme	a f i ʁ m
affirment	a f i ʁ m
affirmé	a f i ʁ m e
affriolant	a f ʁ i j ɔ l ɑ̃
affrontement	a f ʁ ɔ̃ t m ɑ̃
affronter	a f ʁ ɔ̃ t e
afghan	a f ɡ ɑ̃
afghanistan	a f ɡ a n i s t ɑ̃
afin	a f ɛ̃
africaine	a f ʁ i k ɛ n
afrique	a f ʁ i k
age	a ʒ
agenda	a ʒ ɛ̃ d a
agent	a ʒ ɑ̃
agents	a ʒ ɑ̃
agir	a ʒ i ʁ
agnès	a ɲ ɛ s
agrandir	a ɡ ʁ ɑ̃ d i ʁ
agression	a ɡ ʁ ɛ s j ɔ̃
agricole	a ɡ ʁ i k ɔ l
agriculture	a ɡ ʁ i k y l t y ʁ
agréable	a ɡ ʁ e a b l
aigle	ɛ ɡ l
ailier	ɛ l j e
aillent	a j
aime	ɛ m
aiment	ɛ m
aimerait	ɛ m ʁ ɛ
aimons	ɛ m ɔ̃
ainsi	ɛ̃ s i
aise	ɛ z
ajouté	a ʒ u t e
ajuster	a ʒ y s t e
alain	a l ɛ̃
alberta	a l b ɛ ʁ t a
album	a l b ɔ m
alentours	a l ɑ̃ t u ʁ
alerte	a l ɛ ʁ t
alerter	a l ɛ ʁ t e
alex	a l ɛ k s
alexandre	a l ɛ k s ɑ̃ d ʁ
algérie	a l ʒ e ʁ i
alien	a l j ɛ n
aligner	a l i ɲ e
alimentaire	a l i m ɑ̃ t ɛ ʁ
alimentation	a l i m ɑ̃ t a s j ɔ̃
alimenter	a l i m ɑ̃ t e
aline	a l i n
allaient	a l ɛ
allait	a l ɛ
allaitement	a l ɛ t m ɑ̃
allemagne	a l m a ɲ
allemand	a l m ɑ̃
allemands	a l m ɑ̃
aller	a l e
allez	a l e
alliance	a l j ɑ̃ s
allocution	a l ɔ k y s j ɔ̃
allons	a l ɔ̃
allumeuse	a l y m ø z
allure	a l y ʁ
allusion	a l y z j ɔ̃
allé	a l e
allée	a l e
alors	a l ɔ ʁ
alpes	a l p
alphonse	a l f ɔ̃ s
alsacien	a l z a s j ɛ̃
altitude	a l t i t y d
alès	a l ɛ s
amateur	a m a t œ ʁ
amateurs	a m a t œ ʁ
ambassadeur	ɑ̃ b a s a d œ ʁ
ambiance	ɑ̃ b j ɑ̃ s
ambigu	ɑ̃ b i ɡ y
ambitieux	ɑ̃ b i s j ø
ambition	ɑ̃ b i s j ɔ̃
ambroisie	ɑ̃ b ʁ w a z i
amende	a m ɑ̃ d
amener	a m n e
ami	a m i
amical	a m i k a l
amiral	a m i ʁ a l
amis	a m i
amitié	a m i t j e
amnistie	a m n i s t i
amortissement	a m ɔ ʁ t i s m ɑ̃
amour	a m u ʁ
amoureux	a m u ʁ ø
amours	a m u ʁ
ampleur	ɑ̃ p l œ ʁ
amplifier	ɑ̃ p l i f j e
amsterdam	a m s t ɛ ʁ d a m
amuse	a m y z
amène	a m ɛ n
améliorer	a m e l j ɔ ʁ e
américain	a m e ʁ i k ɛ̃
amérique	a m e ʁ i k
analyste	a n a l i s t
analystes	a n a l i s t
ancien	ɑ̃ s j ɛ̃
ancienne	ɑ̃ s j ɛ n
andrée	ɑ̃ d ʁ e
anglais	ɑ̃ ɡ l ɛ
anglaise	ɑ̃ ɡ l ɛ z
angleterre	ɑ̃ ɡ l ə t ɛ ʁ
anneaux	a n o
annie	a n i
anniversaire	a n i v ɛ ʁ s ɛ ʁ
annonce	a n ɔ̃ s
annulation	a n y l a s j ɔ̃
année	a n e
années	a n e
annélidés	a n e l i d e
anodin	a n ɔ d ɛ̃
anonyme	a n ɔ n i m
antenne	ɑ̃ t ɛ n
anticipation	ɑ̃ t i s i p a s j ɔ̃
anticipatrice	ɑ̃ t i s i p a t ʁ i s
antimoine	ɑ̃ t i m w a n
antioche	ɑ̃ t j ɔ ʃ
antisémitisme	ɑ̃ t i s e m i t i z m
antoine	ɑ̃ t w a n
apparat	a p a ʁ a
apparaître	a p a ʁ ɛ t ʁ
appareil	a p a ʁ ɛ j
apparemment	a p a ʁ a m ɑ̃
apparence	a p a ʁ ɑ̃ s
apparente	a p a ʁ ɑ̃ t
appartement	a p a ʁ t ə m ɑ̃
appel	a p ɛ l
appelant	a p l ɑ̃
appeler	a p ə l e
appelle	a p ɛ l
appliquer	a p l i k e
apport	a p ɔ ʁ
apporter	a p ɔ ʁ t e
apprendre	a p ʁ ɑ̃ d ʁ
apprenti	a p ʁ ɑ̃ t i
appris	a p ʁ i
approche	a p ʁ ɔ ʃ
approcher	a p ʁ ɔ ʃ e
approvisionner	a p ʁ ɔ v i z j ɔ n e
approximativement	a p ʁ ɔ k s i m a t i v m ɑ̃
appui	a p ɥ i
après	a p ʁ ɛ
apéro	a p e ʁ o
aquatique	a k w a t i k
arabe	a ʁ a b
arbitre	a ʁ b i t ʁ
architecture	a ʁ ʃ i t ɛ k t y ʁ
argentine	a ʁ ʒ ɑ̃ t i n
aria	a ʁ j a
arles	a ʁ l
armes	a ʁ m
armé	a ʁ m e
armée	a ʁ m e
arrache	a ʁ a ʃ
arracher	a ʁ a ʃ e
arraché	a ʁ a ʃ e
arranger	a ʁ ɑ̃ ʒ e
arrestation	a ʁ ɛ s t a s j ɔ̃
arrive	a ʁ i v
arriver	a ʁ i v e
arrivée	a ʁ i v e
arrière	a ʁ j ɛ ʁ
arrête	a ʁ ɛ t
art	a ʁ
article	a ʁ t i k l
artisan	a ʁ t i z ɑ̃
artiste	a ʁ t i s t
artistes	a ʁ t i s t
artistique	a ʁ t i s t i k
arts	a ʁ
as	ɑ s
ascendant	a s ɑ̃ d ɑ̃
asiatique	a z j a t i k
asie	a z i
asile	a z i l
aspect	a s p ɛ
asphyxie	a s f i k s i
assaut	a s o
assemblée	a s ɑ̃ b l e
assez	a s e
assis	a s i
assises	a s i z
assistent	a s i s t
assister	a s i s t e
association	a s ɔ s j a s j ɔ̃
associative	a s ɔ s j a t i v
associer	a s ɔ s j e
assume	a s y m
assumer	a s y m e
assumera	a s y m ʁ a
assumé	a s y m e
assurance	a s y ʁ ɑ̃ s
assurer	a s y ʁ e
assurément	a s y ʁ e m ɑ̃
atelier	a t ə l j e
athlète	a t l ɛ t
atlantique	a t l ɑ̃ t i k
atomes	a t ɔ m
atomique	a t ɔ m i k
atteindre	a t ɛ̃ d ʁ
attend	a t ɑ̃
attendre	a t ɑ̃ d ʁ
attends	a t ɑ̃
attendu	a t ɑ̃ d y
attentat	a t ɑ̃ t a
attente	a t ɑ̃ t
attention	a t ɑ̃ s j ɔ̃
atterrissage	a t ɛ ʁ i s a ʒ
attirer	a t i ʁ e
attitude	a t i t y d
attrait	a t ʁ ɛ
aubaine	o b ɛ n
aucun	o k œ̃
aucune	o k y n
audace	o d a s
audience	o d j ɑ̃ s
augmentation	o ɡ m ɑ̃ t a s j ɔ̃
auparavant	o p a ʁ a v ɑ̃
auprès	o p ʁ ɛ
auquel	o k ɛ l
aura	o ʁ a
aurait	o ʁ ɛ
aurions	o ʁ j ɔ̃
auront	o ʁ ɔ̃
australie	o s t ʁ a l i
australien	o s t ʁ a l j ɛ̃
autobus	o t o b y s
automatiquement	o t ɔ m a t i k m ɑ̃
automne	o t ɔ n
automobile	o t ɔ m ɔ b i l
autonomie	o t ɔ n ɔ m i
autopsie	o t ɔ p s i
autoroute	o t ɔ ʁ u t
autoroutier	o t ɔ ʁ u t j e
autour	o t u ʁ
autrement	o t ʁ ə m ɑ̃
autriche	o t ʁ i ʃ
auxquelles	o k ɛ l
avais	a v ɛ
avait	a v ɛ
avance	a v ɑ̃ s
avancé	a v ɑ̃ s e
avancée	a v ɑ̃ s e
avant	a v ɑ̃
avantage	a v ɑ̃ t a ʒ
avare	a v a ʁ
avec	a v ɛ k
avenir	a v n i ʁ
aventure	a v ɑ̃ t y ʁ
avenue	a v n y
avertir	a v ɛ ʁ t i ʁ
avertissement	a v ɛ ʁ t i s m ɑ̃
aveugle	a v œ ɡ l
avez	a v e
aviation	a v j a s j ɔ̃
avignon	a v i ɲ ɔ̃
avion	a v j ɔ̃
avions	a v j ɔ̃
avis	a v i
avisé	a v i z e
avocat	a v ɔ k a
avons	a v ɔ̃
axel	a k s ɛ l
ayant	ɛ j ɑ̃
ayez	ɛ j e
azerbaïdjan	a z ɛ ʁ b a j d ʒ ɑ̃
azuréenne	a z y ʁ e ɛ n
aérienne	a e ʁ j ɛ n
aéroport	a e ʁ ɔ p ɔ ʁ
baby	b a b i
babylone	b a b i l ɔ n
bader	b a d e
bagage	b a ɡ a ʒ
bagages	b a ɡ a ʒ
bagdad	b a ɡ d a d
bahreïn	b a ʁ ɛ j n
baiser	b ɛ z e
baisse	b ɛ s
baladeur	b a l a d œ ʁ
balayer	b a l ɛ j e
ballon	b a l ɔ̃
bamako	b a m a k o
banal	b a n a l
banane	b a n a n
banc	b ɑ̃
banderilles	b ɑ̃ d ʁ i j
banderole	b ɑ̃ d ʁ ɔ l
bangkok	b ɑ̃ k ɔ k
banlieue	b ɑ̃ l j ø
bannir	b a n i ʁ
banque	b ɑ̃ k
banquier	b ɑ̃ k j e
bara	b a ʁ a
barcelone	b a ʁ s ə l ɔ n
bardot	b a ʁ d o
baromètre	b a ʁ ɔ m ɛ t ʁ
barque	b a ʁ k
bas	b ɑ
basculer	b a s k y l e
basculé	b a s k y l e
baseball	b ɛ z b ɔ l
basile	b a z i l
basket	b a s k ɛ t
basque	b a s k
basse	b ɑ s
bataillon	b a t a j ɔ̃
bateau	b a t o
batteur	b a t œ ʁ
baudouin	b o d w ɛ̃
baume	b o m
bavière	b a v j ɛ ʁ
bazar	b a z a ʁ
bce	b e s e ø
bd	b e d e
beau	b o
beauchamp	b o ʃ ɑ̃
beaucoup	b o k u
beauté	b o t e
bec	b ɛ k
bel	b ɛ l
belge	b ɛ l ʒ
belgique	b ɛ l ʒ i k
belle	b ɛ l
belles	b ɛ l
benêt	b ə n ɛ
berlin	b ɛ ʁ l ɛ̃
bernard	b ɛ ʁ n a ʁ
berne	b ɛ ʁ n
bertrand	b ɛ ʁ t ʁ ɑ̃
besoin	b ə z w ɛ̃
besson	b ɛ s ɔ̃
biathlon	b j a t l ɔ̃
bible	b i b l
bien	b j ɛ̃
bienfait	b j ɛ̃ f ɛ
bienvenue	b j ɛ̃ v ə n y
bilan	b i l ɑ̃
bilatéral	b i l a t e ʁ a l
bill	b i l
billet	b i j ɛ
bio	b j o
biologie	b j ɔ l ɔ ʒ i
bière	b j ɛ ʁ
black	b l a k
blague	b l a ɡ
blaise	b l ɛ z
blanc	b l ɑ̃
blanche	b l ɑ̃ ʃ
blasé	b l ɑ z e
blesse	b l ɛ s
blessure	b l e s y ʁ
blessé	b l e s e
bloc	b l ɔ k
blocage	b l ɔ k a ʒ
blog	b l ɔ ɡ
blonde	b l ɔ̃ d
bloquer	b l ɔ k e
blouson	b l u z ɔ̃
boire	b w a ʁ
bombe	b ɔ̃ b
bond	b ɔ̃
bonheur	b ɔ n œ ʁ
bonne	b ɔ n
bonnes	b ɔ n
bonus	b ɔ n y s
bord	b ɔ ʁ
bordeaux	b ɔ ʁ d o
bordure	b ɔ ʁ d y ʁ
bordée	b ɔ ʁ d e
borne	b ɔ ʁ n
bosnie	b o z n i
botte	b ɔ t
boucle	b u k l
boucler	b u k l e
bouclier	b u k l i j e
bouddha	b u d a
boue	b u
bouillon	b u j ɔ̃
boulanger	b u l ɑ̃ ʒ e
boule	b u l
boulevard	b u l v a ʁ
boulot	b u l o
boursier	b u ʁ s j e
boursière	b u ʁ s j ɛ ʁ
bousculent	b u s k y l
bousculé	b u s k y l e
bouteille	b u t ɛ j
bouteilles	b u t ɛ j
bouée	b w e
box	b ɔ k s
bracelet	b ʁ a s l ɛ
branche	b ʁ ɑ̃ ʃ
bras	b ʁ ɑ
break	b ʁ ɛ k
bretagne	b ʁ ə t a ɲ
brevet	b ʁ ə v ɛ
bridge	b ʁ i d ʒ
brigade	b ʁ i ɡ a d
brin	b ʁ ɛ̃
britannique	b ʁ i t a n i k
british	b ʁ i t i ʃ
brouillard	b ʁ u j a ʁ
bruit	b ʁ ɥ i
bruno	b ʁ y n o
brut	b ʁ y t
bruxellois	b ʁ y s ɛ l w a
brésil	b ʁ e z i l
brésilien	b ʁ e z i l j ɛ̃
brûlé	b ʁ y l e
budget	b y d ʒ ɛ
budgétaire	b y d ʒ e t ɛ ʁ
bulle	b y l
bulletin	b y l t ɛ̃
buse	b y z
business	b i z n ɛ s
buteur	b y t œ ʁ
bâtiment	b ɑ t i m ɑ̃
bâton	b ɑ t ɔ̃
béatrice	b e a t ʁ i s
bébé	b e b e
bélier	b e l j e
bénéficiaire	b e n e f i s j ɛ ʁ
bénéficiaires	b e n e f i s j ɛ ʁ
bénéficie	b e n e f i s i
bénéficient	b e n e f i s i
bénéficier	b e n e f i s j e
bénéficié	b e n e f i s j e
bénévole	b e n e v ɔ l
bétail	b e t a j
bêta	b ɛ t a
bête	b ɛ t
ca	s e a
cabillaud	k a b i j o
cabinet	k a b i n ɛ
cabriolet	k a b ʁ i j ɔ l ɛ
cac	k a k
cache	k a ʃ
cadavre	k a d ɑ v ʁ
cadeau	k a d o
cadenas	k a d n ɑ
cadre	k ɑ d ʁ
caen	k ɑ̃
café	k a f e
cage	k a ʒ
caillou	k a j u
caisse	k ɛ s
calcul	k a l k y l
calendrier	k a l ɑ̃ d ʁ i j e
caler	k a l e
californie	k a l i f ɔ ʁ n i
calme	k a l m
calmer	k a l m e
calvados	k a l v a d o s
calvaire	k a l v ɛ ʁ
cameroun	k a m ʁ u n
camerounais	k a m ʁ u n ɛ
campagne	k ɑ̃ p a ɲ
campagnol	k ɑ̃ p a ɲ ɔ l
caméra	k a m e ʁ a
canada	k a n a d a
canadien	k a n a d j ɛ̃
canadiens	k a n a d j ɛ̃
cancer	k ɑ̃ s ɛ ʁ
candidat	k ɑ̃ d i d a
candidats	k ɑ̃ d i d a
caniveau	k a n i v o
cannes	k a n
canton	k ɑ̃ t ɔ̃
cantons	k ɑ̃ t ɔ̃
cap	k a p
capable	k a p a b l
capacité	k a p a s i t e
cape	k a p
capitaine	k a p i t ɛ n
capital	k a p i t a l
capitale	k a p i t a l
capitonnerais	k a p i t ɔ n ʁ ɛ
captivant	k a p t i v ɑ̃
car	k a ʁ
caractéristique	k a ʁ a k t e ʁ i s t i k
carnet	k a ʁ n ɛ
caroline	k a ʁ ɔ l i n
carrefour	k a ʁ f u ʁ
carrière	k a ʁ j ɛ ʁ
carrières	k a ʁ j ɛ ʁ
carrément	k a ʁ e m ɑ̃
carte	k a ʁ t
cartes	k a ʁ t
carton	k a ʁ t ɔ̃
cas	k ɑ
cash	k a ʃ
casier	k ɑ z j e
casse	k ɑ s
casser	k ɑ s e
casting	k a s t i ŋ
catalan	k a t a l ɑ̃
catalogue	k a t a l ɔ ɡ
catapulte	k a t a p y l t
catastrophe	k a t a s t ʁ ɔ f
catherine	k a t ʁ i n
catholique	k a t ɔ l i k
catholiques	k a t ɔ l i k
catégorie	k a t e ɡ ɔ ʁ i
caucase	k ɔ k a z
cause	k o z
causer	k o z e
cavalerie	k a v a l ʁ i
ce	s ə
ceci	s ə s i
cela	s ə l a
celle	s ɛ l
celles	s ɛ l
celui	s ə l ɥ i
centaine	s ɑ̃ t ɛ n
centime	s ɑ̃ t i m
central	s ɑ̃ t ʁ a l
centrale	s ɑ̃ t ʁ a l
centre	s ɑ̃ t ʁ
centres	s ɑ̃ t ʁ
centristes	s ɑ̃ t ʁ i s t
cependant	s ə p ɑ̃ d ɑ̃
cerise	s ə ʁ i z
certainement	s ɛ ʁ t ɛ n m ɑ̃
certes	s ɛ ʁ t
certitude	s ɛ ʁ t i t y d
cession	s ɛ s j ɔ̃
cet	s ɛ t ‿
cette	s ɛ t
ceux	s ø
cgt	s e ʒ e t e
chaire	ʃ ɛ ʁ
challenge	ʃ a l ɑ̃ ʒ
chambre	ʃ ɑ̃ b ʁ
chamonix	ʃ a m ɔ n i
champ	ʃ ɑ̃
championnat	ʃ ɑ̃ p j ɔ n a
change	ʃ ɑ̃ ʒ
changement	ʃ ɑ̃ ʒ m ɑ̃
changer	ʃ ɑ̃ ʒ e
chanson	ʃ ɑ̃ s ɔ̃
chansons	ʃ ɑ̃ s ɔ̃
chantal	ʃ ɑ̃ t a l
chanter	ʃ ɑ̃ t e
chanteur	ʃ ɑ̃ t œ ʁ
chanteuse	ʃ ɑ̃ t ø z
chaos	k a o
chapitre	ʃ a p i t ʁ
chaque	ʃ a k
charge	ʃ a ʁ ʒ
charges	ʃ a ʁ ʒ
charles	ʃ a ʁ l
charlotte	ʃ a ʁ l ɔ t
charmes	ʃ a ʁ m
charte	ʃ a ʁ t
chaud	ʃ o
chaîne	ʃ ɛ n
chef	ʃ ɛ f
cheffe	ʃ ɛ f
chefs	ʃ ɛ f
chemin	ʃ ə m ɛ̃
cher	ʃ ɛ ʁ
chercher	ʃ ɛ ʁ ʃ e
chercheur	ʃ ɛ ʁ ʃ œ ʁ
chers	ʃ ɛ ʁ
cheville	ʃ ə v i j
chez	ʃ e
chic	ʃ i k
chicago	ʃ i k a ɡ o
chien	ʃ j ɛ̃
chiffre	ʃ i f ʁ
chiffres	ʃ i f ʁ
chilien	ʃ i l j ɛ̃
chine	ʃ i n
chinois	ʃ i n w a
chlore	k l ɔ ʁ
chocolat	ʃ ɔ k ɔ l a
choisir	ʃ w a z i ʁ
choix	ʃ w a
choses	ʃ o z
chouette	ʃ w ɛ t
christian	k ʁ i s t j ɑ̃
christine	k ʁ i s t i n
christophe	k ʁ i s t ɔ f
chronique	k ʁ ɔ n i k
chu	ʃ y
chum	t ʃ ɔ m
chute	ʃ y t
chypre	ʃ i p ʁ
chypriote	ʃ i p ʁ i j ɔ t
chômage	ʃ o m a ʒ
chômer	ʃ o m e
ciel	s j ɛ l
cigarettes	s i ɡ a ʁ ɛ t
cimetière	s i m t j ɛ ʁ
cinquante	s ɛ̃ k ɑ̃ t
cinquième	s ɛ̃ k j ɛ m
cinéma	s i n e m a
cinémas	s i n e m ɑ
circuit	s i ʁ k ɥ i
circuits	s i ʁ k ɥ i
circulation	s i ʁ k y l a s j ɔ̃
cirque	s i ʁ k
citation	s i t a s j ɔ̃
citer	s i t e
citron	s i t ʁ ɔ̃
citroën	s i t ʁ o ɛ n
cité	s i t e
civil	s i v i l
clair	k l ɛ ʁ
claire	k l ɛ ʁ
clairement	k l ɛ ʁ m ɑ̃
clan	k l ɑ̃
classiques	k l a s i k
claude	k l o d
claustrophobie	k l o s t ʁ ɔ f ɔ b i
client	k l i j ɑ̃
clients	k l i j ɑ̃
clique	k l i k
cloche	k l ɔ ʃ
clore	k l ɔ ʁ
clos	k l o
clou	k l u
clémence	k l e m ɑ̃ s
clés	k l e
clôture	k l o t y ʁ
coach	k o t ʃ
coalition	k ɔ a l i s j ɔ̃
coche	k ɔ ʃ
cochon	k ɔ ʃ ɔ̃
coco	k o k o
code	k ɔ d
cohésion	k ɔ e z j ɔ̃
coin	k w ɛ̃
colisée	k ɔ l i z e
colle	k ɔ l
collecte	k ɔ l ɛ k t
collectif	k ɔ l ɛ k t i f
collection	k ɔ l ɛ k s j ɔ̃
collectivités	k ɔ l ɛ k t i v i t e
coller	k ɔ l e
collège	k ɔ l ɛ ʒ
collègue	k ɔ l ɛ ɡ
colombien	k ɔ l ɔ̃ b j ɛ̃
colonel	k ɔ l ɔ n ɛ l
colonial	k ɔ l ɔ n j a l
colonisation	k ɔ l ɔ n i z a s j ɔ̃
colère	k ɔ l ɛ ʁ
combat	k ɔ̃ b a
combattants	k ɔ̃ b a t ɑ̃
combinaison	k ɔ̃ b i n ɛ z ɔ̃
combiner	k ɔ̃ b i n e
combiné	k ɔ̃ b i n e
comble	k ɔ̃ b l
comblés	k ɔ̃ b l e
comité	k ɔ m i t e
commandant	k ɔ m ɑ̃ d ɑ̃
commande	k ɔ m ɑ̃ d
commandement	k ɔ m ɑ̃ d m ɑ̃
commanditaire	k ɔ m ɑ̃ d i t ɛ ʁ
comme	k ɔ m
commencer	k ɔ m ɑ̃ s e
comment	k ɔ m ɑ̃
commentaire	k ɔ m ɑ̃ t ɛ ʁ
commentaires	k ɔ m ɑ̃ t ɛ ʁ
commenter	k ɔ m ɑ̃ t e
commençant	k ɔ m ɑ̃ s ɑ̃
commerciale	k ɔ m ɛ ʁ s j a l
commerciales	k ɔ m ɛ ʁ s j a l
commercialisation	k ɔ m ɛ ʁ s j a l i z a s j ɔ̃
commerciaux	k ɔ m ɛ ʁ s j o
commettre	k ɔ m ɛ t ʁ
commis	k ɔ m i
commun	k ɔ m œ̃
communales	k ɔ m y n a l
communauté	k ɔ m y n o t e
communautés	k ɔ m y n o t e
commune	k ɔ m y n
communication	k ɔ m y n i k a s j ɔ̃
communiste	k ɔ m y n i s t
compagnie	k ɔ̃ p a ɲ i
compagnies	k ɔ̃ p a ɲ i
compagnon	k ɔ̃ p a ɲ ɔ̃
comparaison	k ɔ̃ p a ʁ ɛ z ɔ̃
comparaître	k ɔ̃ p a ʁ ɛ t ʁ
compatible	k ɔ̃ p a t i b l
compenser	k ɔ̃ p ɑ̃ s e
complaisant	k ɔ̃ p l ɛ z ɑ̃
complexe	k ɔ̃ p l ɛ k s
complexité	k ɔ̃ p l ɛ k s i t e
complications	k ɔ̃ p l i k a s j ɔ̃
complètement	k ɔ̃ p l ɛ t m ɑ̃
composer	k ɔ̃ p o z e
composition	k ɔ̃ p o z i s j ɔ̃
composé	k ɔ̃ p o z e
comprendre	k ɔ̃ p ʁ ɑ̃ d ʁ
compris	k ɔ̃ p ʁ i
compte	k ɔ̃ t
compter	k ɔ̃ t e
comptes	k ɔ̃ t
compteur	k ɔ̃ t œ ʁ
comptoir	k ɔ̃ t w a ʁ
compétition	k ɔ̃ p e t i s j ɔ̃
compétitivité	k ɔ̃ p e t i t i v i t e
comté	k ɔ̃ t e
comédies	k ɔ m e d i
con	k ɔ̃
concentrer	k ɔ̃ s ɑ̃ t ʁ e
concept	k ɔ̃ s ɛ p t
concernant	k ɔ̃ s ɛ ʁ n ɑ̃
concerné	k ɔ̃ s ɛ ʁ n e
conciliant	k ɔ̃ s i l j ɑ̃
conclu	k ɔ̃ k l y
conclure	k ɔ̃ k l y ʁ
concurrence	k ɔ̃ k y ʁ ɑ̃ s
condamnation	k ɔ̃ d ɑ n a s j ɔ̃
condition	k ɔ̃ d i s j ɔ̃
conducteur	k ɔ̃ d y k t œ ʁ
conduire	k ɔ̃ d ɥ i ʁ
conduit	k ɔ̃ d ɥ i
conduite	k ɔ̃ d ɥ i t
confiance	k ɔ̃ f j ɑ̃ s
conflit	k ɔ̃ f l i
conforme	k ɔ̃ f ɔ ʁ m
conformer	k ɔ̃ f ɔ ʁ m e
confrontation	k ɔ̃ f ʁ ɔ̃ t a s j ɔ̃
confus	k ɔ̃ f y
confusion	k ɔ̃ f y z j ɔ̃
confédération	k ɔ̃ f e d e ʁ a s j ɔ̃
congolais	k ɔ̃ ɡ ɔ l ɛ
congrès	k ɔ̃ ɡ ʁ ɛ
congé	k ɔ̃ ʒ e
conjoint	k ɔ̃ ʒ w ɛ̃
conjointe	k ɔ̃ ʒ w ɛ̃ t
conjoints	k ɔ̃ ʒ w ɛ̃
connaissance	k ɔ n ɛ s ɑ̃ s
connaissances	k ɔ n ɛ s ɑ̃ s
connaissent	k ɔ n ɛ s
connaît	k ɔ n ɛ
connaître	k ɔ n ɛ t ʁ
connecter	k ɔ n ɛ k t e
connu	k ɔ n y
consacrer	k ɔ̃ s a k ʁ e
conseil	k ɔ̃ s ɛ j
consensus	k ɔ̃ s ɛ̃ s y s
conservateur	k ɔ̃ s ɛ ʁ v a t œ ʁ
considération	k ɔ̃ s i d e ʁ a s j ɔ̃
considérer	k ɔ̃ s i d e ʁ e
consolation	k ɔ̃ s ɔ l a s j ɔ̃
console	k ɔ̃ s ɔ l
consoler	k ɔ̃ s ɔ l e
consommation	k ɔ̃ s ɔ m a s j ɔ̃
constance	k ɔ̃ s t ɑ̃ s
constantin	k ɔ̃ s t ɑ̃ t ɛ̃
constat	k ɔ̃ s t a
constatation	k ɔ̃ s t a t a s j ɔ̃
constater	k ɔ̃ s t a t e
constituent	k ɔ̃ s t i t ɥ ɑ̃
constituer	k ɔ̃ s t i t ɥ e
constitution	k ɔ̃ s t i t y s j ɔ̃
constitutionnel	k ɔ̃ s t i t y s j ɔ n ɛ l
constructeur	k ɔ̃ s t ʁ y k t œ ʁ
consécutif	k ɔ̃ s e k y t i f
contact	k ɔ̃ t a k t
contacter	k ɔ̃ t a k t e
contemporain	k ɔ̃ t ɑ̃ p ɔ ʁ ɛ̃
contentieux	k ɔ̃ t ɑ̃ s j ø
contents	k ɔ̃ t ɑ̃
contenu	k ɔ̃ t n y
contestation	k ɔ̃ t ɛ s t a s j ɔ̃
contesté	k ɔ̃ t ɛ s t e
contexte	k ɔ̃ t ɛ k s t
continent	k ɔ̃ t i n ɑ̃
continue	k ɔ̃ t i n y
continuer	k ɔ̃ t i n ɥ e
continué	k ɔ̃ t i n ɥ e
contraception	k ɔ̃ t ʁ a s ɛ p s j ɔ̃
contraire	k ɔ̃ t ʁ ɛ ʁ
contribuer	k ɔ̃ t ʁ i b ɥ e
controverseraient	k ɔ̃ t ʁ ɔ v ɛ ʁ s ə ʁ ɛ
contrée	k ɔ̃ t ʁ e
contrôle	k ɔ̃ t ʁ o l
contrôler	k ɔ̃ t ʁ o l e
convaincre	k ɔ̃ v ɛ̃ k ʁ
conventionnel	k ɔ̃ v ɑ̃ s j ɔ n ɛ l
conversation	k ɔ̃ v ɛ ʁ s a s j ɔ̃
convictions	k ɔ̃ v i k s j ɔ̃
convivial	k ɔ̃ v i v j a l
convocation	k ɔ̃ v ɔ k a s j ɔ̃
cool	k u l
coopération	k ɔ ɔ p e ʁ a s j ɔ̃
copuler	k ɔ p y l e
coran	k ɔ ʁ ɑ̃
coraniques	k ɔ ʁ a n i k
coraux	k ɔ ʁ o
corinne	k ɔ ʁ i n
corps	k ɔ ʁ
correspondant	k ɔ ʁ ɛ s p ɔ̃ d ɑ̃
corriger	k ɔ ʁ i ʒ e
corruption	k ɔ ʁ y p s j ɔ̃
corrélation	k ɔ ʁ e l a s j ɔ̃
corréler	k ɔ ʁ e l e
cortège	k ɔ ʁ t ɛ ʒ
cotation	k ɔ t a s j ɔ̃
cotisation	k ɔ t i z a s j ɔ̃
cou	k u
couleur	k u l œ ʁ
couloir	k u l w a ʁ
coup	k u
coupables	k u p a b l
couper	k u p e
couple	k u p l
cour	k u ʁ
courage	k u ʁ a ʒ
courageux	k u ʁ a ʒ ø
courant	k u ʁ ɑ̃
courent	k u ʁ
courir	k u ʁ i ʁ
courrier	k u ʁ j e
cours	k u ʁ
course	k u ʁ s
court	k u ʁ
coutil	k u t i
coutume	k u t y m
couvrir	k u v ʁ i ʁ
coût	k u
crainte	k ʁ ɛ̃ t
crash	k ʁ a ʃ
criant	k ʁ i j ɑ̃
crie	k ʁ i
crier	k ʁ i j e
criminalité	k ʁ i m i n a l i t e
crise	k ʁ i z
critique	k ʁ i t i k
critiquer	k ʁ i t i k e
croire	k ʁ w a ʁ
crois	k ʁ w a
croissance	k ʁ w a s ɑ̃ s
croix	k ʁ w a
crèche	k ʁ ɛ ʃ
crème	k ʁ ɛ m
créatifs	k ʁ e a t i f
création	k ʁ e a s j ɔ̃
crécher	k ʁ e ʃ e
crédible	k ʁ e d i b l
crédit	k ʁ e d i
créent	k ʁ e
créer	k ʁ e e
créée	k ʁ e e
crû	k ʁ y
cubisme	k y b i s m
cubitus	k y b i t y s
cuir	k ɥ i ʁ
cuire	k ɥ i ʁ
cuisine	k ɥ i z i n
cuisinière	k ɥ i z i n j ɛ ʁ
culbuteur	k y l b y t œ ʁ
culpabilité	k y l p a b i l i t e
culture	k y l t y ʁ
cumulait	k y m y l ɛ
cure	k y ʁ
curieux	k y ʁ j ø
cycliste	s i k l i s t
cynisme	s i n i s m
cyril	s i ʁ i l
céder	s e d e
cérébrales	s e ʁ e b ʁ a l
côte	k o t
côté	k o t e
daller	d a l e
dam	d ɑ̃
danemark	d a n m a ʁ k
danger	d ɑ̃ ʒ e
dangereuse	d ɑ̃ ʒ ʁ ø z
dangereux	d ɑ̃ ʒ ʁ ø
daniel	d a n j ɛ l
danoise	d a n w a z
danse	d ɑ̃ s
datte	d a t
dauphin	d o f ɛ̃
davantage	d a v ɑ̃ t a ʒ
davis	d e v i s
daïra	d a i ʁ a
de	d ə
debout	d ə b u
degré	d ə ɡ ʁ e
dehors	d ə ɔ ʁ
delta	d ɛ l t a
delà	d ə l a
demain	d ə m ɛ̃
demande	d ə m ɑ̃ d
demander	d ə m ɑ̃ d e
demeure	d ə m œ ʁ
demi	d ə m i
denis	d ə n i
denise	d ə n i z
dense	d ɑ̃ s
dents	d ɑ̃
der	d ɛ ʁ
derby	d ɛ ʁ b i
dernier	d ɛ ʁ n j e
dernièrement	d ɛ ʁ n j ɛ ʁ m ɑ̃
descente	d e s ɑ̃ t
design	d i z a j n
desquels	d e k ɛ l
destin	d ɛ s t ɛ̃
destination	d ɛ s t i n a s j ɔ̃
destinée	d ɛ s t i n e
destruction	d ɛ s t ʁ y k s j ɔ̃
dette	d ɛ t
dettes	d ɛ t
deuil	d œ j
deux	d ø
deuxième	d ø z j ɛ m
devait	d ə v ɛ
devant	d ə v ɑ̃
devenir	d ə v ə n i ʁ
devise	d ə v i z
devoir	d ə v w a ʁ
devrait	d ə v ʁ ɛ
dialyse	d j a l i z
diane	d j a n
dictature	d i k t a t y ʁ
dicter	d i k t e
diffamation	d i f a m a s j ɔ̃
différemment	d i f e ʁ a m ɑ̃
différence	d i f e ʁ ɑ̃ s
digitale	d i ʒ i t a l
dignité	d i ɲ i t e
digue	d i ɡ
dilemme	d i l ɛ m
dimanche	d i m ɑ̃ ʃ
dire	d i ʁ
direct	d i ʁ ɛ k t
directement	d i ʁ ɛ k t ə m ɑ̃
direction	d i ʁ ɛ k s j ɔ̃
directive	d i ʁ ɛ k t i v
dirige	d i ʁ i ʒ
diriger	d i ʁ i ʒ e
dis	d i
disait	d i z ɛ
disciplinaire	d i s i p l i n ɛ ʁ
discours	d i s k u ʁ
discrétion	d i s k ʁ e s j ɔ̃
discussion	d i s k y s j ɔ̃
discussions	d i s k y s j ɔ̃
discuter	d i s k y t e
dise	d i z
disent	d i z
disparaître	d i s p a ʁ ɛ t ʁ
disponibilité	d i s p ɔ n i b i l i t e
disposer	d i s p o z e
dispositif	d i s p o z i t i f
disposition	d i s p o z i s j ɔ̃
disposé	d i s p o z e
disque	d i s k
disques	d ɪ s k
dissident	d i s i d ɑ̃
distance	d i s t ɑ̃ s
distribuer	d i s t ʁ i b ɥ e
distribution	d i s t ʁ i b y s j ɔ̃
dit	d i
dite	d i t
dites	d i t
diva	d i v a
divers	d i v ɛ ʁ
diversité	d i v ɛ ʁ s i t e
dividende	d i v i d ɑ̃ d
division	d i v i z j ɔ̃
divorce	d i v ɔ ʁ s
dixième	d i z j ɛ m
dizaine	d i z ɛ n
docile	d ɔ s i l
documentation	d ɔ k y m ɑ̃ t a s j ɔ̃
doigt	d w a
dois	d w a
doit	d w a
dollar	d ɔ l a ʁ
domaine	d ɔ m ɛ n
domicile	d ɔ m i s i l
dominante	d ɔ m i n ɑ̃ t
dominique	d ɔ m i n i k
don	d ɔ̃
donc	d ɔ̃ k
donne	d ɔ n
donner	d ɔ n e
donnée	d ɔ n e
dont	d ɔ̃
dordogne	d ɔ ʁ d ɔ ɲ
dorment	d ɔ ʁ m
dorénavant	d ɔ ʁ e n a v ɑ̃
dos	d o
dossier	d o s j e
dote	d ɔ t
doter	d ɔ t e
dotés	d ɔ t e
douane	d w a n
double	d u b l
doublement	d u b l ə m ɑ̃
doubles	d u b l
douce	d u s
doucette	d u s ɛ t
douche	d u ʃ
douleur	d u l œ ʁ
doute	d u t
douteux	d u t ø
douze	d u z
doués	d w e
drame	d ʁ a m
drapeau	d ʁ a p o
drogue	d ʁ ɔ ɡ
droit	d ʁ w ɑ
droite	d ʁ w a t
dubaï	d u b a j
duel	d ɥ ɛ l
dune	d y n
dunkerque	d œ̃ k ɛ ʁ k
duo	d ɥ o
dur	d y ʁ
durant	d y ʁ ɑ̃
dure	d y ʁ
durer	d y ʁ e
dures	d y ʁ
durée	d y ʁ e
dysfonctionnement	d i s f ɔ̃ k s j ɔ n m ɑ̃
dès	d ɛ
débat	d e b a
déboires	d e b w a ʁ
déboucher	d e b u ʃ e
débourser	d e b u ʁ s e
début	d e b y
décadence	d e k a d ɑ̃ s
décembre	d e s ɑ̃ b ʁ
déception	d e s ɛ p s j ɔ̃
décevoir	d e s ə v w a ʁ
déchets	d e ʃ ɛ
décider	d e s i d e
décidément	d e s i d e m ɑ̃
décision	d e s i z j ɔ̃
déclaration	d e k l a ʁ a s j ɔ̃
déclarer	d e k l a ʁ e
déclinaison	d e k l i n ɛ z ɔ̃
découverte	d e k u v ɛ ʁ t
décret	d e k ʁ ɛ
décrire	d e k ʁ i ʁ
décrocher	d e k ʁ ɔ ʃ e
décès	d e s ɛ
déduire	d e d ɥ i ʁ
défense	d e f ɑ̃ s
défenseur	d e f ɑ̃ s œ ʁ
déficit	d e f i s i t
défilé	d e f i l e
définir	d e f i n i ʁ
définition	d e f i n i s j ɔ̃
déforestation	d e f ɔ ʁ ɛ s t a s j ɔ̃
défunt	d e f œ̃
dégradation	d e ɡ ʁ a d a s j ɔ̃
déjanté	d e ʒ ɑ̃ t e
déjà	d e ʒ a
délai	d e l ɛ
délibérations	d e l i b e ʁ a s j ɔ̃
délicat	d e l i k a
délictueuse	d e l i k t ɥ ø z
démembre	d e m ɑ̃ b ʁ
démenti	d e m ɑ̃ t i
démentiront	d e m ɑ̃ t i ʁ ɔ̃
démentis	d e m ɑ̃ t i
démission	d e m i s j ɔ̃
démissionnaire	d e m i s j ɔ n ɛ ʁ
démocrate	d e m ɔ k ʁ a t
démocrates	d e m ɔ k ʁ a t
démocratie	d e m ɔ k ʁ a s i
démonstration	d e m ɔ̃ s t ʁ a s j ɔ̃
déménagement	d e m e n a ʒ m ɑ̃
dénigrante	d e n i ɡ ʁ ɑ̃ t
dénonce	d e n ɔ̃ s
dénoncé	d e n ɔ̃ s e
dénouement	d e n u m ɑ̃
déontologie	d e ɔ̃ t ɔ l ɔ ʒ i
départ	d e p a ʁ
département	d e p a ʁ t ə m ɑ̃
départementale	d e p a ʁ t ə m ɑ̃ t a l
dépassement	d e p ɑ s m ɑ̃
dépenses	d e p ɑ̃ s
déplorable	d e p l ɔ ʁ a b l
déployer	d e p l w a j e
déposer	d e p o z e
dépression	d e p ʁ ɛ s j ɔ̃
député	d e p y t e
dépôt	d e p o
désastreux	d e z a s t ʁ ø
désert	d e z ɛ ʁ
désirable	d e z i ʁ a b l
désire	d e z i ʁ
désolation	d e z ɔ l a s j ɔ̃
désormais	d e z ɔ ʁ m ɛ
détail	d e t a j
déterminer	d e t ɛ ʁ m i n e
détour	d e t u ʁ
détourné	d e t u ʁ n e
détournés	d e t u ʁ n e
détresse	d e t ʁ ɛ s
développement	d e v l ɔ p m ɑ̃
développer	d e v l ɔ p e
dévier	d e v j e
dévoiler	d e v w a l e
déçu	d e s y
dôme	d o m
dû	d y
eau	ø a y
effacer	e f a s e
effectif	e f ɛ k t i f
effective	e f ɛ k t i v
effectivement	e f ɛ k t i v m ɑ̃
effet	e f ɛ
efficace	e f i k a s
efficacité	ɛ f i k a s i t e
efficient	e f i s j ɑ̃
effort	e f ɔ ʁ
effraction	e f ʁ a k s j ɔ̃
egypte	e ʒ i p t
elle	ɛ l
elles	ɛ l
embarquer	ɑ̃ b a ʁ k e
embarrasse	ɑ̃ b a ʁ a s
embauche	ɑ̃ b o ʃ
embaucher	ɑ̃ b o ʃ e
embrasser	ɑ̃ b ʁ a s e
emmagasiner	ɑ̃ m a ɡ a z i n e
emmerde	ɑ̃ m ɛ ʁ d
emplissaient	ɑ̃ p l i s ɛ
emploi	ɑ̃ p l w a
employé	ɑ̃ p l w a j e
emprisonné	ɑ̃ p ʁ i z ɔ n e
emprunter	ɑ̃ p ʁ œ̃ t e
empêcher	ɑ̃ p ɛ ʃ e
encadrement	ɑ̃ k a d ʁ ə m ɑ̃
enchaîner	ɑ̃ ʃ ɛ n e
encore	ɑ̃ k ɔ ʁ
encourager	ɑ̃ k u ʁ a ʒ e
endettement	ɑ̃ d ɛ t m ɑ̃
endommager	ɑ̃ d ɔ m a ʒ e
endosser	ɑ̃ d o s e
endroit	ɑ̃ d ʁ w a
endroits	ɑ̃ d ʁ w a
enfance	ɑ̃ f ɑ̃ s
enfantin	ɑ̃ f ɑ̃ t ɛ̃
enfants	ɑ̃ f ɑ̃
enfin	ɑ̃ f ɛ̃
engager	ɑ̃ ɡ a ʒ e
englué	ɑ̃ ɡ l y e
enquête	ɑ̃ k ɛ t
enquêter	ɑ̃ k ɛ t e
enragerais	ɑ̃ ʁ a ʒ ʁ ɛ
enregistrement	ɑ̃ ʁ ə ʒ i s t ʁ ə m ɑ̃
enseignement	ɑ̃ s ɛ ɲ m ɑ̃
ensemble	ɑ̃ s ɑ̃ b l
ensuite	ɑ̃ s ɥ i t
entendre	ɑ̃ t ɑ̃ d ʁ
entendu	ɑ̃ t ɑ̃ d y
entente	ɑ̃ t ɑ̃ t
entier	ɑ̃ t j e
entièrement	ɑ̃ t j ɛ ʁ m ɑ̃
entourage	ɑ̃ t u ʁ a ʒ
entrailles	ɑ̃ t ʁ a j
entrain	ɑ̃ t ʁ ɛ̃
entraînement	ɑ̃ t ʁ ɛ n m ɑ̃
entre	ɑ̃ t ʁ
entrer	ɑ̃ t ʁ e
entretenir	ɑ̃ t ʁ ə t ə n i ʁ
entretenu	ɑ̃ t ʁ ə t ə n y
entretiendraient	ɑ̃ t ʁ ə t j ɛ̃ d ʁ ɛ
entretient	ɑ̃ t ʁ ə t j ɛ̃
entrée	ɑ̃ t ʁ e
entériner	ɑ̃ t e ʁ i n e
envers	ɑ̃ v ɛ ʁ
envie	ɑ̃ v i
environ	ɑ̃ v i ʁ ɔ̃
environnement	ɑ̃ v i ʁ ɔ n m ɑ̃
environs	ɑ̃ v i ʁ ɔ̃
envisager	ɑ̃ v i z a ʒ e
envoi	ɑ̃ v w a
envoyer	ɑ̃ v w a j e
ergotez	ɛ ʁ ɡ ɔ t e
erreur	e ʁ œ ʁ
escient	e s j ɑ̃
escroc	ɛ s k ʁ o
escroquerie	ɛ s k ʁ ɔ k ʁ i
espace	ɛ s p a s
espagne	ɛ s p a ɲ
espagnol	ɛ s p a ɲ ɔ l
espionnage	ɛ s p j ɔ n a ʒ
espoirs	ɛ s p w a ʁ
espèce	ɛ s p ɛ s
espèces	ɛ s p ɛ s
espérer	ɛ s p e ʁ e
essentiel	e s ɑ̃ s j ɛ l
est	ɛ s t
esthétique	ɛ s t e t i k
estime	ɛ s t i m
euro	ø ʁ o
europe	ø ʁ ɔ p
européen	ø ʁ ɔ p e ɛ̃
euros	ø ʁ o
exactement	ɛ ɡ z a k t ə m ɑ̃
examiner	ɛ ɡ z a m i n e
excellence	ɛ k s ɛ l ɑ̃ s
exception	ɛ k s ɛ p s j ɔ̃
exceptionnel	ɛ k s ɛ p s j ɔ n ɛ l
exclusivité	ɛ k s k l y z i v i t e
excuser	ɛ k s k y z e
exemplaire	ɛ ɡ z ɑ̃ p l ɛ ʁ
exemple	ɛ ɡ z ɑ̃ p l
exemples	ɛ ɡ z ɑ̃ p l
exercent	ɛ ɡ z ɛ ʁ s
exercice	ɛ ɡ z ɛ ʁ s i s
exiger	ɛ ɡ z i ʒ e
exilés	ɛ ɡ z i l e
existence	ɛ ɡ z i s t ɑ̃ s
existences	ɛ ɡ z i s t ɑ̃ s
explicable	ɛ k s p l i k a b l
explication	ɛ k s p l i k a s j ɔ̃
explique	ɛ k s p l i k
expliquent	ɛ k s p l i k
expliquer	ɛ k s p l i k e
expliqué	ɛ k s p l i k e
exploit	ɛ k s p l w a
exploitant	ɛ k s p l w a t ɑ̃
exploitation	ɛ k s p l w a t a s j ɔ̃
exploiter	ɛ k s p l w a t e
exploration	ɛ k s p l ɔ ʁ a s j ɔ̃
exploser	ɛ k s p l o z e
explosion	ɛ k s p l o z j ɔ̃
expose	ɛ k s p o z
exposent	ɛ k s p o z
exposition	ɛ k s p o z i s j ɔ̃
expositions	ɛ k s p o z i s j ɔ̃
exposé	ɛ k s p o z e
exprimer	ɛ k s p ʁ i m e
expérience	ɛ k s p e ʁ j ɑ̃ s
expérimenté	ɛ k s p e ʁ i m ɑ̃ t e
extrait	ɛ k s t ʁ ɛ
extrême	ɛ k s t ʁ ɛ m
fabricant	f a b ʁ i k ɑ̃
fabrication	f a b ʁ i k a s j ɔ̃
face	f a s
facile	f a s i l
facilement	f a s i l m ɑ̃
faciles	f a s i l
faciliter	f a s i l i t e
facteur	f a k t œ ʁ
faible	f ɛ b l
faiblesse	f ɛ b l ɛ s
faiblirait	f e b l i ʁ ɛ
faillir	f a j i ʁ
faillite	f a j i t
faim	f ɛ̃
faire	f ɛ ʁ
fais	f ɛ
faisais	f ə z ɛ
faisait	f ə z ɛ
faisant	f ə z ɑ̃
faiseur	f ə z œ ʁ
fameux	f a m ø
familial	f a m i l j a l
famille	f a m i j
fan	f a n
fantastique	f ɑ̃ t a s t i k
farine	f a ʁ i n
fat	f a
faute	f o t
faveur	f a v œ ʁ
favorable	f a v ɔ ʁ a b l
favori	f a v ɔ ʁ i
façon	f a s ɔ̃
fbi	ɛ f b i a j
fc	ɛ f s e
femme	f a m
fer	f ɛ ʁ
ferme	f ɛ ʁ m
fermer	f ɛ ʁ m e
fermé	f ɛ ʁ m e
fermée	f ɛ ʁ m e
festival	f ɛ s t i v a l
feuille	f œ j
feux	f ø
fiable	f j a b l
fibre	f i b ʁ
fidèles	f i d ɛ l
fierté	f j ɛ ʁ t e
figure	f i ɡ y ʁ
figurer	f i ɡ y ʁ e
file	f i l
filet	f i l ɛ
filiale	f i l j a l
fille	f i j
filles	f i j
film	f i l m
filmé	f i l m e
fin	f ɛ̃
financier	f i n ɑ̃ s j e
firme	f i ʁ m
fixe	f i k s
fixer	f i k s e
flamme	f l ɑ m
flanc	f l ɑ̃
flash	f l a ʃ
florence	f l ɔ ʁ ɑ̃ s
floride	f l ɔ ʁ i d
flotte	f l ɔ t
flottille	f l ɔ t i j
flou	f l u
flux	f l y
foi	f w a
foire	f w a ʁ
fois	f w a
foisonnes	f w a z ɔ n
folie	f ɔ l i
folklore	f ɔ l k l ɔ ʁ
fonce	f ɔ̃ s
foncier	f ɔ̃ s j e
fonction	f ɔ̃ k s j ɔ̃
fonctionnaire	f ɔ̃ k s j ɔ n ɛ ʁ
fonctionnement	f ɔ̃ k s j ɔ n m ɑ̃
fonctionner	f ɔ̃ k s j ɔ n e
fond	f ɔ̃
fondamental	f ɔ̃ d a m ɑ̃ t a l
fondamentales	f ɔ̃ d a m ɑ̃ t a l
fondation	f ɔ̃ d a s j ɔ̃
fonds	f ɔ̃
font	f ɔ̃
footing	f u t i ŋ
force	f ɔ ʁ s
forcer	f ɔ ʁ s e
forces	f ɔ ʁ s
forcément	f ɔ ʁ s e m ɑ̃
forfait	f ɔ ʁ f ɛ
formaldéhyde	f ɔ ʁ m a l d e i d
format	f ɔ ʁ m a
formation	f ɔ ʁ m a s j ɔ̃
forme	f ɔ ʁ m
former	f ɔ ʁ m e
formidablement	f ɔ ʁ m i d a b l ə m ɑ̃
formule	f ɔ ʁ m y l
forum	f ɔ ʁ ɔ m
forêt	f ɔ ʁ ɛ
fossé	f ɔ s e
fou	f u
foulard	f u l a ʁ
foule	f u l
foulée	f u l e
fourchette	f u ʁ ʃ ɛ t
fournir	f u ʁ n i ʁ
fournis	f u ʁ n i
fournisseur	f u ʁ n i s œ ʁ
fouterie	f u t ʁ i
fragile	f ʁ a ʒ i l
frais	f ʁ ɛ
franc	f ʁ ɑ̃
france	f ʁ ɑ̃ s
francfort	f ʁ ɑ̃ k f ɔ ʁ
franche	f ʁ ɑ̃ ʃ
franchement	f ʁ ɑ̃ ʃ m ɑ̃
franchir	f ʁ ɑ̃ ʃ i ʁ
franchise	f ʁ ɑ̃ ʃ i z
franchises	f ʁ ɑ̃ ʃ i z
francis	f ʁ ɑ̃ s i s
francophones	f ʁ ɑ̃ k ɔ f ɔ n
francophonie	f ʁ ɑ̃ k ɔ f ɔ n i
frank	f ʁ ɑ̃ k
française	f ʁ ɑ̃ s ɛ z
françaises	f ʁ ɑ̃ s ɛ z
françois	f ʁ ɑ̃ s w a
frappe	f ʁ a p
frapper	f ʁ a p e
frayeur	f ʁ ɛ j œ ʁ
fribourg	f ʁ i b u ʁ
frigo	f ʁ i ɡ o
fromage	f ʁ ɔ m a ʒ
front	f ʁ ɔ̃
fruits	f ʁ ɥ i
frédéric	f ʁ e d e ʁ i k
frénésie	f ʁ e n e z i
fréquemment	f ʁ e k a m ɑ̃
fréquence	f ʁ e k ɑ̃ s
fumer	f y m e
fur	f y ʁ
furieusement	f y ʁ j ø z m ɑ̃
fustigé	f y s t i ʒ e
fusée	f y z e
fut	f y
futur	f y t y ʁ
future	f y t y ʁ
futuriste	f y t y ʁ i s t
fuyant	f ɥ i j ɑ̃
fédération	f e d e ʁ a s j ɔ̃
féminin	f e m i n ɛ̃
février	f e v ʁ i j e
fêter	f ɛ t e
gaga	ɡ a ɡ a
gagne	ɡ a ɲ
gagner	ɡ a ɲ e
galvauder	ɡ a l v o d e
galère	ɡ a l ɛ ʁ
gamme	ɡ a m
gap	ɡ a p
garage	ɡ a ʁ a ʒ
garantie	ɡ a ʁ ɑ̃ t i
garantir	ɡ a ʁ ɑ̃ t i ʁ
garde	ɡ a ʁ d
garder	ɡ a ʁ d e
gardien	ɡ a ʁ d j ɛ̃
garnis	ɡ a ʁ n i
garçon	ɡ a ʁ s ɔ̃
gaston	ɡ a s t ɔ̃
gatineau	ɡ a t i n o
gauche	ɡ o ʃ
gaz	ɡ ɑ z
gazette	ɡ a z ɛ t
gaël	ɡ a ɛ l
gel	ʒ ɛ l
geneviève	ʒ ə n ə v j ɛ v
genou	ʒ ə n u
genre	ʒ ɑ̃ ʁ
genève	ʒ ə n ɛ v
georges	ʒ ɔ ʁ ʒ
germain	ʒ ɛ ʁ m ɛ̃
gervais	ʒ ɛ ʁ v ɛ
gestion	ʒ ɛ s t j ɔ̃
gestionnaire	ʒ ɛ s t j ɔ n ɛ ʁ
ghana	ɡ a n a
gingembre	ʒ ɛ̃ ʒ ɑ̃ b ʁ
glace	ɡ l a s
glisser	ɡ l i s e
globale	ɡ l ɔ b a l
globe	ɡ l ɔ b
go	ɡ o
gogol	ɡ ɔ ɡ ɔ l
golfe	ɡ ɔ l f
golfeur	ɡ ɔ l f œ ʁ
goudronné	ɡ u d ʁ ɔ n e
gouvernance	ɡ u v ɛ ʁ n ɑ̃ s
gouvernemental	ɡ u v ɛ ʁ n ə m ɑ̃ t a l
gouverneure	ɡ u v ɛ ʁ n œ ʁ
goût	ɡ u
grande	ɡ ʁ ɑ̃ d
grandes	ɡ ʁ ɑ̃ d
grandeur	ɡ ʁ ɑ̃ d œ ʁ
grandit	ɡ ʁ ɑ̃ d i
grasse	ɡ ʁ ɑ s
gratuite	ɡ ʁ a t ɥ i t
gratuitement	ɡ ʁ a t ɥ i t m ɑ̃
grave	ɡ ʁ a v
grecque	ɡ ʁ ɛ k
grecs	ɡ ʁ ɛ k
grenoble	ɡ ʁ ə n ɔ b l
grippe	ɡ ʁ i p
grise	ɡ ʁ i z
grison	ɡ ʁ i z ɔ̃
grognon	ɡ ʁ ɔ ɲ ɔ̃
gros	ɡ ʁ o
grosse	ɡ ʁ o s
grosses	ɡ ʁ o s
groupe	ɡ ʁ u p
grouper	ɡ ʁ u p e
grues	ɡ ʁ y
grâce	ɡ ʁ ɑ s
grève	ɡ ʁ ɛ v
guerre	ɡ ɛ ʁ
gustave	ɡ y s t a v
guyane	ɡ ɥ i j a n
guéguerre	ɡ e ɡ ɛ ʁ
guérison	ɡ e ʁ i z ɔ̃
génie	ʒ e n i
génocidaires	ʒ e n ɔ s i d ɛ ʁ
génomique	ʒ e n ɔ m i k
général	ʒ e n e ʁ a l
générale	ʒ e n e ʁ a l
généralement	ʒ e n e ʁ a l m ɑ̃
générales	ʒ e n e ʁ a l
génération	ʒ e n e ʁ a s j ɔ̃
généreux	ʒ e n e ʁ ø
génétiquement	ʒ e n e t i k m ɑ̃
gérant	ʒ e ʁ ɑ̃
gérer	ʒ e ʁ e
gêne	ʒ ɛ n
habiter	a b i t e
habits	a b i
habitude	a b i t y d
habituellement	a b i t ɥ ɛ l m ɑ̃
habituelles	a b i t ɥ ɛ l
harper	a ʁ p e
hasard	a z a ʁ
haussière	o s j ɛ ʁ
haut	h o
haute	o t
hauteur	o t œ ʁ
haïti	a i t i
haïtien	a i s j ɛ̃
herbe	ɛ ʁ b
hervé	ɛ ʁ v e
heurter	œ ʁ t e
histoire	i s t w a ʁ
historique	i s t ɔ ʁ i k
hiver	i v ɛ ʁ
hommage	ɔ m a ʒ
homme	ɔ m
hommes	ɔ m
hongrie	ɔ̃ ɡ ʁ i
honteux	ɔ̃ t ø
horaire	ɔ ʁ ɛ ʁ
horizon	ɔ ʁ i z ɔ̃
hors	ɔ ʁ
hospitalier	ɔ s p i t a l j e
houlette	u l ɛ t
hughes	y ɡ
hui	ɥ i
huis	ɥ i
humaines	y m ɛ n
humains	y m ɛ̃
humiliation	y m i l j a s j ɔ̃
humilier	y m i l j e
humour	y m u ʁ
hypothèse	i p ɔ t ɛ z
hypothèses	i p ɔ t ɛ z
hypothéquer	i p ɔ t e k e
hébergement	e b ɛ ʁ ʒ ə m ɑ̃
hébert	e b ɛ ʁ
hébreu	e b ʁ ø
héritage	e ʁ i t a ʒ
hériter	e ʁ i t e
héritiers	e ʁ i t j e
hétérogène	e t e ʁ ɔ ʒ ɛ n
ici	i s i
identité	i d ɑ̃ t i t e
idiot	i d j o
idéal	i d e a l
idée	i d e
il	i l
illimité	i l i m i t e
illustre	i l y s t ʁ
ils	i l
image	i m a ʒ
images	i m a ʒ
immeuble	i m œ b l
immigré	i m i ɡ ʁ e
immiscerait	i m i s ʁ ɛ
immédiat	i m e d j a
impacter	ɛ̃ p a k t e
impassible	ɛ̃ p a s i b l
implacable	ɛ̃ p l a k a b l
implicitement	ɛ̃ p l i s i t m ɑ̃
importance	ɛ̃ p ɔ ʁ t ɑ̃ s
important	ɛ̃ p ɔ ʁ t ɑ̃
importante	ɛ̃ p ɔ ʁ t ɑ̃ t
importe	ɛ̃ p ɔ ʁ t
impossible	ɛ̃ p ɔ s i b l
imprévisible	ɛ̃ p ʁ e v i z i b l
impôt	ɛ̃ p o
incapable	ɛ̃ k a p a b l
incartade	ɛ̃ k a ʁ t a d
incendie	ɛ̃ s ɑ̃ d i
incendies	ɛ̃ s ɑ̃ d i
incertain	ɛ̃ s ɛ ʁ t ɛ̃
incertitude	ɛ̃ s ɛ ʁ t i t y d
incitation	ɛ̃ s i t a s j ɔ̃
inciter	ɛ̃ s i t e
inclure	ɛ̃ k l y ʁ
inconnu	ɛ̃ k ɔ n y
inconnue	ɛ̃ k ɔ n y
incontournable	ɛ̃ k ɔ̃ t u ʁ n a b l
incontrôlable	ɛ̃ k ɔ̃ t ʁ o l a b l
inde	ɛ̃ d
indemne	ɛ̃ d ɛ m n
indice	ɛ̃ d i s
indices	ɛ̃ d i s
indien	ɛ̃ d j ɛ̃
indique	ɛ̃ d i k
individu	ɛ̃ d i v i d y
individuel	ɛ̃ d i v i d ɥ ɛ l
indonésienne	ɛ̃ d ɔ n e z j ɛ n
industriel	ɛ̃ d y s t ʁ i j ɛ l
indépendance	ɛ̃ d e p ɑ̃ d ɑ̃ s
indépendances	ɛ̃ d e p ɑ̃ d ɑ̃ s
infatigable	ɛ̃ f a t i ɡ a b l
infection	ɛ̃ f ɛ k s j ɔ̃
infirmes	ɛ̃ f i ʁ m
infirmier	ɛ̃ f i ʁ m j e
infirmière	ɛ̃ f i ʁ m j ɛ ʁ
inflige	ɛ̃ f l i ʒ
infligé	ɛ̃ f l i ʒ e
influencer	ɛ̃ f l y ɑ̃ s e
info	ɛ̃ f o
informer	ɛ̃ f ɔ ʁ m e
ingénierie	ɛ̃ ʒ e n i ʁ i
ingénieur	ɛ̃ ʒ e n j œ ʁ
ingérence	ɛ̃ ʒ e ʁ ɑ̃ s
inhabitables	i n a b i t a b l
inquiets	ɛ̃ k j ɛ
inquiéter	ɛ̃ k j e t e
inscrire	ɛ̃ s k ʁ i ʁ
insensé	ɛ̃ s ɑ̃ s e
inspiration	ɛ̃ s p i ʁ a s j ɔ̃
installer	ɛ̃ s t a l e
instance	ɛ̃ s t ɑ̃ s
instant	ɛ̃ s t ɑ̃
instantané	ɛ̃ s t ɑ̃ t a n e
instituer	ɛ̃ s t i t ɥ e
institut	ɛ̃ s t i t y
instrument	ɛ̃ s t ʁ y m ɑ̃
insu	ɛ̃ s y
intelligente	ɛ̃ t e l i ʒ ɑ̃ t
intense	ɛ̃ t ɑ̃ s
intensification	ɛ̃ t ɑ̃ s i f i k a s j ɔ̃
intention	ɛ̃ t ɑ̃ s j ɔ̃
interagir	ɛ̃ t ɛ ʁ a ʒ i ʁ
interdire	ɛ̃ t ɛ ʁ d i ʁ
interdit	ɛ̃ t ɛ ʁ d i
interface	ɛ̃ t ɛ ʁ f a s
interminable	ɛ̃ t ɛ ʁ m i n a b l
international	ɛ̃ t ɛ ʁ n a s j ɔ n a l
internationale	ɛ̃ t ɛ ʁ n a s j ɔ n a l
internationalisation	ɛ̃ t ɛ ʁ n a s j ɔ n a l i z a s j ɔ̃
interne	ɛ̃ t ɛ ʁ n
internet	ɛ̃ t ɛ ʁ n ɛ t
interprète	ɛ̃ t ɛ ʁ p ʁ ɛ t
interprétation	ɛ̃ t ɛ ʁ p ʁ e t a s j ɔ̃
interpréter	ɛ̃ t ɛ ʁ p ʁ e t e
interroger	ɛ̃ t ɛ ʁ ɔ ʒ e
intervenir	ɛ̃ t ɛ ʁ v ə n i ʁ
intimes	ɛ̃ t i m
intimité	ɛ̃ t i m i t e
intitulé	ɛ̃ t i t y l e
introduction	ɛ̃ t ʁ ɔ d y k s j ɔ̃
intuitif	ɛ̃ t ɥ i t i f
intégral	ɛ̃ t e ɡ ʁ a l
intéressant	ɛ̃ t e ʁ ɛ s ɑ̃
intérieur	ɛ̃ t e ʁ j œ ʁ
intérim	ɛ̃ t e ʁ i m
intérêt	ɛ̃ t e ʁ ɛ
inutile	i n y t i l
investir	ɛ̃ v ɛ s t i ʁ
investissement	ɛ̃ v ɛ s t i s m ɑ̃
invoquer	ɛ̃ v ɔ k e
inéluctable	i n e l y k t a b l
inévitable	i n e v i t a b l
inévitablement	i n e v i t a b l ə m ɑ̃
ira	i ʁ a
irak	i ʁ a k
iran	i ʁ ɑ̃
irlandais	i ʁ l ɑ̃ d ɛ
irlandaise	i ʁ l ɑ̃ d ɛ z
irlande	i ʁ l ɑ̃ d
isabelle	i z a b ɛ l
islamique	i s l a m i k
issu	i s y
istanbul	i s t ɑ̃ b u l
italie	i t a l i
jaloux	ʒ a l u
jan	ʒ ɑ̃
japon	ʒ a p ɔ̃
japonais	ʒ a p ɔ n ɛ
japonaise	ʒ a p ɔ n ɛ z
jardin	ʒ a ʁ d ɛ̃
jardinier	ʒ a ʁ d i n j e
jaune	ʒ o n
jaunes	ʒ o n
je	ʒ ə
jessica	ʒ ɛ s i k a
jette	ʒ ɛ t
jeté	ʒ ə t e
jeudi	ʒ ø d i
jeune	ʒ œ n
jeunes	ʒ œ n
jeunesse	ʒ œ n ɛ s
jeux	ʒ ø
johnson	ʒ ɔ n s ɔ̃
joie	ʒ w a
joindre	ʒ w ɛ̃ d ʁ
joint	ʒ w ɛ̃
jonathan	ʒ ɔ n a t ɑ̃
jones	ʒ ɔ n
josé	ʒ o z e
josée	ʒ o z e
joue	ʒ u
jouent	ʒ u
jour	ʒ u ʁ
journalisme	ʒ u ʁ n a l i z m
journaliste	ʒ u ʁ n a l i s t
journée	ʒ u ʁ n e
jouxtant	ʒ u k s t ɑ̃
joyeux	ʒ w a j ø
juge	ʒ y ʒ
jugement	ʒ y ʒ m ɑ̃
juges	ʒ y ʒ
juif	ʒ ɥ i f
julie	ʒ y l i
julien	ʒ y l j ɛ̃
jura	ʒ y ʁ a
juriste	ʒ y ʁ i s t
jury	ʒ y ʁ i
juré	ʒ y ʁ e
just	ʒ y s t
juste	ʒ y s t
justement	ʒ y s t ə m ɑ̃
justesse	ʒ y s t ɛ s
justice	ʒ y s t i s
justification	ʒ y s t i f i k a s j ɔ̃
justine	ʒ y s t i n
jérôme	ʒ e ʁ o m
kaboul	k a b u l
kevin	k e v i n
kirghiz	k i ʁ ɡ i z
kirghizstan	k i ʁ ɡ i s t ɑ̃
kérosène	k e ʁ o z ɛ n
label	l a b ɛ l
laboratoire	l a b ɔ ʁ a t w a ʁ
laborieux	l a b ɔ ʁ j ø
lai	l ɛ
laideur	l ɛ d œ ʁ
laisse	l ɛ s
laissé	l ɛ s e
lait	l ɛ
lamente	l a m ɑ̃ t
lance	l ɑ̃ s
lancement	l ɑ̃ s m ɑ̃
lancer	l ɑ̃ s e
lancé	l ɑ̃ s e
landes	l ɑ̃ d
langue	l ɑ̃ ɡ
lanterne	l ɑ̃ t ɛ ʁ n
laquelle	l a k ɛ l
large	l a ʁ ʒ
latine	l a t i n
latium	l a s j ɔ m
laval	l a v a l
laver	l a v e
leader	l i d œ ʁ
leclerc	l ə k l ɛ ʁ
leclercq	l ə k l ɛ ʁ
lecture	l ɛ k t y ʁ
lendemain	l ɑ̃ d m ɛ̃
lent	l ɑ̃
lentement	l ɑ̃ t m ɑ̃
lentes	l ɑ̃ t
lequel	l ə k ɛ l
lesquelles	l e k ɛ l
let	l ɛ t
lettre	l ɛ t ʁ
leur	l œ ʁ
levée	l ə v e
leçon	l ə s ɔ̃
liant	l j ɑ̃
liban	l i b ɑ̃
libanais	l i b a n ɛ
liberté	l i b ɛ ʁ t e
libre	l i b ʁ
libye	l i b i
libéral	l i b e ʁ a l
libération	l i b e ʁ a s j ɔ̃
libérer	l i b e ʁ e
licenciement	l i s ɑ̃ s i m ɑ̃
lien	l j ɛ̃
lieu	l j ø
lieux	l j ø
ligue	l i ɡ
liliane	l i l j a n
lima	l i m a
limbourgeoise	l ɛ̃ b u ʁ ʒ w a z
limite	l i m i t
limiter	l i m i t e
limites	l i m i t
lire	l i ʁ
lit	l i
lithographie	l i t ɔ ɡ ʁ a f i
litre	l i t ʁ
livraison	l i v ʁ ɛ z ɔ̃
livre	l i v ʁ
livrer	l i v ʁ e
livres	l i v ʁ
livrée	l i v ʁ e
local	l ɔ k a l
locale	l ɔ k a l
location	l ɔ k a s j ɔ̃
logement	l ɔ ʒ m ɑ̃
logiciel	l ɔ ʒ i s j ɛ l
logique	l ɔ ʒ i k
loin	l w ɛ̃
loiret	l w a ʁ ɛ
lois	l w a
loisir	l w a z i ʁ
loisirs	l w a z i ʁ
londres	l ɔ̃ d ʁ
long	l ɔ̃
longtemps	l ɔ̃ t ɑ̃
longue	l ɔ̃ ɡ
longueur	l ɔ̃ ɡ œ ʁ
lors	l ɔ ʁ
lorsque	l ɔ ʁ s k
los	l o
louer	l w e
louise	l w i z
lourd	l u ʁ
lourdement	l u ʁ d ə m ɑ̃
louvain	l u v ɛ̃
lu	l y
luc	l y k
lucide	l y s i d
lucien	l y s j ɛ̃
lui	l ɥ i
luis	l ɥ i
lumière	l y m j ɛ ʁ
lunch	l œ̃ ʃ
lundi	l œ̃ d i
lundis	l œ̃ d i
lunette	l y n ɛ t
luxe	l y k s
lycée	l i s e
lyonnais	l j ɔ n ɛ
lâche	l ɑ ʃ
lâcher	l ɑ ʃ e
légendaire	l e ʒ ɑ̃ d ɛ ʁ
législatif	l e ʒ i s l a t i f
législation	l e ʒ i s l a s j ɔ̃
législatives	l e ʒ i s l a t i v
légitimité	l e ʒ i t i m i t e
légèrement	l e ʒ ɛ ʁ m ɑ̃
léonard	l e ɔ n a ʁ
lévesque	l e v ɛ k
ma	m a
mac	m a k
madagascar	m a d a ɡ a s k a ʁ
madame	m a d a m
madrid	m a d ʁ i d
magazine	m a ɡ a z i n
magique	m a ʒ i k
magnifique	m a ɲ i f i k
maigre	m ɛ ɡ ʁ
maillot	m a j o
main	m ɛ̃
mains	m ɛ̃
maintenance	m ɛ̃ t n ɑ̃ s
maintenant	m ɛ̃ t n ɑ̃
maintenir	m ɛ̃ t n i ʁ
maire	m ɛ ʁ
maires	m ɛ ʁ
mais	m ɛ
maison	m ɛ z ɔ̃
maisons	m ɛ z ɔ̃
majestueux	m a ʒ ɛ s t ɥ ø
majorité	m a ʒ ɔ ʁ i t e
mal	m a l
malade	m a l a d
maladie	m a l a d i
malaise	m a l ɛ z
malaria	m a l a ʁ j a
malentendants	m a l ɑ̃ t ɑ̃ d ɑ̃
malgré	m a l ɡ ʁ e
malheur	m a l œ ʁ
malheureusement	m a l œ ʁ ø z m ɑ̃
malheureux	m a l œ ʁ ø
malien	m a l j ɛ̃
maltais	m a l t ɛ
manageur	m a n a ʒ œ ʁ
manche	m ɑ̃ ʃ
mandat	m ɑ̃ d a
manganèse	m ɑ̃ ɡ a n ɛ z
mangiez	m ɑ̃ ʒ j e
maniement	m a n i m ɑ̃
manifestation	m a n i f ɛ s t a s j ɔ̃
manifester	m a n i f ɛ s t e
manière	m a n j ɛ ʁ
mannequin	m a n k ɛ̃
manquait	m ɑ̃ k ɛ
manque	m ɑ̃ k
manqué	m ɑ̃ k e
manteau	m ɑ̃ t o
manuels	m a n ɥ ɛ l
marbre	m a ʁ b ʁ
marc	m a ʁ k
marchand	m a ʁ ʃ ɑ̃
marche	m a ʁ ʃ
marcher	m a ʁ ʃ e
marché	m a ʁ ʃ e
mardi	m a ʁ d i
marge	m a ʁ ʒ
mariage	m a ʁ j a ʒ
marin	m a ʁ ɛ̃
mariniers	m a ʁ i n j e
mark	m a ʁ k
marketing	m a ʁ k e t i ŋ
maroc	m a ʁ ɔ k
marocain	m a ʁ ɔ k ɛ̃
marquage	m a ʁ k a ʒ
marque	m a ʁ k
marrant	m a ʁ ɑ̃
marseille	m a ʁ s ɛ j
martin	m a ʁ t ɛ̃
maréchal	m a ʁ e ʃ a l
masculin	m a s k y l ɛ̃
masculine	m a s k y l i n
masque	m a s k
masse	m a s
massif	m a s i f
massivement	m a s i v m ɑ̃
match	m a t ʃ
matinée	m a t i n e
matière	m a t j ɛ ʁ
matthieu	m a t j ø
maussade	m o s a d
maux	m o
maxi	m a k s i
maximum	m a k s i m ɔ m
mayonnaise	m a j ɔ n ɛ z
mayotte	m a j ɔ t
maître	m ɛ t ʁ
maîtrise	m ɛ t ʁ i z
maïs	m a i s
meeting	m i t i ŋ
membre	m ɑ̃ b ʁ
menace	m ə n a s
menacer	m ə n a s e
mener	m ə n e
meneur	m ə n œ ʁ
mensuel	m ɑ̃ s ɥ ɛ l
mental	m ɑ̃ t a l
menteur	m ɑ̃ t œ ʁ
menu	m ə n y
mer	m ɛ ʁ
merci	m ɛ ʁ s i
mercier	m ɛ ʁ s j e
mercure	m ɛ ʁ k y ʁ
mes	m e
messieurs	m e s j ø
met	m ɛ
mets	m ɛ
metteur	m ɛ t œ ʁ
mettre	m ɛ t ʁ
meurtre	m œ ʁ t ʁ
meurtrier	m œ ʁ t ʁ i j e
meurtrière	m œ ʁ t ʁ i j ɛ ʁ
mexicain	m ɛ k s i k ɛ̃
mexico	m ɛ k s i k o
mexique	m ɛ k s i k
miami	m i j a m i
michelle	m i ʃ ɛ l
michèle	m i ʃ ɛ l
mickaël	m i k a ɛ l
mieux	m j ø
milan	m i l ɑ̃
milice	m i l i s
milieu	m i l j ø
militaire	m i l i t ɛ ʁ
miller	m i l œ ʁ
milliard	m i l j a ʁ
milliardaire	m i l j a ʁ d ɛ ʁ
millier	m i l j e
million	m i l j ɔ̃
mince	m ɛ̃ s
mine	m i n
mineur	m i n œ ʁ
mini	m i n i
minimal	m i n i m a l
minimum	m i n i m ɔ m
ministre	m i n i s t ʁ
ministère	m i n i s t ɛ ʁ
minorité	m i n ɔ ʁ i t e
minuit	m i n ɥ i
miné	m i n e
mis	m i
mise	m i z
miserais	m i z ʁ ɛ
mission	m i s j ɔ̃
misère	m i z ɛ ʁ
mixte	m i k s t
mme	m a d a m
mobile	m ɔ b i l
mobilisation	m ɔ b i l i z a s j ɔ̃
modem	m ɔ d ɛ m
modeste	m ɔ d ɛ s t
modification	m ɔ d i f i k a s j ɔ̃
modifier	m ɔ d i f j e
modèle	m ɔ d ɛ l
modèles	m ɔ d ɛ l
modéré	m ɔ d e ʁ e
moindre	m w ɛ̃ d ʁ
moins	m w ɛ̃
moitié	m w a t j e
moleskine	m ɔ l ə s k i n
mollet	m ɔ l ɛ
moment	m ɔ m ɑ̃
monde	m ɔ̃ d
mondial	m ɔ̃ d j a l
moniteur	m ɔ n i t œ ʁ
monnaie	m ɔ n ɛ
mont	m ɔ̃
montant	m ɔ̃ t ɑ̃
monte	m ɔ̃ t
monter	m ɔ̃ t e
montre	m ɔ̃ t ʁ
montrer	m ɔ̃ t ʁ e
montréal	m ɔ̃ ʁ e a l
monté	m ɔ̃ t e
morale	m ɔ ʁ a l
mordu	m ɔ ʁ d y
more	m ɔ ʁ
mort	m ɔ ʁ
mortel	m ɔ ʁ t ɛ l
mosaïque	m o z a i k
moscou	m ɔ s k u
motif	m ɔ t i f
motion	m ɔ s j ɔ̃
motivante	m ɔ t i v ɑ̃ t
mots	m o
mouille	m u j
moussa	m u s a
mouton	m u t ɔ̃
mouvement	m u v m ɑ̃
moyen	m w a j ɛ̃
moyenne	m w a j ɛ n
moyeu	m w a j ø
multimédia	m y l t i m e d j a
municipal	m y n i s i p a l
municipalité	m y n i s i p a l i t e
mur	m y ʁ
murmure	m y ʁ m y ʁ
musclé	m y s k l e
musical	m y z i k a l
musicien	m y z i s j ɛ̃
musiques	m y z i k
musulman	m y z y l m ɑ̃
musée	m y z e
mutuel	m y t ɥ ɛ l
mystifier	m i s t i f j e
mythe	m i t
mère	m ɛ ʁ
mètres	m ɛ t ʁ
médaille	m e d a j
médical	m e d i k a l
médicale	m e d i k a l
médicament	m e d i k a m ɑ̃
médicaux	m e d i k o
mélanger	m e l ɑ̃ ʒ e
mélanie	m e l a n i
mémoire	m e m w a ʁ
méprendre	m e p ʁ ɑ̃ d ʁ
mépris	m e p ʁ i
mérite	m e ʁ i t
métal	m e t a l
méthane	m e t a n
méthanier	m e t a n j e
métier	m e t j e
métrage	m e t ʁ a ʒ
métro	m e t ʁ o
métropole	m e t ʁ ɔ p ɔ l
nage	n a ʒ
nantes	n ɑ̃ t
narcotiques	n a ʁ k ɔ t i k
natal	n a t a l
natale	n a t a l
natif	n a t i f
national	n a s j ɔ n a l
nationale	n a s j ɔ n a l
nationalité	n a s j ɔ n a l i t e
nature	n a t y ʁ
naturel	n a t y ʁ ɛ l
naturellement	n a t y ʁ ɛ l m ɑ̃
naufrage	n o f ʁ a ʒ
navire	n a v i ʁ
naïf	n a i f
neige	n ɛ ʒ
nerfs	n ɛ ʁ
net	n ɛ t
nette	n ɛ t
netteté	n ɛ t t e
nettoyage	n ɛ t w a j a ʒ
nettoyer	n ɛ t w a j e
neutrino	n ø t ʁ i n o
ni	n i
nice	n i s
nickel	n i k ɛ l
nie	n i
niger	n i ʒ ɛ ʁ
nini	n i n i
niveau	n i v o
nièvre	n j ɛ v ʁ
noble	n ɔ b l
noir	n w a ʁ
noire	n w a ʁ
noirs	n w a ʁ
nombre	n ɔ̃ b ʁ
nombreux	n ɔ̃ b ʁ ø
norbert	n ɔ ʁ b ɛ ʁ
nord	n ɔ ʁ
normal	n ɔ ʁ m a l
normalement	n ɔ ʁ m a l m ɑ̃
normalisation	n ɔ ʁ m a l i z a s j ɔ̃
norvège	n ɔ ʁ v ɛ ʒ
nos	n o
notamment	n ɔ t a m ɑ̃
notation	n ɔ t a s j ɔ̃
notre	n ɔ t ʁ
nourrice	n u ʁ i s
nourrir	n u ʁ i ʁ
nourriture	n u ʁ i t y ʁ
nous	n u
nouveau	n u v o
nouveauté	n u v o t e
nouvel	n u v ɛ l
nouvelle	n u v ɛ l
nouvelles	n u v ɛ l
novembre	n ɔ v ɑ̃ b ʁ
noyau	n w a j o
noël	n ɔ ɛ l
nucléaire	n y k l e ɛ ʁ
nul	n y l
nullement	n y l m ɑ̃
nutrition	n y t ʁ i s j ɔ̃
né	n e
néanmoins	n e ɑ̃ m w ɛ̃
nébuleuse	n e b y l ø z
nécessaire	n e s e s ɛ ʁ
nécessairement	n e s e s ɛ ʁ m ɑ̃
nécessité	n e s e s i t e
née	n e
négativement	n e ɡ a t i v m ɑ̃
négligence	n e ɡ l i ʒ ɑ̃ s
négocier	n e ɡ ɔ s j e
objet	ɔ b ʒ ɛ
oblige	ɔ b l i ʒ
observateur	ɔ p s ɛ ʁ v a t œ ʁ
obtenir	ɔ p t ə n i ʁ
obésité	ɔ b e z i t e
occasion	ɔ k a z j ɔ̃
occidental	ɔ k s i d ɑ̃ t a l
occidentale	ɔ k s i d ɑ̃ t a l
occupant	ɔ k y p ɑ̃
occuper	ɔ k y p e
occupé	ɔ k y p e
octobre	ɔ k t ɔ b ʁ
océans	ɔ s e ɑ̃
oeuf	œ f
office	ɔ f i s
officiers	ɔ f i s j e
offshore	ɔ f ʃ ɔ ʁ
ombre	ɔ̃ b ʁ
onde	ɔ̃ d
open	ɔ p ɛ n
opinion	ɔ p i n j ɔ̃
opposant	ɔ p o z ɑ̃
opposer	ɔ p o z e
opposition	ɔ p o z i s j ɔ̃
opposé	ɔ p o z e
optimisation	ɔ p t i m i z a s j ɔ̃
or	ɔ ʁ
orale	ɔ ʁ a l
ordinateur	ɔ ʁ d i n a t œ ʁ
ordinateurs	ɔ ʁ d i n a t œ ʁ
organisation	ɔ ʁ ɡ a n i z a s j ɔ̃
orgie	ɔ ʁ ʒ i
orgue	ɔ ʁ ɡ
orientales	ɔ ʁ j ɑ̃ t a l
orientation	ɔ ʁ j ɑ̃ t a s j ɔ̃
orienté	ɔ ʁ j ɑ̃ t e
originaire	ɔ ʁ i ʒ i n ɛ ʁ
originaires	ɔ ʁ i ʒ i n ɛ ʁ
origine	ɔ ʁ i ʒ i n
orthodoxe	ɔ ʁ t o d ɔ k s
ortie	ɔ ʁ t i
os	ɔ s
ose	o z
oslo	ɔ s l o
ossements	ɔ s m ɑ̃
otage	ɔ t a ʒ
ottawa	ɔ t a w a
oublie	u b l i
oublier	u b l i j e
oublié	u b l i j e
ouest	w ɛ s t
ouganda	u ɡ ɑ̃ d a
oui	w i
outre	u t ʁ
ouvert	u v ɛ ʁ
ouverte	u v ɛ ʁ t
ouvertement	u v ɛ ʁ t ə m ɑ̃
ouvertes	u v ɛ ʁ t
ouverture	u v ɛ ʁ t y ʁ
ouvrage	u v ʁ a ʒ
ouvre	u v ʁ
ouvrir	u v ʁ i ʁ
oxygène	ɔ k s i ʒ ɛ n
page	p a ʒ
paiement	p ɛ m ɑ̃
paiera	p ɛ ʁ a
pain	p ɛ̃
paisible	p e z i b l
paix	p ɛ
pakistan	p a k i s t ɑ̃
pakistanais	p a k i s t a n ɛ
palais	p a l ɛ
palestine	p a l ɛ s t i n
palestinien	p a l ɛ s t i n j ɛ̃
pallier	p a l j e
palmarès	p a l m a ʁ ɛ s
paludisme	p a l y d i s m
panique	p a n i k
panne	p a n
pape	p a p
papier	p a p j e
papillon	p a p i j ɔ̃
paquet	p a k ɛ
par	p a ʁ
paradis	p a ʁ a d i
parallèle	p a ʁ a l ɛ l
parc	p a ʁ k
parce	p a ʁ s
pardon	p a ʁ d ɔ̃
pareil	p a ʁ ɛ j
parents	p a ʁ ɑ̃
parer	p a ʁ e
parfait	p a ʁ f ɛ
parfaitement	p a ʁ f ɛ t m ɑ̃
parfois	p a ʁ f w a
paris	p a ʁ i
parisien	p a ʁ i z j ɛ̃
parker	p a ʁ k e
parking	p a ʁ k i ŋ
parle	p a ʁ l
parlement	p a ʁ l ə m ɑ̃
parlementaire	p a ʁ l ə m ɑ̃ t ɛ ʁ
parlent	p a ʁ l
parler	p a ʁ l e
parlerais	p a ʁ l ə ʁ ɛ
parlé	p a ʁ l e
parlée	p a ʁ l e
parmi	p a ʁ m i
paroissial	p a ʁ w a s j a l
parquet	p a ʁ k ɛ
parrain	p a ʁ ɛ̃
parrainage	p a ʁ ɛ n a ʒ
pars	p a ʁ
part	p a ʁ
partant	p a ʁ t ɑ̃
partenaire	p a ʁ t ə n ɛ ʁ
parti	p a ʁ t i
participation	p a ʁ t i s i p a s j ɔ̃
particule	p a ʁ t i k y l
particulier	p a ʁ t i k y l j e
particulièrement	p a ʁ t i k y l j ɛ ʁ m ɑ̃
parties	p a ʁ t i
partir	p a ʁ t i ʁ
partis	p a ʁ t i
partisane	p a ʁ t i z a n
partout	p a ʁ t u
party	p a ʁ t i
pascal	p a s k a l
passion	p a s j ɔ̃
pasteur	p a s t œ ʁ
patience	p a s j ɑ̃ s
patinage	p a t i n a ʒ
patrice	p a t ʁ i s
patrick	p a t ʁ i k
patron	p a t ʁ ɔ̃
patronage	p a t ʁ ɔ n a ʒ
patrouiller	p a t ʁ u j e
patte	p a t
pau	p o
paul	p ɔ l
pauline	p o l i n
pause	p o z
pauvre	p o v ʁ
pavillon	p a v i j ɔ̃
payant	p ɛ j ɑ̃
paysage	p ɛ i z a ʒ
peine	p ɛ n
peinture	p ɛ̃ t y ʁ
pencher	p ɑ̃ ʃ e
pendant	p ɑ̃ d ɑ̃
penser	p ɑ̃ s e
pension	p ɑ̃ s j ɔ̃
pensé	p ɑ̃ s e
pensée	p ɑ̃ s e
people	p i p ɔ l
percevoir	p ɛ ʁ s ə v w a ʁ
perchoir	p ɛ ʁ ʃ w a ʁ
perdre	p ɛ ʁ d ʁ
perdu	p ɛ ʁ d y
permanent	p ɛ ʁ m a n ɑ̃
permettre	p ɛ ʁ m ɛ t ʁ
permis	p ɛ ʁ m i
permission	p ɛ ʁ m i s j ɔ̃
perpendiculaire	p ɛ ʁ p ɑ̃ d i k y l ɛ ʁ
perron	p ɛ ʁ ɔ̃
personnage	p ɛ ʁ s ɔ n a ʒ
personnages	p ɛ ʁ s ɔ n a ʒ
personnaliser	p ɛ ʁ s ɔ n a l i z e
personnalité	p ɛ ʁ s ɔ n a l i t e
personne	p ɛ ʁ s ɔ n
personnel	p ɛ ʁ s ɔ n ɛ l
personnelle	p ɛ ʁ s ɔ n ɛ l
personnes	p ɛ ʁ s ɔ n
perspective	p ɛ ʁ s p ɛ k t i v
persécutions	p ɛ ʁ s e k y t j ɔ̃
persévérance	p ɛ ʁ s e v e ʁ ɑ̃ s
perte	p ɛ ʁ t
pertinemment	p ɛ ʁ t i n a m ɑ̃
pertinence	p ɛ ʁ t i n ɑ̃ s
pertinentes	p ɛ ʁ t i n ɑ̃ t
pestai	p ɛ s t e
petite	p ə t i t
petits	p ə t i
peu	p ø
peugeot	p ø ʒ o
peuple	p œ p l
peur	p œ ʁ
peut	p ø
peuvent	p œ v
peux	p ø
pharaon	f a ʁ a ɔ̃
phase	f a z
phil	f i l
philadelphie	f i l a d ɛ l f i
philippe	f i l i p
philosophe	f i l ɔ z ɔ f
phone	f ɔ n
photographe	f ɔ t ɔ ɡ ʁ a f
phrase	f ʁ ɑ z
physique	f i z i k
phénomène	f e n ɔ m ɛ n
piaillâmes	p j a j ɑ m
pied	p j e
pieds	p j e
pierre	p j ɛ ʁ
pilier	p i l j e
pilote	p i l ɔ t
piloter	p i l ɔ t e
pineau	p i n o
pintade	p ɛ̃ t a d
pirate	p i ʁ a t
pire	p i ʁ
pis	p i
piste	p i s t
pistes	p i s t
pisté	p i s t e
pittoresque	p i t ɔ ʁ ɛ s k
pièce	p j ɛ s
piège	p j ɛ ʒ
place	p l a s
placer	p l a s e
places	p l a s
placé	p l a s e
plaie	p l ɛ
plainte	p l ɛ̃ t
plaire	p l ɛ ʁ
plaisanciers	p l ɛ z ɑ̃ s j e
plan	p l ɑ̃
planification	p l a n i f i k a s j ɔ̃
plans	p l ɑ̃
planète	p l a n ɛ t
planétaire	p l a n e t ɛ ʁ
plaquer	p l a k e
plat	p l a
plateau	p l a t o
plaît	p l ɛ
plier	p l i j e
plongeon	p l ɔ̃ ʒ ɔ̃
plug	p l œ ɡ
plupart	p l y p a ʁ
plusieurs	p l y z j œ ʁ
plutôt	p l y t o
pléthore	p l e t ɔ ʁ
pme	p e ɛ m ø
poche	p ɔ ʃ
poignet	p w a ɲ ɛ
poignée	p w a ɲ e
poing	p w ɛ̃
point	p w ɛ̃
pointant	p w ɛ̃ t ɑ̃
pointe	p w ɛ̃ t
points	p w ɛ̃
poisson	p w a s ɔ̃
poissons	p w a s ɔ̃
poker	p ɔ k ɛ ʁ
police	p ɔ l i s
politicien	p ɔ l i t i s j ɛ̃
politique	p ɔ l i t i k
poltron	p ɔ l t ʁ ɔ̃
polytechnique	p ɔ l i t ɛ k n i k
polyvalence	p ɔ l i v a l ɑ̃ s
polémique	p ɔ l e m i k
polémiquer	p ɔ l e m i k e
pomme	p ɔ m
pont	p ɔ̃
pornographique	p ɔ ʁ n ɔ ɡ ʁ a f i k
port	p ɔ ʁ
portaient	p ɔ ʁ t ɛ
portant	p ɔ ʁ t ɑ̃
portative	p ɔ ʁ t a t i v
porteur	p ɔ ʁ t œ ʁ
portier	p ɔ ʁ t j e
porto	p ɔ ʁ t o
portée	p ɔ ʁ t e
poser	p o z e
positif	p o z i t i f
position	p o z i s j ɔ̃
possible	p ɔ s i b l
possibles	p ɔ s i b l
posséder	p ɔ s e d e
poste	p ɔ s t
potable	p ɔ t a b l
potager	p ɔ t a ʒ e
poteau	p ɔ t o
potentiel	p ɔ t ɑ̃ s j ɛ l
potentiels	p ɔ t ɑ̃ s j ɛ l
pouces	p u s
poudre	p u d ʁ
poulain	p u l ɛ̃
poule	p u l
poulpe	p u l p
pour	p u ʁ
pourquoi	p u ʁ k w a
pourra	p u ʁ a
poursuivre	p u ʁ s ɥ i v ʁ
pourtant	p u ʁ t ɑ̃
pouvez	p u v e
pouvoir	p u v w a ʁ
pouvons	p u v ɔ̃
poète	p ɔ ɛ t
poétiques	p ɔ e t i k
pratique	p ʁ a t i k
pratiquent	p ʁ a t i k
pratiques	p ʁ a t i k
pratiqué	p ʁ a t i k e
première	p ʁ ə m j ɛ ʁ
prenait	p ʁ ə n ɛ
prend	p ʁ ɑ̃
prendra	p ʁ ɑ̃ d ʁ a
prendre	p ʁ ɑ̃ d ʁ
prenne	p ʁ ɛ n
prennent	p ʁ ɛ n
presque	p ʁ ɛ s k
presse	p ʁ ɛ s
prestation	p ʁ ɛ s t a s j ɔ̃
prestige	p ʁ ɛ s t i ʒ
primauté	p ʁ i m o t e
primordial	p ʁ i m ɔ ʁ d j a l
principal	p ʁ ɛ̃ s i p a l
principe	p ʁ ɛ̃ s i p
printanier	p ʁ ɛ̃ t a n j e
printemps	p ʁ ɛ̃ t ɑ̃
priorité	p ʁ i j ɔ ʁ i t e
pris	p ʁ i
prison	p ʁ i z ɔ̃
privation	p ʁ i v a s j ɔ̃
priver	p ʁ i v e
privilège	p ʁ i v i l ɛ ʒ
privé	p ʁ i v e
prix	p ʁ i
probable	p ʁ ɔ b a b l
problème	p ʁ ɔ b l ɛ m
problématique	p ʁ ɔ b l e m a t i k
processeur	p ʁ ɔ s ɛ s œ ʁ
processus	p ʁ ɔ s ɛ s y s
prochaine	p ʁ ɔ ʃ ɛ n
proche	p ʁ ɔ ʃ
proches	p ʁ ɔ ʃ
procureur	p ʁ ɔ k y ʁ œ ʁ
procès	p ʁ ɔ s ɛ
procédure	p ʁ ɔ s e d y ʁ
procédures	p ʁ ɔ s e d y ʁ
production	p ʁ ɔ d y k s j ɔ̃
produisent	p ʁ ɔ d ɥ i z
produit	p ʁ ɔ d ɥ i
prof	p ʁ ɔ f
professeur	p ʁ ɔ f ɛ s œ ʁ
professeure	p ʁ ɔ f ɛ s œ ʁ
profession	p ʁ ɔ f ɛ s j ɔ̃
profil	p ʁ ɔ f i l
profit	p ʁ ɔ f i
profits	p ʁ ɔ f i
profondeur	p ʁ ɔ f ɔ̃ d œ ʁ
programme	p ʁ ɔ ɡ ʁ a m
progresser	p ʁ ɔ ɡ ʁ ɛ s e
progression	p ʁ ɔ ɡ ʁ ɛ s j ɔ̃
progrès	p ʁ ɔ ɡ ʁ ɛ
projet	p ʁ ɔ ʒ ɛ
prolonge	p ʁ ɔ l ɔ̃ ʒ
prolonger	p ʁ ɔ l ɔ̃ ʒ e
promesse	p ʁ ɔ m ɛ s
promoteur	p ʁ ɔ m ɔ t œ ʁ
promotion	p ʁ ɔ m ɔ s j ɔ̃
promouvoir	p ʁ ɔ m u v w a ʁ
prononcer	p ʁ ɔ n ɔ̃ s e
prononcé	p ʁ ɔ n ɔ̃ s e
prophète	p ʁ ɔ f ɛ t
propos	p ʁ ɔ p o
proposer	p ʁ ɔ p o z e
proposition	p ʁ ɔ p o z i s j ɔ̃
propre	p ʁ ɔ p ʁ
propriétaire	p ʁ ɔ p ʁ i j e t ɛ ʁ
protection	p ʁ ɔ t ɛ k s j ɔ̃
protester	p ʁ ɔ t ɛ s t e
protocole	p ʁ ɔ t ɔ k ɔ l
protège	p ʁ ɔ t ɛ ʒ
protégeait	p ʁ ɔ t e ʒ ɛ
protéger	p ʁ ɔ t e ʒ e
protégée	p ʁ ɔ t e ʒ e
prouesse	p ʁ u ɛ s
proviendra	p ʁ ɔ v j ɛ̃ d ʁ a
province	p ʁ ɔ v ɛ̃ s
provinces	p ʁ ɔ v ɛ̃ s
provincial	p ʁ ɔ v ɛ̃ s j a l
provoquer	p ʁ ɔ v ɔ k e
proximité	p ʁ ɔ k s i m i t e
prudence	p ʁ y d ɑ̃ s
prudent	p ʁ y d ɑ̃
prudente	p ʁ y d ɑ̃ t
près	p ʁ ɛ
pré	p ʁ e
préalable	p ʁ e a l a b l
précipiter	p ʁ e s i p i t e
précis	p ʁ e s i
précurseur	p ʁ e k y ʁ s œ ʁ
précédemment	p ʁ e s e d a m ɑ̃
précédent	p ʁ e s e d ɑ̃
prédire	p ʁ e d i ʁ
prédominance	p ʁ e d ɔ m i n ɑ̃ s
préfecture	p ʁ e f ɛ k t y ʁ
préfet	p ʁ e f ɛ
préféré	p ʁ e f e ʁ e
préjudiciable	p ʁ e ʒ y d i s j a b l
prélever	p ʁ e l v e
prématuré	p ʁ e m a t y ʁ e
prénom	p ʁ e n ɔ̃
préoccupations	p ʁ e ɔ k y p a s j ɔ̃
préparatifs	p ʁ e p a ʁ a t i f
préparer	p ʁ e p a ʁ e
présence	p ʁ e z ɑ̃ s
présent	p ʁ e z ɑ̃
présentation	p ʁ e z ɑ̃ t a s j ɔ̃
présents	p ʁ e z ɑ̃
présentée	p ʁ e z ɑ̃ t e
préservation	p ʁ e z ɛ ʁ v a s j ɔ̃
préserver	p ʁ e z ɛ ʁ v e
présidence	p ʁ e z i d ɑ̃ s
prétendre	p ʁ e t ɑ̃ d ʁ
prévisible	p ʁ e v i z i b l
prévoir	p ʁ e v w a ʁ
prévu	p ʁ e v y
prêcher	p ʁ ɛ ʃ e
prêt	p ʁ ɛ
prête	p ʁ ɛ t
prêteurs	p ʁ ɛ t œ ʁ
prône	p ʁ o n
psychologie	p s i k ɔ l ɔ ʒ i
pu	p y
public	p y b l i k
publication	p y b l i k a s j ɔ̃
publicité	p y b l i s i t e
publier	p y b l i j e
puis	p ɥ i
puisque	p ɥ i s k
puissance	p ɥ i s ɑ̃ s
puits	p ɥ i
punition	p y n i s j ɔ̃
put	p y
pâle	p ɑ l
pâques	p ɑ k
pâtit	p a t i
pédagogique	p e d a ɡ ɔ ʒ i k
pédophiles	p e d ɔ f i l
pégase	p e ɡ a z
pékin	p e k ɛ̃
pénible	p e n i b l
période	p e ʁ j ɔ d
périodes	p e ʁ j ɔ d
péter	p e t e
pétition	p e t i s j ɔ̃
pétrole	p e t ʁ ɔ l
pétrolier	p e t ʁ ɔ l j e
pôle	p o l
qu	k y
qualité	k a l i t e
quantité	k ɑ̃ t i t e
quarante	k a ʁ ɑ̃ t
quartier	k a ʁ t j e
quartiers	k a ʁ t j e
quasiment	k a z i m ɑ̃
quatorze	k a t ɔ ʁ z
quatrième	k a t ʁ i j ɛ m
que	k ə
quel	k ɛ l
quelles	k ɛ l
quelques	k ɛ l k
quels	k ɛ l
questions	k ɛ s t j ɔ̃
queue	k ø
qui	k i
quiconque	k i k ɔ̃ k
quignon	k i ɲ ɔ̃
quincaillerie	k ɛ̃ k ɑ j ʁ i
quinze	k ɛ̃ z
quitte	k i t
quitter	k i t e
quotidien	k ɔ t i d j ɛ̃
québec	k e b ɛ k
québécoise	k e b e k w a z
quête	k ɛ t
rachel	ʁ a ʃ ɛ l
radar	ʁ a d a ʁ
radio	ʁ a d j o
radiologie	ʁ a d j ɔ l ɔ ʒ i
rage	ʁ a ʒ
raison	ʁ ɛ z ɔ̃
raisonnable	ʁ ɛ z ɔ n a b l
rallonge	ʁ a l ɔ̃ ʒ
rallye	ʁ a l i
rame	ʁ a m
ramener	ʁ a m n e
rapace	ʁ a p a s
raphaël	ʁ a f a ɛ l
rapide	ʁ a p i d
rapidement	ʁ a p i d m ɑ̃
rappel	ʁ a p ɛ l
rappeler	ʁ a p l e
rapport	ʁ a p ɔ ʁ
rapporter	ʁ a p ɔ ʁ t e
rare	ʁ ɑ ʁ
rarement	ʁ ɑ ʁ m ɑ̃
rassemblements	ʁ a s ɑ̃ b l ə m ɑ̃
rationaliser	ʁ a s j ɔ n a l i z e
ratisbonne	ʁ a t i s b ɔ n
rats	ʁ a
rattrapage	ʁ a t ʁ a p a ʒ
rattraper	ʁ a t ʁ a p e
raté	ʁ a t e
ravi	ʁ a v i
ravitailler	ʁ a v i t a j e
raymond	ʁ ɛ m ɔ̃
rc	ɛ ʁ s e
rebecca	ʁ e b ɛ k a
rebelle	ʁ ə b ɛ l
recadrer	ʁ ə k a d ʁ e
recel	ʁ ə s ɛ l
recensement	ʁ ə s ɑ̃ s m ɑ̃
recevoir	ʁ ə s ə v w a ʁ
recherche	ʁ ə ʃ ɛ ʁ ʃ
rechercher	ʁ ə ʃ ɛ ʁ ʃ e
recherches	ʁ ə ʃ ɛ ʁ ʃ
recluse	ʁ ə k l y z
recommandé	ʁ ə k ɔ m ɑ̃ d e
reconnaissance	ʁ ə k ɔ n ɛ s ɑ̃ s
reconstruire	ʁ ə k ɔ̃ s t ʁ ɥ i ʁ
record	ʁ ə k ɔ ʁ
recours	ʁ ə k u ʁ
recrue	ʁ ə k ʁ y
recruter	ʁ ə k ʁ y t e
rectifier	ʁ ɛ k t i f j e
recueillir	ʁ ə k œ j i ʁ
recule	ʁ ə k y l
reculer	ʁ ə k y l e
redonner	ʁ ə d ɔ n e
redouter	ʁ ə d u t e
redéfinissant	ʁ ə d e f i n i s ɑ̃
refiler	ʁ ə f i l e
refonte	ʁ ə f ɔ̃ t
refuge	ʁ ə f y ʒ
refus	ʁ ə f y
regard	ʁ ə ɡ a ʁ
registre	ʁ ə ʒ i s t ʁ
rejeter	ʁ ə ʒ ə t e
rejoindre	ʁ ə ʒ w ɛ̃ d ʁ
relais	ʁ ə l ɛ
relance	ʁ ə l ɑ̃ s
relation	ʁ ə l a s j ɔ̃
relativement	ʁ ə l a t i v m ɑ̃
relatives	ʁ ə l a t i v
relever	ʁ ə l ə v e
reliant	ʁ ə l j ɑ̃
relie	ʁ ə l i
relier	ʁ ə l j e
religion	ʁ ə l i ʒ j ɔ̃
relu	ʁ ə l y
remarque	ʁ ə m a ʁ k
rembourser	ʁ ɑ̃ b u ʁ s e
remise	ʁ ə m i z
remplacer	ʁ ɑ̃ p l a s e
remporter	ʁ ɑ̃ p ɔ ʁ t e
remédier	ʁ ə m e d j e
renault	ʁ ə n o
rencontre	ʁ ɑ̃ k ɔ̃ t ʁ
rencontrer	ʁ ɑ̃ k ɔ̃ t ʁ e
rend	ʁ ɑ̃
rendre	ʁ ɑ̃ d ʁ
renforcement	ʁ ɑ̃ f ɔ ʁ s ə m ɑ̃
renforcer	ʁ ɑ̃ f ɔ ʁ s e
rennes	ʁ ɛ n
renommée	ʁ ə n ɔ m e
renoncer	ʁ ə n ɔ̃ s e
renouvellement	ʁ ə n u v ɛ l m ɑ̃
renseignement	ʁ ɑ̃ s ɛ ɲ m ɑ̃
rentrée	ʁ ɑ̃ t ʁ e
renverser	ʁ ɑ̃ v ɛ ʁ s e
renvoi	ʁ ɑ̃ v w a
renvoyer	ʁ ɑ̃ v w a j e
rené	ʁ ə n e
report	ʁ ə p ɔ ʁ
repos	ʁ ə p o
repose	ʁ ə p o z
reposer	ʁ ə p o z e
reprise	ʁ ə p ʁ i z
reprocher	ʁ ə p ʁ ɔ ʃ e
représentait	ʁ ə p ʁ e z ɑ̃ t ɛ
représentant	ʁ ə p ʁ e z ɑ̃ t ɑ̃
rescousse	ʁ ɛ s k u s
respect	ʁ ɛ s p ɛ
respectivement	ʁ ɛ s p ɛ k t i v m ɑ̃
responsabilité	ʁ ɛ s p ɔ̃ s a b i l i t e
responsable	ʁ ɛ s p ɔ̃ s a b l
ressassés	ʁ ə s a s e
ressenti	ʁ ə s ɑ̃ t i
ressentir	ʁ ə s ɑ̃ t i ʁ
ressort	ʁ ə s ɔ ʁ
ressortent	ʁ ə s ɔ ʁ t
ressorti	ʁ ə s ɔ ʁ t i
ressortir	ʁ ə s ɔ ʁ t i ʁ
ressortissait	ʁ ə s ɔ ʁ t i s ɛ
ressortissant	ʁ ə s ɔ ʁ t i s ɑ̃
restaient	ʁ ɛ s t ɛ
restait	ʁ ɛ s t ɛ
reste	ʁ ɛ s t
restent	ʁ ɛ s t
rester	ʁ ɛ s t e
resté	ʁ ɛ s t e
retenir	ʁ ə t ə n i ʁ
retirer	ʁ ə t i ʁ e
retordre	ʁ ə t ɔ ʁ d ʁ
retour	ʁ ə t u ʁ
retourner	ʁ ə t u ʁ n e
retourné	ʁ ə t u ʁ n e
retrait	ʁ ə t ʁ ɛ
retraite	ʁ ə t ʁ ɛ t
retraité	ʁ ə t ʁ ɛ t e
retrousseront	ʁ ə t ʁ u s ʁ ɔ̃
retrouver	ʁ ə t ʁ u v e
revanche	ʁ ə v ɑ̃ ʃ
revendication	ʁ ə v ɑ̃ d i k a s j ɔ̃
revoir	ʁ ə v w a ʁ
reçu	ʁ ə s y
rhum	ʁ ɔ m
richard	ʁ i ʃ a ʁ
riches	ʁ i ʃ
ridicule	ʁ i d i k y l
rien	ʁ j ɛ̃
rigoureux	ʁ i ɡ u ʁ ø
riposte	ʁ i p ɔ s t
rire	ʁ i ʁ
rival	ʁ i v a l
rive	ʁ i v
river	ʁ i v e
riz	ʁ i
roadmap	ʁ ɔ d m a p
robe	ʁ ɔ b
robin	ʁ ɔ b ɛ̃
robustesse	ʁ ɔ b y s t ɛ s
rock	ʁ ɔ k
roger	ʁ ɔ ʒ e
roland	ʁ ɔ l ɑ̃
roman	ʁ ɔ m ɑ̃
rome	ʁ ɔ m
ronde	ʁ ɔ̃ d
roque	ʁ ɔ k
roselyne	ʁ o z l i n
rosée	ʁ o z e
rotation	ʁ ɔ t a s j ɔ̃
roubaix	ʁ u b ɛ
rouge	ʁ u ʒ
roumanie	ʁ u m a n i
roussillon	ʁ u s i j ɔ̃
route	ʁ u t
ruben	ʁ y b ɛ n
rubrique	ʁ y b ʁ i k
rude	ʁ y d
rue	ʁ y
ruines	ʁ ɥ i n
rumeur	ʁ y m œ ʁ
rupture	ʁ y p t y ʁ
russe	ʁ y s
russes	ʁ y s
russie	ʁ y s i
rythme	ʁ i t m
règle	ʁ ɛ ɡ l
règlement	ʁ ɛ ɡ l ə m ɑ̃
règles	ʁ ɛ ɡ l
réalisateur	ʁ e a l i z a t œ ʁ
réaliser	ʁ e a l i z e
réalité	ʁ e a l i t e
récemment	ʁ e s a m ɑ̃
récent	ʁ e s ɑ̃
réception	ʁ e s ɛ p s j ɔ̃
réclame	ʁ e k l a m
réclamer	ʁ e k l a m e
récolte	ʁ e k ɔ l t
récréation	ʁ e k ʁ e a s j ɔ̃
récupérer	ʁ e k y p e ʁ e
réduction	ʁ e d y k s j ɔ̃
réduire	ʁ e d ɥ i ʁ
réellement	ʁ e ɛ l m ɑ̃
réfection	ʁ e f ɛ k s j ɔ̃
réfectoire	ʁ e f ɛ k t w a ʁ
réflexion	ʁ e f l ɛ k s j ɔ̃
réformer	ʁ e f ɔ ʁ m e
réformes	ʁ e f ɔ ʁ m
référence	ʁ e f e ʁ ɑ̃ s
régie	ʁ e ʒ i
régime	ʁ e ʒ i m
régiment	ʁ e ʒ i m ɑ̃
région	ʁ e ʒ j ɔ̃
régionale	ʁ e ʒ j ɔ n a l
régionales	ʁ e ʒ j ɔ n a l
réglementation	ʁ ɛ ɡ l ə m ɑ̃ t a s j ɔ̃
régler	ʁ e ɡ l e
régulièrement	ʁ e ɡ y l j ɛ ʁ m ɑ̃
réjouis	ʁ e ʒ w i
rémy	ʁ e m i
réouverture	ʁ e u v ɛ ʁ t y ʁ
répartie	ʁ e p a ʁ t i
répondre	ʁ e p ɔ̃ d ʁ
réponds	ʁ e p ɔ̃
réponse	ʁ e p ɔ̃ s
réprimande	ʁ e p ʁ i m ɑ̃ d
réputation	ʁ e p y t a s j ɔ̃
répéter	ʁ e p e t e
résolution	ʁ e z ɔ l y s j ɔ̃
résonner	ʁ e z ɔ n e
résoudre	ʁ e z u d ʁ
résultat	ʁ e z y l t a
résumé	ʁ e z y m e
résurrection	ʁ e z y ʁ ɛ k s j ɔ̃
rétablissement	ʁ e t a b l i s m ɑ̃
rétablit	ʁ e t a b l i
rétention	ʁ e t ɑ̃ s j ɔ̃
rétroactivité	ʁ e t ʁ o a k t i v i t e
rétrograde	ʁ e t ʁ ɔ ɡ ʁ a d
réunir	ʁ e y n i ʁ
réussite	ʁ e y s i t
réveillonnent	ʁ e v ɛ j ɔ n
révolte	ʁ e v ɔ l t
révolution	ʁ e v ɔ l y s j ɔ̃
révolutionnaire	ʁ e v ɔ l y s j ɔ n ɛ ʁ
révélations	ʁ e v e l a s j ɔ̃
révéler	ʁ e v e l e
rêve	ʁ ɛ v
rêvé	ʁ ɛ v e
rôle	ʁ o l
sa	s a
sable	s ɑ b l
sacha	s a ʃ a
sacré	s a k ʁ e
saga	s a ɡ a
sage	s a ʒ
sagement	s a ʒ m ɑ̃
sain	s ɛ̃
saints	s ɛ̃
saisie	s ɛ z i
saisir	s ɛ z i ʁ
saison	s ɛ z ɔ̃
salaire	s a l ɛ ʁ
salle	s a l
salon	s a l ɔ̃
saluer	s a l ɥ e
samba	s ɑ̃ b a
samedi	s a m d i
samu	s a m y
samuel	s a m ɥ ɛ l
san	s a n
sanction	s ɑ̃ k s j ɔ̃
sang	s ɑ̃
saragosse	s a ʁ a ɡ ɔ s
sarajevo	s a ʁ a j e v o
sardaigne	s a ʁ d ɛ ɲ
sarkozy	s a ʁ k ɔ z i
sassari	s a s a ʁ i
satisfaction	s a t i s f a k s j ɔ̃
satisfaire	s a t i s f ɛ ʁ
satisfait	s a t i s f ɛ
sauce	s o s
saut	s o
sauteurs	s o t œ ʁ
sauve	s o v
sauver	s o v e
savante	s a v ɑ̃ t
saveur	s a v œ ʁ
savourer	s a v u ʁ e
scandale	s k ɑ̃ d a l
scientifique	s j ɑ̃ t i f i k
scolaire	s k ɔ l ɛ ʁ
score	s k ɔ ʁ
script	s k ʁ i p t
scrutin	s k ʁ y t ɛ̃
sculpture	s k y l t y ʁ
scène	s ɛ n
scénario	s e n a ʁ j o
scénariste	s e n a ʁ i s t
scénique	s e n i k
se	s ə
seconde	s ə ɡ ɔ̃ d
secours	s ə k u ʁ
secrets	s ə k ʁ ɛ
secrétaire	s ə k ʁ e t ɛ ʁ
secteur	s ɛ k t œ ʁ
section	s ɛ k s j ɔ̃
sein	s ɛ̃
seizième	s ɛ z j ɛ m
sel	s ɛ l
selon	s ə l ɔ̃
sembler	s ɑ̃ b l e
semestre	s ə m ɛ s t ʁ
sens	s ɑ̃ s
sensible	s ɑ̃ s i b l
sensé	s ɑ̃ s e
senti	s ɑ̃ t i
sentiment	s ɑ̃ t i m ɑ̃
sentimentale	s ɑ̃ t i m ɑ̃ t a l
sentir	s ɑ̃ t i ʁ
septième	s ɛ t j ɛ m
serge	s ɛ ʁ ʒ
serrée	s e ʁ e
sert	s ɛ ʁ
serve	s ɛ ʁ v
serveur	s ɛ ʁ v œ ʁ
servir	s ɛ ʁ v i ʁ
ses	s e
session	s ɛ s j ɔ̃
set	s ɛ t
seuil	s œ j
seul	s œ l
seule	s œ l
seulement	s œ l m ɑ̃
shooter	ʃ u t e
si	s i
sida	s i d a
signal	s i ɲ a l
signe	s i ɲ
signer	s i ɲ e
signifie	s i ɲ i f i
silence	s i l ɑ̃ s
simon	s i m ɔ̃
simple	s ɛ̃ p l
simplement	s ɛ̃ p l ə m ɑ̃
simplicité	s ɛ̃ p l i s i t e
simultanément	s i m y l t a n e m ɑ̃
sincère	s ɛ̃ s ɛ ʁ
sincèrement	s ɛ̃ s ɛ ʁ m ɑ̃
singapour	s ɛ̃ ɡ a p u ʁ
sinon	s i n ɔ̃
situation	s i t ɥ a s j ɔ̃
sixième	s i z j ɛ m
siècle	s j ɛ k l
siège	s j ɛ ʒ
ski	s k i
slalom	s l a l ɔ m
slovaquie	s l ɔ v a k i
sms	ɛ s ɛ m ɛ s
sobre	s ɔ b ʁ
soc	s ɔ k
social	s ɔ s j a l
sociale	s ɔ s j a l
sociales	s ɔ s j a l
sociaux	s ɔ s j o
société	s ɔ s j e t e
sociétés	s ɔ s j e t e
socle	s ɔ k l
soeur	s œ ʁ
sofia	s ɔ f j a
soft	s ɔ f t
soi	s w a
soient	s w a
soin	s w ɛ̃
soirs	s w a ʁ
soirée	s w a ʁ e
soixantaine	s w a s ɑ̃ t ɛ n
sol	s ɔ l
soldat	s ɔ l d a
solde	s ɔ l d
solidaire	s ɔ l i d ɛ ʁ
solidarité	s ɔ l i d a ʁ i t e
solide	s ɔ l i d
solitaire	s ɔ l i t ɛ ʁ
solution	s ɔ l y s j ɔ̃
sombre	s ɔ̃ b ʁ
somme	s ɔ m
sommes	s ɔ m
sommet	s ɔ m ɛ
sondage	s ɔ̃ d a ʒ
sonner	s ɔ n e
sonnette	s ɔ n ɛ t
sort	s ɔ ʁ
sorte	s ɔ ʁ t
sortir	s ɔ ʁ t i ʁ
sou	s u
souci	s u s i
soucier	s u s j e
soucoupe	s u k u p
soudan	s u d ɑ̃
souffle	s u f l
souffrance	s u f ʁ ɑ̃ s
souffrir	s u f ʁ i ʁ
soulager	s u l a ʒ e
soupaient	s u p ɛ
source	s u ʁ s
sourire	s u ʁ i ʁ
souris	s u ʁ i
sous	s u
soutenir	s u t n i ʁ
soutien	s u t j ɛ̃
souvenir	s u v n i ʁ
souvent	s u v ɑ̃
spectacle	s p ɛ k t a k l
spectaculaire	s p ɛ k t a k y l ɛ ʁ
spirale	s p i ʁ a l
spirituel	s p i ʁ i t ɥ ɛ l
splendeur	s p l ɑ̃ d œ ʁ
sponsor	s p ɔ̃ s ɔ ʁ
sportif	s p ɔ ʁ t i f
sprint	s p ʁ i n t
sprinteur	s p ʁ i n t œ ʁ
spécial	s p e s j a l
spécialement	s p e s j a l m ɑ̃
spécialiste	s p e s j a l i s t
spécifiquement	s p e s i f i k m ɑ̃
spéculateurs	s p e k y l a t œ ʁ
square	s k w a ʁ
stable	s t a b l
staff	s t a f
standard	s t ɑ̃ d a ʁ
stanislas	s t a n i s l a s
station	s t a s j ɔ̃
statistique	s t a t i s t i k
statistiques	s t a t i s t i k
statut	s t a t y
stocker	s t ɔ k e
stratégie	s t ʁ a t e ʒ i
studio	s t y d j o
style	s t i l
subit	s y b i
subitement	s y b i t m ɑ̃
subordinations	s y b ɔ ʁ d i n a s j ɔ̃
substance	s y p s t ɑ̃ s
substitution	s y p s t i t y s j ɔ̃
subtil	s y p t i l
successeur	s y k s ɛ s œ ʁ
succession	s y k s ɛ s j ɔ̃
succéder	s y k s e d e
sud	s y d
suffisant	s y f i z ɑ̃
suggestions	s y ɡ ʒ ɛ s t j ɔ̃
suicide	s ɥ i s i d
suicider	s ɥ i s i d e
suisse	s ɥ i s
suite	s ɥ i t
suites	s ɥ i t
sujet	s y ʒ ɛ
supplémentaire	s y p l e m ɑ̃ t ɛ ʁ
suprême	s y p ʁ ɛ m
supérieurs	s y p e ʁ j œ ʁ
sur	s y ʁ
surcharger	s y ʁ ʃ a ʁ ʒ e
surface	s y ʁ f a s
surgir	s y ʁ ʒ i ʁ
surgisse	s y ʁ ʒ i s
surmonter	s y ʁ m ɔ̃ t e
surnommaient	s y ʁ n ɔ m ɛ
surnommé	s y ʁ n ɔ m e
surplus	s y ʁ p l y
surprendre	s y ʁ p ʁ ɑ̃ d ʁ
surprise	s y ʁ p ʁ i z
sursis	s y ʁ s i
surveillais	s y ʁ v ɛ j ɛ
surveillance	s y ʁ v ɛ j ɑ̃ s
surveillent	s y ʁ v ɛ j
surveiller	s y ʁ v ɛ j e
survenu	s y ʁ v ə n y
survient	s y ʁ v j ɛ̃
suscité	s y s i t e
suspecte	s y s p ɛ k t
suspension	s y s p ɑ̃ s j ɔ̃
suspicion	s y s p i s j ɔ̃
suède	s ɥ ɛ d
suédois	s ɥ e d w a
sylvie	s i l v i
symbole	s ɛ̃ b ɔ l
sympa	s ɛ̃ p a
sympathie	s ɛ̃ p a t i
synchronisme	s ɛ̃ k ʁ ɔ n i s m
syndic	s ɛ̃ d i k
syndicales	s ɛ̃ d i k a l
syndicat	s ɛ̃ d i k a
syndrome	s ɛ̃ d ʁ o m
synthèse	s ɛ̃ t ɛ z
systèmes	s i s t ɛ m
séance	s e ɑ̃ s
séances	s e ɑ̃ s
sébastien	s e b a s t j ɛ̃
séduction	s e d y k s j ɔ̃
ségolène	s e ɡ ɔ l ɛ n
séisme	s e i s m
sélection	s e l ɛ k s j ɔ̃
sélectionneur	s e l ɛ k s j ɔ n œ ʁ
sélections	s e l ɛ k s j ɔ̃
sénat	s e n a
sénatrice	s e n a t ʁ i s
sénégal	s e n e ɡ a l
séoul	s e u l
sérieusement	s e ʁ j ø z m ɑ̃
sérieux	s e ʁ j ø
sévit	s e v i
sûr	s y ʁ
sûre	s y ʁ
sûrement	s y ʁ m ɑ̃
sûreté	s y ʁ t e
tabac	t a b a
tablettes	t a b l ɛ t
taille	t a j
taire	t ɛ ʁ
talent	t a l ɑ̃
talon	t a l ɔ̃
tanger	t ɑ̃ ʒ e
tanzanie	t ɑ̃ z a n i
tape	t a p
taquin	t a k ɛ̃
tard	t a ʁ
tarmac	t a ʁ m a k
taxation	t a k s a s j ɔ̃
tchèque	t ʃ ɛ k
te	t ə
technique	t ɛ k n i k
technologique	t ɛ k n ɔ l ɔ ʒ i k
teinturier	t ɛ̃ t y ʁ j e
tel	t ɛ l
tellement	t ɛ l m ɑ̃
température	t ɑ̃ p e ʁ a t y ʁ
tendance	t ɑ̃ d ɑ̃ s
tendon	t ɑ̃ d ɔ̃
tendre	t ɑ̃ d ʁ
tenir	t ə n i ʁ
tennis	t e n i s
tentatives	t ɑ̃ t a t i v
tente	t ɑ̃ t
tenter	t ɑ̃ t e
tenue	t ə n y
terme	t ɛ ʁ m
terminer	t ɛ ʁ m i n e
terrain	t ɛ ʁ ɛ̃
terre	t ɛ ʁ
terrestres	t ɛ ʁ ɛ s t ʁ
terroir	t ɛ ʁ w a ʁ
tes	t e
test	t ɛ s t
texte	t ɛ k s t
tgv	t e ʒ e v e
thaïe	t a j
thaïlandais	t a j l ɑ̃ d ɛ
thaïlande	t a j l ɑ̃ d
thibault	t i b o
thomas	t ɔ m ɑ
thème	t ɛ m
thèse	t ɛ z
thématique	t e m a t i k
thématiques	t e m a t i k
théodore	t e ɔ d ɔ ʁ
thérapie	t e ʁ a p i
thérèse	t e ʁ ɛ z
théâtre	t e ɑ t ʁ
tiers	t j ɛ ʁ
tigre	t i ɡ ʁ
timbre	t ɛ̃ b ʁ
timide	t i m i d
tir	t i ʁ
tire	t i ʁ
tirer	t i ʁ e
tissu	t i s y
titre	t i t ʁ
togo	t o ɡ o
tokyo	t o k j o
tolérance	t ɔ l e ʁ ɑ̃ s
tombe	t ɔ̃ b
tomber	t ɔ̃ b e
torpiller	t ɔ ʁ p i j e
toscane	t ɔ s k a n
totalement	t ɔ t a l m ɑ̃
totales	t ɔ t a l
totalité	t ɔ t a l i t e
toucher	t u ʃ e
touché	t u ʃ e
toujours	t u ʒ u ʁ
toulouse	t u l u z
tour	t u ʁ
tourbe	t u ʁ b
touristique	t u ʁ i s t i k
tournesol	t u ʁ n ə s ɔ l
tournure	t u ʁ n y ʁ
tours	t u ʁ
tout	t u
toutefois	t u t ə f w a
traduire	t ʁ a d ɥ i ʁ
trafic	t ʁ a f i k
tragédie	t ʁ a ʒ e d i
train	t ʁ ɛ̃
trainant	t ʁ e n ɑ̃
traite	t ʁ ɛ t
traitement	t ʁ ɛ t m ɑ̃
traiter	t ʁ ɛ t e
trajet	t ʁ a ʒ ɛ
trame	t ʁ a m
tranche	t ʁ ɑ̃ ʃ
trancher	t ʁ ɑ̃ ʃ e
tranquille	t ʁ ɑ̃ k i l
transcender	t ʁ ɑ̃ s ɑ̃ d e
transfert	t ʁ ɑ̃ s f ɛ ʁ
transformation	t ʁ ɑ̃ s f ɔ ʁ m a s j ɔ̃
transformer	t ʁ ɑ̃ s f ɔ ʁ m e
transmettre	t ʁ ɑ̃ s m ɛ t ʁ
transparence	t ʁ ɑ̃ s p a ʁ ɑ̃ s
transparent	t ʁ ɑ̃ s p a ʁ ɑ̃
transport	t ʁ ɑ̃ s p ɔ ʁ
traque	t ʁ a k
traquer	t ʁ a k e
travail	t ʁ a v a j
travailler	t ʁ a v a j e
travailliste	t ʁ a v a j i s t
travers	t ʁ a v ɛ ʁ
tremblay	t ʁ ɑ̃ b l ɛ
trentaine	t ʁ ɑ̃ t ɛ n
trente	t ʁ ɑ̃ t
triangle	t ʁ i j ɑ̃ ɡ l
tribu	t ʁ i b y
tribunal	t ʁ i b y n a l
tribunaux	t ʁ i b y n o
tribune	t ʁ i b y n
tricolore	t ʁ i k ɔ l ɔ ʁ
trimaran	t ʁ i m a ʁ ɑ̃
trio	t ʁ i j o
triple	t ʁ i p l
trois	t ʁ w ɑ
trompe	t ʁ ɔ̃ p
tronçon	t ʁ ɔ̃ s ɔ̃
trot	t ʁ o
trotter	t ʁ ɔ t e
trottoir	t ʁ ɔ t w a ʁ
troupe	t ʁ u p
trouver	t ʁ u v e
trucs	t ʁ y k
très	t ʁ ɛ
trésor	t ʁ e z ɔ ʁ
trésorerie	t ʁ e z ɔ ʁ ə ʁ i
trésorier	t ʁ e z ɔ ʁ j e
trône	t ʁ o n
tu	t y
turc	t y ʁ k
turin	t y ʁ ɛ̃
turquie	t y ʁ k i
tva	t e v e a
tvq	t e v e k y
twitter	t w i t e
type	t i p
tzigane	t s i ɡ a n
tâche	t ɑ ʃ
téhéran	t e e ʁ ɑ̃
télé	t e l e
téléchargement	t e l e ʃ a ʁ ʒ ə m ɑ̃
télégramme	t e l e ɡ ʁ a m
téléphone	t e l e f ɔ n
téléphonique	t e l e f ɔ n i k
téléviseur	t e l e v i z œ ʁ
témoignage	t e m w a ɲ a ʒ
témoigner	t e m w a ɲ e
témoin	t e m w ɛ̃
tête	t ɛ t
tôt	t o
ukraine	y k ʁ ɛ n
ukrainien	y k ʁ ɛ n j ɛ̃
unité	y n i t e
universelle	y n i v ɛ ʁ s ɛ l
université	y n i v ɛ ʁ s i t e
universités	y n i v ɛ ʁ s i t e
untel	œ̃ t ɛ l
urgence	y ʁ ʒ ɑ̃ s
urgent	y ʁ ʒ ɑ̃
urnes	y ʁ n
urticaire	y ʁ t i k ɛ ʁ
uruguay	y ʁ y ɡ w e
us	y s
usa	y z a
usage	y z a ʒ
user	y z e
utiliser	y t i l i z e
utilisé	y t i l i z e
va	v a
vache	v a ʃ
vaillantes	v a j ɑ̃ t
vaincre	v ɛ̃ k ʁ
vainqueur	v ɛ̃ k œ ʁ
vais	v ɛ
valence	v a l ɑ̃ s
valeurs	v a l œ ʁ
valoir	v a l w a ʁ
vannes	v a n
vanté	v ɑ̃ t e
var	v a ʁ
variante	v a ʁ j ɑ̃ t
varsovie	v a ʁ s ɔ v i
vaut	v o
vedette	v ə d ɛ t
veille	v ɛ j
venais	v ə n ɛ
venait	v ə n ɛ
venant	v ə n ɑ̃
vendre	v ɑ̃ d ʁ
vendredi	v ɑ̃ d ʁ ə d i
vendée	v ɑ̃ d e
venir	v ə n i ʁ
vente	v ɑ̃ t
venu	v ə n y
venue	v ə n y
verbe	v ɛ ʁ b
verra	v ɛ ʁ a
verre	v ɛ ʁ
versant	v ɛ ʁ s ɑ̃
versement	v ɛ ʁ s ə m ɑ̃
verser	v ɛ ʁ s e
version	v ɛ ʁ s j ɔ̃
verts	v ɛ ʁ
veuille	v œ j
veut	v ø
veux	v ø
via	v j a
viande	v j ɑ̃ d
vice	v i s
vicieux	v i s j ø
victoire	v i k t w a ʁ
victoria	v i k t ɔ ʁ j a
vidéo	v i d e o
vieille	v j ɛ j
viendrait	v j ɛ̃ d ʁ ɛ
vienne	v j ɛ n
viens	v j ɛ̃
vient	v j ɛ̃
vies	v i
vietnam	v j ɛ t n a m
vieux	v j ø
vif	v i f
vigilance	v i ʒ i l ɑ̃ s
vignerons	v i ɲ ʁ ɔ̃
vigueur	v i ɡ œ ʁ
villa	v i l a
village	v i l a ʒ
villette	v i l ɛ t
vinaigre	v i n ɛ ɡ ʁ
vincent	v ɛ̃ s ɑ̃
vingtaine	v ɛ̃ t ɛ n
violence	v j ɔ l ɑ̃ s
virer	v i ʁ e
virginie	v i ʁ ʒ i n i
virgule	v i ʁ ɡ y l
virtuel	v i ʁ t ɥ ɛ l
virus	v i ʁ y s
visage	v i z a ʒ
visible	v i z i b l
vision	v i z j ɔ̃
vison	v i z ɔ̃
vit	v i
vite	v i t
vitesse	v i t ɛ s
vitre	v i t ʁ
vivant	v i v ɑ̃
vives	v i v
viviane	v i v j a n
vivre	v i v ʁ
vocabulaire	v ɔ k a b y l ɛ ʁ
voici	v w a s i
voilier	v w a l j e
voir	v w a ʁ
voisin	v w a z ɛ̃
voisinage	v w a z i n a ʒ
voiture	v w a t y ʁ
voitures	v w a t y ʁ
volaille	v ɔ l a j
volcaniques	v ɔ l k a n i k
volet	v ɔ l ɛ
volontaire	v ɔ l ɔ̃ t ɛ ʁ
volonté	v ɔ l ɔ̃ t e
volume	v ɔ l y m
volupté	v ɔ l y p t e
vont	v ɔ̃
vos	v o
votants	v ɔ t ɑ̃
votation	v ɔ t a s j ɔ̃
vote	v ɔ t
voter	v ɔ t e
votre	v ɔ t ʁ
voté	v ɔ t e
votées	v ɔ t e
vouloir	v u l w a ʁ
vous	v u
voyagiste	v w a j a ʒ i s t
vrai	v ʁ ɛ
vu	v y
vue	v y
vécu	v e k y
véhicule	v e i k y l
vélo	v e l o
véritable	v e ʁ i t a b l
véritablement	v e ʁ i t a b l ə m ɑ̃
vérité	v e ʁ i t e
vêtements	v ɛ t m ɑ̃
vêtu	v e t y
vôtre	v o t ʁ
washington	w a ʃ i ŋ t ɔ n
water	w a t ɛ ʁ
web	w ɛ b
weber	v e b ɛ ʁ
wilaya	w i l a j a
williams	w i l j a m z
wilson	w i l s ɔ̃
wolof	w ɔ l ɔ f
xavier	ɡ z a v j e
yacht	j ɔ t
yann	j a n
yannick	j a n i k
yen	j ɛ n
yves	i v
zone	z o n
zones	z o n
zoom	z u m
âge	ɑ ʒ
ça	s a
écart	e k a ʁ
écarter	e k a ʁ t e
échapper	e ʃ a p e
échecs	e ʃ ɛ k
échelonnera	e ʃ l ɔ n ʁ a
écologique	e k ɔ l ɔ ʒ i k
écologiste	e k ɔ l ɔ ʒ i s t
économie	e k ɔ n ɔ m i
économiste	e k ɔ n ɔ m i s t
écopé	e k ɔ p e
écouler	e k u l e
écouter	e k u t e
écran	e k ʁ ɑ̃
écraser	e k ʁ a z e
écueil	e k œ j
écurie	e k y ʁ i
éditeur	e d i t œ ʁ
édition	e d i s j ɔ̃
égale	e ɡ a l
également	e ɡ a l m ɑ̃
égales	e ɡ a l
égalisation	e ɡ a l i z a s j ɔ̃
égyptien	e ʒ i p s j ɛ̃
élargissions	e l a ʁ ʒ i s j ɔ̃
élection	e l ɛ k s j ɔ̃
électorale	e l ɛ k t ɔ ʁ a l
électoraux	e l ɛ k t ɔ ʁ o
électricité	e l ɛ k t ʁ i s i t e
électrique	e l ɛ k t ʁ i k
élevé	e l v e
élisabeth	e l i z a b ɛ t
éloigner	e l w a ɲ e
élus	e l y
élève	e l ɛ v
éminemment	e m i n a m ɑ̃
émission	e m i s j ɔ̃
émotion	e m o s j ɔ̃
ému	e m y
émues	e m y
énergie	e n ɛ ʁ ʒ i
énergisai	e n ɛ ʁ ʒ i z e
énorme	e n ɔ ʁ m
énormes	e n ɔ ʁ m
épisode	e p i z ɔ d
époque	e p ɔ k
épouse	e p u z
épreuve	e p ʁ œ v
équilibre	e k i l i b ʁ
équipier	e k i p j e
équitable	e k i t a b l
équivalent	e k i v a l ɑ̃
érable	e ʁ a b l
éric	e ʁ i k
ériger	e ʁ i ʒ e
érudit	e ʁ y d i
établi	e t a b l i
établir	e t a b l i ʁ
établissement	e t a b l i s m ɑ̃
étage	e t a ʒ
étaient	e t ɛ
était	e t ɛ
état	e t a
éteindre	e t ɛ̃ d ʁ
éteint	e t ɛ̃
étendu	e t ɑ̃ d y
étendue	e t ɑ̃ d y
éthique	e t i k
étincelamment	e t ɛ̃ s l a m ɑ̃
étoiles	e t w a l
étonnant	e t ɔ n ɑ̃
étrangement	e t ʁ ɑ̃ ʒ m ɑ̃
étude	e t y d
études	e t y d
étudiant	e t y d j ɑ̃
étudiante	e t y d j ɑ̃ t
étudier	e t y d j e
évaluer	e v a l ɥ e
évanouir	e v a n w i ʁ
évasion	e v a z j ɔ̃
éventuellement	e v ɑ̃ t ɥ ɛ l m ɑ̃
évidemment	e v i d a m ɑ̃
éviter	e v i t e
évolution	e v ɔ l y s j ɔ̃
évoquer	e v ɔ k e
événement	e v ɛ n m ɑ̃
êtes	ɛ t
êtres	ɛ t ʁ
île	i l
îles	i l
