άγγιξα	a ŋ ɟ i k s a
άγια	a ʝ i a
άγιε	a ʝ i e
άγιες	a ʝ i e s
άγιο	a ʝ i o
άγιοι	a ʝ i i
άγιος	a ʝ i o s
άγκιστρο	a ŋ ɟ i s t r o
άγραφος	a ɣ r a f o s
άδικη	a ð i c i
άι	a i
άκακος	a k a k o s
άκουα	a k u a
άκουγα	a k u ɣ a
άκουσα	a k u s a
άκουσες	a k u s e s
άλγεβρα	a l ʝ e v ɾ a
άλγος	a l ɣ o s
άλειψα	a l i p s a
άλλοθι	a l o θ i
άμαθος	a m a θ o s
άμε	a m e
άμυαλος	a m ɲ a l o s
άνδρο	a n ð ɾ o
άνδρος	a n ð ɾ o s
άνδρου	a n ð ɾ u
άνθιμος	a n θ i m o s
άνθρωπος	a n θ ɾ o p o s
άνοιξη	a n i k s i
άντε	a d e
άπειρων	a p i r o n
άραγε	a ɾ a ʝ e
άραχλος	a ɾ a x l o s
άργος	a ɾ ɣ o s
άρκτος	a ɾ k t o s
άρμα	a ɾ m a
άρον	a r o n
άρτος	a r t o s
άρχοντας	a ɾ x ɔ n d a s
άσεβης	a s e v i s
άσεβου	a s e v u
άσεβους	a s e v u s
άστραψα	a s t ɾ a p s a
έβαλα	e v a l a
έβαλε	e v a l e
έβαλες	e v a l e s
έβαλλα	e v a l a
έβαψα	e v a p s a
έβενος	e v e n o s
έβλαψα	e v l a p s a
έγγραφο	e ŋ ɣ r a f o
έγινα	e ʝ i n a
έγκυος	ɛ ŋ ɟ i ɔ s
έγνοια	e ɣ ɲ a
έδεσσα	e ð e s a
έδιωξα	e ð ʝ o k s a
έδρα	e ð ɾ a
έδυσα	e ð i s a
έζησαν	e z i s a n
έκλεισα	e k l i s a
έκλειψη	e k l i p s i
έκπληξη	ɛ k p l i k s i
έκρηξη	ɛ k ɾ i k s i
έκρινα	e k ɾ i n a
έκταση	e k t a s i
έκτοπος	e k t o p o s
έκτος	e k t o s
έλκος	e l k o s
έλκουμε	e l k u m e
έλληνα	e l i n a
έλουσα	e l u s a
έναντι	e n a n d i
ένατος	e n a t o s
ένδεκα	e n ð e k a
ένζυμο	e n z i m o
ένρινοι	e n r i n i
έντεκα	e n d e k a
έντερο	e n d e ɾ o
έντρομοι	e n d ɾ o m i
έντρομος	e n d ɾ o m o s
έξι	e k s i
έξοδος	ɛ k s ɔ ð ɔ s
έπαιξα	e p e k s a
έπαυσα	e p a f s a
έπεισα	e p i s a
έπλευσα	e p l e f s a
έπρεπε	e p ɾ e p e
έραψα	e ɾ a p s a
έριδα	e r i ð a
έριδες	e r i ð e s
έρρινη	e r i n i
έρρινης	e r i n i s
έρρινων	e r i n o n
έρχομαι	e ɾ x o m e
έσεισα	e s i s a
έστρεψα	e s t ɾ e p s a
έσυρα	e s i r a
έτοιμος	e t i m o s
έτος	ɛ t o s
έτρεμα	e t r e m a
έφερα	e f e ɾ a
έφηβη	ɛ f i v i
έφθασα	e f θ a s a
έφραξα	e f r a k s a
έφτασα	e f t a s a
έφτιαξα	e f t ç a k s a
έχασα	e x a s a
έχαψα	e x a p s a
έχε	e ç e
έχει	e ç i
έχεις	e ç i s
έχετε	e ç e t e
έχομε	e x o m e
έχοντας	e x o n d a s
έχουμε	e x u m e
έχουν	e x u n
έχουνε	e x u n e
έχω	e x o
έψαξα	e p s a k s a
έως	e o s
ήβη	i v i
ήδη	i ð i
ήμασταν	i m a s t a n
ήμεθα	i m e θ a
ήμουν	i m u n
ήντα	i n d a
ήσαν	i s a n
ήσασταν	i s a s t a n
ήσαστε	i s a s t e
ήσουν	i s u n
ήσουνα	i s u n a
ήτα	i t a
ήταν	i t a n
ήττα	i t a
ίδρυμα	i ð r i m a
ίδρυσα	i ð r i s a
ίντα	i n d a
ίντσα	i n t͡s a
ίπταμαι	i p t a m e
αέρισα	a e ɾ i s a
αήθης	a i θ i s
αίαντας	e a n d a s
αίγινα	e ʝ i n a
αίγιο	e ʝ i o
αίθουσα	ɛ θ u s a
αίμα	ɛː m a
αίσθημα	ɛ s θ i m a
αίσθηση	ɛ s θ i s i
αίσχος	e s x o s
αίτηση	ɛ t i s i
αίτνα	e t n a
αβάνα	a v a n a
αβέβαιος	a v ɛ v ɛ ɔ s
αβλαβής	a v l a v i s
αβουλία	a v u l i a
αγάμητος	a ɣ a m i t o s
αγέλη	a ʝ ɛ l i
αγένεια	a ʝ e n i a
αγία	a ʝ i a
αγίας	a ʝ i a s
αγίου	a ʝ i u
αγίους	a ʝ i u s
αγίων	a ʝ i o n
αγαθοπιστία	a ɣ a θ o p i s t i a
αγαθοπιστίας	a ɣ a θ o p i s t i a s
αγανακτισμένη	a ɣ a n a k t i z m e n i
αγανακτισμένης	a ɣ a n a k t i z m e n i s
αγανακτισμένο	a ɣ a n a k t i z m e n o
αγανακτισμένοι	a ɣ a n a k t i z m e n i
αγανακτισμένος	a ɣ a n a k t i z m e n o s
αγανακτισμένου	a ɣ a n a k t i z m e n u
αγανακτισμένους	a ɣ a n a k t i z m e n u s
αγανακτισμένων	a ɣ a n a k t i z m e n o n
αγαντάριζα	a ɣ a n d a r i z a
αγαπάω	a ɣ a p a ɔ
αγαπημένα	a ɣ a p i m e n a
αγαπημένες	a ɣ a p i m e n e s
αγαπημένη	a ɣ a p i m e n i
αγαπημένης	a ɣ a p i m e n i s
αγαπημένοι	a ɣ a p i m e n i
αγαπημένος	a ɣ a p i m e n o s
αγαπημένου	a ɣ a p i m e n u
αγαπημένους	a ɣ a p i m e n u s
αγαπημένων	a ɣ a p i m e n o n
αγγίζουμε	a ŋ ɟ i z u m e
αγγίζω	a ŋ ɟ i z o
αγγαρεύτηκα	a ŋ ɡ a ɾ e f t i k a
αγγελούδι	a ŋ ɟ e l u ð i
αγγελούδια	a ŋ ɟ e l u ð ʝ a
αγγιγμένο	a ŋ ɟ i ɣ m e n o
αγγισμένης	a ŋ ɟ i z m e n i s
αγγισμένο	a ŋ ɟ i z m e n o
αγγλία	a ŋ ɡ l i a
αγγουριά	a ŋ ɡ u ɾ ʝ a
αγγουριού	a ŋ ɡ u ɾ ʝ u
αγενής	a ʝ e n i s
αγιάγκαθο	a ʝ a ŋ ɡ a θ o
αγιασματάριο	a ʝ a z m a t a r i o
αγιατολάχ	a ʝ a t o l a x
αγιοκέρι	a ʝ o c e r i
αγιοποιημένες	a ʝ i o p i i m e n e s
αγιοποιημένη	a ʝ i o p i i m e n i
αγιοποιημένοι	a ʝ i o p i i m e n i
αγκίστρι	a ŋ ɟ i s t r i
αγλάισμα	a ɣ l a i z m a
αγνάντευε	a ɣ n a n d e v e
αγνάντεψε	a ɣ n a n d e p s e
αγναντεύω	a ɣ n a n d e v o
αγνοούμενος	a ɣ n o u m e n o s
αγονία	a ɣ o n i a
αγορά	a ɣ o r a
αγοράζω	a ɣ o ɾ a z o
αγοράς	a ɣ o r a s
αγορές	a ɣ o r e s
αγορών	a ɣ o r o n
αγρίνιο	a ɣ r i n i o
αγριεύω	a ɣ ɾ i e v o
αγρόκτημα	a ɣ ɾ o k t i m a
αγυιόπαιδα	a ʝ i o p e ð a
αγχώνομαι	a ŋ x o n o m e
αγωνία	a ɣ o n i a
αγωνίζομαι	a ɣ o n i z o m e
αγωνιζόμενος	a ɣ o n i z o m e n o s
αγωνιστές	a ɣ o n i s t e s
αγωνιστή	a ɣ o n i s t i
αγωνιστών	a ɣ o n i s t o n
αγόρασα	a ɣ o ɾ a s a
αδίκησα	a ð i c i s a
αδειάζω	a ð ʝ a z o
αδελφοκτονία	a ð e l f o k t o n i a
αδελφός	a ð ɛ l f ɔ s
αδιευκρίνιστος	a ð i e f k ɾ i n i s t o s
αδικούμαι	a ð i k u m e
αδικούμε	a ð i k u m e
αδικώ	a ð i k o
αδρεναλίνη	a ð ɾ e n a l i n i
αεροδρόμιο	a e ɾ o ð ɾ o m i o
αεροφωτογραφίσεις	a e r o f o t o ɣ r a f i s i s
αερόσακος	a ɛ ɾ ɔ s a k ɔ s
αηδής	a i ð i s
αηδία	a i ð i a
αθήνα	a θ i n a
αθίγγανος	a θ i ŋ ɡ a n o s
αθεϊσμέ	a θ e i z m e
αθεϊσμού	a θ e i z m u
αθεϊσμό	a θ e i z m o
αθεϊσμός	a θ e i z m o s
αθηνά	a θ i n a
αιγίνης	e ʝ i n i s
αιγόκερος	e ɣ o c e ɾ o s
αιγόκερως	e ɣ o c e ɾ o s
αιματοβαμμένα	e m a t o v a m e n a
αιματοβαμμένες	e m a t o v a m e n e s
αιματοβαμμένη	e m a t o v a m e n i
αιματοβαμμένο	e m a t o v a m e n o
αιματοβαμμένος	e m a t o v a m e n o s
αιμομιξία	e m o m i k s i a
αισθάνομαι	e s θ a n o m e
αισχροκέρδεια	e s x r o c e r ð i a
αιτία	ɛ t i a
ακάματος	a k a m a t o s
ακίνδυνος	a c i n ð i n o s
ακαδημία	a k a ð i m i a
ακατάδεχτος	a k a t a ð e x t o s
ακατάσβεστος	a k a t a z v e s t o s
ακαταδεξιά	a k a t a ð e k s ç a
ακεφιά	a c e f ç a
ακολασία	a k ɔ l a s i a
ακονίζομαι	a k o n i z o m e
ακοσμία	a k o z m i a
ακουστικός	a k u s t i k o s
ακοόγραμμα	a k o o ɣ r a m a
ακούγομαι	a k u ɣ o m e
ακούγοντας	a k u ɣ o n d a s
ακούσθηκε	a k u s θ i k e
ακούστηκα	a k u s t i k a
ακούστηκε	a k u s t i k e
ακρίτας	a k r i t a s
ακρεοφαγία	a k ɾ e o f a ʝ i a
ακροαματικότητα	a k ɾ o a m a t i k o t i t a
ακροατής	a k ɾ o a t i s
ακροβάτης	a k r o v a t i s
ακροβασία	a k r o v a s i a
ακτινογραφία	a k t i n o ɣ ɾ a f i a
ακτινοσκόπηση	a k t i n o s k o p i s i
ακυρώνω	a c i ɾ o n o
ακυρώσεις	a c i ɾ o s i s
ακυρώσεων	a c i ɾ o s e o n
ακυρώσεως	a c i ɾ o s e o s
ακύρωσης	a c i ɾ o s i s
αλάνα	a l a n a
αλάσκα	a l a s k a
αλήθεια	a l i θ ç a
αλαμπάμα	a l a b a m a
αλαμπουρνέζικου	a l a b u r n e z i k u
αλατισμένα	a l a t i z m e n a
αλατισμένης	a l a t i z m e n i s
αλατισμένο	a l a t i z m e n o
αλατισμένος	a l a t i z m e n o s
αλατισμένων	a l a t i z m e n o n
αλαφιασμένα	a l a f ç a z m e n a
αλαφιασμένοι	a l a f ç a z m e n i
αλαφιασμένος	a l a f ç a z m e n o s
αλείφουμε	a l i f u m e
αλείφτηκα	a l i f t i k a
αλεξάνδρεια	a l e k s a n ð ɾ i a
αλεξανδρούπολη	a l e k s a n ð ɾ u p o l i
αλευρωμένα	a l e v r o m e n a
αλευρωμένες	a l e v r o m e n e s
αλευρωμένη	a l e v r o m e n i
αλευρωμένους	a l e v r o m e n u s
αληθές	a l i θ e s
αληθή	a l i θ i
αληθείς	a l i θ i s
αληθώς	a l i θ o s
αλητεύω	a l i t e v o
αλιεύτηκα	a l i e f t i k a
αλλάχ	a l a x
αλλαξιέρα	a l a k s ç e ɾ a
αλληλεπίδραση	a l l i l e p i ð ɾ a s i
αλληλοσυγκρούστηκα	a l i l o s i ŋ ɡ r u s t i k a
αλλοιώθηκα	a l i o θ i k a
αλλοιώσεις	a l i o s i s
αλλοιώσεων	a l i o s e o n
αλλού	a l u
αλμυρός	a l m i r o s
αλογόμυγα	a l o ɣ o m i ɣ a
αλυσίδα	a l i s i ð a
αλυσοδεμένα	a l i s o ð e m e n a
αλυσοδεμένη	a l i s o ð e m e n i
αλυσοδεμένης	a l i s o ð e m e n i s
αλυσοδεμένο	a l i s o ð e m e n o
αλυσοδεμένοι	a l i s o ð e m e n i
αλφαδιάστηκα	a l f a ð ʝ a s t i k a
αλώνι	a l o n i
αμ	a m
αμήν	a m i n
αμαλιάδα	a m a ʎ a d a
αμβούργο	a ɱ v u r ɣ o
αμείβομαι	a m i v o m e
αμειψισπορά	a m i p s i s p o ɾ a
αμνηστεύω	a m n i s t e v o
αμοιβαιότητα	a m i v e o t i t a
αμοργέ	a m o ɾ ʝ e
αμοργός	a m o ɾ ɣ o s
αμπέλι	a m b e l i
αμπελοχώραφα	a m b e l o x o ɾ a f a
αμφιβολία	a m f i v o l i a
αμφιθέατρο	a m f i θ e a t ɾ o
αμφιλεγόμενα	a ɱ f i l e ɣ o m e n a
αμφιλεγόμενες	a ɱ f i l e ɣ o m e n e s
αμφιλεγόμενη	a ɱ f i l e ɣ o m e n i
αμφιλεγόμενο	a ɱ f i l e ɣ o m e n o
αμφιλεγόμενοι	a ɱ f i l e ɣ o m e n i
αμφιλεγόμενος	a ɱ f i l e ɣ o m e n o s
αμφιλεγόμενους	a ɱ f i l e ɣ o m e n u s
ανάδοχος	a n a ð o x o s
ανάθεμα	a n a θ e m a
ανάκρουση	a n a k ɾ u s i
ανάλυση	a n a l i s i
ανάπαψα	a n a p a p s a
ανάπλι	a n a p l i
ανάποδα	a n a p o ð a
ανάποδος	a n a p o ð o s
ανάργυρος	a n a ɾ ʝ i ɾ o s
ανάφερα	a n a f e ɾ a
ανέξοδος	a n e k s o ð o s
ανέπαφος	a n e p a f o s
ανέπνευσα	a n e p n e f s a
ανέρχομαι	a n e r x o m e
ανέφερα	a n e f e ɾ a
ανέχομαι	a n e x o m e
ανέχτηκα	a n e x t i k a
αναβάλλω	a n a v a l o
αναβαθμολογήσεις	a n a v a θ m o l o ʝ i s i s
αναβαλλόμενη	a n a v a l o m e n i
αναβαλλόμενης	a n a v a l o m e n i s
αναβαλλόμενος	a n a v a l o m e n o s
αναβαλλόμενου	a n a v a l o m e n u
αναγκάζομαι	a n a ŋ ɡ a z o m e
αναγκάζομε	a n a ŋ ɡ a z o m e
αναγκάζω	a n a ŋ ɡ a z o
αναγκάσθηκα	a n a ŋ ɡ a s θ i k a
αναγκάστηκα	a n a ŋ ɡ a s t i k a
αναγνωρισμένα	a n a ɣ n o r i z m e n a
αναγνωρισμένες	a n a ɣ n o r i z m e n e s
αναγνωρισμένη	a n a ɣ n o r i z m e n i
αναγνωρισμένης	a n a ɣ n o r i z m e n i s
αναγνωρισμένο	a n a ɣ n o r i z m e n o
αναγνωρισμένοι	a n a ɣ n o r i z m e n i
αναγνωρισμένους	a n a ɣ n o r i z m e n u s
αναγνωσιμότητα	a n a ɣ n o s i m o t i t a
αναγνώστης	a n a ɣ n o s t i s
αναγνώστρια	a n a ɣ n o s t ɾ i a
αναγράφουμε	a n a ɣ r a f u m e
αναδέχθηκα	a n a ð e x θ i k a
αναδεικνύομαι	a n a ð i k n i o m e
αναδεικνύω	a n a ð i k n i o
αναζωογονώ	a n a z o o ɣ o n o
αναζωογόνηση	a n a z o o ɣ o n i s i
αναθεματισμένα	a n a θ e m a t i z m e n a
αναθεματισμένης	a n a θ e m a t i z m e n i s
αναθεματισμένοι	a n a θ e m a t i z m e n i
ανακάλυψα	a n a k a l i p s a
ανακάλυψη	a n a k a l i p s i
ανακάτεψα	a n a k a t e p s a
ανακάτωσα	a n a k a t o s a
ανακαλύπτομε	a n a k a l i p t o m e
ανακαλύπτω	a n a k a l i p t o
ανακαλύψεις	a n a k a l i p s i s
ανακαλώ	a n a k a l o
ανακατεύω	a n a k a t e v o
ανακοινώνω	a n a c i n o n o
ανακρούομε	a n a k r u o m e
ανακρούουμε	a n a k r u u m e
αναλογία	a n a l o ʝ i a
αναλογίζομαι	a n a l o ʝ i z o m e
αναλογίστηκα	a n a l o ʝ i s t i k a
αναλυτής	a n a l i t i s
αναλυτικά	a n a l i t i k a
αναλύω	a n a l i o
αναλώ	a n a l o
αναμένει	a n a m e n i
αναμένεις	a n a m e n i s
αναμαλλιασμένα	a n a m a ʎ a z m e n a
αναμαλλιασμένε	a n a m a ʎ a z m e n e
αναμαλλιασμένο	a n a m a ʎ a z m e n o
αναμαλλιασμένοι	a n a m a ʎ a z m e n i
αναμειγνύω	a n a m i ɣ n i o
αναμμένα	a n a m e n a
αναμμένες	a n a m e n e s
αναμμένη	a n a m e n i
αναμμένο	a n a m e n o
αναμμένους	a n a m e n u s
ανανά	a n a n a
ανανάδες	a n a n a ð e s
ανανάς	a n a n a s
αναπαύομαι	a n a p a v o m e
αναπαύσεις	a n a p a f s i s
αναπαύω	a n a p a v o
αναπλειστηριασμός	a n a p l i s t i r i a z m o s
αναπνέω	a n a p n e o
αναπνοή	a n a p n o i
αναπόφευκτος	a n a p o f e f k t o s
αναρμοδιότητα	a n a ɾ m o ð i o t i t a
αναρμόδια	a n a ɾ m o ð i a
αναρμόδιος	a n a ɾ m o ð i o s
ανασκάπτουμε	a n a s k a p t u m e
ανασκάπτω	a n a s k a p t o
ανασκαφείς	a n a s k a f i s
αναστέναξα	a n a s t e n a k s a
αναστατώνω	a n a s t a t o n o
αναστατώσεις	a n a s t a t o s i s
αναστεναγμός	a n a s t e n a ɣ m o s
αναστηλώσεις	a n a s t i l o s i s
αναστρέφομε	a n a s t ɾ e f o m e
αναστρέψιμος	a n a s t ɾ e p s i m o s
αναστροφή	a n a s t ɾ o f i
αναστυλώνομαι	a n a s t i l o n o m e
ανασυνιστώ	a n a s i n i s t o
ανατινάχτηκα	a n a t i n a x t i k a
ανατράπηκε	a n a t ɾ a p i c e
ανατρέπουμε	a n a t ɾ e p u m e
αναφέρθηκα	a n a f e ɾ θ i k a
αναφέρομαι	a n a f e ɾ o m e
αναφέρομε	a n a f e ɾ o m e
αναφέρουμε	a n a f e ɾ u m e
αναφέρω	a n a f e ɾ o
αναφιώτικα	a n a f ç o t i k a
αναφορά	a n a f o ɾ a
αναφτερώνομαι	a n a f t e ɾ o n o m e
αναφύομαι	a n a f i o m e
ανγκουίλα	a ŋ ɡ u i l a
ανδρώνομαι	a n ð ɾ o n o m e
ανεβάζω	a n e v a z o
ανεβαίνω	a n e v e n o
ανεβοκατεβαίνω	a n e v o k a t e v e n o
ανεκαλύφθην	a n e k a l i f θ i n
ανεκτίμητος	a n e k t i m i t o s
ανελκυστήρας	a n e l c i s t i ɾ a s
ανενταφίαστος	a n e n d a f i a s t o s
ανεπάρκεια	a n e p a ɾ c i a
ανεπαίσθητα	a n e p e s θ i t a
ανεπαρκής	a n e p a ɾ c i s
ανεπαρκώς	a n e p a ɾ k o s
ανεπηρέαστος	a n e p i ɾ e a s t o s
ανεπιθύμητος	a n e p i θ i m i t o s
ανετράπη	a n e t ɾ a p i
ανευρέθηκα	a n e v ɾ e θ i k a
ανεφοδιάζω	a n e f o ð i a z o
ανησυχία	a n i s i ç i a
ανθέλληνας	a n θ e l i n a s
ανθεστήρια	a n θ e s t i ɾ i a
ανθεστηρίων	a n θ e s t i ɾ i o n
ανθρωπεύομαι	a n θ ɾ o p e v o m e
ανθρωπεύτηκα	a n θ ɾ o p e f t i k a
ανθρώπεψε	a n θ ɾ o p e p s e
ανιδρύουμε	a n i ð r i u m e
ανοίγω	a n i ɣ o
ανοησία	a n o i s i a
ανορθόδοξος	a n o ɾ θ o ð o k s o s
αντάμωσα	a n d a m o s a
αντάμωση	a n d a m o s i
αντέχω	a n d e x o
αντίγκουα	a n t i ɡ w a
αντίδραση	a n d i ð ɾ a s i
αντίνοος	a n d i n o o s
αντίο	a d i o
αντίπαρος	a n d i p a ɾ o s
ανταμοιβή	a n d a m i v i
ανταμώνω	a n d a m o n o
ανταμώσεις	a n d a m o s i s
ανταποκρίνομαι	a n d a p o k ɾ i n o m e
αντιγράφεις	a n d i ɣ r a f i s
αντιγράφηκα	a n d i ɣ r a f i k a
αντιγράφω	a n d i ɣ r a f o
αντιδάνειο	a n d i ð a n i o
αντικλεπτικές	a n d i k l e p t i c e s
αντικλεπτική	a n d i k l e p t i c i
αντικλεπτικών	a n d i k l e p t i k o n
αντιμετωπίζω	a n d i m e t o p i z o
αντιμετώπισα	a n d i m e t o p i s a
αντιπαραβάλλω	a n d i p a ɾ a v a l o
αντιπροσωπεύω	a n d i p ɾ o s o p e v o
αντιστέκομαι	a n d i s t e k o m e
ανώριμος	a n o ɾ i m o s
αξέχαστος	a k s e x a s t o s
αξίζει	a k s i z i
αξίζω	a k s i z o
αξιαγάπητος	a k s i a ɣ a p i t o s
αξιοζήλευτος	a k s i o z i l e f t o s
αξιοθρήνητος	a k s i o θ ɾ i n i t o s
αξιολύπητος	a k s i o l i p i t o s
αξιοσημείωτα	a k s i o s i m i o t a
αξιοσημείωτες	a k s i o s i m i o t e s
αξιοσημείωτη	a k s i o s i m i o t i
αξιοσημείωτης	a k s i o s i m i o t i s
αξιοσημείωτο	a k s i o s i m i o t o
αξιοσημείωτος	a k s i o s i m i o t o s
αξιοσημείωτου	a k s i o s i m i o t u
αξιοσημείωτων	a k s i o s i m i o t o n
αξιόπιστος	a k s i o p i s t o s
αορτή	a ɔ ɾ t i
απ	a p
απέβαλα	a p e v a l a
απέβαλλα	a p e v a l a
απέδειξα	a p e ð i k s a
απέδειξε	a p e ð i k s e
απέκλεισα	a p e k l i s a
απέλυσα	a p e l i s a
απέχθεια	a p e x θ i a
απαγορεύσεις	a p a ɣ o ɾ e f s i s
απαγορεύω	a p a ɣ o r e v o
απαγόρευση	a p a ɣ o r e f s i
απαθής	a p a θ i s
απαλείφομε	a p a l i f o m e
απαλλαγή	a p a l a ʝ i
απαραίτητος	a p a r e t i t o s
απαραδέκτως	a p a ɾ a ð e k t o s
απαρχαιωμένα	a p a r ç e o m e n a
απαρχαιωμένες	a p a r ç e o m e n e s
απαρχαιωμένη	a p a r ç e o m e n i
απαρχαιωμένο	a p a r ç e o m e n o
απαρχαιωμένοι	a p a r ç e o m e n i
απαρχαιωμένους	a p a r ç e o m e n u s
απαρχαιωμένων	a p a r ç e o m e n o n
απασχολήσεις	a p a s x o l i s i s
απασχολημένα	a p a s x o l i m e n a
απασχολημένη	a p a s x o l i m e n i
απασχολημένης	a p a s x o l i m e n i s
απασχολημένο	a p a s x o l i m e n o
απασχολημένος	a p a s x o l i m e n o s
απασχολιέμαι	a p a s x o ʎ e m e
απασχολούμε	a p a s x o l u m e
απασχολώ	a p a s x o l o
απασχόλησα	a p a s x o l i s a
απεδείχθη	a p e ð i x θ i
απεδείχθησαν	a p e ð i x θ i s a n
απελπισμένα	a p e l p i z m e n a
απελπισμένες	a p e l p i z m e n e s
απελπισμένη	a p e l p i z m e n i
απελπισμένο	a p e l p i z m e n o
απελπισμένοι	a p e l p i z m e n i
απελπισμένος	a p e l p i z m e n o s
απελπισμένου	a p e l p i z m e n u
απελπισμένους	a p e l p i z m e n u s
απελπισμένων	a p e l p i z m e n o n
απετράπησαν	a p e t ɾ a p i s a n
απεχθάνομαι	a p e x θ a n o m e
απεύχομαι	a p e f x o m e
αποβάλετε	a p o v a l e t e
αποβάλλεται	a p o v a l e t e
αποβάλλετε	a p o v a l e t e
αποβάλομε	a p o v a l o m e
απογοητεύομαι	a p o ɣ o i t e v o m e
απογοητεύτηκα	a p o ɣ o i t e f t i k a
αποδέχομαι	a p o ð e x o m e
αποδέχτηκα	a p o ð e x t i k a
αποδείξεις	a p o ð i k s i s
αποδείχθηκε	a p o ð i x θ i c e
αποδείχνω	a p o ð i x n o
αποδείχτηκαν	a p o ð i x t i k a n
αποδείχτηκε	a p o ð i x t i c e
αποδεικνύουμε	a p o ð i k n i u m e
αποδεικνύω	a p o ð i k n i o
αποδειχτήκανε	a p o ð i x t i k a n e
αποδεχθεί	a p o ð e x θ i
αποδεχτεί	a p o ð e x t i
αποδοκιμάζουμε	a p o ð o c i m a z u m e
αποζημιώσεις	a p o z i m i o s i s
αποθήκευσα	a p o θ i c e f s a
αποθανών	a p o θ a n o n
αποθηκεύθηκα	a p o θ i c e f θ i k a
αποκέντρωση	a p o c e n d ɾ o s i
αποκαλύπτουμε	a p o k a l i p t u m e
αποκαλύψεις	a p o k a l i p s i s
αποκερματισμέ	a p o c e ɾ m a t i z m e
αποκλείεται	a p o k l i e t e
αποκλείετε	a p o k l i e t e
αποκλείουμε	a p o k l i u m e
αποκλείσθηκε	a p o k l i s θ i c e
αποκλείστηκε	a p o k l i s t i c e
αποκλείω	a p o k l i o
αποκλεισμένα	a p o k l i z m e n a
αποκλεισμένες	a p o k l i z m e n e s
αποκλεισμένη	a p o k l i z m e n i
αποκλεισμένης	a p o k l i z m e n i s
αποκλεισμένοι	a p o k l i z m e n i
αποκλεισμένος	a p o k l i z m e n o s
αποκλεισμένου	a p o k l i z m e n u
αποκλεισμένων	a p o k l i z m e n o n
αποκρίθηκα	a p o k ɾ i θ i k a
αποκρίνομαι	a p o k ɾ i n o m e
αποκρύπτομαι	a p o k ɾ i p t o m e
αποκρύπτω	a p o k ɾ i p t o
αποκρύψεις	a p o k ɾ i p s i s
αποκυήματα	a p o c i i m a t a
αποκόμισα	a p o k o m i s a
αποκύημα	a p o c i i m a
απολίθωμα	a p o l i θ o m a
απολογητικά	a p o l o ʝ i t i k a
απολογητική	a p o l o ʝ i t i c i
απολογητικό	a p o l o ʝ i t i k o
απολογητικός	a p o l o ʝ i t i k o s
απολογούμαι	a p o l o ɣ u m e
απολύθηκα	a p o l i θ i k a
απομονωμένα	a p o m o n o m e n a
απομονωμένες	a p o m o n o m e n e s
απομονωμένη	a p o m o n o m e n i
απομονωμένης	a p o m o n o m e n i s
απομονωμένο	a p o m o n o m e n o
απομονωμένοι	a p o m o n o m e n i
απομονωμένος	a p o m o n o m e n o s
απομονωμένου	a p o m o n o m e n u
απομονωμένους	a p o m o n o m e n u s
απομονωμένων	a p o m o n o m e n o n
απομονώνομαι	a p o m o n o n o
απομονώσεις	a p o m o n o s i s
απορρίπτομαι	a p o ɾ i p t o m e
απορρίπτω	a p o ɾ i p t o
απορρίψεις	a p o ɾ i p s i s
απορώ	a p o ɾ o
αποσείομε	a p o s i o m e
αποστάξεις	a p o s t a k s i s
αποστάσεις	a p o s t a s i s
αποστέλλω	a p o s t e l o
αποστειρώνω	a p o s t i ɾ o n o
αποστολέας	a p o s t o l e a s
αποτράπηκε	a p o t ɾ a p i c e
αποτυχία	a p ɔ t i ç i a
αποφασίζω	a p o f a s i z o
απόβαλλε	a p o v a l e
απόγονος	a p o ɣ o n o s
απόδειξα	a p o ð i k s a
απόδειξε	a p o ð i k s e
απόκριση	a p o k ɾ i s i
απόκρουσα	a p o k r u s a
απόπλου	a p o p l u
απόπλους	a p o p l u s
απόρριμμα	a p o r i m a
απόρριψα	a p o ɾ i p s a
αράδα	a ɾ a ð a
αράζω	a r a z o
αράπης	a ɾ a p i s
αράχνη	a ɾ a x n i
αραχνιασμένα	a ɾ a x ɲ a z m e n a
αραχνιασμένες	a ɾ a x ɲ a z m e n e s
αραχνιασμένη	a ɾ a x ɲ a z m e n i
αργοσάλευε	a ɾ ɣ o s a l e v e
αργύρης	a ɾ ʝ i ɾ i s
αρετές	a r e t e s
αρετή	a r e t i
αρετής	a r e t i s
αρετών	a r e t o n
αριζόνα	a ɾ i z o n a
αριστοκρατία	a ɾ i s t o k ɾ a t i a
αρκτικός	a ɾ k t i k o s
αρκώ	a ɾ k o
αρμοδίως	a ɾ m o ð i o s
αρμοδιότητα	a ɾ m o ð i o t i t a
αρμόδιος	a ɾ m o ð i o s
αρούμπα	a ɾ u b a
αρπάζω	a ɾ p a z o
αρρωστημένο	a r o s t i m e n o
αρρωστημένων	a r o s t i m e n o n
αρχή	a r ç i
αρχίδαμος	a ɾ ç i ð a m o s
αρχίδι	a ɾ ç i ð i
αρχειοθήκη	a r ç i o θ i c i
αρχηγός	a ɾ ç i ɣ ɔ s
αρχικά	a r ç i k a
αρχικός	a r ç i k o s
αρχικώς	a r ç i k o s
αρχιφύλακας	a ɾ ç i f i l a k a s
ασ'	a s
ασέβειας	a s e v i a s
ασέβειες	a s e v i e s
ασεβής	a s e v i s
ασελγείς	a s e l ʝ i s
ασκώ	a s k o
αστέρι	a s t e ɾ i
αστράφτει	a s t ɾ a f t i
αστυνομοκρατία	a s t i n o m o k ɾ a t i a
αστυνόμος	a s t i n o m o s
αστυφύλακας	a s t i f i l a k a s
ατάλαντος	a t a l a n d o s
ατροφία	a t ɾ o f i a
αυγό	a v ɣ o
αυλός	a v l o s
αυτί	a f t i
αυτοκινούμενος	a f t o c i n u m e n o s
αυτοκράτορας	a f t o k r a t o r a s
αυτοκτονία	a f t o k t o n i a
αυτό	a f t o
αυτός	a f t o s
αφήγηση	a f i ʝ i s i
αφηγητής	a f i ʝ i t i s
αφορμή	a f o ɾ m i
αφορούσε	a f o r u s e
αφουγκράζομαι	a f u ɡ ɾ a z o m e
αφουγκράστηκα	a f u ɡ ɾ a s t i k a
αφρική	a f ɾ i c i
αφτί	a f t i
αχάριστος	a x a ɾ i s t o s
αχαιός	a ç e o s
αχθοφόρος	a x θ o f o r o s
αϊ	a i
αϊόβα	a i o v a
αϋπνία	a i p n i a
βάζο	v a z o
βάζοντας	v a z o n d a s
βάζω	v a z o
βάλαμε	v a l a m e
βάλανος	v a l a n o s
βάλε	v a l e
βάλει	v a l i
βάλεις	v a l i s
βάλετε	v a l e t e
βάλλεται	v a l e t e
βάλλουμε	v a l u m e
βάλλω	v a l o
βάλομε	v a l o m e
βάλουμε	v a l u m e
βάλουνε	v a l u n e
βάλω	v a l o
βάρβαρος	v a r v a r o s
βάσανο	v a s a n o
βάσανος	v a s a n o s
βάσω	v a s o
βάφομαι	v a f o m e
βάφω	v a f o
βέβαιος	v ɛ v ɛ ɔ s
βέρα	v e ɾ a
βέροια	v e ɾ i a
βίβλος	v i v l o s
βίκυ	v i c i
βίτσιο	v i t s ç o
βαβυλώνα	v a v i l o n a
βαθιά	v a θ ç a
βαθιάς	v a θ ç a s
βαθιών	v a θ ç o n
βαθμολογημένο	v a θ m o l o ʝ i m e n o
βαθμολογημένος	v a θ m o l o ʝ i m e n o s
βαλς	v a l s
βαν	v a n
βαρελότο	v a ɾ e l o t o
βαριέμαι	v a r ʝ e m e
βαρκελώνη	v a ɾ c e l o n i
βασίλεψε	v a s i l e p s e
βασίλισσα	v a s i l i s a
βασανίστρια	v a s a n i s t ɾ i a
βασανιστήριο	v a s a n i s t i ɾ i o
βασιλέας	v a s i l e a s
βασιλεύς	v a s i l e f s
βασιλεύω	v a s i l e v o
βασιλιάς	v a s i ʎ a s
βασιλική	v a s i l i c i
βαστάζομαι	v a s t a z o m e
βαυαρία	v a v a r i a
βγάζοντας	v ɣ a z o n d a s
βγάζω	v ɣ a z o
βγαίνω	v ʝ e n o
βδέλυγμα	v ð e l i ɣ m a
βδομάδα	v ð o m a ð a
βεβαίως	v e v e o s
βεβαιώνω	v e v e o n o
βεγγαλικό	v e ŋ ɡ a l i k o
βελτιώσεις	v e l t i o s i s
βελόνα	v ɛ l ɔ n a
βερολίνο	v e r o l i n o
βιβλιοπωλεία	v i v l i o p o l i a
βιβλιοπωλείο	v i v l i o p o l i o
βιόσφαιρα	v i o s f e ɾ a
βλάκας	v l a k a s
βλάπτει	v l a p t i
βλέποντας	v l e p o n d a s
βλακεία	v l a c i a
βλαμμένε	v l a m e n e
βλαμμένες	v l a m e n e s
βλαμμένο	v l a m e n o
βλαμμένος	v l a m e n o s
βλαμμένου	v l a m e n u
βουβάλια	v u v a ʎ a
βουβαλιού	v u v a ʎ u
βουβαλιών	v u v a ʎ o n
βουλευτής	v u l e f t i s
βουλιάζω	v u ʎ a z o
βουτυρωμένη	v u t i r o m e n i
βουτυρωμένο	v u t i r o m e n o
βουτυρώνω	v u t i ɾ o n o
βούληση	v u l i s i
βράδυ	v r a ð i
βράζω	v r a z o
βρέθηκα	v ɾ e θ i k a
βρήκα	v ɾ i k a
βρήκαμε	v ɾ i k a m e
βρήκατε	v ɾ i k a t e
βρήκε	v ɾ i c e
βρήκες	v ɾ i c e s
βρίζω	v ɾ i z o
βρίσκω	v ɾ i s k o
βραδάκι	v ɾ a ð a c i
βραχυκύκλωμα	v ɾ a ç i c i k l o m a
βραχώδης	v ɾ a x o ð i s
βρε	v ɾ e
βρείτε	v ɾ i t e
βρει	v ɾ i
βρεις	v ɾ i s
βρετάνη	v r e t a n i
βρετανία	v r e t a n i a
βρικόλακας	v ɾ i k o l a k a s
βρισίδι	v ɾ i s i ð i
βρισιά	v ɾ i s ç a
βυζάκι	v i z a c i
βυζί	v i z i
βυθισμένες	v i θ i z m e n e s
βυθισμένης	v i θ i z m e n i s
βυθισμένο	v i θ i z m e n o
βυθισμένος	v i θ i z m e n o s
βυθισμένων	v i θ i z m e n o n
βυρσοδέψης	v i ɾ s o ð e p s i s
βόρειος	v o ɾ i o s
βόσκω	v o s k o
γάιδαρος	ɣ a i ð a ɾ o s
γάμα	ɣ a m a
γάμος	ɣ a m o s
γάντζος	ɣ a n d z o s
γένεση	ʝ e n e s i
γένεσης	ʝ e n e s i s
γέννας	ʝ e n a s
γέννες	ʝ e n e s
γέννησις	ʝ e n i s i s
γένος	ʝ e̞ n o̞ s
γέρος	ʝ e ɾ o s
γήπεδο	ʝ i p e ð o
γίγαντας	ʝ i ɣ a d a s
γαβ	ɣ a v
γαλήνη	ɣ a l i n i
γαλακτοκομείο	ɣ a l a k t o k o m i o
γαλακτομπούρεκο	ɣ a l a k t o b u ɾ ɛ k o
γαλλία	ɣ a l i a
γαλοπούλα	ɣ a l o p u l a
γαμάτα	ɣ a m a t a
γαμάτοι	ɣ a m a t i
γαμάτος	ɣ a m a t o s
γαμημένα	ɣ a m i m e n a
γαμημένε	ɣ a m i m e n e
γαμημένες	ɣ a m i m e n e s
γαμημένη	ɣ a m i m e n i
γαμημένο	ɣ a m i m e n o
γαμιέμαι	ɣ a m ɲ e m e
γαμώντας	ɣ a m o n d a s
γαμώτο	ɣ a m o t o
γαργάρα	ɣ a ɾ ɣ a ɾ a
γαϊδαράκος	ɣ a i ð a ɾ a k o s
γαϊδουριά	ɣ a i ð u ɾ j a
γαϊδούρι	ɣ a i ð u ɾ i
γελάμε	ʝ e l a m e
γελοίος	ʝ e l i o s
γελωτοποιός	ʝ e l o t o p i o s
γελώ	ʝ e l o
γενέσεως	ʝ e n e s e o s
γενέσθαι	ʝ e n e s θ e
γενεά	ʝ e n e a
γενεάς	ʝ e n e a s
γενεές	ʝ e n e e s
γενεών	ʝ e n e o n
γενιά	ʝ e ɲ a
γενιάς	ʝ e ɲ a s
γενιές	ʝ e ɲ e s
γεράματα	ʝ e ɾ a m a t a
γερός	ʝ e ɾ o s
γεωγραφία	ʝ e o ɣ r a f i a
γεωγραφίας	ʝ e o ɣ r a f i a s
γηροκομείο	ʝ i ɾ o k o m i o
γητεύομαι	ʝ i t e v o m e
γιάννα	ʝ a n a
γιάννης	ʝ a n i s
γιάτρεψα	ʝ a t ɾ e p s a
γιακάς	ʝ a k a s
γιαννάκης	ʝ a n a c i s
γιασεμί	ʝ a s e m i
γιατάκι	ʝ a t a c i
γιατί	ʝ a t i
γιατρεύω	ʝ a t ɾ e v o
γιατρός	ʝ a t r o s
γιεν	ʝ e n
γιογιό	ʝ o ʝ o
γιορτάζουμε	ʝ o ɾ t a z u m e
γιορτάζω	ʝ o ɾ t a z o
γιος	ʝ o s
γιουγκοσλαβία	ʝ u ɡ o z l a v i a
γιώτα	ʝ o t a
γκέι	ɡ e i
γκαστρωμένη	ɡ a s t ɾ o m e n i
γκαστρωμένης	ɡ a s t r o m e n i s
γκαστρωμένους	ɡ a s t r o m e n u s
γκεσέμια	ɟ e s e m ɲ a
γκεσεμιού	ɟ e s e m ɲ u
γκιλοτίνα	ɟ i l o t i n a
γκομενάρα	ɡ o m e n a ɾ a
γκομενίτσα	ɡ o m e n i t s a
γκουγκλάρω	ɡ u ɡ l a ɾ o
γκρεμός	ɡ r e m o s
γκρινιάζω	ɡ ɾ i ɲ a z o
γκόμενα	ɡ o m e n a
γλάστρα	ɣ l a s t ɾ a
γλαστράκι	ɣ l a s t ɾ a c i
γλείφομαι	ɣ l i f o m e
γλείφω	ɣ l i f o
γλειφομούνι	ɣ l i f o m u n i
γλιτώνω	ɣ l i t o n o
γλυκίσματα	ɣ l i c i z m a t a
γλυκισμάτων	ɣ l i c i z m a t o n
γλυφάδα	ɣ l i f a ð a
γλύκισμα	ɣ l i c i z m a
γλώσσα	ɣ l o s a
γνωρίζω	ɣ n o ɾ i z o
γνώση	ɣ n ɔ s i
γοήτευσα	ɣ o i t e f s a
γογγύλι	ɣ o ŋ ɟ i l i
γοητεύω	ɣ o i t e v o
γονυπετές	ɣ o n i p e t e s
γονυπετείς	ɣ o n i p e t i s
γονυπετών	ɣ o n i p e t o n
γουρούνα	ɣ u ɾ u n a
γουρούνι	ɣ u ɾ u n i
γουστάρω	ɣ u s t a ɾ o
γούσταρα	ɣ u s t a ɾ a
γούσταρε	ɣ u s t a ɾ e
γούστο	ɣ u s t o
γράμμα	ɣ r a m a
γράφω	ɣ r a f o
γρήγορος	ɣ r i ɣ o r o s
γραδάρω	ɣ ɾ a ð a ɾ o
γραφείο	ɣ ɾ a f i ɔ
γρεβενά	ɣ ɾ e v e n a
γρηγόρης	ɣ ɾ i ɣ o ɾ i s
γρηγόριος	ɣ r i ɣ o r i o s
γριά	ɣ ɾ i a
γυαλί	ʝ a l i
γυαλιά	ʝ a ʎ a
γυρεύω	ʝ i ɾ e v o
γόνυ	ɣ o n i
γύρεψα	ʝ i ɾ e p s a
γύρος	ʝ i r o s
δάφνη	ð a f n i
δέκατος	ð e k a t o s
δέομαι	ð e o m e
δέχθηκα	ð e x θ i k a
δέχομαι	ð e x o m e
δέχτηκα	ð e x t i k a
δέω	ð e o
δήθεν	ð i θ e n
δήμητρα	ð i m i t ɾ a
δήμητρας	ð i m i t r a s
δήμος	ð i m o s
δίεση	ð i e s i
δαίμονας	ð ɛ m ɔ n a s
δαγκάσει	ð a ŋ ɡ a s i
δαγκώνω	ð a ŋ ɡ o n o
δαγκώσει	ð a ŋ ɡ o s i
δανάη	ð a n a i
δανάης	ð a n a i s
δανία	ð a n i a
δασμός	ð a z m o s
δείχνω	ð i x n o
δεκαεννέα	ð e k a e n e a
δεκαεννιά	ð e k a e ɲ a
δεκανέας	ð e k a n e a s
δεκαπέντε	ð e k a p e n d e
δεκατέσσερα	ð e k a t e s e ɾ a
δεκατέσσερις	ð e k a t e s e ɾ i s
δεκατρία	ð e k a t ɾ i a
δεκατρείς	ð e k a t ɾ i s
δελφοί	ð e l f i
δεμάτι	ð e m a t i
δενδροχρονολόγηση	ð e n d r o x r o n o l o ʝ i s i
δεσπότης	ð e s p o t i s
δευτεραγωνιστές	ð e f t e r a ɣ o n i s t e s
δεχτεί	ð e x t i
δεύτερος	ð e f t e ɾ o s
δηλαδή	ð i l a ð i
δημήτρης	ð i m i t ɾ i s
δημήτριος	ð i m i t ɾ i o s
δημαρχία	ð i m a ɾ ç i a
δημαρχεία	ð i m a ɾ ç i a
δημαρχείο	ð i m a ɾ ç i o
δημητρούλα	ð i m i t ɾ u l a
δημοκρατία	ð i m o k r a t i a
δημοκρατίας	ð i m o k r a t i a s
δημοκρατιών	ð i m o k r a t i o n
δημοσιεύω	ð i m o s i e v o
δημοτική	ð i m o t i c i
δημοψήφισμα	ð i m o p s i f i z m a
διά	ð i͜a
διήθηση	ð i i θ i s i
διαβάζω	ð ʝ a v a z o
διαδοχή	ð ʝ a ð o ç i
διαδοχικός	ð ʝ a ð o ç i k o s
διαισθάνομαι	ð i e s θ a n o m e
διακήρυξη	ð i a c i ɾ i k s i
διακομιστής	ð i a k o m i s t i s
διαλογίζομαι	ð i a l o ʝ i z o m e
διαλυτικά	ð ʝ a l i t i k a
διανομή	ð ʝ a n o m i
διανύομε	ð i a n i o m e
διανύουμε	ð i a n i u m e
διαπλέω	ð i a p l e o
διαστροφή	ð ʝ a s t ɾ o f i
διαφήμιση	ð i a f i m i s i
διαχειρίζομαι	ð i a ç i ɾ i z o m e
διδάσκω	ð i ð a s k o
διεθνισμός	ð i e θ n i z m o s
διημείφθη	ð i i m i f θ i
διημείφθην	ð i i m i f θ i n
διημείφθησαν	ð i i m i f θ i s a n
δικαιολογία	ð i c e o l o ʝ i a
δικός	ð i k o s
διπλανή	ð i p l a n i
διπλανοί	ð i p l a n i
διπλανός	ð i p l a n o s
διπλασιάζομαι	ð i p l a s i a z o m e
δις	ð i s
δισεκατομμύριο	ð i s e k a t o m i r i o
διώκω	ð i o k o
διώχνω	ð ʝ o x n o
δολιοφθορά	ð o ʎ o f o ɾ a
δολοφονώ	ð o l o f o n o
δοντιού	ð o n d ʝ u
δοντιών	ð o n d ʝ o n
δουλεύω	ð u l e v o
δούναβης	ð u n a v i s
δράκος	ð ɾ a k o s
δράκουλας	v ɾ i k o l a k a s
δράμα	ð r a m a
δράμι	ð r a m i
δραπέτης	ð ɾ a p e t i s
δρόμος	ð r o m o s
δυνατόν	ð i n a t o n
δυσανάγνωστος	ð i s a n a ɣ n o s t o s
δυσθυμία	ð i s θ i m i a
δυσκολία	ð i s k o l i a
δυσκολεύομαι	ð i s k o l e v o m e
δυόμισι	ð ʝ o m i s i
δόγμα	ð o ɣ m a
δόντια	ð o n d ʝ a
δύο	ð i o
δύσκολα	ð i s k o l a
δύσκολος	ð i s k o l o s
δώδεκα	ð o ð e k a
δώρα	ð o ɾ a
δώρων	ð o r o n
είδωλο	i ð o̞ l o̞
είμαι	i m e̞
είμαστε	i m a s t e
είμεθα	i m e θ a
είναι	i n ɛ
είρων	i r o n
είσαι	i s e
είστε	i s t e
είχα	i x a
είχαμε	i x a m e
είχαν	i x a n
είχανε	i x a n e
είχατε	i x a t e
είχε	i ç e
είχες	i ç e s
εαυτός	e a f t o s
εβδομάδα	e v ð o m a ð a
εβδομήκοντα	e v ð o m i k o n d a
εβδομήντα	e v ð o m i n d a
εβραία	e v ɾ e a
εβραίος	e v ɾ e o s
εγέρθηκε	e ʝ e ɾ θ i c e
εγγλέζα	e ŋ ɡ l e z a
εγγλέζος	e ŋ ɡ l e z o s
εγγονιών	e ŋ ɡ o ɲ o n
εγγράφηκε	e ŋ ɣ r a f i c e
εγγράφουμε	e ŋ ɣ r a f u m e
εγγράφω	e ŋ ɣ ɾ a f o
εγγραφή	e ŋ ɣ r a f i
εγγόνι	e ŋ ɡ o n i
εγγόνια	e ŋ ɡ o ɲ a
εγείρω	e ʝ i ɾ o
εγερθήκαν	e ʝ e ɾ θ i k a n
εγκατάλειψη	e ŋ ɡ a t a l i p s i
εγκατέλειψα	e ŋ ɡ a t e l i p s a
εγκαταλείπω	e ŋ ɡ a t a l i p o
εγκαταλείψεις	e ŋ ɡ a t a l i p s i s
εγκλείομε	e ŋ ɡ l i o m e
εγχέω	e ŋ ç e o
εγώ	e ɣ o
εδέσσης	e ð e s i s
εθνάρχες	e θ n a r ç e s
εθνάρχη	e θ n a r ç i
εθναρχών	e θ n a r x o n
ειλημμένες	i l i m e n e s
ειλημμένη	i l i m e n i
ειλημμένων	i l i m e n o n
εισαγγελέας	i s a ŋ ɟ e l e a s
εισπνέουμε	i s p n e u m e
εισροή	i z r o i
εκβιασμός	e ɡ v i a z m o s
εκδίκηση	e k ð i c i s i
εκδρομή	e k ð ɾ o m i
εκείνη	e c i n i
εκείνοι	e c i n i
εκκλησία	e k l i s i a
εκλέγω	e k l e ɣ o
εκλέχθηκα	e k l e x θ i k a
εκλείψεις	e k l i p s i s
εκπέμπω	e k p e m b o
εκπληκτικά	e k p l i k t i k a
εκπομπές	e k p o m b e s
εκπομπή	e k p o m b i
εκτέλεσα	e k t e l e s a
εκτέλεση	e k t e l e s i
εκτελέσεις	e k t e l e s i s
εκτελεστικός	e k t e l e s t i k o s
εκτελώ	e k t e l o
εκτράπηκα	e k t ɾ a p i k a
ελάφι	e l a f i
ελεημοσύνη	e l e i m o s i n i
ελευθερουδάκης	e l e f θ e r u ð a c i s
ελεύθερος	e l e f θ e r o s
ελιά	ɛ ʎ a
ελιόψωμα	e ʎ o p s o m a
ελκυστικός	e l c i s t i k o s
ελληναράς	e l i n a ɾ a s
εμμανουήλ	e m a n u i l
εμπερικλείομαι	e m b e r i k l i o m e
εμπιστεύομαι	e m b i s t e v o m e
εμπιστοσύνη	e m b i s t o s i n i
εμπνέομε	e m b n e o m e
εμπνέω	e m b n e o
εμπνευσμένα	e m b n e v z m e n a
εμπνευσμένες	e m b n e v z m e n e s
εμπνευσμένη	e m b n e v z m e n i
εμπνευσμένης	e m b n e v z m e n i s
εμπνευσμένο	e m b n e v z m e n o
εμπνευσμένοι	e m b n e v z m e n i
εμπορία	e m b o r i a
εμπρός	e m b r o s
εμπόδιο	e m b o ð i o
εμπόριο	ɛ m b ɔ ɾ i ɔ
ενέπνευσα	e n e p n e f s a
εναντίον	e n a n d i o n
ενδέχεται	e n ð e x e t e
ενδιαφέρθηκα	e n ð i̯ a f e ɾ θ i k a
ενδιαφέρομαι	e n ð i̯ a f e ɾ o m e
ενδιαφέρουσας	e n ð j a f e r u s a s
ενεγράφη	e n e ɣ r a f i
ενετοκρατία	e n e t o k ɾ a t i a
ενημέρωσης	e n i m e r o s i s
ενημερώσεις	e n i m e r o s i s
ενημερώσεων	e n i m e r o s e o n
ενθύμιο	ɛ n θ i m i ɔ
εννέα	e n e a
εννιά	e ɲ a
εννιακόσια	e ɲ a k o s ç a
εννοώ	e n o o
ενοικιαστής	e n i c i a s t i s
ενορχήστρωση	e n o ɾ ç i s t ɾ o s i
ενορχηστρώσεις	e n o ɾ ç i s t ɾ o s i s
ενοχλητικά	e n o x l i t i k a
ενοχλητικός	e n o x l i t i k o s
ενρίνως	e n r i n o s
ενρινότητα	e n r i n o t i t a
ενρινότητες	e n r i n o t i t e s
ενστερνίστηκα	e n s t e r n i s t i k a
εντάξει	ɛ n d a k s i
εντούτοις	e n d u t i s
εντύπωση	e n d i p o s i
ενόχληση	e n o x l i s i
εξέγερση	e k s e ʝ e r s i
εξαιτίας	e k s e t i a s
εξακόσια	e k s a k o s ç a
εξαλείφομαι	e k s a l i f o m e
εξαλείφτηκα	e k s a l i f t i k a
εξαναγκάζομε	e k s a n a ŋ ɡ a z o m e
εξαπολύουμε	e k s a p o l i u m e
εξετάζω	e k s e t a z o
εξολοθρεύθηκα	e k s o l o θ ɾ e f θ i k a
εξοπλισμένα	e k s o p l i z m e n a
εξοπλισμένες	e k s o p l i z m e n e s
εξοπλισμένο	e k s o p l i z m e n o
εξοπλισμένοι	e k s o p l i z m e n i
εξοπλισμένου	e k s o p l i z m e n u
εξοπλισμένους	e k s o p l i z m e n u s
εξοπλισμένων	e k s o p l i z m e n o n
εξού	e k s u
εξώστης	e k s o s t i s
επάρκεια	e p a ɾ c i a
επέστρεψα	e p e s t ɾ e p s a
επέτρεψα	e p e t ɾ e p s a
επίδαυρο	e p i ð a v ɾ o
επίδαυρος	e p i ð a v ɾ o s
επανέφερα	e p a n e f e ɾ a
επαναλαμβάνω	e p a n a l a ɱ v a n o
επαναφέρομαι	e p a n a f e ɾ o m e
επαναφέρουμε	e p a n a f e ɾ u m e
επαναφέρω	e p a n a f e ɾ o
επανειλημμένα	e p a n i l i m e n a
επανειλημμένες	e p a n i l i m e n e s
επανειλημμένου	e p a n i l i m e n u
επανειλημμένων	e p a n i l i m e n o n
επανειλημμένως	e p a n i l i m e n o s
επανιδρύουμε	e p a n i ð r i u m e
επαρκέστεροι	e p a ɾ c e s t e ɾ i
επαρκής	e p a ɾ c i s
επαρκείς	e p a ɾ c i s
επαρκώς	e p a ɾ k o s
επαρχία	e p a ɾ ç i a
επαρχίας	e p a ɾ ç i a s
επαρχίες	e p a ɾ ç i e s
επαρχιών	e p a ɾ ç i o n
επείγον	e p i ɣ o n
επείγων	e p i ɣ o n
επερχόμενος	e p e ɾ x o m e n o s
επετράπησαν	e p e t ɾ a p i s a n
επηρεάζομαι	e p i ɾ e a z o m e
επιβάλλω	e p i v a l o
επιδαύρου	e p i ð a v ɾ u
επιδοκιμάζω	e p i ð o c i m a z o
επιδοκιμάστηκα	e p i ð o c i m a s t i k a
επικαλύψεις	e p i k a l i p s i s
επικαρπία	e p i k a ɾ p i a
επικείμενος	e p i c i m e n o s
επικράτεια	e p i k r a t i a
επικρατώ	e p i k r a t o
επιλέγω	e p i l e ɣ o
επιλογή	ɛ p i l ɔ ʝ i
επιλοχίας	e p i l o ç i a s
επιπλέον	e p i p l e o n
επιπλέω	e p i p l e o
επισκέπτομαι	e p i s c e p t o m e
επισκέφθηκα	e p i s c e f θ i k a
επιστημολογία	ɛ p i s t i m ɔ l ɔ ʝ i a
επιστρέφουμε	e p i s t ɾ e f u m e
επιστρέφω	e p i s t ɾ e f o
επισυνάπτουμε	e p i s i n a p t u m e
επισυνάπτω	e p i s i n a p t o
επισυνάφθηκαν	e p i s i n a f θ i k a n
επιτράπηκε	e p i t ɾ a p i c e
επιτρέπετε	e p i t ɾ e p e t e
επιτρέπουμε	e p i t ɾ e p u m e
επιτρέπω	e p i t ɾ e p o
επιτυχία	ɛ p i t i ç i a
επομένως	e p o m e n o s
επρόκειτο	e p ɾ o c i t o
επτά	e p t a
επωνυμία	e p o n i m i a
επόμενος	e p o m e n o s
εργάζομαι	e ɾ ɣ a z o m e
εργάστηκα	e ɾ ɣ a s t i k a
εργαλειοθήκη	e r ɣ a l i o θ i c i
ερρινοτήτων	e r i n o t i t o n
ερρινότητας	e r i n o t i t a s
ερυθρός	e r i θ r o s
ερχομένη	e r x o m e n i
ερχόμενα	e r x o m e n a
ερχόμενες	e r x o m e n e s
ερχόμενης	e r x o m e n i s
ερχόμενο	e r x o m e n o
ερχόμενοι	e r x o m e n i
ερχόμενος	e r x o m e n o s
ερχόμενου	e r x o m e n u
ερχόμενους	e r x o m e n u s
ερωτεύθηκα	e ɾ o t e f θ i k a
ερωτεύτηκα	e ɾ o t e f t i k a
εσπεράντο	ɛ s p ɛ ɾ a n d ɔ
εστιατόριο	e s t i a t o ɾ i o
εσώκλεισα	e s o k l i s a
εσώρουχο	e s o ɾ u x o
ετοιμάζω	e t i m a z o
ετοιμασία	e t i m a s i a
ετοιμασίας	e t i m a s i a s
ετοιμασίες	e t i m a s i e s
ευθέως	e f θ e o s
ευθανασία	e f θ a n a s i a
ευθεία	e f θ i a
ευθυμία	e f θ i m i a
ευρίσκω	e v ɾ i s k o
ευρώπη	e v r o p i
ευσέβεια	e f s e v i a
ευσέβειας	e f s e v i a s
ευσέβειες	e f s e v i e s
ευσεβές	e f s e v e s
ευσεβέστερα	e f s e v e s t e r a
ευσεβή	e f s e v i
ευσεβής	e f s e v i s
ευσεβείας	e f s e v i a s
ευσεβείς	e f s e v i s
ευσεβούς	e f s e v u s
ευσεβών	e f s e v o n
ευσεβώς	e f s e v o s
ευφροσύνη	e f ɾ o s i n i
ευχή	e f ç i
ευχήθηκα	e f ç i θ i k a
ευχαριστώ	e f x a ɾ i s t o
εφέτος	e f e t o s
εφευρέθηκα	e f e v ɾ e θ i k a
εφεύρα	e f e v ɾ a
εφηύρα	e f i v ɾ a
εφοδιάστηκα	e f o ð i a s t i k a
εφτά	e f t a
εψές	e p s e s
εύβοια	e v i a
εύχομαι	e f x o m e
ζάκυνθο	z a c i n θ o
ζάρι	z a ɾ i
ζέβρα	z e v ɾ a
ζήλος	z i l o s
ζήτα	z i t a
ζακύνθου	z a c i n θ u
ζαριά	z a ɾ ʝ a
ζενίθ	z e n i θ
ζευγάρι	z e v ɣ a r i
ζευγάρια	z e v ɣ a r ʝ a
ζευγαριού	z e v ɣ a r ʝ u
ζευγαριών	z e v ɣ a r ʝ o n
ζευς	z e f s
ζεύγη	z e v ʝ i
ζεύγος	z e v ɣ o s
ζεύγους	z e v ɣ u s
ζηλεύω	z i l e v o
ζητιάνευε	z i t ç a n e v e
ζητιανεύτε	z i t ç a n e f t e
ζητιανεύω	z i t ç a n e v o
ζητώ	z i t o
ζωή	z o i
ζύθος	z i θ ɔ s
ζώδιο	z o ð i o
ηγέρθη	i ʝ e ɾ θ i
ηγουμένη	i ɣ u m e n i
ηγουμένου	i ɣ u m e n u
ηγουμένων	i ɣ u m e n o n
ηγούμενο	i ɣ u m e n o
ηδονοβλεψίας	i ð o n o v l e p s i a s
ηδύποτο	i ð i p o t o
ηθικότητα	i θ i k o t i t a
ηθοποιία	i θ o p i i a
ηλιθιότητα	i l i θ i o t i t a
ηλικιωμένες	i l i c i o m e n e s
ηλικιωμένη	i l i c i o m e n i
ηλικιωμένο	i l i c i o m e n o
ηλικιωμένος	i l i c i o m e n o s
ηλικιωμένους	i l i c i o m e n u s
ηλικιωμένων	i l i c i o m e n o n
ηλιοθεραπεία	i ʎ o θ e ɾ a p i a
ηλιόλουστος	i ʎ ɔ l u s t ɔ s
ημέρευ'	i m e ɾ e f
ημερεύτε	i m e ɾ e f t e
ηράκλειο	i r a k l i o
ηρόδοτος	i r o ð o t o s
ηφαίστειο	i f ɛ s t i ɔ
θέλω	θ e l o
θέματα	θ e m a t a
θέματος	θ e m a t o s
θέρος	θ e̞ r o̞ s
θήβα	θ i v a
θήρα	θ i ɾ a
θήτα	θ i t a
θα	θ a
θαλαμηγό	θ a l a m i ɣ o
θαλαμηγός	θ a l a m i ɣ o s
θαρραλέος	θ a r a l e o s
θαυμάζομε	θ a v m a z o m e
θαυμάζουμε	θ a v m a z u m e
θαύμα	θ a v m a
θαύμασα	θ a v m a s a
θείον	θ i o n
θεαματικότητα	θ e a m a t i k o t i t a
θεμάτων	θ e m a t o n
θεοδώρα	θ e o ð o ɾ a
θεοκρατία	θ e o k r a t i a
θεούλης	θ e u l i s
θερμά	θ e r m a
θερμοδυναμική	θ e r m o ð i n a m i c i
θερμοδυναμικής	θ e r m o ð i n a m i c i s
θερμοδυναμικό	θ e r m o ð i n a m i k o
θερμοδυναμικός	θ e r m o ð i n a m i k o s
θερμοκοιτίδα	θ e r m o c i t i ð a
θερμοκρασία	θ ɛ ɾ m ɔ k ɾ a s i a
θεσσαλονίκη	θ e s a l o n i c i
θεωρία	θ e o r i a
θεωρώ	θ e o r o
θεός	θ e o s
θηλιά	θ i ʎ a
θλίψη	θ l i p s i
θλιμμένο	θ l i m e n o
θλιμμένοι	θ l i m e n i
θλιμμένος	θ l i m e n o s
θλιμμένου	θ l i m e n u
θοδωρής	θ o ð o ɾ i s
θρησκόληπτος	θ ɾ i s k o l i p t o s
θρόμβωση	θ ɾ o ɱ v o s i
θρόνος	θ r o n o s
θυελλώδεις	θ i e l o ð i s
θυελλώδης	θ i e l o ð i s
θυμώνω	θ i m o n o
θωρώ	θ o r o
θόδωρος	θ o ð o ɾ o s
θύελλα	θ i e l a
ιδίως	i ð i o s
ιδιαίτερα	i ð i e t e ɾ a
ιδιαιτέρως	i ð i e t e ɾ o s
ιδιοσυγκρασία	i ð i ɔ s i ŋ ɡ ɾ a s i a
ιδιωτικοποίηση	i ð i ɔ t i k ɔ p i i s i
ιδρυμάτων	i ð r i m a t o n
ιδρύματα	i ð r i m a t a
ιδρύματος	i ð r i m a t o s
ιδρύομε	i ð r i o m e
ιεράπετρα	i e ɾ a p e t ɾ a
ιεράρχες	i e r a r ç e s
ιεράρχη	i e r a r ç i
ιεραρχών	i e r a r x o n
ιεροσόλυμα	i e ɾ o s o l i m a
ιερουσαλήμ	i e ɾ u s a l i m
ιερόδουλη	i e ɾ o ð u l i
ιερός	i e ɾ o s
ικανοποιημένα	i k a n o p i i m e n a
ικανοποιημένε	i k a n o p i i m e n e
ικανοποιημένες	i k a n o p i i m e n e s
ικανοποιημένη	i k a n o p i i m e n i
ικανοποιημένο	i k a n o p i i m e n o
ικανοποιημένοι	i k a n o p i i m e n i
ικανοποιημένους	i k a n o p i i m e n u s
ικανοποιημένων	i k a n o p i i m e n o n
ικετεύω	i c e t e v o
ιλινόις	i l i n o i s
ιντιάνα	i n d i a n a
ιουδαία	i u ð e a
ιουδαίος	i u ð e o s
ιουδαϊσμός	i u ð a i z m o s
ιπποπόταμος	i p o p o t a m o s
ιπτάμενος	i p t a m e n o s
ιπταμένη	i p t a m e n i
ιρλανδία	i ɾ l a n ð i a
ιρλανδικός	i ɾ l a n ð i k o s
ισορροπία	i s o̞ r o̞ p i a
ισπανία	i s p a n i a
ισχίο	i s ç i o
ισχνός	i s x n ɔ s
ισχυρίζομαι	i s ç i ɾ i z o m e
ισχυρίστηκα	i s ç i ɾ i s t i k a
ισχυρισμός	i s ç i ɾ i z m o s
ισχύων	i s ç i o n
ιταλική	i t a l i k i
ιταλικό	i t a l i k o
ιταλικός	i t a l i k o s
ιωάννα	i o a n a
ιωάννης	i o a n i s
ιωάννινα	i o a n i n a
ιός	i ɔ s
κάγκελο	k a ŋ ɡ e l o
κάγκουρας	k a ŋ ɡ u ɾ a s
κάδρο	k a ð ɾ o
κάθαρμα	k a θ a ɾ m a
κάθετος	k a θ e t o s
κάθισα	k a θ i s a
κάθομαι	k a θ o m e
κάλλιο	k a ʎ o
κάλμα	k a l m a
κάλπη	k a l p i
κάλυμνο	k a l i m n o
κάλυψα	k a l i p s a
κάμπτω	k a m p t o
κάμψεις	k a m p s i s
κάνοντας	k a n o n d a s
κάνσας	k a n z a s
κάνω	k a n o
κάποτε	k a p o t e
κάππα	k a p a
κάρδαμο	k a r ð a m o
κάρπαθο	k a ɾ p a θ o
κένταυρος	c e n d a v ɾ o s
κέρδος	c e r ð o s
κέρκυρα	c e r c i r a
κέφι	c e f i
κέφια	c e f ç a
κίμωλε	c i m o l e
κίμωλο	c i m o l o
κίμωλος	c i m o l o s
κίνητρο	c i n i t r o
κίτρο	c i t ɾ o
καβάλα	k a v a l a
καημένος	k a i m e n o s
καθίκι	k a θ i c i
καθαρεύουσα	k a θ a ɾ ɛ v u s a
καθελκύσθηκα	k a θ e l c i s θ i k a
καθελκύω	k a θ e l c i o
καθισμένες	k a θ i z m e n e s
καθισμένη	k a θ i z m e n i
καθισμένο	k a θ i z m e n o
καθισμένοι	k a θ i z m e n i
καθισμένος	k a θ i z m e n o s
καθομιλουμένη	k a θ o m i l u m e n i
καθορίζουμε	k a θ o ɾ i z u m e
καθορίζω	k a θ o ɾ i z o
καθοριστικά	k a θ o ɾ i s t i k a
και	c e̞
καινοτομία	c e n o t o m i a
καινοτομίας	c e n o t o m i a s
καινοτομίες	c e n o t o m i e s
καινοτομιών	c e n o t o m i o n
καινοφανής	c e n o f a n i s
κακογαμημένες	k a k o ɣ a m i m e n e s
κακογαμημένης	k a k o ɣ a m i m e n i s
κακό	k a k o
κακός	k a k o s
καλέ	k a l e
καλή	k a l i
καλαμάτα	k a l a m a t a
καλημέρα	k a l i m e r a
καληνύχτα	k a l i n i x t a
καλησπέρα	k a l i s p e r a
καλιαρντά	k a ʎ a r d a
καλικάντζαρος	k a l i k a n d z a ɾ o s
καλιφόρνια	k a l i f o ɾ n i a
καλμάρω	k a l m a ɾ o
καλντερίμι	k a l d e ɾ i m i
καλοήθης	k a l o i θ i s
καλοκαίρι	k a l o c e r i
καλοκαιριάτικα	k a l o c e ɾ ʝ a t i k a
καλοκαιρινός	k a l o c e ɾ i n o s
καλομαθημένε	k a l o m a θ i m e n e
καλομαθημένες	k a l o m a θ i m e n e s
καλομαθημένης	k a l o m a θ i m e n i s
καλομαθημένο	k a l o m a θ i m e n o
καλομαθημένων	k a l o m a θ i m e n o n
καλομοίρα	k a l o m i r a
καλομοίρας	k a l o m i r a s
καλός	k a l o s
καλύπτουμε	k a l i p t u m e
καλύψεις	k a l i p s i s
κανάκεψα	k a n a c e p s a
κανονικός	k a n o n i k o s
κανόνας	k a n o n a s
καπνίζουμε	k a p n i z u m e
καπνίζω	k a p n i z o
καπνοδόχο	k a p n o ð o x o
καρέκλα	k a ɾ e k l a
καραβάνι	k a ɾ a v a n i
καραπουτάνα	k a r a p u t a n a
καρβέλι	k a r v e l i
καρδιά	k a r ð ʝ a
καρδινάλιος	k a ɾ ð i n a l i o s
καρεκλάκι	k a ɾ e k l a c i
καρεκλίτσα	k a ɾ e k l i t s a
καριόλα	k a ɾ ʝ o l a
καριόλης	k a ɾ ʝ o l i s
καρπάθου	k a ɾ p a θ u
καστοριά	k a s t o ɾ ʝ a
κατά	k a t a
κατέβαλα	k a t e v a l a
κατέβαλε	k a t e v a l e
κατέβαλλε	k a t e v a l e
κατέστρεψα	k a t e s t ɾ e p s a
καταβάλετε	k a t a v a l e t e
καταβάλλεται	k a t a v a l e t e
καταβάλλετε	k a t a v a l e t e
καταβάλλουμε	k a t a v a l u m e
καταβάλλω	k a t a v a l o
καταβάλουμε	k a t a v a l u m e
καταβάλω	k a t a v a l o
καταγράφομαι	k a t a ɣ r a f o m e
καταγράφουμε	k a t a ɣ r a f u m e
καταγράφω	k a t a ɣ r a f o
καταδύσεις	k a t a ð i s i s
καταιγίδα	k a t e ʝ i ð a
καταιγίδας	k a t e ʝ i ð a s
καταιγίδες	k a t e ʝ i ð e s
καταιγίδων	k a t e ʝ i ð o n
κατακάθι	k a t a k a θ i
κατακάθια	k a t a k a θ ç a
καταλύθηκα	k a t a l i θ i k a
καταλύθηκε	k a t a l i θ i c e
καταλύομεν	k a t a l i o m e n
καταλύουμε	k a t a l i u m e
καταντώ	k a t a n d o
καταξόδιασα	k a t a k s o ð ʝ a s a
καταπίνω	k a t a p i n o
καταρρέω	k a t a r e o
κατασκευάζω	k a t a s c e v a z o
κατασκεύασα	k a t a s c e v a s a
καταφέρομαι	k a t a f e ɾ o m e
καταφέρω	k a t a f e ɾ o
κατερίνη	k a t e ɾ i n i
κατούρημα	k a t u ɾ i m a
κατρουλιό	k a t ɾ u ʎ o
καυλώνω	k a v l o n o
κείνη	c i n i
κεκ	k e k
κεκλεισμένε	c e k l i z m e n e
κεκλεισμένες	c e k l i z m e n e s
κεκλεισμένων	c e k l i z m e n o n
κεντώ	c e n t o
κερί	c e r r i
κεραμίδι	c e ɾ a m i ð i
κερδίζω	c e r ð i z o
κεριά	c e r ʝ a
κεριού	c e r ʝ u
κεφαλάρι	c e̞ f a l a r i
κεφιού	c e f ç u
κηροπήγιο	c i ɾ o p i ʝ i o
κηφισιά	c i f i s j a
κιβωτός	c i v o t o s
κιλκίς	c i l c i s
κιμάς	c i m a s
κιμωλία	c i m o l i a
κιμώλου	c i m o l u
κινέζικα	c i n e z i k a
κινδυνέψει	c i n ð i n e p s i
κινδυνεύσει	c i n ð i n e f s i
κινδυνεύω	c i n ð i n e v o
κινδύνευα	c i n ð i n e v a
κινδύνευε	c i n ð i n e v e
κινδύνευσε	c i n ð i n e f s e
κινεζικά	c i n e z i k a
κινεζοποίηση	c i n e z o p i i s i
κιτς	c i t s
κιτσαρία	c i t s a ɾ i a
κιόλας	c o l a s
κλάδος	k l a ð o s
κλάνω	k l a n o
κλάσμα	k l a z m a
κλέβω	k l e v o
κλέφτηκα	k l e f t i k a
κλέφτης	k l e f t i s
κλέφτικα	k l e f t i k a
κλέφτικο	k l e f t i k a
κλέψω	k l e p s o
κλίση	k ʎ i s i
κλαίω	k l e o
κλανιά	k l a ɲ a
κλαρίνο	k l a ɾ i n o
κλαρινέτο	k l a ɾ i n e t o
κλαρινογαμπρός	k l a ɾ i n o ɣ a m b ɾ o s
κλείνομαι	k l i n o m e
κλείνομε	k l i n o m e
κλείστηκα	k l i s t i k a
κλεισμένες	k l i z m e n e s
κλεισμένη	k l i z m e n i
κλεισμένης	k l i z m e n i s
κλεισμένο	k l i z m e n o
κλεισμένοι	k l i z m e n i
κλεισμένος	k l i z m e n o s
κλεισμένους	k l i z m e n u s
κλεφτρόνι	k l e f t ɾ o n i
κλόουν	k l o u n
κλώσσα	k l o s a
κοίτη	c i t i
κοζάνη	k o z a n i
κοιμάμαι	c i m a m e
κοινόν	c i n o n
κοινός	c i n o s
κοιτάζω	c i t a z o
κοιτίδα	c i t i ð a
κοκκίνου	k o c i n u
κοκκινίζω	k o c i n i z o
κοκκινιστό	k o c i n i s t o
κοκορέτσι	k o k o ɾ e t s i
κολοράντο	k o l o ɾ a d o
κολωνία	k o l o n i a
κομεντί	k o m e d i
κομμένα	k o m e n a
κομμένες	k o m e n e s
κομμένη	k o m e n i
κομμένο	k o m e n o
κομμένοι	k o m e n i
κομμένου	k o m e n u
κομμένους	k o m e n u s
κομμένων	k o m e n o n
κομπίνα	k o m b i n a
κομπιναδόρος	k o m b i n a ð o ɾ o s
κονέκτικατ	k o n e k t i k a t
κοπή	k o p i
κορίνθου	k o ɾ i n θ u
κορίτσαρο	k o r i t s a r o
κορίτσαρους	k o r i t s a r u s
κορίτσι	k ɔ ɾ i t s i
κορίτσια	k o ɾ i t s ç a
κοριτσιού	k o ɾ i t s ç u
κοριτσιών	k o ɾ i t s ç o n
κοροϊδεύω	k o ɾ o i̯ ð e v o
κορόιδευα	k o ɾ o i̯ ð e v a
κορόιδευε	k o ɾ o i̯ ð e v e
κορόιδεψε	k o ɾ o i̯ ð e p s e
κορόιδο	k o ɾ o i̯ ð o
κοσμάκη	k o z m a c i
κοσμάκης	k o z m a c i s
κοτσάρω	k o t s a ɾ o
κοτσαδόρος	k o t s a ð o ɾ o s
κουκλάκι	k u k l a c i
κουκλάρα	k u k l a ɾ a
κουκλίτσα	k u k l i t s a
κουκουλοφόρος	k u k u l o f o ɾ o s
κουκούλα	k u k u l a
κουλούρι	k u l u ɾ i
κουμπάρος	k u m b a r o s
κουνουπίδι	k u n u p i ð i
κουντεπιέ	k u d e p ç e
κουπάκι	k u p a c i
κουράδα	k u ɾ a ð a
κουράζομαι	k u ɾ a z o m e
κουράστηκα	k u ɾ a s t i k a
κουρασμένες	k u r a z m e n e s
κουρασμένη	k u r a z m e n i
κουρασμένο	k u r a z m e n o
κουρασμένοι	k u r a z m e n i
κουρασμένος	k u r a z m e n o s
κουρασμένου	k u r a z m e n u
κουρασμένους	k u r a z m e n u s
κουρασμένων	k u r a z m e n o n
κουραστικά	k u r a s t i k a
κουραστικές	k u r a s t i c e s
κουραστική	k u r a s t i c i
κουραστικής	k u r a s t i c i s
κουραστικοί	k u r a s t i c i
κουραστικού	k u r a s t i k u
κουραστικούς	k u r a s t i k u s
κουραστικό	k u r a s t i k o
κουραστικός	k u r a s t i k o s
κουρελιάστηκα	k u ɾ e ʎ a s t i k a
κουσούρι	k u s u ɾ i
κουταλιά	k u t a ʎ a
κουτσομπολιό	k u t s o b o ʎ o
κουτσομπόλα	k u t s o b o l a
κουτσομπόλης	k u t s o b o l i s
κουτσουλιά	k u t s u ʎ a
κουτός	k u t o s
κούκλα	k u k l a
κούκλος	k u k l o s
κούκος	k u k o s
κούνια	k u ɲ a
κούπα	k u p a
κούρασα	k u ɾ a s a
κράζω	k ɾ a z o
κρέας	k r e̞ a s
κρίνουμε	k ɾ i n u m e
κραγιόν	k ɾ a ʝ ɔ n
κραυγάζω	k r a v ɣ a z o
κρεβατομουρμούρα	k ɾ e v a t o m u ɾ m u ɾ a
κρεμασμένα	k r e m a z m e n a
κρεμασμένες	k r e m a z m e n e s
κρεμασμένη	k r e m a z m e n i
κρεμασμένο	k r e m a z m e n o
κρεμασμένοι	k r e m a z m e n i
κρεμασμένου	k r e m a z m e n u
κρεμασμένους	k r e m a z m e n u s
κριθάρι	k r i θ a r i
κροτώ	k ɾ o t o
κρυμμένες	k r i m e n e s
κρυμμένη	k r i m e n i
κρυμμένης	k r i m e n i s
κρυμμένο	k r i m e n o
κρυμμένοι	k r i m e n i
κρυμμένου	k r i m e n u
κρυμμένους	k r i m e n u s
κρότος	k r o t o s
κρύβω	k ɾ i v o
κρύσταλλος	k r i s t a l o s
κτήματα	k t i m a t a
κτηνοβασία	k t i n o v a s i a
κυήματος	c i i m a t o s
κυανός	c i a n o s
κυνηγάω	c i n i ɣ a o
κυνηγημένα	c i n i ʝ i m e n a
κυνηγημένοι	c i n i ʝ i m e n i
κυνηγημένος	c i n i ʝ i m e n o s
κυνηγημένου	c i n i ʝ i m e n u
κυράτσα	c i ɾ a t s a
κυριακάτικα	c i r ʝ a k a t i k a
κυριακάτικος	c i r ʝ a k a t i k o s
κυριακή	c i r ʝ a c i
κυριολεκτικά	c i ɾ i o l e k t i k a
κυρογενιά	c i r o ʝ e ɲ a
κωλάρα	k o l a ɾ a
κωλοπηλάλα	k o l o p i l a l a
κωλοτρυπίδα	k o l o t r i p i ð a
κωλόγρια	k o l o ɣ ɾ i a
κωλόπαιδο	k o l o p e ð o
κωλόχαρτο	k o l o x a ɾ t o
κωνσταντή	k o s t a n d i
κωνσταντίνα	k o n s t a n d i n a
κωνσταντίνας	k o n s t a n d i n a s
κωνσταντίνε	k o n s t a n d i n e
κωνσταντίνος	k o n s t a n d i n o s
κωνσταντίνου	k o n s t a n d i n u
κωνσταντινουπόλεως	k o n s t a n d i n u p o l e o s
κωνσταντινούπολη	k o n s t a n d i n u p o l i
κωνσταντινούπολης	k o n s t a n d i n u p o l i s
κως	k o s
κωστής	k o s t i s
κωσταντίνο	k o s t a n d i n o
κωσταντίνος	k o s t a n d i n o s
κόβω	k o v o
κόκκινα	k o c i n a
κόκκινες	k o c i n e s
κόκκινη	k o c i n i
κόκκινης	k o c i n i s
κόκκινο	k o c i n o
κόκκινοι	k o c i n i
κόκκινος	k o c i n o s
κόκκινου	k o c i n u
κόκκινων	k o c i n o n
κόλλησα	k o l i s a
κόμης	k o m i s
κόμπος	k o m b o s
κόπος	k o p o s
κόπτομαι	k o p t o m e
κόρινθο	k o ɾ i n θ o
κόρινθος	k o ɾ i n θ o s
κόρνα	k o ɾ n a
κόσμος	k o z m o s
κότα	k o t a
κύημα	c i i m a
κύηση	c i i s i
κύπελλο	c i p e l o
κύπρο	c i p ɾ o
κύπρου	c i p ɾ u
κώδικας	k ɔ ð i k a s
κώστας	k o s t a s
λάκων	l a k o n
λάκωνας	l a k o n a s
λάκωνες	l a k o n e s
λάμπα	l a m b a
λάμπω	l a m b o
λάμψεις	l a m p s i s
λάρισα	l a r i s a
λάρνακα	l a ɾ n a k a
λάτρα	l a t ɾ a
λέγει	l e ʝ i
λέγεις	l e ʝ i s
λέγετε	l e ʝ e t e
λέγω	l e ɣ o
λέσβο	l e z v o
λέσβος	l e z v o s
λέω	l e o
λήμνος	l i m n o s
λίαν	l i a n
λίθοι	l i θ i
λίπος	l i p o s
λαβών	l a v o n
λαιστρυγόνες	l e s t r i ɣ o n e s
λακωνία	l a k o n i a
λακωνίας	l a k o n i a s
λακωνικός	l a k o n i k o s
λακώνων	l a k o n o n
λαμία	l a m i a
λαογραφία	l a o ɣ ɾ a f i a
λατρεύομαι	l a t ɾ e v o m e
λατρεύω	l a t ɾ e v o
λεία	l i a
λεβαδειά	l e v a ð ʝ a
λες	l e s
λευκά	l e f k a
λευκοί	l e f c i
λευκούς	l e f k u s
λευκό	l e f k o
λευκός	l e f k o s
λευκότερος	l e f k o t e r o s
λευκώ	l e f k o
λευκών	l e f k o n
λευχαιμία	l e f ç e m i a
ληστεύω	l i s t e v o
λητώ	l i t o
λιβαδειά	l i v a ð ʝ a
λιγάκι	l i ɣ a c i
λιμένος	l i m e n o s
λιμός	l i m o s
λιπών	l i p o n
λιτός	l i t o s
λιτότητα	l i t o t i t a
λιόψωμα	ʎ o p s o m a
λιώνω	ʎ o n o
λογίζομαι	l o ʝ i z o m e
λογοκρίνω	l o ɣ o k ɾ i n o
λοιπόν	l i p o n
λονδίνο	l o n ð i n o
λουιζιάνα	l u i z i a n a
λουκανικόπιτα	l u k a n i k o p i t a
λουκούμι	l u k u m i
λουτράκι	l u t ɾ a c i
λουφάρω	l u f a ɾ o
λοχίας	l o ç i a s
λυθεί	l i θ i
λυθούμε	l i θ u m e
λυθώ	l i θ o
λυμένα	l i m e n a
λυμένες	l i m e n e s
λυμένο	l i m e n o
λυμένων	l i m e n o n
λυνόμαστε	l i n o m a s t e
λυνόντουσαν	l i n o n d u s a n
λυνόταν	l i n o t a n
λυπάμαι	l i p a m e
λυπημένα	l i p i m e n a
λυπημένη	l i p i m e n i
λυπημένο	l i p i m e n o
λυπημένοι	l i p i m e n i
λυπημένος	l i p i m e n o s
λυπημένους	l i p i m e n u s
λωποδύτης	l o p o ð i t i s
λόγω	l o ɣ o
λόφος	l o f o s
λύεται	l i e t e
λύθηκα	l i θ i k a
λύθηκαν	l i θ i k a n
λύθηκε	l i θ i c e
λύκος	l i k o̞ s
λύνεται	l i n e t e
λύνομαι	l i n o m e
λύνονται	l i n o n d e
λύνονταν	l i n o n d a n
λύνουμε	l i n u m e
λύνουν	l i n u n
λύνουνε	l i n u n e
λύουν	l i u n
λύσαν	l i s a n
λύσεις	l i s i s
λύσετε	l i s e t e
λύση	l i s i
λύσουμε	l i s u m e
λύσουν	l i s u n
λύσσα	l i s a
λύστε	l i s t e
λύσω	l i s o
μάγκας	m a ŋ ɡ a s
μάγος	m a ɣ ɔ s
μάζευα	m a z e v a
μάζευε	m a z e v e
μάζεψα	m a z e p s a
μάζεψε	m a z e p s e
μάλαμα	m a l a m a
μάλωμα	m a l o m a
μάντεψε	m a n d e p s e
μάντης	m a n d i s
μάστιγα	m a s t i ɣ a
μάστορας	m a s t o r a s
μάτα	m a t a
μέγαρα	m e ɣ a ɾ a
μέδουσα	m e̞ ð u s a
μέιν	m e i n
μένε	m e n e
μέρα	m e̞ r a
μέριλαντ	m e ɾ i l a n d
μέρος	m e ɾ o s
μέσα	m e s a
μέσο	m e s o
μέσω	m e s o
μήλο	m i l o
μήνυμα	m i n i m a
μήτρος	m i t ɾ o s
μήτσος	m i t s o s
μία	m i a
μίσιγκαν	m i s i ɡ a n
μα	m a
μαγείρεψα	m a ʝ i ɾ e p s a
μαγειρέψει	m a ʝ i ɾ e p s i
μαγειρεύω	m a ʝ i ɾ e v o
μαγικός	m a ʝ i k o s
μαγιονέζα	m a ʝ o n e z a
μαγκάκι	m a ŋ ɡ a c i
μαζέψτε	m a z e p s t e
μαζεύω	m a z e v o
μαζικά	m a z i k a
μαζικές	m a z i c e s
μαζική	m a z i c i
μαζικής	m a z i c i s
μαζικοί	m a z i c i
μαζικού	m a z i k u
μαζικό	m a z i k o
μαζικός	m a z i k o s
μαζικότατες	m a z i k o t a t e s
μαζικότατης	m a z i k o t a t i s
μαζικότατο	m a z i k o t a t o
μαζικότερες	m a z i k o t e r e s
μαζικότερη	m a z i k o t e r i
μαζικότερο	m a z i k o t e r o
μαζικών	m a z i k o n
μαθαίνω	m a θ e n o
μαθεύτηκε	m a θ e f t i c e
μαθημένη	m a θ i m e n i
μαθημένο	m a θ i m e n o
μαθημένοι	m a θ i m e n i
μακάβριος	m a k a v ɾ i o s
μακαρονάδα	m a k a ɾ o n a ð a
μακαρόνια	m a k a ɾ o ɲ a
μαλάκα	m a l a k a
μαλάκας	m a l a k a s
μαλάκω	m a l a k o
μαλακισμένη	m a l a c i z m e n i
μαλακισμένο	m a l a c i z m e n o
μαλακτικό	m a l a k t i k o
μαλαματένιος	m a l a m a t e ɲ o s
μαλώνω	m a l o n o
μαντεία	m a n d i a
μαντεύω	m a n d e v o
μαντολάτο	m a n d o l a t o
μανόλης	m a n o l i s
μαραθώνας	m a ɾ a θ o n a s
μαρασκίνο	m a ɾ a s c i n o
μαρκάριζε	m a ɾ k a ɾ i z e
μαρκάρισα	m a ɾ k a ɾ i s a
μαρκάρω	m a ɾ k a ɾ o
μασαχουσέτη	m a s a x u s e t i
μασσαλία	m a s a l i a
μαστίζω	m a s t i z o
μαστός	m a s t o s
ματοβαμμένες	m a t o v a m e n e s
ματοβαμμένοι	m a t o v a m e n i
ματοκυλίστηκα	m a t o c i l i s t i k a
μαυρίζω	m a v r i z o
μαυρισμένα	m a v r i z m e n a
μαυρισμένη	m a v r i z m e n i
μαυρισμένο	m a v r i z m e n o
μαϊντανός	m a i d a n o s
μεγάλος	m e ɣ a l o s
μεθ	m e θ
μεθαύριο	m e θ a v ɾ i o
μελισσοκόμος	m e l i s o k o m o s
μελιτζάνα	m e l i d͡z a n a
μερίδα	m e ɾ i ð a
μεσαιωνικά	m e s e o n i k a
μεσαιωνική	m e s e o n i c i
μεσαιωνικής	m e s e o n i c i s
μεσαιωνικού	m e s e o n i k u
μεσαιωνικό	m e s e o n i k o
μεσαιωνικός	m e s e o n i k o s
μεσαιωνικών	m e s e o n i k o n
μεσημβρίαν	m e s i m v r i a n
μεσολόγγι	m e s o l o ŋ ɟ i
μετάπτωση	m e t a p t o s i
μετάπτωσης	m e t a p t o s i s
μετάφερε	m e t a f e ɾ e
μετέφερα	m e t e f e ɾ a
μετέχω	m e t e x o
μεταπτώσεις	m e t a p t o s i s
μεταπτώσεως	m e t a p t o s e o s
μετατρέπουμε	m e t a t ɾ e p u m e
μεταφέρετε	m e t a f e ɾ e t e
μεταφέρθηκα	m e t a f e ɾ θ i k a
μεταφέρουμε	m e t a f e ɾ u m e
μεταφέρω	m e t a f e ɾ o
μεταφράζω	m e t a f ɾ a z o
μεταφράστηκα	m e t a f ɾ a s t i k a
μεταφραστές	m e t a f ɾ a s t e s
μεταφραστή	m e t a f ɾ a s t i
μεταφραστής	m e t a f ɾ a s t i s
μεταφραστών	m e t a f ɾ a s t o n
μεταφυτεύομαι	m e t a f i t e v o m e
μητέρα	m i t e r a
μητρική	m i t r i c i
μητρικός	m i t r i k o s
μι	m iː
μιάμιση	m ɲ a m i s i
μιζούρι	m i z u ɾ i
μικρό	m i k ɾ o
μιλάνο	m i l a n o
μινεσότα	m i n e s o t a
μινόρε	m i n o ɾ e
μισαλλοδοξία	m i s a l o ð o k s i a
μισθοφόρος	m i s θ o f o ɾ o s
μισθωτής	m i s θ o t i s
μισθός	m i s θ o s
μισοσκόταδο	m i s o s k o t a ð o
μνήμα	m n i m a
μνήμες	m n i m e s
μνημών	m n i m o n
μοίρα	m i r a
μοιάζω	m ɲ a z o
μοιράζομαι	m i ɾ a z o m e
μοιράζω	m i ɾ a z o
μοιράστηκα	m i ɾ a s t i k a
μοιρασμένες	m i ɾ a z m e n e s
μοιρασμένη	m i ɾ a z m e n i
μολύβι	m ɔ l i v i
μονάρχες	m o n a r ç e s
μονάρχη	m o n a r ç i
μονάρχης	m o n a r ç i s
μοναξιά	m o n a k s ç a
μοναρχών	m o n a r x o n
μοναχός	m o n a x o s
μοντέλο	m o d e l o
μορφέα	m ɔ r f ɛ a
μουνάκι	m u n a c i
μουνάρα	m u n a ɾ a
μουνί	m u n i
μουντή	m u n d i
μουντός	m u n d o s
μουνόψειρα	m u n o p s i ɾ a
μουσκεμένα	m u s c e m e n a
μουσκεμένο	m u s c e m e n o
μουσκεμένοι	m u s c e m e n i
μουσκεμένους	m u s c e m e n u s
μουσκεύω	m u s c e v o
μουσμουλιά	m u z m u ʎ a
μοχλός	m ɔ x l ɔ s
μπάνιο	b a ɲ o
μπάντα	b a n d a
μπάρκαρα	b a ɾ k a ɾ a
μπάρμπας	b a ɾ b a
μπέρδεψα	b e ɾ ð e p s a
μπαμπάς	b a b a s
μπαμπούλας	b a b u l a s
μπανιέρα	b a ɲ e ɾ a
μπαρδόν	b a ɾ ð o n
μπαρκάριζα	b a ɾ k a ɾ i z a
μπαρκάριζε	b a ɾ k a ɾ i z e
μπαρκάρισε	b a ɾ k a ɾ i s e
μπερδεμένα	b e ɾ ð e m e n a
μπερδεμένες	b e ɾ ð e m e n e s
μπερδεμένη	b e ɾ ð e m e n i
μπερδεμένο	b e ɾ ð e m e n o
μπερδεμένοι	b e ɾ ð e m e n i
μπερδεμένος	b e ɾ ð e m e n o s
μπερδεμένους	b e ɾ ð e m e n u s
μπερδεύτηκα	b e ɾ ð e f t i k a
μπερδεύω	b e ɾ ð e v o
μπινελίκι	b i n e l i c i
μπλουζάκι	b l u z a c i
μπογάζι	b o ɣ a z i
μπογιατζής	b o ʝ a n d z i s
μπομπότα	b o b o t a
μπουγάζι	b u ɣ a z i
μπουζί	b u z i
μποϊκοτάρω	b o i k o t a ɾ o
μπούρδα	b u ɾ ð a
μπούρδας	b u ɾ ð a s
μπόλικος	b o l i k o s
μυγοπαγίδα	m i ɣ o p a ʝ i ð a
μυγοσκοτώστρα	m i ɣ o s k o t o s t ɾ a
μυθολογία	m i θ o l o ʝ i a
μυκήνες	m i c i n e s
μυκόνου	m i k o n u
μυρωδιά	m i ɾ o ð ʝ a
μυρωμένη	m i r o m e n i
μυταράς	m i t a ɾ a s
μυτιλήνη	m i t i l i n i
μυτούλα	m i t u l a
μωάμεθ	m o a m e θ
μωρέ	m o ɾ e
μύγα	m i ɣ a
μύκονο	m i k o n o
μύκονος	m i k o n o s
μύλο	m i l o
μύξα	m i k s a
μύριοι	m i ɾ ʝ i
μύρρο	m i ɾ o
μύτη	m i t i
νάζι	n a z i
νάνου	n a n u
νάνων	n a n o n
νάουσα	n a u s a
νέο	n e o
νήστεψα	n i s t e p s a
νατο	n a t o
ναυς	n a f s
ναυσικά	n a f s i k a
ναυσικάς	n a f s i k a s
ναυτολογίων	n a f t o l o ʝ i o n
ναύπακτο	n a f p a k t o
ναύπλιο	n a f p l i o
νεβάδα	n e v a ð a
νεκρή	n e k ɾ i
νεκροί	n e k ɾ i
νεκροκεφαλή	n e k ɾ o c e f a l i
νεκροστάσιο	n e k ɾ o s t a s i o
νεκροταφείο	n ɛ k ɾ o t a f i o
νεκροτομή	n e k ɾ o t o m i
νεκροτομείο	n e k ɾ o t o m i o
νεκρό	n e k ɾ o
νεκρός	n e k ɾ o s
νεοελληνικά	n e o e l i n i k a
νεοελληνική	n e o e l i n i c i
νεοζηλανδή	n e o z i l a n ð i
νεποτισμός	n e p o t i z m o s
νερό	n e r o
νηστικός	n i s t i k o s
νι	n i
νιάτα	ɲ a t a
νικήτρια	n i c i t ɾ i a
νοητός	n o i t o s
νοιάζει	ɲ a z i
νοιάζομαι	ɲ a z o m e
νομίζω	n o m i z o
νοσοκομείο	n ɔ s ɔ k ɔ m i ɔ
νοστιμεύω	n o s t i m e v o
ντίνα	d i n a
ντίνος	d i n o s
ντε	d e
ντελιβεράδες	d e l i v e r a ð e s
ντελιβεράς	d e l i v e r a s
ντεντέκτιβ	d e d e k t i v
ντετερμινισμοί	d e t e r m i n i z m i
ντετερμινισμό	d e t e r m i n i z m o
ντετερμινισμός	d e t e r m i n i z m o s
ντετερμινισμών	d e t e r m i n i z m o n
ντο	d o
ντουζ	d u z
ντουλάπα	d u l a p a
ντουλάπι	d u l a p i
ντουμπλάρισε	d u b l a ɾ i s e
ντους	d u s
ντροπή	d ɾ o p i
ντροπαλά	d ɾ o p a l a
ντροπαλή	d ɾ o p a l i
ντροπαλοί	d ɾ o p a l i
ντροπιασμένα	d ɾ o p ç a z m e n a
ντροπιασμένοι	d ɾ o p ç a z m e n i
ντροπιασμένου	d ɾ o p ç a z m e n u
ντόρα	d o ɾ a
νυστάζω	n i s t a z o
νυχτερίδα	n i x t ɛ ɾ i ð a
νωθρός	n o θ ɾ o s
νόθος	n o θ o s
νόσο	n o s o
νόσου	n o s u
νόστιμος	n o s t i m o s
ξάσπρισα	k s a s p r i s a
ξέκωλη	k s e k o l i
ξέλυσα	k s e l i s a
ξένη	k s e n i
ξένης	k s e n i s
ξένια	k s e ɲ a
ξέροντας	k s e ɾ o n d a s
ξαναγράφω	k s a n a ɣ ɾ a f o
ξαναμοίρασα	k s a n a m i ɾ a s a
ξαπλώνω	k s a p l o n o
ξαποσταίνω	k s a p o s t e n o
ξεκινάω	k s e c i n o
ξεκωλιάζομαι	k s e k o ʎ a z o m e
ξεκωλιάρης	k s e k o ʎ a ɾ i s
ξεμπέρδεψα	k s e b e ɾ ð e p s a
ξενέρωτος	k s e n e ɾ o t o s
ξενιτειά	k s e n i t ʝ a
ξενιτιά	k s e n i t ʝ a
ξενοδόχος	k s e n o ð o x o s
ξερόψωμων	k s e r o p s o m o n
ξεσπίτωμα	k s e s p i t o m a
ξεχνώ	k s e x n o
ξι	k s i
ξινό	k s i n o
ξοδεύομαι	k s o ð e v o m e
ξοδεύω	k s o ð e v o
ξυπόλυτος	k s i p o l i t o s
ξωτικό	k s o t i k o
ξύλα	k s i l a
ξύλο	k s i l o
ξύνω	k s i n o
οίκος	i k o s
οδοί	o ð i
οδού	o ð u
οδούς	o ð u s
οδό	o ð o
οδών	o ð o n
οικογένεια	i k ɔ ʝ ɛ n i a
οικοδομικός	i k o ð o m i k o s
οικονόμος	i k o n o m o s
οινόπνευμα	i n o p n e v m a
οκτακόσια	o k t a k o s ç a
οκτώ	o k t o
ολάκερος	o l a c e r o s
ολόκληρος	o l o k l i r o s
ολόφωτα	o l o f o t a
ολόφωτης	o l o f o t i s
ολόφωτο	o l o f o t o
ολόφωτους	o l o f o t u s
ομοβροντία	o m o v ɾ o n d i a
ομολογώ	o m o l o ɣ o
ομοφυλόφιλος	o m o f i l o f i l o s
ομοφωνία	o m o f o n i a
ον	o n
ονομάζομαι	o n o m a z o m e
ονομάζομε	o n o m a z o m e
ονομάζουμε	o n o m a z u m e
ονομάζω	o n o m a z o
ονομάστηκα	o n o m a s t i k a
οπίου	o p i u
οπερέτα	o p e ɾ e t a
οποίου	o p i u
ορίζομαι	o ɾ i z o m e
ορίζουμε	o ɾ i z u m e
ορίζω	o ɾ i z o
ορίστε	o ɾ i s t e
οραματίζομαι	o ɾ a m a t i z o m e
οραματίστηκα	o ɾ a m a t i s t i k a
οργή	o r ʝ i
ορεστιάδα	o ɾ e s t i a ð a
ορθογραφία	o ɾ θ o ɣ ɾ a f i a
ορθόδοξα	o ɾ θ o ð o k s a
ορθόδοξη	o ɾ θ o ð o k s i
ορθόδοξοι	o ɾ θ o ð o k s i
ορθόδοξος	o ɾ θ o ð o k s o s
οριστικά	o ɾ i s t i k a
οριστική	o ɾ i s t i c i
ορμούζ	o r m u z
οσάκα	o s a k a
οστεοφυλάκιο	o s t e o f i l a c i o
ουαλία	u a l i a
ουγκιά	u ŋ ɟ a
ουδαμού	u ð a m u
ουλή	u l i
ουστ	u s t
οφείλω	o f i l o
οφειλέτης	o f i l e t i s
οφθαλμός	o f θ a l m o s
οφιοειδούς	o f i o i ð u s
οφιοειδών	o f i o i ð o n
ούτως	u t o s
πάγκος	p a ŋ ɡ o s
πάγκρεας	p a ŋ ɡ ɾ e a s
πάγος	p a ɣ o s
πάμμαυροι	p a m a v ɾ i
πάνσοφος	p a n s o f o s
πάριζα	p a ɾ i z a
πάρκινσον	p a ɾ c i n s o n
πάτρα	p a t ɾ a
πέδιλο	p e ð i l o
πέθανε	p e θ a n e
πέμπουμε	p e m b u m e
πέμπω	p e m b o
πέος	p e o s
πέρας	p e ɾ a s
πέρδομαι	p e ɾ ð o m e
πέσαχ	p e s a x
πέταμα	p e t a ɣ m a
πέτρος	p e t ɾ o s
πίεσα	p i e s a
πίθο	p i θ o
πίθος	p i θ o s
πίθους	p i θ u s
πίνομε	p i n o m e
πίνω	p i n o
πίπα	p i p a
πίστεψα	p i s t e p s a
πίστεψε	p i s t e p s e
πίσω	p i s o
πίτα	p i t a
πίτας	p i t a s
πίτες	p i t e s
παίζουμε	p e z u m e
παγκάκι	p a ŋ ɡ a c i
παγκοσμιοποίηση	p a ŋ ɡ o z m i o p i i s i
παγκοσμιοποίησης	p a ŋ ɡ o z m i o p i i s i s
παγωμένα	p a ɣ o m e n a
παγωμένες	p a ɣ o m e n e s
παγωμένη	p a ɣ o m e n i
παγωμένοι	p a ɣ o m e n i
παγωμένος	p a ɣ o m e n o s
παγωμένου	p a ɣ o m e n u
παγωμένους	p a ɣ o m e n u s
παγωμένων	p a ɣ o m e n o n
παγωνιά	p a ɣ o ɲ a
παθαίνω	p a θ e n o
παιδί	p e ð i
παιδεραστία	p e ð e ɾ a s t i a
παιδότοπος	p e ð o t o p o s
πακέτο	p a c e t o
πακετάρω	p a c e t a ɾ o
παλιάτσος	p a ʎ a t s o s
παλιόγρια	p a ʎ o ɣ ɾ i a
παλτό	p a l t o
παμφάγος	p a ɱ f a ɣ o s
παναγιώτατος	p a n a ʝ i o t a t o s
πανεύκολα	p a n e f k o l a
πανεύκολος	p a n e f k o l o s
πανηγύρι	p a n i ʝ i ɾ i
πανικοβάλλομαι	p a n i k o v a l o m e
πανταχού	p a n d a x u
παντελής	p a n d e l i s
παντού	p a n d u
παντρεμένα	p a n d ɾ e m e n a
παντρεμένες	p a n d ɾ e m e n e s
παντρεμένη	p a n d ɾ e m e n i
παντρεμένο	p a n d ɾ e m e n o
παντρεμένοι	p a n d ɾ e m e n i
παντρεμένος	p a n d ɾ e m e n o s
παντρεμένου	p a n d ɾ e m e n u
παντρεμένους	p a n d ɾ e m e n u s
παντρεμένων	p a n d ɾ e m e n o n
παντρεύομαι	p a n d ɾ e v o m e
παντρεύτηκα	p a n d ɾ e f t i k a
παοκ	p a o k
παπάρι	p a p a ɾ i
παπαγάλος	p a p a ɣ a l ɔ s
παππούς	p a p u s
παράξενα	p a ɾ a k s e n a
παράξενος	p a ɾ a k s e n o s
παρέβλεψα	p a ɾ e v l e p s a
παρέκαμψε	p a ɾ e k a m p s e
παρέλαβα	p a ɾ e l a v a
παρέρχομαι	p a ɾ e ɾ x o m e
παρίσι	p a ɾ i s i
παραβάλλω	p a ɾ a v a l o
παραβάλομε	p a ɾ a v a l o m e
παραβλέπομαι	p a ɾ a v l e p o m e
παραβλέπω	p a ɾ a v l e p o
παραδέχομαι	p a ɾ a ð e x o m e
παραδέχτηκα	p a ɾ a ð e x t i k a
παραδεκτή	p a ɾ a ð e k t i
παραδεχτός	p a ɾ a ð e x t o s
παρακάμψεις	p a ɾ a k a m p s i s
παρακαλάω	p a r a k a l a o
παρακαλώ	p a r a k a l o
παρακείμενα	p a r a c i m e n a
παρακείμενε	p a r a c i m e n e
παρακείμενη	p a ɾ a c i m e n i
παρακείμενο	p a ɾ a c i m e n o
παρακείμενος	p a ɾ a c i m e n o s
παρακείμενου	p a ɾ a c i m e n u
παρακείμενους	p a ɾ a c i m e n u s
παρακείμενων	p a ɾ a c i m e n o n
παρακειμένου	p a r a c i m e n u
παραλίγο	p a ɾ a l i ɣ o
παραμύθι	p a ɾ a m i θ i
παραξενιά	p a ɾ a k s e ɲ a
παραπάνω	p a ɾ a p a n o
παραπέμπομε	p a ɾ a p e m b o m e
παραπέμπουμε	p a ɾ a p e m b u m e
παραπέμπω	p a ɾ a p e m b o
παρασκευάζομαι	p a ɾ a s c e v a z o
παρασκευάζω	p a ɾ a s c e v a z o
παρατράγουδο	p a ɾ a t ɾ a ɣ u ð o
παρεκτρέπουμε	p a ɾ e k t ɾ e p u m e
παρελθούσα	p a r e l θ u s a
παρελθούσας	p a r e l θ u s a s
παρελθούσες	p a ɾ e l θ u s e s
παρελθούσης	p a r e l θ u s i s
παρελθόν	p a r e l θ o n
παρελθόντα	p a r e l θ o n d a
παρελθόντες	p a ɾ e l θ o n d e s
παρελθόντος	p a r e l θ o n d o s
παρελθόντων	p a r e l θ o n d o n
παρεξήγηση	p a ɾ e k s i ʝ i s i
παρεξετράπη	p a ɾ e k s e t ɾ a p i
παρεστιγμένη	p a ɾ e s t i ɣ m e n i
παρετυμολογία	p a ɾ e t i m o l o ʝ i a
παριστάνω	p a r i s t a n o
παρκάριζε	p a ɾ k a ɾ i z e
παρκάρισε	p a ɾ k a ɾ i s e
παρκάρω	p a ɾ k a ɾ o
παροιμία	p a ɾ i m i a
πας	p a s
πασαλείφω	p a s a l i f o
πασοκ	p a s o k
πασχαλίτσα	p a s x a l i t s a
πατάω	p a t a o
πατέρα	p a t e r a
πατέρας	p a t e r a s
πατέρες	p a t e r e s
πατέρων	p a t e r o n
πατεράδες	p a t e r a ð e s
πατρίδα	p a t r i ð a
πατσαβούρα	p a t s a v u ɾ a
πατσαβούρας	p a t s a v u ɾ a s
πατσαβούρες	p a t s a v u ɾ e s
παυλάκης	p a v l a c i s
παϊδάκι	p a i ð a c i
παϊδάκια	p a i ð a c a
παύλος	p a v l o s
παύω	p a v o
πείθομαι	p i θ o m e
πείσω	p i s o
πεθαμένα	p e θ a m e n a
πεθαμένη	p e θ a m e n i
πεθαμένης	p e θ a m e n i s
πεθαμένο	p e θ a m e n o
πεθαμένοι	p e θ a m e n i
πεθαμένος	p e θ a m e n o s
πεθαμένου	p e θ a m e n u
πεθαμένους	p e θ a m e n u s
πεθερικά	p e θ e ɾ i k a
πεθερός	p e θ e ɾ o s
πειθαναγκάζουμε	p i θ a n a ŋ ɡ a z u m e
πειθόμενη	p i θ o m e n i
πειθόμενοι	p i θ o m e n i
πειθόμενου	p i θ o m e n u
πειράζει	p i ɾ a z i
πειραματίζομαι	p i ɾ a m a t i z o m e
πειραματόζωο	p i r a m a t o z o o
πειρατής	p i r a t i s
πεισμένες	p i z m e n e s
πεισμένοι	p i z m e n i
πεισμένος	p i z m e n o s
πενήντα	p e n i n d a
πεντάγωνο	p e n d a ɣ o n o
πεντήκοντα	p e n d i k o n d a
πεντακόσια	p e n d a k o s ç a
πεολειχία	p e o l i ç i a
πεπεισμένες	p e p i z m e n e s
πεπεισμένη	p e p i z m e n i
πεπεισμένο	p e p i z m e n o
πεπεισμένων	p e p i z m e n o n
περήφανος	p e r i f a n o s
περίοδε	p e r i o ð e
περίοδο	p e r i o ð o
περίοδοι	p e r i o ð i
περίοδος	p e r i o ð o s
περίπλου	p e r i p l u
περίπλους	p e r i p l u s
περίπτωση	p e ɾ i p t o s i
περασμένα	p e r a z m e n a
περασμένες	p e r a z m e n e s
περασμένη	p e r a z m e n i
περασμένης	p e r a z m e n i s
περασμένο	p e r a z m e n o
περασμένοι	p e r a z m e n i
περασμένου	p e r a z m e n u
περασμένους	p e r a z m e n u s
περασμένων	p e r a z m e n o n
περηφάνια	p e r i f a ɲ a
περιέγραψα	p e ɾ i e ɣ r a p s a
περιέστρεψα	p e ɾ i e s t ɾ e p s a
περιήγηση	p ɛ ɾ i i ʝ i s i
περιγράφουμε	p e ɾ i ɣ r a f u m e
περιγράφω	p e ɾ i ɣ r a f o
περιεπλάκην	p e ɾ i e p l a c i n
περιεπλάκησαν	p e ɾ i e p l a c i s a n
περικλείουμε	p e r i k l i u m e
περιμένω	p e r i m e n o
περιοδικά	p e r i o ð i k a
περιοδικέ	p e r i o ð i c e
περιοδικές	p e r i o ð i c e s
περιοδική	p e r i o ð i c i
περιοδικής	p e r i o ð i c i s
περιοδικού	p e r i o ð i k u
περιοδικό	p e r i o ð i k o
περιοδικός	p e r i o ð i k o s
περιοδικών	p e r i o ð i k o n
περιορισμένος	p e ɾ i o ɾ i z m e n o s
περιπλέκουμε	p e ɾ i p l e k u m e
περιπλέχτηκαν	p e ɾ i p l e x t i k a n
περιπλέχτηκε	p e ɾ i p l e x t i c e
περισπωμένες	p e r i s p o m e n e s
περιόδου	p e r i o ð u
περιόδους	p e r i o ð u s
περιόδων	p e r i o ð o n
περσέα	p e ɾ s e a
περσέας	p e r s e a s
περσεύς	p e r s e f s
πετάγομαι	p e t a ɣ o m e
πετράκης	p e t ɾ a c i s
πηγαινέλα	p i ʝ e n e l a
πι	p i
πιάνομαι	p ç a n o m e
πιέζω	p i e z o
πιθάρι	p i θ a r i
πιθάρια	p i θ a r ʝ a
πιθανότητα	p i θ a n o t i t a
πιθαριού	p i θ a r ʝ u
πιθαριών	p i θ a r ʝ o n
πικάπ	p i k a p
πιλόταρε	p i l o t a ɾ e
πινακοθήκη	p i n a k o θ i c i
πιονιού	p ç o ɲ u
πιπί	p i p i
πιπεριά	p i p e r ʝ a
πιροσκί	p i r o s k i
πιστεύεται	p i s t e v e t e
πιστεύομε	p i s t e v o m e
πιστεύουμε	p i s t e v u m e
πιστεύω	p i s t e v o
πισωκολλητό	p i s o k o l i t o
πιτσαδόρος	p i t s a ð o ɾ o s
πιόνι	p ç o n i
πλάγιασα	p l a ʝ a s a
πλέκουμε	p l e k u m e
πλέον	p l e o n
πλέχτηκα	p l e x t i k a
πλέω	p l e o
πλήρωσα	p l i ɾ o s a
πλίνθοι	p l i n θ i
πλίνθους	p l i n θ u s
πλίνθων	p l i n θ o n
πλαγίασα	p l a ʝ i a s a
πλακούντας	p l a k u n d a s
πλατιά	p l a t ç a
πλειστάκις	p l i s t a c i s
πλειστηριασμός	p l i s t i r i a z m o s
πληθυντικός	p l i θ i n d i k ɔ s
πληθυσμός	p l i θ i z m o s
πληροφορική	p l i r o f o r i c i
πληρώνομαι	p l i ɾ o n o m e
πλησίασα	p l i s i a s a
πλησιάζομαι	p l i s i a z o m e
πλησιάζουμε	p l i s i a z u m e
πλησιάζω	p l i s i a z o
πλησιάστηκα	p l i s i a s t i k a
πλοίο	p l i ɔ
πλούσιος	p l u s i o s
πλύσιμο	p l i s i m o
πνέω	p n e o
πνίγω	p n i ɣ o
πνεύμα	p n e v m a
ποίηση	p i i s i
ποίησης	p i i s i s
ποδάρι	p o ð a ɾ i
ποδάρια	p o ð a ɾ ʝ a
ποδαρίλα	p o ð a ɾ i l a
ποδαριού	p o ð a ɾ ʝ u
ποδοσφαίρου	p o ð o s f e r u
ποδοσφαιριστής	p o ð o s f e ɾ i s t i s
ποδόσφαιρο	p o ð o s f e r o
ποδόσφαιρου	p o ð o s f e r u
ποιήσεως	p i i s e o s
ποικίλα	p i c i l a
ποικίλες	p i c i l e s
ποικίλη	p i c i l i
ποικίλης	p i c i l i s
ποικίλος	p i c i l o s
ποικίλου	p i c i l u
ποικίλους	p i c i l u s
ποικίλων	p i c i l o n
ποικιλότατων	p i c i l o t a t o n
ποικιλότερο	p i c i l o t e r o
ποιος	p ç o s
πολιτιστικός	p o l i t i s t i k o s
πολυμήχανος	p o l i m i x a n o s
πολωνή	p o l o n i
πολωνικά	p o l o n i k a
πολωνικές	p o l o n i c e s
πολωνική	p o l o n i c i
πολωνικής	p o l o n i c i s
πολωνικού	p o l o n i k u
πολωνικό	p o l o n i k o
πολωνός	p o l o n o s
πολύ	p o l i
πομφολύγων	p o ɱ f o l i ɣ o n
πομφόλυγα	p o ɱ f o l i ɣ a
πομφόλυξ	p o ɱ f o l i x
ποντάρισε	p o n d a ɾ i s e
ποντάρω	p o n d a r o
ποντίκι	p o n d i c i
ποντικός	p o n d i k o s
ποπός	p o p o s
πορδή	p o ɾ ð i
πορνεία	p o ɾ n i a
πορτοκάλι	p o ɾ t o k a l i
πορτοκαλιά	p o ɾ t o k a ʎ a
πορτοκαλόπιτα	p o ɾ t o k a l o p i t a
πουθενά	p u θ e n a
πουλάκι	p u l a c i
πουλάρι	p u l a ɾ i
πουλί	p u l i
πουσταριό	p u s t a ɾ ʝ o
πουτάνα	p u t a n a
πούλι	p u l i
πούτσος	p u t s o s
πράσινος	p ɾ a s i n o s
πρέζα	p ɾ e z a
πρήζω	p ɾ i z o
πρήξιμο	p ɾ i k s i m o
πρεζόνι	p ɾ e z o n i
πρεσβευτής	p ɾ e z v e f t i s
πρησμένε	p ɾ i z m e n e
πρησμένη	p ɾ i z m e n i
πρησμένος	p ɾ i z m e n o s
προέβλεψα	p ɾ o e v l e p s a
προέκυψε	p r o e c i p s e
προέρχομαι	p r o e r x o m e
προαγωγή	p ɾ o a ɣ o ʝ i
προαλείφομαι	p ɾ o a l i f o m e
προβλέπουμε	p ɾ o v l e p u m e
προβλέπω	p ɾ o v l e p o
προετοιμάζομαι	p ɾ o e t i m a z o m e
προετοιμάζω	p ɾ o e t i m a z o
προετοιμασία	p ɾ o e t i m a s i a
προηγουμένη	p r o i ɣ u m e n i
προηγουμένων	p r o i ɣ u m e n o n
προηγούμενα	p r o i ɣ u m e n a
προηγούμενες	p r o i ɣ u m e n e s
προηγούμενη	p r o i ɣ u m e n i
προηγούμενης	p r o i ɣ u m e n i s
προηγούμενο	p r o i ɣ u m e n o
προηγούμενοι	p r o i ɣ u m e n i
προηγούμενος	p ɾ o i ɣ u m e n o s
προηγούμενου	p r o i ɣ u m e n u
προηγούμενους	p r o i ɣ u m e n u s
προηγούμενων	p r o i ɣ u m e n o n
προκαταβάλουμε	p ɾ o k a t a v a l u m e
προκοπή	p ɾ o k o p i
προμηθέα	p r o m i θ e a
προμηθέας	p r o m i θ e a s
προμηθεύομαι	p ɾ ɔ m i θ e v o m e
προμηθεύτηκα	p ɾ ɔ m i θ e f t i k a
προπονήσεις	p r o p o n i s i s
προπονήσεων	p r o p o n i s e o n
προπόνηση	p r o p o n i s i
προπόνησης	p r o p o n i s i s
προσήλθα	p r o s i l θ a
προσβλέπω	p ɾ o s v l e p o
προσγειώνω	p ɾ o z ʝ i o n o
προσγράφομε	p ɾ o z ɣ r a f o m e
προσγράφτηκα	p ɾ o z ɣ r a f t i k a
προσελκύομαι	p r o s e l c i o m e
προσελκύουμε	p r o s e l c i u m e
προσευχή	p ɾ o s e f ç i
προσθήκη	p r o s θ i c i
προσκρούω	p r o s k r u o
προσοχή	p ɾ o s o ç i
προσπαθώντας	p ɾ o s p a θ o n d a s
προστατευόμενος	p ɾ o s t a t e v o m e n o s
προσφέρουμε	p ɾ o s f e ɾ u m e
προσφέρω	p ɾ o s f e ɾ o
προτρέπω	p ɾ o t ɾ e p o
προφτάνω	p ɾ ɔ f t a n o
προϊόν	p ɾ o i o n
πρωκτικός	p ɾ o k t i k o s
πρωτάθλημα	p ɾ o t a θ l i m a
πρωταγωνιστές	p ɾ o t a ɣ o n i s t e s
πρωταγωνιστή	p ɾ o t a ɣ o n i s t i
πρωταγωνιστής	p ɾ o t a ɣ o n i s t i s
πρωταγωνιστών	p ɾ o t a ɣ o n i s t o n
πρωταθλήτρια	p ɾ o t a θ l i t ɾ i a
πρωταθλητής	p ɾ o t a θ l i t i s
πρωταπριλιά	p ɾ o t a p ɾ i ʎ a
πρωτεύον	p ɾ ɔ t ɛ v o n
πρωτεύουσα	p ɾ ɔ t ɛ v u s a
πρωτεύων	p ɾ ɔ t e v o n
πρωτοβουλία	p ɾ o t o v u l i a
πρωτομαγιά	p ɾ o t o m a ʝ a
πρωτοχρονιά	p ɾ o t o x ɾ o ɲ a
πρωτόγονος	p ɾ o t o ɣ o n o s
πρωτότυπος	p ɾ o t o t i p o s
πρόβλεψα	p r o v l e p s a
πρόβλημα	p r ɔ v l i m a
πρόεδρος	p ɾ o e ð ɾ o s
πρόκειται	p ɾ o c i t e
πρόσφερα	p ɾ o s f e ɾ a
πρώτος	p ɾ o t o s
πυροτέχνημα	p i ɾ o t e x n i m a
πυροφάνι	p i ɾ o f a n i
πως	p o s
πόδι	p o ð i
πόλη	p o l i
πόνταρα	p o n d a ɾ a
πόνταρε	p o n d a ɾ e
πόρνη	p ɔ ɾ n i
πόροι	p o r i
πότε	p o t e
πύο	p i o
πύον	p i o n
πύργο	p i r ɣ o
πύργοι	p i r ʝ i
πύργος	p i r ɣ o s
πύργου	p i r ɣ u
πύργους	p i r ɣ u s
πύργων	p i r ɣ o n
πώς	p o s
ράβομαι	ɾ a v o m e
ρέθυμνο	ɾ e θ i m n o
ρέπω	ɾ e p o
ρίχνομαι	ɾ i x n o m e
ρίχνω	ɾ i x n o
ραγιά	ɾ a ʝ a
ραγιάδων	ɾ a ʝ a ð o n
ραγιάς	ɾ a ʝ a s
ραμολιμέντο	ɾ a m o l i m e n d o
ρε	ɾ e
ρεζίλι	ɾ e z i l e
ρετσίνα	ɾ e t s i n a
ρεφρέν	r e̞ f r e̞ n
ροβέρτος	ɾ o v e ɾ t o s
ροδάκινα	r o ð a c i n a
ροδάκινο	r o ð a c i n o
ροδάκινου	r o ð a c i n u
ροδάκινων	r o ð a c i n o n
ροδακίνου	r o ð a c i n u
ροδακίνων	r o ð a c i n o n
ροδιά	ɾ o ð ʝ a
ροπή	ɾ o p i
ρουθούνι	ɾ u θ u n i
ροχάλισμα	ɾ o x a l i z m a
ροχαλίζω	ɾ o x a l i z o
ροχαλητό	ɾ o x a l i t o
ρωμαίος	ɾ o m e o s
ρόγα	r o ɣ a
ρόδι	ɾ o ð i
ρόδο	ɾ o ð o
ρόδος	ɾ o ð o s
ρόζος	r o z o s
ρόμπερτ	ɾ o b e ɾ t
ρώμη	ɾ o m i
σάλεψα	s a l e p s a
σάλεψε	s a l e p s e
σάλος	s a l o s
σάλταρε	s a l t a ɾ e
σάπιος	s a p ç o s
σέβομαι	s e v o m e
σέντερ	s e n d e ɾ
σέρνομαι	s e r n o m e
σέρνω	s e r n o
σέρρες	s e ɾ e s
σίγμα	s i ɣ m a
σίγουρος	s i ɣ u ɾ o s
σαγηνευτικός	s a ʝ i n ɛ f t i k ɔ s
σαγηνεύθηκα	s a ʝ i n e f θ i k a
σαγιονάρα	s a ʝ o n a ɾ a
σαλαμίνα	s a l a m i n a
σαλτάρισα	s a l t a ɾ i s a
σαντορίνη	s a n d o ɾ i n i
σαντουριού	s a n d u r ʝ u
σαντούρι	s a n d u r i
σαντούρια	s a n d u r ʝ a
σαπουνίζω	s a p u n i z o
σαράντα	s a ɾ a n d a
σαχλαμάρα	s a x l a m a ɾ a
σβήνω	z v i n o
σεβαστιανός	s e v a s t ç a n o s
σερβίριζα	s e ɾ v i ɾ i z a
σερβίρισε	s e ɾ v i ɾ i s e
σερβίρω	s e ɾ v i ɾ o
σερβιέτα	s e ɾ v i e t a
σηκωμάρα	s i k o m a ɾ a
σημάδεψα	s i m a ð e p s a
σημάδι	s i m a ð i
σημάδια	s i m a ð ʝ a
σημαδεύω	s i m a ð e v o
σημαδιών	s i m a ð ʝ o n
σημασία	s i m a s i a
σημειωθήκαν	s i m i o θ i k a n
σημειώθηκα	s i m i o θ i k a
σημειώθηκαν	s i m i o θ i k a n
σημειώνουμε	s i m i o n u m e
σημειώνω	s i m i o n o
σιάτιστα	s ç a t i s t a
σιγκαπούρη	s i ŋ ɡ a p u ɾ i
σιταποθήκη	s i t a p o θ i c i
σιχαίνομαι	s i ç e n o m e
σιχτίρ	s i x t i ɾ
σκάνδαλο	s k a n ð a l o
σκάσε	s k a s e
σκέπτομαι	s c e p t o m e
σκέφθηκα	s c e f θ i k a
σκέφτηκα	s c e f t i k a
σκέφτομαι	s c e f t o m e
σκανδάλη	s k a n ð a l i
σκατά	s k a t a
σκατό	s k a t o
σκληρή	s k l i r i
σκληρός	s k l i ɾ o s
σκοντάβω	s k o n d a v o
σκοντάφτω	s k o n d a f t o
σκορδόψωμων	s k o ɾ ð o p s o m o n
σκοτώνω	s k o t o n o
σκοτώστρα	s k o t o s t ɾ a
σκουλήκι	s k u l i c i
σκυλάδικο	s c i l a ð i k o
σκυλί	s c i l i
σκυλίτσα	s c i l i t s a
σκυλολόι	s c i l o l o
σκωτία	s k ɔ t i a
σκόπια	s k o p ç a
σκύβω	s c i v o
σκύλα	s c i l a
σκύλος	s c i l o s
σοκάκι	s o k a c i
σοροί	s o ɾ i
σορού	s o ɾ u
σορούς	s o ɾ u s
σορό	s o ɾ o
σορός	s o ɾ o s
σουίτα	s u i t a
σουβλατζίδικο	s u v l a d z i ð i k o
σοφά	s o f a
σοφάδων	s o f a ð o n
σοφέ	s o f e
σοφές	s o f e s
σοφή	s o f i
σοφία	s o f i a
σοφίαν	s o f i a n
σοφίας	s o f i a s
σοφιών	s o f i o n
σοφοί	s o f i
σοφού	s o f u
σοφούς	s o f u s
σοφό	s o f o
σοφότερο	s o f o t e ɾ o
σοφότερος	s o f o t e ɾ o s
σούρνω	s u r n o
σούταρε	s u t a ɾ e
σπάρτη	s p a ɾ t i
σπάρτο	s p a ɾ t o
σπέτσες	s p e t s e s
σπίθιζε	s p i θ i z e
σπίτι	s p i t i
σπιτάκι	s p i t a c i
σπρώχνω	s p ɾ o x n o
στάζει	s t a z i
στάζουμε	s t a z u m e
στάζω	s t a z o
στάνη	s t a n i
στέλιος	s t e ʎ o s
στέλλα	s t e l a
στέλνω	s t e l n o
στέμμα	s t e m a
στέρηση	s t e ɾ i s i
στέρησης	s t e ɾ i s i s
στέψεις	s t e p s i s
στήθος	s t i θ o s
στα	s t a
σταγόνα	s t a ɣ o n a
σταγόνας	s t a ɣ o n a s
σταγόνες	s t a ɣ o n e s
σταγόνων	s t a ɣ o n o n
σταγών	s t a ɣ o n
σταθμός	s t a θ m o s
σταμάτης	s t a m a t i s
σταματία	s t a m a t i a
σταυροφορία	s t a v ɾ ɔ f ɔ ɾ i a
σταυρός	s t a v r o s
σταφιδόψωμα	s t a f i ð o p s o m a
σταφιδόψωμο	s t a f i ð o p s o m o
σταφιδόψωμου	s t a f i ð o p s o m u
στείρος	s t i ɾ o s
στείρωση	s t i ɾ o s i
στειμμένα	s t i m e n a
στειμμένοι	s t i m e n i
στειμμένους	s t i m e n u s
στειρότητα	s t i ɾ o t i t a
στειρώσεις	s t i ɾ o s i s
στεναγμός	s t e n a ɣ m o s
στεναχωρήθηκα	s t e n a x o r i θ i k a
στεναχωρημένες	s t e n a x o r i m e n e s
στεναχωρημένη	s t e n a x o r i m e n i
στεναχωρημένος	s t e n a x o r i m e n o s
στεναχωριέμαι	s t e n a x o r ʝ e m e
στενοχωρήθηκα	s t e n o x o r i θ i k a
στενοχωρημένα	s t e n o x o r i m e n a
στενοχωρημένες	s t e n o x o r i m e n e s
στενοχωρημένη	s t e n o x o r i m e n i
στενοχωρημένο	s t e n o x o r i m e n o
στενοχωρημένοι	s t e n o x o r i m e n i
στενοχωρημένος	s t e n o x o r i m e n o s
στενοχωριέμαι	s t e n o x o r ʝ e m e
στενοχωρώ	s t e n o x o r o
στενό	s t e n o
στερήσεις	s t e ɾ i s i s
στερήσεων	s t e ɾ i s e o n
στερούμε	s t e ɾ u m e
στεφάνη	s t e f a n i
στεφάνι	s t e f a n i
στηθοσκόπιο	s t i θ ɔ s k ɔ p j ɔ
στης	s t i s
στιβάδα	s t i v a ð a
στιγματισμένος	s t i ɣ m a t i z m e n o s
στις	s t i s
στολή	s t o l i
στον	s t o n
στοργή	s t o r ʝ i
στουτγάρδη	s t u t ɣ a r ð i
στοχάζομαι	s t o x a z o m e
στράφηκα	s t ɾ a f i k a
στρέφομαι	s t ɾ e f o m e
στρέφουμε	s t ɾ e f u m e
στρέφω	s t ɾ e f o
στρίβομαι	s t ɾ i v o m e
στρίβω	s t ɾ i v o
στρατοπέδου	s t ɾ a t o p e ð u
στρατοπέδων	s t ɾ a t o p e ð o n
στρατόπεδα	s t ɾ a t o p e ð a
στρατόπεδο	s t ɾ a t o p e ð o
στρατός	s t ɾ a t o s
στριμμένα	s t ɾ i m e n a
στριμμένης	s t ɾ i m e n i s
στριμμένο	s t ɾ i m e n o
στριμμένος	s t ɾ i m e n o s
στυλιανή	s t i ʎ a n i
στυλιανός	s t i ʎ a n o s
στων	s t o n
συγγενής	s i ŋ ɟ e n i s
συγγνώμη	s i ŋ ɣ n o m i
συγγράφει	s i ŋ ɣ r a f i
συγγράφομαι	s i ŋ ɣ r a f o m e
συγγραφέα	s i ŋ ɣ r a f e a
συγγραφέας	s i ŋ ɣ r a f e a s
συγγραφέων	s i ŋ ɣ r a f e o n
συγγραφέως	s i ŋ ɣ r a f e o s
συγγραφής	s i ŋ ɣ r a f i s
συγγραφεί	s i ŋ ɣ r a f i
συγγραφείς	s i ŋ ɣ r a f i s
συγκίνηση	s i ŋ ɟ i n i s i
συγκινημένα	s i ŋ ɟ i n i m e n a
συγκινημένε	s i ŋ ɟ i n i m e n e
συγκινημένοι	s i ŋ ɟ i n i m e n i
συγκινητικά	s i ŋ ɟ i n i t i k a
συγκινητική	s i ŋ ɟ i n i t i c i
συγκινούμαι	s i ŋ ɟ i n u m e
συγκρουόμενα	s i ŋ ɡ r u o m e n a
συγκρουόμενες	s i ŋ ɡ r u o m e n e s
συγκόπτομε	s i ŋ ɡ o p t o m e
συγκόπτουμε	s i ŋ ɡ o p t u m e
συγνώμη	s i ɣ n o m i
συγχάρηκε	s i ŋ x a ɾ i c e
συγχαίρω	s i ŋ ç e r o
συγχαρητήρια	s i ŋ x a ɾ i t i ɾ i a
συκοφάντης	s i k o f a n d i s
συλλέκτης	s i l e k t i s
συλλογίζομαι	s i l o ʝ i z o m e
συμβουλή	s i ɱ v u l i
συμβουλεύω	s i ɱ v u l e v o
συμβούλιο	s i ɱ v u l i o
συμπεριφέρομαι	s i m b e ɾ i f e ɾ o m e
συμπεριφορά	s i m b e ɾ i f o ɾ a
συμπλέω	s i m b l e o
συμπολεμιστής	s i m b o l e m i s t i s
συμπρωταγωνιστές	s i m b ɾ o t a ɣ o n i s t e s
συνέτριψα	s i n e t ɾ i p s a
συνέτριψε	s i n e t ɾ i p s e
συνέχεια	s i n e ç i a
συνήθης	s i n i θ i s
συνήθως	s i n i θ o s
συναίρεση	s i n e r e s i
συναναστρέφομαι	s i n a n a s t ɾ e f o m e
συνδέομαι	s i n ð e o m e
συνδέσεις	s i n ð e s i s
συνδέω	s i n ð e o
συνδιασκέφθηκα	s i n ð i a s c e f θ i k a
συνδυάζουμε	s i n ð i a z u m e
συνεννοούμαι	s i n e n o u m e
συνεννόηση	s i n e n o i s i
συνετρίβη	s i n e t ɾ i v i
συνετρίβησαν	s i n e t ɾ i v i s a n
συνεχάρη	s i n e x a r i
συνεχάρησαν	s i n e x a ɾ i s a n
συνεχίζουμε	s i n e ç i z u m e
συνεχίζω	s i n e ç i z o
συνθετικά	s i n θ e t i k a
συνοδοί	s i n o ð i
συνοδού	s i n o ð u
συνοδούς	s i n o ð u s
συνοδό	s i n o ð o
συνοδός	s i n o ð o s
συνοδών	s i n o ð o n
συνουσία	s i n u s i a
συντρίφθηκε	s i n d r i f θ i c e
συντρίφτηκαν	s i n d r i f t i k a n
συντρίφτηκε	s i n d r i f t i c e
συντριπτικός	s i n d r i p t i k o s
συριζα	s i ɾ i z a
συριζαίος	s i ɾ i z e o s
σφαλιάρα	s f a ʎ a ɾ a
σφαλιαρίζω	s f a ʎ a ɾ i z o
σφαλιαρίτσα	s f a ʎ a ɾ i t s a
σφιχτά	s f i x t a
σφυρί	s f i r i
σφύριξα	s f i r i k s a
σχηματίστηκα	s ç i m a t i s t i k a
σχολίου	s x o l i u
σχολίων	s x o l i o n
σχόλιο	s x o l i o
σωκράτης	s o k ɾ a t i s
σωπαίνω	s o p e n o
σωρού	s o ɾ u
σωρούς	s o ɾ u s
σωρό	s o ɾ o
σωρός	s o ɾ o s
σωρών	s o ɾ o n
σόι	s o i
σύκο	s i k o
σύνδεσα	s i n ð e s a
σύννεφο	s i n ɛ f ɔ
σύνταξη	s i n d a k s i
σύντριψε	s i n d r i p s e
σύρω	s i r o
σώζω	s o z o
σώμα	s ɔ m a
σώπα	s o p a
σώπασε	s o p a s e
σώσε	s o s e
τάλαντο	t a l a n d o
τάρανδος	t a ɾ a n ð o s
τάραξα	t a r a k s a
τάφρο	t a f r o
τάφροι	t a f r i
τάφρος	t a f r o s
τάφρου	t a f r u
τάφρους	t a f r u s
τάφρων	t a f r o n
τάχα	t a x a
τάχατες	t a x a t e s
τέλειωσα	t e ʎ o s a
τέλι	t e l i
τέσσερις	t e s e ɾ i s
τέταρτο	t e t a ɾ t o
τέταρτος	t e t a ɾ t o s
τέχνη	t e x n i
τέως	t e o s
τήνε	t i n e
τήνο	t i n o
τήνος	t i n o s
τίνα	t i n a
τίνας	t i n a s
τίνος	t i n o s
τίσι	t i s i
ταίρι	t e r i
ταιριάζετε	t e r ʝ a z e t e
ταιριάζω	t e r ʝ a z o
ταλέντο	t a l e n d o
ταλαίπωρος	t a l e p o ɾ o s
ταλαιπωρία	t a l e p o ɾ i a
ταξιδεύω	t a k s i ð e v o
ταξιτζής	t a k s i n d z i s
ταπεινώνομαι	t a p i n o n o m e
ταράζω	t a r a z o
ταριχεύθηκα	t a ɾ i x e f θ i k a
τασάκι	t a s a c i
ταυ	t a f
ταχυδακτυλουργός	t a ç i ð a k t i l u ɾ ɣ o s
ταχυδρομείο	t a ç i ð ɾ o m i o
ταχυδρομικός	t a ç i ð ɾ o m i k o s
ταχυδρόμος	t a ç i ð ɾ o m o s
ταχυφαγείο	t a ç i f a ʝ i o
ταχύτητα	t a ç i t i t a
τείνομε	t i n o m e
τείνουμε	t i n u m e
τείνω	t i n o
τελευταία	t e l e f t e a
τελευταίος	t e l e f t e o s
τελευταίως	t e l e f t e o s
τετρακόσια	t e t ɾ a k o s ç a
τετριμμένες	t e t r i m e n e s
τετριμμένο	t e t r i m e n o
τετριμμένου	t e t r i m e n u
τετριμμένους	t e t r i m e n u s
τεχνολόγε	t e x n o l o ʝ e
τεχνολόγοι	t e x n o l o ʝ i
τεχνολόγος	t e x n o l o ɣ o s
τεχνολόγων	t e x n o l o ɣ o n
τζάμπα	t s a m b a
τζένη	d z e n i
τζατζίκι	d͡z a d͡z i c i
τζερτζελές	d z e ɾ d z e l e s
τζόρτζια	d z o ɾ d z i a
τηλεθέαση	t i l e θ e a s i
τηλεθεάτρια	t i l e θ e a t ɾ i a
τηλεθεατής	t i l e θ e a t i s
της	t i s
τιμή	t i m i
τιμολόγιο	t i m o l o ʝ o
τιμονιέρης	t i m o ɲ e ɾ i s
τιμόνι	t i m o n i
τις	t i s
τιτάνα	t i t a n a
τιτάνας	t i t a n a s
τιτάνες	t i t a n e s
τιτάνων	t i t a n o n
το	t o
τολμάω	t o l m a o
τομάρι	t o m a ɾ i
τον	t o n
τορπίλη	t o ɾ p i l i
τορόντο	t o ɾ o n d o
τουρκοκρατία	t u ɾ k o k ɾ a t i a
τούβλο	t u v l o
τούρκικος	t u ɾ c i k o s
τούρτες	t u ɾ t e s
τούτοις	t u t i s
τρέμω	t r e m o
τρέπομε	t ɾ e p o m e
τρέπουμε	t ɾ e p u m e
τρίβω	t r i v o
τρίκαλα	t ɾ i k a l a
τρίπολη	t ɾ i p o l i
τρίτος	t ɾ i t o s
τραγουδιστής	t ɾ a ɣ u ð i s t i s
τραπέζι	t ɾ a p e z i
τρεις	t ɾ i s
τρεισήμισι	t ɾ i s i m i s i
τρελάθηκα	t ɾ e l a θ i k a
τρελή	t r e l i
τρελαίνομαι	t ɾ e l e n o m e
τρελοκομείο	t ɾ e l o k o m i o
τριακόσια	t ɾ i a k o s ç a
τριμμένα	t r i m e n a
τριμμένες	t r i m e n e s
τριμμένη	t r i m e n i
τριμμένοι	t r i m e n i
τρομάζω	t r o m a z o
τρομαγμένη	t ɾ o m a ɣ m e n i
τρομαγμένοι	t ɾ o m a ɣ m e n i
τρομοκράτης	t ɾ o m o k ɾ a t i s
τρομοκρατία	t ɾ o m o k ɾ a t i a
τροχονόμος	t ɾ o x o n o m o s
τροχόσπιτο	t ɾ o x o s p i t o
τρόμος	t r o m o s
τρώω	t ɾ o o
τσάκωνας	t s a k o n a s
τσέκαρα	t s e k a ɾ a
τσίσα	t s i s a
τσίτσα	t s i t s a
τσακωνιάς	t s a k o ɲ a s
τσακωνικός	t s a k o n i k o s
τσακώνικα	t s a k o n i k a
τσακώνικη	t s a k o n i c i
τσακώνομαι	t s a k o n o m e
τσαμπουκάς	t s a m b u k a s
τσεκάριζε	t s e k a ɾ i z e
τσεκάρισα	t s e k a ɾ i s a
τσεκάρω	t s e k a ɾ o
τσεκαρίστηκα	p o n d a ɾ i s t i k a
τσιγγάνος	t s i ŋ ɡ a n o s
τσιμπούκι	t s i m b u c i
τσιτσίδι	t s i t s i ð i
τσογλάνι	t s o ɣ l a n i
τσογλαναράς	t s o ɣ l a n a ɾ a s
τσούχτρα	t͡s u x t r a
τυροκόμος	t i ɾ o k o m o s
τυροπιτάκι	t i ɾ o p i t a k i
τυροπιτούλα	t i ɾ o p i t u l a
τυχερός	t i ç e r o s
των	t o n
τόνος	t o n o s
τόπι	t o p i
τόση	t o s i
τόσο	t o s o
τόσοι	t o s i
τόσος	t o s o s
υγεία	i ʝ i a
υγείες	i ʝ i e s
υγειά	i ʝ a
υδράργυρος	i ð ɾ a ɾ ʝ i ɾ o s
υδραυλικός	i ð r a v l i k o s
υδρογόνο	i ð r o ɣ o n o
υιοθετούμε	i o θ e t u m e
υιοθετώ	i o θ e t o
υιός	i ɔ s
υπάρχω	i p a r x o
υπέγραψα	i p e ɣ r a p s a
υπέκυψα	i p e c i p s a
υπέρ	i p e r
υπέροχα	i p e ɾ o x a
υπέροχοι	i p e ɾ o ç i
υπαγόρευσα	i p a ɣ o ɾ e f s a
υπερβάλλω	i p e ɾ v a l o
υπερηφάνεια	i p e r i f a n i a
υπεροχή	i p e ɾ o ç i
υπερτροφία	i p e ɾ t ɾ o f i a
υπεύθυνος	i p e f θ i n o s
υπογράφει	i p o ɣ r a f i
υπογράφεις	i p o ɣ r a f i s
υπογράφουμε	i p o ɣ r a f u m e
υπογράφω	i p o ɣ ɾ a f o
υποδέχθηκα	i p o ð e x θ i k a
υποδέχτηκα	i p o ð e x t i k a
υποδεκανέας	i p o ð e k a n e a s
υποδεχτεί	i p o ð e x t i
υποδιαστολή	i p o ð i a s t o l i
υποκλέπτουμε	i p o k l e p t u m e
υποκρύπτομε	i p o k ɾ i p t o m e
υπολογίζουμε	i p o l o ʝ i z u m e
υπολογισμένα	i p o l o ʝ i z m e n a
υπολογισμένη	i p o l o ʝ i z m e n i
υπολογιστικά	i p o l o ʝ i s t i k a
υπολογιστικές	i p o l o ʝ i s t i c e s
υπολογιστική	i p o l o ʝ i s t i c i
υπολογιστικό	i p o l o ʝ i s t i k o
υπολογιστικών	i p o l o ʝ i s t i k o n
υπομονή	i p o m o n i
υστέρησα	i s t e ɾ i s a
υστεροβουλία	i s t e ɾ o v u l i a
υόρκη	i o ɾ c i
φάληρο	f a l i ɾ o
φάτνη	f a t n i
φέρε	f e ɾ e
φέρετρο	f e ɾ e t ɾ o
φέρθηκα	f e ɾ θ i k a
φέρνω	f e ɾ n o
φέρομαι	f e ɾ o m e
φέτος	f e t o s
φίδι	f i ð i
φίλιππος	f i l i p o s
φαβορίτα	f a v o r i t a
φακλάνα	f a k l a n a
φακός	f a k o s
φαντάζομαι	f a n d a z o m e
φαντάστηκα	f a n d a s t i k a
φαντασία	f a n d a s i a
φανταστική	f a n d a s t i ç i
φανταστικοί	f a n d a s t i ç i
φαρμάκι	f a ɾ m a c i
φαρμάκια	f a ɾ m a c a
φαρμακείο	f a r m a c i o
φασαρία	f a s a ɾ i a
φασολιά	f a s o ʎ a
φασούλι	f a s u l i
φασόλι	f a s o l i
φετίχ	f e t i x
φευ	f e f
φημίζομαι	f i m i z o m e
φθάνω	f θ a n o
φιλί	f i l i
φιλιά	f i ʎ a
φιλιού	f i ʎ u
φιλολογίας	f i l o l o ʝ i a s
φιλολογίες	f i l o l o ʝ i e s
φιλολογιών	f i l o l o ʝ i o n
φιλοξενούμενος	f i l o k s e n u m e n o s
φιλοσοφία	f i l o s o f i a
φιλοσοφικά	f i l o s o f i k a
φιλοσοφική	f i l o s o f i c i
φιλοσοφώ	f i l o s o f o
φιλόδοξος	f i l o ð o k s o s
φιλόσοφος	f i l o s o f o s
φλερτ	f l e ɾ t
φλερτάκι	f l e ɾ t a c i
φλερτάρω	f l e r t a r o
φλιτζάνι	f l i d͡z a n i
φλωρίνης	f l o r i n i s
φλόριντα	f l o ɾ i d a
φλώρινα	f l o ɾ i n a
φλώρος	f l o ɾ o s
φολίδα	f o l i ð a
φονιάς	f o ɲ a s
φοροαπαλλαγές	f o ɾ o a p a l a ʝ e s
φοροαπαλλαγή	f o ɾ o a p a l a ʝ i
φοροαπαλλαγών	f o ɾ o a p a l a ɣ o n
φοροδιαφυγή	f o ɾ o ð ʝ a f i ʝ i
φορολογία	f o ɾ o l o ʝ i a
φουμάριζε	f u m a ɾ i z e
φουμάρω	f u m a r o
φουσκάλα	f u s k a l a
φούμαρα	f u m a ɾ a
φράγκος	f ɾ a ŋ ɡ o s
φράουλα	f ɾ a u l a
φρέσκαρε	f ɾ e s k a ɾ e
φραγκφούρτη	f r a ŋ k f u r t i
φρανκφούρτη	f r a ŋ k f u r t i
φραντζόλα	f r a n d z o l a
φτάνω	f t a n o
φτιάχνω	f t ç a x n o
φτου	f t u
φτυστός	f t i s t o s
φτύνω	f t i n o
φυλαχτό	f i l a x t o
φυσικά	f i s i k a
φυτικά	f i t i k a
φυτικές	f i t i c e s
φυτική	f i t i c i
φυτικοί	f i t i c i
φυτικού	f i t i k u
φυτικούς	f i t i k u s
φυτικό	f i t i k o
φυτικόν	f i t i k o n
φυτικός	f i t i k o s
φυτικών	f i t i k o n
φωνάζω	f o n a z o
φωνάρα	f o n a ɾ a
φωνή	f o n i
φωτοβολίδα	f o t o v o l i ð a
φωτογράφισα	f o t o ɣ r a f i s a
φωτογραφήσεις	f o t o ɣ r a f i s i s
φωτογραφία	f o t o ɣ r a f i a
φωτογραφίζομε	f o t o ɣ r a f i z o m e
φωτογραφίζουμε	f o t o ɣ r a f i z u m e
φωτογραφίζω	f o t o ɣ r a f i z o
φωτογραφίσεις	f o t o ɣ r a f i s i s
φωτογραφίστηκα	f o t o ɣ r a f i s t i k a
φωτογραφεία	f o t o ɣ r a f i a
φωτογραφείο	f o t o ɣ r a f i a
φωτογραφούμαι	f o t o ɣ r a f u m e
φώναξα	f o n a k s a
φώνημα	f o n i m a
φώσφορος	f o s f o ɾ o s
χάιδεψα	x a i̯ ð e p s a
χάμπουργκερ	x a m b u ɾ ŋ ɟ e ɾ
χάνω	x a n o
χάραξα	x a ɾ a k s a
χάριν	x a r i n
χάρτης	x a r t i s
χάφτετε	x a f t e t e
χάχανο	x a x a n o
χάχας	x a x a s
χέρι	ç e ɾ i
χέσιμο	ç e s i m o
χέστρα	ç e s t ɾ a
χίασμα	ç i a z m a
χίε	ç i e
χίλια	ç i ʎ a
χίο	ç i o
χίος	ç i o s
χίου	ç i u
χίους	ç i u s
χίων	ç i o n
χαίρε	ç e r e
χαίρετε	ç e r e t e
χαίρομαι	ç e ɾ o m e
χαίρω	ç e r o
χαίτη	ç e t i
χαζοκούτι	x a z o k u t i
χαζομάρα	x a z o m a ɾ a
χαζός	x a z o s
χαλάω	x a l a o
χαλίφης	x a l i f i s
χαλασμένα	x a l a z m e n a
χαλασμένες	x a l a z m e n e s
χαλασμένη	x a l a z m e n i
χαλασμένο	x a l a z m e n o
χαλασμένοι	x a l a z m e n i
χαλκίδα	x a l c i ð a
χαμηλός	x a m i l o s
χαμόγελο	x a m ɔ ʝ ɛ l ɔ
χανιά	x a ɲ a
χαράζει	x a ɾ a z i
χαράζω	x a r a z o
χαράλαμπος	x a ɾ a l a m b o s
χαραλάμπης	x a ɾ a l a m b i s
χαραμίζω	x a ɾ a m i z o
χαραμοφάης	x a ɾ a m o f a i s
χαρτί	x a ɾ t i
χαρτζιλίκι	x a ɾ d z i l i c i
χαρτομάντης	x a ɾ t o m a n d i s
χαρτομάντισσα	x a ɾ t o m a n d i s a
χαστουκάκι	x a s t u k a c i
χαστούκι	x a s t u c i
χαϊδεύτηκα	x a i̯ ð e f t i k a
χαϊδεύω	x a i̯ ð e v o
χείλι	ç i l i
χείλια	ç i ʎ a
χεβρώνα	ç e v r o n a
χειλέων	ç i l e o n
χειλιών	ç i ʎ o n
χειμωνιάτικα	ç i m o ɲ a t i k a
χειμωνιάτικος	ç i m o ɲ a t i k o s
χειρότερος	ç i ɾ o t e ɾ o s
χελώνα	ç e l o n a
χι	ç i
χιλιάδα	ç i ʎ a ð a
χιμπατζής	ç i m b a n d z i s
χιονάνθρωπος	ç ɔ n a n θ ɾ ɔ p ɔ s
χιόνι	ç o n i
χοντρή	x o d r i
χοντρομπαλού	x o n d ɾ o b a l u
χοντρό	x o n d ɾ o
χοντρός	x o n d ɾ o s
χορέψαμε	x o ɾ e p s a m e
χορέψτε	x o ɾ e p s t e
χορεύουμε	x o ɾ e v u m e
χορεύουν	x o ɾ e v u n
χορεύουνε	x o ɾ e v u n e
χορεύω	x o ɾ e v o
χορταίνω	x o ɾ t e n o
χορτοφαγία	x o ɾ t o f a ʝ i a
χούφταλο	x u f t a l o
χρειάζεται	x ɾ i a z e t e
χρειάζομαι	x ɾ i a z o m e
χρειάστηκα	x ɾ i a s t i k a
χρειάστηκε	x ɾ i a s t i c e
χρηματοκιβώτιο	x ɾ i m a t o k i v o t i o
χριστουγέννων	x ɾ i s t u ʝ e n o n
χριστουγεννιάτικα	x r i s t u ʝ e ɲ a t i k a
χριστούγεννα	x ɾ i s t u ʝ e n a
χριστόψωμο	x r i s t o p s o m o
χριστόψωμου	x r i s t o p s o m u
χρονιά	x r o ɲ a
χρονολογήσεις	x r o n o l o ʝ i s i s
χρονολογία	x r o n o l o ʝ i a
χρονολογίας	x r o n o l o ʝ i a s
χρονολογίες	x r o n o l o ʝ i e s
χρονολόγηση	x r o n o l o ʝ i s i
χρονολόγησης	x r o n o l o ʝ i s i s
χρόνος	x ɾ o n o s
χτικιό	x t i c o
χόρεψαν	x o ɾ e p s a n
χόρεψε	x o ɾ e p s e
ψάρεψα	p s a ɾ e p s a
ψάχνομαι	p s a x n o m e
ψάχνω	p s a x n o
ψήφο	p s i f o
ψήφοι	p s i f i
ψήφου	p s i f u
ψαρεύω	p s a ɾ e v o
ψημένα	p s i m e n a
ψημένη	p s i m e n i
ψημένης	p s i m e n i s
ψημένο	p s i m e n o
ψημένοι	p s i m e n i
ψημένος	p s i m e n o s
ψημένου	p s i m e n u
ψημένους	p s i m e n u s
ψημένων	p s i m e n o n
ψηφίζομαι	p s i f i z o m e
ψηφίζω	p s i f i z ɔ
ψηφίο	p s i f i o
ψηφίσατε	p s i f i s a t e
ψηφίστηκα	p s i f i s t i k a
ψηφιακά	p s i f i a k a
ψηφιακέ	p s i f i a c e
ψηφιακές	p s i f i a c e s
ψηφιακή	p s i f i a c i
ψηφιακής	p s i f i a c i s
ψηφιακοί	p s i f i a c i
ψηφιακού	p s i f i a k u
ψηφιακό	p s i f i a k o
ψηφιακός	p s i f i a k o s
ψηφιακών	p s i f i a k o n
ψηφοδέλτιο	p s i f o ð e l t i o
ψηφοφορία	p s i f o f o ɾ i a
ψηφοφορίας	p s i f o f o ɾ i a s
ψηφοφόρος	p s i f o f o r o s
ψιλό	p s i l o
ψιτ	p s i t
ψοφώ	p s o f o
ψυχιατρική	p s i ç a t r i c i
ψυχιατρικοί	p s i ç a t r i c i
ψυχολογική	p s i x o l o ʝ i c i
ψυχολογικοί	p s i x o l o ʝ i c i
ψωλή	p s o l i
ψωμάκι	p s o m a c i
ψωμί	p s o m i
ψωμιά	p s o m ɲ a
ψωμιού	p s o m ɲ u
ψωμιών	p s o m ɲ o n
ψόφος	p s o f o s
ωμέγα	o m e ɣ a
ωριμότητα	o ɾ i m o t i t a
ωρύομαι	o r i o m e
ωσαννά	o s a n a
ωσότου	o s o t u
ωφελούμε	o f e l u m e
όγδοος	o ɣ ð o o s
όζος	o z o s
όλισβος	ɔ l i z v ɔ s
όλυμπος	o l i m b o s
όμικρον	o m i k r o n
όνος	o n o s
όντας	o n d a s
όντως	o n d o s
όπερα	o p e ɾ a
όπιο	o p i o
όπλο	o p l o
όποιο	o p ç o
όρεξη	o ɾ e k s i
όρισα	o ɾ i s a
όρνιθα	o r n i θ a
ότι	o t i
όφελος	o f e l o s
όφις	o f i s
ύβρις	i v ɾ i s
ύφεση	i f e s i
ύψιλον	iː p s i l o n
ώρα	o r a
ώριμα	o ɾ i m a
ώριμη	o ɾ i m i
ώριμοι	o ɾ i m i
ώριμος	o ɾ i m o s
ώσπερ	o s p e ɾ
ώσπου	o s p u
ώστε	o s t e
ἀνέγραψα	a n e ɣ r a p s a
ἀνίδρυσα	a n i ð r i s a
ἀπασχολῶ	a p a s x o l o
ἀττικίζουσα	a t i c i z u s a
ἐκλάπην	e k l a p i n
ἐκρούσθην	e k r u s θ i n
ἐπέστρεψα	e p e s t ɾ e p s a
