अंक	ə ŋ k
अंकन	ə ŋ k ə n
अंकल	ə ŋ k ə l
अंकित	ə ŋ k ɪ t̪
अंकुर	ə ŋ k ʊ ɾ
अंकुरित	ə ŋ k ʊ ɾ ɪ t̪
अंकुश	ə ŋ k ʊ ʃ
अंग	ə ŋ ɡ
अंगड़ाई	ə ŋ ɡ ɽ ɑː iː
अंगहीन	ə ŋ ɡʱ iː n
अंगुली	ə ŋ ɡ ʊ l iː
अंगूठा	ə ŋ ɡ uː ʈʰ ɑː
अंगूर	ə ŋ ɡ uː ɾ
अंगोला	ə ŋ ɡ oː l ɑː
अंग्रेज़	ə ŋ ɡ ɾ eː z
अंग्रेज़ी	ə ŋ ɡ ɾ eː z iː
अंग्रेजी	ə ŋ ɡ ɾ eː d͡ʒ iː
अंचल	ə ɲ t͡ʃ ə l
अंजाम	ə ɲ d͡ʒ ɑː m
अंजु	ə ɲ d͡ʒ uː
अंडा	ə n ɖ ɑː
अंतर्गत	ə n t̪ ə ɾ ɡ ə t̪
अंतर्निहित	ə n t̪ ə ɾ n ɪ ɦ ɪ t̪
अंतर्राष्ट्रीय	ə n t̪ ə ɾ ɾ ɑː ʃ ʈ ɾ iː j
अंतिम	ə n t̪ ɪ m
अंत्येष्टि	ə n t̪ j eː ʃ ʈ iː
अंदर	ə n d̪ ə ɾ
अंदाज़	ə n̪ d̪ a z
अंधड़	ə n d̪ʱ ə ɽ
अंधविश्वास	ə n d̪ʱ ʋ ɪ ʃ ʋ ɑː s
अंधाधुंध	ə n d̪ʱ ɑː d̪ʱ ʊ n d̪ʱ
अंधेरा	ə n d̪ʱ eː ɾ ɑː
अंबर	ə m b ə ɾ
अंश	ə n ʃ
अंशकालिक	ə n ʃ k ɑː l ɪ k
अए	ə eː
अकड़	ə k ə ɽ
अकर्मण्यता	ə k ə ɾ m ə n j ə t̪ ɑː
अकादमिक	ə k ɑː d̪ m ɪ k
अकादमी	ə k ɑː d̪ m iː
अकारण	ə k ɑː ɾ ə n
अकाल	ə k ɑː l
अकूत	ə k uː t̪
अकेला	ə k eː l ɑː
अकेलापन	ə k eː l ɑː p ə n
अक्षत	ə k ʃ ə t̪
अक्सर	ə k s ə ɾ
अखंड	ə kʰ ə ɳ ɖ
अखंडता	ə kʰ ə n ɖ t̪ ɑː
अखाड़ा	ə kʰ ɑː ɽ ɑː
अखिल	ə kʰ ɪ l
अगर	ə ɡ ə ɾ
अगरतला	ə ɡ ə ɾ t̪ ə l ɑː
अगरबत्ती	ə ɡ ə ɾ b ə t̪ t̪ iː
अगवानी	ə ɡ ʋ ɑː n iː
अगस्त	ə ɡ ə s t̪
अगुआ	ə ɡ ʊ ɑː
अग्नि	ə ɡ n iː
अग्निपरीक्षा	ə ɡ n ɪ p ə ɾ iː k ʃ ɑː
अग्रिम	ə ɡ ɾ ɪ m
अचरज	ə t͡ʃ ɾ ə d͡ʒ
अचानक	ə t͡ʃ ɑː n ə k
अचूक	ə t͡ʃ uː k
अछूता	ə t͡ʃʰ uː t̪ ɑː
अजब	ə d͡ʒ ə b
अजमेर	ə d͡ʒ m eː ɾ
अजान	ə d͡ʒ ɑː n
अजीब	ə d͡ʒ iː b
अजूबा	ə d͡ʒ uː b ɑː
अजेंडा	ə d͡ʒ eː n ɖ ɑː
अज्ञात	ə ɡ j aː t̪
अटक	ə ʈ ə k
अटपटा	ə ʈ p ə ʈ ɑː
अटल	ə ʈ ə l
अटारी	ə ʈ ɑː ɾ iː
अटूट	ə ʈ uː ʈ
अटैची	ə ʈ ɛː t͡ʃ iː
अट्ठानवे	ə ʈ ʈʰ ɑː n ʋ eː
अठन्नी	ə ʈʰ ə n n iː
अठारह	ə ʈʰ ɑː ɾ əʱ
अड़चन	ə ɽ t͡ʃ ə n
अड़तालीस	ə ɽ t̪ ɑː l iː s
अड़ना	ə ɽ n ɑː
अड़ियल	ə ɽ iː j ə l
अणु	ə n uː
अतः	ə t̪ əʰ
अति	ə t̪ iː
अतिवाद	ə t̪ ɪ ʋ ɑː d̪
अतिवादी	ə t̪ ɪ ʋ ɑː d̪ iː
अतीत	ə t̪ iː t̪
अत्यंत	ə t̪ j ə n t̪
अत्याचार	ə t̪ j ɑː t͡ʃ ɑː ɾ
अत्याचारी	ə t̪ j ɑː t͡ʃ ɑː ɾ iː
अथक	ə t̪ʰ ə k
अथाह	ə t̪ʰ ɑːʱ
अदरक	ə d̪ ɾ ə k
अदा	ə d̪ ɑː
अदाकार	ə d̪ ɑː k ɑː ɾ
अदालती	ə d̪ ɑː l ə t̪ iː
अद्यतन	ə d̪ j ə t̪ ə n
अधिकतम	ə d̪ʱ ɪ k t̪ ə m
अधिकार	ə d̪ʱ ɪ k ɑː ɾ
अधिनियम	ə d̪ʱ ɪ n iː j ə m
अधिभार	ə d̪ʱ ɪ bʱ ɑː ɾ
अधिवक्ता	ə d̪ʱ ɪ ʋ ə k t̪ ɑː
अधिवेशन	ə d̪ʱ ɪ ʋ eː ʃ ə n
अधिसूचित	ə d̪ʱ ɪ s uː t͡ʃ ɪ t̪
अधीक्षक	ə d̪ʱ iː k ʃ ə k
अधीक्षण	ə d̪ʱ iː k ʃ ə n
अधीन	ə d̪ʱ iː n
अधीनता	ə d̪ʱ iː n t̪ ɑː
अधूरा	ə d̪ʱ uː ɾ ɑː
अधेड़	ə d̪ʱ eː ɽ
अध्यक्षता	ə d̪ʱ j ə k ʃ t̪ ɑː
अध्यापक	ə d̪ʱ j ɑː p ə k
अनंतपुर	ə n ə n t̪ p ʊ ɾ
अनगिनत	ə n ɡ ɪ n ə t̪
अनजाना	ə n d͡ʒ ɑː n ɑː
अनजाने	ə n d͡ʒ ɑː n eː
अनदेखा	ə n d̪ eː kʰ ɑː
अनपढ़	ə n p ə ɽʱ
अनमोल	ə n m oː l
अनर्थ	ə n ə ɾ t̪ʰ
अनशन	ə n ʃ ə n
अनसुना	ə n s ʊ n ɑː
अनहोनी	ə n ɦ oː n iː
अनाज	ə n ɑː d͡ʒ
अनाथालय	ə n ɑː t̪ʰ ɑː l ə j
अनाधिकारिक	ə n ɑː d̪ʱ ɪ k ɑː ɾ ɪ k
अनामिका	ə n ɑː m ɪ k ɑː
अनार	ə n ɑː ɾ
अनिच्छा	ə n ɪ t͡ʃ t͡ʃʰ ɑː
अनिद्रा	ə n ɪ d̪ ɾ ɑː
अनियंत्रित	ə n iː j ə n t̪ ɾ ɪ t̪
अनिवार्य	ə n ɪ ʋ ɑː ɾ j
अनिश्चित	ə n ɪ ʃ t͡ʃ ɪ t̪
अनिश्चितता	ə n ɪ ʃ t͡ʃ ɪ t̪ t̪ ɑː
अनुकूल	ə n ʊ k uː l
अनुचित	ə n ʊ t͡ʃ ɪ t̪
अनुदान	ə n ʊ d̪ ɑː n
अनुपजाऊ	ə n ʊ p d͡ʒ ɑː uː
अनुपयोगी	ə n ʊ p j oː ɡ iː
अनुपस्थित	ə n uː p ə s t̪ʰ ɪ t̪
अनुपस्थिति	ə n ʊ p ə s t̪ʰ ɪ t̪ iː
अनुपात	ə n ʊ p ɑː t̪
अनुपूरक	ə n ʊ p uː ɾ ə k
अनुभवी	ə n ʊ bʱ ə ʋ iː
अनुभूति	ə n ʊ bʱ uː t̪ iː
अनुमानित	ə n ʊ m ɑː n ɪ t̪
अनुमोदन	ə n̪ ʊ m o d̪ ə n̪
अनुयायी	ə n ʊ j ɑː j iː
अनुरोध	ə n ʊ ɾ oː d̪ʱ
अनुवादित	ə n ʊ ʋ ɑː d̪ ɪ t̪
अनुशासन	ə n ʊ ʃ ɑː s ə n
अनुशासित	ə n ʊ ʃ ɑː s ɪ t̪
अनुष्ठान	ə n ʊ ʃ ʈʰ ɑː n
अनुसंधान	ə n ʊ s ə n d̪ʱ ɑː n
अनूदित	ə n uː d̪ ɪ t̪
अनेक	ə n eː k
अनेकता	ə n eː k t̪ ɑː
अन्दर	ə n d̪ ə ɾ
अन्न	ə n n ə
अन्यथा	ə n j ə t̪ʰ ɑː
अन्याय	ə n j ɑː j
अन्यायपूर्ण	ə n j ɑː j p uː ɾ n
अपकार	ə p k ɑː ɾ
अपना	ə p n ɑː
अपमान	ə p m ɑː n
अपमानजनक	ə p m ɑː n d͡ʒ ə n ə k
अपराध	ə p ɾ ɑː d̪ʱ
अपराधी	ə p ɾ ɑː d̪ʱ iː
अपरिपक्व	ə p ɾ ɪ p ə k ʋ
अपर्याप्त	ə p ə ɾ j ɑː p t̪
अपवाद	ə p ʋ ɑː d̪
अपवित्र	ə p ə ʋ ɪ t̪ ɾ
अपशकुन	ə p ʃ ə k ʊ n
अपहरण	ə pʰ ə ɾ ə n
अपूर्ण	ə p uː ɾ n
अपेक्षा	ə p eː k ʃ ɑː
अपेक्षाकृत	ə p eː k ʃ ɑː k ɾ ɪ t̪
अप्रत्यक्ष	ə p ɾ ə t̪ j ə k ʃ
अप्रत्याशित	ə p ɾ ə t̪ j ɑː ʃ ɪ t̪
अप्रिय	ə p ɾ ɪ j
अप्रैल	ə p ɾ ɛː l
अफ़वाह	ə f ʋ ɑːʱ
अफ़सर	ə f s ə ɾ
अफ़साना	ə f s ɑː n ɑː
अफ़्रीका	ə f ɾ iː k ɑː
अभिनेत्री	ə bʱ ɪ n eː t̪ ɾ iː
अभिभावक	ə bʱ ɪ bʱ ɑː ʋ ə k
अभिभूत	ə bʱ ɪ bʱ uː t̪
अभियंता	ə bʱ iː j ə n t̪ ɑː
अभियांत्रिकी	ə bʱ iː j ɑː n t̪ ɾ ɪ k iː
अभियान	ə bʱ iː j ɑː n
अभियुक्त	ə bʱ i j ʊ k t̪
अभियोक्ता	ə bʱ iː j oː k t̪ ɑː
अभियोग	ə bʱ iː j oː ɡ
अभियोजक	ə bʱ iː j oː d͡ʒ ə k
अभिलाषा	ə bʱ ɪ l ɑː ʃ ɑː
अभिव्यक्ति	ə bʱ ɪ ʋ j ə k t̪ iː
अभी	ə bʱ iː
अभ्यस्त	ə bʱ j ə s t̪
अभ्यास	ə bʱ j ɑː s
अमन	ə m ə n
अमरावती	ə m ɾ ɑː ʋ ə t̪ iː
अमरूद	ə m ɾ uː d̪
अमल	ə m ə l
अमानत	ə m ɑː n ə t̪
अमान्य	ə m ɑː n j
अमीर	ə m iː ɾ
अमीरी	ə m iː ɾ iː
अमूल्य	ə m uː l j
अमेरिका	ə m eː ɾ ɪ k ɑː
अमोघ	ə m oː ɡʱ
अम्बर	ə m b ə ɾ
अयस्क	ə j ə s k
अयोध्या	ə j oː d̪ʱ j ɑː
अरगनी	ə ɾ ə ɡ n iː
अरब	ə ɾ ə b
अरबिंद	ə ɾ b ɪ n d̪
अरमान	ə ɾ m ɑː n
अरविंद	ə ɾ ʋ ɪ n d̪
अरुणोदय	ə ɾ ʊ n oː d̪ ə j
अर्ज़ी	ə ɾ z iː
अर्जुन	ə ɾ d͡ʒ ʊ n
अर्जेंटीना	ə ɾ d͡ʒ eː n ʈ iː n ɑː
अर्थ	ə ɾ t̪ʰ
अर्थपूर्ण	ə ɾ t̪ʰ ə p uː ɾ n
अर्थव्यवस्था	ə ɾ t̪ʰ ə ʋ j ə ʋ ə s t̪ʰ ɑː
अर्थशास्त्री	ə ɾ t̪ʰ ə ʃ ɑː s t̪ ɾ iː
अर्थात	ə ɾ t̪ʰ ɑː t̪
अर्द्ध	ə ɾ d̪ d̪ʱ
अर्ध	ə ɾ d̪ʱ
अर्पित	ə ɾ p ɪ t̪
अलगाव	ə l ɡ ɑː ʋ
अलबत्ता	ə l b ə t̪ t̪ ɑː
अलबम	ə l b ə m
अलमारी	ə l m ɑː ɾ iː
अलहदा	ə l ɛːʱ d̪ ɑː
अलादीन	ə l ɑː d̪ iː n
अलाव	ə l ɑː ʋ
अल्जीरिया	ə l d͡ʒ iː ɾ iː j ɑː
अल्पसंख्यक	ə l p s ə ŋ kʰ j ə k
अल्लाह	ə l l ɑːʱ
अवतार	ə ʋ t̪ ɑː ɾ
अवधारणा	ə ʋ d̪ʱ ɑː ɾ n ɑː
अवयव	ə ʋ j ə ʋ
अवलोकन	ə ʋ l oː k ə n
अवशोषण	ə ʋ ʃ oː ʃ ə n
अवश्य	ə ʋ ə ʃ j
अवसर	ə ʋ s ə ɾ
अवाम	ə ʋ ɑː m
अवार्ड	ə ʋ ɑː ɾ ɖ
अव्वल	ə ʋ ʋ ə l
अश्विनी	ə ʃ ʋ ɪ n iː
असंगत	ə s ə ŋ ɡ ə t̪
असंतुष्ट	ə s ə n t̪ ʊ ʃ ʈ
असंभव	ə s ə m bʱ ə ʋ
असंवेदनशील	ə s ə m ʋ eː d̪ ə n ʃ iː l
असंवैधानिक	ə s ə m ʋ ɛː d̪ʱ ɑː n ɪ k
असफल	ə s ə pʰ ə l
असम	ə s ə m
असमंजस	ə s ə m ə ɲ d͡ʒ ə s
असर	ə s ə ɾ
असल	ə s l
असलियत	ə s l iː j ə t̪
असली	ə s l iː
असहमति	ə s ɛːʱ m ə t̪ iː
असहयोग	ə s əʱ j oː ɡ
असहाय	ə s ɦ ɑː j
असाधारण	ə s ɑː d̪ʱ ɑː ɾ ə n
असामाजिक	ə s ɑː m ɑː d͡ʒ ɪ k
असुरक्षित	ə s ʊ ɾ ə k ʃ ɪ t̪
असुविधा	ə s ʊ ʋ ɪ d̪ʱ ɑː
असैनिक	ə s ɛː n ɪ k
अस्तित्व	ə s t̪ ɪ t̪ ʋ
अस्पताल	ə s p ə t̪ ɑː l
अस्सी	ə s s iː
अहं	ɛːʱ m
अहम	ɛːʱ m
अहमियत	ɛːʱ m iː j ə t̪
आँख	ɑ̃ː kʰ
आँगन	ɑ̃ː ɡ ə n
आँच	ɑ̃ː t͡ʃ
आँसू	ɑ̃ː s uː
आंकड़ा	ɑː ŋ k ɽ ɑː
आंतरिक	ɑː n t̪ ɾ ɪ k
आंदोलन	ɑː n d̪ oː l ə n
आइंदा	ɑː ɪ n d̪ ɑː
आइसक्रीम	ɑː ɪ s k ɾ iː m
आइसलैंड	ɑː ɪ s l ɛː n ɖ
आकर्षक	ɑː k ə ɾ ʃ ə k
आकर्षण	ɑː k ə ɾ ʃ ə n
आकर्षित	ɑː k ə ɾ ʃ ɪ t̪
आकलन	ɑː k ə l ə n
आकस्मिक	ɑː k ə s m ɪ k
आकांक्षा	ɑː k ɑː ŋ k ʃ ɑː
आकार	ɑː k ɑː ɾ
आकाश	ɑː k ɑː ʃ
आकाशवाणी	ɑː k ɑː ʃ ʋ ɑː n iː
आक्रमण	ɑː k ɾ ə m ə n
आक्रामकता	ɑː k ɾ ɑː m ə k t̪ ɑː
आक्रोश	ɑː k ɾ oː ʃ
आग	ɑː ɡ
आगमन	ɑː ɡ ə m ə n
आगाह	ɑː ɡ ɑːʱ
आगे	ɑː ɡ eː
आचरण	ɑː t͡ʃ ə ɾ ə n
आचार	ɑː t͡ʃ ɑː ɾ
आज	ɑː d͡ʒ
आज़ाद	ɑː z ɑː d̪
आजीविका	ɑː d͡ʒ iː ʋ ɪ k ɑː
आज्ञा	ɑː ɡ j ɑː
आठ	ɑː ʈʰ
आठवां	ɑː ʈʰ ʋ ɑ̃ː
आडवाणी	ɑː ɖ ʋ ɑː n iː
आड़	ɑː ɽ
आतंकित	ɑː t̪ ə ŋ k ɪ t̪
आतिश	ɑː t̪ ɪ ʃ
आतिशबाज़ी	ɑː t̪ ɪ ʃ b ɑː z iː
आतुर	ɑː t̪ ʊ ɾ
आत्मकथा	ɑː t̪ m ə k ə t̪ʰ ɑː
आत्मघाती	ɑː t̪ m ə ɡʱ ɑː t̪ iː
आत्मनिर्भर	ɑː t̪ m ə n ɪ ɾ bʱ ə ɾ
आत्मविश्वास	ɑː t̪ m ə ʋ ɪ ʃ ʋ ɑː s
आत्मसमर्पण	ɑː t̪ m s ə m ə ɾ p ə n
आत्मसात	ɑː t̪ m ə s ɑː t̪
आत्महत्या	ɑː t̪ m ɦ ə t̪ j ɑː
आत्मा	ɑː t̪ m ɑː
आदतन	ɑː d̪ ə t̪ ə n
आदम	ɑː d̪ ə m
आदमी	ɑː d̪ m iː
आदर	ɑː d̪ ə ɾ
आदर्श	ɑː d̪ ə ɾ ʃ
आदिवासी	ɑː d̪ ɪ ʋ ɑː s iː
आदी	ɑː d̪ iː
आदेश	ɑː d̪ eː ʃ
आधार	ɑː d̪ʱ ɑː ɾ
आधारभूत	ɑː d̪ʱ ɑː ɾ bʱ uː t̪
आधिपत्य	ɑː d̪ʱ ɪ p ə t̪ j
आधुनिकीकरण	ɑː d̪ʱ ʊ n ɪ k iː k ə ɾ ə n
आध्यात्मिक	ɑː d̪ʱ j ɑː t̪ m ɪ k
आना	ɑː n ɑː
आन्दोलन	ɑː n d̪ oː l ə n
आप	aː p
आपका	ɑː p k ɑː
आपत्ति	ɑː p ə t̪ t̪ iː
आपत्तिजनक	ɑː p ə t̪ t̪ iː d͡ʒ ə n ə k
आपबीती	ɑː p b iː t̪ iː
आपूर्ति	ɑː p uː ɾ t̪ iː
आबरू	ɑː b ɾ uː
आमंत्रित	ɑː m ə n t̪ ɾ ɪ t̪
आमदनी	ɑː m ə d̪ n iː
आयत	ɑː j ə t̪
आयन	ɑː j ə n
आयरलैंड	ɑː j ə ɾ l ɛː n ɖ
आया	ɑː j ɑː
आयात	ɑː j ɑː t̪
आयु	ɑː j uː
आयुक्त	ɑː j ʊ k t̪
आयुर्विज्ञान	ɑː j ʊ ɾ ʋ ɪ ɡ j ɑː n
आयुर्वेद	ɑː j ʊ ɾ ʋ eː d̪
आयोग	ɑː j oː ɡ
आयोजन	ɑː j oː d͡ʒ ə n
आयोजित	ɑː j oː d͡ʒ ɪ t̪
आरंभिक	ɑː ɾ ə m bʱ ɪ k
आरक्षण	ɑː ɾ ə k ʃ ə n
आराम	ɑː ɾ ɑː m
आरोग्य	ɑː ɾ oː ɡ j
आरोप	ɑː ɾ oː p
आलसी	ɑː l s iː
आलीशान	ɑː l iː ʃ ɑː n
आलू	ɑː l uː
आलेख	ɑː l eː kʰ
आवंटन	ɑː ʋ ə n ʈ ə n
आवंटित	ɑː ʋ ə n ʈ ɪ t̪
आवक	ɑː ʋ ə k
आवश्यकता	ɑː ʋ ə ʃ j ə k t̪ ɑː
आविष्कार	ɑː ʋ ɪ ʃ k ɑː ɾ
आवेदन	ɑː ʋ eː d̪ ə n
आशना	ɑː ʃ n ɑː
आशय	ɑː ʃ ə j
आशियाना	ɑː ʃ iː j ɑː n ɑː
आशीर्वाद	ɑː ʃ iː ɾ ʋ ɑː d̪
आश्चर्य	ɑː ʃ t͡ʃ ə ɾ j
आश्रम	ɑː ʃ ɾ ə m
आसन	ɑː s ə n
आसन्न	ɑː s ə n n
आसरा	ɑː s ɾ ɑː
आसामी	ɑː s ɑː m iː
आसार	ɑː s ɑː ɾ
आस्था	ɑː s t̪ʰ ɑː
आहट	ɑː ɦ ə ʈ
आहत	ɑː ɦ ə t̪
आहार	ɑː ɦ ɑː ɾ
इंग्लैंड	ɪ ŋ ɡ l ɛː n ɖ
इंच	ɪ ɲ t͡ʃ
इंजीनियर	ɪ ɲ d͡ʒ iː n iː j ə ɾ
इंटेल	ɪ n ʈ eː l
इंडस्ट्री	ɪ n ɖ ə s ʈ ɾ iː
इंतज़ार	ɪ n t̪ ə z ɑː ɾ
इंदौर	ɪ n d̪ ɔː ɾ
इंद्रिय	ɪ n d̪ ɾ ɪ j
इंफाल	ɪ m pʰ ɑː l
इंस्पेक्टर	ɪ n s p eː k ʈ ə ɾ
इकलौता	ɪ k l ɔː t̪ ɑː
इग्लू	ɪ ɡ l uː
इज़हार	ɪ z ɦ ɑː ɾ
इज़ाफ़ा	ɪ z ɑː f ɑː
इज़्ज़त	ɪ z z ə t̪
इटालियन	ɪ ʈ ɑː l iː j ə n
इतर	ɪ t̪ ə ɾ
इतराना	ɪ t̪ ɾ ɑː n ɑː
इतालवी	ɪ t̪ ɑː l ʋ iː
इतिहास	ɪ t̪ ɪ ɦ ɑː s
इतिहासकार	ɪ t̪ ɪ ɦ ɑː s k ɑː ɾ
इत्र	ɪ t̪ ɾ
इथियोपिया	ɪ t̪ʰ iː j oː p iː j ɑː
इनका	ɪ n k ɑː
इनको	ɪ n k oː
इनसाफ़	ɪ n s ɑː f
इन्हें	ɪ n ɦ ẽ
इबादत	ɪ b ɑː d̪ ə t̪
इब्राहीम	ɪ b ɾ ɑː ɦ iː m
इमली	ɪ m l iː
इमारत	ɪ m ɑː ɾ ə t̪
इमोशन	ɪ m oː ʃ ə n
इम्तहान	ɪ m t̪ ə ɦ ɑː n
इम्तेहान	ɪ m t̪ eː ɦ ɑː n
इरादतन	ɪ ɾ ɑː d̪ t̪ ə n
इलाज	ɪ l ɑː d͡ʒ
इलायची	ɪ l ɑː j ə t͡ʃ iː
इलाहाबाद	ɪ l ɑː ɦ ɑː b ɑː d̪
इलाही	ɪ l ɑː ɦ iː
इश्क	ɪ ʃ k
इश्तहार	ɪ ʃ t̪ ə ɦ ɑː ɾ
इसका	ɪ s k ɑː
इसको	ɪ s k oː
इसमें	ɪ s m ẽ
इसरार	ɪ s ɾ ɑː ɾ
इसरो	ɪ s ɾ oː
इसलिए	ɪ s l ɪ eː
इसे	ɪ s eː
इस्तेमाल	ɪ s t̪ eː m ɑː l
इस्पात	ɪ s p ɑː t̪
इस्राइल	ɪ s ɾ ɑː ɪ l
इस्लाम	ɪ s l ɑː m
इस्लामाबाद	ɪ s l ɑː m ɑː b ɑː d̪
ईंधन	iː n d̪ʱ ə n
ईटानगर	iː ʈ ɑː n ə ɡ ə ɾ
ईद	iː d̪
ईमानदार	iː m ɑː n d̪ ɑː ɾ
ईरान	iː ɾ ɑː n
ईरानी	iː ɾ ɑː n iː
ईर्ष्या	iː ɾ ʃ j ɑː
ईश	iː ʃ
ईश्वर	iː ʃ ʋ ə ɾ
ईसा	iː s ɑː
ईसाई	iː s ɑː iː
उंगली	ʊ ŋ ɡ l iː
उंचाई	ʊ ɲ t͡ʃ ɑː iː
उक्त	ʊ k t̪
उग्र	ʊ ɡ ɾ
उचित	ʊ t͡ʃ ɪ t̪
उच्चायुक्त	ʊ t͡ʃ t͡ʃ ɑː j ʊ k t̪
उच्चायोग	ʊ t͡ʃ t͡ʃ ɑː j oː ɡ
उच्चारण	ʊ t͡ʃ t͡ʃ ɑː ɾ ə n
उजागर	ʊ d͡ʒ ɑː ɡ ə ɾ
उड़द	ʊ ɽ ə d̪
उड़ना	ʊ ɽ n ɑː
उड़ान	ʊ ɽ ɑː n
उड़ीसा	ʊ ɽ iː s ɑː
उड्डयन	ʊ ɖ ɖ ə j ə n
उतरना	ʊ t̪ ə ɾ n ɑː
उतारना	ʊ t̪ ɑː ɾ n ɑː
उत्कृष्ट	ʊ t̪ k ɾ ɪ ʃ ʈ
उत्तम	ʊ t̪ t̪ ə m
उत्तर	ʊ t̪ t̪ ə ɾ
उत्तरकाशी	ʊ t̪ t̪ ə ɾ k ɑː ʃ iː
उत्तरदायित्व	ʊ t̪ t̪ ə ɾ d̪ ɑː j ɪ t̪ ʋ
उत्तरदायी	ʊ t̪ t̪ ə ɾ d̪ ɑː j iː
उत्तराधिकारी	ʊ t̪ t̪ ə ɾ ɑː d̪ʱ ɪ k ɑː ɾ iː
उत्तेजित	ʊ t̪ː e d ʒ ɪ t̪
उत्पत्ति	ʊ t̪ p ə t̪ t̪ iː
उत्पाद	ʊ t̪ p ɑː d̪
उत्पादन	ʊ t̪ p ɑː d̪ ə n
उत्पीड़न	ʊ t̪ p iː ɽ ə n
उत्प्रेरक	ʊ t̪ p ɾ eː ɾ ə k
उत्सर्जन	ʊ t̪ s ə ɾ d͡ʒ ə n
उत्साह	ʊ t̪ s ɑːʱ
उत्साहित	ʊ t̪ s ɑː ɦ ɪ t̪
उत्सुक	ʊ t̪ s ʊ k
उदारता	ʊ d̪ ɑː ɾ t̪ ɑː
उदास	ʊ d̪ ɑː s
उदासीन	ʊ d̪ ɑː s iː n
उद्घाटन	ʊ d̪ ɡʱ ɑː ʈ ə n
उद्भव	ʊ d̪ bʱ ə ʋ
उद्यमी	ʊ d̪ j ə m iː
उद्यान	ʊ d̪ j ɑː n
उद्योग	ʊ d̪ j oː ɡ
उद्योगपति	ʊ d̪ j oː ɡ p ə t̪ iː
उद्योगीकरण	ʊ d̪ j oː ɡ iː k ə ɾ ə n
उधार	ʊ d̪ʱ ɑː ɾ
उनका	ʊ n k ɑː
उनको	ʊ n k oː
उनींदा	ʊ n iː n d̪ ɑː
उन्नत	ʊ n n ə t̪
उन्नाव	ʊ n n ɑː ʋ
उन्माद	ʊ n̪ m aː d̪
उन्मूलन	ʊ n m uː l ə n
उन्हें	ʊ n ɦ ẽ
उन्होंने	ʊ n ɦ õː n eː
उपचुनाव	ʊ p t͡ʃ ʊ n ɑː ʋ
उपजाऊ	ʊ p d͡ʒ ɑː uː
उपनगर	ʊ p n ə ɡ ə ɾ
उपनाम	ʊ p n ɑː m
उपन्यास	ʊ p ə n j ɑː s
उपभोक्ता	ʊ p bʱ oː k t̪ ɑː
उपभोग	ʊ p bʱ oː ɡ
उपयोग	ʊ p j oː ɡ
उपलब्ध	ʊ p l ə b d̪ʱ
उपहार	ʊ pʰ ɑː ɾ
उपाधि	ʊ p ɑː d̪ʱ iː
उपाध्याय	ʊ p ɑː d̪ʱ j ɑː j
उपाय	ʊ p ɑː j
उपेक्षा	ʊ p eː k ʃ ɑː
उबरना	ʊ b ə ɾ n ɑː
उभरना	ʊ bʱ ə ɾ n ɑː
उमंग	ʊ m ə ŋ ɡ
उमर	ʊ m ə ɾ
उमस	ʊ m ə s
उम्दा	ʊ m d̪ ɑː
उम्मीदवार	ʊ m m iː d̪ ʋ ɑː ɾ
उलझन	ʊ l d͡ʒʱ ə n
उलझना	ʊ l ə d͡ʒʱ n ɑː
उलटी	ʊ l ʈ iː
उल्का	ʊ l k ɑː
उल्टा	ʊ l ʈ ɑː
उल्टी	ʊ l ʈ iː
उल्लंघन	ʊ l l ə ŋ ɡʱ ə n
उल्लू	ʊ l l uː
उल्लेख	ʊ l l eː kʰ
उषा	ʊ ʃ ɑː
उसका	ʊ s k ɑː
उसको	ʊ s k oː
उससे	ʊ s s eː
उसूल	ʊ s uː l
उसे	ʊ s eː
उस्ताद	ʊ s t̪ ɑː d̪
ऊँट	ũː ʈ
ऊन	uː n
ऊना	uː n ɑː
ऊपरी	uː p ɾ iː
ऊब	uː b
ऊर्जा	uː ɾ d͡ʒ ɑː
ऋग्वेद	ɾ ɪ ɡ ʋ eː d̪
ऋण	ɾ ɪ n
ऋणदाता	ɾ ɪ n d̪ ɑː t̪ ɑː
ऋतु	ɾ ɪ t̪ uː
एक	eː k
एकजुट	eː k d͡ʒ ʊ ʈ
एकजुटता	eː k d͡ʒ ʊ ʈ t̪ ɑː
एकतरफ़ा	eː k t̪ ə ɾ f ɑː
एकत्र	eː k ə t̪ ɾ
एकल	eː k ə l
एकांत	eː k ɑː n t̪
एकाएक	eː k ɑː eː k
एकाध	eː k ɑː d̪ʱ
एडिलेड	eː ɖ ɪ l eː ɖ
एयरलाइन	eː j ə ɾ l ɑː ɪ n
एलान	eː l ɑː n
एल्युमिनियम	eː l j ʊ m ɪ n iː j ə m
एशिया	eː ʃ iː j ɑː
एसोसिएशन	eː s oː s ɪ eː ʃ ə n
एहसान	eːʱ s ɑː n
एहसानमंद	eːʱ s ɑː n m ə n d̪
ऐच्छिक	ɛː t͡ʃ t͡ʃʰ ɪ k
ऐतिहासिक	ɛː t̪ ɪ ɦ ɑː s ɪ k
ऐनक	ɛː n ə k
ऐश	ɛː ʃ
ऐश्वर्य	ɛː ʃ ʋ ə ɾ j
ऐसी	ɛː s iː
ऐसे	ɛː s eː
ऑकलैंड	ɔː k l ɛː n ɖ
ऑस्ट्रिया	ɔː s ʈ ɾ iː j ɑː
ऑस्ट्रेलिया	ɔː s ʈ ɾ eː l iː j ɑː
ओर	oː ɾ
ओलंपिक	oː l ə m p ɪ k
ओसाका	oː s ɑː k ɑː
ओहायो	oː ɦ ɑː j oː
औद्योगिक	ɔː d̪ j oː ɡ ɪ k
औद्योगीकरण	ɔː d̪ j oː ɡ iː k ə ɾ ə n
औपचारिक	ɔː p t͡ʃ ɑː ɾ ɪ k
औरत	ɔː ɾ ə t̪
औसतन	ɔː s t̪ ə n
कंकड़	k ə ŋ k ə ɽ
कंकाल	k ə ŋ k ɑː l
कंडकटर	k ə n ɖ ə k ʈ ə ɾ
कंडीशनर	k ə n ɖ iː ʃ n ə ɾ
कंधा	k ə n d̪ʱ ɑː
कंपन	k ə m p ə n
कंप्यूटरीकरण	k ə m p j uː ʈ ɾ iː k ə ɾ ə n
कंबल	k ə m b ə l
कई	k ə iː
कक्ष	k ə k ʃ
कक्षा	k ə k ʃ ɑː
कगार	k ə ɡ ɑː ɾ
कचरा	k ə t͡ʃ ɾ ɑː
कच्चा	k ə t͡ʃ t͡ʃ ɑː
कच्छ	k ə t͡ʃ t͡ʃʰ
कटाई	k ə ʈ ɑː iː
कटोरा	k ə ʈ oː ɾ ɑː
कट्टर	k ə ʈ ʈ ə ɾ
कठिन	k ə ʈʰ ɪ n
कठुआ	k ə ʈʰ ʊ ɑː
कड़वाहट	k ə ɽ ʋ ɑː ɦ ə ʈ
कड़ा	k ə ɽ ɑː
कढ़ाई	k ə ɽʱ ɑː iː
कथन	k ə t̪ʰ ə n
कथा	k ə t̪ʰ ɑː
कथित	k ə t̪ʰ ɪ t̪
कनपटी	k ə n p ə ʈ iː
कनाडा	k ə n ɑː ɖ ɑː
कनिष्ठ	k ə n ɪ ʃ ʈʰ
कनिष्ठा	k ə n ɪ ʃ ʈʰ ɑː
कपड़ा	k ə p ɽ ɑː
कपास	k ə p ɑː s
कपूर	k ə p uː ɾ
कप्तान	k ə p t̪ ɑː n
कबड्डी	k ə b ə ɖ ɖ iː
कबाब	k ə b ɑː b
कबूतर	k ə b uː t̪ ə ɾ
कभी	k ə bʱ iː
कम	k ə m
कमज़ोर	k ə m z oː ɾ
कमरा	k ə m ɾ ɑː
कमर्शियल	k ə m ə ɾ ʃ iː j ə l
कमल	k ə m ə l
कमाई	k ə m ɑː iː
कमान	k ə m ɑː n
कमिश्नर	k ə m ɪ ʃ n ə ɾ
कमी	k ə m iː
कमीना	k ə m iː n ɑː
कमेंट	k ə m eː n ʈ
कमेटी	k ə m eː ʈ iː
कमोबेश	k ə m oː b eː ʃ
कर	k ə ɾ
करणी	k ə ɾ n iː
करतब	k ə ɾ t̪ ə b
करना	k ə ɾ n ɑː
कराची	k ə ɾ ɑː t͡ʃ iː
करारा	k ə ɾ ɑː ɾ ɑː
करूंगा	k ə ɾ ũː ŋ ɡ ɑ
करोड़	k ə ɾ oː ɽ
करोड़पति	k ə ɾ oː ɽ p ə t̪ iː
कर्म	k ə ɾ m
कर्मभूमि	k ə ɾ m bʱ uː m iː
कर्मी	k ə ɾ m iː
कलंक	k ə l ə ŋ k
कलह	k ə l əʱ
कलाई	k ə l ɑː iː
कलात्मक	k ə l ɑː t̪ m ə k
कलावंत	k ə l ɑː ʋ ə n t̪
कल्पना	k ə l p ə n ɑː
कवच	k ə ʋ ə t͡ʃ
कविता	k ə ʋ ɪ t̪ ɑː
कशमकश	k ə ʃ ə m k ə ʃ
कश्ती	k ə ʃ t̪ iː
कश्मीर	k ə ʃ m iː ɾ
कष्ट	k ə ʃ ʈ
कसौटी	k ə s ɔː ʈ iː
कहलाना	k ɛːʱ l ɑː n ɑː
कहाँ	k ə ɦ ɑ̃ː
कहानी	k ə ɦ ɑː n iː
कहावत	k ə ɦ ɑː ʋ ə t̪
कहीं	k ə ɦ ĩː
का	k ɑː
कांग्रेस	k ɑː ŋ ɡ ɾ eː s
कांग्रेसी	k ɑː ŋ ɡ ɾ eː s iː
कांटा	k ɑː n ʈ ɑː
काज	k ɑː d͡ʒ
काजल	k ɑː d͡ʒ ə l
काजू	k ɑː d͡ʒ uː
कान	k ɑː n
कानपुर	k ɑː n p ʊ ɾ
कान्हा	k ɑː n ɦ ɑː
काफी	k ɑː pʰ iː
काबीना	k ɑː b iː n ɑː
काम	k ɑː m
कामकाज	k ɑː m k ɑː d͡ʒ
कामगार	k ɑː m ɡ ɑː ɾ
कामना	k ɑː m n ɑː
कामयाब	k ɑː m j ɑː b
कायनात	k ɑː j n ɑː t̪
कायर	k ɑː j ə ɾ
कार	k ɑː ɾ
कारगर	k ɑː ɾ ɡ ə ɾ
कारण	k ɑː ɾ ə n
कारतूस	k ɑː ɾ t̪ uː s
कारनामा	k ɑː ɾ n ɑː m ɑː
कारवाँ	k ɑː ɾ ʋ ɑ̃ː
कारोबारी	k ɑː ɾ oː b ɑː ɾ iː
कार्गो	k ɑː ɾ ɡ oː
कार्टून	k ɑː ɾ ʈ uː n
कार्ड	k ɑː ɾ ɖ
कार्य	k ɑː ɾ j
कार्यकर्ता	k ɑː ɾ j ə k ə ɾ t̪ ɑː
कार्यभार	k ɑː ɾ j ə bʱ ɑː ɾ
कार्यसमिति	k ɑː ɾ j s ə m ɪ t̪ iː
कार्यान्वित	k ɑː ɾ j ɑː n ʋ ɪ t̪
काल	k ɑː l
कालक्रम	k ɑː l k ɾ ə m
काला	k ɑː l ɑː
कालाधन	k ɑː l ɑː d̪ʱ ə n
कालापन	k ɑː l ɑː p ə n
कालेज	k ɑː l eː d͡ʒ
किंतु	k ɪ n t̪ uː
किए	k ɪ eː
किचन	k ɪ t͡ʃ ə n
कितना	k ɪ t̪ n ɑː
कितने	k ɪ t̪ n eː
किताब	k ɪ t̪ ɑː b
किमी	k ɪ m iː
किरण	k ɪ ɾ ə n
किरदार	k ɪ ɾ d̪ ɑː ɾ
किराया	k ɪ ɾ ɑː j ɑː
किरायेदार	k ɪ ɾ ɑː j eː d̪ ɑː ɾ
किलो	k ɪ l oː
किलोग्राम	k ɪ l oː ɡ ɾ ɑː m
किशमिश	k ɪ ʃ m ɪ ʃ
किश्त	k ɪ ʃ t̪
कीचड़	k iː t͡ʃ ə ɽ
कीटाणु	k iː ʈ ɑː n uː
कीड़ा	k iː ɽ ɑː
कील	k iː l
कुंद	k ʊ n d̪
कुख्यात	k ʊ kʰ j ɑː t̪
कुटिल	k ʊ ʈ ɪ l
कुत्ता	k ʊ t̪ t̪ ɑː
कुदाल	k ʊ d̪ ɑː l
कुमारी	k ʊ m ɑː ɾ iː
कुम्हड़ा	k ʊ m ɦ ə ɽ ɑː
कुर्की	k ʊ ɾ k iː
कुल	k ʊ l
कुशल	k ʊ ʃ ə l
कुशासन	k ʊ ʃ ɑː s ə n
कुश्ती	k ʊ ʃ t̪ iː
कुहनी	k ʊʱ n iː
कूच	k uː t͡ʃ
कूटनीति	k uː ʈ n iː t̪ iː
कूटनीतिक	k uː ʈ n iː t̪ ɪ k
कृति	k ɽ ɪ t̪ iː
कृष्णा	k ɾ ɪ ʃ n ɑː
केंद्र	k eː n d̪ ɾ
केंद्रित	k eː n d̪ ɾ ɪ t̪
केन्या	k eː n j ɑː
केपटाउन	k eː p ʈ ɑː ʊ n
केरल	k eː ɾ ə l
केला	k eː l ɑː
कैंडी	k ɛː n ɖ iː
कैमरा	k ɛː m ɾ ɑː
कैरम	k ɛː ɾ ə m
कैलकुलेटर	k ɛː l k ʊ l eː ʈ ə ɾ
कैलिफ़ोर्निया	k ɛː l ɪ f oː ɾ n iː j ɑː
कैसा	k ɛː s ɑː
कॉफ़ी	k ɔː f iː
कॉमनवेल्थ	k ɔː m ə n ʋ eː l t̪ʰ
कॉमेडी	k ɔː m eː ɖ iː
कोंकण	k oː ŋ k ə n
कोट	k oː ʈ
कोटा	k oː ʈ ɑː
कोठारी	k oː ʈʰ ɑː ɾ iː
कोड़ा	k oː ɽ ɑː
कोढ़	k oː ɽʱ
कोण	k oː n
कोयला	k oː j ə l ɑː
कोरा	k oː ɾ ɑː
कोरियन	k oː ɾ iː j ə n
कोरिया	k oː ɾ iː j ɑː
कोलकाता	k oː l k ɑː t̪ ɑː
कोश	k oː ʃ
कोस	k oː s
कोसना	k oː s n ɑː
कोहनी	k oːʱ n iː
कोहराम	k oːʱ ɾ ɑː m
कौन	k ɔː n
क्या	k j ɑː
क्यूँ	k j ũː
क्यूबा	k j uː b ɑː
क्योटो	k j oː ʈ oː
क्रम	k ɾ ə m
क्रमशः	k ɾ ə m ʃ əʰ
क्रय	k ɾ ə j
क्रांतिकारी	k ɾ ɑː n t̪ ɪ k ɑː ɾ iː
क्राइस्टचर्च	k ɾ ɑː ɪ s ʈ t͡ʃ ə ɾ t͡ʃ
क्रिया	k ɾ iː j ɑː
क्रिसमस	k ɾ ɪ s m ə s
क्रिस्टल	k ɾ ɪ s ʈ ə l
क्रीम	k ɾ iː m
क्रुद्ध	k ɾ ʊ d̪ d̪ʱ
क्रोएशिया	k ɾ oː eː ʃ iː j ɑː
क्रोध	k ɾ oː d̪ʱ
क्लब	k l ə b
क्लास	k l ɑː s
क्विंटल	k ʋ ɪ n ʈ ə l
क्वेटा	k ʋ eː ʈ ɑː
क्षण	k ʃ ə n
क्षत्रिय	k ʃ ə t̪ ɾ iː j ə
क्षितिज	k ʃ ɪ t̪ ɪ d͡ʒ
क्षेत्र	k ʃ eː t̪ ɾ
क्षेत्रफल	k ʃ eː t̪ ɾ ə pʰ ə l
खंभा	kʰ ə m bʱ ɑː
खजूर	kʰ ə d͡ʒ uː ɾ
खटपट	kʰ ə ʈ p ə ʈ
खटमल	kʰ ə ʈ m ə l
खटाई	kʰ ə ʈ aː iː
खत्री	kʰ ə t̪ ɾ iː
खदान	kʰ ə d̪ ɑː n
खनिज	kʰ ə n ɪ d͡ʒ
खपत	kʰ ə p ə t̪
खरब	kʰ ə ɾ ə b
खर्च	kʰ ə ɾ t͡ʃ
खलनायक	kʰ ə l n ɑː j ə k
खसरा	kʰ ə s ɾ ɑː
खाई	kʰ ɑː iː
खाड़ी	kʰ ɑː ɽ iː
खाद	kʰ ɑː d̪
खादी	kʰ ɑː d̪ iː
खाद्य	kʰ ɑː d̪ j ə
खान	kʰ ɑː n
खाना	kʰ ɑː n ɑː
खिंचाव	kʰ ɪ ɲ t͡ʃ ɑː ʋ
खिड़की	kʰ ɪ ɽ k iː
खिलाना	kʰ ɪ l ɑː n ɑː
खिलौना	kʰ ɪ l̪ ɔː n̪ ɑː
खींच	kʰ iː ɲ t͡ʃ
खींचतान	kʰ iː ɲ t͡ʃ t̪ ɑː n
खीर	kʰ iː ɾ
खीरा	kʰ iː ɾ ɑː
खुदाई	kʰ ʊ d̪ ɑː iː
खुलकर	kʰ ʊ l k ə ɾ
खुलना	kʰ ʊ l n ɑː
खुला	kʰ ʊ l ɑː
खुलापन	kʰ ʊ l ɑː p ə n
खूब	kʰ uː b
खेत	kʰ e t̪
खेती	kʰ eː t̪ iː
खेद	kʰ eː d̪
खेल	kʰ eː l
खेलना	kʰ eː l n ɑː
खोज	kʰ oː d͡ʒ
खोपड़ी	kʰ oː p ɽ iː
खोया	kʰ oː j ɑː
खोला	kʰ oː l ɑː
गंतव्य	ɡ ə n t̪ ə ʋ j
गंदगी	ɡ ə n d̪ ə ɡ iː
गंदा	ɡ ə n d̪ ɑː
गंभीर	ɡ ə m bʱ iː ɾ
गंवाना	ɡ ə̃ ʋ ɑː n ɑː
गई	ɡ ə iː
गऊ	ɡ ə uː
गगन	ɡ ə ɡ ə n
गज	ɡ ə d͡ʒ
गठजोड़	ɡ ə ʈʰ d͡ʒ oː ɽ
गठित	ɡ ə ʈʰ ɪ t̪
गड्ढा	ɡ ə ɖ ɖʱ ɑː
गढ़	ɡ ə ɽʱ
गढ़वाल	ɡ ə ɽʱ ʋ ɑː l
गढ़ी	ɡ ə ɽʱ iː
गणना	ɡ ə n n ɑː
गणित	ɡ ə n ɪ t̪
गणितज्ञ	ɡ ə n ɪ t̪ ə ɡ j
गणेश	ɡ ə ɳ e ʃ
गत	ɡ ə t̪
गतिमान	ɡ ə t̪ ɪ m ɑː n
गद्य	ɡ ə d̪ j
गधा	ɡ ə d̪ʱ ɑː
गन्ना	ɡ ə n n ɑː
गपशप	ɡ ə p ʃ ə p
गम्भीर	ɡ ə m bʱ iː ɾ
गया	ɡ ə j ɑː
गरिमा	ɡ ə ɾ ɪ m ɑː
गर्दिश	ɡ ə ɾ d̪ ɪ ʃ
गर्भवती	ɡ ə ɾ bʱ ʋ ə t̪ iː
गर्भावस्था	ɡ ə ɾ bʱ ɑː ʋ ə s t̪ʰ ɑː
गला	ɡ ə l ɑː
गलियारा	ɡ ə l iː j ɑː ɾ ɑː
गली	ɡ ə l iː
गवाह	ɡ ə ʋ ɑːʱ
गश्त	ɡ ə ʃ t̪
गहना	ɡ ɛːʱ n ɑː
गहरा	ɡ ɛːʱ ɾ ɑː
गाँधी	ɡ ɑ̃ː d̪ʱ iː
गांगुली	ɡ ɑː ŋ ɡ ʊ l iː
गांजा	ɡ ãː n̪ d ʒ aː
गांव	ɡ ɑ̃ː ʋ
गाजर	ɡ ɑː d͡ʒ ə ɾ
गाड़ा	ɡ ɑː ɽ ɑː
गाय	ɡ ɑː j
गायकी	ɡ ɑː j ə k iː
गायन	ɡ ɑː j ə n
गिनना	ɡ ɪ n n ɑː
गिनी	ɡ ɪ n iː
गिरगिट	ɡ ɪ ɾ ɡ ɪ ʈ
गिरजा	ɡ ɪ ɾ d͡ʒ ɑː
गिरफ़्तार	ɡ ɪ ɾ ə f t̪ ɑː ɾ
गिरा	ɡ ɪ ɾ ɑː
गिराना	ɡ ɪ ɾ ɑː n ɑː
गिरोह	ɡ ɪ ɾ oːʱ
गिलहरी	ɡ ɪ l ɛːʱ ɾ iː
गिला	ɡ ɪ l ɑː
गिलास	ɡ ɪ l ɑː s
गीला	ɡ iː l ɑː
गुंटूर	ɡ ʊ n ʈ uː ɾ
गुंडा	ɡ ʊ n ɖ ɑː
गुंडागर्दी	ɡ ʊ n ɖ ɑː ɡ ə ɾ d̪ iː
गुजरात	ɡ ʊ d͡ʒ ɾ ɑː t̪
गुजराती	ɡ ʊ d͡ʒ ɾ ɑː t̪ iː
गुज़रना	ɡ ʊ z ə ɾ n ɑː
गुदा	ɡ ʊ d̪ ɑː
गुनाह	ɡ ʊ n ɑːʱ
गुप्तचर	ɡ ʊ p t̪ t͡ʃ ə ɾ
गुप्तांग	ɡ ʊ p t̪ ɑː ŋ ɡ
गुफा	ɡ ʊ pʰ ɑː
गुम	ɡ ʊ m
गुमनाम	ɡ ʊ m n ɑː m
गुरु	ɡ ʊ ɾ uː
गुरुत्वीय	ɡ ʊ ɾ ʊ t̪ ʋ iː j
गुरुद्वारा	ɡ ʊ ɾ ʊ d̪ ʋ ɑː ɾ ɑː
गुरू	ɡ ʊ ɾ uː
गुलज़ार	ɡ ʊ l z ɑː ɾ
गुलदस्ता	ɡ ʊ l d̪ ə s t̪ ɑː
गुलशन	ɡ ʊ l ʃ ə n
गुलाब	ɡ ʊ l ɑː b
गुलाबी	ɡ ʊ l ɑː b iː
गुवाहाटी	ɡ ʊ ʋ ɑː ɦ ɑː ʈ iː
गूंगा	ɡ uː ŋ ɡ ɑː
गूंजना	ɡ uː ɲ d͡ʒ n ɑː
गृहमंत्री	ɡ ɾ ɪʱ m ə n t̪ ɾ iː
गृहस्थ	ɡ ɾ ɪ ɦ ə s t̪ʰ
गे	ɡ eː
गोदी	ɡ oː d̪ iː
गोपनीयता	ɡ oː p n iː j ə t̪ ɑː
गोबर	ɡ oː b ə ɾ
गोल	ɡ oː l
गोलबंदी	ɡ oː l b ə n d̪ iː
गोलमाल	ɡ oː l m ɑː l
गोलीबारी	ɡ oː l iː b ɑː ɾ iː
गोवा	ɡ oː ʋ ɑː
गौरव	ɡ ɔː ɾ ə ʋ
गौरवान्वित	ɡ ɔː ɾ ə ʋ ɑː n ʋ ɪ t̪
गौशाला	ɡ ɔː ʃ ɑː l ɑː
ग्राहक	ɡ ɾ ɑː ɦ ə k
ग्रीस	ɡ ɾ iː s
ग्लासगो	ɡ l ɑː s ɡ oː
ग्वालियर	ɡ ʋ ɑː l iː j ə ɾ
घंटा	ɡʱ ə n ʈ ɑː
घटना	ɡʱ ə ʈ n ɑː
घटित	ɡʱ ə ʈ ɪ t̪
घटिया	ɡʱ ə ʈ iː j ɑː
घन	ɡʱ ə n
घनत्व	ɡʱ ə n ə t̪ ʋ
घबराना	ɡʱ ə b ɾ ɑː n ɑː
घबराहट	ɡʱ ə b ɾ ɑː ɦ ə ʈ
घमंड	ɡʱ ə m ə n ɖ
घमासान	ɡʱ ə m ɑː s ɑː n
घर	ɡʱ ə ɾ
घरेलू	ɡʱ ə ɾ eː l uː
घर्षण	ɡʱ ə ɾ ʃ ə n
घाटी	ɡʱ ɑː ʈ iː
घात	ɡʱ ɑː t̪
घाना	ɡʱ ɑː n ɑː
घायल	ɡʱ ɑː j ə l
घाव	ɡʱ ɑː ʋ
घी	ɡʱ iː
घुटना	ɡʱ ʊ ʈ n ɑː
घुड़सवार	ɡʱ ʊ ɽ ə s ʋ ɑː ɾ
घुसपैठ	ɡʱ ʊ s p ɛː ʈʰ
घूंट	ɡʱ uː n ʈ
घूम	ɡʱ uː m
घेरना	ɡʱ eː ɾ n ɑː
घेराव	ɡʱ eː ɾ ɑː ʋ
घोटाला	ɡʱ oː ʈ ɑː l ɑː
घोड़ा	ɡʱ oː ɽ ɑː
घोल	ɡʱ oː l
घोषणा	ɡʱ oː ʃ n ɑː
चंद	t͡ʃ ə n d̪
चंद्र	t͡ʃ ə n d̪ ɾ
चंद्रगुप्त	t͡ʃ ə n d̪ ɾ ə ɡ ʊ p t̪
चंद्रग्रहण	t͡ʃ ə n d̪ ɾ ə ɡ ɾ ɛːʱ n
चंद्रमा	t͡ʃ ə n d̪ ɾ ə m ɑː
चंपा	t͡ʃ ə m p ɑː
चक्र	t͡ʃ ə k ɾ
चक्रवर्ती	t͡ʃ ə k ɾ ə ʋ ə ɾ t̪ iː
चटगांव	t͡ʃ ə ʈ ɡ ɑ̃ː ʋ
चटनी	t͡ʃ ə ʈ n iː
चट्टान	t͡ʃ ə ʈ ʈ ɑː n
चढ़ना	t͡ʃ ə ɽʱ n ɑː
चढ़ाई	t͡ʃ ə ɽʱ ɑː iː
चतुराई	t͡ʃ ə t̪ ʊ ɾ ɑː iː
चना	t͡ʃ ə n ɑː
चन्द्र	t͡ʃ ə n d̪ ɾ
चन्द्रमा	t͡ʃ ə n d̪ ɾ ə m ɑː
चपरासी	t͡ʃ ə p ɾ ɑː s iː
चपाती	t͡ʃ ə p ɑː t̪ iː
चपेट	t͡ʃ ə p eː ʈ
चप्पल	t͡ʃ ə p p ə l
चमक	t͡ʃ ə m ə k
चमड़ी	t͡ʃ ə m ɽ iː
चयन	t͡ʃ ə j ə n
चरण	t͡ʃ ə ɾ ə n
चरागाह	t͡ʃ ə ɾ ɑː ɡ ɑːʱ
चरित्र	t͡ʃ ə ɾ ɪ t̪ ɾ
चर्च	t͡ʃ ə ɾ t͡ʃ
चर्चित	t͡ʃ ə ɾ t͡ʃ ɪ t̪
चर्म	t͡ʃ ə ɾ m
चल	t͡ʃ ə l
चलना	t͡ʃ ə l n ɑː
चलाना	t͡ʃ ə l ɑː n ɑː
चवन्नी	t͡ʃ ə ʋ ə n n iː
चश्मा	t͡ʃ ə ʃ m ɑː
चाँद	t͡ʃ ɑː n d̪
चांदी	t͡ʃ ɑː n d̪ iː
चाकलेट	t͡ʃ ɑː k l eː ʈ
चाचा	t͡ʃ ɑː t͡ʃ ɑː
चाची	t͡ʃ ɑː t͡ʃ iː
चाट	t͡ʃ ɑː ʈ
चाप	t͡ʃ ɑː p
चाबी	t͡ʃ ɑː b iː
चाभी	t͡ʃ ɑː bʱ iː
चाय	t͡ʃ ɑː j
चार	t͡ʃ ɑː ɾ
चारपाई	t͡ʃ ɑː ɾ p ɑː iː
चाल	t͡ʃ ɑː l
चालान	t͡ʃ ɑː l ɑː n
चालीस	t͡ʃ ɑː l iː s
चावल	t͡ʃ ɑː ʋ ə l
चाशनी	t ʃ ɑː ʃ n iː
चाह	t͡ʃ ɑːʱ
चाहे	t͡ʃ ɑː ɦ eː
चिंगारी	t͡ʃ ɪ ŋ ɡ ɑː ɾ iː
चिंता	t͡ʃ ɪ n t̪ ɑː
चिंताजनक	t͡ʃ ɪ n t̪ ɑː d͡ʒ ə n ə k
चिड़िया	t͡ʃ ɪ ɽ iː j ɑː
चिढ़	t͡ʃ ɪ ɽʱ
चित	t͡ʃ ɪ t̪
चित्त	t͡ʃ ɪ t̪ t̪
चित्रकार	t͡ʃ ɪ t̪ ɾ ə k ɑː ɾ
चित्रण	t͡ʃ ɪ t̪ ɾ ə n
चिरंजीव	t͡ʃ ɪ ɾ ə ɲ d͡ʒ iː ʋ
चिली	t͡ʃ ɪ l iː
चीज़	t͡ʃ iː z
चीता	t͡ʃ iː t̪ ɑː
चीन	t͡ʃ iː n
चीनी	t͡ʃ iː n iː
चुकंदर	t͡ʃ ʊ k ə n d̪ ə ɾ
चुकाना	t͡ʃ ʊ k ɑː n ɑː
चुटकी	t͡ʃ ʊ ʈ k iː
चुटकुला	t͡ʃ ʊ ʈ k ʊ l ɑː
चुनौती	t͡ʃ ʊ n ɔː t̪ iː
चुपचाप	t͡ʃ ʊ p t͡ʃ ɑː p
चुप्पी	t͡ʃ ʊ p p iː
चुम्बन	t͡ʃ ʊ m b ə n
चुलबुल	t͡ʃ ʊ l b ʊ l
चूड़ी	t͡ʃ uː ɽ iː
चूना	t͡ʃ uː n ɑː
चूर्ण	t͡ʃ uː ɾ n
चूल्हा	t͡ʃ uː l ɦ ɑː
चूहा	t͡ʃ uː ɦ ɑː
चेक	t͡ʃ eː k
चेचेन	t͡ʃ eː t͡ʃ eː n
चेन्नई	t͡ʃ eː n n ə iː
चेरी	t͡ʃ eː ɾ iː
चेला	t͡ʃ eː l ɑː
चेहरा	t͡ʃ eːʱ ɾ ɑː
चैट	t͡ʃ ɛː ʈ
चोटी	t͡ʃ oː ʈ iː
चोर	t͡ʃ oː ɾ
चोरी	t͡ʃ oː ɾ iː
चौड़ा	t͡ʃ ɔː ɽ ɑː
चौथ	t͡ʃ ɔː t̪ʰ
चौथाई	t͡ʃ ɔː t̪ʰ ɑː iː
चौदह	t͡ʃ ɔː d̪ əʱ
चौबीस	t͡ʃ ɔː b iː s
छक्का	t͡ʃʰ ə k k ɑː
छटा	t͡ʃʰ ə ʈ ɑː
छड़ी	t͡ʃʰ ə ɽ iː
छतरी	t͡ʃʰ ə t̪ ɾ iː
छत्तीसगढ़	t͡ʃʰ ə t̪ t̪ iː s ɡ ə ɽʱ
छमाही	t͡ʃʰ ə m ɑː ɦ iː
छल	t͡ʃʰ ə l
छलकना	t͡ʃʰ ə l ə k n ɑː
छह	t͡ʃʰ əʱ
छाँव	t͡ʃʰ ɑ̃ː ʋ
छाछ	t͡ʃʰ ɑː t͡ʃʰ
छाती	t͡ʃʰ ɑː t̪ iː
छात्रसंघ	t͡ʃʰ ɑː t̪ ɾ ə s ə ŋ ɡʱ
छाप	t͡ʃʰ ɑː p
छापा	t͡ʃʰ ɑː p ɑː
छापामार	t͡ʃʰ ɑː p ɑː m ɑː ɾ
छावनी	t͡ʃʰ ɑː ʋ n iː
छिड़काव	t͡ʃʰ ɪ ɽ k ɑː ʋ
छिन	t͡ʃʰ ɪ n
छिपाना	t͡ʃʰ ɪ p ɑː n ɑː
छियालीस	t͡ʃʰ iː j ɑː l iː s
छिलका	t͡ʃʰ ɪ l k ɑː
छुपना	t͡ʃʰ ʊ p n ɑː
छूट	t͡ʃʰ uː ʈ
छेड़	t͡ʃʰ eː ɽ
छेड़छाड़	t͡ʃʰ eː ɽ t͡ʃʰ ɑː ɽ
छोटा	t͡ʃʰ oː ʈ ɑː
छोटू	t͡ʃʰ oː ʈ uː
छोड़ना	t͡ʃʰ oː ɽ n ɑː
जंग	d͡ʒ ə ŋ ɡ
जंतर	d͡ʒ ə n t̪ ə ɾ
जगाना	d͡ʒ ə ɡ ɑː n ɑː
जज	d͡ʒ ə d͡ʒ
जज़ीरा	d͡ʒ ə z iː ɾ ɑː
जड़	d͡ʒ ə ɽ
जताना	d͡ʒ ə t̪ ɑː n ɑː
जदयू	d͡ʒ ə d̪ j uː
जन	d͡ʒ ə n
जनजाति	d͡ʒ ə n d͡ʒ ɑː t̪ iː
जनतंत्र	d͡ʒ ə n t̪ ə n t̪ ɾ
जनता	d͡ʒ ə n t̪ ɑː
जननी	d͡ʒ ə n n iː
जनपद	d͡ʒ ə n p ə d̪
जनप्रतिनिधि	d͡ʒ ə n p ɾ ə t̪ ɪ n ɪ d̪ʱ iː
जनप्रतिनिधित्व	d͡ʒ ə n p ɾ ə t̪ ɪ n ɪ d̪ʱ ɪ t̪ ʋ
जनरल	d͡ʒ ə n ɾ ə l
जनसंख्या	d͡ʒ ə n s ə ŋ kʰ j ɑː
जनाधार	d͡ʒ ə n ɑː d̪ʱ ɑː ɾ
जनाब	d͡ʒ ə n ɑː b
जन्नत	d͡ʒ ə n n ə t̪
जन्मदिन	d͡ʒ ə n ə m d̪ ɪ n
जन्मभूमि	d͡ʒ ə n m bʱ uː m iː
जब	d͡ʒ ə b
जमशेदपुर	d͡ʒ ə m ʃ eː d̪ p ʊ ɾ
जमाई	d͡ʒ ə m ɑː iː
जमीन	d͡ʒ ə m iː n
जमीयत	d͡ʒ ə m iː j ə t̪
जम्मू	d͡ʒ ə m m uː
जय	d͡ʒ ə j
जयकार	d͡ʒ ə j ə k ɑː ɾ
जरूरी	d͡ʒ ə ɾ uː ɾ iː
जर्जर	d͡ʒ ə ɾ d͡ʒ ə ɾ
जर्मनी	d͡ʒ ə ɾ m ə n̪ iː
जल	d͡ʒ ə l
जलना	d͡ʒ ə l n ɑː
जलमार्ग	d͡ʒ ə l m ɑː ɾ ɡ
जलवा	d͡ʒ ə l ʋ ɑː
जलसा	d͡ʒ ə l s ɑː
जलारेख	d͡ʒ ə l ɑː ɾ eː kʰ
जलालाबाद	d͡ʒ ə l ɑː l ɑː b ɑː d̪
जलाशय	d͡ʒ ə l ɑː ʃ ə j
जलेबी	d͡ʒ ə l eː b iː
जल्द	d͡ʒ ə l d̪
जल्दबाज़ी	d͡ʒ ə l d̪ b ɑː z iː
जल्दी	d͡ʒ ə l d̪ iː
जवानी	d͡ʒ ə ʋ ɑː n iː
जहाँगीर	d͡ʒ ə ɦ ɑ̃ː ɡ iː ɾ
जहाज़	d͡ʒ ə ɦ ɑː z
जहान	d͡ʒ ə ɦ ɑː n
ज़फ़र	z ə f ə ɾ
ज़बान	z ə b ɑː n
ज़बानी	z ə b ɑː n iː
ज़मीन	z ə m iː n
ज़मीनी	z ə m iː n iː
ज़रिया	z ə ɾ iː j ɑː
ज़रूर	z ə ɾ uː ɾ
ज़हरीली	z ɛːʱ ɾ iː l iː
ज़ाहिर	z ɑː ɦ ɪ ɾ
ज़िंदा	z ɪ n d̪ ɑː
ज़िक्र	z ɪ k ɾ
ज़िम्बाब्वे	z ɪ m b ɑː b ʋ eː
ज़िलाधीश	z ɪ l ɑː d̪ʱ iː ʃ
ज़ीरा	z iː ɾ ɑː
ज़ेवर	z eː ʋ ə ɾ
ज़ेहन	z ɛːʱ n
ज़ोर	z oː ɾ
ज़ोरदार	z oː ɾ d̪ ɑː ɾ
जांघ	d͡ʒ ɑː ŋ ɡʱ
जाएगा	d͡ʒ ɑː eː ɡ ɑː
जागरूकता	d͡ʒ ɑː ɡ ɾ uː k t̪ ɑː
जातिगत	d͡ʒ ɑː t̪ ɪ ɡ ə t̪
जातिवाद	d͡ʒ ɑː t̪ iː ʋ ɑː d̪
जादू	d͡ʒ ɑː d̪ uː
जादूगर	d͡ʒ ɑː d̪ uː ɡ ə ɾ
जानकार	d͡ʒ ɑː n k ɑː ɾ
जानना	d͡ʒ ɑː n n ɑː
जानबूझकर	d͡ʒ ɑː n b uː d͡ʒʱ k ə ɾ
जानवर	d͡ʒ ɑː n ʋ ə ɾ
जाना	d͡ʒ ɑː n ɑː
जानी	d͡ʒ ɑː n iː
जापान	d͡ʒ ɑː p ɑː n
जाम	d͡ʒ ɑː m
जायज़	d͡ʒ ɑː j ə z
जायज़ा	d͡ʒ ɑː j ə z ɑː
जायदाद	d͡ʒ ɑː j ə d̪ ɑː d̪
जाल	d͡ʒ ɑː l
जासूसी	d͡ʒ ɑː s uː s iː
जिंस	d͡ʒ ɪ n s
जिज्ञासा	d͡ʒ ɪ ɡ j ɑː s ɑː
जितना	d͡ʒ ɪ t̪ n ɑː
जिन	d͡ʒ ɪ n
जिनका	d͡ʒ ɪ n k ɑː
जिन्न	d͡ʒ ɪ n n
जिन्होंने	d͡ʒ ɪ n ɦ õː n eː
जिस	d͡ʒ ɪ s
जिसका	d͡ʒ ɪ s k ɑː
जिसको	d͡ʒ ɪ s k oː
जिसने	d͡ʒ ɪ s n eː
जिसमें	d͡ʒ ɪ s m ẽ
जिससे	d͡ʒ ɪ s s eː
जिसे	d͡ʒ ɪ s eː
जी	d͡ʒ iː
जीजा	d͡ʒ iː d͡ʒ ɑː
जीतना	d͡ʒ iː t̪ n ɑː
जीन	d͡ʒ iː n
जीभ	d͡ʒ iː bʱ
जीवनी	d͡ʒ iː ʋ n iː
जीवाश्म	d͡ʒ iː ʋ ɑː ʃ m
जुआ	d͡ʒ ʊ ɑː
जुआरी	d͡ʒ ʊ ɑː ɾ iː
जुगनू	d͡ʒ ʊ ɡ n uː
जुगलबंदी	d͡ʒ ʊ ɡ ə l b ə n d̪ iː
जुटाना	d͡ʒ ʊ ʈ ɑː n ɑː
जुदा	d͡ʒ ʊ d̪ ɑː
जुदाई	d͡ʒ ʊ d̪ ɑː iː
जुनून	d͡ʒ ʊ n uː n
जुमला	d͡ʒ ʊ m l ɑː
जुमा	d͡ʒ ʊ m ɑː
जुर्म	d͡ʒ ʊ ɾ m
जुलूस	d͡ʒ ʊ l uː s
जूझना	d͡ʒ uː d͡ʒʱ n ɑː
जेठानी	d͡ʒ eː ʈʰ ɑː n iː
जेद्दा	d͡ʒ eː d̪ d̪ ɑː
जेब	d͡ʒ eː b
जेल	d͡ʒ eː l
जॉर्जिया	d͡ʒ ɔː ɾ d͡ʒ iː j ɑː
जॉर्डन	d͡ʒ ɔː ɾ ɖ ə n
जो	d͡ʒ oː
जोखिम	d͡ʒ oː kʰ ɪ m
जोड़ना	d͡ʒ oː ɽ n ɑː
जोधपुर	d͡ʒ oː d̪ʱ p ʊ ɾ
जोश	d͡ʒ oː ʃ
जौ	d͡ʒ ɔː
जौहर	d͡ʒ ɔː ɦ ə ɾ
ज्ञात	ɡ j ɑː t̪
ज्ञान	ɡ j ɑː n
ज्यादा	d͡ʒ j ɑː d̪ ɑː
ज्वार	d͡ʒ ʋ ɑː ɾ
ज्वालामुखी	d ʒ ʋ aː l aː m ʊ kʰ iː
झंझट	d͡ʒʱ ə ɲ d͡ʒʱ ə ʈ
झगड़ा	d͡ʒʱ ə ɡ ɽ ɑː
झड़प	d͡ʒʱ ə ɽ ə p
झामुमो	d͡ʒʱ ɑː m ʊ m oː
झारखण्ड	d͡ʒʱ ɑː ɾ kʰ ə n ɖ
झिझक	d͡ʒʱ ɪ d͡ʒʱ ə k
झील	d͡ʒʱ iː l
झुकना	d͡ʒʱ ʊ k n ɑː
झूठ	d͡ʒʱ uː ʈʰ
झूठा	d͡ʒʱ uː ʈʰ ɑː
झूठे	d ʒʱ uː ʈʰ e
झेलना	d͡ʒʱ eː l n ɑː
झोंपड़ा	d͡ʒʱ oː m p ɽ ɑː
झोली	d͡ʒʱ oː l iː
टकराव	ʈ ə k ɾ ɑː ʋ
टटोलना	ʈ ə ʈ oː l n ɑː
टब	ʈ ə b
टांग	ʈ ɑː ŋ ɡ
टापू	ʈ ɑː p uː
टिप्पणी	ʈ ɪ p p ə n iː
टीकाकरण	ʈ iː k ɑː k ə ɾ ə n
टीम	ʈ iː m
टीस	ʈ iː s
टूर्नामेंट	ʈ uː ɾ n ɑː m eː n ʈ
टेक	ʈ eː k
टैंकर	ʈ ɛː ŋ k ə ɾ
टैक्स	ʈ ɛː k s
टोकना	ʈ oː k n ɑː
टोकरा	ʈ oː k ɾ ɑː
टोक्यो	ʈ oː k j oː
टोपी	ʈ oː p iː
टोरंटो	ʈ oː ɾ ə n ʈ oː
ट्यूनिशिया	ʈ j uː n ɪ ʃ iː j ɑː
ट्वीट	ʈ ʋ iː ʈ
ठंडक	ʈʰ ə n ɖ ə k
ठंडा	ʈʰ ə n ɖ ɑː
ठिठक	ʈʰ ɪ ʈʰ ə k
ठेठ	ʈʰ eː ʈʰ
ठोस	ʈʰ oː s
डकार	ɖ ə k ɑː ɾ
डरबन	ɖ ə ɾ b ə n
डाक	ɖ ɑː k
डाकघर	ɖ ɑː k ɡʱ ə ɾ
डायनासोर	ɖ ɑː j n ɑː s oː ɾ
डायरी	ɖ ɑː j ə ɾ iː
डार्विन	ɖ ɑː ɾ ʋ ɪ n
डाल	ɖ ɑː l
डालना	ɖ ɑː l n ɑː
डिक्की	ɖ ɪ k k iː
डिजिटल	ɖ ɪ d͡ʒ ɪ ʈ ə l
डिप्टी	ɖ ɪ p ʈ iː
डिमांड	ɖ ɪ m ɑː n ɖ
डीज़ल	ɖ iː z ə l
डीयू	ɖ iː j uː
डुबकी	ɖ ʊ b k iː
डेटा	ɖ eː ʈ ɑː
डेढ़	ɖ eː ɽʱ
डेनमार्क	ɖ eː n m ɑː ɾ k
डेरा	ɖ eː ɾ ɑː
डॉक्टर	ɖ ɔː k ʈ ə ɾ
डोरी	ɖ oː ɾ iː
डोली	ɖ oː l iː
ड्यूक	ɖ j uː k
ढाँचा	ɖʱ ɑ̃ː t͡ʃ ɑː
ढांचा	ɖʱ ɑː ɲ t͡ʃ ɑː
ढाई	ɖʱ ɑː iː
ढाका	ɖʱ ɑː k ɑː
ढाबा	ɖʱ ɑː b ɑː
ढाल	ɖʱ ɑː l
ढीठ	ɖʱ iː ʈʰ
ढील	ɖʱ iː l
ढेर	ɖʱ eː ɾ
ढोंग	ɖʱ oː ŋ ɡ
ढोना	ɖʱ oː n ɑː
तंग	t̪ ə ŋ ɡ
तंबू	t̪ ə m b uː
तक	t̪ ə k
तकरार	t̪ ə k ɾ ɑː ɾ
तकलीफ़	t̪ ə k l iː f
तकिया	t̪ ə k iː j ɑː
तजुर्बा	t̪ ə d͡ʒ ʊ ɾ b ɑː
तटस्थ	t̪ ə ʈ ə s t̪ʰ
तटीय	t̪ ə ʈ iː j
तत्कालीन	t̪ ə t̪ k ɑː l iː n
तथा	t̪ ə t̪ʰ ɑː
तथ्य	t̪ ə t̪ʰ j
तन	t̪ ə n
तनाव	t̪ ə n ɑː ʋ
तब	t̪ ə b
तबला	t̪ ə b l ɑː
तबाह	t̪ ə b ɑːʱ
तबाही	t̪ ə b ɑː ɦ iː
तबीयत	t̪ ə b iː j ə t̪
तमंचा	t̪ ə m ə ɲ t͡ʃ ɑː
तमन्ना	t̪ ə m ə n n ɑː
तमिल	t̪ ə m ɪ l
तय	t̪ ə j
तर	t̪ ə ɾ
तरफ़	t̪ ə ɾ ə f
तरल	t̪ ə ɾ ə l
तराई	t̪ ə ɾ ɑː iː
तरीका	t̪ ə ɾ iː k ɑː
तरेरना	t̪ ə ɾ eː ɾ n ɑː
तर्क	t̪ ə ɾ k
तर्जनी	t̪ ə ɾ d͡ʒ ə n iː
तर्ज़	t̪ ə ɾ z
तल	t̪ ə l
तलवार	t̪ ə l ʋ ɑː ɾ
तलाशी	t̪ ə l ɑː ʃ iː
तले	t̪ ə l eː
तसल्ली	t̪ ə s ə l l iː
तस्करी	t̪ ə s k ə ɾ iː
तस्वीर	t̪ ə s ʋ iː ɾ
तह	t̪ əʱ
तहज़ीब	t̪ ɛːʱ z iː b
तहलका	t̪ ɛːʱ l k ɑː
ताँबा	t̪ ɑ̃ː b ɑː
ताई	t̪ ɑː iː
ताउम्र	t̪ ɑː ʊ m ɾ
ताक	t̪ ɑː k
ताकि	t̪ ɑː k iː
ताज	t̪ ɑː d͡ʒ
ताजपोशी	t̪ ɑː d͡ʒ p oː ʃ iː
ताज़ा	t̪ ɑː z ɑː
तादाद	t̪ ɑː d̪ ɑː d̪
तान	t̪ ɑː n
तानाशाह	t̪ ɑː n ɑː ʃ ɑːʱ
ताप	t̪ ɑː p
तामील	t̪ ɑː m iː l
तारा	t̪ ɑː ɾ ɑː
तारीफ़	t̪ ɑː ɾ iː f
तालमेल	t̪ ɑː l m eː l
तालाब	t̪ ɑː l ɑː b
तालिका	t̪ ɑː l ɪ k ɑː
तालियों	t̪ ɑː l iː j õː
तालु	t̪ ɑː l uː
तावीज़	t̪ ɑː ʋ iː z
तासीर	t̪ ɑː s iː ɾ
तिजोरी	t̪ ɪ d͡ʒ oː ɾ iː
तिब्बत	t̪ ɪ b b ə t̪
तिरंगा	t̪ ɪ ɾ ə ŋ ɡ ɑː
तिरस्कार	t̪ ɪ ɾ ə s k ɑː ɾ
तिरुवनंतपुरम	t̪ ɪ ɾ ʊ ʋ ə n ə n t̪ ə p ʊ ɾ ə m
तीन	t̪ iː n
तीर	t̪ iː ɾ
तीली	t̪ iː l iː
तीव्रता	t̪ iː ʋ ɾ ə t̪ ɑː
तीस	t̪ iː s
तीसरा	t̪ iː s ɾ ɑː
तुम	t ʊ m
तुमने	t̪ ʊ m n eː
तुम्हें	t̪ ʊ m ɦ ẽ
तुर्क	t̪ ʊ ɾ k
तुर्कमेनिस्तान	t̪ ʊ ɾ k m eː n ɪ s t̪ ɑː n
तुर्किस्तान	t̪ ʊ ɾ k ɪ s t̪ ɑː n
तुलनात्मक	t̪ ʊ l ə n ɑː t̪ m ə k
तुलसी	t̪ ʊ l s iː
तुष्टीकरण	t̪ ʊ ʃ ʈ iː k ə ɾ ə n
तू	t̪ uː
तूफ़ान	t̪ uː f ɑː n
तेज	t̪ eː d͡ʒ
तेजपुर	t̪ eː d͡ʒ p ʊ ɾ
तेरा	t̪ eː ɾ ɑː
तेरे	t̪ eː ɾ eː
तेल	t̪ eː l
तेलंगाना	t̪ eː l ə ŋ ɡ ɑː n ɑː
तेलुगू	t̪ eː l ʊ ɡ uː
तैनात	t̪ ɛː n ɑː t̪
तैनाती	t̪ ɛː n ɑː t̪ iː
तो	t̪ oː
तोमर	t̪ oː m ə ɾ
तोहफ़ा	t̪ oːʱ f ɑː
तौर	t̪ ɔː ɾ
तौहीन	t̪ ɔː ɦ iː n
त्यागपत्र	t̪ j ɑː ɡ p ə t̪ ɾ
त्यौहार	t̪ j ɔː ɦ ɑː ɾ
त्रासदी	t̪ ɾ ɑː s d̪ iː
त्रिपुरा	t̪ ɾ ɪ p ʊ ɾ ɑː
त्वचा	t̪ ʋ ə t͡ʃ ɑː
त्वरित	t̪ ʋ ə ɾ ɪ t̪
थकान	t̪ʰ ə k ɑː n
थकावट	t̪ʰ ə k ɑː ʋ ə ʈ
थाई	t̪ʰ ɑː iː
थाना	t̪ʰ ɑː n ɑː
थानेदार	t̪ʰ ɑː n eː d̪ ɑː ɾ
थैला	t̪ʰ ɛː l ɑː
थोक	t̪ʰ oː k
थोड़ा	t̪ʰ oː ɽ ɑː
थोपना	t̪ʰ oː p n ɑː
दंग	d̪ ə ŋ ɡ
दंगल	d̪ ə ŋ ɡ ə l
दंगा	d̪ ə ŋ ɡ ɑː
दंड	d̪ ə n ɖ
दंभ	d̪ ə m bʱ
दंश	d̪ ə n ʃ
दक्ष	d̪ ə k ʃ
दक्षिण	d̪ ə k ʃ ɪ n
दक्षिणा	d̪ ə k ʃ ɪ n ɑː
दफ़तर	d̪ ə f t̪ ə ɾ
दफ़ा	d̪ ə f ɑː
दबदबा	d̪ ə b d̪ ə b ɑː
दबाना	d̪ ə b aː n̪ aː
दबाव	d̪ ə b ɑː ʋ
दमन	d̪ ə m ə n
दर	d̪ ə ɾ
दरअसल	d̪ ə ɾ ə s ə l
दरगाह	d̪ ə ɾ ɡ ɑːʱ
दरबार	d̪ ə ɾ b ɑː ɾ
दरमियान	d̪ ə ɾ m iː j ɑː n
दरवाज़ा	d̪ ə ɾ ʋ ɑː z ɑː
दरार	d̪ ə ɾ ɑː ɾ
दर्ज	d̪ ə ɾ d͡ʒ
दर्द	d̪ ə ɾ d̪
दर्दनाक	d̪ ə ɾ d̪ n ɑː k
दर्शन	d̪ ə ɾ ʃ ə n
दल	d̪ ə l
दलहन	d̪ ə l ɦ ə n
दलाल	d̪ ə l ɑː l
दलित	d̪ ə l ɪ t̪
दलील	d̪ ə l iː l
दवाई	d̪ ə ʋ ɑː iː
दशमलव	d̪ ə ʃ ə m l ə ʋ
दशहरा	d̪ ə ʃ ɛːʱ ɾ ɑː
दस	d̪ ə s
दस्यु	d̪ ə s j uː
दहला	d̪ ɛːʱ l ɑː
दही	d̪ ə ɦ iː
दाँत	d̪ ɑ̃ː t̪
दाँव	d̪ ɑ̃ː ʋ
दाई	d̪ ɑː iː
दाता	d̪ ɑː t̪ ɑː
दाताओं	d̪ ɑː t̪ ɑː oː n
दादा	d̪ ɑː d̪ ɑː
दादी	d̪ ɑː d̪ iː
दाम	d̪ ɑː m
दामन	d̪ ɑː m ə n
दायर	d̪ ɑː j ə ɾ
दारू	d̪ ɑː ɾ uː
दाल	d̪ ɑː l
दावत	d̪ ɑː ʋ ə t̪
दावेदार	d̪ ɑː ʋ eː d̪ ɑː ɾ
दाहिने	d̪ ɑː ɦ ɪ n eː
दिखावा	d̪ ɪ kʰ ɑː ʋ ɑː
दिगंबर	d̪ ɪ ɡ ə m b ə ɾ
दिग्गज	d̪ ɪ ɡ ɡ ə d͡ʒ
दिनेश	d̪ ɪ n eː ʃ
दिया	d̪ iː j ɑː
दिल	d̪ ɪ l
दिलचस्पी	d̪ ɪ l t͡ʃ ə s p iː
दिली	d̪ ɪ l iː
दिवाली	d̪ ɪ ʋ ɑː l iː
दिसंबर	d̪ ɪ s ə m b ə ɾ
दीदार	d̪ iː d̪ ɑː ɾ
दीनार	d̪ iː n ɑː ɾ
दीपक	d̪ iː p ə k
दीपावली	d̪ iː p ɑː ʋ l iː
दीया	d̪ iː j ɑː
दीर्घ	d̪ iː ɾ ɡʱ
दीवान	d̪ iː ʋ ɑː n
दीवार	d̪ iː ʋ ɑː ɾ
दुकान	d̪ ʊ k ɑː n
दुपट्टा	d̪ ʊ p ə ʈ ʈ ɑː
दुबई	d̪ ʊ b ə iː
दुर्गंध	d̪ ʊ ɾ ɡ ə n d̪ʱ
दुर्घटनाग्रस्त	d̪ ʊ ɾ ɡʱ ə ʈ n ɑː ɡ ɾ ə s t̪
दुर्भाग्य	d̪ ʊ ɾ bʱ ɑː ɡ j
दुर्भाग्यवश	d̪ ʊ ɾ bʱ ɑː ɡ j ə ʋ ə ʃ
दुर्भावना	d̪ ʊ ɾ bʱ ɑː ʋ n ɑː
दुर्व्यवहार	d̪ ʊ ɾ ʋ j ə ʋ ɦ ɑː ɾ
दुष्चक्र	d̪ ʊ ʃ t͡ʃ ə k ɾ
दुष्ट	d̪ ʊ ʃ ʈ
दुहाई	d̪ ʊ ɦ ɑː iː
दूतावास	d̪ uː t̪ ɑː ʋ ɑː s
दूध	d̪ uː d̪ʱ
दूधिया	d̪ uː d̪ʱ ɪ j ɑː
दूना	d̪ uː n ɑː
दूरदर्शिता	d̪ uː ɾ d̪ ə ɾ ʃ ɪ t̪ ɑː
दूरबीन	d̪ uː ɾ b iː n
दूरी	d̪ uː ɾ iː
दूल्हा	d̪ uː l ɦ ɑː
दूसरा	d̪ uː s ɾ ɑː
दृश्य	d̪ ɾ ɪ ʃ j
दृष्टि	d̪ ɾ ɪ ʃ ʈ iː
दे	d̪ eː
देखना	d̪ eː kʰ n ɑː
देन	d̪ eː n
देना	d̪ eː n ɑː
देने	d̪ eː n eː
देर	d̪ eː ɾ
देव	d̪ eː ʋ
देवदार	d̪ eː ʋ d̪ ɑː ɾ
देवल	d̪ eː ʋ ə l
देवी	d̪ eː ʋ iː
देश	d̪ eː ʃ
देशभक्त	d̪ eː ʃ bʱ ə k t̪
देशी	d̪ eː ʃ iː
देहरादून	d̪ eːʱ ɾ ɑː d̪ uː n
देहांत	d̪ eː ɦ ɑː n t̪
देहात	d̪ eː ɦ ɑː t̪
दो	d̪ oː
दोगुना	d̪ oː ɡ ʊ n ɑː
दोपहर	d̪ oː p ɛːʱ ɾ
दोष	d̪ oː ʃ
दोषी	d̪ oː ʃ iː
दोस्त	d̪ oː s t̪
दोहा	d̪ oː ɦ ɑː
दौड़	d̪ ɔː ɽ
दौर	d̪ ɔː ɾ
दौलतमंद	d̪ ɔː l ə t̪ m ə n d̪
द्रविड़	d̪ ɾ ə ʋ ɪ ɽ
द्रुतगामी	d̪ ɾ ʊ t̪ ɡ ɑː m iː
द्वार	d̪ ʋ aː r
द्वारा	d̪ ʋ ɑː ɾ ɑː
द्विपक्षीय	d̪ ʋ ɪ p ə k ʃ iː j
धंधा	d̪ʱ ə n d̪ʱ ɑː
धड़कन	d̪ʱ ə ɽ k ə n
धनिया	d̪ʱ ə n iː j ɑː
धनी	d̪ʱ ə n iː
धन्यवाद	d̪ʱ ə n j ə ʋ ɑː d̪
धब्बा	d̪ʱ ə b b ɑː
धमकाना	d̪ʱ ə m k ɑː n ɑː
धमकी	d̪ʱ ə m k iː
धमनी	d̪ʱ ə m n iː
धरती	d̪ʱ ə ɾ t̪ iː
धरना	d̪ʱ ə ɾ n ɑː
धरातल	d̪ʱ ə ɾ ɑː t̪ ə l
धर्म	d̪ʱ ə ɾ m
धर्मनिरपेक्ष	d̪ʱ ə ɾ m n ɪ ɾ p eː k ʃ
धर्मनिरपेक्षता	d̪ʱ ə ɾ m n ɪ ɾ p eː k ʃ t̪ ɑː
धर्मशाला	d̪ʱ ə ɾ ə m ʃ ɑː l ɑː
धर्मार्थ	d̪ʱ ə ɾ m ɑː ɾ t̪ʰ
धाकड़	d̪ʱ ɑː k ə ɽ
धाम	d̪ʱ ɑː m
धारणा	d̪ʱ ɑː ɾ n ɑː
धारा	d̪ʱ ɑː ɾ ɑː
धावा	d̪ʱ ɑː ʋ ɑː
धीरे	d̪ʱ iː ɾ eː
धुंध	d̪ʱ ʊ n d̪ʱ
धूप	d̪ʱ uː p
धूम	d̪ʱ uː m
धैर्य	d̪ʱ ɛː ɾ j
धोखा	d̪ʱ oː kʰ ɑː
धोखेबाज़	d̪ʱ oː kʰ eː b ɑː z
धोना	d̪ʱ oː n̪ ɑː
धोबी	d̪ʱ oː b iː
ध्यान	d̪ʱ j ɑː n
ध्रुवीकरण	d̪ʱ ɾ ʊ ʋ iː k ɾ ə n
ध्वज	d̪ʱ ʋ ə d͡ʒ
ध्वजा	d̪ʱ ʋ ə d͡ʒ ɑː
ध्वस्त	d̪ʱ ʋ ə s t̪
नंबर	n ə m b ə ɾ
नई	n ə iː
नकेल	n ə k eː l
नगण्य	n ə ɡ ə n j
नगर	n ə ɡ ə ɾ
नज़रबंदी	n ə z ə ɾ b ə n d̪ iː
नटखट	n ə ʈ kʰ ə ʈ
नतीजा	n ə t̪ iː d͡ʒ ɑː
नत्थी	n ə t̪ t̪ʰ iː
नदारद	n ə d̪ ɑː ɾ ə d̪
नदी	n ə d iː
नब्ज़	n ə b z
नमक	n ə m ə k
नमाज़	n ə m ɑː z
नमी	n ə m iː
नमूना	n ə m uː n ɑː
नम्रता	n ə m ɾ ə t̪ ɑː
नयन	n ə j ə n
नया	n ə j ɑː
नयी	n ə j iː
नर	n ə ɾ
नरक	n ə ɾ ə k
नरगिस	n ə ɾ ɡ ɪ s
नरसिंह	n ə ɾ s ɪ ŋ ɡʱ
नरेश	n ə ɾ eː ʃ
नर्तक	n ə ɾ t̪ ə k
नर्मदा	n ə ɾ m ə d̪ ɑː
नवंबर	n ə ʋ ə m b ə ɾ
नवजात	n ə ʋ d͡ʒ ɑː t̪
नवनीत	n ə ʋ n iː t̪
नवरात्रि	n ə ʋ ɾ ɑː t̪ ɾ iː
नवविवाहित	n ə ʋ ʋ ɪ ʋ ɑː ɦ ɪ t̪
नवाब	n ə ʋ ɑː b
नवीन	n ə ʋ iː n
नशा	n ə ʃ ɑː
नस	n ə s
नसीब	n ə s iː b
नसीहत	n ə s iː ɦ ə t̪
नस्ल	n ə s l
नस्लभेद	n ə s l bʱ eː d̪
नहर	n ɛːʱ ɾ
नहलाना	n ɛːʱ l ɑː n ɑː
नहीं	n ə ɦ ĩː
ना	n ɑː
नाइनसाफ़ी	n ɑː ɪ n s ɑː f iː
नाई	n ɑː iː
नाक	n ɑː k
नाकाम	n ɑː k ɑː m
नाखून	n ɑː kʰ uː n
नागपुर	n ɑː ɡ p ʊ ɾ
नागवार	n ɑː ɡ ə ʋ ɑː ɾ
नाता	n ɑː t̪ ɑː
नाना	n ɑː n ɑː
नानी	n ɑː n iː
नाभिक	n ɑː bʱ ɪ k
नाम	n ɑː m
नामंज़ूर	n ɑː m ə n z uː ɾ
नामक	n ɑː m ə k
नामकरण	n ɑː m k ə ɾ ə n
नामांकन	n ɑː m ɑː ŋ k ə n
नायब	n ɑː j ə b
नायाब	n ɑː j ɑː b
नायिका	n ɑː j ɪ k ɑː
नारंगी	n ɑː ɾ ə ŋ ɡ iː
नारा	n ɑː ɾ ɑː
नाराज़	n ɑː ɾ ɑː z
नारायण	n ɑː ɾ ɑː j ə n
नारी	n ɑː ɾ iː
नाल	n ɑː l
नाला	n ɑː l ɑː
नाव	n ɑː ʋ
नाशपाती	n ɑː ʃ p ɑː t̪ iː
नासिक	n ɑː s ɪ k
निंदा	n ɪ n d̪ ɑː
निःशुल्क	n ɪʰ ʃ ʊ l k
निकलना	n ɪ k ə l n ɑː
निकारागुआ	n ɪ k ɑː ɾ ɑː ɡ ʊ ɑː
निकाह	n ɪ k ɑːʱ
निगाह	n ɪ ɡ ɑːʱ
निचला	n ɪ t͡ʃ l ɑː
निज	n ɪ d͡ʒ
निजात	n ɪ d͡ʒ ɑː t̪
निजी	n ɪ d͡ʒ iː
निजीकरण	n ɪ d͡ʒ iː k ə ɾ ə n
नित्य	n ɪ t̪ j
निदेशक	n ɪ d̪ eː ʃ ə k
निनानवे	n ɪ n ɑː n ʋ eː
निन्यानवे	n ɪ n j ɑː n ʋ eː
निबंध	n ɪ b ə n d̪ʱ
निभाना	n ɪ bʱ ɑː n ɑː
निमंत्रण	n ɪ m ə n t̪ ɾ ə n
निम्न	n ɪ m n
नियंत्रित	n iː j ə n t̪ ɾ ɪ t̪
नियमित	n iː j ə m ɪ t̪
नियुक्ति	n iː j ʊ k t̪ iː
निरंकुश	n ɪ ɾ ə ŋ k ʊ ʃ
निरपेक्ष	n ɪ ɾ p eː k ʃ
निरस्त	n ɪ ɾ ə s t̪
निराश	n ɪ ɾ ɑː ʃ
निराशा	n ɪ ɾ ɑː ʃ ɑː
निरीक्षक	n ɪ ɾ iː k ʃ ə k
निरीक्षण	n ɪ ɾ iː k ʃ ə n
निर्णय	n ɪ ɾ n ə j
निर्णायक	n ɪ ɾ n ɑː j ə k
निर्देश	n ɪ ɾ d̪ eː ʃ
निर्देशक	n ɪ ɾ d̪ eː ʃ ə k
निर्देशन	n ɪ ɾ d̪ eː ʃ ə n
निर्भर	n ɪ ɾ bʱ ə ɾ
निर्मल	n ɪ ɾ m ə l
निर्माण	n ɪ ɾ m ɑː n
निर्मित	n ɪ ɾ m ɪ t̪
निर्यात	n ɪ ɾ j ɑː t̪
निर्वाचित	n ɪ ɾ ʋ ɑː t͡ʃ ɪ t̪
निलंबित	n ɪ l ə m b ɪ t̪
निवाला	n ɪ ʋ ɑː l ɑː
निवास	n ɪ ʋ ɑː s
निवासी	n ɪ ʋ ɑː s iː
निवृत्त	n ɪ ʋ ɾ ɪ t̪ t̪
निवेदन	n ɪ ʋ eː d̪ ə n
निवेश	n ɪ ʋ eː ʃ
निशान	n ɪ ʃ ɑː n
निश्चय	n ɪ ʃ t͡ʃ ə j
निष्कर्ष	n ɪ ʃ k ə ɾ ʃ
निष्कासन	n ɪ ʃ k ɑː s ə n
निष्कासित	n ɪ ʃ k ɑː s ɪ t̪
निष्क्रिय	n ɪ ʃ k ɾ ɪ j
निष्ठा	n ɪ ʃ ʈʰ ɑː
निष्पक्ष	n ɪ ʃ p ə k ʃ
निसार	n ɪ s ɑː ɾ
निस्संदेह	n ɪ s s ə n d̪ eːʱ
नींबू	n iː m b uː
नींव	n ĩː ʋ
नीति	n iː t̪ iː
नीतिगत	n iː t̪ ɪ ɡ ə t̪
नीयत	n iː j ə t̪
नील	n iː l
नीलम	n iː l ə m
नीला	n iː l ɑː
नीलाम	n iː l ɑː m
नुमाइंदगी	n ʊ m ɑː ɪ n d̪ ə ɡ iː
नुमाइंदा	n ʊ m ɑː ɪ n d̪ ɑː
नुमाइश	n ʊ m ɑː ɪ ʃ
नुस्खा	n ʊ s kʰ ɑː
नूर	n uː ɾ
नृत्य	n ɾ ɪ t̪ j ə
ने	n eː
नेक	n eː k
नेकी	n eː k iː
नेटवर्क	n eː ʈ ʋ ə ɾ k
नेता	n eː t̪ ɑː
नेतृत्व	n eː t̪ ɾ ɪ t̪ ʋ
नेत्र	n eː t̪ ɾ
नेपथ्य	n eː p ə t̪ʰ j
नेम	n eː m
नेस्तनाबूद	n eː s t̪ ə n ɑː b uː d̪
नैन	n ɛː n
नॉर्वे	n ɔː ɾ ʋ eː
नोएडा	n oː eː ɖ ɑː
नोट	n oː ʈ
नोटबुक	n oː ʈ b ʊ k
नौकर	n ɔː k ə ɾ
नौकरशाही	n ɔː k ə ɾ ʃ ɑː ɦ iː
नौका	n ɔː k ɑː
नौबत	n ɔː b ə t̪
नौसेना	n ɔː s eː n ɑː
न्याय	n j ɑː j
न्यायिक	n j ɑː j ɪ k
न्यास	n j ɑː s
न्यूज़	n j uː z
न्यूनतम	n j uː n t̪ ə m
न्योता	n j oː t̪ ɑː
पंक्ति	p ə ŋ k t̪ iː
पंखा	p ə ŋ kʰ ɑː
पंगु	p ə ŋ ɡ uː
पंचशील	p ə ɲ t͡ʃ ʃ iː l
पंचायत	p ə ɲ t͡ʃ ɑː j ə t̪
पंचायती	p ə ɲ t͡ʃ ɑː j ə t̪ iː
पंछी	p ə ɲ t͡ʃʰ iː
पंजाब	p ə ɲ d͡ʒ ɑː b
पंजीकरण	p ə ɲ d͡ʒ iː k ə ɾ ə n
पंडाल	p ə n ɖ ɑː l
पंडित	p ə n ɖ ɪ t̪
पंसारी	p ə n s ɑː ɾ iː
पकवान	p ə k ʋ ɑː n
पकाना	p ə k ɑː n ɑː
पक्का	p ə k k ɑː
पक्षधर	p ə k ʃ d̪ʱ ə ɾ
पक्षपात	p ə k ʃ p ɑː t̪
पक्षपातपूर्ण	p ə k ʃ p ɑː t̪ p uː ɾ n
पखवाड़ा	p ə kʰ ʋ ɑː ɽ ɑː
पगला	p ə ɡ l ɑː
पचहत्तर	p ə t͡ʃʰ ə t̪ t̪ ə ɾ
पचानवे	p ə t͡ʃ ɑː n ʋ eː
पचास	p ə t͡ʃ ɑː s
पछाड़	p ə t͡ʃʰ ɑː ɽ
पछाड़ना	p ə t͡ʃʰ ɑː ɽ n ɑː
पटरी	p ə ʈ ɾ iː
पटवारी	p ə ʈ ʋ ɑː ɾ iː
पटाखा	p ə ʈ ɑː kʰ ɑː
पटेल	p ə ʈ eː l
पट्टा	p ə ʈ ʈ ɑː
पड़ताल	p ə ɽ t̪ ɑː l
पड़ना	p ə ɽ n ɑː
पढ़ना	p ə ɽʱ n ɑː
पढ़ाई	p ə ɽʱ ɑː iː
पतला	p ə t̪ l ɑː
पतलून	p ə t̪ l uː n
पत्ती	p ə tː iː
पत्तीदार	p ə t̪ t̪ iː d̪ ɑː ɾ
पत्थर	p ə t̪ t̪ʰ ə ɾ
पत्र	p ə t̪ ɾ
पथ	p ə t̪ʰ
पदक	p ə d̪ ə k
पदयात्रा	p ə d̪ j ɑː t̪ ɾ ɑː
पदवी	p ə d̪ ʋ iː
पदाधिकारी	p ə d̪ ɑː d̪ʱ ɪ k ɑː ɾ iː
पद्धति	p ə d̪ d̪ʱ ə t̪ iː
पद्म	p ə d̪ m
पनडुब्बी	p ə n ɖ ʊ b b iː
पनामा	p ə n ɑː m ɑː
पनीर	p ə n iː ɾ
पन्द्रह	p ə n d̪ ɾ əʱ
पन्ना	p ə n n ɑː
पपीता	p ə p iː t̪ ɑː
पर	p ə ɾ
परंपरागत	p ə ɾ ə m p ə ɾ ɑː ɡ ə t̪
परख	p ə ɾ ə kʰ
परचम	p ə ɾ t͡ʃ ə m
परमाणु	p ə ɾ m ɑː n uː
परवाज़	p ə ɾ ʋ ɑː z
परवाह	p ə ɾ ʋ ɑːʱ
परस्पर	p ə ɾ ə s p ə ɾ
पराठा	p ə ɾ ɑː ʈʰ ɑː
परामर्श	p ə ɾ ɑː m ə ɾ ʃ
पराया	p ə ɾ ɑː j ɑː
परास्त	p ə ɾ ɑː s t̪
परिचय	p ə ɾ ɪ t͡ʃ ə j
परिचालन	p ə ɾ ɪ t͡ʃ ɑː l ə n
परिचित	p ə ɾ ɪ t͡ʃ ɪ t̪
परिणाम	p ə ɾ ɪ n ɑː m
परिणामस्वरूप	p ə ɾ ɪ n ɑː m s ʋ ə ɾ uː p
परित्यक्त	p ə ɾ ɪ t̪ j ə k t̪
परिदृश्य	p ə ɾ ɪ d̪ ɾ ɪ ʃ j
परिधि	p ə ɾ ɪ d̪ʱ iː
परिभाषा	p ə r ɪ bʱ aː ʃ aː
परिभाषित	p ə ɾ ɪ bʱ ɑː ʃ ɪ t̪
परियोजना	p ə ɾ iː j oː d͡ʒ n ɑː
परिवारवाद	p ə ɾ ɪ ʋ ɑː ɾ ʋ ɑː d̪
परिषद	p ə ɾ ɪ ʃ ə d̪
परिसंघ	p ə ɾ ɪ s ə ŋ ɡʱ
परिसंपत्ति	p ə ɾ ɪ s ə m p ə t̪ t̪ iː
परी	p ə ɾ iː
परीक्षण	p ə ɾ iː k ʃ ə n
परीक्षा	p ə ɾ iː k ʃ ɑː
परे	p ə ɾ eː
परोसा	p ə ɾ oː s ɑː
पर्याप्त	p ə ɾ j ɑː p t̪
पर्याय	p ə ɾ j ɑː j
पर्यावरण	p ə ɾ j ɑː ʋ ə ɾ ə n
पर्व	p ə ɾ ʋ
पर्वत	p ə ɾ ʋ ə t̪
पल	p ə l
पलंग	p ə l ə ŋ ɡ
पलक	p ə l ə k
पलटवार	p ə l ə ʈ ʋ ɑː ɾ
पलायन	p ə l ɑː j ə n
पलीता	p ə l iː t̪ ɑː
पवन	p ə ʋ ə n
पशु	p ə ʃ uː
पश्चिम	p ə ʃ t͡ʃ ɪ m
पश्चिमी	p ə ʃ t͡ʃ ɪ m iː
पश्मीना	p ə ʃ m iː n ɑː
पसंद	p ə s ə n d̪
पसंदीदा	p ə s ə n d̪ iː d̪ ɑː
पसली	p ə s l iː
पसीना	p ə s iː n ɑː
पहचान	p ɛːʱ t͡ʃ ɑː n
पहनना	p ɛːʱ n n ɑː
पहनावा	p ɛːʱ n ɑː ʋ ɑː
पहरेदार	p ɛːʱ ɾ eː d̪ ɑː ɾ
पहल	p ɛːʱ l
पहला	p ɛːʱ l ɑː
पहले	p ɛːʱ l eː
पहाड़	p ə ɦ ɑː ɽ
पहुँचना	p ə ɦ ʊ̃ t͡ʃ n ɑː
पहुँचाना	p ə ɦ ʊ̃ t͡ʃ ɑː n ɑː
पहेली	p ə ɦ eː l iː
पांच	p ɑː ɲ t͡ʃ
पाउंड	p ɑː ʊ n ɖ
पाक	p ɑː k
पाकिस्तान	p ɑː k ɪ s t̪ ɑː n
पागल	p ɑː ɡ ə l
पाचन	p ɑː t͡ʃ ə n
पाठक	p ɑː ʈʰ ə k
पाठ्य	p ɑː ʈʰ j
पात्र	p ɑː t̪ ɾ
पाद	p ɑː d̪
पादरी	p ɑː d̪ ɾ iː
पान	p ɑː n
पाना	p ɑː n ɑː
पानी	p ɑː n iː
पापड़	p ɑː p ə ɽ
पाबंदी	p ɑː b ə n d̪ iː
पायदान	p ɑː j d̪ ɑː n
पायल	p ɑː j ə l
पार	p ɑː ɾ
पारदर्शी	p ɑː ɾ d̪ ə ɾ ʃ iː
पारसी	p ɑː ɾ s iː
पारिवारिक	p ɑː ɾ ɪ ʋ ɑː ɾ ɪ k
पारिश्रमिक	p ɑː ɾ ɪ ʃ ɾ ə m ɪ k
पारी	p ɑː ɾ iː
पालक	p ɑː l ə k
पालकी	p ɑː l k iː
पालना	p ɑː l n ɑː
पाश्चात्य	p ɑː ʃ t͡ʃ ɑː t̪ j
पास	p ɑː s
पिता	p ɪ t̪ ɑː
पितृ	p ɪ t̪ ɾ
पित्त	p ɪ t̪ t̪
पिया	p iː j ɑː
पिस्तौल	p ɪ s t̪ ɔː l
पीएम	p iː eː m
पीक	p iː k
पीठ	p iː ʈʰ
पीढ़ी	p iː ɽʱ iː
पीतल	p iː t̪ ə l
पीना	p iː n̪ ɑː
पीपल	p iː p ə l
पीरियड	p iː ɾ iː j ə ɖ
पीला	p iː l ɑː
पीलापन	p iː l ɑː p ə n
पुजारी	p ʊ d͡ʒ ɑː ɾ iː
पुट	p ʊ ʈ
पुण्य	p ʊ n j
पुण्यतिथि	p ʊ n j ə t̪ ɪ t̪ʰ iː
पुतला	p ʊ t̪ l ɑː
पुदीना	p ʊ d̪ iː n ɑː
पुनः	p ʊ n əʰ
पुनर्जीवित	p ʊ n ə ɾ d͡ʒ iː ʋ ɪ t̪
पुनर्निर्माण	p ʊ n ə ɾ n ɪ ɾ m ɑː n
पुरस्कार	p ʊ ɾ ə s k ɑː ɾ
पुरातत्व	p ʊ ɾ ɑː t̪ ə t̪ ʋ
पुरुष	p ʊ ɾ ʊ ʃ
पुरोहित	p ʊ ɾ oː ɦ ɪ t̪
पुर्तगाल	p ʊ ɾ t̪ ə ɡ ɑː l
पुल	p ʊ l
पुलिंदा	p ʊ l ɪ n d̪ ɑː
पुलिसकर्मी	p ʊ l ɪ s k ə ɾ m iː
पुश्तैनी	p ʊ ʃ t̪ ɛː n iː
पुष्प	p ʊ ʃ p
पुस्तक	p ʊ s t̪ ə k
पुस्तकालय	p ʊ s t̪ ə k ɑː l ə j
पुस्तिका	p ʊ s t̪ ɪ k ɑː
पूछ	p uː t͡ʃʰ
पूछना	p uː t͡ʃʰ n ɑː
पूरब	p uː ɾ ə b
पूरा	p uː ɾ ɑː
पूरी	p uː ɾ iː
पूर्ण	p uː ɾ n
पूर्णकालिक	p uː ɾ n ə k ɑː l ɪ k
पूर्णिमा	p uː ɾ n ɪ m ɑː
पूर्व	p uː ɾ ʋ
पूर्वी	p uː ɾ ʋ iː
पृथ्वी	p ɾ ɪ t̪ʰ ʋ iː
पेंशन	p eː n ʃ ə n
पेच	p eː t͡ʃ
पेचीदा	p eː t͡ʃ iː d̪ ɑː
पेज	p eː d͡ʒ
पेट	p eː ʈ
पेटी	p eː ʈ iː
पेट्रोल	p eː ʈ ɾ oː l
पेड़	p eː ɽ
पेन	p e n
पेरू	p eː ɾ uː
पेश	p eː ʃ
पेशा	p eː ʃ ɑː
पेशाब	p eː ʃ ɑː b
पेशावर	p eː ʃ ɑː ʋ ə ɾ
पेशी	p eː ʃ iː
पेशेवर	p eː ʃ eː ʋ ə ɾ
पैकेट	p ɛː k eː ʈ
पैदाइश	p ɛː d̪ ɑː ɪ ʃ
पैना	p ɛː n ɑː
पैमाना	p ɛː m ɑː n ɑː
पैरोकार	p ɛː ɾ oː k ɑː ɾ
पैसा	p ɛː s ɑː
पोत	p oː t̪
पोतना	p oː t̪ n ɑː
पोलैंड	p oː l ɛː n ɖ
पोशाक	p oː ʃ ɑː k
पौंड	p ɔː n ɖ
पौधा	p ɔː d̪ʱ ɑː
पौने	p ɔː n eː
पौराणिक	p ɔː ɾ ɑː n ɪ k
पौष्टिक	p ɔː ʃ ʈ ɪ k
प्याज	p j ɑː d͡ʒ
प्याज़	p j ɑː z
प्यादा	p j ɑː d̪ ɑː
प्यार	p j ɑː ɾ
प्यास	p j ɑː s
प्यासा	p j ɑː s ɑː
प्रकाश	p ɾ ə k ɑː ʃ
प्रक्रिया	p ɾ ə k ɾ iː j ɑː
प्रगति	p ɾ ə ɡ ə t̪ iː
प्रगतिशील	p ɾ ə ɡ ə t̪ ɪ ʃ iː l
प्रचंड	p ɾ ə t͡ʃ ə n ɖ
प्रचलित	p ɾ ə t͡ʃ ə l ɪ t̪
प्रचारित	p ɾ ə t͡ʃ ɑː ɾ ɪ t̪
प्रजा	p ɾ ə d͡ʒ ɑː
प्रजातंत्र	p ɾ ə d͡ʒ ɑː t̪ ə n t̪ ɾ
प्रण	p ɾ ə n
प्रणाम	p ɾ ə n ɑː m
प्रणाली	p ɾ ə n ɑː l iː
प्रतिक्रिया	p ɾ ə t̪ ɪ k ɾ iː j ɑː
प्रतिनिधि	p ɾ ə t̪ ɪ n ɪ d̪ʱ iː
प्रतिनिधित्व	p ɾ ə t̪ ɪ n ɪ d̪ʱ ɪ t̪ ʋ
प्रतिबंध	p ɾ ə t̪ ɪ b ə n d̪ʱ
प्रतिबंधित	p ɾ ə t̪ ɪ b ə n d̪ʱ ɪ t̪
प्रतिबिंब	p ɾ ə t̪ ɪ b ɪ m b
प्रतिभा	p ɾ ə t̪ ɪ bʱ ɑː
प्रतिभूति	p ɾ ə t̪ ɪ bʱ uː t̪ iː
प्रतिमा	p ɾ ə t̪ ɪ m ɑː
प्रतिमाह	p ɾ ə t̪ ɪ m ɑːʱ
प्रतियोगिता	p ɾ ə t̪ iː j oː ɡ ɪ t̪ ɑː
प्रतिरूप	p ɾ ə t̪ ɪ ɾ uː p
प्रतिरोध	p ɾ ə t̪ ɪ ɾ oː d̪ʱ
प्रतिरोधक	p ɾ ə t̪ ɪ ɾ oː d̪ʱ ə k
प्रतिशत	p ɾ ə t̪ ɪ ʃ ə t̪
प्रतिस्पर्धा	p ɾ ə t̪ ɪ s p ə ɾ d̪ʱ ɑː
प्रतीकात्मक	p ɾ ə t̪ iː k ɑː t̪ m ə k
प्रत्यक्षीकरण	p ɾ ə t̪ j ə k ʃ iː k ɾ ə n
प्रत्यर्पण	p ɾ ə t̪ j ə ɾ p ə n
प्रत्यर्पित	p ɾ ə t̪ j ə ɾ p ɪ t̪
प्रत्याशी	p ɾ ə t̪ j ɑː ʃ iː
प्रत्येक	p ɾ ə t̪ j eː k
प्रदर्शित	p ɾ ə d̪ ə ɾ ʃ ɪ t̪
प्रदाता	p ɾ ə d̪ ɑː t̪ ɑː
प्रदूषण	p ɾ ə d̪ uː ʃ ə n
प्रदेश	p ɾ ə d̪ eː ʃ
प्रधानाध्यापक	p ɾ ə d̪ʱ ɑː n ɑː d̪ʱ j ɑː p ə k
प्रबंध	p ɾ ə b ə n d̪ʱ
प्रबंधक	p ɾ ə b ə n d̪ʱ ə k
प्रबन्ध	p ɾ ə b ə n d̪ʱ
प्रबल	p ɾ ə b ə l
प्रभात	p ɾ ə bʱ ɑː t̪
प्रभारी	p ɾ ə bʱ ɑː ɾ iː
प्रभाव	p ɾ ə bʱ ɑː ʋ
प्रभावकारी	p ɾ ə bʱ ɑː ʋ k ɑː ɾ iː
प्रभावी	p ɾ ə bʱ ɑː ʋ iː
प्रमाण	p ɾ ə m ɑː n
प्रमुख	p ɾ ə m ʊ kʰ
प्रयास	p ɾ ə j ɑː s
प्रयोग	p ɾ ə j oː ɡ
प्रयोगशाला	p ɾ ə j oː ɡ ʃ ɑː l ɑː
प्रलय	p ɾ ə l ə j
प्रवक्ता	p ɾ ə ʋ ə k t̪ ɑː
प्रवर्तक	p ɾ ə ʋ ə ɾ t̪ ə k
प्रवाह	p ɾ ə ʋ ɑːʱ
प्रशंसक	p ɾ ə ʃ ə n s ə k
प्रशंसा	p ɾ ə ʃ ə n s ɑː
प्रशासक	p ɾ ə ʃ ɑː s ə k
प्रशासन	p ɾ ə ʃ ɑː s ə n
प्रशिक्षण	p ɾ ə ʃ ɪ k ʃ ə n
प्रसंग	p ɾ ə s ə ŋ ɡ
प्रसन्नता	p ɾ ə s ə n n t̪ ɑː
प्रसव	p ɾ ə s ə ʋ
प्रसारित	p ɾ ə s ɑː ɾ ɪ t̪
प्रस्ताव	p ɾ ə s t̪ ɑː ʋ
प्रस्तुत	p ɾ ə s t̪ ʊ t̪
प्रस्तुति	p ɾ ə s t̪ ʊ t̪ iː
प्रहार	p ɾ ə ɦ ɑː ɾ
प्रांत	p ɾ ɑː n t̪
प्राण	p ɾ ɑː n
प्राणी	p ɾ ɑː n iː
प्राथमिक	p r aː t̪ʰ m ɪ k
प्रादेशिक	p ɾ ɑː d̪ eː ʃ ɪ k
प्राधिकार	p ɾ ɑː d̪ʱ ɪ k ɑː ɾ
प्राध्यापक	p ɾ ɑː d̪ʱ j ɑː p ə k
प्राप्ति	p ɾ ɑː p t̪ iː
प्रायद्वीप	p ɾ ɑː j d̪ ʋ iː p
प्रारंभ	p ɾ ɑː ɾ ə m bʱ
प्रावधान	p ɾ ɑː ʋ d̪ʱ ɑː n
प्रासंगिक	p ɾ ɑː s ə ŋ ɡ ɪ k
प्रिंस	p ɾ ɪ n s
प्रिय	p ɾ ɪ j
प्रेक्षित	p ɾ eː k ʃ ɪ t̪
प्रेम	p ɾ eː m
प्रेरणा	p ɾ eː ɾ n ɑː
प्रेरित	p ɾ eː ɾ ɪ t̪
प्रेस	p ɾ eː s
प्रोग्राम	p ɾ oː ɡ ɾ ɑː m
प्रोत्साहन	p ɾ oː t̪ s ɑː ɦ ə n
प्रोत्साहित	p ɾ oː t̪ s ɑː ɦ ɪ t̪
प्रोस्टेट	p ɾ oː s ʈ eː ʈ
प्रौढ़	p ɾ ɔː ɽʱ
प्लीज़	p l iː z
फंदा	pʰ ə n d̪ ɑː
फट	pʰ ə ʈ
फरवरी	pʰ ə ɾ ʋ ə ɾ iː
फर्नीचर	pʰ ə ɾ n iː t͡ʃ ə ɾ
फल	pʰ ə l
फलस्वरूप	pʰ ə l ə s ʋ ə ɾ uː p
फ़तवा	f ə t̪ ʋ ɑː
फ़रमान	f ə ɾ m ɑː n
फ़रवरी	f ə ɾ ʋ ə ɾ iː
फ़रार	f ə ɾ ɑː ɾ
फ़रीदाबाद	f ə ɾ iː d̪ ɑː b ɑː d̪
फ़लस्तीनी	f ə l ə s t̪ iː n iː
फ़ालतू	f ɑː l t̪ uː
फ़िनलैंड	f ɪ n l ɛː n ɖ
फ़िलहाल	f ɪ l ɦ ɑː l
फ़ीस	f iː s
फ़ीसद	f iː s ə d̪
फ़ुटबॉल	f ʊ ʈ b ɔː l
फ़ेसबुक	f eː s b ʊ k
फ़ेहरिस्त	f eːʱ ɾ ɪ s t̪
फ़ैज़	f ɛː z
फ़ॉर्मूला	f ɔː ɾ m uː l ɑː
फ़ोटो	f oː ʈ oː
फ़ौज	f ɔː d͡ʒ
फ़ौरन	f ɔː ɾ ə n
फ़्रांसीसी	f ɾ ɑː n s iː s iː
फ़्लोरिडा	f l oː ɾ ɪ ɖ ɑː
फांसी	pʰ ɑː n s iː
फालतू	pʰ ɑː l t̪ uː
फिटकरी	pʰ ɪ ʈ k ə ɾ iː
फिरकी	pʰ ɪ ɾ k iː
फिरना	pʰ ɪ ɾ n ɑː
फिल्म	pʰ ɪ l m
फिसलन	pʰ ɪ s l ə n
फूंक	pʰ uː ŋ k
फूल	pʰ uː l
फेंक	pʰ eː ŋ k
फेंकना	pʰ eː ŋ k n ɑː
फेसबुक	pʰ eː s b ʊ k
फोड़ा	pʰ oː ɽ ɑː
फ्रांस	pʰ ɾ ɑː n s
बंगला	b ə ŋ ɡ l ɑː
बंगाली	b ə ŋ ɡ ɑː l iː
बंजर	b ə ɲ d͡ʒ ə ɾ
बंजारा	b ə ɲ d͡ʒ ɑː ɾ ɑː
बंद	b ə n d̪
बंदर	b ə n d̪ ə ɾ
बंदरिया	b ə n d̪ ə ɾ iː j ɑː
बंध	b ə n d̪ʱ
बंबई	b ə m b ə iː
बकरा	b ə k ɾ ɑː
बकरी	b ə k ɾ iː
बकवास	b ə k ʋ ɑː s
बखान	b ə kʰ ɑː n
बचना	b ə t͡ʃ n ɑː
बचपन	b ə t͡ʃ p ə n
बचपना	b ə t͡ʃ p ə n ɑː
बचाना	b ə t͡ʃ ɑː n ɑː
बच्चन	b ə t͡ʃ t͡ʃ ə n
बच्चा	b ə t͡ʃ t͡ʃ ɑː
बजाय	b ə d͡ʒ ɑː j
बटोरना	b ə ʈ oː ɾ n ɑː
बड़	b ə ɽ
बड़ा	b ə ɽ ɑː
बढ़ना	b ə ɽʱ n ɑː
बढ़ाना	b ə ɽʱ ɑː n ɑː
बढ़ावा	b ə ɽʱ ɑː ʋ ɑː
बढ़ोतरी	b ə ɽʱ oː t̪ ə ɾ iː
बताना	b ə t̪ ɑː n ɑː
बतौर	b ə t̪ ɔː ɾ
बत्तीस	b ə t̪ t̪ iː s
बदतमीज़	b ə d̪ t̪ ə m iː z
बदन	b ə d̪ ə n
बदल	b ə d̪ ə l
बदलाव	b ə d̪ l ɑː ʋ
बदौलत	b ə d̪ ɔː l ə t̪
बन	b ə n
बनना	b ə n n ɑː
बनवाना	b ə n ʋ ɑː n ɑː
बनाना	b ə n ɑː n ɑː
बनाने	b ə n ɑː n eː
बनाम	b ə n ɑː m
बनारस	b ə n ɑː ɾ ə s
बनावट	b ə n ɑː ʋ ə ʈ
बनावटी	b ə n aː ʋ ə ʈ iˑ
बन्दूक	b ə n d̪ uː k
बबूल	b ə b uː l
बब्बर	b ə b b ə ɾ
बमबारी	b ə m b ɑː ɾ iː
बम्बई	b ə m b ə iː
बयान	b ə j ɑː n
बरात	b ə ɾ ɑː t̪
बरामद	b ə ɾ ɑː m ə d̪
बरामदा	b ə ɾ ɑː m d̪ ɑː
बरी	b ə ɾ iː
बरेली	b ə ɾ eː l iː
बर्तन	b ə ɾ t̪ ə n
बर्ताव	b ə ɾ t̪ ɑː ʋ
बर्दाश्त	b ə ɾ d̪ ɑː ʃ t̪
बल	b ə l
बलूच	b ə l uː t͡ʃ
बलूचिस्तान	b ə l uː t͡ʃ ɪ s t̪ ɑː n
बल्ला	b ə l l ɑː
बल्लेबाज़	b ə l l eː b ɑː z
बवाल	b ə ʋ ɑː l
बस	b ə s
बसंत	b ə s ə n t̪
बस्ती	b ə s t̪ iː
बहना	b ɛːʱ n ɑː
बहनोई	b ɛːʱ n oː iː
बहरा	b ɛːʱ ɾ ɑː
बहाव	b ə ɦ ɑː ʋ
बहावलपुर	b ə ɦ ɑː ʋ ə l p ʊ ɾ
बहिन	b ɛːʱ n
बही	b ə ɦ iː
बहुचर्चित	b ə ɦ ʊ t͡ʃ ə ɾ t͡ʃ ɪ t̪
बहुजन	b ə ɦ ʊ d͡ʒ ə n
बहुराष्ट्रीय	b ə ɦ ʊ ɾ ɑː ʃ ʈ ɾ iː j
बहुसंख्यक	b ə ɦ ʊ s ə ŋ kʰ j ə k
बहू	b ə ɦ uː
बाँध	b ɑ̃ː d̪ʱ
बांग्लादेश	b ɑː ŋ ɡ l ɑː d̪ eː ʃ
बांटना	b ɑː n ʈ n ɑː
बाएँ	b ɑː ẽ
बाघ	b ɑː ɡʱ
बाजरा	b ɑː d͡ʒ ɾ ɑː
बाज़ारी	b ɑː z ɑː ɾ iː
बाजी	b ɑː d͡ʒ iː
बाट	b ɑː ʈ
बाड़ी	b ɑː ɽ iː
बाढ़	b ɑː ɽʱ
बाण	b ɑː n
बात	b ɑː t̪
बाती	b ɑː t̪ iː
बाथरूम	b ɑː t̪ʰ ɾ uː m
बाद	b ɑː d̪
बादशाह	b ɑː d̪ ʃ ɑːʱ
बादशाहत	b ɑː d̪ ʃ ɑː ɦ ə t̪
बादाम	b ɑː d̪ ɑː m
बान	b ɑː n
बापू	b ɑː p uː
बाबर	b ɑː b ə ɾ
बाबू	b ɑː b uː
बार	b ɑː ɾ
बारात	b ɑː ɾ ɑː t̪
बारिश	b ɑː ɾ ɪ ʃ
बारीक	b ɑː ɾ iː k
बाल	b ɑː l
बालिका	b ɑː l ɪ k ɑː
बालू	b ɑː l uː
बावजूद	b ɑː ʋ d͡ʒ uː d̪
बासन	b ɑː s ə n
बासमती	b ɑː s ə m t̪ iː
बाहुबली	b ɑː ɦ ʊ b ə l iː
बाह्य	b ɑːʱ j
बिंदास	b ɪ n d̪ ɑː s
बिंदी	b ɪ n d̪ iː
बिंदु	b ɪ n d̪ uː
बिक्री	b ɪ k ɾ iː
बिगड़ना	b ɪ ɡ ə ɽ n ɑː
बिगुल	b ɪ ɡ ʊ l
बिच्छू	b ɪ t͡ʃ t͡ʃʰ uː
बिछाना	b ɪ t͡ʃʰ ɑː n ɑː
बिजलीकरण	b ɪ d͡ʒ l iː k ə ɾ ə n
बिटिया	b ɪ ʈ iː j ɑː
बिताना	b ɪ t̪ ɑː n ɑː
बिना	b ɪ n ɑː
बिमारी	b ɪ m ɑː ɾ iː
बिरयानी	b ɪ ɾ j ɑː n iː
बिल्कुल	b ɪ l k ʊ l
बिल्ली	b ɪ l l iː
बिश्नोई	b ɪ ʃ n oː iː
बिस्कुट	b ɪ s k ʊ ʈ
बिस्तर	b ɪ s t̪ ə ɾ
बिहार	b ɪ ɦ ɑː ɾ
बिहारी	b ɪ ɦ ɑː ɾ iː
बी	b iː
बीकानेर	b iː k ɑː n eː ɾ
बीघा	b iː ɡʱ ɑː
बीच	b iː t͡ʃ
बीड़ा	b iː ɽ ɑː
बीड़ी	b iː ɽ iː
बीती	b iː t̪ iː
बीबी	b iː b iː
बीमा	b iː m ɑː
बीमारी	b iː m ɑː ɾ iː
बीर	b iː ɾ
बीरगंज	b iː ɾ ɡ ə ɲ d͡ʒ
बीवी	b iː ʋ iː
बीस	b iː s
बीहड़	b iː ɦ ə ɽ
बुआ	b ʊ ɑː
बुक	b ʊ k
बुड्ढा	b ʊ ɖ ɖʱ ɑː
बुढ़ापा	b ʊ ɽʱ aː p aː
बुद्ध	b ʊ d̪ d̪ʱ
बुद्धि	b ʊ d̪ d̪ʱ iː
बुद्धिजीवी	b ʊ d̪ d̪ʱ ɪ d͡ʒ iː ʋ iː
बुनियाद	b ʊ n ɪ j ɑː d̪
बुलंदशहर	b ʊ l ə n d̪ ʃ ɛːʱ ɾ
बुलाना	b ʊ l ɑː n ɑː
बुलेटिन	b ʊ l eː ʈ ɪ n
बुल्गारिया	b ʊ l ɡ ɑː ɾ iː j ɑː
बृहस्पति	b ɾ ɪ ɦ ə s p ə t̪ iː
बेंच	b eː ɲ t͡ʃ
बेकरी	b eː k ɾ iː
बेकार	b eː k ɑː ɾ
बेगुनाह	b eː ɡ ʊ n ɑːʱ
बेचैन	b eː t͡ʃ ɛː n
बेजान	b eː d͡ʒ ɑː n
बेटा	b eː ʈ ɑː
बेड़ा	b eː ɽ ɑː
बेतहाशा	b eː t̪ ə ɦ ɑː ʃ ɑː
बेताब	b eː t̪ ɑː b
बेनतीजा	b eː n ə t̪ iː d͡ʒ ɑː
बेमेल	b eː m eː l
बेलारूस	b eː l ɑː ɾ uː s
बेशक	b eː ʃ ə k
बेसन	b eː s ə n
बेसबॉल	b eː s b ɔː l
बैंगन	b ɛː ŋ ɡ ə n
बैठना	b ɛ ʈʰ n aː
बैर	b ɛː ɾ
बैल	b ɛː l
बैलगाड़ी	b ɛː l ɡ ɑː ɽ iː
बैसाखी	b ɛː s ɑː kʰ iː
बॉलीवुड	b ɔː l iː ʋ ʊ ɖ
बोझ	b oː d͡ʒʱ
बोझिल	b oː d͡ʒʱ ɪ l
बोट	b oː ʈ
बोध	b oː d̪ʱ
बोरियत	b oː ɾ iː j ə t̪
बोल	b oː l
बोलना	b oː l n ɑː
बोली	b oː l iː
बौछार	b ɔː t͡ʃʰ ɑː ɾ
बौना	b ɔː n ɑː
ब्याह	b j ɑːʱ
ब्यूरो	b j uː ɾ oː
ब्यौरा	b j ɔː ɾ ɑː
ब्रज	b ɾ ə d͡ʒ
ब्रह्म	b ɾ əʱ m
ब्राह्मी	b ɾ ɑːʱ m iː
ब्रिटेन	b ɾ ɪ ʈ eː n
भक्त	bʱ ə k t̪
भक्ति	bʱ ə k t̪ iː
भगदड़	bʱ ə ɡ d̪ ə ɽ
भगवा	bʱ ə ɡ ʋ ɑː
भगवान	bʱ ə ɡ ʋ ɑː n
भजन	bʱ ə d͡ʒ ə n
भटकना	bʱ ə ʈ ə k n ɑː
भटनागर	bʱ ə ʈ n ɑː ɡ ə ɾ
भड़काऊ	bʱ ə ɽ k ɑː uː
भड़कीला	bʱ ə ɽ k iː l ɑː
भतीजा	bʱ ə t̪ iː d͡ʒ ɑː
भतीजी	bʱ ə t̪ iː d͡ʒ iː
भत्ता	bʱ ə t̪ t̪ ɑː
भय	bʱ ɛː
भयभीत	bʱ ə j bʱ iː t̪
भरना	bʱ ə ɾ n ɑː
भरोसा	bʱ ə ɾ oː s ɑː
भरोसेमंद	bʱ ə ɾ oː s eː m ə n d̪
भर्ती	bʱ ə ɾ t̪ iː
भर्त्सना	bʱ ə ɾ t̪ s ə n ɑː
भले	bʱ ə l eː
भविष्य	bʱ ə ʋ ɪ ʃ j ə
भविष्यवाणी	bʱ ə ʋ ɪ ʃ j ə ʋ ɑː n iː
भांग	bʱ ɑː ŋ ɡ
भांजी	bʱ ɑː ɲ d͡ʒ iː
भाई	bʱ ɑː iː
भाग	bʱ ɑː ɡ
भागना	bʱ ɑː ɡ n ɑː
भागी	bʱ ɑː ɡ iː
भागे	bʱ ɑː ɡ eː
भाग्यशाली	bʱ aː ɡ j ə ʃ aː l iː
भाजपा	bʱ ɑː d͡ʒ p ɑː
भात	bʱ ɑː t̪
भाप	bʱ ɑː p
भाभी	bʱ ɑː bʱ iː
भार	bʱ ɑː ɾ
भारत	bʱ ɑː ɾ ə t̪
भारतीय	bʱ ɑː ɾ t̪ iː j
भारी	bʱ ɑː ɾ iː
भाव	bʱ ɑː ʋ
भावनात्मक	bʱ ɑː ʋ n ɑː t̪ m ə k
भावुक	bʱ ɑː ʋ ʊ k
भावुकता	bʱ ɑː ʋ ʊ k t̪ ɑː
भाषण	bʱ ɑː ʃ ə n
भाषा	bʱ ɑː ʂ ɑː
भास्कर	bʱ ɑː s k ə ɾ
भिखारी	bʱ ɪ kʰ ɑː ɾ iː
भिड़	bʱ ɪ ɽ
भिडु	bʱ ɪ ɖ uː
भीख	bʱ iː kʰ
भीड़	bʱ iː ɽ
भीतर	bʱ iː t̪ ə ɾ
भीषण	bʱ iː ʃ ə n
भुगतना	bʱ ʊ ɡ ə t̪ n ɑː
भुगतान	bʱ ʊ ɡ t̪ ɑː n
भुगताना	bʱ ʊ ɡ t̪ ɑː n ɑː
भुवन	bʱ ʊ ʋ ə n
भू	bʱ uː
भूख	bʱ uː kʰ
भूखा	bʱ uː kʰ ɑː
भूगोल	bʱ uː ɡ oː l
भूचाल	bʱ uː t͡ʃ ɑː l
भूटान	bʱ uː ʈ ɑː n
भूमिका	bʱ uː m ɪ k ɑː
भूमिगत	bʱ uː m ɪ ɡ ə t̪
भूविज्ञान	bʱ uː ʋ ɪ ɡ j ɑː n
भेजना	bʱ eː d͡ʒ n ɑː
भेजा	bʱ eː d͡ʒ ɑː
भेड़	bʱ eː ɽ
भेदभाव	bʱ eː d̪ bʱ ɑː ʋ
भेलपूरी	bʱ eː l p uː ɾ iː
भेषज	bʱ eː ʃ ə d͡ʒ
भैंस	bʱ ɛ̃ː s
भैया	bʱ ə iː j ɑː
भोग	bʱ oː ɡ
भोगना	bʱ oː ɡ n ɑː
भोजपुरी	bʱ oː d͡ʒ p ʊ ɾ iː
भोपाल	bʱ oː p ɑː l
भोर	bʱ oː ɾ
भोला	bʱ oː l ɑː
भौतिक	bʱ ɔː t̪ ɪ k
भौतिकी	bʱ ɔː t̪ ɪ k iː
भ्रष्ट	bʱ ɾ ə ʃ ʈ
भ्रष्टाचार	bʱ ɾ ə ʃ ʈ ɑː t͡ʃ ɑː ɾ
भ्रूण	bʱ ɾ uː n
मंगल	m ə ŋ ɡ ə l
मंगोलिया	m ə ŋ ɡ oː l iː j ɑː
मंज़र	m ə n z ə ɾ
मंज़िल	m ə n z ɪ l
मंज़ूर	m ə n z uː ɾ
मंत्रालय	m ə n t̪ ɾ ɑː l ə j
मंशा	m ə n ʃ ɑː
मई	m ə iː
मकान	m ə k aː n
मक्का	m ə k k ɑː
मक्खन	m ə k kʰ ə n
मगर	m ə ɡ ə ɾ
मगरमच्छ	m ə ɡ ə ɾ m ə t͡ʃ t͡ʃʰ
मचाना	m ə t͡ʃ ɑː n ɑː
मछलीपालन	m ə t͡ʃʰ l iː p ɑː l ə n
मछुआरा	m ə t͡ʃʰ ʊ ɑː ɾ ɑː
मजनू	m ə d͡ʒ n uː
मजनूँ	m ə d͡ʒ n ũː
मजबूर	m ə d͡ʒ b uː ɾ
मजबूरी	m ə d͡ʒ b uː ɾ iː
मजलिस	m ə d͡ʒ l ɪ s
मज़लूम	m ə z l uː m
मज़ा	m ə z ɑː
मज़ार	m ə z ɑː ɾ
मटमैला	m ə ʈ m ɛː l ɑː
मटर	m ə ʈ ə ɾ
मठ	m ə ʈʰ
मणि	m ə n iː
मत	m ə t̪
मतगणना	m ə t̪ ɡ ə n n ɑː
मतदाता	m ə t̪ d̪ ɑː t̪ ɑː
मतदान	m ə t̪ d̪ ɑː n
मतलब	m ə t̪ l ə b
मतलबी	m ə t̪ l ə b iː
मथुरा	m ə t̪ʰ ʊ ɾ ɑː
मद	m ə d̪
मदुरै	m ə d̪ ʊ ɾ ɛː
मद्देनज़र	m ə d̪ d̪ eː n ə z ə ɾ
मद्धम	m ə d̪ d̪ʱ ə m
मधु	m ə d̪ʱ uː
मधुमक्खी	m ə d̪ʱ ʊ m ə k kʰ iː
मधुमेह	m ə d̪ʱ uː m eːʱ
मधुर	m ə d̪ʱ ʊ ɾ
मध्य	m ə d̪ʱ j
मध्ययुग	m ə d̪ʱ j ə j ʊ ɡ
मध्यवर्ग	m ə d̪ʱ j ə ʋ ə ɾ ɡ
मध्यांतर	m ə d̪ʱ j ɑː n t̪ ə ɾ
मध्यावधि	m ə d̪ʱ j ɑː ʋ ə d̪ʱ iː
मन	m ə n
मना	m ə n ɑː
मनाना	m ə n ɑː n ɑː
मनीऑर्डर	m ə n iː ɔː ɾ ɖ ə ɾ
मनुष्य	m ə n ʊ ʃ j ə
मनोबल	m ə n oː b ə l
मनोरंजन	m ə n oː ɾ ə ɲ d͡ʒ ə n
मनोरोग	m ə n oː ɾ oː ɡ
मनोवैज्ञानिक	m ə n oː ʋ ɛː ɡ j ɑː n ɪ k
मन्नत	m ə n n ə t̪
मयूर	m ə j uː ɾ
मरना	m ə ɾ n ɑː
मरम्मत	m ə ɾ ə m m ə t̪
मराठा	m ə ɾ ɑː ʈʰ ɑː
मराठी	m ə ɾ ɑː ʈʰ iː
मरीज़	m ə ɾ iː z
मर्तबा	m ə ɾ t̪ ə b ɑː
मर्दाना	m ə ɾ d̪ ɑː n ɑː
मर्यादा	m ə ɾ j ɑː d̪ ɑː
मलयालम	m ə l ə j ɑː l ə m
मलाई	m ə l ɑː iː
मलाल	m ə l ɑː l
मलिका	m ə l ɪ k ɑː
मलेशिया	m ə l eː ʃ iː j ɑː
मल्होत्रा	m ə l ɦ oː t̪ ɾ ɑː
मशहूर	m ə ʃ ɦ uː ɾ
मशीन	m ə ʃ iː n
मशीनीकरण	m ə ʃ iː n iː k ɾ ə n
मसल	m ə s ə l
मसला	m ə s l ɑː
मसीह	m ə s iːʱ
मसीहा	m ə s iː ɦ ɑː
मस्तिष्क	m ə s t̪ ɪ ʃ k
महँगाई	m ə ɦ ə̃ ɡ ɑː iː
महंगा	m ɛːʱ ŋ ɡ ɑː
महकमा	m ɛːʱ k m ɑː
महज़	m ɛːʱ z
महताब	m ɛːʱ t̪ ɑː b
महत्त्व	m ɛːʱ t̪ t̪ ʋ
महत्व	m ɛːʱ t̪ ʋ
महत्वाकांक्षा	m ɛːʱ t̪ ʋ ɑː k ɑː ŋ k ʃ ɑː
महबूब	m ɛːʱ b uː b
महबूबा	m ɛːʱ b uː b ɑː
महरूम	m ɛːʱ ɾ uː m
महल	m ɛːʱ l
महादेव	m ə ɦ ɑː d̪ eː ʋ
महाधिवक्ता	m ə ɦ ɑː d̪ʱ ɪ ʋ ə k t̪ ɑː
महान	m ə ɦ ɑː n
महापौर	m ə ɦ ɑː p ɔː ɾ
महाभियोग	m ə ɦ ɑː bʱ iː j oː ɡ
महारत	m ə ɦ ɑː ɾ ə t̪
महाराज	m ə ɦ ɑː ɾ ɑː d͡ʒ
महाराजा	m ə ɦ ɑː ɾ ɑː d͡ʒ ɑː
महाराष्ट्र	m ə ɦ ɑː ɾ ɑː ʃ ʈ ɾ
महावीर	m ə ɦ ɑː ʋ iː ɾ
महासचिव	m ə ɦ ɑː s ə t͡ʃ ɪ ʋ
माँ	m ɑ̃ː
माँग	m ɑ̃ː ɡ
माँगना	m ɑ̃ː ɡ n ɑː
मां	m ɑ̃ː
मांजा	m ɑː ɲ d͡ʒ ɑː
मांस	m ɑː n s
मांसपेशी	m ɑː n s p eː ʃ iː
माइक	m ɑː ɪ k
माओवाद	m ɑː oː ʋ ɑː d̪
माचिस	m ɑː t͡ʃ ɪ s
माजरा	m ɑː d͡ʒ ɾ ɑː
मातृभाषा	m ɑː t̪ ɾ ɪ bʱ ɑː ʃ ɑː
माथा	m ɑː t̪ʰ ɑː
मादा	m ɑː d̪ ɑː
माधव	m ɑː d̪ʱ ə ʋ
मानक	m ɑː n ə k
मानना	m ɑː n n ɑː
माननीय	m ɑː n n iː j
मानवीय	m ɑː n ə ʋ iː j
मानस	m ɑː n ə s
मानसिकता	m ɑː n s ɪ k t̪ ɑː
मानसून	m ɑː n s uː n
मानसूनी	m ɑː n s uː n iː
माने	m ɑː n eː
मान्यता	m ɑː n j ə t̪ ɑː
माप	m ɑː p
माफ़	m ɑː f
माफ़ी	m ɑː f iː
मामला	m ɑː m l ɑː
मामा	m ɑː m ɑː
मामी	m ɑː m iː
मामूली	m ɑː m uː l iː
मायने	m ɑː j n eː
मायूस	m ɑː j uː s
मायूसी	m ɑː j uː s iː
मारना	m ɑː ɾ n ɑː
मारवाड़	m ɑː ɾ ʋ ɑː ɽ
मारवाड़ी	m ɑː ɾ ʋ ɑː ɽ iː
मार्केट	m ɑː ɾ k eː ʈ
मार्ग	m ɑː ɾ ɡ
मार्गदर्शन	m ɑː ɾ ɡ d̪ ə ɾ ʃ ə n
मार्च	m ɑː ɾ t͡ʃ
मालदार	m ɑː l d̪ ɑː ɾ
मालूम	m ɑː l uː m
माल्टा	m aː l ʈ aː
मावा	m ɑː ʋ ɑː
मास	m ɑː s
मास्को	m ɑː s k oː
माह	m ɑːʱ
माहौल	m ɑː ɦ ɔː l
मिज़ाज	m ɪ z ɑː d͡ʒ
मिज़ोरम	m ɪ z oː ɾ ə m
मिटना	m ɪ ʈ n̪ aː
मिट्टी	m ɪ ʈ ʈ iː
मिठाई	m ɪ ʈʰ ɑː iː
मिठास	m ɪ ʈʰ ɑː s
मिनट	m ɪ n ə ʈ
मिन्नत	m ɪ n n ə t̪
मियाँ	m iː j ɑ̃ː
मिर्च	m ɪ ɾ t͡ʃ
मिल	m ɪ l
मिलन	m ɪ l ə n
मिलीभगत	m ɪ l iː bʱ ə ɡ ə t̪
मिश्रण	m ɪ ʃ ɾ ə n
मिस	m ɪ s
मिस्टर	m ɪ s ʈ ə ɾ
मिस्त्री	m ɪ s t̪ ɾ iː
मिस्र	m ɪ s ɾ
मीडिया	m iː ɖ iː j ɑː
मीन	m iː n
मीर	m iː ɾ
मुँह	m ũːʱ
मुंडन	m ʊ n ɖ ə n
मुंशी	m ʊ n ʃ iː
मुआवज़ा	m ʊ ɑː ʋ z ɑː
मुखर	m ʊ kʰ ə ɾ
मुखिया	m ʊ kʰ iː j ɑː
मुख्य	m ʊ kʰ j ə
मुग्ध	m ʊ ɡ d̪ʱ
मुजरिम	m ʊ d͡ʒ ɾ ɪ m
मुज़फ़्फ़राबाद	m ʊ z ə f f ə ɾ ɑː b ɑː d̪
मुजाहिदीन	m ʊ d͡ʒ ɑː ɦ ɪ d̪ iː n
मुझ	m ʊ d͡ʒʱ
मुझसे	m ʊ d͡ʒʱ s eː
मुझे	m ʊ d͡ʒʱ eː
मुठभेड़	m ʊ ʈʰ bʱ eː ɽ
मुद्दा	m ʊ d̪ d̪ ɑː
मुनाफ़ा	m ʊ n ɑː f ɑː
मुनासिब	m ʊ n ɑː s ɪ b
मुन्ना	m ʊ n n ɑː
मुबारकबाद	m ʊ b ɑː ɾ ə k b ɑː d̪
मुरीद	m ʊ ɾ iː d̪
मुर्दा	m ʊ ɾ d̪ ɑː
मुल्तान	m ʊ l t̪ ɑː n
मुल्ला	m ʊ l l ɑː
मुसलमान	m ʊ s ə l m ɑː n
मुसल्ला	m ʊ s ə l l ɑː
मुहब्बत	m ʊ ɦ ə b b ə t̪
मुहर	m ʊ ɦ ə ɾ
मुहर्रम	m ʊ ɦ ə ɾ ɾ ə m
मुहावरा	m ʊ ɦ ɑː ʋ ɾ ɑː
मुहिम	m ʊ ɦ ɪ m
मूँग	m ũː ɡ
मूंग	m uː ŋ ɡ
मूंछ	m uː ɲ t͡ʃʰ
मूक	m uː k
मूत्राशय	m uː t̪ ɾ ɑː ʃ ə j
मूर्ख	m uː ɾ kʰ
मूर्धन्य	m uː ɾ d̪ʱ ə n j
मूलतः	m uː l t̪ əʰ
मूल्य	m uː l j
मूल्यांकन	m uː l j ɑː ŋ k ə n
मृत	m ɾ ɪ t̪
मृतक	m ɾ ɪ t̪ ə k
मे	m eː
में	m ẽ
मेंढक	m eː n ɖʱ ə k
मेक्सिको	m eː k s ɪ k oː
मेघालय	m eː ɡʱ ɑː l ə j
मेज़	m eː z
मेज़बान	m eː z b ɑː n
मेथी	m eː t̪ʰ iː
मेमो	m eː m oː
मेयर	m eː j ə ɾ
मेरा	m eː ɾ ɑː
मेवा	m eː ʋ ɑː
मेवाड़	m eː ʋ ɑː ɽ
मेष	m eː ʃ
मेहनत	m eːʱ n ə t̪
मेहनती	m eː ɦ ə n t̪ iː
मैंने	m ɛ̃ː n eː
मैच	m ɛː t͡ʃ
मैथुन	m ɛː t̪ʰ ʊ n
मैनचेस्टर	m ɛː n t͡ʃ eː s ʈ ə ɾ
मॉड्यूल	m ɔː ɖ j uː l
मोक्ष	m oː k ʃ ə
मोती	m oː t̪ iː
मोदी	m oː d̪ iː
मोनाको	m oː n ɑː k oː
मोबाइल	m oː b ɑː ɪ l
मोबिलिटी	m oː b ɪ l ɪ ʈ iː
मोम	m oː m
मोर	m oː ɾ
मोरक्को	m oː ɾ ə k k oː
मोर्चा	m oː ɾ t͡ʃ ɑː
मोल	m oː l
मोहताज	m oːʱ t̪ ɑː d͡ʒ
मोहरा	m oːʱ ɾ ɑː
मोहलत	m oːʱ l ə t̪
मौखिक	m ɔː kʰ ɪ k
मौजूदगी	m ɔː d͡ʒ uː d̪ ɡ iː
मौजूदा	m ɔː d͡ʒ uː d̪ ɑː
मौन	m ɔː n
मौलवी	m ɔː l ʋ iː
मौला	m ɔː l ɑː
मौलाना	m ɔː l ɑː n ɑː
मौलिक	m ɔː l ɪ k
मौसम	m ɔː s ə m
मौसमी	m ɔː s m iː
मौसी	m ɔː s iː
यंत्र	j ə n t̪ ɾ ə
यद्यपि	j ə d̪ j ə p iː
यमन	j ə m ə n
यमुना	j ə m ʊ n ɑː
यरुशलम	j ə ɾ ʊ ʃ ə l ə m
यह	j əʱ
यहूदी	j ə ɦ uː d̪ iː
या	j ɑː
याचिका	j ɑː t͡ʃ ɪ k ɑː
यातायात	j ɑː t̪ ɑː j ɑː t̪
यात्री	j ɑː t̪ ɾ iː
याद	j ɑː d̪
यान	j ɑː n
यानी	j ɑː n iː
यार	j ɑː ɾ
युक्त	j ʊ k t̪
युग	j ʊ ɡ
युद्ध	j ʊ d̪ d̪ʱ
युद्धक	j ʊ d̪ d̪ʱ ə k
युवक	j ʊ ʋ ə k
युवती	j ʊ ʋ t̪ iː
युवा	j ʊ ʋ ɑː
यूँ	j ũː
यूक्रेन	j uː k ɾ eː n
यूनानी	j uː n ɑː n iː
यूरोप	j uː ɾ oː p
योनि	j oː n iː
यौवन	j ɔː ʋ ə n
रंग	ɾ ə ŋ ɡ
रंगमंच	ɾ ə ŋ ɡ m ə ɲ t͡ʃ
रंगरूट	ɾ ə ŋ ɡ ɾ uː ʈ
रंजिश	ɾ ə ɲ d͡ʒ ɪ ʃ
रईस	ɾ ə iː s
रक्त	ɾ ə k t̪
रक्तपात	ɾ ə k t̪ p ɑː t̪
रक्षण	ɾ ə k ʃ ə n
रखना	ɾ ə kʰ n ɑː
रखा	ɾ ə kʰ ɑː
रचना	ɾ ə t͡ʃ n ɑː
रज़ामंद	ɾ ə z ɑː m ə n d̪
रज़ामंदी	ɾ ə z ɑː m ə n d̪ iː
रजिस्टर	ɾ ə d͡ʒ ɪ s ʈ ə ɾ
रणनीतिक	ɾ ə n n iː t̪ ɪ k
रद्द	ɾ ə d̪ d̪
रब	ɾ ə b
रबड़	ɾ ə b ə ɽ
रवांडा	ɾ ə ʋ ɑː n ɖ ɑː
रवाना	ɾ ə ʋ ɑː n ɑː
रवि	ɾ ə ʋ iː
रवैया	ɾ ə ʋ ə iː j ɑː
रशिया	ɾ ə ʃ iː j ɑː
रस	ɾ ə s
रसूल	ɾ ə s uː l
रसोई	ɾ ə s oː iː
रस्सी	ɾ ə s s iː
रहना	ɾ ɛːʱ n ɑː
रहमान	ɾ ɛːʱ m ɑː n
रहस्य	r ɛ ɦ ɛ s j
रहस्यमय	ɾ ɛːʱ s j ə m ə j
रहीम	ɾ ə ɦ iː m
रांची	ɾ ɑː ɲ t͡ʃ iː
राख	r a kʰ
राज	ɾ ɑː d͡ʒ
राजग	ɾ ɑː d͡ʒ ə ɡ
राजद	ɾ ɑː d͡ʒ ə d̪
राजदूत	ɾ ɑː d͡ʒ d̪ uː t̪
राजनयिक	ɾ ɑː d͡ʒ n ə j ɪ k
राजवंश	ɾ ɑː d͡ʒ ʋ ə n ʃ
राजस्थान	ɾ ɑː d͡ʒ ə s t̪ʰ ɑː n
राजस्थानी	ɾ ɑː d͡ʒ ə s t̪ʰ ɑː n iː
राज़	ɾ ɑː z
राज़ी	ɾ ɑː z iː
राजा	ɾ ɑː d͡ʒ ɑː
राजेश	r aː d͡ʒ e ʃ
राज्यपाल	ɾ ɑː d͡ʒ j ə p ɑː l
रात	ɾ ɑː t̪
रात्रि	ɾ ɑː t̪ ɾ iː
रानी	ɾ ɑː n iː
राम	ɾ ɑː m
रामचंद्र	ɾ ɑː m t͡ʃ ə n d̪ ɾ
रामलीला	ɾ ɑː m l iː l ɑː
रामल्लाह	ɾ ɑː m ə l l ɑːʱ
रार	ɾ ɑː ɾ
राष्ट्रपिता	ɾ ɑː ʃ ʈ ɾ ə p ɪ t̪ ɑː
राष्ट्रीय	ɾ ɑː ʃ ʈ ɾ iː j
राह	ɾ ɑːʱ
रिकॉर्ड	ɾ ɪ k ɔː ɾ ɖ
रिक्त	ɾ ɪ k t̪
रिक्शा	ɾ ɪ k ʃ ɑː
रिपोर्ट	ɾ ɪ p oː ɾ ʈ
रिपोर्टर	ɾ ɪ p oː ɾ ʈ ə ɾ
रियासत	ɾ iː j ɑː s ə t̪
रिवाज	ɾ ɪ ʋ ɑː d͡ʒ
रिश्ता	ɾ ɪ ʃ t̪ ɑː
रिहा	ɾ ɪ ɦ ɑː
रिहाई	ɾ ɪ ɦ ɑː iː
रीढ़	ɾ iː ɽʱ
रीता	ɾ iː t̪ ɑː
रीति	ɾ iː t̪ iː
रुकना	ɾ ʊ k n ɑː
रुझान	ɾ ʊ d͡ʒʱ ɑː n
रुपया	ɾ ʊ p j ɑː
रूप	r uː p
रूपरेखा	ɾ uː p ɾ eː kʰ ɑː
रूबरू	ɾ uː b ɾ uː
रूस	ɾ uː s
रूह	ɾ uːʱ
रे	ɾ eː
रेत	ɾ eː t̪
रेल	ɾ eː l
रेलगाड़ी	ɾ eː l ɡ ɑː ɽ iː
रैन	ɾ ɛː n
रोक	ɾ oː k
रोका	ɾ oː k ɑː
रोग	ɾ oː ɡ
रोगी	ɾ oː ɡ iː
रोज़	ɾ oː z
रोज़गार	ɾ oː z ɡ ɑ ɾ
रोज़मर्रा	ɾ oː z m ə ɾ ɾ ɑː
रोज़ा	ɾ oː z ɑː
रोड	ɾ oː ɖ
रोड़ा	ɾ oː ɽ ɑː
रोध	ɾ oː d̪ʱ
रोमांच	ɾ oː m ɑː ɲ t͡ʃ
रोमानिया	ɾ oː m ɑː n iː j ɑː
रोहतक	ɾ oːʱ t̪ ə k
रौशन	ɾ ɔː ʃ ə n
लंगूर	l ə ŋ ɡ uː ɾ
लंदन	l ə n d̪ ə n
लंबाई	l ə m b ɑː iː
लंबू	l ə m b uː
लकीर	l ə k iː ɾ
लखन	l ə kʰ ə n
लखनऊ	l ə kʰ n ə uː
लगन	l ə ɡ ə n
लगभग	l ə ɡ bʱ ə ɡ
लगान	l ə ɡ ɑː n
लज्जा	l ə d͡ʒ d͡ʒ ɑː
लड़की	l ə ɽ k iː
लड़ना	l ə ɽ n ɑː
लड़ाई	l ə ɽ ɑː iː
लड़ाकू	l ə ɽ ɑː k uː
लड्डू	l ə ɖ ɖ uː
लय	l ə j
ललाट	l ə l ɑː ʈ
लश्कर	l ə ʃ k ə ɾ
लहजा	l ɛːʱ d͡ʒ ɑː
लहर	l ɛːʱ ɾ
लहरा	l ɛːʱ ɾ ɑː
लाइन	l ɑː ɪ n
लाइसेंस	l ɑː ɪ s eː n s
लाख	l ɑː kʰ
लागत	l ɑː ɡ ə t̪
लागू	l ɑː ɡ uː
लाजवाब	l ɑː d͡ʒ ə ʋ ɑː b
लाट	l ɑː ʈ
लातीनी	l ɑː t̪ iː n iː
लापरवाह	l ɑː p ə ɾ ʋ ɑːʱ
लापरवाही	l ɑː p ə ɾ ʋ ɑː ɦ iː
लाभदायक	l ɑː bʱ d̪ ɑː j ə k
लाल	l ɑː l
लालच	l ɑː l ə t͡ʃ
लालटेन	l ɑː l ʈ eː n
लालसा	l ɑː l s ɑː
लालायित	l ɑː l ɑː j ɪ t̪
लिंग	l ɪ ŋ ɡ
लिंगानुपात	l ɪ ŋ ɡ ɑː n ʊ p ɑː t̪
लिंगायत	l ɪ ŋ ɡ ɑː j ə t̪
लिखना	l ɪ kʰ n ɑː
लिखने	l ɪ kʰ n eː
लिखाई	l ɪ kʰ ɑː iː
लिमिटेड	l ɪ m ɪ ʈ eː ɖ
लिवरपूल	l ɪ ʋ ə ɾ p uː l
लीची	l iː t͡ʃ iː
लुटेरा	l ʊ ʈ eː ɾ ɑː
लुत्फ़	l ʊ t̪ f
लुप्त	l ʊ p t̪
लुभाना	l ʊ bʱ ɑː n ɑː
लेकर	l eː k ə ɾ
लेकिन	l eː k ɪ n
लेख	l eː kʰ
लेखन	l eː kʰ ə n
लेखा	l eː kʰ ɑː
लेना	l eː n ɑː
लेस्टर	l eː s ʈ ə ɾ
लैंगिक	l ɛː ŋ ɡ ɪ k
लैब	l ɛː b
लोक	l oː k
लोकसभा	l oː k ə s bʱ ɑː
लोग	l oː ɡ
लोगो	l oː ɡ oː
लोगों	l oː ɡ õː
लोटपोट	l oː ʈ p oː ʈ
लोन	l oː n
लौ	l ɔː
ल्हासा	l ɦ ɑː s ɑː
वंचित	ʋ ə ɲ t͡ʃ ɪ t̪
वंदना	ʋ ə n d̪ ə n ɑː
वंश	ʋ ə n ʃ
वंशवाद	ʋ ə n ʃ ʋ ɑː d̪
वकालत	ʋ ə k ɑː l ə t̪
वक्ता	ʋ ə k t̪ ɑː
वचन	ʋ ə t͡ʃ ə n
वजह	ʋ ə d͡ʒ əʱ
वज़न	ʋ ə z ə n
वजूद	ʋ ə d͡ʒ uː d̪
वड़ोदरा	ʋ ə ɽ oː d̪ ɾ ɑː
वतन	ʋ ə t̪ ə n
वन	ʋ ə n
वन्य	ʋ ə n j
वफ़ादार	ʋ ə f ɑː d̪ ɑː ɾ
वरण	ʋ ə ɾ ə n
वरिष्ठ	ʋ ə ɾ ɪ ʃ ʈʰ
वरीयता	ʋ ə ɾ iː j ə t̪ ɑː
वरुण	ʋ ə r ʊ ɳ
वर्ग	ʋ ə ɾ ɡ
वर्णमाला	ʋ ə ɾ n m ɑː l ɑː
वर्मा	ʋ ə ɾ m ɑː
वर्ष	ʋ ə ɾ ʃ
वर्षा	ʋ ə ɾ ʃ ɑː
वली	ʋ ə l iː
वसंत	ʋ ə s ə n t̪
वसूल	ʋ ə s uː l
वस्तु	ʋ ə s t̪ uː
वस्त्र	ʋ ə s t̪ ɾ
वही	ʋ ə ɦ iː
वहीं	ʋ ə ɦ ĩː
वा	ʋ ɑː
वाटर	ʋ ɑː ʈ ə ɾ
वाणी	ʋ ɑː n iː
वातानुकूलित	ʋ ɑː t̪ ɑː n ʊ k uː l ɪ t̪
वातावरण	ʋ ɑː t̪ ɑː ʋ ɾ ə n
वादा	ʋ ɑː d̪ ɑː
वाद्य	ʋ ɑː d̪ j
वानर	ʋ ɑː n ə ɾ
वापस	ʋ ɑː p ə s
वापसी	ʋ ɑː p s iː
वापिस	ʋ ɑː p ɪ s
वामपंथी	ʋ ɑː m p ə n t̪ʰ iː
वायदा	ʋ ɑː j d̪ ɑː
वायुसेना	ʋ ɑː j uː s eː n ɑː
वार	ʋ ɑː ɾ
वारदात	ʋ ɑː ɾ d̪ ɑː t̪
वारिस	ʋ ɑː ɾ ɪ s
वाली	ʋ ɑː l iː
वासी	ʋ ɑː s iː
वासुदेव	ʋ ɑː s ʊ d̪ eː ʋ
वास्तुकला	ʋ ɑː s t̪ ʊ k ə l ɑː
वाहक	ʋ ɑː ɦ ə k
वाहन	ʋ ɑː ɦ ə n
विकार	ʋ ɪ k ɑː ɾ
विकासशील	ʋ ɪ k ɑː s ʃ iː l
विक्रय	ʋ ɪ k ɾ ə j
विक्रेता	ʋ ɪ k ɾ eː t̪ ɑː
विख्यात	ʋ ɪ kʰ j ɑː t̪
विचारधारा	ʋ ɪ t͡ʃ ɑː ɾ d̪ʱ ɑː ɾ ɑː
विजेता	ʋ ɪ d͡ʒ eː t̪ ɑː
विज्ञान	ʋ ɪ ɡ j ɑː n
विज्ञापन	ʋ ɪ ɡ j ɑː p ə n
वितरण	ʋ ɪ t̪ ɾ ə n
वित्तीय	ʋ ɪ t̪ t̪ iː j
विद्या	ʋ ɪ d̪ j ɑː
विद्यार्थी	ʋ ɪ d̪ j ɑː ɾ t̪ʰ iː
विद्रोह	ʋ ɪ d̪ ɾ oːʱ
विद्वान	ʋ ɪ d̪ ʋ ɑː n
विधवा	ʋ ɪ d̪ʱ ʋ ɑː
विधानसभा	ʋ ɪ d̪ʱ ɑː n s ə bʱ ɑː
विधेयक	ʋ ɪ d̪ʱ eː j ə k
विनम्रता	ʋ ɪ n ə m ɾ ə t̪ ɑː
विनय	ʋ ɪ n ə j
विनाशकारी	ʋ ɪ n ɑː ʃ k ɑː ɾ iː
विनिर्माण	ʋ ɪ n ɪ ɾ m ɑː n
विनिवेश	ʋ ɪ n ɪ ʋ eː ʃ
विनोद	ʋ ɪ n oː d̪
विपक्षी	ʋ ɪ p ə k ʃ iː
विपरीत	ʋ ɪ p ɾ iː t̪
विभाजित	ʋ ɪ bʱ ɑː d͡ʒ ɪ t̪
विभीषिका	ʋ ɪ bʱ iː ʃ ɪ k ɑː
विभूति	ʋ ɪ bʱ uː t̪ iː
विमान	ʋ ɪ m ɑː n
वियतनाम	ʋ iː j ə t̪ n ɑː m
विराजमान	ʋ ɪ ɾ ɑː d͡ʒ m ɑː n
विराटनगर	ʋ ɪ ɾ ɑː ʈ ə n ɡ ə ɾ
विरुद्ध	ʋ ɪ ɾ ʊ d̪ d̪ʱ
विरोधी	ʋ ɪ ɾ oː d̪ʱ iː
विलास	ʋ ɪ l ɑː s
विलीन	ʋ ɪ l iː n
विवादित	ʋ ɪ ʋ ɑː d̪ ɪ t̪
विवि	ʋ ɪ ʋ iː
विविध	ʋ ɪ ʋ ɪ d̪ʱ
विशिष्ट	ʋ ɪ ʃ ɪ ʃ ʈ
विशेषकर	ʋ ɪ ʃ eː ʃ k ə ɾ
विशेषज्ञ	ʋ ɪ ʃ eː ʃ ə ɡ j
विशेषण	ʋ ɪ ʃ eː ʃ ə n
विशेषता	ʋ ɪ ʃ eː ʃ t̪ ɑː
विश्लेषण	ʋ ɪ ʃ l eː ʃ ə n
विश्व	ʋ ɪ ʃ ʋ ə
विश्वकोश	ʋ ɪ ʃ ʋ ə k oː ʃ
विश्वप्रसिद्ध	ʋ ɪ ʃ ʋ ə p ɾ ə s ɪ d̪ d̪ʱ
विश्वविख्यात	ʋ ɪ ʃ ʋ ə ʋ ɪ kʰ j ɑː t̪
विश्वासघात	ʋ ɪ ʃ ʋ ɑː s ɡʱ ɑː t̪
विश्वासपात्र	ʋ ɪ ʃ ʋ ɑː s p ɑː t̪ ɾ
विषम	ʋ ɪ ʃ ə m
विषय	ʋ ɪ ʃ ə j
विष्णु	ʋ ɪ ʃ n uː
विसर्जन	ʋ ɪ s ə ɾ d͡ʒ ə n
विसर्जित	ʋ ɪ s ə ɾ d͡ʒ ɪ t̪
विस्थापन	ʋ ɪ s t̪ʰ ɑː p ə n
विस्फोट	ʋ ɪ s pʰ oː ʈ
विस्फोटक	ʋ ɪ s pʰ oː ʈ ə k
विस्मय	ʋ ɪ s m ə j
विहीन	ʋ ɪ ɦ iː n
वीर	ʋ iː ɾ
वृक्ष	ʋ ɾ ɪ k ʃ
वृद्धि	ʋ ɾ ɪ d̪ d̪ʱ iː
वेग	ʋ eː ɡ
वेटिकन	ʋ eː ʈ ɪ k ə n
वेद	ʋ eː d̪
वेदांत	ʋ eː d̪ ɑː n t̪
वेबसाइट	ʋ eː b s ɑː ɪ ʈ
वैंकूवर	ʋ ɛː ŋ k uː ʋ ə ɾ
वैचारिक	ʋ ɛː t͡ʃ ɑː ɾ ɪ k
वैदिक	ʋ ɛː d̪ ɪ k
वैद्य	ʋ ɛː d̪ j
वैध	ʋ ɛː d̪ʱ
वैवाहिक	ʋ ɛː ʋ ɑː ɦ ɪ k
वैशाख	ʋ ɛː ʃ ɑː kʰ
वॉट	ʋ ɔː ʈ
वो	ʋ oː
व्यंजक	ʋ j ə ɲ d͡ʒ ə k
व्यंजन	ʋ j ə ɲ d͡ʒ ə n
व्यक्त	ʋ j ə k t̪
व्यथा	ʋ j ə t̪ʰ ɑː
व्यभिचार	ʋ j ə bʱ ɪ t͡ʃ ɑː ɾ
व्यय	ʋ j ə j
व्यर्थ	ʋ j ə ɾ t̪ʰ
व्यवसाय	ʋ j ə ʋ s ɑː j
व्यवस्था	ʋ j ə ʋ ə s t̪ʰ ɑː
व्यस्त	ʋ j ə s t̪
व्याकरण	ʋ j aː k ə r ə ɳ
व्याख्या	ʋ j ɑː kʰ j ɑː
व्याख्याता	ʋ j ɑː kʰ j ɑː t̪ ɑː
व्यापक	ʋ j ɑː p ə k
व्यापार	ʋ j ɑː p ɑː ɾ
व्यायाम	ʋ j ɑː j ɑː m
व्यावहारिक	ʋ j ɑː ʋ ɦ ɑː ɾ ɪ k
व्युत्पत्ति	ʋ j ʊ t̪ p ə t̪ t̪ iː
व्रत	ʋ ɾ ə t̪
व्लादिमीर	ʋ l ɑː d̪ ɪ m iː ɾ
व्लादिवोस्तोक	ʋ l ɑː d̪ ɪ ʋ oː s t̪ oː k
शक्ति	ʃ ə k t̪ iː
शक्ल	ʃ ə k l
शख्स	ʃ ə kʰ s
शख्सियत	ʃ ə kʰ s iː j ə t̪
शटर	ʃ ə ʈ ə ɾ
शतक	ʃ ə t̪ ə k
शताब्दी	ʃ ə t̪ ɑː b d̪ iː
शपथ	ʃ ə p ə t̪ʰ
शब्दावली	ʃ ə b d äː ʋ l iː
शमशेर	ʃ ə m ʃ eː ɾ
शमा	ʃ ə m ɑː
शरण	ʃ ə ɾ ə n
शराब	ʃ ə ɾ ɑː b
शरारत	ʃ ə ɾ ɑː ɾ ə t̪
शरियत	ʃ ə ɾ iː j ə t̪
शरीफ़	ʃ ə ɾ iː f
शरीर	ʃ ə ɾ iː ɾ
शर्मनाक	ʃ ə ɾ m n ɑː k
शलभ	ʃ ə l ə bʱ
शव	ʃ ə ʋ
शस्त्र	ʃ ə s t̪ ɾ
शहंशाह	ʃ ɛːʱ n ʃ ɑːʱ
शहद	ʃ ɛːʱ d̪
शहर	ʃ ɛːʱ ɾ
शहरी	ʃ ɛːʱ ɾ iː
शहादत	ʃ ə ɦ ɑː d̪ ə t̪
शहीद	ʃ ə ɦ iː d̪
शांतिपूर्ण	ʃ ɑː n t̪ ɪ p uː ɾ n
शादी	ʃ ɑː d̪ iː
शान	ʃ ɑː n
शान्ति	ʃ ɑː n t̪ iː
शाप	ʃ ɑː p
शाबाशी	ʃ ɑː b ɑː ʃ iː
शाम	ʃ ɑː m
शामियाना	ʃ ɑː m iː j ɑː n ɑː
शामिल	ʃ ɑː m ɪ l
शायरा	ʃ ɑː j ə ɾ ɑː
शारजाह	ʃ ɑː ɾ d͡ʒ ɑːʱ
शालीन	ʃ ɑː l iː n
शावक	ʃ ɑː ʋ ə k
शाश्वत	ʃ ɑː ʃ ʋ ə t̪
शासक	ʃ ɑː s ə k
शास्त्र	ʃ ɑː s t̪ ɾ
शाही	ʃ ɑː ɦ iː
शाहीन	ʃ ɑː ɦ iː n
शिकंजा	ʃ ɪ k ə ɲ d͡ʒ ɑː
शिकस्त	ʃ ɪ k ə s t̪
शिकार	ʃ ɪ k ɑː ɾ
शिकारी	ʃ ɪ k ɑː ɾ iː
शिक्षण	ʃ ɪ k ʃ ə n
शिक्षा	ʃ ɪ k ʃ ɑː
शिखर	ʃ ɪ kʰ ə ɾ
शिद्दत	ʃ ɪ d̪ d̪ ə t̪
शिमला	ʃ ɪ m l ɑː
शिल्प	ʃ ɪ l p
शिवलिंग	ʃ ɪ ʋ l ɪ ŋ ɡ
शिवालय	ʃ ɪ ʋ ɑː l ə j
शिविर	ʃ ɪ ʋ ɪ ɾ
शिष्य	ʃ ɪ ʃ j
शीघ्रता	ʃ iː ɡʱ ɾ ə t̪ ɑː
शीत	ʃ iː t̪
शीर्ष	ʃ iː ɾ ʃ
शीर्षक	ʃ iː ɾ ʃ ə k
शीशा	ʃ iː ʃ ɑː
शुक्रगुज़ार	ʃ ʊ k ɾ ə ɡ ʊ z ɑː ɾ
शुक्राणु	ʃ ʊ k ɾ ɑː n uː
शुक्रिया	ʃ ʊ k ɾ iː j ɑː
शुद्ध	ʃ ʊ d̪ d̪ʱ
शुभकामना	ʃ ʊ bʱ k ɑː m n ɑː
शुरु	ʃ ʊ ɾ uː
शुरुआती	ʃ ʊ ɾ ʊ ɑː t̪ iː
शुरू	ʃ ʊ ɾ uː
शुल्क	ʃ ʊ l k
शू	ʃ uː
शूटिंग	ʃ uː ʈ ɪ ŋ ɡ
शून्य	ʃ uː n j ə
शृंखला	ʃ ɾ ɪ ŋ kʰ l ɑː
शेरनी	ʃ eː ɾ n iː
शेष	ʃ eː ʃ
शैतान	ʃ ɛː t̪ ɑː n
शैली	ʃ ɛː l iː
शो	ʃ oː
शोध	ʃ oː d̪ʱ
शोर	ʃ oː ɾ
शोला	ʃ oː l ɑː
शोषण	ʃ oː ʃ ə n
शौकत	ʃ ɔː k ə t̪
शौर्य	ʃ ɔː ɾ j
श्मशान	ʃ m ə ʃ ɑː n
श्रद्धालु	ʃ ɾ ə d̪ d̪ʱ ɑː l uː
श्री	ʃ ɾ iː
श्रीनगर	ʃ ɾ iː n ə ɡ ə ɾ
श्रीफल	ʃ ɾ iː pʰ ə l
श्रीलंका	ʃ ɾ iː l ə ŋ k ɑː
श्रुति	ʃ ɾ ʊ t̪ iː
श्रेणी	ʃ ɾ eː n iː
श्रोता	ʃ ɾ oː t̪ ɑː
श्लोक	ʃ l oː k
श्वान	ʃ ʋ ɑː n
षष्ठी	ʃ ə ʃ ʈʰ iː
संकट	s ə ŋ k ə ʈ
संकल्प	s ə ŋ k ə l p
संकेत	s ə ŋ k eː t̪
संक्रांति	s ə ŋ k ɾ ɑː n t̪ iː
संक्रामक	s ə ŋ k ɾ ɑː m ə k
संक्षिप्त	s ə ŋ k ʃ ɪ p t̪
संख्या	s ə ŋ kʰ j ɑː
संग	s ə ŋ ɡ
संगठन	s ə ŋ ɡ ə ʈʰ ə n
संगम	s ə ŋ ɡ ə m
संगीत	s ə ŋ ɡ iː t̪
संगीन	s ə ŋ ɡ iː n
संग्राम	s ə ŋ ɡ ɾ ɑː m
संघ	s ə ŋ ɡʱ
संघीय	s ə ŋ ɡʱ iː j
संचार	s ə ɲ t͡ʃ ɑː ɾ
संज्ञा	s ə ɲ ɡ j ɑː
संत	s ə n t̪
संतरा	s ə n t̪ ɾ ɑː
संतान	s ə n t̪ ɑː n
संतोषी	s ə n t̪ oː ʃ iː
संदिग्ध	s ə n d̪ ɪ ɡ d̪ʱ
संदेह	s ə n d̪ eːʱ
संध्या	s ə n d̪ʱ j ɑː
संन्यास	s ə n n j ɑː s
संन्यासी	s ə n n j ɑː s iː
संपत्ति	s ə m p ə t̪ t̪ iː
संपदा	s ə m p ə d̪ ɑː
संपर्क	s ə m p ə ɾ k
संपादकीय	s ə m p ɑː d̪ ə k iː j
संप्रदाय	s ə m p ɾ ə d̪ ɑː j
संप्रभुता	s ə m p ɾ ə bʱ ʊ t̪ ɑː
संबंध	s ə m b ə n d̪ʱ
संबोधित	s ə m b oː d̪ʱ ɪ t̪
संभव	s ə̃ m bʱ ə ʋ
संभावना	s ə m bʱ ɑː ʋ n ɑː
संभोग	s ə m bʱ oː ɡ
संयंत्र	s ə̃ j ə n t̪ ɾ
संयम	s ə̃ j ə m
संयुक्त	s ə̃ j ʊ k t̪
संयोग	s ə̃ j oː ɡ
संयोजक	s ə̃ j oː d͡ʒ ə k
संरक्षण	s ə n ɾ ə k ʃ ə n
संरचनात्मक	s ə n ɾ ə t͡ʃ n ɑː t̪ m ə k
संवाददाता	s ə m ʋ ɑː d̪ d̪ ɑː t̪ ɑː
संवेदना	s ə̃ m ʋ eː d̪ n̪ aː
संवैधानिक	s ə m ʋ ɛː d̪ʱ ɑː n ɪ k
संशोधन	s ə n ʃ oː d̪ʱ ə n
संशोधित	s ə n ʃ oː d̪ʱ ɪ t̪
संसदीय	s ə n s ə d̪ iː j
संसाधन	s ə n s ɑː d̪ʱ ə n
संसार	s ə n s ɑː ɾ
संस्कृत	s ə n s k ɾ ɪ t̪
संस्थान	s ə n s t̪ʰ ɑː n
संहिता	s ə n ɦ ɪ t̪ ɑː
सकता	s ə k t̪ ɑː
सकल	s ə k ə l
सक्रिय	s ə k ɾ ɪ j
सक्षम	s ə k ʃ ə m
सगाई	s ə ɡ ɑː iː
सघन	s ə ɡʱ ə n
सचमुच	s ə t͡ʃ m ʊ t͡ʃ
सज़ा	s ə z ɑː
सजावट	s ə d͡ʒ ɑː ʋ ə ʈ
सजावटी	s ə d͡ʒ ɑː ʋ ʈ iː
सज्जन	s ə d͡ʒ d͡ʒ ə n
सज्जा	s ə d͡ʒ d͡ʒ ɑː
सटीक	s ə ʈ iː k
सड़क	s ə ɽ ə k
सतह	s ə t̪ əʱ
सत्तर	s ə t̪ t̪ ə ɾ
सत्तारूढ़	s ə t̪ t̪ ɑː ɾ uː ɽʱ
सत्य	s ə t̪ j
सत्याग्रह	s ə t̪ j ɑː ɡ ɾ əʱ
सत्यापन	s ə t̪ j ɑː p ə n
सत्रह	s ə t̪ ɾ əʱ
सदन	s ə d̪ ə n
सदाबहार	s ə d̪ ɑː b ə ɦ ɑː ɾ
सदैव	s ə d̪ ɛː ʋ
सद्भावना	s ə d̪ bʱ ɑː ʋ n ɑː
सनसनी	s ə n s ə n iː
सन्	s ə n
सन्नाटा	s ə n n ɑː ʈ ɑː
सप्ताह	s ə p t̪ ɑːʱ
सप्ताहांत	s ə p t̪ ɑː ɦ ɑː n t̪
सफ़र	s ə f ə ɾ
सफ़ेद	s ə f eː d̪
सबब	s ə b ə b
सबूत	s ə b uː t̪
सभा	s ə bʱ ɑː
सम	s ə m
समकालीन	s ə m k ɑː l iː n
समक्ष	s ə m ə k ʃ
समझना	s ə m ə d͡ʒʱ n ɑː
समझाना	s ə m d͡ʒʱ ɑː n ɑː
समझौता	s ə m d͡ʒʱ ɔː t̪ ɑː
समतल	s ə m t̪ ə l
समन्वय	s ə m ə n ʋ ə j
समय	s ə m ə j
समयानुसार	s ə m j ɑː n ʊ s ɑː ɾ
समर्थ	s ə m ə ɾ t̪ʰ
समर्थक	s ə m ə ɾ t̪ʰ ə k
समर्थन	s ə m ə ɾ t̪ʰ ə n
समर्पण	s ə m ə ɾ p ə n
समाचार	s ə m ɑː t͡ʃ ɑː ɾ
समाज	s ə m ɑː d͡ʒ
समाजवाद	s ə m ɑː d͡ʒ ʋ ɑː d̪
समाधान	s ə m ɑː d̪ʱ ɑː n
समाधि	s ə m ɑː d̪ʱ iː
समापन	s ə m ɑː p ə n
समायोजन	s ə m ɑː j oː d͡ʒ ə n
समावेश	s ə m ɑː ʋ eː ʃ
समिट	s ə m ɪ ʈ
समिति	s ə m ɪ t̪ iː
समीक्षा	s ə m iː k ʃ ɑː
समीप	s ə m iː p
समीर	s ə m iː ɾ
समेटना	s ə m eː ʈ n ɑː
समेत	s ə m eː t̪
सम्पादक	s ə m p ɑː d̪ ə k
सम्बन्धी	s ə m b ə n d̪ʱ iː
सम्मति	s ə m m ə t̪ iː
सम्मिश्रण	s ə m m ɪ ʃ ɾ ə n
सम्मेलन	s ə m m eː l ə n
सम्राट	s ə m ɾ ɑː ʈ
सर	s ə ɾ
सरपंच	s ə ɾ p ə ɲ t͡ʃ
सरल	s ə ɾ ə l
सरसों	s ə ɾ s õː
सरहद	s ə ɾ ɦ ə d̪
सराबोर	s ə ɾ ɑː b oː ɾ
सराय	s ə ɾ ɑː j
सराहना	s ə ɾ ɑːʱ n ɑː
सरीसृप	s ə ɾ iː s ɾ ɪ p
सरेआम	s ə ɾ eː ɑː m
सर्किल	s ə ɾ k ɪ l
सर्प	s ə ɾ p
सर्ब	s ə ɾ b
सर्बिया	s ə ɾ b iː j ɑː
सर्वत्र	s ə ɾ ʋ ə t̪ ɾ
सर्वदलीय	s ə ɾ ʋ d̪ ə l iː j
सर्वसम्मति	s ə ɾ ʋ s ə m m ə t̪ iː
सर्वाधिक	s ə ɾ ʋ ɑː d̪ʱ ɪ k
सर्विस	s ə ɾ ʋ ɪ s
सर्वेक्षण	s ə ɾ ʋ eː k ʃ ə n
सर्वोच्च	s ə ɾ ʋ oː t͡ʃ t͡ʃ
सर्वोदय	s ə ɾ ʋ oː d̪ ə j
सर्वोपरि	s ə ɾ ʋ oː p ə ɾ iː
सलाम	s ə l ɑː m
सलामत	s ə l ɑː m ə t̪
सलामी	s ə l ɑː m iː
सलाह	s ə l ɑːʱ
सलाहकार	s ə l ɑːʱ k ɑː ɾ
सलीम	s ə l iː m
सल्तनत	s ə l t̪ ə n ə t̪
सवर्ण	s ə ʋ ə ɾ n
सवाल	s ə ʋ ɑː l
सवेरे	s ə ʋ eː ɾ eː
सशक्तिकरण	s ə ʃ ə k t̪ ɪ k ə ɾ ə n
सशस्त्र	s ə ʃ ə s t̪ ɾ
ससुर	s ə s ʊ ɾ
ससुराल	s ə s ʊ ɾ ɑː l
सस्ता	s ə s t̪ ɑː
सहकर्मी	s ɛːʱ k ə ɾ m iː
सहकारी	s ɛːʱ k ɑː ɾ iː
सहज	s ɛ ɦ ɛ d͡ʒ
सहना	s ɛːʱ n ɑː
सहमत	s ɛːʱ m ə t̪
सहयोग	s əʱ j oː ɡ
सहयोगी	s əʱ j oː ɡ iː
सहरी	s ɛːʱ ɾ iː
सहसंयोजक	s əʱ s ə̃ j oː d͡ʒ ə k
सहायक	s ə ɦ ɑː j ə k
सही	s ə ɦ iː
साँस	s ɑ̃ː s
सांख्यिकी	s ɑː ŋ kʰ j ɪ k iː
सांप	s ɑ̃ː p
सांप्रदायिकता	s ɑː m p ɾ ə d̪ ɑː j ɪ k t̪ ɑː
सांसद	s ɑː n s ə d̪
सांस्कृतिक	s ɑː n s k ɾ ɪ t̪ ɪ k
साइप्रस	s ɑː ɪ p ɾ ə s
साक्षात्कार	s ɑː k ʃ ɑː t̪ k ɑː ɾ
साख	s ɑː kʰ
साजन	s ɑː d͡ʒ ə n
साज़िश	s ɑː z ɪ ʃ
साझा	s ɑː d͡ʒʱ ɑː
साझेदार	s ɑː d͡ʒʱ eː d̪ ɑː ɾ
साझेदारी	s ɑː d͡ʒʱ eː d̪ ɑː ɾ iː
साठ	s ɑː ʈʰ
साड़ी	s ɑː ɽ iː
साढ़े	s ɑː ɽʱ eː
सात	s ɑː t̪
सातवां	s ɑː t̪ ʋ ɑ̃ː
सातवाहन	s ɑː t̪ ʋ ɑː ɦ ə n
सादगी	s ɑː d̪ ə ɡ iː
सादा	s ɑː d̪ ɑː
साधन	s ɑː d̪ʱ ə n
साध्वी	s ɑː d̪ʱ ʋ iː
सानी	s ɑː n iː
साप्ताहिक	s ɑː p t̪ ɑː ɦ ɪ k
साफ़	s ɑː f
साबित	s ɑː b ɪ t̪
सामग्री	s ɑː m ə ɡ ɾ iː
सामने	s ɑː m n eː
सामर्थ्य	s ɑː m ə ɾ t̪ʰ j ə
सामान्यतः	s ɑː m ɑː n j ə t̪ əʰ
सामूहिक	s ɑː m uː ɦ ɪ k
साम्यवाद	s ɑː m j ə ʋ ɑː d̪
साम्राज्यवाद	s ɑː m ɾ ɑː d͡ʒ j ə ʋ ɑː d̪
साया	s ɑː j ɑː
सारंगी	s ɑː ɾ ə ŋ ɡ iː
सारा	s ɑː ɾ ɑː
सार्थक	s ɑː ɾ t̪ʰ ə k
साल	s ɑː l
सालभर	s ɑː l bʱ ə ɾ
सालाना	s ɑː l ɑː n ɑː
सास	s ɑː s
साहसी	s ɑːʱ s iː
साहित्य	s ɑː ɦ ɪ t̪ j
साहित्यिक	s ɑː ɦ ɪ t̪ j ɪ k
साहिल	s ɑː ɦ ɪ l
सिंगापुर	s ɪ ŋ ɡ ɑː p ʊ ɾ
सिंघ	s ɪ ŋ ɡʱ
सिंचाई	s ɪ ɲ t͡ʃ ɑː iː
सिंचित	s ɪ ɲ t͡ʃ ɪ t̪
सिंदूर	s ɪ n d̪ uː ɾ
सिंह	s ɪ nʱ
सिंहासन	s ɪ ŋ ɡʱ ɑː s ə n
सिकंदर	s ɪ k ə n d̪ ə ɾ
सिकंदराबाद	s ɪ k ə n d̪ ə ɾ ɑː b ɑː d̪
सिक्किम	s ɪ k k ɪ m
सिगार	s ɪ ɡ ɑː ɾ
सिचुआन	s ɪ t͡ʃ ʊ ɑː n
सितारा	s ɪ t̪ ɑː ɾ ɑː
सिद्धांत	s ɪ d̪ d̪ʱ ɑː n t̪
सिनेमा	s ɪ n eː m ɑː
सिनेमाघर	s ɪ n eː m ɑː ɡʱ ə ɾ
सिफ़ारिश	s ɪ f ɑː ɾ ɪ ʃ
सिया	s iː j ɑː
सियालकोट	s iː j ɑː l k oː ʈ
सिरा	s ɪ ɾ ɑː
सी	s iː
सीट	s iː ʈ
सीधा	s iː d̪ʱ ɑː
सीना	s iː n ɑː
सीनेट	s iː n eː ʈ
सीनेटर	s iː n eː ʈ ə ɾ
सीमा	s iː m ɑː
सीमित	s iː m ɪ t̪
सीरिया	s iː ɾ iː j ɑː
सुंदर	s ʊ n d̪ ə ɾ
सुअर	s ʊ ə ɾ
सुई	s uː iː
सुकून	s ʊ k uː n
सुख	s ʊ kʰ
सुखमय	s ʊ kʰ m ə j
सुचारु	s ʊ t͡ʃ ɑː ɾ uː
सुझाव	s ʊ d͡ʒʱ ɑː ʋ
सुडौल	s ʊ ɖ ɔː l
सुथरा	s ʊ t̪ʰ ɾ ɑː
सुधार	s ʊ d̪ʱ ɑː ɾ
सुधारना	s ʊ d̪ʱ ɑː ɾ n ɑː
सुधारवादी	s ʊ d̪ʱ ɑː ɾ ʋ ɑː d̪ iː
सुनना	s ʊ n n ɑː
सुनसान	s ʊ n s ɑː n
सुनहरा	s ʊ n ɛːʱ ɾ ɑː
सुनाई	s ʊ n ɑː iː
सुनामी	s ʊ n ɑː m iː
सुनार	s ʊ n ɑː ɾ
सुन्नी	s ʊ n n iː
सुपुर्द	s ʊ p ʊ ɾ d̪
सुबोध	s ʊ b oː d̪ʱ
सुरंग	s ʊ ɾ ə ŋ ɡ
सुरक्षाबल	s ʊ ɾ ə k ʃ ɑː b ə l
सुलह	s ʊ l əʱ
सुलेमान	s ʊ l eː m ɑː n
सुस्ती	s ʊ s t̪ iː
सूअर	s uː ə ɾ
सूई	s uː iː
सूखा	s uː kʰ ɑː
सूचक	s uː t͡ʃ ə k
सूचना	s uː t͡ʃ n ɑː
सूचित	s uː t͡ʃ ɪ t̪
सूची	s uː t͡ʃ iː
सूजन	s uː d͡ʒ ə n
सूत	s uː t̪
सूत्र	s uː t̪ ɾ
सूद	s uː d̪
सूरज	s uː ɾ ə d͡ʒ
सूर्य	s uː ɾ j
सूर्यास्त	s uː ɾ j ɑː s t̪
सूर्योदय	s uː ɾ j oː d̪ ə j
सृजन	s ɾ ɪ d͡ʒ ə n
सृष्टि	s ɾ ɪ ʃ ʈ iː
से	s eː
सेठ	s eː ʈʰ
सेब	s eː b
सेल	s eː l
सेवक	s eː ʋ ə k
सेवा	s eː ʋ ɑː
सेवानिवृत्त	s eː ʋ ɑː n ɪ ʋ ɾ ɪ t̪ t̪
सेवानिवृत्ति	s eː ʋ ɑː n ɪ ʋ ɾ ɪ t̪ t̪ iː
सैकड़ा	s ɛː k ɽ ɑː
सैद्धांतिक	s ɛː d̪ d̪ʱ ɑː n t̪ ɪ k
सैन्य	s ɛː n j
सैर	s ɛː ɾ
सॉरी	s ɔː ɾ iː
सोची	s oː t͡ʃ iː
सोना	s oː n ɑː
सोमालिया	s oː m ɑː l iː j ɑː
सोमाली	s oː m ɑː l iː
सोवियत	s oː ʋ iː j ə t̪
सोशलिस्ट	s oː ʃ l ɪ s ʈ
सौंपना	s ɔː m p n ɑː
सौदा	s ɔː d̪ ɑː
सौदागर	s ɔː d̪ ɑː ɡ ə ɾ
सौभाग्य	s ɔː bʱ ɑː ɡ j
सौर	s ɔː ɾ
सौराष्ट्र	s ɔː ɾ ɑː ʃ ʈ ɾ
स्कर्ट	s k ə ɾ ʈ
स्कूल	s k uː l
स्कूली	s k uː l iː
स्टेटस	s ʈ eː ʈ ə s
स्टेडियम	s ʈ eː ɖ iː j ə m
स्तंभ	s t̪ ə m bʱ
स्तुति	s t̪ ʊ t̪ iː
स्त्री	s t̪ ɾ iː
स्त्रोत	s t̪ ɾ oː t̪
स्थल	s t̪ʰ ə l
स्थाई	s t̪ʰ ɑː iː
स्थानांतरण	s t̪ʰ ɑː n ɑː n t̪ ɾ ə n
स्थिर	s t̪ʰ ɪ ɾ
स्नातकोत्तर	s n ɑː t̪ ə k oː t̪ t̪ ə ɾ
स्नायु	s n ɑː j uː
स्पर्श	s p ə ɾ ʃ
स्पेन	s p eː n
स्मरण	s m ə ɾ ə n
स्मार्टफ़ोन	s m ɑː ɾ ʈ f oː n
स्मृति	s m ɾ ɪ t̪ iː
स्लोवाकिया	s l oː ʋ ɑː k iː j ɑː
स्वचालित	s ʋ ə t͡ʃ ɑː l ɪ t̪
स्वजन	s ʋ ə d͡ʒ ə n
स्वदेशी	s ʋ ə d̪ eː ʃ iː
स्वभाव	s w ə bʱ ɑː ʋ
स्वर	s ʋ ə ɾ
स्वाद	s ʋ ɑː d̪
स्वामित्व	s ʋ ɑː m ɪ t̪ ʋ
स्वायत्तता	s ʋ ɑː j ə t̪ t̪ t̪ ɑː
स्वार्थी	s ʋ ɑː ɾ t̪ʰ iː
स्वास्थ्य	s ʋ ɑː s t̪ʰ j ə
स्वीकारना	s ʋ iː k ɑː ɾ n ɑː
स्वीकृति	s ʋ iː k ɾ ɪ t̪ iː
हंगरी	ɦ ə ŋ ɡ ɾ iː
हंगामा	ɦ ə ŋ ɡ ɑː m ɑː
हंस	ɦ ə n s
हज़ार	ɦ ə z ɑː ɾ
हटना	ɦ ə ʈ n ɑː
हटाना	ɦ ə ʈ ɑː n ɑː
हड़ताल	ɦ ə ɽ t̪ ɑː l
हड़ताली	ɦ ə ɽ t̪ ɑː l iː
हड़बड़ी	ɦ ə ɽ b ə ɽ iː
हड्डी	ɦ ə ɖ ɖ iː
हत्यारा	ɦ ə t̪ j ɑː ɾ ɑː
हथियार	ɦ ə t̪ʰ iː j ɑː ɾ
हथियारबंद	ɦ ə t̪ʰ iː j ɑː ɾ b ə n d̪
हथेली	ɦ ə t̪ʰ eː l iː
हबीब	ɦ ə b iː b
हम	ɦ ə m
हमको	ɦ ə m k oː
हमला	ɦ ə m l ɑː
हमलावर	ɦ ə m l ɑː ʋ ə ɾ
हमाम	ɦ ə m ɑː m
हमारा	ɦ ə m ɑː ɾ ɑː
हमें	ɦ ə m ẽ
हरकत	ɦ ə ɾ k ə t̪
हरगिज़	ɦ ə ɾ ɡ ɪ z
हरा	ɦ ə ɾ ɑː
हराना	ɦ ə ɾ ɑː n ɑː
हराम	ɦ ə ɾ ɑː m
हरामी	ɦ ə ɾ ɑː m iː
हरिजन	ɦ ə ɾ ɪ d͡ʒ ə n
हरित	ɦ ə ɾ ɪ t̪
हरियाणा	ɦ ə ɾ iː j ɑː n ɑː
हरियाली	ɦ ə ɾ iː j ɑː l iː
हरेक	ɦ ə ɾ eː k
हर्ज	ɦ ə ɾ d͡ʒ
हर्ष	ɦ ə ɾ ʃ
हल	ɦ ə l
हलचल	ɦ ə l t͡ʃ ə l
हलफ़नामा	ɦ ə l ə f n ɑː m ɑː
हल्का	ɦ ə l̪ k ɑː
हवलदार	ɦ ə ʋ ə l d̪ ɑː ɾ
हवा	ɦ ə ʋ ɑː
हवाला	ɦ ə ʋ ɑː l ɑː
हवालात	ɦ ə ʋ ɑː l ɑː t̪
हवेली	ɦ ə ʋ eː l iː
हसीन	ɦ ə s iː n
हसीना	ɦ ə s iː n ɑː
हस्तक्षेप	ɦ ə s t̪ ə k ʃ eː p
हस्ताक्षर	ɦ ə s t̪ ɑː k ʃ ə ɾ
हाँ	ɦ ɑ̃ː
हाइड्रोजन	ɦ ɑː ɪ ɖ ɾ oː d͡ʒ ə n
हाउस	ɦ ɑː ʊ s
हाज़िर	ɦ ɑː z ɪ ɾ
हाथ	ɦ ɑː t̪ʰ
हाथी	ɦ ɑː t̪ʰ iː
हादसा	ɦ ɑː d̪ s ɑː
हामी	ɦ ɑː m iː
हाय	ɦ ɑː j
हार	ɦ ɑː ɾ
हाल	ɦ ɑː l
हालत	ɦ ɑː l ə t̪
हालात	ɦ ɑː l ɑː t̪
हिंद	ɦ ɪ n d̪
हिंदी	ɦ ɪ n d̪ iː
हिंदुत्व	ɦ ɪ n d̪ ʊ t̪ ʋ
हिंसा	ɦ ɪ n s ɑː
हिंसात्मक	ɦ ɪ n s ɑː t̪ m ə k
हित	ɦ ɪ t̪
हिन्दुस्तानी	ɦ ɪ n d̪ ʊ s t̪ ɑː n iː
हिमस्खलन	ɦ ɪ m s kʰ ə l ə n
हिरन	ɦ ɪ ɾ ə n
हिसाब	ɦ ɪ s ɑː b
हिस्सेदार	ɦ ɪ s s eː d̪ ɑː ɾ
हिस्सेदारी	ɦ ɪ s s eː d̪ ɑː ɾ iː
ही	ɦ iː
हीटर	ɦ iː ʈ ə ɾ
हीर	ɦ iː ɾ
हीरो	ɦ iː ɾ oː
हुआ	ɦ ʊ ɑː
हुस्न	ɦ ʊ s n
हूँ	ɦ ũː
हूबहू	ɦ uː b ə ɦ uː
हृदयाघात	ɦ ɾ ɪ d̪ ə j ɑː ɡʱ ɑː t̪
हे	ɦ eː
हेक्टेयर	ɦ eː k ʈ eː j ə ɾ
हेतु	ɦ eː t̪ uː
हेलीकॉप्टर	ɦ eː l iː k ɔː p ʈ ə ɾ
है	ɦ ɛː
हैं	ɦ ɛ̃ː
हैती	ɦ ɛː t̪ iː
हैदर	ɦ ɛː d̪ ə ɾ
हैदराबाद	ɦ ɛː d̪ ɾ ɑː b ɑː d̪
हैरत	ɦ ɛː ɾ ə t̪
हैरान	ɦ ɛː ɾ ɑː n
हैवान	ɦ ɛː ʋ ɑː n
हैवानियत	ɦ ɛː ʋ ɑː n iː j ə t̪
हैसियत	ɦ ɛː s iː j ə t̪
हॉकी	ɦ ɔː k iː
हॉलैंड	ɦ ɔː l ɛː n ɖ
होंठ	ɦ oː n ʈʰ
होकर	ɦ oː k ə ɾ
होगा	ɦ oː ɡ ɑː
होनहार	ɦ oː n ɦ ɑː ɾ
होना	ɦ oː n ɑː
होशंगाबाद	ɦ oː ʃ ə ŋ ɡ ɑː b ɑː d̪
होशियार	ɦ oː ʃ iː j ɑː ɾ
हौसला	ɦ ɔː s l ɑː
