abban	ɒ bː ɒ n
abból	ɒ bː oː l
abortusz	ɒ b o r t u s
abszolút	ɒ p s o l uː t
ad	ɒ d
adatai	ɒ d ɒ t ɒʲ i
adatait	ɒ d ɒ t ɒʲ i t
addig	ɒ dː i ɡ
adjanak	ɒ ɟː ɒ n ɒ k
adjuk	ɒ ɟː u k
adják	ɒ ɟː aː k
adnak	ɒ d n ɒ k
adni	ɒ d n i
adniuk	ɒ d n iʲ u k
adnom	ɒ d n o m
adná	ɒ d n aː
adott	ɒ d o tː
adottak	ɒ d o tː ɒ k
adta	ɒ tː ɒ
adták	ɒ tː aː k
adunk	ɒ d u ŋ k
ady	ɒ d i
adócsökkentés	ɒ d oː t͡ʃ ø kː ɛ n t eː ʃ
adódik	ɒ d oː d i k
adókulcs	ɒ d oː k u l t͡ʃ
adós	ɒ d oː ʃ
afganisztáni	ɒ v ɡ ɒ n i s t aː n i
afrika	ɒ f r i k ɒ
aggodalmak	ɒ ɡː o d ɒ l m ɒ k
agresszív	ɒ ɡ r ɛ sː iː v
agyar	ɒ ɟ ɒ r
ahhoz	ɒ ɦ o z
ahogy	ɒ ɦ o ɟ
ahogyan	ɒ ɦ o ɟ ɒ n
ahol	ɒ ɦ o l
ahonnan	ɒ ɦ o nː ɒ n
ajtóba	ɒ j t oː b ɒ
ajtók	ɒ j t oː k
ajtón	ɒ j t oː n
ajándék	ɒ j aː n d eː k
ajánlat	ɒ j aː n l ɒ t
ajánlatot	ɒ j aː n l ɒ t o t
akadémia	ɒ k ɒ d eː m iʲ ɒ
akar	ɒ k ɒ r
akarata	ɒ k ɒ r ɒ t ɒ
akaratát	ɒ k ɒ r ɒ t aː t
akarjuk	ɒ k ɒ r j u k
akarják	ɒ k ɒ r j aː k
akarnak	ɒ k ɒ r n ɒ k
akarná	ɒ k ɒ r n aː
akarsz	ɒ k ɒ r s
akart	ɒ k ɒ r t
akarta	ɒ k ɒ r t ɒ
akartak	ɒ k ɒ r t ɒ k
aki	ɒ k i
akik	ɒ k i k
akikben	ɒ k i ɡ b ɛ n
akiket	ɒ k i k ɛ t
akiknek	ɒ k i k n ɛ k
akit	ɒ k i t
akitől	ɒ k i t øː l
akkora	ɒ kː o r ɒ
akkori	ɒ kː o r i
aktivitás	ɒ k t i v i t aː ʃ
aktus	ɒ k t u ʃ
aktív	ɒ k t iː v
akvamarin	ɒ k v ɒ m ɒ r i n
akár	ɒ k aː r
akárcsak	ɒ k aː r t͡ʃ ɒ k
akárhogy	ɒ k aː r ɦ o ɟ
akárki	ɒ k aː r k i
alacsony	ɒ l ɒ t͡ʃ o ɲ
alacsonyabb	ɒ l ɒ t͡ʃ o ɲ ɒ bː
alak	ɒ l ɒ k
alakok	ɒ l ɒ k o k
alakuló	ɒ l ɒ k u l oː
alakítható	ɒ l ɒ k iː t h ɒ t oː
alanya	ɒ l ɒ ɲ ɒ
alanyai	ɒ l ɒ ɲ ɒʲ i
alapján	ɒ l ɒ p j aː n
alapját	ɒ l ɒ p j aː t
alapjául	ɒ l ɒ p j aː u l
alapokra	ɒ l ɒ p o k r ɒ
alapon	ɒ l ɒ p o n
alaposan	ɒ l ɒ p o ʃ ɒ n
alapul	ɒ l ɒ p u l
alapvető	ɒ l ɒ p v ɛ t øː
alapítvány	ɒ l ɒ p iː t v aː ɲ
alapító	ɒ l ɒ p iː t oː
alatt	ɒ l ɒ tː
alatta	ɒ l ɒ tː ɒ
alatti	ɒ l ɒ tː i
album	ɒ l b u m
algoritmus	ɒ l ɡ o r i t m u ʃ
alkalmas	ɒ l k ɒ l m ɒ ʃ
alkalmat	ɒ l k ɒ l m ɒ t
alkalmazható	ɒ l k ɒ l m ɒ s h ɒ t oː
alkalmazás	ɒ l k ɒ l m ɒ z aː ʃ
alkalmazása	ɒ l k ɒ l m ɒ z aː ʃ ɒ
alkalmazások	ɒ l k ɒ l m ɒ z aː ʃ o k
alkalmi	ɒ l k ɒ l m i
alkalmon	ɒ l k ɒ l m o n
alkalmából	ɒ l k ɒ l m aː b oː l
alkalmával	ɒ l k ɒ l m aː v ɒ l
alkalommal	ɒ l k ɒ l o mː ɒ l
alkoholizmus	ɒ l k o h o l i z m u ʃ
alkot	ɒ l k o t
alkotmánybíróság	ɒ l k o t m aː ɲ b iː r oː ʃ aː ɡ
alkotók	ɒ l k o t oː k
alkum	ɒ l k u m
allergiás	ɒ lː ɛ r ɡ iʲ aː ʃ
alpolgármester	ɒ l p o l ɡ aː r m ɛ ʃ t ɛ r
aludttej	ɒ l u tː ɛ j
alá	ɒ l aː
alábbi	ɒ l aː bː i
aláírta	ɒ l aːʲ iː r t ɒ
aláírása	ɒ l aːʲ iː r aː ʃ ɒ
amatőr	ɒ m ɒ t øː r
amely	ɒ m ɛ j
amelyben	ɒ m ɛ j b ɛ n
amelyből	ɒ m ɛ j b øː l
amelyek	ɒ m ɛ j ɛ k
amelyekben	ɒ m ɛ j ɛ ɡ b ɛ n
amelyeknél	ɒ m ɛ j ɛ k n eː l
amelyen	ɒ m ɛ j ɛ n
amelyet	ɒ m ɛ j ɛ t
amelyhez	ɒ m ɛ j h ɛ z
amelynek	ɒ m ɛ j n ɛ k
amennyiben	ɒ m ɛ ɲː i b ɛ n
amennyire	ɒ m ɛ ɲː i r ɛ
amerika	ɒ m ɛ r i k ɒ
amerikai	ɒ m ɛ r i k ɒʲ i
amerikában	ɒ m ɛ r i k aː b ɒ n
ami	ɒ m i
amiben	ɒ m i b ɛ n
amihez	ɒ m i ɦ ɛ z
amik	ɒ m i k
amiket	ɒ m i k ɛ t
amikor	ɒ m i k o r
amilyen	ɒ m i j ɛ n
amin	ɒ m i n
amint	ɒ m i n t
amire	ɒ m i r ɛ
amiről	ɒ m i r øː l
amit	ɒ m i t
amivel	ɒ m i v ɛ l
amiért	ɒ m iʲ eː r t
amszterdam	ɒ m s t ɛ r d ɒ m
amíg	ɒ m iː ɡ
amúgy	ɒ m uː ɟ
analízis	ɒ n ɒ l iː z i ʃ
andrás	ɒ n d r aː ʃ
angol	ɒ ŋ ɡ o l
angolszász	ɒ ŋ ɡ o l s aː s
angolul	ɒ ŋ ɡ o l u l
angyal	ɒ ɲ ɟ ɒ l
anita	ɒ n i t ɒ
anna	ɒ nː ɒ
annak	ɒ nː ɒ k
annamária	ɒ nː ɒ m aː r iʲ ɒ
annyi	ɒ ɲː i
annyira	ɒ ɲː i r ɒ
annyit	ɒ ɲː i t
annál	ɒ nː aː l
antal	ɒ n t ɒ l
anya	ɒ ɲ ɒ
anyag	ɒ ɲ ɒ ɡ
anyagból	ɒ ɲ ɒ ɡ b oː l
anyagi	ɒ ɲ ɒ ɡ i
anyagok	ɒ ɲ ɒ ɡ o k
anyagokat	ɒ ɲ ɒ ɡ o k ɒ t
anyagokból	ɒ ɲ ɒ ɡ o ɡ b oː l
anyagot	ɒ ɲ ɒ ɡ o t
anyja	ɒ ɲː ɒ
apja	ɒ p j ɒ
apám	ɒ p aː m
arab	ɒ r ɒ b
aranyat	ɒ r ɒ ɲ ɒ t
arca	ɒ r t͡s ɒ
archívum	ɒ r ɦ iː v u m
aroma	ɒ r o m ɒ
arról	ɒ rː oː l
arány	ɒ r aː ɲ
aránytalan	ɒ r aː ɲ t ɒ l ɒ n
aránytalanul	ɒ r aː ɲ t ɒ l ɒ n u l
arányát	ɒ r aː ɲ aː t
arányú	ɒ r aː ɲ uː
asszisztens	ɒ sː i s t ɛ n ʃ
asszony	ɒ sː o ɲ
asztalitenisz	ɒ s t ɒ l i t ɛ n i s
asztalok	ɒ s t ɒ l o k
atlétikai	ɒ t l eː t i k ɒʲ i
attila	ɒ t i lː ɒ
attól	ɒ tː oː l
ausztrál	ɒ u s t r aː l
automata	ɒ u t o m ɒ t ɒ
autonómia	ɒ u t o n oː m iʲ ɒ
autógyár	ɒ u t oː ɟ aː r
autópálya	ɒ u t oː p aː j ɒ
autópályán	ɒ u t oː p aː j aː n
avagy	ɒ v ɒ ɟ
az	ɒ z
azaz	ɒ z ɒ z
azokat	ɒ z o k ɒ t
azokkal	ɒ z o kː ɒ l
azon	ɒ z o n
azonban	ɒ z o m b ɒ n
azonnal	ɒ z o nː ɒ l
azonos	ɒ z o n o ʃ
azonosító	ɒ z o n o ʃ iː t oː
azt	ɒ s t
aztán	ɒ s t aː n
azzal	ɒ zː ɒ l
azért	ɒ z eː r t
azóta	ɒ z oː t ɒ
babára	b ɒ b aː r ɒ
baj	b ɒ j
baja	b ɒ j ɒ
bajnok	b ɒ j n o k
bajnoki	b ɒ j n o k i
bajokat	b ɒ j o k ɒ t
balaton	b ɒ l ɒ t o n
balhét	b ɒ l ɦ eː t
baloldali	b ɒ l o l d ɒ l i
bank	b ɒ ŋ k
bankban	b ɒ ŋ ɡ b ɒ n
banknak	b ɒ ŋ k n ɒ k
bankok	b ɒ ŋ k o k
bankokat	b ɒ ŋ k o k ɒ t
bankokkal	b ɒ ŋ k o kː ɒ l
bankokon	b ɒ ŋ k o k o n
barna	b ɒ r n ɒ
bartók	b ɒ r t oː k
baráti	b ɒ r aː t i
barátjának	b ɒ r aː cː aː n ɒ k
barátságos	b ɒ r aː t͡ʃː aː ɡ o ʃ
be	b ɛ
beavatkozások	b ɛ ɒ v ɒ t k o z aː ʃ o k
befektetések	b ɛ f ɛ k t ɛ t eː ʃ ɛ k
befolyás	b ɛ f o j aː ʃ
bejelenteni	b ɛ j ɛ l ɛ n t ɛ n i
belföldi	b ɛ l f ø l d i
belső	b ɛ l ʃ øː
belé	b ɛ l eː
belépő	b ɛ l eː p øː
belügyminisztérium	b ɛ l y ɟ m i n i s t eː r iʲ u m
belül	b ɛ l y l
belüli	b ɛ l y l i
belőle	b ɛ l øː l ɛ
belőlük	b ɛ l øː l y k
bemutatkozó	b ɛ m u t ɒ t k o z oː
bemutatása	b ɛ m u t ɒ t aː ʃ ɒ
bemutatásra	b ɛ m u t ɒ t aː ʃ r ɒ
benkő	b ɛ ŋ k øː
benne	b ɛ nː ɛ
bennük	b ɛ nː y k
bennünket	b ɛ nː y ŋ k ɛ t
bent	b ɛ n t
berlini	b ɛ r l i n i
beruházás	b ɛ r u ɦ aː z aː ʃ
beruházások	b ɛ r u ɦ aː z aː ʃ o k
beszéde	b ɛ s eː d ɛ
beszédét	b ɛ s eː d eː t
beszélni	b ɛ s eː l n i
beteg	b ɛ t ɛ ɡ
betegek	b ɛ t ɛ ɡ ɛ k
betegség	b ɛ t ɛ k ʃ eː ɡ
betegsége	b ɛ t ɛ k ʃ eː ɡ ɛ
bethlen	b ɛ t l ɛ n
betöltött	b ɛ t ø l t ø tː
betűméret	b ɛ t yː m eː r ɛ t
bevezetni	b ɛ v ɛ z ɛ t n i
bevezető	b ɛ v ɛ z ɛ t øː
bevételt	b ɛ v eː t ɛ l t
bezár	b ɛ z aː r
biblia	b i b l iʲ ɒ
bináris	b i n aː r i ʃ
birtoka	b i r t o k ɒ
birtokba	b i r t o ɡ b ɒ
birtokában	b i r t o k aː b ɒ n
bizalmunk	b i z ɒ l m u ŋ k
bizonyos	b i z o ɲ o ʃ
bizonyítékok	b i z o ɲ iː t eː k o k
bizottság	b i z o t͡ʃː aː ɡ
bizottságok	b i z o t͡ʃː aː ɡ o k
biztató	b i s t ɒ t oː
biztatók	b i s t ɒ t oː k
biztonsági	b i s t o n ʃ aː ɡ i
biztonságos	b i s t o n ʃ aː ɡ o ʃ
biztos	b i s t o ʃ
biztosan	b i s t o ʃ ɒ n
biztosít	b i s t o ʃ iː t
biztosítani	b i s t o ʃ iː t ɒ n i
biztosítja	b i s t o ʃ iː cː ɒ
biztosítása	b i s t o ʃ iː t aː ʃ ɒ
biztosítási	b i s t o ʃ iː t aː ʃ i
biztosítására	b i s t o ʃ iː t aː ʃ aː r ɒ
blog	b l o ɡ
blues	b l u ɛ ʃ
bocsátani	b o t͡ʃ aː t ɒ n i
bocsátott	b o t͡ʃ aː t o tː
bocsátottak	b o t͡ʃ aː t o tː ɒ k
bojár	b o j aː r
boldogan	b o l d o ɡ ɒ n
boltok	b o l t o k
bolygó	b o j ɡ oː
bonyodalom	b o ɲ o d ɒ l o m
borús	b o r uː ʃ
bosnyák	b o ʃ ɲ aː k
bronz	b r o n z
bruttó	b r u tː oː
buborék	b u b o r eː k
buda	b u d ɒ
budai	b u d ɒʲ i
budapest	b u d ɒ p ɛ ʃ t
budapesten	b u d ɒ p ɛ ʃ t ɛ n
bukarest	b u k ɒ r ɛ ʃ t
burgonya	b u r ɡ o ɲ ɒ
burkolat	b u r k o l ɒ t
bácsik	b aː t͡ʃ i k
bánatot	b aː n ɒ t o t
bárcsak	b aː r t͡ʃ ɒ k
bárki	b aː r k i
bárkinek	b aː r k i n ɛ k
bárkit	b aː r k i t
bármelyik	b aː r m ɛ j i k
bármi	b aː r m i
bármikor	b aː r m i k o r
bécs	b eː t͡ʃ
béla	b eː l ɒ
bélyegek	b eː j ɛ ɡ ɛ k
bérelt	b eː r ɛ l t
bérleti	b eː r l ɛ t i
bíró	b iː r oː
bírói	b iː r oːʲ i
bíróság	b iː r oː ʃ aː ɡ
bírósági	b iː r oː ʃ aː ɡ i
bízott	b iː z o tː
búcsú	b uː t͡ʃ uː
búvár	b uː v aː r
büszke	b y s k ɛ
büszkék	b y s k eː k
büszkén	b y s k eː n
bővebben	b øː v ɛ bː ɛ n
bővítést	b øː v iː t eː ʃ t
bűn	b yː n
bűncselekmények	b yː n t͡ʃ ɛ l ɛ k m eː ɲ ɛ k
bűntény	b yː n t eː ɲ
cd	t͡s eː d eː
cikk	t͡s i kː
cikkeket	t͡s i kː ɛ k ɛ t
citrom	t͡s i t r o m
csak	t͡ʃ ɒ k
csaknem	t͡ʃ ɒ k n ɛ m
csakugyan	t͡ʃ ɒ k u ɟ ɒ n
család	t͡ʃ ɒ l aː d
csapadék	t͡ʃ ɒ p ɒ d eː k
csapat	t͡ʃ ɒ p ɒ t
csapata	t͡ʃ ɒ p ɒ t ɒ
csapatok	t͡ʃ ɒ p ɒ t o k
csatlakozás	t͡ʃ ɒ t l ɒ k o z aː ʃ
csatorna	t͡ʃ ɒ t o r n ɒ
csatában	t͡ʃ ɒ t aː b ɒ n
csecsemő	t͡ʃ ɛ t͡ʃ ɛ m øː
csendes	t͡ʃ ɛ n d ɛ ʃ
csendőrök	t͡ʃ ɛ n d øː r ø k
csere	t͡ʃ ɛ r ɛ
csinálhat	t͡ʃ i n aː l ɦ ɒ t
csinálni	t͡ʃ i n aː l n i
csinálsz	t͡ʃ i n aː l s
csinálunk	t͡ʃ i n aː l u ŋ k
csipetnyi	t͡ʃ i p ɛ t ɲ i
csodálatos	t͡ʃ o d aː l ɒ t o ʃ
csomagja	t͡ʃ o m ɒ ɡ j ɒ
csongrád	t͡ʃ o ŋ ɡ r aː d
csont	t͡ʃ o n t
csontos	t͡ʃ o n t o ʃ
csoport	t͡ʃ o p o r t
csoportok	t͡ʃ o p o r t o k
csoportot	t͡ʃ o p o r t o t
csoportra	t͡ʃ o p o r t r ɒ
csupán	t͡ʃ u p aː n
császár	t͡ʃ aː s aː r
csíp	t͡ʃ iː p
csípős	t͡ʃ iː p øː ʃ
csökkent	t͡ʃ ø kː ɛ n t
csökkentése	t͡ʃ ø kː ɛ n t eː ʃ ɛ
csökkenése	t͡ʃ ø kː ɛ n eː ʃ ɛ
csökkenő	t͡ʃ ø kː ɛ n øː
csökönyös	t͡ʃ ø k ø ɲ ø ʃ
csúcs	t͡ʃ uː t͡ʃ
csütörtök	t͡ʃ y t ø r t ø k
csütörtökön	t͡ʃ y t ø r t ø k ø n
csőr	t͡ʃ øː r
cuki	t͡s u k i
cég	t͡s eː ɡ
cégek	t͡s eː ɡ ɛ k
cégeket	t͡s eː ɡ ɛ k ɛ t
céget	t͡s eː ɡ ɛ t
cégnél	t͡s eː ɡ n eː l
cégünk	t͡s eː ɡ y ŋ k
cél	t͡s eː l
célba	t͡s eː l b ɒ
célból	t͡s eː l b oː l
célkitűzés	t͡s eː l k i t yː z eː ʃ
célokra	t͡s eː l o k r ɒ
célpont	t͡s eː l p o n t
célszerű	t͡s eː l s ɛ r yː
címe	t͡s iː m ɛ
címen	t͡s iː m ɛ n
címere	t͡s iː m ɛ r ɛ
címet	t͡s iː m ɛ t
címkék	t͡s iː m k eː k
címmel	t͡s iː mː ɛ l
címre	t͡s iː m r ɛ
címzett	t͡s iː m z ɛ tː
címén	t͡s iː m eː n
címére	t͡s iː m eː r ɛ
címét	t͡s iː m eː t
című	t͡s iː m yː
dagad	d ɒ ɡ ɒ d
dal	d ɒ l
dalai	d ɒ l ɒʲ i
dalokat	d ɒ l o k ɒ t
darab	d ɒ r ɒ b
darabig	d ɒ r ɒ b i ɡ
darabot	d ɒ r ɒ b o t
david	d eː v i d
de	d ɛ
debrecen	d ɛ b r ɛ t͡s ɛ n
debreceni	d ɛ b r ɛ t͡s ɛ n i
december	d ɛ t͡s ɛ m b ɛ r
decemberben	d ɛ t͡s ɛ m b ɛ r b ɛ n
decemberi	d ɛ t͡s ɛ m b ɛ r i
demokrata	d ɛ m o k r ɒ t ɒ
demokrácia	d ɛ m o k r aː t͡s iʲ ɒ
derült	d ɛ r y l t
deák	d ɛ aː k
dicséret	d i t͡ʃ eː r ɛ t
digitális	d i ɡ i t aː l i ʃ
dinamikus	d i n ɒ m i k u ʃ
diplomáciai	d i p l o m aː t͡s iʲ ɒʲ i
diplomát	d i p l o m aː t
divatos	d i v ɒ t o ʃ
diák	d iʲ aː k
diákok	d iʲ aː k o k
dkg	d ɛ k ɒ ɡ r ɒ mː
dobja	d o b j ɒ
doktor	d o k t o r
dokumentumot	d o k u m ɛ n t u m o t
dolga	d o l ɡ ɒ
dolgai	d o l ɡ ɒʲ i
dolgozni	d o l ɡ o z n i
dolgozott	d o l ɡ o z o tː
dolgoztak	d o l ɡ o s t ɒ k
dolgozói	d o l ɡ o z oːʲ i
dolgozók	d o l ɡ o z oː k
domináns	d o m i n aː n ʃ
dráma	d r aː m ɒ
durván	d u r v aː n
dániel	d aː n iʲ ɛ l
dátum	d aː t u m
dávid	d aː v i d
dédunoka	d eː d u n o k ɒ
délben	d eː l b ɛ n
délelőtt	d eː l ɛ l øː tː
délelőtti	d eː l ɛ l øː tː i
déli	d eː l i
délután	d eː l u t aː n
díj	d iː j
dózsa	d oː ʒ ɒ
dönt	d ø n t
döntés	d ø n t eː ʃ
döntéseket	d ø n t eː ʃ ɛ k ɛ t
döntést	d ø n t eː ʃ t
döntését	d ø n t eː ʃ eː t
döntött	d ø n t ø tː
döntő	d ø n t øː
eddig	ɛ dː i ɡ
eddigi	ɛ dː i ɡ i
edény	ɛ d eː ɲ
eger	ɛ ɡ ɛ r
egerszegi	ɛ ɡ ɛ r s ɛ ɡ i
egy	ɛ ɟː
egyaránt	ɛ ɟː ɒ r aː n t
egyben	ɛ ɟ b ɛ n
egyedi	ɛ ɟ ɛ d i
egyedül	ɛ ɟ ɛ d y l
egyedüli	ɛ ɟ ɛ d y l i
egyenes	ɛ ɟ ɛ n ɛ ʃ
egyes	ɛ ɟː ɛ ʃ
egyesek	ɛ ɟː ɛ ʃ ɛ k
egyesült	ɛ ɟː ɛ ʃ y l t
egyet	ɛ ɟː ɛ t
egyetem	ɛ ɟ ɛ t ɛ m
egyetemben	ɛ ɟ ɛ t ɛ m b ɛ n
egyetlen	ɛ ɟː ɛ t l ɛ n
egyezség	ɛ ɟː ɛ ʃː eː ɡ
egyeztetés	ɛ ɟː ɛ s t ɛ t eː ʃ
egyfajta	ɛ c f ɒ j t ɒ
egyhangúlag	ɛ c h ɒ ŋ ɡ uː l ɒ ɡ
egyház	ɛ c h aː z
egyházi	ɛ c h aː z i
egyik	ɛ ɟː i k
egyiket	ɛ ɟː i k ɛ t
egyikük	ɛ ɟː i k y k
egyiptológia	ɛ ɟ i p t o l oː ɡ iʲ ɒ
egyiptomi	ɛ ɟ i p t o m i
egykori	ɛ c k o r i
egymás	ɛ ɟ m aː ʃ
egymásban	ɛ ɟ m aː ʒ b ɒ n
egymást	ɛ ɟ m aː ʃ t
egymástól	ɛ ɟ m aː ʃ t oː l
egyre	ɛ ɟ r ɛ
egyszemélyes	ɛ c s ɛ m eː j ɛ ʃ
egyszer	ɛ c s ɛ r
egyszerre	ɛ c s ɛ rː ɛ
egyszerű	ɛ c s ɛ r yː
egyszerűbb	ɛ c s ɛ r yː bː
egyszerűen	ɛ c s ɛ r yː ɛ n
egység	ɛ c ʃ eː ɡ
egysége	ɛ c ʃ eː ɡ ɛ
egyáltalán	ɛ ɟː aː l t ɒ l aː n
egyéb	ɛ ɟ eː b
egyébként	ɛ ɟ eː p k eː n t
egyéni	ɛ ɟ eː n i
együtt	ɛ ɟː y tː
együttműködés	ɛ ɟː y t m yː k ø d eː ʃ
egér	ɛ ɡ eː r
egész	ɛ ɡ eː s
egészen	ɛ ɡ eː s ɛ n
egészséges	ɛ ɡ eː ʃː eː ɡ ɛ ʃ
ejtőernyőzés	ɛ j t øː ɛ r ɲ øː z eː ʃ
ekkor	ɛ kː o r
eközben	ɛ k ø z b ɛ n
el	ɛ l
elad	ɛ l ɒ d
eladni	ɛ l ɒ d n i
eladó	ɛ l ɒ d oː
eldőlt	ɛ l d øː l t
elegendő	ɛ l ɛ ɡ ɛ n d øː
elegük	ɛ l ɛ ɡ y k
eleinte	ɛ l ɛʲ i n t ɛ
eleje	ɛ l ɛ j ɛ
elején	ɛ l ɛ j eː n
elektronika	ɛ l ɛ k t r o n i k ɒ
elemeit	ɛ l ɛ m ɛʲ i t
elemi	ɛ l ɛ m i
elemzések	ɛ l ɛ m z eː ʃ ɛ k
elemzők	ɛ l ɛ m z øː k
elenyésző	ɛ l ɛ ɲ eː s øː
elfogadása	ɛ l f o ɡ ɒ d aː ʃ ɒ
elfogy	ɛ l f o ɟ
elhelyezkedő	ɛ l ɦ ɛ j ɛ s k ɛ d øː
elhunyt	ɛ l ɦ u ɲ t
elhízott	ɛ l ɦ iː z o tː
elismerés	ɛ l i ʃ m ɛ r eː ʃ
elismerést	ɛ l i ʃ m ɛ r eː ʃ t
eljárást	ɛ jː aː r aː ʃ t
elkerülhetetlen	ɛ l k ɛ r y l ɦ ɛ t ɛ t l ɛ n
elképzelhetetlen	ɛ l k eː b z ɛ l ɦ ɛ t ɛ t l ɛ n
elképzelések	ɛ l k eː b z ɛ l eː ʃ ɛ k
elkészítése	ɛ l k eː s iː t eː ʃ ɛ
elkészítésére	ɛ l k eː s iː t eː ʃ eː r ɛ
elkövetkező	ɛ l k ø v ɛ t k ɛ z øː
elkülönített	ɛ l k y l ø n iː t ɛ tː
ellene	ɛ lː ɛ n ɛ
elleni	ɛ lː ɛ n i
ellenkező	ɛ lː ɛ ŋ k ɛ z øː
ellenség	ɛ lː ɛ n ʃ eː ɡ
ellenségek	ɛ lː ɛ n ʃ eː ɡ ɛ k
ellenséges	ɛ lː ɛ n ʃ eː ɡ ɛ ʃ
ellentmond	ɛ lː ɛ n t m o n d
ellenében	ɛ lː ɛ n eː b ɛ n
ellenére	ɛ lː ɛ n eː r ɛ
ellenőrzi	ɛ lː ɛ n øː r z i
ellenőrzés	ɛ lː ɛ n øː r z eː ʃ
ellenőrzött	ɛ lː ɛ n øː r z ø tː
ellenőrző	ɛ lː ɛ n øː r z øː
ellátott	ɛ lː aː t o tː
elmondta	ɛ l m o n t ɒ
elmúlt	ɛ l m uː l t
elnöke	ɛ l n ø k ɛ
elnöki	ɛ l n ø k i
elnökség	ɛ l n ø k ʃ eː ɡ
elnöksége	ɛ l n ø k ʃ eː ɡ ɛ
elnökségi	ɛ l n ø k ʃ eː ɡ i
elnökét	ɛ l n ø k eː t
elsajátítása	ɛ l ʃ ɒ j aː t iː t aː ʃ ɒ
első	ɛ l ʃ øː
elsődleges	ɛ l ʃ øː d l ɛ ɡ ɛ ʃ
elsősorban	ɛ l ʃ øː ʃ o r b ɒ n
elte	ɛ l t ɛ
elve	ɛ l v ɛ
elvégezhető	ɛ l v eː ɡ ɛ s h ɛ t øː
elé	ɛ l eː
elég	ɛ l eː ɡ
elégedetlenség	ɛ l eː ɡ ɛ d ɛ t l ɛ n ʃ eː ɡ
elérhető	ɛ l eː r ɦ ɛ t øː
elérni	ɛ l eː r n i
elérésére	ɛ l eː r eː ʃ eː r ɛ
elérését	ɛ l eː r eː ʃ eː t
előadás	ɛ l øː ɒ d aː ʃ
előadást	ɛ l øː ɒ d aː ʃ t
előadó	ɛ l øː ɒ d oː
előadók	ɛ l øː ɒ d oː k
előbb	ɛ l øː bː
elől	ɛ l øː l
elősegítése	ɛ l øː ʃ ɛ ɡ iː t eː ʃ ɛ
először	ɛ l øː s ø r
előtt	ɛ l øː tː
előtte	ɛ l øː tː ɛ
előtti	ɛ l øː tː i
előzetes	ɛ l øː z ɛ t ɛ ʃ
előzetesen	ɛ l øː z ɛ t ɛ ʃ ɛ n
előző	ɛ l øː z øː
előírások	ɛ l øːʲ iː r aː ʃ o k
ember	ɛ m b ɛ r
emberei	ɛ m b ɛ r ɛʲ i
emberek	ɛ m b ɛ r ɛ k
embereket	ɛ m b ɛ r ɛ k ɛ t
emberi	ɛ m b ɛ r i
emberiség	ɛ m b ɛ r i ʃ eː ɡ
embernek	ɛ m b ɛ r n ɛ k
embert	ɛ m b ɛ r t
eme	ɛ m ɛ
emeleti	ɛ m ɛ l ɛ t i
emelkedett	ɛ m ɛ l k ɛ d ɛ tː
emelkedés	ɛ m ɛ l k ɛ d eː ʃ
emellett	ɛ m ɛ lː ɛ tː
emiatt	ɛ m iʲ ɒ tː
emlékek	ɛ m l eː k ɛ k
emlékeket	ɛ m l eː k ɛ k ɛ t
emlékiratok	ɛ m l eː k i r ɒ t o k
emlékmű	ɛ m l eː k m yː
említett	ɛ m l iː t ɛ tː
emőke	ɛ m øː k ɛ
enciklopédia	ɛ n t͡s i k l o p eː d iʲ ɒ
endre	ɛ n d r ɛ
energia	ɛ n ɛ r ɡ iʲ ɒ
energikus	ɛ n ɛ r ɡ i k u ʃ
engedély	ɛ ŋ ɡ ɛ d eː j
engedélyt	ɛ ŋ ɡ ɛ d eː j t
ennek	ɛ nː ɛ k
ennél	ɛ nː eː l
enyhén	ɛ ɲ ɦ eː n
enyém	ɛ ɲ eː m
erdei	ɛ r d ɛʲ i
erdélyben	ɛ r d eː j b ɛ n
erdő	ɛ r d øː
erdőtűz	ɛ r d øː t yː z
eredete	ɛ r ɛ d ɛ t ɛ
eredetileg	ɛ r ɛ d ɛ t i l ɛ ɡ
eredményeit	ɛ r ɛ d m eː ɲ ɛʲ i t
eredményes	ɛ r ɛ d m eː ɲ ɛ ʃ
eredményesen	ɛ r ɛ d m eː ɲ ɛ ʃ ɛ n
erejével	ɛ r ɛ j eː v ɛ l
erkel	ɛ r k ɛ l
erkölcsi	ɛ r k ø l t͡ʃ i
erkölcsös	ɛ r k ø l t͡ʃ ø ʃ
erről	ɛ rː øː l
erzsébet	ɛ r ʒ eː b ɛ t
erő	ɛ r øː
erőforrás	ɛ r øː f o rː aː ʃ
erőforrások	ɛ r øː f o rː aː ʃ o k
erők	ɛ r øː k
erőnek	ɛ r øː n ɛ k
erős	ɛ r øː ʃ
erősebb	ɛ r øː ʃ ɛ bː
erőszakot	ɛ r øː s ɒ k o t
esetleg	ɛ ʃ ɛ t l ɛ ɡ
esetleges	ɛ ʃ ɛ t l ɛ ɡ ɛ ʃ
esetében	ɛ ʃ ɛ t eː b ɛ n
esetén	ɛ ʃ ɛ t eː n
esik	ɛ ʃ i k
esküdt	ɛ ʃ k y tː
esküszik	ɛ ʃ k y s i k
este	ɛ ʃ t ɛ
esterházy	ɛ s t ɛ r ɦ aː z i
eszed	ɛ s ɛ d
eszerint	ɛ s ɛ r i n t
eszköz	ɛ s k ø z
eszköze	ɛ s k ø z ɛ
eszközei	ɛ s k ø z ɛʲ i
eszközt	ɛ s k ø s t
eszter	ɛ s t ɛ r
esztergályos	ɛ s t ɛ r ɡ aː j o ʃ
esélye	ɛ ʃ eː j ɛ
ettől	ɛ tː øː l
euró	ɛ u r oː
európai	ɛ u r oː p ɒʲ i
európában	ɛ u r oː p aː b ɒ n
eurós	ɛ u r oː ʃ
eurót	ɛ u r oː t
evangélikus	ɛ v ɒ ŋ ɡ eː l i k u ʃ
exkluzív	ɛ k s k l u z iː v
extrém	ɛ k s t r eː m
ez	ɛ z
ezek	ɛ z ɛ k
ezeken	ɛ z ɛ k ɛ n
ezeket	ɛ z ɛ k ɛ t
ezekkel	ɛ z ɛ kː ɛ l
ezekre	ɛ z ɛ k r ɛ
ezekről	ɛ z ɛ k r øː l
ezektől	ɛ z ɛ k t øː l
ezelőtt	ɛ z ɛ l øː tː
ezen	ɛ z ɛ n
ezt	ɛ s t
ezután	ɛ z u t aː n
ezzel	ɛ zː ɛ l
ezáltal	ɛ z aː l t ɒ l
ezért	ɛ z eː r t
ezúttal	ɛ z uː tː ɒ l
ezüstszürke	ɛ z y ʃ t s y r k ɛ
fa	f ɒ
fagylalt	f ɒ ɟ l ɒ l t
falakat	f ɒ l ɒ k ɒ t
falat	f ɒ l ɒ t
falusi	f ɒ l u ʃ i
fantázia	f ɒ n t aː z iʲ ɒ
farkas	f ɒ r k ɒ ʃ
fax	f ɒ k s
fazekas	f ɒ z ɛ k ɒ ʃ
februárban	f ɛ b r u aː r b ɒ n
fed	f ɛ d
fedett	f ɛ d ɛ tː
fehér	f ɛ ɦ eː r
fehérjét	f ɛ ɦ eː r j eː t
feje	f ɛ j ɛ
fejlemény	f ɛ j l ɛ m eː ɲ
fejlesztése	f ɛ j l ɛ s t eː ʃ ɛ
fejlesztési	f ɛ j l ɛ s t eː ʃ i
fejlesztésének	f ɛ j l ɛ s t eː ʃ eː n ɛ k
fejlődik	f ɛ j l øː d i k
fején	f ɛ j eː n
fejét	f ɛ j eː t
fekete	f ɛ k ɛ t ɛ
fekvő	f ɛ k v øː
feladat	f ɛ l ɒ d ɒ t
feladatok	f ɛ l ɒ d ɒ t o k
feladatokat	f ɛ l ɒ d ɒ t o k ɒ t
feladatot	f ɛ l ɒ d ɒ t o t
feladatra	f ɛ l ɒ d ɒ t r ɒ
felelős	f ɛ l ɛ l øː ʃ
felesleges	f ɛ l ɛ ʃ l ɛ ɡ ɛ ʃ
felesége	f ɛ l ɛ ʃ eː ɡ ɛ
feleséged	f ɛ l ɛ ʃ eː ɡ ɛ d
feletti	f ɛ l ɛ tː i
felhasználás	f ɛ l ɦ ɒ s n aː l aː ʃ
felhasználók	f ɛ l ɦ ɒ s n aː l oː k
felhasználókat	f ɛ l ɦ ɒ s n aː l oː k ɒ t
felhívni	f ɛ l ɦ iː v n i
felismerni	f ɛ l i ʃ m ɛ r n i
feljebb	f ɛ jː ɛ bː
felszínre	f ɛ l s iː n r ɛ
felsőoktatás	f ɛ l ʃ øː o k t ɒ t aː ʃ
feltárása	f ɛ l t aː r aː ʃ ɒ
feltétel	f ɛ l t eː t ɛ l
feltételes	f ɛ l t eː t ɛ l ɛ ʃ
feltüntetni	f ɛ l t y n t ɛ t n i
felvesz	f ɛ l v ɛ s
felváltva	f ɛ l v aː l t v ɒ
felvételi	f ɛ l v eː t ɛ l i
felé	f ɛ l eː
felében	f ɛ l eː b ɛ n
felének	f ɛ l eː n ɛ k
felére	f ɛ l eː r ɛ
felújítása	f ɛ l uː j iː t aː ʃ ɒ
felügyelő	f ɛ l y ɟ ɛ l øː
felül	f ɛ l y l
felület	f ɛ l y l ɛ t
felől	f ɛ l øː l
fennhangon	f ɛ n ɦ ɒ ŋ ɡ o n
fennsíkok	f ɛ n ʃ iː k o k
fentebb	f ɛ n t ɛ bː
ferenc	f ɛ r ɛ n t͡s
festmények	f ɛ ʃ t m eː ɲ ɛ k
festő	f ɛ ʃ t øː
feszült	f ɛ s y l t
feszültség	f ɛ s y l t͡ʃ eː ɡ
fiatal	f iʲ ɒ t ɒ l
fiatalok	f iʲ ɒ t ɒ l o k
fidesz	f i d ɛ s
fideszes	f i d ɛ s ɛ ʃ
figyelembe	f i ɟ ɛ l ɛ m b ɛ
figyelemmel	f i ɟ ɛ l ɛ mː ɛ l
figyelhet	f i ɟ ɛ l ɦ ɛ t
figyelik	f i ɟ ɛ l i k
figyelmet	f i ɟ ɛ l m ɛ t
figyelmeztetés	f i ɟ ɛ l m ɛ s t ɛ t eː ʃ
figyelmét	f i ɟ ɛ l m eː t
film	f i l m
filmben	f i l m b ɛ n
filmje	f i l m j ɛ
filozófiai	f i l o z oː f iʲ ɒʲ i
finn	f i nː
finom	f i n o m
fiuk	f iʲ u k
fix	f i k s
fizetnek	f i z ɛ t n ɛ k
fizetni	f i z ɛ t n i
fizikai	f i z i k ɒʲ i
fizikailag	f i z i k ɒʲ i l ɒ ɡ
fizikus	f i z i k u ʃ
fiú	f iʲ uː
fiúk	f iʲ uː k
foci	f o t͡s i
focista	f o t͡s i ʃ t ɒ
fodor	f o d o r
fog	f o ɡ
fogad	f o ɡ ɒ d
fogadják	f o ɡ ɒ ɟː aː k
fogadni	f o ɡ ɒ d n i
fogadott	f o ɡ ɒ d o tː
fogadta	f o ɡ ɒ tː ɒ
fogadó	f o ɡ ɒ d oː
fogalmaz	f o ɡ ɒ l m ɒ z
fogamzás	f o ɡ ɒ m z aː ʃ
fogja	f o ɡ j ɒ
fogjuk	f o ɡ j u k
fogják	f o ɡ j aː k
foglalja	f o ɡ l ɒ jː ɒ
foglalkozik	f o ɡ l ɒ l k o z i k
fogod	f o ɡ o d
fogorvosok	f o ɡ o r v o ʃ o k
fogva	f o ɡ v ɒ
fogyasztása	f o ɟ ɒ s t aː ʃ ɒ
fogyasztói	f o ɟ ɒ s t oːʲ i
fogyasztók	f o ɟ ɒ s t oː k
fogyatékosok	f o ɟ ɒ t eː k o ʃ o k
fok	f o k
fokon	f o k o n
fokoz	f o k o z
fokozott	f o k o z o tː
fokozottan	f o k o z o tː ɒ n
folyamat	f o j ɒ m ɒ t
folyamatban	f o j ɒ m ɒ d b ɒ n
folyamaton	f o j ɒ m ɒ t o n
folyamatos	f o j ɒ m ɒ t o ʃ
folyamatosan	f o j ɒ m ɒ t o ʃ ɒ n
folyamán	f o j ɒ m aː n
folyt	f o j t
folytatni	f o j t ɒ t n i
folytatódik	f o j t ɒ t oː d i k
folytonosan	f o j t o n o ʃ ɒ n
folyékony	f o j eː k o ɲ
folyóiratok	f o j oːʲ i r ɒ t o k
fontos	f o n t o ʃ
fontosnak	f o n t o ʃ n ɒ k
forduló	f o r d u l oː
fordulóban	f o r d u l oː b ɒ n
fordítva	f o r d iː t v ɒ
fordítás	f o r d iː t aː ʃ
forgalma	f o r ɡ ɒ l m ɒ
forgalmat	f o r ɡ ɒ l m ɒ t
forgalmazó	f o r ɡ ɒ l m ɒ z oː
forgó	f o r ɡ oː
forint	f o r i n t
forintot	f o r i n t o t
forintra	f o r i n t r ɒ
forinttal	f o r i n t ɒ l
forintért	f o r i n t eː r t
forma	f o r m ɒ
formula	f o r m u l ɒ
formában	f o r m aː b ɒ n
formájú	f o r m aː j uː
forradalmi	f o rː ɒ d ɒ l m i
forrás	f o rː aː ʃ
forrásokat	f o rː aː ʃ o k ɒ t
fotó	f o t oː
fotók	f o t oː k
fotót	f o t oː t
franciaország	f r ɒ n t͡s iʲ ɒ o r s aː ɡ
franciák	f r ɒ n t͡s iʲ aː k
friss	f r i ʃː
futballista	f u d b ɒ lː i ʃ t ɒ
futni	f u t n i
fáj	f aː j
fájdalmas	f aː j d ɒ l m ɒ ʃ
fájdalmat	f aː j d ɒ l m ɒ t
fájdalom	f aː j d ɒ l o m
fél	f eː l
félek	f eː l ɛ k
félidő	f eː l i d øː
félig	f eː l i ɡ
fém	f eː m
fényes	f eː ɲ ɛ ʃ
fényt	f eː ɲ t
férfi	f eː r f i
férfiak	f eː r f iʲ ɒ k
férjem	f eː r j ɛ m
föld	f ø l d
földet	f ø l d ɛ t
földrengés	f ø l d r ɛ ŋ ɡ eː ʃ
fölött	f ø l ø tː
független	f y ɡː ɛ t l ɛ n
függetlenül	f y ɡː ɛ t l ɛ n y l
függőlegesen	f y ɡː øː l ɛ ɡ ɛ ʃ ɛ n
fülig	f y l i ɡ
fürdőszoba	f y r d øː s o b ɒ
füzet	f y z ɛ t
fő	f øː
főbb	f øː bː
főiskola	f øːʲ i ʃ k o l ɒ
főleg	f øː l ɛ ɡ
főnév	f øː n eː v
fővárosi	f øː v aː r o ʃ i
gallyat	ɡ ɒ jː ɒ t
garanciát	ɡ ɒ r ɒ n t͡s iʲ aː t
garantált	ɡ ɒ r ɒ n t aː l t
gazda	ɡ ɒ z d ɒ
gazdag	ɡ ɒ z d ɒ ɡ
gazdagon	ɡ ɒ z d ɒ ɡ o n
gazdasági	ɡ ɒ z d ɒ ʃ aː ɡ i
gazdaságilag	ɡ ɒ z d ɒ ʃ aː ɡ i l ɒ ɡ
gazdálkodás	ɡ ɒ z d aː l k o d aː ʃ
geometriai	ɡ ɛ o m ɛ t r iʲ ɒʲ i
gergely	ɡ ɛ r ɡ ɛ j
gimnázium	ɡ i m n aː z iʲ u m
globális	ɡ l o b aː l i ʃ
gombák	ɡ o m b aː k
gondolatok	ɡ o n d o l ɒ t o k
gondolatokat	ɡ o n d o l ɒ t o k ɒ t
gondolatot	ɡ o n d o l ɒ t o t
gondoljuk	ɡ o n d o jː u k
gondolkodott	ɡ o n d o l k o d o tː
gondolok	ɡ o n d o l o k
gondolom	ɡ o n d o l o m
gondolsz	ɡ o n d o l s
gondos	ɡ o n d o ʃ
gondozottak	ɡ o n d o z o tː ɒ k
gonosz	ɡ o n o s
gramm	ɡ r ɒ mː
grammatikai	ɡ r ɒ m ɒ t i k ɒʲ i
granulátum	ɡ r ɒ n u l aː t u m
gusztáv	ɡ u s t aː v
gyakori	ɟ ɒ k o r i
gyakorlat	ɟ ɒ k o r l ɒ t
gyakorlati	ɟ ɒ k o r l ɒ t i
gyakorlatilag	ɟ ɒ k o r l ɒ t i l ɒ ɡ
gyakorlatok	ɟ ɒ k o r l ɒ t o k
gyakran	ɟ ɒ k r ɒ n
gyanúja	ɟ ɒ n uː j ɒ
gyengébb	ɟ ɛ ŋ ɡ eː bː
gyerek	ɟ ɛ r ɛ k
gyerekek	ɟ ɛ r ɛ k ɛ k
gyerekekkel	ɟ ɛ r ɛ k ɛ kː ɛ l
gyerekkel	ɟ ɛ r ɛ kː ɛ l
gyereknek	ɟ ɛ r ɛ k n ɛ k
gyilkos	ɟ i l k o ʃ
gyors	ɟ o r ʃ
gyorsak	ɟ o r ʃ ɒ k
gyorsan	ɟ o r ʃ ɒ n
gyula	ɟ u l ɒ
gyártó	ɟ aː r t oː
gyógyszer	ɟ oː c s ɛ r
gyógyítható	ɟ oː ɟ iː t h ɒ t oː
gyöngyház	ɟ ø ɲ c h aː z
gyönyörű	ɟ ø ɲ ø r yː
györgy	ɟ ø r ɟ
gyümölcstelen	ɟ y m ø l t͡ʃ t ɛ l ɛ n
győr	ɟ øː r
győri	ɟ øː r i
győzelem	ɟ øː z ɛ l ɛ m
gyűjtemény	ɟ yː j t ɛ m eː ɲ
gyűlölködő	ɟ yː l ø l k ø d øː
gép	ɡ eː p
gépe	ɡ eː p ɛ
gépek	ɡ eː p ɛ k
gépeken	ɡ eː p ɛ k ɛ n
gépkocsi	ɡ eː p k o t͡ʃ i
géppel	ɡ eː pː ɛ l
gój	ɡ oː j
gól	ɡ oː l
gólt	ɡ oː l t
gödör	ɡ ø d ø r
gördülékeny	ɡ ø r d y l eː k ɛ ɲ
görög	ɡ ø r ø ɡ
gőz	ɡ øː z
ha	h ɒ
hadnagy	h ɒ d n ɒ ɟ
hadsereg	h ɒ t ʃ ɛ r ɛ ɡ
hagyj	h ɒ ɟː
hagyja	h ɒ ɟː ɒ
hagyjuk	h ɒ ɟː u k
hagynak	h ɒ ɟ n ɒ k
hagynánk	h ɒ ɟ n aː ŋ k
hagyomány	h ɒ ɟ o m aː ɲ
hagyományos	h ɒ ɟ o m aː ɲ o ʃ
hajba	h ɒ j b ɒ
hajdani	h ɒ j d ɒ n i
hajhoz	h ɒ j ɦ o z
hajlandó	h ɒ j l ɒ n d oː
hajléktalanok	h ɒ j l eː k t ɒ l ɒ n o k
hajnal	h ɒ j n ɒ l
hajnalban	h ɒ j n ɒ l b ɒ n
hajrá	h ɒ j r aː
hajó	h ɒ j oː
hajóra	h ɒ j oː r ɒ
hajót	h ɒ j oː t
hajú	h ɒ j uː
halaid	h ɒ l ɒʲ i d
halból	h ɒ l b oː l
haljunk	h ɒ jː u ŋ k
hallgató	h ɒ l ɡ ɒ t oː
hallgatók	h ɒ l ɡ ɒ t oː k
hallom	h ɒ lː o m
hallunk	h ɒ lː u ŋ k
halnak	h ɒ l n ɒ k
halotti	h ɒ l o tː i
halvány	h ɒ l v aː ɲ
halála	h ɒ l aː l ɒ
halálos	h ɒ l aː l o ʃ
halálra	h ɒ l aː rː ɒ
halálát	h ɒ l aː l aː t
hamar	h ɒ m ɒ r
hamarabb	h ɒ m ɒ r ɒ bː
hamarosan	h ɒ m ɒ r o ʃ ɒ n
hamis	h ɒ m i ʃ
hamu	h ɒ m u
hanem	h ɒ n ɛ m
hangosan	h ɒ ŋ ɡ o ʃ ɒ n
hangsúlyozni	h ɒ ŋ k ʃ uː j o z n i
hangsúlyt	h ɒ ŋ k ʃ uː j t
hangulatú	h ɒ ŋ ɡ u l ɒ t uː
hangversenyek	h ɒ ŋ ɡ v ɛ r ʃ ɛ ɲ ɛ k
hanyatlás	h ɒ ɲ ɒ t l aː ʃ
harmadik	h ɒ r m ɒ d i k
hasból	h ɒ ʒ b oː l
hasonló	h ɒ ʃ o n l oː
hasonlóképpen	h ɒ ʃ o n l oː k eː pː ɛ n
hasonlóságok	h ɒ ʃ o n l oː ʃ aː ɡ o k
használ	h ɒ s n aː l
használatra	h ɒ s n aː l ɒ t r ɒ
használatát	h ɒ s n aː l ɒ t aː t
használja	h ɒ s n aː jː ɒ
használják	h ɒ s n aː jː aː k
használni	h ɒ s n aː l n i
használt	h ɒ s n aː l t
hat	h ɒ t
hatalmak	h ɒ t ɒ l m ɒ k
hatalmas	h ɒ t ɒ l m ɒ ʃ
hatalmat	h ɒ t ɒ l m ɒ t
hatalom	h ɒ t ɒ l o m
hatvan	h ɒ t v ɒ n
hatálya	h ɒ t aː j ɒ
hatályos	h ɒ t aː j o ʃ
határ	h ɒ t aː r
határokon	h ɒ t aː r o k o n
határon	h ɒ t aː r o n
határozatképes	h ɒ t aː r o z ɒ t k eː p ɛ ʃ
határozatot	h ɒ t aː r o z ɒ t o t
hatás	h ɒ t aː ʃ
hatásai	h ɒ t aː ʃ ɒʲ i
hatásait	h ɒ t aː ʃ ɒʲ i t
hatáskörébe	h ɒ t aː ʃ k ø r eː b ɛ
hatásokat	h ɒ t aː ʃ o k ɒ t
hatással	h ɒ t aː ʃː ɒ l
hatást	h ɒ t aː ʃ t
hatékony	h ɒ t eː k o ɲ
hatékonyan	h ɒ t eː k o ɲ ɒ n
hatóság	h ɒ t oː ʃ aː ɡ
hatósági	h ɒ t oː ʃ aː ɡ i
hatóságok	h ɒ t oː ʃ aː ɡ o k
havi	h ɒ v i
haza	h ɒ z ɒ
hazai	h ɒ z ɒʲ i
hazaiak	h ɒ z ɒʲ iʲ ɒ k
hazája	h ɒ z aː j ɒ
hazánk	h ɒ z aː ŋ k
hazánkban	h ɒ z aː ŋ ɡ b ɒ n
hegedűművész	h ɛ ɡ ɛ d yː m yː v eː s
hellyel	h ɛ jː ɛ l
helyben	h ɛ j b ɛ n
helye	h ɛ j ɛ
helyeken	h ɛ j ɛ k ɛ n
helyen	h ɛ j ɛ n
helyes	h ɛ j ɛ ʃ
helyesen	h ɛ j ɛ ʃ ɛ n
helyet	h ɛ j ɛ t
helyett	h ɛ j ɛ tː
helyezett	h ɛ j ɛ z ɛ tː
helyezik	h ɛ j ɛ z i k
helyezkedik	h ɛ j ɛ s k ɛ d i k
helyezni	h ɛ j ɛ z n i
helyi	h ɛ j i
helyre	h ɛ j r ɛ
helyszínek	h ɛ j s iː n ɛ k
helyszínen	h ɛ j s iː n ɛ n
helyszínre	h ɛ j s iː n r ɛ
helyzete	h ɛ j z ɛ t ɛ
helyzetének	h ɛ j z ɛ t eː n ɛ k
helyzetét	h ɛ j z ɛ t eː t
helyére	h ɛ j eː r ɛ
helyét	h ɛ j eː t
helyüket	h ɛ j y k ɛ t
henry	h ɛ n r i
hete	h ɛ t ɛ
hetet	h ɛ t ɛ t
hevesen	h ɛ v ɛ ʃ ɛ n
hiba	h i b ɒ
hibám	h i b aː m
hihetetlen	h i ɦ ɛ t ɛ t l ɛ n
hirdetés	h i r d ɛ t eː ʃ
hirtelen	h i r t ɛ l ɛ n
hisz	h i s
hiszem	h i s ɛ m
hiszen	h i s ɛ n
hiszik	h i s i k
hit	h i t
hivatal	h i v ɒ t ɒ l
hivatali	h i v ɒ t ɒ l i
hivatalok	h i v ɒ t ɒ l o k
hivatalos	h i v ɒ t ɒ l o ʃ
hivatkozik	h i v ɒ t k o z i k
hiány	h iʲ aː ɲ
hiánya	h iʲ aː ɲ ɒ
hiányosságok	h iʲ aː ɲ o ʃː aː ɡ o k
hiányzik	h iʲ aː ɲ z i k
hiányzó	h iʲ aː ɲ z oː
hiúság	h iʲ uː ʃ aː ɡ
hogy	h o ɟ
hogyha	h o c h ɒ
hol	h o l
holland	h o lː ɒ n d
holnapi	h o l n ɒ p i
homok	h o m o k
homályos	h o m aː j o ʃ
honnét	h o nː eː t
honvéd	h o ɱ v eː d
honvédelmi	h o ɱ v eː d ɛ l m i
hosszabb	h o sː ɒ bː
hosszú	h o sː uː
hosszútávú	h o sː uː t aː v uː
hozamok	h o z ɒ m o k
hozni	h o z n i
hozok	h o z o k
hozza	h o zː ɒ
hozzájuk	h o zː aː j u k
hozzám	h o zː aː m
hozzászólás	h o zː aː s oː l aː ʃ
hu	h u
hullámos	h u lː aː m o ʃ
huszonhat	h u s o n ɦ ɒ t
háborús	h aː b o r uː ʃ
hálózati	h aː l oː z ɒ t i
hálózatokon	h aː l oː z ɒ t o k o n
hálózatra	h aː l oː z ɒ t r ɒ
hány	h aː ɲ
három	h aː r o m
hátha	h aː t h ɒ
hátra	h aː t r ɒ
hátrányos	h aː t r aː ɲ o ʃ
hátterét	h aː tː ɛ r eː t
ház	h aː z
házak	h aː z ɒ k
házban	h aː z b ɒ n
házi	h aː z i
háztartások	h aː s t ɒ r t aː ʃ o k
hét	h eː t
héten	h eː t ɛ n
hétfő	h eː t f øː
hétfőn	h eː t f øː n
hétköznapok	h eː t k ø z n ɒ p o k
hétre	h eː t r ɛ
hétvégén	h eː t v eː ɡ eː n
hír	h iː r
híre	h iː r ɛ
hírek	h iː r ɛ k
híres	h iː r ɛ ʃ
hírlap	h iː r l ɒ p
hírt	h iː r t
híve	h iː v ɛ
híven	h iː v ɛ n
hó	h oː
hófehér	h oː f ɛ ɦ eː r
hónapjában	h oː n ɒ p j aː b ɒ n
hónapos	h oː n ɒ p o ʃ
hülye	h y j ɛ
hülyének	h y j eː n ɛ k
hőmérséklet	h øː m eː r ʃ eː k l ɛ t
hű	h yː
hűtlen	h yː t l ɛ n
hűvös	h yː v ø ʃ
hűvösebb	h yː v ø ʃ ɛ bː
ide	i d ɛ
idegen	i d ɛ ɡ ɛ n
idei	i d ɛʲ i
ideig	i d ɛʲ i ɡ
ideiglenes	i d ɛʲ i ɡ l ɛ n ɛ ʃ
ideje	i d ɛ j ɛ
idején	i d ɛ j eː n
ideális	i d ɛ aː l i ʃ
idén	i d eː n
idő	i d øː
időbe	i d øː b ɛ
időben	i d øː b ɛ n
időd	i d øː d
idők	i d øː k
időközben	i d øː k ø z b ɛ n
időn	i d øː n
időnként	i d øː ŋ k eː n t
időpontban	i d øː p o n d b ɒ n
időpontja	i d øː p o ɲ c ɒ
időre	i d øː r ɛ
idősebb	i d øː ʃ ɛ bː
idősek	i d øː ʃ ɛ k
időtartam	i d øː t ɒ r t ɒ m
ifjú	i f j uː
ifjúsági	i f j uː ʃ aː ɡ i
igaz	i ɡ ɒ z
igazam	i ɡ ɒ z ɒ m
igazat	i ɡ ɒ z ɒ t
igazgató	i ɡ ɒ z ɡ ɒ t oː
igazi	i ɡ ɒ z i
igazságok	i ɡ ɒ ʃː aː ɡ o k
igazságot	i ɡ ɒ ʃː aː ɡ o t
igen	i ɡ ɛ n
igenis	i ɡ ɛ n i ʃ
igent	i ɡ ɛ n t
igény	i ɡ eː ɲ
igénybe	i ɡ eː ɲ b ɛ
igényei	i ɡ eː ɲ ɛʲ i
igények	i ɡ eː ɲ ɛ k
igényeket	i ɡ eː ɲ ɛ k ɛ t
igényel	i ɡ eː ɲ ɛ l
igényt	i ɡ eː ɲ t
ildi	i l d i
illegális	i lː ɛ ɡ aː l i ʃ
illeszkedik	i lː ɛ s k ɛ d i k
illetve	i lː ɛ t v ɛ
illető	i lː ɛ t øː
illetőleg	i lː ɛ t øː l ɛ ɡ
ilona	i l o n ɒ
ilyen	i j ɛ n
ilyenek	i j ɛ n ɛ k
ilyenkor	i j ɛ ŋ k o r
ilyet	i j ɛ t
immár	i mː aː r
imre	i m r ɛ
index	i n d ɛ k s
indexei	i n d ɛ k s ɛʲ i
indexen	i n d ɛ k s ɛ n
indiai	i n d iʲ ɒʲ i
indián	i n d iʲ aː n
indul	i n d u l
indult	i n d u l t
indítványok	i n d iː t v aː ɲ o k
influenza	i ɱ f l u ɛ n z ɒ
infláció	i ɱ f l aː t͡s iʲ oː
információ	i ɱ f o r m aː t͡s iʲ oː
információt	i ɱ f o r m aː t͡s iʲ oː t
infrastruktúra	i ɱ f r ɒ ʃ t r u k t uː r ɒ
ingyenes	i ɲ ɟ ɛ n ɛ ʃ
ingyenesen	i ɲ ɟ ɛ n ɛ ʃ ɛ n
inkább	i ŋ k aː bː
internet	i n t ɛ r n ɛ t
interneten	i n t ɛ r n ɛ t ɛ n
internetes	i n t ɛ r n ɛ t ɛ ʃ
intézet	i n t eː z ɛ t
intézett	i n t eː z ɛ tː
inzulin	i n z u l i n
ipar	i p ɒ r
ipari	i p ɒ r i
iroda	i r o d ɒ
irodalmi	i r o d ɒ l m i
irodalom	i r o d ɒ l o m
irodája	i r o d aː j ɒ
irodák	i r o d aː k
iránt	i r aː n t
iránti	i r aː n t i
irány	i r aː ɲ
irányít	i r aː ɲ iː t
irányítja	i r aː ɲ iː cː ɒ
irányítás	i r aː ɲ iː t aː ʃ
irányú	i r aː ɲ uː
irén	i r eː n
is	i ʃ
iskola	i ʃ k o l ɒ
iskolai	i ʃ k o l ɒʲ i
iskolába	i ʃ k o l aː b ɒ
iskolában	i ʃ k o l aː b ɒ n
iskolák	i ʃ k o l aː k
iskolások	i ʃ k o l aː ʃ o k
ismeretterjesztő	i ʃ m ɛ r ɛ tː ɛ r j ɛ s t øː
ismeri	i ʃ m ɛ r i
ismerik	i ʃ m ɛ r i k
ismert	i ʃ m ɛ r t
ismerte	i ʃ m ɛ r t ɛ
ismertetett	i ʃ m ɛ r t ɛ t ɛ tː
ismerve	i ʃ m ɛ r v ɛ
ismét	i ʃ m eː t
ismétlődő	i ʃ m eː t l øː d øː
isten	i ʃ t ɛ n
istenben	i ʃ t ɛ m b ɛ n
istenem	i ʃ t ɛ n ɛ m
istentiszteletek	i ʃ t ɛ n t i s t ɛ l ɛ t ɛ k
istálló	i ʃ t aː lː oː
iszap	i s ɒ p
iszonyatos	i s o ɲ ɒ t o ʃ
iszonyatosan	i s o ɲ ɒ t o ʃ ɒ n
italok	i t ɒ l o k
itt	i tː
itten	i tː ɛ n
izgalmas	i z ɡ ɒ l m ɒ ʃ
jaj	j ɒ j
január	j ɒ n u aː r
januári	j ɒ n u aː r i
japán	j ɒ p aː n
japánban	j ɒ p aː m b ɒ n
japánok	j ɒ p aː n o k
javaslat	j ɒ v ɒ ʃ l ɒ t
javaslatára	j ɒ v ɒ ʃ l ɒ t aː r ɒ
javára	j ɒ v aː r ɒ
javítja	j ɒ v iː cː ɒ
javítás	j ɒ v iː t aː ʃ
jeges	j ɛ ɡ ɛ ʃ
jegy	j ɛ ɟ
jele	j ɛ l ɛ
jelei	j ɛ l ɛʲ i
jelen	j ɛ l ɛ n
jelenik	j ɛ l ɛ n i k
jelenleg	j ɛ l ɛ n l ɛ ɡ
jelenlegi	j ɛ l ɛ n l ɛ ɡ i
jelent	j ɛ l ɛ n t
jelenteni	j ɛ l ɛ n t ɛ n i
jelentette	j ɛ l ɛ n t ɛ tː ɛ
jelenti	j ɛ l ɛ n t i
jelentkeztek	j ɛ l ɛ n t k ɛ s t ɛ k
jelentése	j ɛ l ɛ n t eː ʃ ɛ
jelentősen	j ɛ l ɛ n t øː ʃ ɛ n
jelleget	j ɛ lː ɛ ɡ ɛ t
jellemzői	j ɛ lː ɛ m z øːʲ i
jelszó	j ɛ l s oː
jelzett	j ɛ l z ɛ tː
jelzés	j ɛ l z eː ʃ
jelöltek	j ɛ l ø l t ɛ k
jen	j ɛ n
jobb	j o bː
jobban	j o bː ɒ n
jobboldal	j o bː o l d ɒ l
jobbra	j o b r ɒ
jobbágyok	j o bː aː ɟ o k
jog	j o ɡ
joga	j o ɡ ɒ
joggal	j o ɡː ɒ l
jogok	j o ɡ o k
jogokat	j o ɡ o k ɒ t
jogosan	j o ɡ o ʃ ɒ n
jogszabályban	j o k s ɒ b aː j b ɒ n
jogú	j o ɡ uː
johnson	d͡ʒ o n z o n
jussanak	j u ʃː ɒ n ɒ k
jusson	j u ʃː o n
jutalom	j u t ɒ l o m
jutni	j u t n i
jutott	j u t o tː
jános	j aː n o ʃ
jár	j aː r
járat	j aː r ɒ t
járművet	j aː r m yː v ɛ t
járni	j aː r n i
járok	j aː r o k
járt	j aː r t
jártam	j aː r t ɒ m
járulék	j aː r u l eː k
járó	j aː r oː
járókelők	j aː r oː k ɛ l øː k
játszanak	j aː t͡sː ɒ n ɒ k
játszanának	j aː t͡sː ɒ n aː n ɒ k
játszma	j aː t͡s m ɒ
játszom	j aː t͡sː o m
játszott	j aː t͡sː o tː
játszottak	j aː t͡sː o tː ɒ k
játszottunk	j aː t͡sː o tː u ŋ k
játék	j aː t eː k
játékos	j aː t eː k o ʃ
játékot	j aː t eː k o t
játékvezető	j aː t eː k v ɛ z ɛ t øː
jégverés	j eː ɡ v ɛ r eː ʃ
jézus	j eː z u ʃ
jók	j oː k
jókat	j oː k ɒ t
jóléti	j oː l eː t i
jótékonysági	j oː t eː k o ɲ ʃ aː ɡ i
józsef	j oː ʒ ɛ f
jöhet	j ø ɦ ɛ t
jöjjön	j ø jː ø n
jönnek	j ø nː ɛ k
jönni	j ø nː i
jött	j ø tː
jöttek	j ø tː ɛ k
jövedelemadó	j ø v ɛ d ɛ l ɛ m ɒ d oː
jövőbeli	j ø v øː b ɛ l i
jövője	j ø v øː j ɛ
július	j uː l iʲ u ʃ
júliusban	j uː l iʲ u ʒ b ɒ n
június	j uː n iʲ u ʃ
kabinet	k ɒ b i n ɛ t
kalauz	k ɒ l ɒ u z
kamat	k ɒ m ɒ t
kanapé	k ɒ n ɒ p eː
kancák	k ɒ n t͡s aː k
kap	k ɒ p
kapacitása	k ɒ p ɒ t͡s i t aː ʃ ɒ
kapcsolata	k ɒ p t͡ʃ o l ɒ t ɒ
kapcsolatba	k ɒ p t͡ʃ o l ɒ d b ɒ
kapcsolatban	k ɒ p t͡ʃ o l ɒ d b ɒ n
kapcsolatok	k ɒ p t͡ʃ o l ɒ t o k
kapcsolatos	k ɒ p t͡ʃ o l ɒ t o ʃ
kapcsolatosan	k ɒ p t͡ʃ o l ɒ t o ʃ ɒ n
kapcsolatot	k ɒ p t͡ʃ o l ɒ t o t
kapcsolatra	k ɒ p t͡ʃ o l ɒ t r ɒ
kapcsolódik	k ɒ p t͡ʃ o l oː d i k
kapcsolódó	k ɒ p t͡ʃ o l oː d oː
kaphat	k ɒ p h ɒ t
kapható	k ɒ p h ɒ t oː
kapjuk	k ɒ p j u k
kapnak	k ɒ p n ɒ k
kapott	k ɒ p o tː
kaptak	k ɒ p t ɒ k
kapták	k ɒ p t aː k
karácsonyi	k ɒ r aː t͡ʃ o ɲ i
karán	k ɒ r aː n
kata	k ɒ t ɒ
katalán	k ɒ t ɒ l aː n
kategóriájú	k ɒ t ɛ ɡ oː r iʲ aː j uː
katolikus	k ɒ t o l i k u ʃ
katona	k ɒ t o n ɒ
katonai	k ɒ t o n ɒʲ i
katonák	k ɒ t o n aː k
katonákat	k ɒ t o n aː k ɒ t
katonát	k ɒ t o n aː t
keddi	k ɛ dː i
kedves	k ɛ d v ɛ ʃ
kedvesen	k ɛ d v ɛ ʃ ɛ n
kedvez	k ɛ d v ɛ z
kedvező	k ɛ d v ɛ z øː
kedvezőtlenebb	k ɛ d v ɛ z øː t l ɛ n ɛ bː
kedvéért	k ɛ d v eːʲ eː r t
kegyes	k ɛ ɟ ɛ ʃ
keleti	k ɛ l ɛ t i
keletre	k ɛ l ɛ t r ɛ
kellemes	k ɛ lː ɛ m ɛ ʃ
kellemetlen	k ɛ lː ɛ m ɛ t l ɛ n
kellene	k ɛ lː ɛ n ɛ
kellő	k ɛ lː øː
kelt	k ɛ l t
kelta	k ɛ l t ɒ
kemény	k ɛ m eː ɲ
keményen	k ɛ m eː ɲ ɛ n
kerek	k ɛ r ɛ k
keresed	k ɛ r ɛ ʃ ɛ d
keresik	k ɛ r ɛ ʃ i k
kereskedelem	k ɛ r ɛ ʃ k ɛ d ɛ l ɛ m
kereskedők	k ɛ r ɛ ʃ k ɛ d øː k
keresnek	k ɛ r ɛ ʃ n ɛ k
keresztek	k ɛ r ɛ s t ɛ k
keresztény	k ɛ r ɛ s t eː ɲ
keresztül	k ɛ r ɛ s t y l
keretek	k ɛ r ɛ t ɛ k
keretében	k ɛ r ɛ t eː b ɛ n
kerti	k ɛ r t i
került	k ɛ r y l t
kerülő	k ɛ r y l øː
ketten	k ɛ tː ɛ n
kettős	k ɛ tː øː ʃ
keveredik	k ɛ v ɛ r ɛ d i k
kevesebb	k ɛ v ɛ ʃ ɛ bː
kezdeményez	k ɛ z d ɛ m eː ɲ ɛ z
kezdetben	k ɛ z d ɛ d b ɛ n
kezdete	k ɛ z d ɛ t ɛ
kezdetektől	k ɛ z d ɛ t ɛ k t øː l
kezdetleges	k ɛ z d ɛ t l ɛ ɡ ɛ ʃ
kezdett	k ɛ z d ɛ tː
kezdte	k ɛ s t ɛ
kezdtem	k ɛ s t ɛ m
kezdték	k ɛ s t eː k
kezdve	k ɛ z d v ɛ
kezdő	k ɛ z d øː
kezdődik	k ɛ z d øː d i k
kezdődött	k ɛ z d øː d ø tː
kezelhető	k ɛ z ɛ l ɦ ɛ t øː
kezelésére	k ɛ z ɛ l eː ʃ eː r ɛ
kezelését	k ɛ z ɛ l eː ʃ eː t
kezelő	k ɛ z ɛ l øː
kezében	k ɛ z eː b ɛ n
kezére	k ɛ z eː r ɛ
kezét	k ɛ z eː t
ki	k i
kiadás	k iʲ ɒ d aː ʃ
kiadása	k iʲ ɒ d aː ʃ ɒ
kialakult	k iʲ ɒ l ɒ k u l t
kialakulása	k iʲ ɒ l ɒ k u l aː ʃ ɒ
kialakuló	k iʲ ɒ l ɒ k u l oː
kialakítása	k iʲ ɒ l ɒ k iː t aː ʃ ɒ
kicsi	k i t͡ʃ i
kicsik	k i t͡ʃ i k
kicsit	k i t͡ʃ i t
kiderül	k i d ɛ r y l
kiegyensúlyozott	k iʲ ɛ ɟ ɛ n ʃ uː j o z o tː
kiegészítő	k iʲ ɛ ɡ eː s iː t øː
kiejt	k iʲ ɛ j t
kiemelt	k iʲ ɛ m ɛ l t
kifizetni	k i f i z ɛ t n i
kifutó	k i f u t oː
kiinduló	k i i n d u l oː
kilenc	k i l ɛ n t͡s
kilencven	k i l ɛ n t͡s v ɛ n
kilométer	k i l o m eː t ɛ r
kilométeres	k i l o m eː t ɛ r ɛ ʃ
kilométerre	k i l o m eː t ɛ rː ɛ
kim	k i m
kinek	k i n ɛ k
királyi	k i r aː j i
kis	k i ʃ
kisebbségek	k i ʃː ɛ p ʃ eː ɡ ɛ k
kislány	k i ʃ l aː ɲ
kisváros	k i ʃ v aː r o ʃ
kiszámítani	k i s aː m iː t ɒ n i
kiterjedt	k i t ɛ r j ɛ tː
kitört	k i t ø r t
kitűzött	k i t yː z ø tː
kivitelben	k i v i t ɛ l b ɛ n
kivonulás	k i v o n u l aː ʃ
kiváló	k i v aː l oː
kivételével	k i v eː t ɛ l eː v ɛ l
kivéve	k i v eː v ɛ
kiállítása	k iʲ aː lː iː t aː ʃ ɒ
kiállításon	k iʲ aː lː iː t aː ʃ o n
kiállítást	k iʲ aː lː iː t aː ʃ t
klub	k l u bː
koalíció	k o ɒ l iː t͡s iʲ oː
kockázati	k o t͡s k aː z ɒ t i
kollektív	k o lː ɛ k t iː v
kolozsvári	k o l o ʒ v aː r i
kommunikációs	k o mː u n i k aː t͡s iʲ oː ʃ
kommunista	k o mː u n i ʃ t ɒ
komoly	k o m o j
komolyzene	k o m o j z ɛ n ɛ
koncepció	k o n t͡s ɛ p t͡s iʲ oː
koncertek	k o n t͡s ɛ r t ɛ k
konferencia	k o ɱ f ɛ r ɛ n t͡s iʲ ɒ
konferencián	k o ɱ f ɛ r ɛ n t͡s iʲ aː n
konfliktus	k o ɱ f l i k t u ʃ
kongresszus	k o ŋ ɡ r ɛ sː u ʃ
konkrét	k o ŋ k r eː t
konkrétan	k o ŋ k r eː t ɒ n
konzervatív	k o n z ɛ r v ɒ t iː v
konzol	k o n z o l
kopár	k o p aː r
kor	k o r
kora	k o r ɒ
korai	k o r ɒʲ i
korhadt	k o r ɦ ɒ tː
kormány	k o r m aː ɲ
kormányfő	k o r m aː ɲ f øː
kormányok	k o r m aː ɲ o k
kormányzat	k o r m aː ɲ z ɒ t
korszerű	k o r s ɛ r yː
korában	k o r aː b ɒ n
korábban	k o r aː bː ɒ n
korábbi	k o r aː bː i
korú	k o r uː
kossuth	k o ʃ u t
koszos	k o s o ʃ
krisztián	k r i s t iʲ aː n
kritika	k r i t i k ɒ
krónikus	k r oː n i k u ʃ
kuba	k u b ɒ
kulcscsont	k u l t͡ʃ o n t
kultúrája	k u l t uː r aː j ɒ
kuratórium	k u r ɒ t oː r iʲ u m
kuriózum	k u r iʲ oː z u m
károly	k aː r o j
kárt	k aː r t
kémiai	k eː m iʲ ɒʲ i
kényelmes	k eː ɲ ɛ l m ɛ ʃ
kényszer	k eː ɲ s ɛ r
kép	k eː p
képeket	k eː p ɛ k ɛ t
képekkel	k eː p ɛ kː ɛ l
képen	k eː p ɛ n
képes	k eː p ɛ ʃ
képesek	k eː p ɛ ʃ ɛ k
képest	k eː p ɛ ʃ t
képez	k eː p ɛ z
képre	k eː p r ɛ
képvisel	k eː p v i ʃ ɛ l
képviselő	k eː p v i ʃ ɛ l øː
képviselői	k eː p v i ʃ ɛ l øːʲ i
képviselője	k eː p v i ʃ ɛ l øː j ɛ
képviselőket	k eː p v i ʃ ɛ l øː k ɛ t
képzési	k eː b z eː ʃ i
kérd	k eː r d
kérdezte	k eː r d ɛ s t ɛ
kérdés	k eː r d eː ʃ
kérdéseire	k eː r d eː ʃ ɛʲ i r ɛ
kérdések	k eː r d eː ʃ ɛ k
kérdésekben	k eː r d eː ʃ ɛ ɡ b ɛ n
kérdéseket	k eː r d eː ʃ ɛ k ɛ t
kérdésekkel	k eː r d eː ʃ ɛ kː ɛ l
kérdéses	k eː r d eː ʃ ɛ ʃ
kérdésre	k eː r d eː ʃ r ɛ
kérdéssel	k eː r d eː ʃː ɛ l
kérdést	k eː r d eː ʃ t
kérdésében	k eː r d eː ʃ eː b ɛ n
kérdésére	k eː r d eː ʃ eː r ɛ
kérek	k eː r ɛ k
kérelmet	k eː r ɛ l m ɛ t
kérem	k eː r ɛ m
kérik	k eː r i k
kérjük	k eː r j y k
kérni	k eː r n i
kért	k eː r t
kérte	k eː r t ɛ
kérték	k eː r t eː k
kérve	k eː r v ɛ
kérés	k eː r eː ʃ
kész	k eː s
készen	k eː s ɛ n
készítene	k eː s iː t ɛ n ɛ
készített	k eː s iː t ɛ tː
készíti	k eː s iː t i
készítő	k eː s iː t øː
készül	k eː s y l
készült	k eː s y l t
készülő	k eː s y l øː
késő	k eː ʃ øː
későbbiekben	k eː ʃ øː bː iʲ ɛ ɡ b ɛ n
két	k eː t
kétmillió	k eː t m i l iʲ oː
kétszer	k eː t s ɛ r
kétségbeesett	k eː t͡ʃː eː ɡ b ɛ ɛ ʃ ɛ tː
kétséges	k eː t͡ʃː eː ɡ ɛ ʃ
kétségkívül	k eː t͡ʃː eː kː iː v y l
kétségtelen	k eː t͡ʃː eː k t ɛ l ɛ n
kétségtelenül	k eː t͡ʃː eː k t ɛ l ɛ n y l
kézi	k eː z i
kézigránát	k eː z i ɡ r aː n aː t
kéznél	k eː z n eː l
kézre	k eː z r ɛ
kézzel	k eː zː ɛ l
kína	k iː n ɒ
kínai	k iː n ɒʲ i
kísértés	k iː ʃ eː r t eː ʃ
kíváncsi	k iː v aː n t͡ʃ i
kíváncsiak	k iː v aː n t͡ʃ iʲ ɒ k
kívánhat	k iː v aː n ɦ ɒ t
kívánja	k iː v aː ɲː ɒ
kívánt	k iː v aː n t
kívánunk	k iː v aː n u ŋ k
kóla	k oː l ɒ
kórházi	k oː r ɦ aː z i
kórokozó	k oː r o k o z oː
ködös	k ø d ø ʃ
kölcsönösen	k ø l t͡ʃ ø n ø ʃ ɛ n
költemények	k ø l t ɛ m eː ɲ ɛ k
költség	k ø l t͡ʃ eː ɡ
költségek	k ø l t͡ʃ eː ɡ ɛ k
költséggel	k ø l t͡ʃ eː ɡː ɛ l
költségvetés	k ø l t͡ʃ eː ɡ v ɛ t eː ʃ
költségvetési	k ø l t͡ʃ eː ɡ v ɛ t eː ʃ i
költözik	k ø l t ø z i k
költő	k ø l t øː
könnyebb	k ø ɲː ɛ bː
könnyebben	k ø ɲː ɛ bː ɛ n
könnyen	k ø ɲː ɛ n
könnyű	k ø ɲː yː
könyv	k ø ɲ v
könyvben	k ø ɲ v b ɛ n
könyveket	k ø ɲ v ɛ k ɛ t
könyvtár	k ø ɲ f t aː r
könyvtári	k ø ɲ f t aː r i
környezetvédelem	k ø r ɲ ɛ z ɛ t v eː d ɛ l ɛ m
környezetvédelmi	k ø r ɲ ɛ z ɛ t v eː d ɛ l m i
környéke	k ø r ɲ eː k ɛ
környékén	k ø r ɲ eː k eː n
körzetben	k ø r z ɛ d b ɛ n
körében	k ø r eː b ɛ n
körül	k ø r y l
körülbelül	k ø r y l b ɛ l y l
körülményei	k ø r y l m eː ɲ ɛʲ i
körülmények	k ø r y l m eː ɲ ɛ k
körülményeket	k ø r y l m eː ɲ ɛ k ɛ t
körülötte	k ø r y l ø tː ɛ
körű	k ø r yː
köszönetet	k ø s ø n ɛ t ɛ t
köszönhető	k ø s ø n ɦ ɛ t øː
köszönhetően	k ø s ø n ɦ ɛ t øː ɛ n
köszönjük	k ø s ø ɲː y k
köteles	k ø t ɛ l ɛ ʃ
kötelesség	k ø t ɛ l ɛ ʃː eː ɡ
kötelessége	k ø t ɛ l ɛ ʃː eː ɡ ɛ
kötelezettség	k ø t ɛ l ɛ z ɛ t ʃ eː ɡ
kötelező	k ø t ɛ l ɛ z øː
kötni	k ø t n i
kötődő	k ø t øː d øː
követelmények	k ø v ɛ t ɛ l m eː ɲ ɛ k
következtetni	k ø v ɛ t k ɛ s t ɛ t n i
következtetésre	k ø v ɛ t k ɛ s t ɛ t eː ʃ r ɛ
következő	k ø v ɛ t k ɛ z øː
követően	k ø v ɛ t øː ɛ n
közalkalmazottak	k ø z ɒ l k ɒ l m ɒ z o tː ɒ k
közben	k ø z b ɛ n
közel	k ø z ɛ l
közelebb	k ø z ɛ l ɛ bː
közeljövőben	k ø z ɛ jː ø v øː b ɛ n
közelmúltban	k ø z ɛ l m uː l d b ɒ n
közelről	k ø z ɛ rː øː l
közelében	k ø z ɛ l eː b ɛ n
közepe	k ø z ɛ p ɛ
közepén	k ø z ɛ p eː n
közepére	k ø z ɛ p eː r ɛ
közgyűlés	k ø z ɟ yː l eː ʃ
közleményben	k ø z l ɛ m eː ɲ b ɛ n
közleménye	k ø z l ɛ m eː ɲ ɛ
közleményében	k ø z l ɛ m eː ɲ eː b ɛ n
központ	k ø s p o n t
központban	k ø s p o n d b ɒ n
központok	k ø s p o n t o k
központosított	k ø s p o n t o ʃ iː t o tː
közreműködő	k ø z r ɛ m yː k ø d øː
község	k ø ʃː eː ɡ
községben	k ø ʃː eː ɡ b ɛ n
közt	k ø s t
köztársasági	k ø s t aː r ʃ ɒ ʃ aː ɡ i
közvetlen	k ø z v ɛ t l ɛ n
közvetlenebb	k ø z v ɛ t l ɛ n ɛ bː
közvetlenül	k ø z v ɛ t l ɛ n y l
közéleti	k ø z eː l ɛ t i
középkori	k ø z eː p k o r i
középső	k ø z eː p ʃ øː
közérdekű	k ø z eː r d ɛ k yː
közölte	k ø z ø l t ɛ
közönség	k ø z ø n ʃ eː ɡ
közönségnek	k ø z ø n ʃ eː ɡ n ɛ k
közösség	k ø z ø ʃː eː ɡ
közösséget	k ø z ø ʃː eː ɡ ɛ t
közösségi	k ø z ø ʃː eː ɡ i
között	k ø z ø tː
közötti	k ø z ø tː i
közül	k ø z y l
küldi	k y l d i
küldött	k y l d ø tː
küldöttek	k y l d ø tː ɛ k
külföldön	k y l f ø l d ø n
külső	k y l ʃ øː
különbség	k y l ø m p ʃ eː ɡ
különböznek	k y l ø m b ø z n ɛ k
különböző	k y l ø m b ø z øː
különféle	k y l ø ɱ f eː l ɛ
különleges	k y l ø n l ɛ ɡ ɛ ʃ
különlegesen	k y l ø n l ɛ ɡ ɛ ʃ ɛ n
különös	k y l ø n ø ʃ
különösen	k y l ø n ø ʃ ɛ n
la	l ɒ
labdarúgó	l ɒ b d ɒ r uː ɡ oː
laboratórium	l ɒ b o r ɒ t oː r iʲ u m
lak	l ɒ k
lakosság	l ɒ k o ʃː aː ɡ
lakás	l ɒ k aː ʃ
lakásban	l ɒ k aː ʒ b ɒ n
lakások	l ɒ k aː ʃ o k
lakója	l ɒ k oː j ɒ
lakók	l ɒ k oː k
lap	l ɒ p
lapos	l ɒ p o ʃ
lapot	l ɒ p o t
lapunk	l ɒ p u ŋ k
lassabban	l ɒ ʃː ɒ bː ɒ n
lassan	l ɒ ʃː ɒ n
latin	l ɒ t i n
laza	l ɒ z ɒ
lecke	l ɛ t͡s k ɛ
legalacsonyabb	l ɛ ɡ ɒ l ɒ t͡ʃ o ɲ ɒ bː
legalábbis	l ɛ ɡ ɒ l aː bː i ʃ
legbecsesebb	l ɛ ɡ b ɛ t͡ʃ ɛ ʃ ɛ bː
legendás	l ɛ ɡ ɛ n d aː ʃ
legfeljebb	l ɛ k f ɛ jː ɛ bː
legfelső	l ɛ k f ɛ l ʃ øː
legfontosabb	l ɛ k f o n t o ʃ ɒ bː
legfőbb	l ɛ k f øː bː
legfőképpen	l ɛ k f øː k eː pː ɛ n
leggyorsabban	l ɛ ɡ ɟ o r ʃ ɒ bː ɒ n
leghíresebb	l ɛ k h iː r ɛ ʃ ɛ bː
legismertebb	l ɛ ɡ i ʃ m ɛ r t ɛ bː
legjelentősebb	l ɛ ɡ j ɛ l ɛ n t øː ʃ ɛ bː
legjobb	l ɛ ɡ j o bː
legjobban	l ɛ ɡ j o bː ɒ n
legkedvezőbb	l ɛ kː ɛ d v ɛ z øː bː
legkisebb	l ɛ kː i ʃː ɛ bː
legkésőbb	l ɛ kː eː ʃ øː bː
legközelebbi	l ɛ kː ø z ɛ l ɛ bː i
legmagasabb	l ɛ ɡ m ɒ ɡ ɒ ʃ ɒ bː
legnagyobb	l ɛ ɡ n ɒ ɟ o bː
legrégibb	l ɛ ɡ r eː ɡ i bː
legrövidebb	l ɛ ɡ r ø v i d ɛ bː
legszorosabb	l ɛ k s o r o ʃ ɒ bː
legtöbb	l ɛ k t ø bː
legtöbben	l ɛ k t ø bː ɛ n
legtöbbször	l ɛ k t ø p s ø r
legutóbb	l ɛ ɡ u t oː bː
legutóbbi	l ɛ ɡ u t oː bː i
legvonzóbb	l ɛ ɡ v o n z oː bː
legyen	l ɛ ɟ ɛ n
legérdekesebb	l ɛ ɡ eː r d ɛ k ɛ ʃ ɛ bː
lehel	l ɛ h ɛ l
lehessen	l ɛ h ɛ ʃː ɛ n
lehet	l ɛ h ɛ t
lehetetlen	l ɛ h ɛ t ɛ t l ɛ n
lehetetlenné	l ɛ h ɛ t ɛ t l ɛ nː eː
lehetett	l ɛ h ɛ t ɛ tː
lehetne	l ɛ h ɛ t n ɛ
lehetséges	l ɛ h ɛ t͡ʃː eː ɡ ɛ ʃ
lehetőleg	l ɛ h ɛ t øː l ɛ ɡ
lehetőség	l ɛ h ɛ t øː ʃ eː ɡ
lehetősége	l ɛ h ɛ t øː ʃ eː ɡ ɛ
lehetőségeinek	l ɛ h ɛ t øː ʃ eː ɡ ɛʲ i n ɛ k
lehetőségek	l ɛ h ɛ t øː ʃ eː ɡ ɛ k
lehetőségekkel	l ɛ h ɛ t øː ʃ eː ɡ ɛ kː ɛ l
lehetőséget	l ɛ h ɛ t øː ʃ eː ɡ ɛ t
lehetőségét	l ɛ h ɛ t øː ʃ eː ɡ eː t
lehetőségük	l ɛ h ɛ t øː ʃ eː ɡ y k
lehetővé	l ɛ h ɛ t øː v eː
lejjebb	l ɛ jː ɛ bː
lejár	l ɛ j aː r
leletek	l ɛ l ɛ t ɛ k
lelkes	l ɛ l k ɛ ʃ
lelki	l ɛ l k i
lelkész	l ɛ l k eː s
lelkét	l ɛ l k eː t
lemez	l ɛ m ɛ z
lemondott	l ɛ m o n d o tː
lengyelország	l ɛ ɲ ɟ ɛ l o r s aː ɡ
lenni	l ɛ nː i
lennie	l ɛ nː iʲ ɛ
lennének	l ɛ nː eː n ɛ k
lennünk	l ɛ nː y ŋ k
lent	l ɛ n t
lesz	l ɛ sː
leszek	l ɛ s ɛ k
lesznek	l ɛ s n ɛ k
leszünk	l ɛ s y ŋ k
lett	l ɛ tː
lettek	l ɛ tː ɛ k
lettem	l ɛ tː ɛ m
lettünk	l ɛ tː y ŋ k
levegő	l ɛ v ɛ ɡ øː
levegőben	l ɛ v ɛ ɡ øː b ɛ n
levente	l ɛ v ɛ n t ɛ
levél	l ɛ v eː l
levéltárak	l ɛ v eː l t aː r ɒ k
leírása	l ɛʲ iː r aː ʃ ɒ
liberális	l i b ɛ r aː l i ʃ
lista	l i ʃ t ɒ
listában	l i ʃ t aː b ɒ n
listáját	l i ʃ t aː j aː t
liszt	l i s t
londonban	l o n d o m b ɒ n
lovastusa	l o v ɒ ʃ t u ʃ ɒ
lába	l aː b ɒ
lábaik	l aː b ɒʲ i k
lábbal	l aː bː ɒ l
lábléc	l aː b l eː t͡s
lábát	l aː b aː t
lány	l aː ɲ
lánynak	l aː ɲ n ɒ k
lányok	l aː ɲ o k
lászló	l aː s l oː
lát	l aː t
látható	l aː t h ɒ t oː
látja	l aː cː ɒ
látjuk	l aː cː u k
látják	l aː cː aː k
látnunk	l aː t n u ŋ k
látogatható	l aː t o ɡ ɒ t h ɒ t oː
látogatók	l aː t o ɡ ɒ t oː k
látok	l aː t o k
látom	l aː t o m
látszik	l aː t͡sː i k
láttam	l aː tː ɒ m
láttuk	l aː tː u k
látásra	l aː t aː ʃ r ɒ
láz	l aː z
légitársaság	l eː ɡ i t aː r ʃ ɒ ʃ aː ɡ
lélek	l eː l ɛ k
lény	l eː ɲ
lényeg	l eː ɲ ɛ ɡ
lényeges	l eː ɲ ɛ ɡ ɛ ʃ
lényegesen	l eː ɲ ɛ ɡ ɛ ʃ ɛ n
lényegében	l eː ɲ ɛ ɡ eː b ɛ n
lények	l eː ɲ ɛ k
lép	l eː p
lépett	l eː p ɛ tː
lépni	l eː p n i
léptem	l eː p t ɛ m
léptünk	l eː p t y ŋ k
lépések	l eː p eː ʃ ɛ k
létesítmény	l eː t ɛ ʃ iː t m eː ɲ
létező	l eː t ɛ z øː
létre	l eː t r ɛ
létrehozását	l eː t r ɛ ɦ o z aː ʃ aː t
létét	l eː t eː t
lévő	l eː v øː
lövés	l ø v eː ʃ
ma	m ɒ
macskák	m ɒ t͡ʃ k aː k
madarak	m ɒ d ɒ r ɒ k
maga	m ɒ ɡ ɒ
magad	m ɒ ɡ ɒ d
magas	m ɒ ɡ ɒ ʃ
magasabb	m ɒ ɡ ɒ ʃ ɒ bː
magasra	m ɒ ɡ ɒ ʃ r ɒ
magatartása	m ɒ ɡ ɒ t ɒ r t aː ʃ ɒ
maguk	m ɒ ɡ u k
magunkat	m ɒ ɡ u ŋ k ɒ t
magunkkal	m ɒ ɡ u ŋ k ɒ l
magyarország	m ɒ ɟ ɒ r o r s aː ɡ
magyarországi	m ɒ ɟ ɒ r o r s aː ɡ i
magyarországon	m ɒ ɟ ɒ r o r s aː ɡ o n
magyarázata	m ɒ ɟ ɒ r aː z ɒ t ɒ
magyarázható	m ɒ ɟ ɒ r aː s h ɒ t oː
magában	m ɒ ɡ aː b ɒ n
magából	m ɒ ɡ aː b oː l
magánál	m ɒ ɡ aː n aː l
magát	m ɒ ɡ aː t
magával	m ɒ ɡ aː v ɒ l
mai	m ɒʲ i
majd	m ɒ j d
majdan	m ɒ j d ɒ n
majdnem	m ɒ j d n ɛ m
mandátumok	m ɒ n d aː t u m o k
mar	m ɒ r
marad	m ɒ r ɒ d
maradéktalan	m ɒ r ɒ d eː k t ɒ l ɒ n
marika	m ɒ r i k ɒ
marketing	m ɒ r k ɛ t i ŋ ɡ
masszív	m ɒ sː iː v
matuzsálem	m ɒ t u ʒ aː l ɛ m
meccset	m ɛ t͡ʃː ɛ t
meg	m ɛ ɡ
megadásával	m ɛ ɡ ɒ d aː ʃ aː v ɒ l
megalapozott	m ɛ ɡ ɒ l ɒ p o z o tː
megelőző	m ɛ ɡ ɛ l øː z øː
megfelel	m ɛ k f ɛ l ɛ l
megfelelő	m ɛ k f ɛ l ɛ l øː
megfelelően	m ɛ k f ɛ l ɛ l øː ɛ n
meghalt	m ɛ k h ɒ l t
meghatározni	m ɛ k h ɒ t aː r o z n i
meghatározó	m ɛ k h ɒ t aː r o z oː
megint	m ɛ ɡ i n t
megismerése	m ɛ ɡ i ʃ m ɛ r eː ʃ ɛ
megjegyezni	m ɛ ɡ j ɛ ɟ ɛ z n i
megjelent	m ɛ ɡ j ɛ l ɛ n t
megjelenés	m ɛ ɡ j ɛ l ɛ n eː ʃ
megjelenő	m ɛ ɡ j ɛ l ɛ n øː
meglepő	m ɛ ɡ l ɛ p øː
meglepően	m ɛ ɡ l ɛ p øː ɛ n
meglévő	m ɛ ɡ l eː v øː
megmarad	m ɛ ɡ m ɒ r ɒ d
megnyugtató	m ɛ ɡ ɲ u k t ɒ t oː
megnövekedett	m ɛ ɡ n ø v ɛ k ɛ d ɛ tː
megoldani	m ɛ ɡ o l d ɒ n i
megoldás	m ɛ ɡ o l d aː ʃ
megoldása	m ɛ ɡ o l d aː ʃ ɒ
megoldások	m ɛ ɡ o l d aː ʃ o k
megoldást	m ɛ ɡ o l d aː ʃ t
megoldására	m ɛ ɡ o l d aː ʃ aː r ɒ
megpróbálja	m ɛ k p r oː b aː jː ɒ
megszerzése	m ɛ k s ɛ r z eː ʃ ɛ
megszokott	m ɛ k s o k o tː
megszűnik	m ɛ k s yː n i k
megtalálható	m ɛ k t ɒ l aː l ɦ ɒ t oː
megtanul	m ɛ k t ɒ n u l
megtartása	m ɛ k t ɒ r t aː ʃ ɒ
megtesz	m ɛ k t ɛ s
megvalósuló	m ɛ ɡ v ɒ l oː ʃ u l oː
megvalósít	m ɛ ɡ v ɒ l oː ʃ iː t
megvalósítani	m ɛ ɡ v ɒ l oː ʃ iː t ɒ n i
megvalósítás	m ɛ ɡ v ɒ l oː ʃ iː t aː ʃ
megvan	m ɛ ɡ v ɒ n
megválasztása	m ɛ ɡ v aː l ɒ s t aː ʃ ɒ
megváltoztatni	m ɛ ɡ v aː l t o s t ɒ t n i
megy	m ɛ ɟ
megye	m ɛ ɟ ɛ
megyei	m ɛ ɟ ɛʲ i
megyében	m ɛ ɟ eː b ɛ n
megállapodás	m ɛ ɡ aː lː ɒ p o d aː ʃ
megállapodások	m ɛ ɡ aː lː ɒ p o d aː ʃ o k
megállapítás	m ɛ ɡ aː lː ɒ p iː t aː ʃ
megállít	m ɛ ɡ aː lː iː t
megérint	m ɛ ɡ eː r i n t
megértése	m ɛ ɡ eː r t eː ʃ ɛ
megértéséhez	m ɛ ɡ eː r t eː ʃ eː ɦ ɛ z
mekkora	m ɛ kː o r ɒ
mellett	m ɛ lː ɛ tː
mellette	m ɛ lː ɛ tː ɛ
mellettem	m ɛ lː ɛ tː ɛ m
mellyel	m ɛ jː ɛ l
mellé	m ɛ lː eː
mellékes	m ɛ lː eː k ɛ ʃ
melléklete	m ɛ lː eː k l ɛ t ɛ
mely	m ɛ j
melyek	m ɛ j ɛ k
melyeket	m ɛ j ɛ k ɛ t
melyik	m ɛ j i k
menekültek	m ɛ n ɛ k y l t ɛ k
menjen	m ɛ ɲː ɛ n
menjünk	m ɛ ɲː y ŋ k
mennek	m ɛ nː ɛ k
mennyi	m ɛ ɲː i
mennyire	m ɛ ɲː i r ɛ
mennyiség	m ɛ ɲː i ʃ eː ɡ
mennyisége	m ɛ ɲː i ʃ eː ɡ ɛ
mennyiségű	m ɛ ɲː i ʃ eː ɡ yː
mentek	m ɛ n t ɛ k
mentem	m ɛ n t ɛ m
menti	m ɛ n t i
mentél	m ɛ n t eː l
mentén	m ɛ n t eː n
mentő	m ɛ n t øː
mer	m ɛ r
merem	m ɛ r ɛ m
mertem	m ɛ r t ɛ m
mese	m ɛ ʃ ɛ
messze	m ɛ sː ɛ
mesterséges	m ɛ ʃ t ɛ r ʃ eː ɡ ɛ ʃ
mexikói	m ɛ k s i k oːʲ i
mezőgazdasági	m ɛ z øː ɡ ɒ z d ɒ ʃ aː ɡ i
mezők	m ɛ z øː k
mi	m i
miatt	m iʲ ɒ tː
micsoda	m i t͡ʃ o d ɒ
mielőbb	m iʲ ɛ l øː bː
mielőtt	m iʲ ɛ l øː tː
mikor	m i k o r
mikulás	m i k u l aː ʃ
milliárd	m i lː iʲ aː r d
milyen	m i j ɛ n
milyennek	m i j ɛ nː ɛ k
mindaddig	m i n d ɒ dː i ɡ
mindazoknak	m i n d ɒ z o k n ɒ k
mindegy	m i n d ɛ ɟː
minden	m i n d ɛ n
mindenekelőtt	m i n d ɛ n ɛ k ɛ l øː tː
mindenekként	m i n d ɛ n ɛ kː eː n t
mindenesetre	m i n d ɛ n ɛ ʃ ɛ t r ɛ
mindenféle	m i n d ɛ ɱ f eː l ɛ
mindenki	m i n d ɛ ŋ k i
mindenkinek	m i n d ɛ ŋ k i n ɛ k
mindenkinél	m i n d ɛ ŋ k i n eː l
mindenkire	m i n d ɛ ŋ k i r ɛ
mindenkit	m i n d ɛ ŋ k i t
mindenképpen	m i n d ɛ ŋ k eː pː ɛ n
mindennapok	m i n d ɛ nː ɒ p o k
mindennapos	m i n d ɛ nː ɒ p o ʃ
mindennél	m i n d ɛ nː eː l
mindenre	m i n d ɛ n r ɛ
mindez	m i n d ɛ z
mindezek	m i n d ɛ z ɛ k
mindig	m i n d i ɡ
mindjárt	m i ɲ ɟ aː r t
mindkét	m i n t k eː t
mindmáig	m i n d m aːʲ i ɡ
mindvégig	m i n d v eː ɡ i ɡ
mindössze	m i n d ø sː ɛ
miniszter	m i n i s t ɛ r
miniszterelnök	m i n i s t ɛ r ɛ l n ø k
minisztérium	m i n i s t eː r iʲ u m
minisztériumi	m i n i s t eː r iʲ u m i
minket	m i ŋ k ɛ t
mint	m i n t
minta	m i n t ɒ
mintája	m i n t aː j ɒ
minél	m i n eː l
minőségi	m i n øː ʃ eː ɡ i
minősítés	m i n øː ʃ iː t eː ʃ
mire	m i r ɛ
miről	m i r øː l
miskolci	m i ʃ k o l t͡s i
miután	m iʲ u t aː n
miért	m iʲ eː r t
mobil	m o b i l
modell	m o d ɛ lː
modellek	m o d ɛ lː ɛ k
modern	m o d ɛ r n
modul	m o d u l
molnár	m o l n aː r
mond	m o n d
mondani	m o n d ɒ n i
mondja	m o ɲ ɟ ɒ
mondom	m o n d o m
mondta	m o n t ɒ
mosogatógépek	m o ʃ o ɡ ɒ t oː ɡ eː p ɛ k
mosolyog	m o ʃ o j o ɡ
motort	m o t o r t
mozambiki	m o z ɒ m b i k i
mozog	m o z o ɡ
mszp	ɛ m ɛ s p eː
mta	ɛ m t eːʲ ɒ
mti	ɛ m t eːʲ i
munka	m u ŋ k ɒ
munkaerő	m u ŋ k ɒ ɛ r øː
munkanélküliek	m u ŋ k ɒ n eː l k y l iʲ ɛ k
munkanélküliség	m u ŋ k ɒ n eː l k y l i ʃ eː ɡ
munkavállaló	m u ŋ k ɒ v aː lː ɒ l oː
munkája	m u ŋ k aː j ɒ
munkájuk	m u ŋ k aː j u k
munkák	m u ŋ k aː k
munkáltatói	m u ŋ k aː l t ɒ t oːʲ i
munkám	m u ŋ k aː m
munkánk	m u ŋ k aː ŋ k
munkát	m u ŋ k aː t
mutat	m u t ɒ t
mutatkozik	m u t ɒ t k o z i k
mutató	m u t ɒ t oː
mutáció	m u t aː t͡s iʲ oː
mágnes	m aː ɡ n ɛ ʃ
májusi	m aː j u ʃ i
málta	m aː l t ɒ
mára	m aː r ɒ
márciusában	m aː r t͡s iʲ u ʃ aː b ɒ n
más	m aː ʃ
másfél	m aː ʃ f eː l
máshol	m aː ʃ h o l
másikat	m aː ʃ i k ɒ t
másikban	m aː ʃ i ɡ b ɒ n
másképp	m aː ʃ k eː pː
másodszor	m aː ʃ o t͡sː o r
mások	m aː ʃ o k
másrészt	m aː ʃ r eː s t
másról	m aː ʃ r oː l
mást	m aː ʃ t
máté	m aː t eː
média	m eː d iʲ ɒ
még	m eː ɡ
mégis	m eː ɡ i ʃ
mégsem	m eː k ʃ ɛ m
méltányos	m eː l t aː ɲ o ʃ
méltó	m eː l t oː
méltóság	m eː l t oː ʃ aː ɡ
mély	m eː j
mélyebb	m eː j ɛ bː
mélyen	m eː j ɛ n
méretű	m eː r ɛ t yː
mérgező	m eː r ɡ ɛ z øː
mérni	m eː r n i
mértékben	m eː r t eː ɡ b ɛ n
mértékű	m eː r t eː k yː
méz	m eː z
mézes	m eː z ɛ ʃ
míg	m iː ɡ
mód	m oː d
módja	m oː ɟː ɒ
módján	m oː ɟː aː n
módjával	m oː ɟː aː v ɒ l
módon	m oː d o n
módosítása	m oː d o ʃ iː t aː ʃ ɒ
módszere	m oː t s ɛ r ɛ
mór	m oː r
móres	m oː r ɛ ʃ
móricz	m oː r i t͡s
mögé	m ø ɡ eː
mögött	m ø ɡ ø tː
mögötte	m ø ɡ ø tː ɛ
múlva	m uː l v ɒ
müncheni	m y ɲ c h ɛ n i
mű	m yː
műholdas	m yː ɦ o l d ɒ ʃ
működik	m yː k ø d i k
működési	m yː k ø d eː ʃ i
működő	m yː k ø d øː
műsorvezető	m yː ʃ o r v ɛ z ɛ t øː
műszaki	m yː s ɒ k i
művelhető	m yː v ɛ l ɦ ɛ t øː
művészet	m yː v eː s ɛ t
művészeti	m yː v eː s ɛ t i
na	n ɒ
nagy	n ɒ ɟ
nagyobb	n ɒ ɟ o bː
nagyok	n ɒ ɟ o k
nagyon	n ɒ ɟ o n
nagyszerű	n ɒ c s ɛ r yː
nagysága	n ɒ c ʃ aː ɡ ɒ
napi	n ɒ p i
napközben	n ɒ p k ø z b ɛ n
naponta	n ɒ p o n t ɒ
nappal	n ɒ pː ɒ l
navigáció	n ɒ v i ɡ aː t͡s iʲ oː
navigációs	n ɒ v i ɡ aː t͡s iʲ oː ʃ
nb	ɛ m b eː
ne	n ɛ
negatív	n ɛ ɡ ɒ t iː v
negyed	n ɛ ɟ ɛ d
negyedik	n ɛ ɟ ɛ d i k
negyven	n ɛ ɟ v ɛ n
negyvenhatodik	n ɛ ɟ v ɛ n ɦ ɒ t o d i k
nehezebb	n ɛ h ɛ z ɛ bː
nehezebben	n ɛ h ɛ z ɛ bː ɛ n
nehezen	n ɛ h ɛ z ɛ n
nehéz	n ɛ ɦ eː z
nehézkes	n ɛ ɦ eː s k ɛ ʃ
nehézségek	n ɛ ɦ eː ʃː eː ɡ ɛ k
nekik	n ɛ k i k
nem	n ɛ m
nemcsak	n ɛ m t͡ʃ ɒ k
nemes	n ɛ m ɛ ʃ
nemrég	n ɛ m r eː ɡ
nemrégiben	n ɛ m r eː ɡ i b ɛ n
nemzet	n ɛ m z ɛ t
nemzeti	n ɛ m z ɛ t i
net	n ɛ t
nettó	n ɛ tː oː
nevek	n ɛ v ɛ k
neveket	n ɛ v ɛ k ɛ t
nevet	n ɛ v ɛ t
nevezetes	n ɛ v ɛ z ɛ t ɛ ʃ
nevezhető	n ɛ v ɛ s h ɛ t øː
nevezik	n ɛ v ɛ z i k
nevezés	n ɛ v ɛ z eː ʃ
nincs	n i n t͡ʃ
noha	n o ɦ ɒ
normatív	n o r m ɒ t iː v
normák	n o r m aː k
normális	n o r m aː l i ʃ
november	n o v ɛ m b ɛ r
novemberi	n o v ɛ m b ɛ r i
nulla	n u lː ɒ
nyalóka	ɲ ɒ l oː k ɒ
nyelv	ɲ ɛ l v
nyelven	ɲ ɛ l v ɛ n
nyelvtudás	ɲ ɛ l f t u d aː ʃ
nyelvű	ɲ ɛ l v yː
nyerni	ɲ ɛ r n i
nyert	ɲ ɛ r t
nyerte	ɲ ɛ r t ɛ
nyilas	ɲ i l ɒ ʃ
nyilatkozata	ɲ i l ɒ t k o z ɒ t ɒ
nyilatkozik	ɲ i l ɒ t k o z i k
nyilván	ɲ i l v aː n
nyilvánvalóan	ɲ i l v aː ɱ v ɒ l oː ɒ n
nyilvánvalóvá	ɲ i l v aː ɱ v ɒ l oː v aː
nyitott	ɲ i t o tː
nyitány	ɲ i t aː ɲ
nyitó	ɲ i t oː
nyolc	ɲ o l t͡s
nyolcadik	ɲ o l t͡s ɒ d i k
nyolcezer	ɲ o l t͡s ɛ z ɛ r
nyomozás	ɲ o m o z aː ʃ
nyomozást	ɲ o m o z aː ʃ t
nyomozóiroda	ɲ o m o z oːʲ i r o d ɒ
nyugati	ɲ u ɡ ɒ t i
nyugdíjas	ɲ u ɡ d iː j ɒ ʃ
nyugodt	ɲ u ɡ o tː
nyári	ɲ aː r i
nyáron	ɲ aː r o n
nyílik	ɲ iː l i k
nyílt	ɲ iː l t
nyíregyházi	ɲ iː r ɛ c h aː z i
nyújtunk	ɲ uː j t u ŋ k
négy	n eː ɟ
néha	n eː ɦ ɒ
néhol	n eː ɦ o l
nélkülözhetetlen	n eː l k y l ø s h ɛ t ɛ t l ɛ n
németország	n eː m ɛ t o r s aː ɡ
népek	n eː p ɛ k
népességnövekedés	n eː p ɛ ʃː eː ɡ n ø v ɛ k ɛ d eː ʃ
népi	n eː p i
néprajzi	n eː p r ɒ j z i
népszavazás	n eː p s ɒ v ɒ z aː ʃ
néptánc	n eː p t aː n t͡s
névvel	n eː vː ɛ l
néz	n eː z
nézd	n eː z d
nézi	n eː z i
néző	n eː z øː
nézők	n eː z øː k
növekedés	n ø v ɛ k ɛ d eː ʃ
növekedése	n ø v ɛ k ɛ d eː ʃ ɛ
növekedési	n ø v ɛ k ɛ d eː ʃ i
növekszik	n ø v ɛ k s i k
növelése	n ø v ɛ l eː ʃ ɛ
növelését	n ø v ɛ l eː ʃ eː t
növény	n ø v eː ɲ
növényi	n ø v eː ɲ i
nő	n øː
nőhet	n øː ɦ ɛ t
női	n øːʲ i
nőstény	n øː ʃ t eː ɲ
nővérek	n øː v eː r ɛ k
oda	o d ɒ
oka	o k ɒ
okai	o k ɒʲ i
okos	o k o ʃ
okosabb	o k o ʃ ɒ bː
okoz	o k o z
oktatási	o k t ɒ t aː ʃ i
október	o k t oː b ɛ r
okán	o k aː n
olaj	o l ɒ j
olasz	o l ɒ s
olcsó	o l t͡ʃ oː
olcsóbban	o l t͡ʃ oː bː ɒ n
oldal	o l d ɒ l
oldalainkat	o l d ɒ l ɒʲ i ŋ k ɒ t
oldalak	o l d ɒ l ɒ k
oldalakat	o l d ɒ l ɒ k ɒ t
oldalon	o l d ɒ l o n
oldalról	o l d ɒ rː oː l
oldalán	o l d ɒ l aː n
oldani	o l d ɒ n i
oldat	o l d ɒ t
olvashat	o l v ɒ ʃ h ɒ t
olvasmány	o l v ɒ ʃ m aː ɲ
olvasni	o l v ɒ ʃ n i
olvassa	o l v ɒ ʃː ɒ
olvasta	o l v ɒ ʃ t ɒ
olvastam	o l v ɒ ʃ t ɒ m
oly	o j
olyan	o j ɒ n
olykor	o j k o r
online	o n l aː j n
orbán	o r b aː n
orosz	o r o s
oroszok	o r o s o k
oroszország	o r o s o r s aː ɡ
orsolya	o r ʃ o j ɒ
ország	o r s aː ɡ
országban	o r s aː ɡ b ɒ n
országok	o r s aː ɡ o k
országokat	o r s aː ɡ o k ɒ t
országokban	o r s aː ɡ o ɡ b ɒ n
országos	o r s aː ɡ o ʃ
országot	o r s aː ɡ o t
orvos	o r v o ʃ
orvosi	o r v o ʃ i
osztanak	o s t ɒ n ɒ k
osztályú	o s t aː j uː
osztó	o s t oː
ott	o tː
otthon	o t h o n
otthonában	o t h o n aː b ɒ n
pajzsok	p ɒ j ʒ o k
pakisztán	p ɒ k i s t aː n
paks	p ɒ k ʃ
paksi	p ɒ k ʃ i
palesztin	p ɒ l ɛ s t i n
paletta	p ɒ l ɛ tː ɒ
papírok	p ɒ p iː r o k
parasztok	p ɒ r ɒ s t o k
parlament	p ɒ r l ɒ m ɛ n t
parlamentben	p ɒ r l ɒ m ɛ n d b ɛ n
parlamenti	p ɒ r l ɒ m ɛ n t i
parti	p ɒ r t i
partnereink	p ɒ r t n ɛ r ɛʲ i ŋ k
pedagógiai	p ɛ d ɒ ɡ oː ɡ iʲ ɒʲ i
pedagógus	p ɛ d ɒ ɡ oː ɡ u ʃ
pedagógusok	p ɛ d ɒ ɡ oː ɡ u ʃ o k
pedig	p ɛ d i ɡ
per	p ɛ r
perc	p ɛ r t͡s
perce	p ɛ r t͡s ɛ
perces	p ɛ r t͡s ɛ ʃ
percre	p ɛ r t͡s r ɛ
pere	p ɛ r ɛ
perek	p ɛ r ɛ k
persze	p ɛ r s ɛ
perzsák	p ɛ r ʒ aː k
pest	p ɛ ʃ t
piacvezető	p iʲ ɒ t͡s v ɛ z ɛ t øː
pierre	p iʲ ɛ r
pillanatban	p i lː ɒ n ɒ d b ɒ n
pillanatot	p i lː ɒ n ɒ t o t
piros	p i r o ʃ
pletyka	p l ɛ c k ɒ
pláza	p l aː z ɒ
plébániák	p l eː b aː n iʲ aː k
plébános	p l eː b aː n o ʃ
pofonok	p o f o n o k
polgári	p o l ɡ aː r i
polgármester	p o l ɡ aː r m ɛ ʃ t ɛ r
polgármestere	p o l ɡ aː r m ɛ ʃ t ɛ r ɛ
polgármesteri	p o l ɡ aː r m ɛ ʃ t ɛ r i
polgárok	p o l ɡ aː r o k
politika	p o l i t i k ɒ
politikai	p o l i t i k ɒʲ i
politikus	p o l i t i k u ʃ
pompás	p o m p aː ʃ
pont	p o n t
pontos	p o n t o ʃ
pontosabban	p o n t o ʃ ɒ bː ɒ n
pontosan	p o n t o ʃ ɒ n
pontot	p o n t o t
porszívó	p o r s iː v oː
portál	p o r t aː l
pozitív	p o z i t iː v
pozitívan	p o z i t iː v ɒ n
pozíciója	p o z iː t͡s iʲ oː j ɒ
pozíciók	p o z iː t͡s iʲ oː k
precíz	p r ɛ t͡s iː z
premier	p r ɛ m iʲ ɛ r
privilegizált	p r i v i l ɛ ɡ i z aː l t
privát	p r i v aː t
problémám	p r o b l eː m aː m
problémás	p r o b l eː m aː ʃ
professzionális	p r o f ɛ sː iʲ o n aː l i ʃ
program	p r o ɡ r ɒ m
programból	p r o ɡ r ɒ m b oː l
programja	p r o ɡ r ɒ m j ɒ
programjai	p r o ɡ r ɒ m j ɒʲ i
programjának	p r o ɡ r ɒ m j aː n ɒ k
programját	p r o ɡ r ɒ m j aː t
programokkal	p r o ɡ r ɒ m o kː ɒ l
programokra	p r o ɡ r ɒ m o k r ɒ
programon	p r o ɡ r ɒ m o n
prostitúció	p r o ʃ t i t uː t͡s iʲ oː
protokoll	p r o t o k o lː
próbál	p r oː b aː l
próbálkozás	p r oː b aː l k o z aː ʃ
próbára	p r oː b aː r ɒ
pszichológus	p s i ɦ o l oː ɡ u ʃ
puszil	p u s i l
puszta	p u s t ɒ
pusztán	p u s t aː n
pál	p aː l
pálya	p aː j ɒ
pályán	p aː j aː n
pályára	p aː j aː r ɒ
pályát	p aː j aː t
pályázat	p aː j aː z ɒ t
pályázati	p aː j aː z ɒ t i
pályázatok	p aː j aː z ɒ t o k
pályázik	p aː j aː z i k
pályázó	p aː j aː z oː
pápa	p aː p ɒ
pár	p aː r
párhuzamosan	p aː r ɦ u z ɒ m o ʃ ɒ n
pártelnök	p aː r t ɛ l n ø k
pártja	p aː r c ɒ
pártok	p aː r t o k
páva	p aː v ɒ
pécs	p eː t͡ʃ
példa	p eː l d ɒ
példányt	p eː l d aː ɲ t
például	p eː l d aː u l
péntek	p eː n t ɛ k
pénteken	p eː n t ɛ k ɛ n
pénz	p eː n z
pénzt	p eː n s t
pénzügyminiszter	p eː n z y ɟ m i n i s t ɛ r
péter	p eː t ɛ r
radikálisan	r ɒ d i k aː l i ʃ ɒ n
rangú	r ɒ ŋ ɡ uː
recepción	r ɛ t͡s ɛ p t͡s iʲ oː n
reform	r ɛ f o r m
református	r ɛ f o r m aː t u ʃ
reformátusok	r ɛ f o r m aː t u ʃ o k
reggeli	r ɛ ɡː ɛ l i
reggelivel	r ɛ ɡː ɛ l i v ɛ l
regionális	r ɛ ɡ iʲ o n aː l i ʃ
rejtett	r ɛ j t ɛ tː
rekesz	r ɛ k ɛ s
remek	r ɛ m ɛ k
remete	r ɛ m ɛ t ɛ
remélem	r ɛ m eː l ɛ m
remélhetőleg	r ɛ m eː l ɦ ɛ t øː l ɛ ɡ
reméljük	r ɛ m eː jː y k
remények	r ɛ m eː ɲ ɛ k
reményeket	r ɛ m eː ɲ ɛ k ɛ t
rend	r ɛ n d
rendben	r ɛ n d b ɛ n
rendelkezik	r ɛ n d ɛ l k ɛ z i k
rendelkeznek	r ɛ n d ɛ l k ɛ z n ɛ k
rendelkezés	r ɛ n d ɛ l k ɛ z eː ʃ
rendelkezésre	r ɛ n d ɛ l k ɛ z eː ʃ r ɛ
rendet	r ɛ n d ɛ t
rendez	r ɛ n d ɛ z
rendezni	r ɛ n d ɛ z n i
rendezvények	r ɛ n d ɛ z v eː ɲ ɛ k
rendezvényen	r ɛ n d ɛ z v eː ɲ ɛ n
rendezvénysorozat	r ɛ n d ɛ z v eː ɲ ʃ o r o z ɒ t
rendező	r ɛ n d ɛ z øː
rendezők	r ɛ n d ɛ z øː k
rendi	r ɛ n d i
rendkívül	r ɛ n t k iː v y l
rendkívüli	r ɛ n t k iː v y l i
rendszer	r ɛ n t s ɛ r
rendszerbe	r ɛ n t s ɛ r b ɛ
rendszerben	r ɛ n t s ɛ r b ɛ n
rendszerek	r ɛ n t s ɛ r ɛ k
rendszeresen	r ɛ n t s ɛ r ɛ ʃ ɛ n
rendszerhez	r ɛ n t s ɛ r ɦ ɛ z
rendszerrel	r ɛ n t s ɛ rː ɛ l
rendszerről	r ɛ n t s ɛ rː øː l
rendőr	r ɛ n d øː r
rendőrség	r ɛ n d øː r ʃ eː ɡ
rengeteg	r ɛ ŋ ɡ ɛ t ɛ ɡ
repülnek	r ɛ p y l n ɛ k
repülőgépek	r ɛ p y l øː ɡ eː p ɛ k
repülőtér	r ɛ p y l øː t eː r
rettenetes	r ɛ tː ɛ n ɛ t ɛ ʃ
reális	r ɛ aː l i ʃ
rideg	r i d ɛ ɡ
ridegebb	r i d ɛ ɡ ɛ bː
ritkán	r i t k aː n
robbanás	r o bː ɒ n aː ʃ
rokonaik	r o k o n ɒʲ i k
roland	r o l ɒ n d
roma	r o m ɒ
romantikus	r o m ɒ n t i k u ʃ
rombusz	r o m b u s
romlott	r o m l o tː
romok	r o m o k
román	r o m aː n
románia	r o m aː n iʲ ɒ
rozmaring	r o z m ɒ r i ŋ ɡ
ruhákat	r u ɦ aː k ɒ t
ruházat	r u ɦ aː z ɒ t
rá	r aː
rád	r aː d
rádió	r aː d iʲ oː
rádióban	r aː d iʲ oː b ɒ n
rádiót	r aː d iʲ oː t
rájuk	r aː j u k
rákóczi	r aː k oː t͡s i
ránk	r aː ŋ k
rég	r eː ɡ
régió	r eː ɡ iʲ oː
régóta	r eː ɡ oː t ɒ
rémület	r eː m y l ɛ t
része	r eː s ɛ
részeit	r eː s ɛʲ i t
részesedése	r eː s ɛ ʃ ɛ d eː ʃ ɛ
részletei	r eː s l ɛ t ɛʲ i
részletes	r eː s l ɛ t ɛ ʃ
részletesebben	r eː s l ɛ t ɛ ʃ ɛ bː ɛ n
részvétele	r eː s v eː t ɛ l ɛ
részvételével	r eː s v eː t ɛ l eː v ɛ l
részén	r eː s eː n
részére	r eː s eː r ɛ
részét	r eː s eː t
részüket	r eː s y k ɛ t
réti	r eː t i
révén	r eː v eː n
rímel	r iː m ɛ l
róla	r oː l ɒ
rólam	r oː l ɒ m
rövid	r ø v i d
rövidebb	r ø v i d ɛ bː
rövidesen	r ø v i d ɛ ʃ ɛ n
rúd	r uː d
sajnos	ʃ ɒ j n o ʃ
sajnálom	ʃ ɒ j n aː l o m
sajtó	ʃ ɒ j t oː
sajtótájékoztatóján	ʃ ɒ j t oː t aː j eː k o s t ɒ t oː j aː n
saját	ʃ ɒ j aː t
sajátos	ʃ ɒ j aː t o ʃ
sarka	ʃ ɒ r k ɒ
sarkára	ʃ ɒ r k aː r ɒ
se	ʃ ɛ
sebészeti	ʃ ɛ b eː s ɛ t i
segíteni	ʃ ɛ ɡ iː t ɛ n i
segíti	ʃ ɛ ɡ iː t i
segítséget	ʃ ɛ ɡ iː t͡ʃː eː ɡ ɛ t
segítségét	ʃ ɛ ɡ iː t͡ʃː eː ɡ eː t
segítségével	ʃ ɛ ɡ iː t͡ʃː eː ɡ eː v ɛ l
sejt	ʃ ɛ j t
sejtmag	ʃ ɛ j t m ɒ ɡ
sem	ʃ ɛ m
semmi	ʃ ɛ mː i
semmibe	ʃ ɛ mː i b ɛ
semmilyen	ʃ ɛ mː i j ɛ n
semmire	ʃ ɛ mː i r ɛ
semmit	ʃ ɛ mː i t
senki	ʃ ɛ ŋ k i
sereg	ʃ ɛ r ɛ ɡ
sikerre	ʃ i k ɛ rː ɛ
sikerrel	ʃ i k ɛ rː ɛ l
sikert	ʃ i k ɛ r t
sikerét	ʃ i k ɛ r eː t
sikerül	ʃ i k ɛ r y l
sikerült	ʃ i k ɛ r y l t
sima	ʃ i m ɒ
siófok	ʃ iʲ oː f o k
sms	ɛ ʃ ɛ m ɛ ʃ
soha	ʃ o ɦ ɒ
sok	ʃ o k
sokadik	ʃ o k ɒ d i k
sokak	ʃ o k ɒ k
sokakban	ʃ o k ɒ ɡ b ɒ n
sokan	ʃ o k ɒ n
sokat	ʃ o k ɒ t
sokkal	ʃ o kː ɒ l
sokszor	ʃ o k s o r
sokáig	ʃ o k aːʲ i ɡ
sor	ʃ o r
sorban	ʃ o r b ɒ n
soron	ʃ o r o n
soros	ʃ o r o ʃ
sorozat	ʃ o r o z ɒ t
sorozatban	ʃ o r o z ɒ d b ɒ n
sorozatot	ʃ o r o z ɒ t o t
sorra	ʃ o rː ɒ
sors	ʃ o r ʃ
sorsuk	ʃ o r ʃ u k
sorába	ʃ o r aː b ɒ
során	ʃ o r aː n
sosem	ʃ o ʃ ɛ m
speciális	ʃ p ɛ t͡s iʲ aː l i ʃ
spontán	ʃ p o n t aː n
sport	ʃ p o r t
sportág	ʃ p o r t aː ɡ
srácok	ʃ r aː t͡s o k
stabil	ʃ t ɒ b i l
stagnál	ʃ t ɒ ɡ n aː l
stratégia	ʃ t r ɒ t eː ɡ iʲ ɒ
stratégiai	ʃ t r ɒ t eː ɡ iʲ ɒʲ i
sugall	ʃ u ɡ ɒ lː
sugárzó	ʃ u ɡ aː r z oː
svájci	ʃ v aː j t͡s i
svéd	ʃ v eː d
svédország	ʃ v eː d o r s aː ɡ
sz	ɛ s
szabad	s ɒ b ɒ d
szabadban	s ɒ b ɒ d b ɒ n
szabadságot	s ɒ b ɒ t͡ʃː aː ɡ o t
szabadul	s ɒ b ɒ d u l
szabályai	s ɒ b aː j ɒʲ i
szabályok	s ɒ b aː j o k
szabályozás	s ɒ b aː j o z aː ʃ
szabályozási	s ɒ b aː j o z aː ʃ i
szabályozó	s ɒ b aː j o z oː
szabályzat	s ɒ b aː j z ɒ t
szabó	s ɒ b oː
szak	s ɒ k
szakdolgozat	s ɒ ɡ d o l ɡ o z ɒ t
szakemberek	s ɒ k ɛ m b ɛ r ɛ k
szakképzési	s ɒ kː eː b z eː ʃ i
szakmai	s ɒ k m ɒʲ i
szakszervezeti	s ɒ k s ɛ r v ɛ z ɛ t i
szakértő	s ɒ k eː r t øː
szalag	s ɒ l ɒ ɡ
szavak	s ɒ v ɒ k
szavazatot	s ɒ v ɒ z ɒ t o t
szavazattal	s ɒ v ɒ z ɒ tː ɒ l
szavazni	s ɒ v ɒ z n i
szavazás	s ɒ v ɒ z aː ʃ
szavazó	s ɒ v ɒ z oː
szdsz	ɛ z d eːʲ ɛ s
szecesszió	s ɛ t͡s ɛ sː iʲ oː
szegedi	s ɛ ɡ ɛ d i
szegény	s ɛ ɡ eː ɲ
szegények	s ɛ ɡ eː ɲ ɛ k
szeles	s ɛ l ɛ ʃ
szelet	s ɛ l ɛ t
szelleme	s ɛ lː ɛ m ɛ
szellemei	s ɛ lː ɛ m ɛʲ i
szellemes	s ɛ lː ɛ m ɛ ʃ
szellemi	s ɛ lː ɛ m i
szem	s ɛ m
szemben	s ɛ m b ɛ n
szemet	s ɛ m ɛ t
szempontból	s ɛ m p o n d b oː l
szempontok	s ɛ m p o n t o k
személy	s ɛ m eː j
személyek	s ɛ m eː j ɛ k
személyekre	s ɛ m eː j ɛ k r ɛ
személyesen	s ɛ m eː j ɛ ʃ ɛ n
személygépkocsi	s ɛ m eː j ɡ eː p k o t͡ʃ i
szemüveges	s ɛ m y v ɛ ɡ ɛ ʃ
szent	s ɛ n t
szentimentális	s ɛ n t i m ɛ n t aː l i ʃ
szentség	s ɛ n t͡ʃ eː ɡ
szeptember	s ɛ p t ɛ m b ɛ r
szeptemberi	s ɛ p t ɛ m b ɛ r i
szerb	s ɛ r b
szerdai	s ɛ r d ɒʲ i
szerdán	s ɛ r d aː n
szerelem	s ɛ r ɛ l ɛ m
szerelmet	s ɛ r ɛ l m ɛ t
szerelmi	s ɛ r ɛ l m i
szerencse	s ɛ r ɛ n t͡ʃ ɛ
szerencsére	s ɛ r ɛ n t͡ʃ eː r ɛ
szerencsétlen	s ɛ r ɛ n t͡ʃ eː t l ɛ n
szerepel	s ɛ r ɛ p ɛ l
szerepet	s ɛ r ɛ p ɛ t
szereplő	s ɛ r ɛ p l øː
szeretem	s ɛ r ɛ t ɛ m
szeretet	s ɛ r ɛ t ɛ t
szeretete	s ɛ r ɛ t ɛ t ɛ
szeretettel	s ɛ r ɛ t ɛ tː ɛ l
szeretné	s ɛ r ɛ t n eː
szeretnéd	s ɛ r ɛ t n eː d
szeretnék	s ɛ r ɛ t n eː k
szeretnének	s ɛ r ɛ t n eː n ɛ k
szeretnénk	s ɛ r ɛ t n eː ŋ k
szerettem	s ɛ r ɛ tː ɛ m
szerezni	s ɛ r ɛ z n i
szerint	s ɛ r i n t
szerinte	s ɛ r i n t ɛ
szerinti	s ɛ r i n t i
szerintük	s ɛ r i n t y k
szerkezete	s ɛ r k ɛ z ɛ t ɛ
szerkezeti	s ɛ r k ɛ z ɛ t i
szert	s ɛ r t
szerves	s ɛ r v ɛ ʃ
szervezet	s ɛ r v ɛ z ɛ t
szervezetek	s ɛ r v ɛ z ɛ t ɛ k
szervezetként	s ɛ r v ɛ z ɛ t k eː n t
szervezetnél	s ɛ r v ɛ z ɛ t n eː l
szervezett	s ɛ r v ɛ z ɛ tː
szervezők	s ɛ r v ɛ z øː k
szerzett	s ɛ r z ɛ tː
szerző	s ɛ r z øː
szerződés	s ɛ r z øː d eː ʃ
szerződést	s ɛ r z øː d eː ʃ t
szezon	s ɛ z o n
sziget	s i ɡ ɛ t
szigetek	s i ɡ ɛ t ɛ k
szigorú	s i ɡ o r uː
szigorúan	s i ɡ o r uː ɒ n
szimbólumok	s i m b oː l u m o k
szimpatikus	s i m p ɒ t i k u ʃ
szimpla	s i m p l ɒ
szint	s i n t
szinte	s i n t ɛ
szinten	s i n t ɛ n
szintet	s i n t ɛ t
szintetikus	s i n t ɛ t i k u ʃ
szintjén	s i ɲ c eː n
szintre	s i n t r ɛ
szintén	s i n t eː n
szlovák	s l o v aː k
szobor	s o b o r
szobába	s o b aː b ɒ
szociológus	s o t͡s iʲ o l oː ɡ u ʃ
szoktam	s o k t ɒ m
szokványos	s o k v aː ɲ o ʃ
szokásos	s o k aː ʃ o ʃ
szolgálni	s o l ɡ aː l n i
szolgáltatás	s o l ɡ aː l t ɒ t aː ʃ
szolgáltatások	s o l ɡ aː l t ɒ t aː ʃ o k
szolgáltatást	s o l ɡ aː l t ɒ t aː ʃ t
szolgáltatását	s o l ɡ aː l t ɒ t aː ʃ aː t
szolgáltató	s o l ɡ aː l t ɒ t oː
szolgáló	s o l ɡ aː l oː
szombathely	s o m b ɒ t h ɛ j
szombati	s o m b ɒ t i
szombaton	s o m b ɒ t o n
szorgalom	s o r ɡ ɒ l o m
szoros	s o r o ʃ
szorosan	s o r o ʃ ɒ n
szorul	s o r u l
szovjet	s o v j ɛ t
szovjetunió	s o v j ɛ t u n iʲ oː
szál	s aː l
szállhat	s aː l ɦ ɒ t
szálló	s aː lː oː
szám	s aː m
száma	s aː m ɒ
számban	s aː m b ɒ n
számlát	s aː m l aː t
számolnak	s aː m o l n ɒ k
számomra	s aː m o m r ɒ
számos	s aː m o ʃ
számukra	s aː m u k r ɒ
számunkra	s aː m u ŋ k r ɒ
számában	s aː m aː b ɒ n
számára	s aː m aː r ɒ
számítani	s aː m iː t ɒ n i
számítógéppel	s aː m iː t oː ɡ eː pː ɛ l
számú	s aː m uː
száraz	s aː r ɒ z
száz	s aː z
század	s aː z ɒ d
században	s aː z ɒ d b ɒ n
századi	s aː z ɒ d i
százados	s aː z ɒ d o ʃ
századtól	s aː z ɒ tː oː l
százaléka	s aː z ɒ l eː k ɒ
százalékos	s aː z ɒ l eː k o ʃ
százalékában	s aː z ɒ l eː k aː b ɒ n
százalékát	s aː z ɒ l eː k aː t
székhelyű	s eː k h ɛ j yː
szélső	s eː l ʃ øː
szélsőséges	s eː l ʃ øː ʃ eː ɡ ɛ ʃ
szélén	s eː l eː n
szép	s eː p
szépen	s eː p ɛ n
szét	s eː t
színház	s i n ɦ aː z
színpadán	s iː m p ɒ d aː n
szíved	s iː v ɛ d
szívesen	s iː v ɛ ʃ ɛ n
szívinfarktus	s iː v i ɱ f ɒ r k t u ʃ
szívvel	s iː vː ɛ l
szó	s oː
szóba	s oː b ɒ
szóbeli	s oː b ɛ l i
szókincs	s oː k i n t͡ʃ
szól	s oː l
szóló	s oː l oː
szórakoztató	s oː r ɒ k o s t ɒ t oː
szót	s oː t
szóval	s oː v ɒ l
szökőár	s ø k øː aː r
szövetkezet	s ø v ɛ t k ɛ z ɛ t
szövetség	s ø v ɛ t͡ʃː eː ɡ
szövetsége	s ø v ɛ t͡ʃː eː ɡ ɛ
szövetségek	s ø v ɛ t͡ʃː eː ɡ ɛ k
szükség	s y k ʃ eː ɡ
szüksége	s y k ʃ eː ɡ ɛ
szükséges	s y k ʃ eː ɡ ɛ ʃ
szükségesnek	s y k ʃ eː ɡ ɛ ʃ n ɛ k
szükségünk	s y k ʃ eː ɡ y ŋ k
szülei	s y l ɛʲ i
született	s y l ɛ t ɛ tː
születési	s y l ɛ t eː ʃ i
születésű	s y l ɛ t eː ʃ yː
szünetben	s y n ɛ d b ɛ n
szürke	s y r k ɛ
szűkös	s yː k ø ʃ
szűnik	s yː n i k
sárga	ʃ aː r ɡ ɒ
sárgaság	ʃ aː r ɡ ɒ ʃ aː ɡ
sértett	ʃ eː r t ɛ tː
sérült	ʃ eː r y l t
sétáló	ʃ eː t aː l oː
sétálók	ʃ eː t aː l oː k
síelők	ʃ iːʲ ɛ l øː k
sírok	ʃ iː r o k
só	ʃ oː
sós	ʃ oː ʃ
sör	ʃ ø r
sötét	ʃ ø t eː t
sötétség	ʃ ø t eː t͡ʃː eː ɡ
súlygyarapodás	ʃ uː j ɟ ɒ r ɒ p o d aː ʃ
súlyos	ʃ uː j o ʃ
súlyosabb	ʃ uː j o ʃ ɒ bː
súlyt	ʃ uː j t
süllyed	ʃ y jː ɛ d
sütő	ʃ y t øː
sőt	ʃ øː t
tagadhatatlan	t ɒ ɡ ɒ t h ɒ t ɒ t l ɒ n
tagja	t ɒ ɡ j ɒ
tagjai	t ɒ ɡ j ɒʲ i
tagját	t ɒ ɡ j aː t
tagot	t ɒ ɡ o t
talál	t ɒ l aː l
található	t ɒ l aː l ɦ ɒ t oː
találhatók	t ɒ l aː l ɦ ɒ t oː k
találja	t ɒ l aː jː ɒ
találmány	t ɒ l aː l m aː ɲ
találnak	t ɒ l aː l n ɒ k
találtam	t ɒ l aː l t ɒ m
találták	t ɒ l aː l t aː k
talán	t ɒ l aː n
tamás	t ɒ m aː ʃ
tanszék	t ɒ n s eː k
tantárgyak	t ɒ n t aː r ɟ ɒ k
tanulmány	t ɒ n u l m aː ɲ
tanulmányait	t ɒ n u l m aː ɲ ɒʲ i t
tanulmányi	t ɒ n u l m aː ɲ i
tanulni	t ɒ n u l n i
tanács	t ɒ n aː t͡ʃ
tanácsok	t ɒ n aː t͡ʃ o k
tanácsot	t ɒ n aː t͡ʃ o t
tanácstól	t ɒ n aː t͡ʃ t oː l
tanár	t ɒ n aː r
tanárok	t ɒ n aː r o k
tanítási	t ɒ n iː t aː ʃ i
tanóra	t ɒ n oː r ɒ
tapasztalt	t ɒ p ɒ s t ɒ l t
tapasztaltabb	t ɒ p ɒ s t ɒ l t ɒ bː
tapintat	t ɒ p i n t ɒ t
tar	t ɒ r
tartalmak	t ɒ r t ɒ l m ɒ k
tartalmaz	t ɒ r t ɒ l m ɒ z
tartalmazza	t ɒ r t ɒ l m ɒ zː ɒ
tartalmazó	t ɒ r t ɒ l m ɒ z oː
tartalmi	t ɒ r t ɒ l m i
tartalom	t ɒ r t ɒ l o m
tarthatatlan	t ɒ r t h ɒ t ɒ t l ɒ n
tartja	t ɒ r c ɒ
tartják	t ɒ r c aː k
tartotta	t ɒ r t o tː ɒ
tartozik	t ɒ r t o z i k
tartozó	t ɒ r t o z oː
tartó	t ɒ r t oː
tartózkodó	t ɒ r t oː s k o d oː
tavaly	t ɒ v ɒ j
tavalyi	t ɒ v ɒ j i
taxi	t ɒ k s i
tb	t eː b eː
te	t ɛ
technikai	t ɛ x n i k ɒʲ i
technológiai	t ɛ x n o l oː ɡ iʲ ɒʲ i
tegnap	t ɛ ɡ n ɒ p
tegnapi	t ɛ ɡ n ɒ p i
tegyünk	t ɛ ɟ y ŋ k
tehet	t ɛ h ɛ t
tehetséges	t ɛ h ɛ t͡ʃː eː ɡ ɛ ʃ
tehették	t ɛ h ɛ tː eː k
tekercsek	t ɛ k ɛ r t͡ʃ ɛ k
tekint	t ɛ k i n t
tekintetben	t ɛ k i n t ɛ d b ɛ n
tekintettel	t ɛ k i n t ɛ tː ɛ l
tekintetében	t ɛ k i n t ɛ t eː b ɛ n
tekinthető	t ɛ k i n t h ɛ t øː
telefon	t ɛ l ɛ f o n
telefonszámon	t ɛ l ɛ f o n s aː m o n
televízió	t ɛ l ɛ v iː z iʲ oː
teli	t ɛ l i
teljes	t ɛ jː ɛ ʃ
teljesebb	t ɛ jː ɛ ʃ ɛ bː
teljesen	t ɛ jː ɛ ʃ ɛ n
teljesítménnyel	t ɛ jː ɛ ʃ iː t m eː ɲː ɛ l
teljesítmények	t ɛ jː ɛ ʃ iː t m eː ɲ ɛ k
telt	t ɛ l t
temet	t ɛ m ɛ t
tengeren	t ɛ ŋ ɡ ɛ r ɛ n
tengeri	t ɛ ŋ ɡ ɛ r i
teniszpályák	t ɛ n i s p aː j aː k
tennie	t ɛ nː iʲ ɛ
tennivaló	t ɛ nː i v ɒ l oː
terek	t ɛ r ɛ k
terem	t ɛ r ɛ m
terjed	t ɛ r j ɛ d
termelő	t ɛ r m ɛ l øː
termet	t ɛ r m ɛ t
termék	t ɛ r m eː k
terméke	t ɛ r m eː k ɛ
termékek	t ɛ r m eː k ɛ k
természet	t ɛ r m eː s ɛ t
természetes	t ɛ r m eː s ɛ t ɛ ʃ
természetesen	t ɛ r m eː s ɛ t ɛ ʃ ɛ n
természeti	t ɛ r m eː s ɛ t i
terv	t ɛ r v
tervei	t ɛ r v ɛʲ i
terveik	t ɛ r v ɛʲ i k
tervek	t ɛ r v ɛ k
tervet	t ɛ r v ɛ t
tervez	t ɛ r v ɛ z
tervezet	t ɛ r v ɛ z ɛ t
tervezett	t ɛ r v ɛ z ɛ tː
tervezési	t ɛ r v ɛ z eː ʃ i
tervezők	t ɛ r v ɛ z øː k
terén	t ɛ r eː n
területe	t ɛ r y l ɛ t ɛ
területén	t ɛ r y l ɛ t eː n
területének	t ɛ r y l ɛ t eː n ɛ k
területéről	t ɛ r y l ɛ t eː r øː l
tesszük	t ɛ sː y k
testét	t ɛ ʃ t eː t
testületi	t ɛ ʃ t y l ɛ t i
teszi	t ɛ s i
teszik	t ɛ s i k
tesznek	t ɛ s n ɛ k
tetszett	t ɛ t͡sː ɛ tː
tetszik	t ɛ t͡sː i k
tett	t ɛ tː
tette	t ɛ tː ɛ
tettei	t ɛ tː ɛʲ i
tetteik	t ɛ tː ɛʲ i k
tettek	t ɛ tː ɛ k
tetten	t ɛ tː ɛ n
tevékenység	t ɛ v eː k ɛ ɲ ʃ eː ɡ
tevékenységek	t ɛ v eː k ɛ ɲ ʃ eː ɡ ɛ k
tevékenységét	t ɛ v eː k ɛ ɲ ʃ eː ɡ eː t
ti	t i
tilalom	t i l ɒ l o m
tilos	t i l o ʃ
tiltakozik	t i l t ɒ k o z i k
tisztelt	t i s t ɛ l t
tisztázatlan	t i s t aː z ɒ t l ɒ n
titeket	t i t ɛ k ɛ t
titkos	t i t k o ʃ
tizenhat	t i z ɛ n ɦ ɒ t
tompaszög	t o m p ɒ s ø ɡ
torony	t o r o ɲ
tovább	t o v aː bː
továbbá	t o v aː bː aː
tradicionálisan	t r ɒ d i t͡s iʲ o n aː l i ʃ ɒ n
tragédia	t r ɒ ɡ eː d iʲ ɒ
tudat	t u d ɒ t
tudjon	t u ɟː o n
tudjunk	t u ɟː u ŋ k
tudják	t u ɟː aː k
tudjátok	t u ɟː aː t o k
tudni	t u d n i
tudnunk	t u d n u ŋ k
tudná	t u d n aː
tudnák	t u d n aː k
tudnának	t u d n aː n ɒ k
tudod	t u d o d
tudom	t u d o m
tudomásul	t u d o m aː ʃ u l
tudott	t u d o tː
tudta	t u tː ɒ
tudtak	t u tː ɒ k
tudtuk	t u tː u k
tudunk	t u d u ŋ k
tudását	t u d aː ʃ aː t
tulajdonban	t u l ɒ j d o m b ɒ n
tulajdonképpen	t u l ɒ j d o ŋ k eː pː ɛ n
tulajdonos	t u l ɒ j d o n o ʃ
tulajdonosok	t u l ɒ j d o n o ʃ o k
turizmus	t u r i z m u ʃ
turul	t u r u l
tábla	t aː b l ɒ
tábor	t aː b o r
tág	t aː ɡ
tájat	t aː j ɒ t
tájékoztatási	t aː j eː k o s t ɒ t aː ʃ i
tájékoztatást	t aː j eː k o s t ɒ t aː ʃ t
támadás	t aː m ɒ d aː ʃ
támadások	t aː m ɒ d aː ʃ o k
támadásokat	t aː m ɒ d aː ʃ o k ɒ t
támadó	t aː m ɒ d oː
támogatás	t aː m o ɡ ɒ t aː ʃ
támogatásokra	t aː m o ɡ ɒ t aː ʃ o k r ɒ
táncolni	t aː n t͡s o l n i
tárgyában	t aː r ɟ aː b ɒ n
tárhely	t aː r ɦ ɛ j
tárlat	t aː r l ɒ t
társa	t aː r ʃ ɒ
társadalmi	t aː r ʃ ɒ d ɒ l m i
társaság	t aː r ʃ ɒ ʃ aː ɡ
társaságot	t aː r ʃ ɒ ʃ aː ɡ o t
tárul	t aː r u l
távlatok	t aː v l ɒ t o k
távol	t aː v o l
távoli	t aː v o l i
távozik	t aː v o z i k
távú	t aː v uː
tél	t eː l
télen	t eː l ɛ n
téli	t eː l i
téma	t eː m ɒ
témakörök	t eː m ɒ k ø r ø k
témája	t eː m aː j ɒ
témájú	t eː m aː j uː
témákat	t eː m aː k ɒ t
témán	t eː m aː n
témát	t eː m aː t
témával	t eː m aː v ɒ l
tény	t eː ɲ
tényeket	t eː ɲ ɛ k ɛ t
tényező	t eː ɲ ɛ z øː
tényleg	t eː ɲ l ɛ ɡ
tényleges	t eː ɲ l ɛ ɡ ɛ ʃ
tényt	t eː ɲ t
térben	t eː r b ɛ n
térdig	t eː r d i ɡ
térre	t eː rː ɛ
térség	t eː r ʃ eː ɡ
tételek	t eː t ɛ l ɛ k
téve	t eː v ɛ
tévében	t eː v eː b ɛ n
típusok	t iː p u ʃ o k
tíz	t iː z
több	t ø bː
többek	t ø bː ɛ k
többen	t ø bː ɛ n
többet	t ø bː ɛ t
többféle	t ø p f eː l ɛ
többre	t ø b r ɛ
többször	t ø p s ø r
többszörös	t ø p s ø r ø ʃ
többszörösen	t ø p s ø r ø ʃ ɛ n
többség	t ø p ʃ eː ɡ
többsége	t ø p ʃ eː ɡ ɛ
többé	t ø bː eː
tökéletes	t ø k eː l ɛ t ɛ ʃ
tökéletesen	t ø k eː l ɛ t ɛ ʃ ɛ n
tölgy	t ø l ɟ
töltőtoll	t ø l t øː t o lː
tömeges	t ø m ɛ ɡ ɛ ʃ
történelem	t ø r t eː n ɛ l ɛ m
történelmi	t ø r t eː n ɛ l m i
története	t ø r t eː n ɛ t ɛ
történt	t ø r t eː n t
történő	t ø r t eː n øː
törvény	t ø r v eː ɲ
törvényben	t ø r v eː ɲ b ɛ n
törvények	t ø r v eː ɲ ɛ k
törvényjavaslat	t ø r v eː ɲ j ɒ v ɒ ʃ l ɒ t
törvénykönyv	t ø r v eː ɲ k ø ɲ v
törvényt	t ø r v eː ɲ t
törékeny	t ø r eː k ɛ ɲ
túl	t uː l
túlságosan	t uː l ʃ aː ɡ o ʃ ɒ n
túra	t uː r ɒ
túsz	t uː s
tükre	t y k r ɛ
tükrözi	t y k r ø z i
tünetmentes	t y n ɛ t m ɛ n t ɛ ʃ
türelmes	t y r ɛ l m ɛ ʃ
tüzet	t y z ɛ t
tőkét	t øː k eː t
tőle	t øː l ɛ
tőlem	t øː l ɛ m
tőzsde	t øː ʒ d ɛ
tőzsdei	t øː ʒ d ɛʲ i
tűnik	t yː n i k
tűnt	t yː n t
tűz	t yː z
udvar	u d v ɒ r
ugró	u ɡ r oː
ugyan	u ɟ ɒ n
ugyanakkor	u ɟ ɒ n ɒ kː o r
ugyanaz	u ɟ ɒ n ɒ z
ugyanazt	u ɟ ɒ n ɒ s t
ugyancsak	u ɟ ɒ n t͡ʃ ɒ k
ugyanebben	u ɟ ɒ n ɛ bː ɛ n
ugyanez	u ɟ ɒ n ɛ z
ugyanilyen	u ɟ ɒ n i j ɛ n
ugyanis	u ɟ ɒ n i ʃ
ugyanolyan	u ɟ ɒ n o j ɒ n
ugyanúgy	u ɟ ɒ n uː ɟ
ugyebár	u ɟ ɛ b aː r
ukrán	u k r aː n
unió	uː n iʲ oː
uniós	uː n iʲ oː ʃ
uralkodik	u r ɒ l k o d i k
urát	u r aː t
utak	u t ɒ k
utakon	u t ɒ k o n
utakra	u t ɒ k r ɒ
utal	u t ɒ l
utalt	u t ɒ l t
utaló	u t ɒ l oː
utas	u t ɒ ʃ
utazás	u t ɒ z aː ʃ
utazások	u t ɒ z aː ʃ o k
utca	u t͡sː ɒ
utcai	u t͡sː ɒʲ i
utcán	u t͡sː aː n
utcára	u t͡sː aː r ɒ
utoljára	u t o jː aː r ɒ
utolsó	u t o l ʃ oː
után	u t aː n
utána	u t aː n ɒ
utáni	u t aː n i
utóbbi	u t oː bː i
uv	uː v eː
vacsorát	v ɒ t͡ʃ o r aː t
vaddisznó	v ɒ dː i s n oː
vadonatúj	v ɒ d o n ɒ t uː j
vagyok	v ɒ ɟ o k
vagyoni	v ɒ ɟ o n i
vagyunk	v ɒ ɟ u ŋ k
vajon	v ɒ j o n
valaha	v ɒ l ɒ h ɒ
valahogy	v ɒ l ɒ ɦ o ɟ
valakinek	v ɒ l ɒ k i n ɛ k
valamely	v ɒ l ɒ m ɛ j
valamennyi	v ɒ l ɒ m ɛ ɲː i
valami	v ɒ l ɒ m i
valamibe	v ɒ l ɒ m i b ɛ
valamilyen	v ɒ l ɒ m i j ɛ n
valamint	v ɒ l ɒ m i n t
valamit	v ɒ l ɒ m i t
valamivel	v ɒ l ɒ m i v ɛ l
vall	v ɒ lː
vallomás	v ɒ lː o m aː ʃ
vallásos	v ɒ lː aː ʃ o ʃ
való	v ɒ l oː
valóban	v ɒ l oː b ɒ n
valójában	v ɒ l oː j aː b ɒ n
valósul	v ɒ l oː ʃ u l
van	v ɒ n
vannak	v ɒ nː ɒ k
vastag	v ɒ ʃ t ɒ ɡ
vasárnap	v ɒ ʃ aː r n ɒ p
vasárnapi	v ɒ ʃ aː r n ɒ p i
vasúti	v ɒ ʃ uː t i
vegyen	v ɛ ɟ ɛ n
vegyi	v ɛ ɟ i
vegyél	v ɛ ɟ eː l
vele	v ɛ l ɛ
velencei	v ɛ l ɛ n t͡s ɛʲ i
velük	v ɛ l y k
vendégeket	v ɛ n d eː ɡ ɛ k ɛ t
venni	v ɛ nː i
vereséget	v ɛ r ɛ ʃ eː ɡ ɛ t
versei	v ɛ r ʃ ɛʲ i
versek	v ɛ r ʃ ɛ k
verseny	v ɛ r ʃ ɛ ɲ
versenyek	v ɛ r ʃ ɛ ɲ ɛ k
versenyt	v ɛ r ʃ ɛ ɲ t
verte	v ɛ r t ɛ
vesszük	v ɛ sː y k
veszi	v ɛ s i
vesznek	v ɛ s n ɛ k
veszte	v ɛ s t ɛ
veszteséget	v ɛ s t ɛ ʃ eː ɡ ɛ t
veszélybe	v ɛ s eː j b ɛ
veszélyben	v ɛ s eː j b ɛ n
veszélyes	v ɛ s eː j ɛ ʃ
veszélyt	v ɛ s eː j t
vett	v ɛ tː
vette	v ɛ tː ɛ
vettem	v ɛ tː ɛ m
vezet	v ɛ z ɛ t
vezetés	v ɛ z ɛ t eː ʃ
vezető	v ɛ z ɛ t øː
vezetői	v ɛ z ɛ t øːʲ i
vezetőinek	v ɛ z ɛ t øːʲ i n ɛ k
vidrák	v i d r aː k
vidék	v i d eː k
vigyázz	v i ɟ aː zː
vigyék	v i ɟ eː k
viktor	v i k t o r
villa	v i lː ɒ
villamos	v i lː ɒ m o ʃ
világ	v i l aː ɡ
világba	v i l aː ɡ b ɒ
világbajnok	v i l aː ɡ b ɒ j n o k
világban	v i l aː ɡ b ɒ n
világokban	v i l aː ɡ o ɡ b ɒ n
világosabb	v i l aː ɡ o ʃ ɒ bː
világra	v i l aː ɡ r ɒ
világába	v i l aː ɡ aː b ɒ
világítás	v i l aː ɡ iː t aː ʃ
vince	v i n t͡s ɛ
virtuális	v i r t u aː l i ʃ
virágzó	v i r aː ɡ z oː
vissza	v i sː ɒ
visszafogott	v i sː ɒ f o ɡ o tː
visszakozik	v i sː ɒ k o z i k
visszatérő	v i sː ɒ t eː r øː
visszavonhatatlan	v i sː ɒ v o n ɦ ɒ t ɒ t l ɒ n
viszont	v i s o n t
vita	v i t ɒ
vizsgálat	v i ʒ ɡ aː l ɒ t
vizsgálata	v i ʒ ɡ aː l ɒ t ɒ
vizsgálatok	v i ʒ ɡ aː l ɒ t o k
vizsgáljuk	v i ʒ ɡ aː jː u k
volna	v o l n ɒ
volt	v o l t
voltak	v o l t ɒ k
voltaképpen	v o l t ɒ k eː pː ɛ n
voltam	v o l t ɒ m
volán	v o l aː n
vonatkozik	v o n ɒ t k o z i k
vonatkozó	v o n ɒ t k o z oː
vonatnál	v o n ɒ t n aː l
vonja	v o ɲː ɒ
vác	v aː t͡s
vágyakozik	v aː ɟ ɒ k o z i k
vágyik	v aː ɟ i k
vágány	v aː ɡ aː ɲ
válasz	v aː l ɒ s
válasza	v aː l ɒ s ɒ
válaszok	v aː l ɒ s o k
választhat	v aː l ɒ s t h ɒ t
választják	v aː l ɒ s c aː k
választás	v aː l ɒ s t aː ʃ
választási	v aː l ɒ s t aː ʃ i
válhat	v aː l ɦ ɒ t
vállalat	v aː lː ɒ l ɒ t
vállalkozások	v aː lː ɒ l k o z aː ʃ o k
vállalkozók	v aː lː ɒ l k o z oː k
vállalni	v aː lː ɒ l n i
válogatott	v aː l o ɡ ɒ t o tː
vált	v aː l t
váltak	v aː l t ɒ k
váltam	v aː l t ɒ m
váltani	v aː l t ɒ n i
váltott	v aː l t o tː
váltotta	v aː l t o tː ɒ
változnak	v aː l t o z n ɒ k
változott	v aː l t o z o tː
változás	v aː l t o z aː ʃ
változása	v aː l t o z aː ʃ ɒ
változások	v aː l t o z aː ʃ o k
változó	v aː l t o z oː
váltás	v aː l t aː ʃ
váltó	v aː l t oː
vár	v aː r
várhatóan	v aː r ɦ ɒ t oː ɒ n
várjuk	v aː r j u k
várják	v aː r j aː k
várná	v aː r n aː
városi	v aː r o ʃ i
várta	v aː r t ɒ
vártak	v aː r t ɒ k
várunk	v aː r u ŋ k
várva	v aː r v ɒ
vászon	v aː s o n
vásárlás	v aː ʃ aː r l aː ʃ
vásárló	v aː ʃ aː r l oː
vásárol	v aː ʃ aː r o l
vásárolnak	v aː ʃ aː r o l n ɒ k
védekezés	v eː d ɛ k ɛ z eː ʃ
védelme	v eː d ɛ l m ɛ
védelmi	v eː d ɛ l m i
védikus	v eː d i k u ʃ
vége	v eː ɡ ɛ
végez	v eː ɡ ɛ z
végezni	v eː ɡ ɛ z n i
végrehajtási	v eː ɡ r ɛ ɦ ɒ j t aː ʃ i
végső	v eː k ʃ øː
végtelenül	v eː k t ɛ l ɛ n y l
végzettségű	v eː ɡ z ɛ t͡ʃː eː ɡ yː
végző	v eː ɡ z øː
végén	v eː ɡ eː n
végére	v eː ɡ eː r ɛ
végét	v eː ɡ eː t
végül	v eː ɡ y l
vékony	v eː k o ɲ
vélem	v eː l ɛ m
vélemény	v eː l ɛ m eː ɲ
véleményed	v eː l ɛ m eː ɲ ɛ d
véleményem	v eː l ɛ m eː ɲ ɛ m
véletlen	v eː l ɛ t l ɛ n
véletlenül	v eː l ɛ t l ɛ n y l
vér	v eː r
vérrög	v eː rː ø ɡ
vétele	v eː t ɛ l ɛ
vírus	v iː r u ʃ
vízi	v iː z i
vörösök	v ø r ø ʃ ø k
washingtoni	v ɒ ʃ i ŋ k t o n i
webek	v ɛ b ɛ k
western	v ɛ s t ɛ r n
zagyva	z ɒ ɟ v ɒ
zajlik	z ɒ j l i k
zendülés	z ɛ n d y l eː ʃ
zene	z ɛ n ɛ
zenei	z ɛ n ɛʲ i
zenész	z ɛ n eː s
zenét	z ɛ n eː t
zoltán	z o l t aː n
zsírsav	ʒ iː r ʃ ɒ v
zsófia	ʒ oː f iʲ ɒ
zárt	z aː r t
záró	z aː r oː
záróvizsga	z aː r oː v i ʒ ɡ ɒ
zöldfülű	z ø l t f y l yː
ábra	aː b r ɒ
ágazati	aː ɡ ɒ z ɒ t i
ágy	aː ɟ
áldozat	aː l d o z ɒ t
áll	aː lː
állam	aː lː ɒ m
állami	aː lː ɒ m i
államilag	aː lː ɒ m i l ɒ ɡ
államnak	aː lː ɒ m n ɒ k
állampolgársági	aː lː ɒ m p o l ɡ aː r ʃ aː ɡ i
államtitkára	aː lː ɒ m t i t k aː r ɒ
állandó	aː lː ɒ n d oː
állapota	aː lː ɒ p o t ɒ
állapotban	aː lː ɒ p o d b ɒ n
állapotában	aː lː ɒ p o t aː b ɒ n
állatkertben	aː lː ɒ t k ɛ r d b ɛ n
állatok	aː lː ɒ t o k
állnak	aː l n ɒ k
állomány	aː lː o m aː ɲ
állott	aː lː o tː
állt	aː l t
álltak	aː l t ɒ k
álltunk	aː l t u ŋ k
állunk	aː lː u ŋ k
állás	aː lː aː ʃ
állítja	aː lː iː cː ɒ
álló	aː lː oː
álma	aː l m ɒ
által	aː l t ɒ l
általa	aː l t ɒ l ɒ
általuk	aː l t ɒ l u k
általában	aː l t ɒ l aː b ɒ n
általános	aː l t ɒ l aː n o ʃ
ám	aː m
április	aː p r i l i ʃ
ára	aː r ɒ
árak	aː r ɒ k
árbevétel	aː r b ɛ v eː t ɛ l
árfolyam	aː r f o j ɒ m
árnyék	aː r ɲ eː k
árnyéka	aː r ɲ eː k ɒ
áron	aː r o n
árt	aː r t
árva	aː r v ɒ
ásványok	aː ʃ v aː ɲ o k
át	aː t
átalakítása	aː t ɒ l ɒ k iː t aː ʃ ɒ
átlagos	aː t l ɒ ɡ o ʃ
átlagosnál	aː t l ɒ ɡ o ʃ n aː l
átlátható	aː t l aː t h ɒ t oː
átlátszó	aː t l aː t͡sː oː
átmeneti	aː t m ɛ n ɛ t i
ázsiai	aː ʒ iʲ ɒʲ i
édes	eː d ɛ ʃ
ég	eː ɡ
égből	eː ɡ b øː l
égi	eː ɡ i
éhbérért	eː b eː r eː r t
éjszaka	eː j s ɒ k ɒ
éjszakai	eː j s ɒ k ɒʲ i
éjszakára	eː j s ɒ k aː r ɒ
él	eː l
élet	eː l ɛ t
életben	eː l ɛ d b ɛ n
élete	eː l ɛ t ɛ
életen	eː l ɛ t ɛ n
életet	eː l ɛ t ɛ t
életmódot	eː l ɛ t m oː d o t
élettartam	eː l ɛ tː ɒ r t ɒ m
életét	eː l ɛ t eː t
élhet	eː l ɦ ɛ t
éli	eː l i
éljen	eː jː ɛ n
élmény	eː l m eː ɲ
élne	eː l n ɛ
élnek	eː l n ɛ k
élni	eː l n i
élénk	eː l eː ŋ k
élünk	eː l y ŋ k
élősködő	eː l øː ʃ k ø d øː
émelygés	eː m ɛ j ɡ eː ʃ
épp	eː pː
éppen	eː pː ɛ n
építészet	eː p iː t eː s ɛ t
építészeti	eː p iː t eː s ɛ t i
építő	eː p iː t øː
építőipar	eː p iː t øːʲ i p ɒ r
épül	eː p y l
épületek	eː p y l ɛ t ɛ k
épülő	eː p y l øː
érdekeit	eː r d ɛ k ɛʲ i t
érdekes	eː r d ɛ k ɛ ʃ
érdeklődést	eː r d ɛ k l øː d eː ʃ t
érdeklődő	eː r d ɛ k l øː d øː
érdekében	eː r d ɛ k eː b ɛ n
érdemes	eː r d ɛ m ɛ ʃ
érezte	eː r ɛ s t ɛ
éreztem	eː r ɛ s t ɛ m
éri	eː r i
érintett	eː r i n t ɛ tː
érintő	eː r i n t øː
érkezett	eː r k ɛ z ɛ tː
érne	eː r n ɛ
érnek	eː r n ɛ k
ért	eː r t
érted	eː r t ɛ d
értelemszerűen	eː r t ɛ l ɛ m s ɛ r yː ɛ n
értelme	eː r t ɛ l m ɛ
értelmes	eː r t ɛ l m ɛ ʃ
értelmezhető	eː r t ɛ l m ɛ s h ɛ t øː
értem	eː r t ɛ m
értette	eː r t ɛ tː ɛ
értettem	eː r t ɛ tː ɛ m
érthetetlen	eː r t h ɛ t ɛ t l ɛ n
érthető	eː r t h ɛ t øː
érthetők	eː r t h ɛ t øː k
értékben	eː r t eː ɡ b ɛ n
értéke	eː r t eː k ɛ
értékeit	eː r t eː k ɛʲ i t
értékek	eː r t eː k ɛ k
értékelés	eː r t eː k ɛ l eː ʃ
értékes	eː r t eː k ɛ ʃ
értékesítés	eː r t eː k ɛ ʃ iː t eː ʃ
értéket	eː r t eː k ɛ t
értékű	eː r t eː k yː
érvel	eː r v ɛ l
érzelmi	eː r z ɛ l m i
érzésem	eː r z eː ʃ ɛ m
és	eː ʃ
északi	eː s ɒ k i
észre	eː s r ɛ
ételek	eː t ɛ l ɛ k
ételt	eː t ɛ l t
étkezés	eː t k ɛ z eː ʃ
étkezési	eː t k ɛ z eː ʃ i
étterem	eː tː ɛ r ɛ m
étvágyat	eː t v aː ɟ ɒ t
év	eː v
éva	eː v ɒ
évben	eː v b ɛ n
éve	eː v ɛ
évek	eː v ɛ k
években	eː v ɛ ɡ b ɛ n
éven	eː v ɛ n
évente	eː v ɛ n t ɛ
éves	eː v ɛ ʃ
évesen	eː v ɛ ʃ ɛ n
évet	eː v ɛ t
évig	eː v i ɡ
évként	eː f k eː n t
évtizede	eː f t i z ɛ d ɛ
évtől	eː f t øː l
évvel	eː vː ɛ l
évét	eː v eː t
így	iː ɟ
ígéri	iː ɡ eː r i
íjász	iː j aː s
íme	iː m ɛ
ír	iː r
írja	iː r j ɒ
írjak	iː r j ɒ k
írják	iː r j aː k
írnak	iː r n ɒ k
írni	iː r n i
írott	iː r o tː
írta	iː r t ɒ
írtunk	iː r t u ŋ k
írásban	iː r aː ʒ b ɒ n
írásbeli	iː r aː ʒ b ɛ l i
ítélet	iː t eː l ɛ t
ízlés	iː z l eː ʃ
óhatatlanul	oː ɦ ɒ t ɒ t l ɒ n u l
ókori	oː k o r i
óra	oː r ɒ
órákban	oː r aː ɡ b ɒ n
órán	oː r aː n
órára	oː r aː r ɒ
órás	oː r aː ʃ
órától	oː r aː t oː l
óvszer	oː f s ɛ r
ön	ø n
önkormányzat	ø ŋ k o r m aː ɲ z ɒ t
önkormányzatok	ø ŋ k o r m aː ɲ z ɒ t o k
önkéntes	ø ŋ k eː n t ɛ ʃ
önkéntesek	ø ŋ k eː n t ɛ ʃ ɛ k
önmagát	ø mː ɒ ɡ aː t
önnek	ø nː ɛ k
önnel	ø nː ɛ l
önt	ø n t
önálló	ø n aː lː oː
önöknek	ø n ø k n ɛ k
öreg	ø r ɛ ɡ
örök	ø r ø k
örökkévalóság	ø r ø kː eː v ɒ l oː ʃ aː ɡ
öröm	ø r ø m
örömmel	ø r ø mː ɛ l
örömét	ø r ø m eː t
örülök	ø r y l ø k
össze	ø sː ɛ
összefügg	ø sː ɛ f y ɡː
összes	ø sː ɛ ʃ
összetett	ø sː ɛ t ɛ tː
öt	ø t
ötlet	ø t l ɛ t
ötlete	ø t l ɛ t ɛ
ötven	ø t v ɛ n
ötödik	ø t ø d i k
úgy	uː ɟ
úgyhogy	uː c h o ɟ
új	uː j
újabb	uː j ɒ bː
újat	uː j ɒ t
újpest	uː j p ɛ ʃ t
újra	uː j r ɒ
újraegyesítés	uː j r ɒ ɛ ɟː ɛ ʃ iː t eː ʃ
újság	uː j ʃ aː ɡ
újságíró	uː j ʃ aː ɡ iː r oː
úri	uː r i
úszni	uː s n i
úszómedence	uː s oː m ɛ d ɛ n t͡s ɛ
út	uː t
úti	uː t i
úton	uː t o n
ügy	y ɟ
ügyben	y ɟ b ɛ n
ügye	y ɟ ɛ
ügyes	y ɟ ɛ ʃ
ügyet	y ɟ ɛ t
ügyfeleink	y c f ɛ l ɛʲ i ŋ k
ügyfelek	y c f ɛ l ɛ k
ügyében	y ɟ eː b ɛ n
ügyét	y ɟ eː t
ül	y l
ülj	y jː
üljem	y jː ɛ m
ültek	y l t ɛ k
ülésen	y l eː ʃ ɛ n
ülést	y l eː ʃ t
ünnep	y nː ɛ p
ünnepség	y nː ɛ p ʃ eː ɡ
üres	y r ɛ ʃ
ütemben	y t ɛ m b ɛ n
ütötte	y t ø tː ɛ
üveg	y v ɛ ɡ
üzemeltető	y z ɛ m ɛ l t ɛ t øː
üzlet	y z l ɛ t
üzleti	y z l ɛ t i
üzletág	y z l ɛ t aː ɡ
őalá	øː ɒ l aː
ők	øː k
őket	øː k ɛ t
őrgrófság	øː r ɡ r oː f ʃ aː ɡ
őrizetbe	øː r i z ɛ d b ɛ
ősi	øː ʃ i
őszi	øː s i
őszintén	øː s i n t eː n
űrhajós	yː r ɦ ɒ j oː ʃ
űrrepülőgép	yː rː ɛ p y l øː ɡ eː p
