adda	a tː a
af	aː v
afar	aː v a r
afgangur	a v k a u ŋ k ʏ r
afgreiða	a v k r e iː ð a
afgreiðsla	a v k r e i ð s t l a
afi	aː v ɪ
afkomandi	a v kʰ ɔː m a n t ɪ
afla	a p l a
afleiðing	a v l e iː ð i ŋ k
afli	a p l ɪ
afmælisgjöf	a v m a iː l ɪ s c œː v
afrit	a v r ɪː t
afsaka	a f s aː k a
afsláttur	a f s t l a u h t ʏ r
afsökun	a f s œː k ʏ n
afturelding	a f t ʏ r ɛ l t i ŋ k
afturhald	a f t ʏ r h a l t
aggi	a cː ɪ
aka	aː k a
akkeri	a h k ɛː r ɪ
akrein	aː k r e iː n
ala	aː l a
alaskaösp	aː l a s k a œ s p
alba	a l p a
alda	a l t a
aldeilis	a l t e iː l ɪ s
aldin	a l t ɪ n
aldrei	a l t r e iː
aldís	a l t iː s
alexander	aː l ɛ k s a n t ɛː r
algerlega	a l c ɛ r l ɛː ɣ a
algjörlega	a l c œ r l ɛː ɣ a
alin	aː l ɪ n
alli	a t l ɪ
alls	a l s
almennilegur	a l m ɛ nː ɪ l ɛː ɣ ʏ r
almennur	a l m ɛ nː ʏ r
altari	a l̥ t a r ɪ
alvarlega	a l v a r l ɛː ɣ a
alvarlegur	a l v a r l ɛː ɣ ʏ r
alvitur	a l v ɪː t ʏ r
alúðlega	aː l u ð l ɛː ɣ a
amerískur	aː m ɛː r i s k ʏ r
amma	a mː a
ananas	aː n aː n a s
anda	a n t a
andarungi	a n t a r u ɲ c ɪ
anddyri	a n t t ɪː r ɪ
andersen	a n t ɛ r s ɛ nː
andfélagslega	a n t f j ɛː l a x s l ɛː ɣ a
andi	a n t ɪ
andlát	a n t l a uː t
andri	a n t r ɪ
andstyggilega	a n t s t ɪ cː ɪ l ɛː ɣ a
andstæður	a n t s t a i ð ʏ r
andvaka	a n t v aː k a
andvari	a n t v aː r ɪ
andvarp	a n t v a r̥ p
andúð	a n t uː ð
anga	a u ŋ k a
angi	a u ɲ c ɪ
anna	a nː a
annar	a nː a r
annars	a nː a r̥ s
ansi	a n s ɪ
apa	aː p a
api	aː p ɪ
app	a h p
appelsínugulur	a h p ɛ l s iː n ʏ k ʏː l ʏ r
apótekari	aː p o uː tʰ ɛː k aː r ɪ
ara	aː r a
arabískur	aː r a p i s k ʏ r
aragrúi	aː r a k r uː ɪ
arfi	a r v ɪ
ari	aː r ɪ
aristóteles	aː r ɪ s t o uː tʰ ɛː l ɛː s
arkitekt	a r̥ c ɪ tʰ ɛ x t
armband	a r m p a n t
armbandsúr	a r m p a n t s uː r
armur	a r m ʏ r
arnar	a r t n aː r
arndís	a r t n t iː s
arnheiður	a r t n h e iː ð ʏ r
arnór	a r t n o uː r
arnþrúður	a r t n θ r uː ð ʏ r
aron	aː r ɔː n
arsen	a r̥ s ɛ n
arður	a r ð ʏ r
as	aː s
aska	a s k a
asni	a s t n ɪ
aspas	a s p a s
at	aː t
ata	aː t a
atburður	aː t p ʏ r ð ʏ r
atferli	aː t f ɛ r t l ɪ
atgervi	aː t c ɛ r v ɪ
athuga	aː t h ʏː ɣ a
athugasemd	aː t h ʏː ɣ a s ɛ m t
athygli	aː t h ɪ k l ɪ
athæfi	aː t h a iː v ɪ
athöfn	aː t h œ p n
atriði	aː t r ɪː ð ɪ
atvik	aː t v ɪː k
atvinna	aː t v ɪ nː a
atvinnumaður	aː t v ɪ nː ʏ m aː ð ʏ r
auga	ø yː ɣ a
augabrún	ø yː ɣ a p r uː n
augljós	ø y ɣ l j o uː s
augljóslega	ø y ɣ l j o uː s l ɛː ɣ a
auglýsa	ø y ɣ l iː s a
augnablik	ø y k n a p l ɪː k
augnhár	ø y k n h a uː r
augnlok	ø y k n l ɔː k
auka	ø yː k a
auki	ø yː c ɪ
aukning	ø y h k n i ŋ k
auli	ø yː l ɪ
aumingi	ø yː m i ɲ c ɪ
aur	ø yː r
ausa	ø yː s a
austur	ø y s t ʏ r
austurríki	ø y s t ʏ r r iː c ɪ
auðmýking	ø y ð m iː c i ŋ k
auðmýkt	ø y ð m i x t
auðna	ø y ð n a
auður	ø yː ð ʏ r
auðvelda	ø y ð v ɛ l t a
auðveldur	ø y ð v ɛ l t ʏ r
auðæfi	ø yː ð a iː v ɪ
axlabönd	a x s t l a p œ n t
aðalatriði	aː ð a l aː t r ɪː ð ɪ
aðalbraut	aː ð a l p r ø yː t
aðallega	aː ð a l l ɛː ɣ a
aðdráttarafl	a ð t r a u h t a r a p l
aðdróttun	a ð t r o u h t ʏ n
aðdáun	a ð t a uː ʏ n
aðeins	aː ð e i n s
aðfaranótt	a ð f aː r a n o u h t
aðferð	a ð f ɛ r ð
aðgangur	a ð k a u ŋ k ʏ r
aðgerð	a ð c ɛ r ð
aðgerðaáætlun	a ð c ɛ r ð aː u a i t l ʏ n
aðgætni	a ð c a i h t n ɪ
aðild	aː ð ɪ l t
aðili	aː ð ɪː l ɪ
aðlaðandi	a ð l aː ð a n t ɪ
aðstoð	a ð s t ɔː ð
aðstoðarforstjóri	a ð s t ɔː ð a r f ɔ r̥ s t j o uː r ɪ
aðstæður	a ð s t a iː ð ʏ r
aðsókn	a ð s o u h k n
aðvörun	a ð v œː r ʏ n
aþena	aː θ ɛː n a
baggi	p a cː ɪ
bak	p aː k
baka	p aː k a
bakka	p a h k a
bakpoki	p aː k pʰ ɔː c ɪ
bakstur	p a x s t ʏ r
bakuggi	p aː k ʏ cː ɪ
bakvörður	p aː k v œ r ð ʏ r
baldur	p a l t ʏ r
bali	p aː l ɪ
ball	p a lː
bambus	p a m p ʏ s
bana	p aː n a
bandalag	p a n t a l aː ɣ
banka	p a u ŋ̊ k a
banki	p a u ɲ̊ c ɪ
bann	p a nː
banna	p a nː a
bar	p aː r
bardagi	p a r t aː j ɪ
barna	p a r t n a
barnalæknir	p a r t n a l a i h k n ɪ r
barrtré	p a rː t r j ɛː
barón	p aː r o uː n
basl	p a s t l
basla	p a s t l a
bassi	p a sː ɪ
bati	p aː t ɪ
baugur	p ø yː ɣ ʏ r
bauk	p ø yː k
baul	p ø yː l
baula	p ø yː l a
baun	p ø yː n
baðherbergi	p aː ð h ɛ r p ɛ r c ɪ
baðkar	p a ð kʰ aː r
beikon	p e iː kʰ ɔ n
bein	p e iː n
beina	p e iː n a
beinn	p e i t n
beisla	p e i s t l a
beisli	p e i s t l ɪ
beita	p e iː t a
beiti	p e iː t ɪ
beitiland	p e iː t ɪ l a n t
beittur	p e i h t ʏ r
beiðni	p e i ð n ɪ
bekkur	p ɛ h k ʏ r
belgía	p ɛ l c i j a
benda	p ɛ n t a
bendir	p ɛ n t ɪ r
benedikt	p ɛː n ɛː t ɪ x t
benjamín	p ɛ n j a m iː n
bensín	p ɛ n s iː n
ber	p ɛː r
bergmann	p ɛ r k m a nː
berlín	p ɛ r l iː n
bernhöft	p ɛ r n h œ f t
beygja	p e iː j a
beð	p ɛː ð
biblía	p ɪ p l iː j a
bifreið	p ɪ v r e iː ð
bikar	p ɪː k a r
bil	p ɪː l
bilun	p ɪː l ʏ n
bindi	p ɪ n t ɪ
birgir	p ɪ r c ɪ r
birgja	p ɪ r c a
birki	p ɪ r̥ c ɪ
birkitré	p ɪ r̥ c ɪ t r j ɛː
birta	p ɪ r̥ t a
biskup	p ɪ s k ʏ p
biti	p ɪː t ɪ
bið	p ɪː ð
biðill	p ɪː ð ɪ t l
biðja	p ɪ ð j a
biðlari	p ɪ ð l aː r ɪ
biðröð	p ɪ ð r œː ð
bjarga	p j a r k a
bjarndís	p j a r t n t iː s
bjartsýni	p j a r̥ t s iː n ɪ
bjartsýnn	p j a r̥ t s i t n
bjartur	p j a r̥ t ʏ r
bjálki	p j a u l̥ k ɪ
bjáni	p j a uː n ɪ
bjó	p j o uː
bjóst	p j o uː s t
bjóða	p j o uː ð a
bjöggi	p j œ cː ɪ
björg	p j œ r k
björgvin	p j œ r k v ɪ n
björk	p j œ r̥ k
björt	p j œ r̥ t
bjúgur	p j uː ʏ r
blak	p l aː k
bland	p l a n t
blanda	p l a n t a
blautur	p l ø yː t ʏ r
blað	p l aː ð
blaðra	p l a ð r a
blekking	p l ɛ h k i ŋ k
blekkja	p l ɛ h c a
blessa	p l ɛ sː a
blessun	p l ɛ sː ʏ n
blettur	p l ɛ h t ʏ r
blik	p l ɪː k
blika	p l ɪː k a
blinda	p l ɪ n t a
blindhæð	p l ɪ n t h a iː ð
bljúgur	p l j uː ʏ r
blogg	p l ɔ kː
bloggari	p l ɔ kː a r ɪ
blá	p l a uː
bláber	p l a uː p ɛː r
blágreni	p l a uː k r ɛː n ɪ
blár	p l a uː r
blása	p l a uː s a
blástur	p l a u s t ʏ r
blær	p l a i̯ː r
blæösp	p l a iː œ s p
blíður	p l iː ð ʏ r
blóm	p l o uː m
blómstra	p l o u m s t r a
blóð	p l o uː ð
blóðnasir	p l o u ð n aː s ɪ r
blóðþrýstingur	p l o u ð θ r i s t i ŋ k ʏ r
blöndal	p l œ n t aː l
blússa	p l u sː a
bogga	p ɔ kː a
boli	p ɔː l ɪ
bolli	p ɔ t l ɪ
bolludagur	p ɔ lː ʏ t aː ɣ ʏ r
bolur	p ɔː l ʏ r
bora	p ɔː r a
borg	p ɔ r k
borgari	p ɔ r k aː r ɪ
borgarstjóri	p ɔ r k a r s t j o uː r ɪ
borð	p ɔ r ð
borða	p ɔ r ð a
borði	b ɔ r ð ɪ
borðstofa	p ɔ r ð s t ɔː v a
borðtennis	p ɔ r ð tʰ ɛ nː ɪ s
botn	p ɔ h t n
botna	p ɔ h t n a
boð	p ɔː ð
boða	p ɔː ð a
boðorð	p ɔː ð ɔ r ð
boðskapur	p ɔ ð s k aː p ʏ r
braggi	p r a cː ɪ
bragur	p r aː ɣ ʏ r
bragð	p r a ɣ ð
brak	p r aː k
brandur	p r a n t ʏ r
bras	p r aː s
brasilía	p r aː s ɪ l iː j a
brass	p r a sː
braut	p r ø yː t
brautargengi	p r ø yː t a r c e i ɲ c ɪ
brautryðjandi	p r ø yː t r ɪ ð j a n t ɪ
brauð	p r ø yː ð
bregða	p r ɛ ɣ ð a
breidd	p r e i tː
breiða	p r e iː ð a
breiður	p r e iː ð ʏ r
breiðþota	p r e i ð θ ɔː t a
breki	p r ɛː c ɪ
brekka	p r ɛ h k a
brenna	p r ɛ nː a
brennisteinn	p r ɛ nː ɪ s t e i t n
brennivín	p r ɛ nː ɪ v iː n
breskur	p r ɛ s k ʏ r
bresta	p r ɛ s t a
brestur	p r ɛ s t ʏ r
breti	p r ɛː t ɪ
bretland	p r ɛː t l a n t
bretti	p r ɛ h t ɪ
breytilegur	p r e iː t ɪ l ɛː ɣ ʏ r
breyting	p r e iː t i ŋ k
breytni	p r e i h t n ɪ
briem	p r iː m
brjálæði	p r j a uː l a iː ð ɪ
brjóst	p r j o u s t
brjóstsviði	p r j o u s t s v ɪː ð ɪ
brjóta	p r j o uː t a
brokk	p r ɔ h k
brons	p r ɔ n s
bros	p r ɔː s
brot	p r ɔː t
brottfall	p r ɔ h t f a t l
brottför	p r ɔ h t f œː r
brottvísun	p r ɔ h t v iː s ʏ n
brum	p r ʏː m
brussel	p r ʏ sː ɛ l
bruðl	p r ʏ ð l
bryggja	p r ɪ cː a
brynja	p r ɪ n j a
brynjólfur	p r ɪ n j o u l v ʏ r
bryti	p r ɪː t ɪ
bryðja	p r ɪ ð j a
brátt	p r a u h t
bráð	p r a uː ð
bráðna	p r a u ð n a
bráður	p r a uː ð ʏ r
bræða	p r a iː ð a
bræði	p r a iː ð ɪ
bræðsla	p r a i ð s t l a
bréf	p r j ɛː v
bróðir	p r o uː ð ɪ r
bróðursonur	p r o uː ð ʏ r̥ s ɔː n ʏ r
brú	p r uː
brún	p r uː n
brúnn	p r u t n
brúðkaup	p r u ð kʰ ø yː p
brúður	p r uː ð ʏ r
bumba	p ʏ m p a
bunga	p u ŋ k a
burkni	p ʏ r̥ k n ɪ
burnirót	p ʏ r t n ɪ r o uː t
bursta	p ʏ r̥ s t a
butur	p ʏː t ʏ r
buxur	p ʏ x s ʏ r
bygging	p ɪ cː i ŋ k
byggð	p ɪ ɣ ð
bylgjulengd	p ɪ l c ʏ l e i ŋ k t
bylting	p ɪ l̥ t i ŋ k
bylur	p ɪː l ʏ r
byrgja	p ɪ r c a
byrja	p ɪ r j a
byrði	p ɪ r ð ɪ
byssa	p ɪ sː a
bál	p a uː l
bárður	p a u r ð ʏ r
bátur	p a uː t ʏ r
bæ	p a iː
bæjar	p a iː j a r̥
bæjarstjóri	p a iː j a r s t j o uː r ɪ
bæklingur	p a i h k l i ŋ k ʏ r
bæla	p a iː l a
bæli	p a iː l ɪ
bæn	p a iː n
bær	p a iː r
bæta	p a iː t a
bæti	p a iː t ɪ
bé	p j ɛː
bílskúr	p i l s k uː r
bílstjóri	p i l s t j o uː r ɪ
bíta	p iː t a
bíða	p iː ð a
bóg	p o uː
bók	p o uː k
bóka	p o uː k a
bókstafur	p o uː k s t aː v ʏ r
bóla	p o uː l a
bólgna	p o u l n a
bólivía	p o uː l ɪ v iː j a
bólstraberg	p o u l s t r a p ɛ r k
bómull	p o uː m ʏ t l
bón	p o uː n
bónus	p o uː n ʏ s
bót	p o uː t
böl	p œː l
börkur	p œ r̥ k ʏ r
börn	p œ r t n
búfé	p uː f j ɛː
búi	p uː ɪ
búlgarska	p u l k a r̥ s k a
búnaður	p uː n aː ð ʏ r
búr	p uː r
búri	p uː r ɪ
búð	p uː ð
bý	p iː
býfluga	p iː f l ʏː ɣ a
býr	p iː r̥
dafna	t a p n a
dagatal	t aː ɣ a tʰ aː l
dagbók	t a ɣ p o uː k
daglega	t a ɣ l ɛː ɣ a
dagsetning	t a x s ɛ h t n i ŋ k
dagskrá	t a x s k r a uː
dagur	t aː ɣ ʏ r
dani	t aː n ɪ
danmörk	t a n m œ r̥ k
dans	t a n s
dansa	t a n s a
danska	t a n s k a
danskur	t a n s k ʏ r
daníel	t aː n i j ɛː l
dauðadómur	t ø yː ð a t o uː m ʏ r
dauðarefsing	t ø yː ð a r ɛ f s i ŋ k
dauði	t ø yː ð ɪ
davíð	t aː v iː ð
deig	t e iː ɣ
deila	t e iː l a
deild	t e i l t
deiling	t e iː l i ŋ k
deita	t e iː t a
dekkja	t ɛ h c a
demba	t ɛ m p a
depill	t ɛː p ɪ t l
dey	t e iː
deyfa	t e iː v a
deyja	t e iː j a
diljá	t ɪ l j a uː
dimma	t ɪ mː a
diskótek	t ɪ s k o uː tʰ ɛː k
dissa	t ɪ sː a
djákni	t j a u h k n ɪ
djók	t j o uː k
djóka	t j o uː k a
djöfull	t j œː v ʏ t l
djúp	t j uː p
djúprista	t j uː p r ɪ s t a
djúpur	t j uː p ʏ r
djús	t j uː s
dofi	t ɔː v ɪ
doktor	t ɔ x t ɔ r
draga	t r aː ɣ a
drama	t r aː m a
draumur	t r ø yː m ʏ r̥
dreif	t r e iː v
dreki	t r ɛː c ɪ
drekkja	t r ɛ h c a
drengur	t r e i ŋ k ʏ r
drepa	t r ɛː p a
dreyma	t r e iː m a
dreymandi	t r e iː m a n t ɪ
drift	t r ɪ f t
drjúgur	t r j uː ʏ r
dropi	t r ɔː p ɪ
drottinn	t r ɔ h t ɪ n
drottna	t r ɔ h t n a
drottning	t r ɔ h t n i ŋ k
drykkja	t r ɪ h c a
drykkjarvatn	t r ɪ h c a r v a h t n
drykkur	t r ɪ h k ʏ r
dráp	t r a uː p
dráttarvél	t r a u h t a r v j ɛː l
drífa	t r iː v a
drýgja	t r iː j a
duga	t ʏː ɣ a
duglegur	t ʏ ɣ l ɛː ɣ ʏ r
dul	t ʏː l
dvelja	t v ɛ l j a
dvergur	t v ɛ r k ʏ r
dvína	t v iː n a
dvöl	t v œː l
dylgjur	t ɪ l c ʏ r
dynja	t ɪ n j a
dyntóttur	t ɪ n̥ t o u h t ʏ r
dynur	t ɪː n ʏ r
dáleiða	t a uː l e iː ð a
dæla	t a iː l a
dæld	t a i l t
dæma	t a iː m a
dæmi	t a iː m ɪ
dís	t iː s
dómari	t o uː m aː r ɪ
dómstóll	t o u m s t o u t l
dómur	t o uː m ʏ r
dóni	t o uː n ɪ
dóná	t o uː n a uː
dósent	t o uː s ɛ n t
dóttir	t o uʰ t ɪ r
dögg	t œ kː
dúr	t uː r
dýfa	t iː v a
dýpi	t iː p ɪ
dýr	t iː r
dýrafræði	t iː r a f r a iː ð ɪ
dýralæknir	t iː r a l a i h k n ɪ r
dýri	t iː r ɪ
dýrka	t i r̥ k a
dýrð	t i r ð
edrú	ɛː t r uː
ef	ɛː v
eff	ɛ fː
efla	ɛ p l a
efli	ɛ p l ɪ
efna	ɛ p n a
efnafræði	ɛ p n a f r a iː ð ɪ
efnahagur	ɛ p n a h aː ɣ ʏ r
efni	ɛ p n ɪ
efnilegur	ɛ p n ɪ l ɛː ɣ ʏ r
efnisyfirlit	ɛ p n ɪ s ɪː v ɪ r l ɪː t
eftirlaun	ɛ f t ɪ r l ø yː n
eftirlit	ɛ f t ɪ r l ɪː t
eftirminnilegur	ɛ f t ɪ r m ɪ nː ɪ l ɛː ɣ ʏ r
eftirmynd	ɛ f t ɪ r m ɪ n t
eftirsókn	ɛ f t ɪ r s o u h k n
egg	ɛ kː
eggjárn	ɛ kː j a u r t n
egyptaland	ɛː c ɪ f t a l a n t
eigandi	e iː ɣ a n t ɪ
eiginkona	e iː j ɪ n kʰ ɔː n a
eiginleiki	e iː j ɪ n l e iː c ɪ
eiginmaður	e iː j ɪ n m aː ð ʏ r
eigur	e iː ɣ ʏ r
eik	e iː k
eilífð	e iː l i v ð
eimskip	e i m s c ɪː p
einar	e iː n a r
einasta	e iː n a s t a
einasti	e iː n a s t ɪ
einelti	e iː n ɛ l̥ t ɪ
einfaldlega	e i n f a l t l ɛː ɣ a
einfaldur	e i n f a l t ʏ r
eingöngu	e i n k ø y ŋ k ʏ
einir	e iː n ɪ r
einkavæðing	e i ŋ k a v a iː ð i ŋ k
einkum	e i n̥ k ʏ m
einlægni	e i n l a i k n ɪ
einn	e i t n
einræði	e i n r a iː ð ɪ
einsemd	e i n s ɛ m t
einstaklingur	e i n s t a k l i ŋ k ʏ r
eintal	e i n tʰ aː l
einustu	e iː n ʏ s t ʏ
einvígi	e i n v iː j ɪ
eir	e iː r
eistland	e i s t l a n t
eitrun	e iː t r ʏ n
eiði	e iː ð ɪ
eiður	e iː ð ʏ r
ekkert	ɛ h c ɛ r̥ t
ekkill	ɛ h c ɪ t l
ekkja	ɛ h c a
ekta	ɛ x t a
el	ɛː l
elda	ɛ l t a
eldast	ɛ l t a s t
eldfimur	ɛ l t f ɪː m ʏ r
eldgos	ɛ l t k ɔː s
eldhús	ɛ l t h uː s
elding	ɛ l t i ŋ k
eldjárn	ɛ l t j a u r t n
eldpipar	ɛ l t p ɪː p a r
eldsneyti	ɛ l t s n e iː t ɪ
eldstæði	ɛ l t s t a iː ð ɪ
eldur	ɛ l t ʏ r
elfa	ɛ l v a
ella	ɛ t l a
ellefu	ɛ t l ɛ v ʏ
elta	ɛ l̥ t a
elí	ɛː l iː
elías	ɛː l iː j a s
embætti	ɛ m p a i h t ɪ
enda	ɛ n t a
endastöð	ɛ n t a s t œː ð
endi	ɛ n t ɪ
endir	ɛ n t ɪ r
endur	ɛ n t ʏ r
endurlífgun	ɛ n t ʏ r l i v k ʏ n
endurskoðandi	ɛ n t ʏ r s k ɔː ð a n t ɪ
endurtaka	ɛ n t ʏ r tʰ aː k a
endurvekja	ɛ n t ʏ r v ɛː c a
engi	e i ɲ c ɪ
engill	e i ɲ c ɪ t l
enginn	e i ŋ c ɪ nː
england	e i ŋ l a n t
enni	ɛ nː ɪ
enska	ɛ n s k a
enskur	ɛ n s k ʏ r
erfingi	ɛ r v i ɲ c ɪ
erfiða	ɛ r v ɪː ð a
erfðamengi	ɛ r v ð a m e i ɲ c ɪ
erindi	ɛː r ɪ n t ɪ
erla	ɛ r t l a
ermi	ɛ r m ɪ
ernir	ɛ r t n ɪ r
eruð	ɛː r ʏ ð
es	ɛː s
eta	ɛː t a
etja	ɛː t j a
eva	ɛː v a
evra	ɛ v r a
eydís	e iː t iː s
eygja	e iː j a
eyja	e iː j a
eyjafjallajökull	e iː j a f j a t l a j œː k ʏ t l
eykt	e i x t
eymsli	e i m s t l ɪ
eymundur	e iː m ʏ n t ʏ r
eyrún	e iː r u n
eystra	e i s t r a
eyða	e iː ð a
eyðilegging	e iː ð ɪ l ɛ cː i ŋ k
eyðni	e i ð n ɪ
eyðsla	e i ð s t l a
eð	ɛː ð
eða	ɛː ð a
eðlilega	ɛ ð l ɪ l ɛː ɣ a
eðlisfræði	ɛ ð l ɪ s f r a iː ð ɪ
faggi	f a cː ɪ
fagur	f aː ɣ ʏ r
fagurfræði	f aː ɣ ʏ r f r a iː ð ɪ
falda	f a l t a
fall	f a t l
falla	f a t l a
fallegur	f a t l ɛː ɣ ʏ r
fanga	f a u ŋ k a
fangelsi	f a u ŋ c ɛ l s ɪ
fangi	f a u ɲ c ɪ
far	f aː r
fara	f aː r a
faraldur	f aː r a l t ʏ r
farlama	f a r l a m a
farsi	f a r̥ s ɪ
fastanefnd	f a s t a n ɛ m t
fastur	f a s t ʏ r
fata	f aː t a
faðir	f aː ð ɪ r
fegurð	f ɛː ɣ ʏ r ð
feiti	f e iː t ɪ
fela	f ɛː l a
felga	f ɛ l k a
fell	f ɛ t l
fella	f ɛ t l a
fellibylur	f ɛ t l ɪ p ɪː l ʏ r
ferill	f ɛː r ɪ t l
ferilskrá	f ɛː r ɪ l s k r a uː
ferming	f ɛ r m i ŋ k
ferningur	f ɛ r t n i ŋ k ʏ r
ferskur	f ɛ r̥ s k ʏ r
ferð	f ɛ r ð
ferðamaður	f ɛ r ð a m aː ð ʏ r
ferðaáætlun	f ɛ r ð a a uː a i h t l ʏ n
festi	f ɛ s t ɪ
festing	f ɛ s t i ŋ k
fet	f ɛː t
feðgar	f ɛ ð k a r
feðgin	f ɛ ð c ɪː n
fimleikar	f ɪ m l e iː k a r
fimm	f ɪ mː
fingur	f i ŋ k ʏ r
finnast	f ɪ nː a s t
finnbogi	f ɪ n p ɔ j ɪ
finni	f ɪ nː ɪ
finnland	f ɪ nː l a n t
finnska	f ɪ n s k a
finnur	f ɪ nː ʏ r
fis	f ɪː s
fiseind	f ɪː s e i n t
fita	f ɪː t a
fiðrildi	f ɪ ð r ɪ l t ɪ
fjall	f j a t l
fjallagrös	f j a t l a k r œː s
fjandi	f j a n t ɪ
fjandskapur	f j a n t s k aː p ʏ r
fjarlægja	f j a r l a iː j a
fjarstýring	f j a r̥ s t iː r i ŋ k
fjáður	f j a uː ð ʏ r
fjóla	f j o uː l a
fjólublár	f j o uː l ʏ p l a uː r
fjórir	f j o uː r i r
fjórði	f j o u r ð ɪ
fjórðungur	f j o u r ð u ŋ k ʏ r
fjós	f j o uː s
fjölbreytni	f j œ l p r e i h t n ɪ
fjölbýlishús	f j œ l p iː l ɪ s h uː s
fjöldamorðingi	f j œ l t a m ɔ r ð i ŋ c ɪ
fjölga	f j œ l k a
fjöllaufungur	f j œ l l ø yː v u ŋ k ʏ r
fjölskylda	f j œ l s c ɪ l t a
fjör	f j œː r
fjötur	f j œː t ʏ r
fjúka	f j uː k a
flagg	f l a kː
flakka	f l a h k a
flass	f l a sː
flautuleikari	f l ø yː t ʏ l e iː k aː r ɪ
fleirtala	f l e i r̥ t aː l a
fletja	f l ɛː t j a
fletta	f l ɛ h t a
fleygur	f l e iː ɣ ʏ r
fleyta	f l e iː t a
flibbi	f l ɪ pː ɪ
flissa	f l ɪ sː a
fljót	f l j o uː t
fljóta	f l j o uː t a
fljóð	f l j o uː ð
fljúga	f l j uː a
flog	f l ɔː ɣ
flogaveiki	f l ɔː ɣ a v e iː c ɪ
flokka	f l ɔ h k a
flokkun	f l ɔ h k ʏ n
flokkur	f l ɔ h k ʏ r
floti	f l ɔː t ɪ
flugbraut	f l ʏ ɣ p r ø yː t
flugfélag	f l ʏː ɣ f j ɛː l aː ɣ
flugslóði	f l ʏ x s t l o uː ð ɪ
flugvél	f l ʏ ɣ v j ɛː l
flugvöllur	f l ʏ ɣ v œ t l ʏ r
flundra	f l ʏ n t r a
flytja	f l ɪː t j a
flækingur	f l a iː c i ŋ k ʏ r
flækja	f l a iː c a
flæði	f l a iː ð ɪ
flétta	f l j ɛ h t a
flík	f l iː k
flís	f l iː s
flóra	f l o uː r a
flórens	f l o uː r ɛ n s
flórída	f l o uː r i t a
flóð	f l o uː ð
flýja	f l iː j a
flýta	f l iː t a
flýtir	f l iː t ɪ r
fnykur	f n ɪː k ʏ r
fokk	f ɔ h k
folald	f ɔː l a l t
for	f ɔː r
foreldrar	f ɔː r ɛ l t r a r
forliður	f ɔ r l ɪː ð ʏ r
forn	f ɔ r t n
fornenska	f ɔ r t n ɛ n s k a
forrit	f ɔ r r ɪː t
forritun	f ɔ rː ɪː t ʏ n
forréttur	f ɔ r r j ɛ h t ʏ r
forseti	f ɔ r̥ s ɛː t ɪ
forsjá	f ɔ r̥ s j a uː
forskeyti	f ɔ r̥ s c e iː t ɪ
forskot	f ɔ r̥ s k ɔː t
forsprakki	f ɔ r̥ s p r a h c ɪ
forstjóri	f ɔ r̥ s t j o uː r ɪ
forstöðumaður	f ɔ r̥ s t œ ð ʏ m aː ð ʏ r
forsætisráðherra	f ɔ r̥ s a iː t ɪ s r a uː ð h ɛ rː a
fortíð	f ɔ r̥ tʰ iː ð
forvitni	f ɔ r v ɪ h t n ɪ
forvöð	f ɔ r v œː ð
forða	f ɔ r ð a
forði	f ɔ r ð ɪ
fosfór	f ɔ s f o uː r
foss	f ɔ sː
frakkland	f r a h k l a n t
framan	f r aː m a n
framburður	f r a m p ʏ r ð ʏ r
framferði	f r a m f ɛ r ð ɪ
framkoma	f r a m kʰ ɔː m a
framkvæma	f r a m kʰ v a iː m a
framkvæmd	f r a m kʰ v a i m t
framkvæmdastjóri	f r a m kʰ v a i m t a s t j o uː r ɪ
framlag	f r a m l aː ɣ
framleiðandi	f r a m l e iː ð a n t ɪ
framleiðsla	f r a m l e i ð s t l a
framlengja	f r a m l e i ɲ c a
framvinda	f r a m v ɪ n t a
frank	f r a ŋ̊ k
franska	f r a n s k a
frasi	f r aː s ɪ
frelsari	f r ɛ l s aː r ɪ
frelsi	f r ɛ l s ɪ
fremja	f r ɛ m j a
fress	f r ɛ sː
fresta	f r ɛ s t a
frestur	f r ɛ s t ʏ r
freyja	f r e iː j a
friða	f r ɪː ð a
friður	f r ɪː ð ʏ r
frjáls	f r j a u l s
frjókorn	f r j o uː kʰ ɔ r t n
frjósemi	f r j o uː s ɛː m ɪ
frost	f r ɔ s t
frumefni	f r ʏː m ɛ p n ɪ
frumvarp	f r ʏ m v a r̥ p
frysta	f r ɪ s t a
frá	f r a uː
frádráttur	f r a u t r a u h t ʏ r
frásögn	f r a uː s œ k n
fræ	f r a iː
frægð	f r a i ɣ ð
frækinn	f r a iː c ɪ nː
frænka	f r a i n k a
fræva	f r a iː v a
fræða	f r a iː ð a
fræði	f r a iː ð ɪ
fræðimaður	f r a iː ð ɪ m aː ð ʏ r
fræðsla	f r a i ð s t l a
frétt	f r j ɛ h t
fréttablað	f r j ɛ h t a p l aː ð
fréttastofa	f r j ɛ h t a s t ɔː v a
frímerki	f r iː m ɛ r̥ c ɪ
fríða	f r iː ð a
fríður	f r iː ð ʏ r
frón	f r o uː n
fugl	f ʏ k l
fuglahræða	f ʏ k l a r̥ a iː ð a
fuglakjöt	f ʏ k l a cʰ œː t
fullkomlega	f ʏ t l̥ kʰ ɔ m l ɛː ɣ a
fullnusta	f ʏ t l n ʏ s t a
fulltrúi	f ʏ t l̥ tʰ r uː ɪ
fullur	f ʏ t ɬ ʏ r
fullyrða	f ʏ t l ɪ r ð a
fullyrðing	f ʏ t l ɪ r ð i ŋ k
funda	f ʏ n t a
fundur	f ʏ n t ʏ r
furða	f ʏ r ð a
fylgd	f ɪ l t
fylgi	f ɪ l c ɪ
fylgifiskur	f ɪ l c ɪ f ɪ s k ʏ r
fylgirit	f ɪ l c ɪ r ɪː t
fylgja	f ɪ l c a
fylja	f ɪ l j a
fylki	f ɪ l̥ c ɪ
fyllilega	f ɪ t l ɪ l ɛː ɣ a
fyrirlestur	f ɪː r ɪ r l ɛ s t ʏ r
fyrirsæta	f ɪː r ɪ r s a iː t a
fyrstur	f ɪ r̥ s t ʏ r
fá	f a uː
fágaður	f a uː a ð ʏ r
fálki	f a u l̥ c ɪ
fána	f a uː n a
fáni	f a uː n ɪ
fár	f a uː r
fáránlegur	f a uː r a u n l ɛː ɣ ʏ r
fátækt	f a uː tʰ a i x t
fátækur	f a uː tʰ a iː k ʏ r
fáviti	f a uː v ɪː t ɪ
fæ	f a iː
fæla	f a iː l a
fælni	f a i l n ɪ
færa	f a iː r a
færeyska	f a iː r e i s k a
færi	f a iː r ɪ
færni	f a i r t n ɪ
fæðing	f a iː ð i ŋ k
fé	f j ɛː
fífl	f i p l
fíkn	f i h k n
fínn	f i t n
fólk	f o u l̥ k
fórnarlamb	f o u r t n a r l a m p
fóstri	f o u s t r ɪ
fóstur	f o u s t ʏ r
fótbolti	f o uː t p ɔ l̥ t ɪ
föl	f œː l
fölur	f œː l ʏ r
föndur	f œ n t ʏ r
fönix	f œː n ɪ x s
för	f œː r
förðun	f œ r ð ʏ n
föstudagur	f œ s tʰ ʏ t aː ɣ ʏ r
föt	f œː t
föðurbróðir	f œː ð ʏ r p r o uː ð ɪ r
föðursystir	f œː ð ʏ r s ɪ s t ɪ r
fúll	f u t l
fús	f uː s
gaffall	k a fː a t l
gagn	k a k n
gagnagrunnur	k a k n a k r ʏ nː ʏ r
gagnsemi	k a k n s ɛː m ɪ
gallabuxur	k a lː a p ʏ x s ʏ r
gallalaus	k a t l a l ø yː s
galílea	k aː l iː l ɛː a
gaman	k aː m aː n
gamansemi	k aː m a n s ɛː m ɪ
ganga	k a u ŋ k a
gangbraut	k a u ŋ k p r ø yː t
gangur	k a u ŋ k ʏ r
garg	k a r k
garn	k a r t n
garðar	k a r ð a r
garðrækt	k a r ð r a i x t
garður	k a r ð ʏ r
garðyrkja	k a r ð ɪ r̥ c a
gat	k aː t
gata	k aː t a
gaur	k ø yː r
gautaborg	k ø yː t a p ɔ r k
gauti	k ø yː t ɪ
gefa	c ɛː v a
gegna	c ɛ k n a
geir	k e iː r
geirfugl	c e i r f ʏ k l
geiri	c e iː r ɪ
geisa	c e iː s a
geisladiskur	c e i s t l a t ɪ s k ʏ r
gel	c ɛː l
gelta	c ɛ l̥ t a
gengi	c e i ɲ c ɪ
gengismunur	c e i ɲ c ɪ s m ʏː n ʏ r
gengur	c e i ŋ k ʏ r
gera	c ɛː r a
gervi	c ɛ r v ɪ
gervigras	c ɛ r v ɪ k r aː s
gervitungl	c ɛ r v ɪ tʰ u ŋ l
gerð	c ɛ r ð
gerði	c ɛ r ð ɪ
gestgjafi	c ɛ s t c aː v ɪ
gestur	c ɛ s t ʏ r
geta	c ɛː t a
geðlæknir	c ɛ ð l a i h k n ɪ r
geðveikur	c ɛ ð v e iː k ʏ r
gifs	c ɪ f s
gifta	c ɪ f t a
gigt	c ɪ x t
gildi	c ɪ l t ɪ
gildur	c ɪ l t ʏ r
gilitrutt	c ɪː l ɪ tʰ r ʏ h t
gimsteinn	c ɪ m s t e i t n
girða	c ɪ r ð a
girðing	c ɪ r ð i ŋ k
giska	c ɪ s k a
gista	c ɪ s t a
gisti	c ɪ s t ɪ
gistihús	c ɪ s t ɪ h uː s
gjald	c a l t
gjalda	c a l t a
gjaldmiðill	c a l t m ɪː ð ɪ t l
gjaldþrot	c a l t θ r ɔː t
gjarn	c a r t n
gjá	c a uː
gjóla	c o uː l a
gjöf	c œː v
gjögur	c œː ɣ ʏ r
glas	k l aː s
glata	k l aː t a
glaður	k l aː ð ʏ r
gler	k l ɛː r
gleraugu	k l ɛː r ø yː ɣ ʏ
gleði	k l ɛː ð ɪ
gljúfur	k l j uː v ʏ r
glott	k l ɔ h t
gluggi	k l ʏ cː ɪ
glundur	k l ʏ n t ʏ r
glymur	k l ɪː m ʏ r
glápa	k l a uː p a
glæpamaður	k l a iː p a m aː ð ʏ r
glæpur	k l a iː p ʏ r
glær	k l a iː r
glæra	k l a iː r a
glæta	k l a iː t a
glæða	k l a iː ð a
glíma	k l iː m a
glódís	k l o uː t iː s
glóð	k l o uː ð
glötun	k l œː t ʏ n
golf	k ɔ l v
gormur	k ɔ r m ʏ r
gos	k ɔː s
gosi	k ɔː s ɪ
gott	k ɔ h t
grafa	k r aː v a
grallari	k r a t l aː r ɪ
gramm	k r a mː
graslendi	k r aː s l ɛ n t ɪ
grautur	k r ø yː t ʏ r
grein	k r e iː n
greina	k r e iː n a
greinargerð	k r e iː n a r c ɛ r ð
greind	k r e i n t
greinilega	k r e iː n ɪ l ɛː ɣ a
greining	k r e iː n i ŋ k
greinir	k r e iː n ɪ r
greip	k r e iː p
greiða	k r e iː ð a
greiðsla	k r e i ð s t l a
greiðslukort	k r e i ð s t l ʏ kʰ ɔ r̥ t
greni	k r ɛː n ɪ
grenja	k r ɛ n j a
grennd	k r ɛ n t
grikkland	k r ɪ h k l a n t
grind	k r ɪ n t
grugg	k r ʏ kː
grund	k r ʏ n t
grunnskóli	k r ʏ nː s k o uː l ɪ
grunnur	k r ʏ nː ʏ r
grunur	k r ʏː n ʏ r
grá	k r a uː
grágæs	k r a uː c a iː s
grár	k r a uː r
gráta	k r a uː t a
gráða	k r a uː ð a
grænmeti	k r a i n m ɛː t ɪ
grænn	k r a i t n
græðgi	k r a i ð c ɪ
gríma	k r iː m a
grímur	k r iː m ʏ r
grín	k r iː n
grípa	k r iː p a
gró	k r o uː
gróf	k r o uː v
gróði	k r o uː ð ɪ
gróður	k r o uː ð ʏ r
gróðurhús	k r o uː ð ʏ r h uː s
gröf	k r œː v
grön	k r œː n
grýla	k r iː l a
grýta	k r iː t a
gufa	k ʏː v a
gula	k ʏː l a
gull	k ʏ t l
gullkorn	k ʏ t l kʰ ɔ r t n
gulur	k ʏː l ʏ r
gulvíðir	k ʏ l v iː ð ɪ r
gum	k ʏː m
gunnþórunn	k ʏ n θ o uː r ʏ nː
gustur	k ʏ s t ʏ r
guðbjörg	k v ʏ ð p j œ r k
guðfræði	k v ʏ ð f r a iː ð ɪ
guðlast	k v ʏ ð l a s t
guðlaugur	k v ʏ ð l ø yː ɣ ʏ r
guðleysi	k v ʏ ð l e iː s ɪ
guðleysingi	k v ʏ ð l e iː s i ɲ c ɪ
guðmundur	k v ʏ ð m ʏ n t ʏ r
guðríður	k v ʏ ð r iː ð ʏ r
guðspjall	k v ʏ ð s p j a t l
gá	k a uː
gáleysi	k a uː l e iː s ɪ
gáski	k a u s c ɪ
gáta	k a uː t a
gátt	k a u h t
gæludýr	c a iː l ʏ t iː r
gæsahúð	c a iː s a h uː ð
gæta	c a iː t a
gætt	k a ɪ h t
gæði	c a iː ð ɪ
gígja	c iː j a
gíslína	c i s t l iː n a
gítar	c iː tʰ aː r
góa	k o uː a
gólf	k o u l v
gómsætur	k o u m s a iː t ʏ r
góður	k o uː ð ʏ r
góðæri	k o uː ð a iː r ɪ
göng	k ø y ŋ k
gönguferð	k ø y ŋ k ʏ f ɛ r ð
göngutúr	k ø y ŋ k ʏ tʰ uː r
gúrkutíð	k u r̥ k ʏ tʰ iː ð
gýgur	c iː ɣ ʏ r
ha	h aː
haarde	h ɔ r t ɛː
hadda	h a tː a
hafdís	h a v t iː s
hafna	h a p n a
hafragrautur	h a v r a k r ø yː t ʏ r
haga	h aː ɣ a
hagfræði	h a x f r a iː ð ɪ
hagl	h a k l
haglabyssa	h a k l a p ɪ sː a
hagnaður	h a k n a ð ʏ r
hagsæld	h a x s a i l t
hagur	h aː ɣ ʏ r
hakka	h a k k a
hald	h a l t
halda	h a l t a
halla	h a t l a
halldór	h a l t o uː r
hallgerður	h a t l c ɛ r ð ʏ r
halli	h a t l ɪ
hallur	h a t l ʏ r
hamar	h aː m a r
hamingjusamur	h aː m i ɲ c ʏ s aː m ʏ r
hamra	h a m r a
hamstur	h a m s t ʏ r
handa	h a n t a
handbremsa	h a n t p r ɛ m s a
handbók	h a n t p o uː k
handklæði	h a n t kʰ l a iː ð ɪ
handleggur	h a n t l ɛ kː ʏ r
handrit	h a n t r ɪː t
handrið	h a n t r ɪː ð
handsnyrting	h a n t s t n ɪ r̥ t i ŋ k
hanga	h a u ŋ k a
hangikjöt	h a u ŋ c ɪ cʰ œː t
hanki	h a u ɲ̊ c ɪ
hansen	h a n s ɛ nː
haraldur	h aː r a l t ʏ r
harka	h a r̥ k a
harpa	h a r̥ p a
harðlífi	h a r ð l iː v ɪ
harður	h a r ð ʏ r
haukur	h ø yː k ʏ r
haus	h ø yː s
hefja	h ɛ v j a
hefnd	h ɛ m t
hefta	h ɛ f t a
hefti	h ɛ f t ɪ
hefð	h ɛ v ð
hegða	h ɛ ɣ ð a
hegðun	h ɛ ɣ ð ʏ n
heilbrigði	h e i l p r ɪ ɣ ð ɪ
heilbrigður	h e i l p r ɪ ɣ ð ʏ r
heild	h e i l t
heili	h e iː l ɪ
heilla	h e i t l a
heimavinna	h e iː m a v ɪ nː a
heimboð	h e i m p ɔː ð
heimferð	h e i m f ɛ r ð
heimild	h e iː m ɪ l t
heimilisfang	h e iː m ɪ l ɪ s f a u ŋ k
heimspeki	h e i m s p ɛː c ɪ
heimspekingur	h e i m s p ɛː c i ŋ k ʏ r
heimsvaldastefna	h e i m s v a l t a s t ɛ p n a
heimta	h e i m̥ t a
heit	h e iː t
heita	h e iː t a
heiti	h e iː t ɪ
heitur	h e iː t ʏ r
heiðagæs	h e iː ð a c a iː s
heiðarlegur	h e iː ð a r l ɛː ɣ ʏ r
heiðarleiki	h e iː ð a r l e iː c ɪ
heiðni	h e i ð n ɪ
hekla	h ɛ h k l a
held	h ɛ l t
helgarferð	h ɛ l k a r f ɛ r ð
helgi	h ɛ l c ɪ
hellingur	h ɛ t l i ŋ k ʏ r
helluhraun	h ɛ t l ʏ r̥ ø yː n
helvíti	h ɛ l v iː t ɪ
hem	h ɛː m
henda	h ɛ n t a
hengi	h e i ɲ c ɪ
hengja	h e i ɲ c a
heppni	h ɛ h p n ɪ
herbergi	h ɛ r p ɛ r c ɪ
herdís	h ɛ r t iː s
hermaður	h ɛ r m aː ð ʏ r
herra	h ɛ rː a
hertogi	h ɛ r̥ tʰ ɔ j ɪ
herðablað	h ɛ r ð a p l aː ð
hespa	h ɛ s p a
hetja	h ɛː t j a
hettupeysa	h ɛ h t ʏ pʰ e iː s a
hey	h e iː
heyja	h e iː j a
heyrn	h e i r t n
heyrnarlaus	h e i r t n a r l ø yː s
heyrnartól	h e i r t n a r tʰ o uː l
hik	h ɪː k
hika	h ɪː k a
hildigunnur	h ɪ l t ɪ k ʏ nː ʏ r
hindra	h ɪ n t r a
hindrun	h ɪ n t r ʏ n
hinn	h ɪ nː
hirð	h ɪ r ð
hirða	h ɪ r ð a
hirðir	h ɪ r ð ɪ r
hissa	h ɪ sː a
hita	h ɪː t a
hiti	h ɪː t ɪ
hittni	h ɪ h t n ɪ
hjal	ç aː l
hjalli	ç a t l ɪ
hjaltalín	ç a l̥ t a l iː n
hjarta	ç a r̥ t a
hjá	ç a uː
hjáleið	ç a uː l e iː ð
hjálmar	ç a u l m a r
hjálp	ç a u l̥ p
hjálpa	ç a u l̥ p a
hjálpari	ç a u l̥ p a r ɪ
hjólabretti	ç o uː l a p r ɛ h t ɪ
hjólbörur	ç o uː l p œː r ʏ r
hjóm	ç o uː m
hjón	ç o uː n
hjónaband	ç o uː n a p a n t
hjörtur	ç œ r̥ t ʏ r
hjörð	ç œ r ð
hjúkra	ç uː k r a
hjúkrun	ç uː k r ʏ n
hjúkrunarheimili	ç uː k r ʏ n a r h e iː m ɪ l ɪ
hjúkrunarkona	ç uː k r ʏ n a r kʰ ɔː n a
hjúpa	ç uː p a
hlaup	l̥ ø yː p
hlaupa	l̥ ø yː p a
hlað	l̥ aː ð
hlaða	l̥ aː ð a
hlaði	l̥ aː ð ɪ
hlekkur	l̥ ɛ h k ʏ r
hleri	l̥ ɛː r ɪ
hleypa	l̥ e iː p a
hlið	l̥ ɪː ð
hljóma	l̥ j o uː m a
hljómur	l̥ j o uː m ʏ r
hljóta	l̥ j o uː t a
hljóð	l̥ j o uː ð
hljóða	l̥ j o uː ð a
hljóðbók	l̥ o u ð p o uː k
hljóðfæri	l̥ j o u ð f a iː r ɪ
hlust	l̥ ʏ s t
hluti	l̥ ʏː t ɪ
hlutur	l̥ ʏː t ʏ r
hlutverk	l̥ ʏː t v ɛ r̥ k
hlægja	l̥ a iː j a
hlæja	l̥ a iː j a
hlé	l̥ j ɛː
hlésey	l̥ j ɛː s e iː
hlíf	l̥ iː v
hlífa	l̥ iː v a
hlíta	l̥ iː t a
hlíð	l̥ iː ð
hlýja	l̥ iː j a
hlýna	l̥ iː n a
hlýri	l̥ iː r ɪ
hlýða	l̥ iː ð a
hlýðni	l̥ i ð n ɪ
hnappur	n̥ a h p ʏ r
hnaus	n̥ ø yː s
hnefi	n̥ ɛː v ɪ
hneigð	n̥ e i ɣ ð
hneta	n̥ ɛː t a
hnetusmjör	n̥ ɛː t ʏ s m j œː r
hnoða	n̥ ɔː ð a
hnoðri	n̥ ɔ ð r ɪ
hnupl	n̥ ʏ h p l
hné	n̥ j ɛː
hnífasmiður	n̥ iː v a s m ɪː ð ʏ r
hnýta	n̥ iː t a
hobbiti	h ɔ pː ɪː t ɪ
hof	h ɔː v
hola	h ɔː l a
holdsveiki	h ɔ l t s v e iː c ɪ
holland	h ɔ l l a n t
hollur	h ɔ t l ʏ r
holt	h ɔ l̥ t
holur	h ɔː l ʏ r
hommi	h ɔ mː ɪ
hopp	h ɔ h p
hoppa	h ɔ h p a
horfa	h ɔ r v a
horfur	h ɔ r v ʏ r
hormón	h ɔ r m o uː n
horn	h ɔ r t n
hrafn	r̥ a p n
hraukur	r̥ ø yː k ʏ r
hraustur	r̥ ø y s t ʏ r
hraða	r̥ aː ð a
hraðbraut	r̥ a ð p r ø yː t
hraði	r̥ aː ð ɪ
hreindýr	r̥ e i n t iː r
hreinlæti	r̥ e i n l a iː t ɪ
hreinskilinn	r̥ e i n s c ɪː l ɪ nː
hreinsun	r̥ e i n s ʏ n
hreiður	r̥ e iː ð ʏ r
hrekja	r̥ ɛː c a
hrekkjalómur	r̥ ɛ h c a l o uː m ʏ r
hrella	r̥ ɛ t l a
hreyfing	r̥ e iː v i ŋ k
hringja	r̥ i ɲ c a
hringlaga	r̥ i ŋ k l aː ɣ a
hringtorg	r̥ i ŋ k tʰ ɔ r k
hrjúfur	r̥ j uː v ʏ r
hrogn	r̥ ɔ k n
hroki	r̥ ɔː c ɪ
hrollur	r̥ ɔ t l ʏ r
hross	r̥ ɔ sː
hrossakjöt	r̥ ɔ sː a cʰ œː t
hrufla	r̥ ʏ p l a
hrun	r̥ ʏː n
hrygna	r̥ ɪ k n a
hryndi	r̥ ɪ n t ɪ
hrynja	r̥ ɪ n j a
hrynji	r̥ ɪ n j ɪ
hryssa	r̥ ɪ sː a
hryðjuverk	r̥ ɪ ð j ʏ v ɛ r̥ k
hryðjuverkamaður	r̥ ɪ ð j ʏ v ɛ r̥ k a m aː ð ʏ r
hræ	r̥ a iː
hrækja	r̥ a iː c a
hræra	r̥ a iː r a
hræsnari	r̥ a i s t n a r ɪ
hræðilega	r̥ a iː ð ɪ l ɛː ɣ a
hrífa	r̥ iː v a
hrísgrjón	r̥ iː s k r j o uː n
hrólfur	r̥ o u l v ʏ r
hrökkva	r̥ œ h k v a
hrönn	r̥ œ nː
hrúga	r̥ uː a
huggun	h ʏ kː ʏ n
hugi	h ʏː j ɪ
hugmynd	h ʏ ɣ m ɪ n t
hugmyndafræði	h ʏ ɣ m ɪ n t a f r a iː ð ɪ
hugsa	h ʏ x s a
hugsanlegur	h ʏ x s a n l ɛː ɣ ʏ r
hugsjónamaður	h ʏ x s j o uː n a m aː ð ʏ r
hugur	h ʏː ɣ ʏ r
hulda	h ʏ l t a
humar	h ʏː m a r
hunang	h ʏː n a u ŋ k
hundrað	h ʏ n t r aː ð
hungur	h u ŋ k ʏ r
hurð	h ʏ r ð
hvalaskoðun	kʰ v aː l a s k ɔː ð ʏ n
hvalkjöt	xʷ a l cʰ œː t
hvati	kʰ v aː t ɪ
hverfa	kʰ v ɛ r v a
hvergi	kʰ v ɛ r c ɪ
hvolf	kʰ v ɔ l v
hvá	xʷ a uː
hvíla	kʰ v iː l a
hvíld	xʷ i l t
hvína	xʷ iː n a
hvítabjörn	xʷ iː t a p j œ r t n
hvítkál	xʷ iː t kʰ a uː l
hvítvín	xʷ iː t v iː n
hvörf	kʰ v œ r v
hyggja	h ɪ cː a
hylja	h ɪ l j a
hylki	h ɪ l̥ c ɪ
hylla	h ɪ t l a
hylli	h ɪ t l ɪ
hylur	h ɪː l ʏ r
há	h a uː
háaloft	h a uː a l ɔ f t
hádegi	h a uː t e iː j ɪ
hádegisverður	h a uː t e iː j ɪ s v ɛ r ð ʏ r
hálendi	h a uː l ɛ n t ɪ
hálfkák	h a u l v kʰ a uː k
hálfleikur	h a u l v l e iː k ʏ r
hálfur	h a u l v ʏ r
háls	h a u l s
hámark	h a uː m a r̥ k
hárbursti	h a u r p ʏ r̥ s t ɪ
hás	h a uː s
háskóli	h a uː s k o uː l ɪ
háttaratviksorð	h a u h t a r aː t v ɪ k s ɔ r ð
hátterni	h a u h t ɛ r t n ɪ
háttur	h a u h t ʏ r
hátíð	h a uː tʰ iː ð
hávaði	h a uː v aː ð ɪ
háþrýstingur	h a uː θ r i s t i ŋ k ʏ r
hæ	h a iː
hæfa	h a iː v a
hægur	h a iː ɣ ʏ r
hækja	h a iː c a
hækka	h a i h k a
hækkun	h a i h k ʏ n
hæna	h a iː n a
hæstiréttur	h a i s t ɪ r j ɛ h t ʏ r
hætta	h a i h t a
hættulegur	h a i h t ʏ l ɛː ɣ ʏ r
hæð	h a iː ð
hæða	h a iː ð a
hér	ç ɛː r
hérna	ç ɛ r t n a
héðan	ç ɛː ð a n
héðinn	ç ɛː ð ɪ nː
híbýli	h iː p iː l ɪ
hóf	h o uː v
hólf	h o u l v
hóll	h o u t l
hólmfríður	h o u l m f r iː ð ʏ r
hópur	h o uː p ʏ r
hór	h o uː r
hósti	h o u s t ɪ
hóta	h o uː t a
hótel	h o uː t ɛ l
höfn	h œ p n
höfnun	h œ p n ʏ n
höfrungur	h œ v r u ŋ k ʏ r
höfuð	h œː v ʏ θ
höfuðborg	h œː v ʏ ð p ɔ r k
höfuðborgarsvæðið	h œː v ʏ θ p ɔ r k a r s v a iː ð ɪ ð
höfði	h œ v ð ɪ
höfðingi	h œ v ð i ɲ c ɪ
höggva	h œ kː v a
hönd	h œ n t
hönnun	h œ nː ʏ n
hörfræ	h œ r f r a iː
hörund	h œː r ʏ n t
hús	h uː s
húsbóndi	h u s p o u n t ɪ
húsfreyja	h uː s f r e iː j a
húsnæði	h uː s n a iː ð ɪ
húð	h uː ð
húðflúr	h u ð f l uː r
hýjungur	h iː j u ŋ k ʏ r
igla	ɪ k l a
il	ɪː l
ildi	ɪ l t ɪ
illgresi	ɪ t l k r ɛː s ɪ
ilma	ɪ l m a
ilmur	ɪ l m ʏ r
ilmvatn	ɪ l m v a h t n
indland	ɪ n t l a n t
indriðason	ɪ n t r ɪː ð a s ɔː n
indæll	ɪ n t a i t l
ingi	i ɲ c ɪ
ingibjörg	i ɲ c ɪ p j œ r k
ingunn	i ŋ k ʏ nː
ingvarsson	i ŋ k v a r̥ s s ɔː n
ingólfur	i ŋ k o u l v ʏ r
innan	ɪ nː a n
innbrot	ɪ nː p r ɔː t
innganga	ɪ nː k a u ŋ k a
inngrip	ɪ nː k r ɪː p
innheimta	ɪ nː h e i m̥ t a
innihald	ɪ nː ɪ h a l t
innkaup	ɪ nː kʰ ø yː p
innrita	ɪ nː r ɪː t a
innritun	ɪ nː r ɪː t ʏ n
innræting	ɪ nː r a iː t i ŋ k
internet	ɪ n̥ t ɛ r n ɛː t
ið	ɪː ð
iða	ɪː ð a
iðja	ɪ ð j a
iðnaður	ɪ ð n aː ð ʏ r
iðngrein	ɪ ð n k r e iː n
iðunn	ɪː ð ʏ nː
jafn	j a p n
jafntefli	j a p n tʰ ɛ p l ɪ
jafnvægi	j a p n v a iː j ɪ
jakki	j a h c ɪ
jakobsfífill	j aː kʰ ɔ p s f iː v ɪ t l
jakobína	j aː kʰ ɔː p iː n a
jana	j aː n a
janúar	j aː n uː aː r
japanska	j aː pʰ a n s k a
jarl	j a r t l
jarma	j a r m a
jarðarber	j a r ð a r p ɛː r
jarðarför	j a r ð a r f œː r
jarðfræði	j a r ð f r a iː ð ɪ
jarðhiti	j a r ð h ɪː t ɪ
jarðskjálfti	j a r ð s c a u l̥ t ɪ
jarðsprengja	j a r ð s p r e i ɲ c a
jarðvegur	j a r ð v ɛː ɣ ʏ r
jensen	j ɛ n s ɛ nː
jeppi	j ɛ h p ɪ
jerúsalem	j ɛː r uː s aː l ɛː m
jess	j ɛ sː
jesús	j ɛː s uː s
johnsen	j o u n s ɛː nː
joð	j ɔː ð
jurt	j ʏ r̥ t
jáeind	j a uː e i n t
járnbrautarlest	j a u r t n p r ø yː t a r l ɛ s t
járnsmiður	j a u r t n s m ɪː ð ʏ r
játa	j a uː t a
jæja	j a iː j a
jóakim	j o uː a cʰ ɪ m
jóhann	j o uː h a nː
jóhanna	j o uː h a nː a
jóhannes	j o uː h a nː ɛː s
jól	j o uː l
jólagjöf	j o uː l a c œː v
jón	j o uː n
jóna	j o uː n a
jónas	j o uː n aː s
jónatan	j o uː n a tʰ aː n
jónína	j o uː n iː n a
jórunn	j o uː r ʏ nː
jöfnun	j œ p n ʏ n
jökull	j œː k ʏ t l
jötunn	j œː tʰ ʏ nː
jú	j uː
júlíus	j uː l iː j ʏ s
júní	j uː n iː
kafa	kʰ aː v a
kaffihús	kʰ a fː ɪ h uː s
kafli	kʰ a p l ɪ
kafna	kʰ a p n a
kaka	kʰ aː k a
kaldi	kʰ a l t ɪ
kaldur	kʰ a l t ʏ r
kalk	kʰ a l̥ k
kalksteinn	kʰ a l̥ k s t e i t n
kall	kʰ a t l
kalla	kʰ a t l a
kambur	kʰ a m p ʏ r
kampavín	kʰ a m̥ p a v iː n
kampur	kʰ a m̥ p ʏ r
kanada	kʰ aː n aː t a
kapp	kʰ a h p
kappi	kʰ a h p ɪ
kapítuli	kʰ aː p i tʰ ʏː l ɪ
karakter	kʰ a r a x t ɛː r
karamella	kʰ aː r a m ɛ lː a
karate	kʰ aː r a t ɛː
karli	kʰ a r t l ɪ
karma	kʰ a r m a
karpa	kʰ a r̥ p a
kasta	kʰ a s t a
katrín	kʰ aː t r iː n
kaup	kʰ ø yː p
kaupa	kʰ ø yː p a
kaupmaður	kʰ ø y p m aː ð ʏ r
kaðlín	kʰ a ð l iː n
kaþólskur	k aː θ o u l s k ʏ r
kenna	cʰ ɛ nː a
kennari	cʰ ɛ nː aː r ɪ
kennd	cʰ ɛ n t
keppa	cʰ ɛ h p a
keppni	cʰ ɛ h p n ɪ
kerfi	cʰ ɛ r v ɪ
kerti	cʰ ɛ r̥ t ɪ
ket	cʰ ɛː t
ketill	cʰ ɛː t ɪ t l
keyra	cʰ e iː r a
kiljan	cʰ ɪ l j a n
kind	cʰ ɪ n t
kindakjöt	cʰ ɪ n t a cʰ œː t
kippa	cʰ ɪ h p a
kirkja	cʰ ɪ r̥ c a
kitla	cʰ ɪ h t l a
kjaftur	cʰ a f t ʏ r
kjallari	cʰ a t l aː r ɪ
kjarkur	cʰ a r̥ k ʏ r
kjarni	cʰ a r t n ɪ
kjartan	cʰ a r̥ t a n
kjassa	cʰ a sː a
kjáni	cʰ a uː n ɪ
kjóll	cʰ o u t l
kjósa	cʰ o uː s a
kjölfar	cʰ œ l f aː r
kjör	cʰ œː r
kjörlendi	cʰ œ r l ɛ n t ɪ
kjörskrá	cʰ œ r s k r a uː
kjöt	kʰ j œː t
kjúklingur	cʰ u h k l i ŋ k ʏ r
klapp	kʰ l a h p
klara	kʰ l aː r a
klauf	kʰ l ø yː v
klaustur	kʰ l ø y s t ʏ r
kleif	kʰ l e iː v
klekkja	kʰ l ɛ h c a
klemma	kʰ l ɛ mː a
klerkur	kʰ l ɛ r̥ k ʏ r
klipping	kʰ l ɪ h p i ŋ k
klippur	kʰ l ɪ h p ʏ r
klisja	kʰ l ɪː s j a
kljúfa	kʰ l j uː v a
klof	kʰ l ɔː v
klossi	kʰ l ɔ sː ɪ
klukka	kʰ l ʏ h k a
klukkustund	kʰ l ʏ h k ʏ s t ʏ n t
klukkutími	kʰ l ʏ h k ʏ tʰ iː m ɪ
klumpur	kʰ l ʏ m̥ p ʏ r
klám	kʰ l a uː m
klæða	kʰ l a iː ð a
klæðnaður	kʰ l a i ð n aː ð ʏ r
klífa	kʰ l iː v a
klíka	kʰ l iː k a
klína	kʰ l iː n a
klóra	kʰ l o uː r a
klósett	kʰ l o uː s ɛ h t
klósettpappír	kʰ l o uː s ɛ h t pʰ a h p iː r
klöpp	kʰ l œ h p
klúbbur	kʰ l u pː ʏ r
klúðra	kʰ l u ð r a
klúður	kʰ l uː ð ʏ r
knapi	kʰ n aː p ɪ
knattspyrna	kʰ n a h t s p ɪ r t n a
kné	kʰ n j ɛː
knús	kʰ n uː s
knútur	kʰ n uː t ʏ r
knýja	kʰ n iː j a
koddaver	kʰ ɔ tː a v ɛː r
koffín	kʰ ɔ fː iː n
kokka	kʰ ɔ h k a
kokkur	kʰ ɔ h k ʏ r
kol	kʰ ɔː l
kolefni	kʰ ɔː l ɛ p n ɪ
kolla	kʰ ɔ t l a
kolvetni	kʰ ɔ l v ɛ h t n ɪ
koma	kʰ ɔː m a
kommúnisti	kʰ ɔ mː uː n ɪ s t ɪ
komutími	kʰ ɔː m ʏ tʰ iː m ɪ
kona	kʰ ɔː n a
konar	kʰ ɔː n a r
konráð	kʰ ɔ n r a uː ð
konunglegur	kʰ ɔː n u ŋ k l ɛː ɣ ʏ r
konungsríki	kʰ ɔː n u ŋ k s r iː c ɪ
konur	kʰ ɔː n ʏ r
kopar	kʰ ɔː p a r
kort	kʰ ɔ r̥ t
kosning	kʰ ɔ s t n i ŋ k
koss	kʰ ɔ sː
kosta	kʰ ɔ s t a
krabbamein	kʰ r a pː a m e iː n
krafa	kʰ r aː v a
kraftaverk	kʰ r a f t a v ɛ r̥ k
krakk	kʰ r a h k
krakki	kʰ r a h c ɪ
kreditkort	kʰ r ɛː t ɪ t kʰ ɔ r̥ t
krefja	kʰ r ɛ v j a
krefjast	kʰ r ɛ v j a s t
krem	kʰ r ɛː m
kringumstæður	kʰ r i ŋ k ʏ m s t a iː ð ʏ r
kristinn	kʰ r ɪ s t ɪ nː
kristjana	k r ɪ s t j aː n a
kristni	kʰ r ɪ s t n ɪ
kristí	kʰ r ɪ s t iː
kristín	kʰ r ɪ s t iː n
krjúpa	kʰ r j uː p a
krol	kʰ r ɔː l
kroppa	kʰ r ɔ h p a
kross	kʰ r ɔ sː
krummi	k r̥ ʏ mː ɪ
krydd	kʰ r ɪ tː
krydda	kʰ r ɪ tː a
krækja	kʰ r a iː c a
krít	kʰ r iː t
króm	kʰ r o uː m
króna	kʰ r o u n a
krýna	kʰ r iː n a
kuldi	kʰ ʏ l t ɪ
kunna	kʰ ʏ nː a
kunnur	kʰ ʏ nː ʏ r
kurt	kʰ ʏ r̥ t
kurteisi	kʰ ʏ r̥ t e iː s ɪ
kuðungur	kʰ ʏː ð u ŋ k ʏ r
kvað	kʰ v aː ð
kvef	kʰ v ɛː v
kveikja	kʰ v e iː c a
kveina	kʰ v e iː n a
kvelja	kʰ v ɛ l j a
kveða	kʰ v ɛː ð a
kveðskapur	kʰ v ɛ ð s k aː p ʏ r
kvikasilfur	kʰ v ɪː k a s ɪ l v ʏ r
kvikmynd	kʰ v ɪː k m ɪ n t
kvittun	kʰ v ɪ h t ʏ n
kvæði	kʰ v a iː ð ɪ
kví	kʰ v iː
kvísl	kʰ v i s t l
kvíða	kʰ v iː ð a
kvíði	kʰ v iː ð ɪ
kvöld	kʰ v œ l t
kvöldmatur	kʰ v œ l t m aː t ʏ r
kvörn	kʰ v œ r t n
kvöð	kʰ v œː ð
kynbundinn	cʰ ɪ n p ʏ n t ɪ nː
kynda	cʰ ɪ n t a
kyngja	cʰ i ɲ c a
kynna	cʰ ɪ nː a
kynnir	cʰ ɪ nː ɪ r
kynslóð	cʰ ɪ n s t l o uː ð
kyrrð	cʰ ɪ r ð
kál	kʰ a uː l
kála	kʰ a uː l a
kápa	kʰ a uː p a
kára	kʰ a uː r a
kári	kʰ a uː r ɪ
kæla	cʰ a iː l a
kæliskápur	cʰ a iː l ɪ s k aː p ʏ r
kær	cʰ a iː r
kíkir	cʰ iː c ɪ r
kíló	cʰ iː l o uː
kók	kʰ o uː k
kólna	kʰ o u l n a
kórea	kʰ o uː r ɛː a
kóríander	kʰ o uː r iː j a n t ɛː r
kóða	kʰ o uː ð a
köfnun	kʰ œ p n ʏ n
köfnunarefni	kʰ œ p n ʏ n a r ɛ p n ɪ
köggull	kʰ œ kː ʏ t l
köllun	kʰ œ t l ʏ n
kúga	k uː a
kúka	kʰ uː k a
kúkur	kʰ uː k ʏ r
kúl	kʰ uː l
kúld	kʰ u l t
kútur	kʰ uː t ʏ r
kýli	cʰ iː l ɪ
kýpur	cʰ iː p ʏ r
labba	l a pː a
lag	l aː ɣ
laga	l aː ɣ a
lager	l aː ɣ ɛ r
laginn	l a iː j ɪ nː
lagður	l a ɣ ð ʏ r
lak	l aː k
lakkrís	l a h k r iː s
lamb	l a m p
lambakjöt	l a m p a cʰ œː t
land	l a n t
landafræði	l a n t a f r a iː ð ɪ
landamæri	l a n t a m a iː r ɪ
landbúnaður	l a n t p uː n aː ð ʏ r
landi	l a n t ɪ
landráð	l a n t r a uː ð
landslag	l a n s l aː ɣ
landsvala	l a n t s v aː l a
landsvæði	l a n t s v a iː ð ɪ
langa	l a u ŋ k a
langafi	l a u ŋ k aː v ɪ
lara	l aː r a
last	l a s t
latur	l aː t ʏ r
lauf	l ø yː v
laufblað	l ø y v p l aː ð
laug	l ø yː ɣ
lauga	l ø yː ɣ a
laugardagur	l ø yː ɣ a r t aː ɣ ʏ r
lauma	l ø yː m a
laun	l ø yː n
launahækkun	l ø yː n a h a i h k ʏ n
laus	l ø yː s
lausn	l ø y s t n
lea	l ɛː a
leg	l ɛː ɣ
lega	l ɛː ɣ a
leggja	l ɛ cː a
leggur	l ɛ kː ʏ r
leif	l e iː v
leifar	l e iː v a r
leiftur	l e i f t ʏ r
leiga	l e iː ɣ a
leigja	l e iː j a
leigubíll	l e iː ɣ ʏ p i t l
leika	l e iː k a
leikari	l e iː k aː r ɪ
leikkona	l e iː k kʰ ɔː n a
leikmaður	l e iː k m aː ð ʏ r
leikmynd	l e iː k m ɪ n t
leikskóli	l e i k s k o uː l ɪ
leikur	l e iː k ʏ r
leikvangur	l e iː k v a u ŋ k ʏ r
leir	l e iː r
leit	l e iː t
leiðangur	l e iː ð a u ŋ k ʏ r
leiðari	l e iː ð aː r ɪ
leiðarstef	l e iː ð a r s t ɛː v
leiði	l e iː ð ɪ
leiðindi	l e iː ð ɪ n t ɪ
leiðni	l e i ð n ɪ
leiðrétting	l e i ð r j ɛ h t i ŋ k
leiðsögumaður	l e i ð s œː ɣ ʏ m aː ð ʏ r
leiðtogi	l e i ð tʰ ɔː j ɪ
leiður	l e iː ð ʏ r
lenda	l ɛ n t a
lengd	l e i ŋ k t
lengja	l e i ɲ c a
lengjast	l e i ɲ c a s t
lerki	l ɛ r̥ c ɪ
les	l ɛː s
lesa	l ɛː s a
lesandi	l ɛː s a n t ɪ
lesbía	l ɛ s p iː j a
lest	l ɛ s t
lestun	l ɛ s t ʏ n
lettland	l ɛ h t l a n t
letur	l ɛː t ʏ r
leyfa	l e iː v a
leyfi	l e iː v ɪ
leyna	l e iː n a
leynd	l e i n t
leyndarmál	l e i n t a r m a uː l
leysa	l e iː s a
leysir	l e iː s ɪ r
lifa	l ɪː v a
lifandi	l ɪː v a n t ɪ
lifur	l ɪː v ʏ r
lilja	l ɪ l j a
limgerði	l ɪ m c ɛ r ð ɪ
linna	l ɪ nː a
lipurð	l ɪː p ʏ r ð
lirfa	l ɪ r v a
list	l ɪ s t
litarefni	l ɪː t a r ɛ p n ɪ
litháen	l ɪː t h a uː ɛː n
litháíska	l ɪː t h a uː i s k a
litur	l ɪː t ʏ r
litín	l ɪː tʰ iː n
lið	l ɪː ð
liðamót	l ɪː ð a m o uː t
liður	l ɪː ð ʏ r
ljá	l j a uː
ljón	l j o uː n
ljós	l j o uː s
ljóseind	l j o uː s e i n t
ljóska	l j o u s k a
ljósmóðir	l j o uː s m o uː ð ɪ r
ljóstillífun	l j o uː s t ɪ l l iː v ʏ n
ljótur	l j o uː t ʏ r
ljóð	l j o uː ð
ljóðskáld	l j o u ð s k a u l t
ljúga	l j uː a
ljúka	l j uː k a
lofa	l ɔː v a
loft	l ɔ f t
loftslag	l ɔ f t s l aː ɣ
lofttæmi	l ɔ f t tʰ a iː m ɪ
loga	l ɔː ɣ a
logi	l ɔ iː j ɪ
lok	l ɔː k
loka	l ɔː k a
loki	l ɔː c ɪ
long	l ɔ ŋː
loppa	l ɔ h p a
lortur	l ɔ r̥ t ʏ r
lottó	l ɔ h t o uː
loðinn	l ɔː ð ɪ nː
loðna	l ɔ ð n a
lukka	l ʏ h k a
lundi	l ʏ n t ɪ
lunga	l u ŋ k a
lyf	l ɪː v
lyfta	l ɪ f t a
lygari	l ɪː ɣ aː r ɪ
lygi	l ɪ iː j ɪ
lykill	l ɪː c ɪ t l
lyklaborð	l ɪ h k l a p ɔ r ð
lykt	l ɪ x t
lykta	l ɪ x t a
lyng	l i ŋ k
lyst	l ɪ s t
lá	l a uː
láglendi	l a u ɣ l ɛ n t ɪ
lágmark	l a u ɣ m a r̥ k
lán	l a uː n
lána	l a uː n a
lárus	l a uː r ʏ s
lægð	l a i ɣ ð
læknir	l a i h k n ɪ r
læknisfræði	l a i h k n ɪ s f r a iː ð ɪ
læknisskoðun	l a i h k n ɪ s s k ɔː ð ʏ n
lækur	l a iː k ʏ r
læra	l a iː r a
lærdómur	l a i r t o uː m ʏ r
læri	l a iː r ɪ
læti	l a iː t ɪ
læða	l a iː ð a
lén	l j ɛː n
léreft	l j ɛː r ɛ f t
létta	l j ɛ h t a
léttir	l j ɛ h t ɪ r
léttur	l j ɛ h t ʏ r
léttúð	l j ɛ h t uː ð
líf	l iː v
lífeðlisfræði	l iː v ɛ ð l ɪ s f r a iː ð ɪ
líffræði	l i f f r a iː ð ɪ
líffræðingur	l i f f r a iː ð i ŋ k ʏ r
líffæri	l i f f a iː r ɪ
lífga	l i v k a
lífrænn	l i v r a i t n
lífsgleði	l i f s k l ɛː ð ɪ
líftími	l iː v tʰ iː m ɪ
lífvera	l i v v ɛː r a
lík	l iː k
líka	l iː k a
líkami	l iː kʰ aː m ɪ
líkamsrækt	l iː kʰ a m s r a i x t
líkn	l i h k n
líkna	l i h k n a
líkur	l iː k ʏ r
lím	l iː m
lín	l iː n
língresi	l i n k r ɛː s ɪ
lísa	l iː s a
líta	l iː t a
lítill	l iː t ɪ t l
lítri	l iː t r ɪ
lítt	l i h t
líða	l iː ð a
lóa	l o uː a
lóga	l o uː a
lói	l o uː ɪ
lómur	l o uː m ʏ r
lón	l o uː n
lóð	l o uː ð
lóða	l o uː ð a
lög	l œː ɣ
lögbrot	l œː ɣ p r ɔː t
lögfræði	l œ ɣ f r a iː ð ɪ
lögfræðingur	l œ ɣ f r a iː ð i ŋ k ʏ r
lögga	l œ kː a
löggjafarvald	l œ ɣ c aː v a r v a l t
löggjöf	l œ ɣ c œː v
lögmaður	l œ ɣ m aː ð ʏ r
lögregla	l œ ɣ r ɛ k l a
lögreglustöð	l œ ɣ r ɛ k l ʏ s t œː ð
lömun	l œː m ʏ n
löngun	l ø y ŋ k ʏ n
lötra	l œː t r a
lúta	l uː t a
lútur	l uː t ʏ r
lúða	l uː ð a
lýsi	l iː s ɪ
lýsing	l iː s i ŋ k
lýsingarorð	l iː s i ŋ k aː r ɔ r ð
lýðræðisríki	l i ð r a iː ð ɪ s r iː c ɪ
lýður	l iː ð ʏ r
maggi	m a cː ɪ
magi	m aː j ɪ
magn	m a k n
magnea	m a k n ɛː a
magnús	m a k n uː s
makedónía	m aː kʰ ɛː t o uː n iː j a
makki	m a h c ɪ
mala	m aː l a
mamma	m a mː a
manna	m a nː a
mannasiður	m a nː a s ɪː ð ʏ r
manneskja	m a nː ɛ s c a
manni	m a nː ɪ
mannorð	m a nː ɔ r ð
mannréttindi	m a nː r j ɛ h t ɪ n t ɪ
manntal	m a nː tʰ aː l
mannvirki	m a nː v ɪ r̥ c ɪ
mappa	m a h p a
mar	m aː r
margfaldur	m a r k f a l t ʏ r
margrét	m a r k r j ɛː t
margur	m a r k ʏ r
mari	m aː r ɪ
mark	m a r̥ k
marka	m a r̥ k a
markaður	m a r̥ k a ð ʏ r
markvörður	m a r̥ k v œ r ð ʏ r
mars	m a r̥ s
marteinn	m a r̥ t e i t n
martröð	m a r̥ tʰ r œː ð
marxismi	m a r̥ k s ɪ s m ɪ
maría	m aː r iː j a
mas	m aː s
mat	m aː t
mata	m aː t a
matareitrun	m aː t aː r e iː t r ʏ n
matreiðslubók	m aː t r e i ð s t l ʏ p o uː k
matskeið	m aː t s c e iː ð
mattur	m a h t ʏ r
matur	m aː t ʏ r
matvara	m aː t v aː r a
maí	m a iː
maðkur	m a θ k ʏ r
mega	m e iː ɣ a
megin	m e iː j ɪ n
megn	m ɛ k n
megna	m ɛ k n a
meirihluti	m e iː r ɪ l̥ ʏː t ɪ
meistaraverk	m e i s t aː r a v ɛ r̥ k
meistari	m e i s t aː r ɪ
meiðsl	m e i ð s t l
meiðsli	m e i ð s t l ɪ
mekka	m ɛ h k a
melaskóli	m ɛː l a s k o uː l ɪ
melding	m ɛ l t i ŋ k
melting	m ɛ l̥ t i ŋ k
melur	m ɛː l ʏ r
men	m ɛː n
menga	m e i ŋ k a
mengun	m e i ŋ k ʏ n
menning	m ɛ nː i ŋ k
meri	m ɛː r ɪ
merki	m ɛ r̥ c ɪ
merkja	m ɛ r̥ c a
merkur	m ɛ r̥ k ʏ r
messa	m ɛ sː a
mestur	m ɛ s t ʏ r
mesópótamía	m ɛː s o uː pʰ o uː t a m iː j a
met	m ɛː t
meta	m ɛː t a
metan	m ɛː tʰ aː n
metfé	m ɛː t f j ɛː
metnaður	m ɛ h t n aː ð ʏ r̥
metri	m ɛː t r ɪ
mexíkó	m ɛ k s iː kʰ o uː
mey	m e iː
meyja	m e iː j a
meyr	m e iː r
meðan	m ɛː ð a n
meðferð	m ɛ ð f ɛ r ð
meðlimur	m ɛ ð l ɪː m ʏ r
meðlæti	m ɛ ð l a iː t ɪ
meðstjórnandi	m ɛ ð s t j o u r t n a n t ɪ
meðstjórnendur	m ɛ ð s t j o u r t n ɛ n t ʏ r
meðvitaður	m ɛ ð v ɪː t aː ð ʏ r
mikael	m ɪː kʰ aː ɛː l
mikill	m ɪː c ɪ t l
mikilvægi	m ɪː c ɪ l v a iː j ɪ
mikið	m ɪː c ɪ ð
mikki	m ɪ h c ɪ
millinafn	m ɪ t l ɪ n a p n
milljón	m ɪ l j o uː n
milt	m ɪ l̥ t
milta	m ɪ l̥ t a
minkur	m i ŋ̊ k ʏ r
minna	m ɪ nː a
minni	m ɪ nː ɪ
minnihluti	m ɪ nː ɪ l̥ ʏː t ɪ
minnimáttarkennd	m ɪ nː ɪ m a u h t a r cʰ ɛ n t
minning	m ɪ nː i ŋ k
minnismerki	m ɪ nː ɪ s m ɛ r̥ c ɪ
minnka	m i ŋ̊ k a
minnkun	m i ŋ̊ k ʏ n
misjafn	m ɪː s j a p n
miski	m ɪ s c ɪ
miskunn	m ɪ s k ʏ nː
mistúlka	m ɪː s tʰ u l̥ k a
miða	m ɪː ð a
miðaftann	m ɪː ð a f t a nː
miðaldir	m ɪː ð a l t ɪ r
miðeyra	m ɪː ð e iː r a
miði	m ɪː ð ɪ
miðill	m ɪː ð ɪ t l
miðja	m ɪ ð j a
miðjumaður	m ɪ ð j ʏ m aː ð ʏ r
miðlari	m ɪ ð l aː r ɪ
miðstig	m ɪ ð s t ɪː ɣ
miðvörður	m ɪ ð v œ r ð ʏ r
mjálm	m j a u l m
mjókka	m j o u h k a
mjólk	m j o u l̥ k
mjólka	m j o u l̥ k a
mjólkurkýr	m j o u l̥ k ʏ r cʰ iː r
mjólkursúkkulaði	m j o u l̥ k ʏ r s u h k ʏ l aː ð ɪ
mjór	m j o uː r
mjölnir	m j œ l n ɪ r
mjöðm	m j œ ð m
mjöður	m j œː ð ʏ r
mjúkur	m j uː k ʏ r
moll	m ɔ lː
mont	m ɔ n̥ t
monta	m ɔ n̥ t a
morgunmatur	m ɔ r k ʏ n m aː t ʏ r
morgunn	m ɔ r k ʏ nː
morgunverður	m ɔ r k ʏ n v ɛ r ð ʏ r
morthens	m ɔ r̥ t ɛ n s
morð	m ɔ r ð
morðingi	m ɔ r ð i ɲ c ɪ
mosi	m ɔː s ɪ
moska	m ɔ s k a
muna	m ʏː n a
mund	m ʏ n t
munkur	m u ŋ̊ k ʏ r
munni	m ʏ nː ɪ
munnur	m ʏ nː ʏ r
munstur	m ʏ n s t ʏ r
munu	m ʏː n ʏ
munur	m ʏː n ʏ r
mygla	m ɪ k l a
mynd	m ɪ n t
mynda	m ɪ n t a
myndarlegur	m ɪ n t a r l ɛː ɣ ʏ r
myndavél	m ɪ n t a v j ɛː l
mynt	m ɪ n̥ t
myrkur	m ɪ r̥ k ʏ r
myrkvi	m ɪ r̥ k v ɪ
myrða	m ɪ r ð a
mysa	m ɪː s a
má	m a uː
mágur	m a uː ʏ r
mál	m a uː l
málband	m a u l p a n t
málfar	m a u l f aː r
málfrelsi	m a u l f r ɛ l s ɪ
málfræði	m a u l f r aː i ð ɪ
málmey	m a u l m e iː
málning	m a u l n i ŋ k
málsgrein	m a u l s k r e iː n
málsháttur	m a u l s h a u h t ʏ r
máltíð	m a u l tʰ iː ð
málverk	m a u l v ɛ r̥ k
máni	m a uː n ɪ
mánudagur	m a uː n ʏ t aː ɣ ʏ r
mánuður	m a uː n ʏː ð ʏ r
már	m a uː r
mát	m a uː t
máta	m a uː t a
mæla	m a iː l a
mæna	m a iː n a
mæta	m a iː t a
mæðgur	m a i ð k ʏ r
mæði	m a iː ð ɪ
mí	m iː
mía	m iː j a
míga	m iː ɣ a
mínus	m iː n ʏ s
mínúta	m iː n uː t a
mólendi	m o uː l ɛ n t ɪ
mót	m o uː t
móta	m o uː t a
mótbára	m o uː t p a uː r a
mótmæla	m o uː t m a iː l a
mótorhjól	m o uː t ɔ r ç o uː l
móttaka	m o uː t tʰ aː k a
mótun	m o uː t ʏ n
móðga	m o u ð k a
móðir	m o uː ð ɪ r
móður	m o uː ð ʏ r
móðurbróðir	m o uː ð ʏ r p r o uː ð ɪ r
móðurmál	m o uː ð ʏ r m a uː l
móðursystir	m o uː ð ʏ r s ɪ s t ɪ r
möller	m œ lː ɛ r
mör	m œː r
mötun	m œː t ʏ n
múhameð	m uː h a m ɛː ð
múslimi	m u s t l ɪː m ɪ
múta	m uː t a
mýfluga	m iː f l ʏː ɣ a
mýkt	m i x t
mýri	m iː r ɪ
mývatn	m iː v aʰ t n
nafar	n aː v a r
nafli	n a p l ɪ
nafn	n a p n
nafna	n a p p a
nafni	n a p n ɪ
nagdýr	n a ɣ t iː r
nagladekk	n a k l a t ɛ h k
namm	n a mː
nammi	n a mː ɪ
narta	n a r̥ t a
natrín	n aː t r iː n
naut	n ø yː t
nautakjöt	n ø yː t a cʰ œː t
nauðgun	n ø y ð k ʏ n
nauðsynlegur	n ø y ð s ɪ n l ɛː ɣ ʏ r
nef	n ɛː v
nefna	n ɛ p n a
nefnd	n ɛ m t
nei	n e iː
nema	n ɛː m a
nemandi	n ɛː m a n t ɪ
nemi	n ɛː m ɪ
nenna	n ɛ nː a
nenni	n ɛ nː ɪ
nes	n ɛː s
nesti	n ɛ s t ɪ
net	n ɛː t
netfang	n ɛː t f a u ŋ k
netla	n ɛ h t l a
neysla	n e i s t l a
neyða	n e iː ð a
nielsen	n i l s ɛ nː
niður	n ɪː ð ʏ r
niðurgangur	n ɪː ð ʏ r k a u ŋ k ʏ r
niðurlæging	n ɪː ð ʏ r l a iː j i ŋ k
niðurlægja	n ɪː ð ʏ r l a iː j a
niðurskurður	n ɪː ð ʏ r s k ʏ r ð ʏ r
niðurstaða	n ɪː ð ʏ r s t aː ð a
njáll	n j a u t l
njósnari	n j o u s t n aː r ɪ
njóta	n j o uː t a
nokkur	n ɔ h k ʏ r
norræna	n ɔ r r a iː n a
norska	n ɔ r̥ s k a
norðaustur	n ɔ r ð ø y s t ʏ r
norðdahl	n ɔ r ð t aː l
norðmaður	n ɔ r ð m aː ð ʏ r
norðurljós	n ɔ r ð ʏ r l j o uː s
norðvestur	n ɔ r ð v ɛ s t ʏ r
nostalgía	n ɔ s t a l c i j a
not	n ɔː t
nota	n ɔː t a
notandi	n ɔː t a n t ɪ
nudda	n ʏ tː a
nyrðra	n ɪ r ð r a
nábrók	n a uː p r o uː k
nágranni	n a uː k r a nː ɪ
nákvæmlega	n a uː kʰ v a i m l ɛː ɣ a
nál	n a uː l
nálarauga	n a uː l a r ø yː ɣ a
nám	n a uː m
nánd	n a u n t
náttúra	n a u h t uː r a
náungi	n a uː u ɲ c ɪ
náð	n a uː ð
nægja	n a iː j a
næla	n a iː l a
næmi	n a iː m ɪ
næra	n a iː r a
nærmynd	n a i r m ɪ n t
nærvera	n a i r v ɛː r a
næs	n a iː s
næsta	n a i s t a
næstur	n a i s t ʏ r
nætur	n a iː t ʏ r
né	n j ɛː
nína	n iː n a
níundi	n iː j ʏ n t ɪ
nóg	n o uː
nói	n o uː ɪ
nökkvi	n œ h k v ɪ
nös	n œː s
nú	n uː
núll	n u lː
núna	n uː n a
núningur	n uː n i ŋ k ʏ r
núpur	n uː p ʏ r
nútíð	n uː tʰ iː ð
nýlega	n iː l ɛː ɣ a
nýr	n iː r
nýting	n iː t i ŋ k
nýyrðasmíð	n iː ɪ r ð a s m iː ð
oddur	ɔ tː ʏ r
oddviti	ɔ tː v ɪ t ɪ
ofan	ɔː v a n
ofbeldi	ɔ v p ɛ l t ɪ
offita	ɔ f f ɪː t a
ofn	ɔ p n
ofnæmi	ɔ v n a iː m ɪ
ofurhetja	ɔː v ʏ r h ɛː t j a
ofviðri	ɔ v v ɪ ð r ɪ
ofvæni	ɔ v v a iː n ɪ
ok	ɔː k
okkar	ɔ h k ɐ r
okkur	ɔ h k ʏ r
olgeirína	ɔ l c e iː r iː n a
olía	ɔː l iː j a
op	ɔ p
opinberun	ɔː p ɪ n p ɛː r ʏ n
opna	ɔ h p n a
opnun	ɔ h p n ʏ n
opnunartími	ɔ h p n ʏː n aː r tʰ iː m ɪ
orf	ɔ r v
organisti	ɔ r k a n ɪ s t ɪ
orgel	ɔ r k ɛː l
orka	ɔ r̥ k a
orsök	ɔ r̥ s œː k
orð	ɔ r ð
orða	ɔ r ð a
orðstír	ɔ r ð s tʰ iː r
ostakaka	ɔ s t a kʰ aː k a
pakki	pʰ a h c ɪ
palestína	pʰ aː l ɛ s t iː n a
panna	pʰ a nː a
panta	pʰ a n̥ t a
pappír	pʰ a h p iː r
par	pʰ aː r
partur	pʰ a r̥ t ʏ r
partí	pʰ a r̥ t i
parís	pʰ aː r iː s
pasta	pʰ a s t a
pendúll	pʰ ɛ n t ʏ t l
peningur	pʰ ɛː n i ŋ k ʏ r
penni	pʰ ɛ nː ɪ
perla	pʰ ɛ r t l a
persóna	pʰ ɛ r̥ s o uː n a
persónulega	pʰ ɛ r̥ s o uː n ʏ l ɛː ɣ a
petersen	pʰ ɛː t ɛ r̥ s ɛ nː
pils	pʰ ɪ l s
piltur	pʰ ɪ l̥ t ʏ r
pinni	pʰ ɪ nː ɪ
pipar	pʰ ɪː p a r
pirra	pʰ ɪ rː a
pissa	pʰ ɪ sː a
pistill	pʰ ɪ s t ɪ t l
planta	pʰ l a n̥ t a
plast	pʰ l a s t
plata	pʰ l aː t a
plága	pʰ l a uː a
pláss	pʰ l a u sː
plástur	pʰ l a u s t ʏ r
plús	pʰ l uː s
poka	pʰ ɔː k a
poki	pʰ ɔː c ɪ
polli	pʰ ɔ lː ɪ
popp	pʰ ɔ h p
poppkorn	pʰ ɔ h p kʰ ɔ r t n
posi	pʰ ɔː s ɪ
postuli	pʰ ɔ s t ʏː l ɪ
pottur	pʰ ɔ h t ʏ r
predika	pʰ r ɛː t ɪː k a
predikun	pʰ r ɛː t ɪ k ʏ n
prenta	pʰ r ɛ n̥ t a
prentsmiðja	pʰ r ɛ n̥ t s m ɪ ð j a
prentun	pʰ r ɛ n̥ t ʏ n
prestastefna	pʰ r ɛ s t a s t ɛ p n a
prestur	pʰ r ɛ s t ʏ r
prins	pʰ r ɪ n s
prinsessa	pʰ r ɪ n s ɛ sː a
prísund	pʰ r iː s ʏ n t
próf	pʰ r o uː v
prófa	pʰ r o uː v a
prófastur	pʰ r o uː v a s t ʏ r
prófessor	pʰ r o uː f ɛ sː ɔ r
prófun	pʰ r o uː v ʏ n
prósenta	pʰ r o uː s ɛ n̥ t a
prýði	pʰ r iː ð ɪ
pund	pʰ ʏ n t
punda	pʰ ʏ n t a
pynta	pʰ ɪ n̥ t a
páll	pʰ a u t l
pálmar	pʰ a u l m a r
pása	pʰ a uː s a
pé	pʰ j ɛː
pétur	p j ɛː t ʏ r
pía	pʰ iː j a
píanó	pʰ iː j aː n o uː
píla	pʰ iː l a
pínulítill	pʰ iː n ʏ l iː t ɪ t l
pípa	pʰ iː p a
pólland	p o u l l a n t
pólska	pʰ o u l s k a
póstkort	pʰ o u s t kʰ ɔ r̥ t
póstur	pʰ o u s t ʏ r
pönnukaka	pʰ œ nː ʏ kʰ aː k a
pöntun	pʰ œ n̥ t ʏ n
púls	pʰ u l s
pútta	pʰ u h t a
púði	pʰ uː ð ɪ
púður	pʰ uː ð ʏ r
radar	r aː t a r
raddblær	r a tː p l a iː r
raftur	r a f t ʏ r
ragnar	r a k n aː r
ragnarök	r a k n a r œː k
ragnheiður	r a k n h e iː ð ʏ r
rak	r aː k
raka	r aː k a
raki	r aː c ɪ
rakvél	r aː k v j ɛː l
rammi	r a mː ɪ
rann	r a nː
rannsókn	r a nː s o u h k n
rasismi	r aː s ɪ s m ɪ
rata	r aː t a
ratsjá	r aː t s j a uː
rauf	r ø yː v
raula	r ø yː l a
raun	r ø yː n
raust	r ø y s t
rauðleitur	r ø y ð l e iː t ʏ r
rauður	r ø yː ð ʏ r
rauðvín	r ø y ð v iː n
raða	r aː ð a
redda	r ɛ tː a
refsa	r ɛ f s a
refsing	r ɛ f s i ŋ k
refur	r ɛː v ʏ r
regla	r ɛ k l a
reglugerð	r ɛ k l ʏ c ɛ r ð
regn	r ɛ k n
reikistjarna	r e iː c ɪ s t j a r t n a
reikningur	r e i h k n i ŋ k ʏ r
rein	r e iː n
reipi	r e iː p ɪ
reisa	r e iː s a
reisn	r e i s t n
reitur	r e iː t ʏ r
reið	r e iː ð
reiða	r e iː ð a
reiði	r e iː ð ɪ
reiðubúinn	r e iː ð ʏ p uː ɪ nː
reiður	r e iː ð ʏ r
reka	r ɛː k a
rekja	r ɛː c a
renta	r ɛ n̥ t a
reykja	r e iː c a
reykur	r e iː k ʏ r
reyna	r e iː n a
reynd	r e i n t
reyndar	r e i n t a r
reynir	r e iː n ɪ r
reynsla	r e i n s t l a
reyta	r e iː t a
riddari	r ɪ tː a r ɪ
rifrildi	r ɪ v r ɪ l t ɪ
rifs	r ɪ f s
rigna	r ɪ k n a
rigning	r ɪ k n i ŋ k
rimma	r ɪ mː a
ris	r ɪː s
risi	r ɪː s ɪ
rismál	r ɪː s m a uː l
rispa	r ɪ s p a
rissa	r ɪ sː a
rist	r ɪ s t
rit	r ɪː t
rita	r ɪː t a
ritari	r ɪː t a r ɪ
ritgerð	r ɪː t c ɛ r ð
rithöfundur	r ɪː t h œː v ʏ n t ʏ r
rið	r ɪː ð
riðill	r ɪː ð ɪ t l
riðla	r ɪ ð l a
rjómaostur	r j o uː m a ɔ s t ʏ r
rjómaís	r j o uː m a iː s
rjúfa	r j uː v a
rjúpa	r j uː p a
romm	r ɔ mː
rot	r ɔː t
rota	r ɔː t a
rotna	r ɔ h t n a
rugga	r ʏ kː a
rugl	r ʏ k l
rugla	r ʏ k l a
rukka	r ʏ h k a
rusl	r ʏ s t l
rustikus	r ʏ s t ɪ kʰ ʏ s
ryk	r ɪː k
ryðfrír	r ɪ ð f r iː r
ryðja	r ɪ ð j a
rák	r a uː k
rán	r a uː n
rás	r a uː s
ráð	r a uː ð
ráða	r a uː ð a
ráðabrugg	r a uː ð a p r ʏ kː
ráðgáta	r a u ð k a uː t a
ráðning	r a u ð n i ŋ k
ráðríkur	r a u ð r iː k ʏ r
rækt	r a i x t
rækta	r a i x t a
ræna	r a iː n a
ræða	r a iː ð a
réttindi	r j ɛ h t ɪ n t ɪ
réttlæti	r j ɛ h t l a iː t ɪ
réttur	r j ɛ h t ʏ r
rífa	r iː v a
rífast	r iː v a s t
ríkharður	r iː k h a r ð ʏ r
ríki	r iː c ɪ
ríkidæmi	r iː c ɪ t a iː m ɪ
ríkisborgari	r iː c ɪ s p ɔ r k a r ɪ
ríkja	r iː c a
ríkur	r iː k ʏ r
rím	r iː m
rís	r iː s
ríða	r iː ð a
ró	r o uː
ról	r o uː l
rólegur	r o uː l ɛː ɣ ʏ r
rós	r o uː s
róður	r o uː ð ʏ r
rödd	r œ tː
rök	r œː k
rökfræði	r œː k f r a iː ð ɪ
rökkur	r œ h k ʏ r
rölt	r œ l̥ t
rölta	r œ l̥ t a
rönd	r œ n t
rör	r œː r
röskun	r œ s k ʏ n
röð	r œː ð
rúgur	r uː ʏ r
rúmur	r uː m ʏ r
rúnar	r uː n aː r
rússland	r u s t l a n t
rússneska	r u sː n ɛ s k a
rússneskur	r u sː t n ɛ s k ʏ r
rúsína	r uː s iː n a
rými	r iː m ɪ
rýna	r iː n a
rýr	r iː r
safamikill	s aː v a m ɪː c ɪ t l
safi	s aː v ɪ
sag	s aː ɣ
saga	s aː ɣ a
sagnfræði	s a k n f r a iː ð ɪ
sagnfræðingur	s a k n f r a iː ð i ŋ k ʏ r
sagnorð	s a k n ɔ r ð
sakaskrá	s aː k a s k r a uː
sakna	s a h k n a
sala	s aː l a
salat	s aː l aː t
salerni	s aː l ɛ r t n ɪ
salt	s a l̥ t
saltfiskur	s a l̥ t f ɪ s k ʏ r
samanburður	s aː m a n p ʏ r ð ʏ r
samband	s a m p a n t
sambland	s a m p l a n t
sameina	s aː m e iː n a
samfélag	s a m f j ɛː l aː ɣ
samheiti	s aː m h e iː t ɪ
samhengi	s a m h e i ɲ c ɪ
samhljómur	s a m l̥ j o uː m ʏ r
samkeppni	s a m cʰ ɛ h p n ɪ
samkvæmt	s a m kʱ v a i m̥ t
samlyndi	s a m l ɪ n t ɪ
samræmi	s a m r a iː m ɪ
samur	s aː m ʏ r
samvinna	s a m v ɪ nː a
samúel	s aː m uː ɛː l
samþykki	s a m θ ɪ h c ɪ
samþykkja	s a m θ ɪ h c a
samþykkt	s a m θ ɪ x t
sandur	s a n t ʏ r
sannarlega	s a nː a r l ɛː ɣ a
sannfæra	s a nː f a iː r a
sannfærandi	s a nː f a iː r a n t ɪ
sannindi	s a nː ɪ n t ɪ
sannlega	s a nː l ɛː ɣ a
sannleikur	s a nː l e iː k ʏ r
sannur	s a nː ʏ r
sara	s aː r a
sauma	s ø yː m a
schiöth	s c œ h t
sef	s ɛː v
sefur	s ɛː v ʏ r
segja	s e iː j a
segð	s ɛ ɣ ð
seinn	s e i t n
seiða	s e iː ð a
seiði	s e iː ð ɪ
sekkur	s ɛ h k ʏ r
sekt	s ɛ x t
sekur	s ɛː k ʏ r
selja	s ɛ l j a
sellerí	s ɛ lː ɛː r iː
selma	s ɛ l m a
selur	s ɛː l ʏ r
semball	s ɛ m p a t l
semja	s ɛ m j a
senda	s ɛ n t a
sendinn	s ɛ n t ɪ nː
senna	s ɛ nː a
sennilega	s ɛ nː ɪ l ɛː ɣ a
serbi	s ɛ r p ɪ
serótónín	s ɛː r o uː tʰ o uː n iː n
sess	s ɛ sː
setning	s ɛ h t n i ŋ k
seytla	s e i h t l a
seðill	s ɛː ð ɪ t l
sif	s ɪː v
sig	s ɪː ɣ
sigfús	s ɪ x f uː s
siggi	s ɪ cː ɪ
sigla	s ɪ k l a
siglt	s ɪ ɬ t
sigmar	s ɪ ɣ m aː r
sigmundur	s ɪ ɣ m ʏ n t ʏ r
sigríður	s ɪ ɣ r iː ð ʏ r
sigurdís	s ɪː ɣ ʏ r t iː s
sigurðsson	s ɪː ɣ ʏ r ð s s ɔː n
sigurður	s ɪː ɣ ʏ r ð ʏ r
sikiley	s ɪː c ɪ l e iː
silfur	s ɪ l v ʏ r
silja	s ɪ l j a
silki	s ɪ l̥ c ɪ
sinfóníuhljómsveit	s ɪ n f o uː n iː j ʏ l̥ j o u m s v e iː t
sinn	s ɪ nː
sinni	s ɪ nː ɪ
sitja	s ɪː t j a
sitjandi	s ɪː t j a n t ɪ
sitkagreni	s ɪː t k a k r ɛː n ɪ
siður	s ɪː ð ʏ r
sjaldgæfur	s j a l t c a iː v ʏ r
sjampó	s j a m̥ p o uː
sjá	s j a uː
sjáland	s j a uː l a n t
sjálfsfróun	s j a u l v s f r o uː ʏ n
sjálfsmynd	s j a u l v s m ɪ n t
sjálfur	s j a u l v ʏ r
sjáumst	s j aː u ʏ m̥ s t
sjóher	s j o uː h ɛː r
sjón	s j o uː n
sjónvarp	s j o u n v a r̥ p
sjór	s j o uː r
sjóveiki	s j o uː v e iː c ɪ
sjóða	s j o uː ð a
sjóður	s j o uː ð ʏ r
sjö	s j ø
sjöundi	s j œː ʏ n t ɪ
sjúkdómur	s j uː k t o uː m ʏ r
sjúkrahús	s j uː k r a h uː s
sjúkur	s j uː k ʏ r
skak	s k aː k
skalla	s k a t l a
skammur	s k a mː ʏ r
skapa	s k aː p a
skapari	s k aː p a r ɪ
skaplyndi	s k aː p l ɪ n t ɪ
skarfur	s k a r v ʏ r
skarpur	s k a r̥ p ʏ r
skart	s k a r̥ t
skattur	s k a h t ʏ r
skaut	s k ø yː t
skaðlegur	s k a ð l ɛː ɣ ʏ r
ske	s c ɛː
skegg	s c ɛ kː
skeina	s c e iː n a
skeið	s c e iː ð
skekkja	s c ɛ h c a
skella	s c ɛ t l a
skema	s c ɛː m a
skemma	s c ɛ mː a
skemmd	s c ɛ m t
skemmta	s c ɛ m̥ t a
skemmtilegur	s k ɛ m̥ t ɪ l ɛː ɣ ʏ r
skepna	s c ɛ h p n a
skera	s c ɛː r a
skermur	s c ɛ r m ʏ r
skerða	s c ɛ r ð a
skil	s c ɪː l
skila	s c ɪː l a
skilja	s c ɪ l j a
skiljanlega	s c ɪ l j a n l ɛː ɣ a
skiljanlegur	s c ɪ l j a n l ɛː ɣ ʏ r
skilningur	s c ɪ l n i ŋ k ʏ r
skin	s c ɪː n
skinn	s c ɪ nː
skinna	s k ɪ nː a
skipaskurður	s c ɪː p a s k ʏ r ð ʏ r
skipun	s c ɪː p ʏ n
skissa	s c ɪ sː a
skjal	s c aː l
skjaldarmerki	s c a l t a r m ɛ r̥ k ɪ
skjálfa	s c a u l v a
skjálfti	s c a u l̥ t ɪ
skjár	s c a uː r
skjól	s c o uː l
skjóta	s c o uː t a
skjöldur	s c œ l t ʏ r
skolli	s k ɔ t l ɪ
skoppa	s k ɔ h p a
skora	s k ɔː r a
skordýr	s k ɔ r t iː r
skortur	s k ɔ r̥ t ʏ r
skot	s k ɔː t
skoti	s k ɔː t ɪ
skotland	s k ɔː t l a n t
skotvopn	s k ɔː t v ɔ h p n
skoða	s k ɔː ð a
skraut	s k r ø yː t
skref	s k r ɛː v
skreppa	s k r ɛ h p a
skreyta	s k r e iː t a
skrifa	s k r ɪː v a
skriflegur	s k r ɪ v l ɛː ɣ ʏ r
skrifstofa	s k r ɪ f s t ɔː v a
skrið	s k r ɪː ð
skriðdreki	s k r ɪ ð t r ɛː c ɪ
skrá	s k r a uː
skráning	s k r a uː n i ŋ k
skrímsli	s k r i m s t l ɪ
skrúðganga	s k r u ð k a u ŋ k a
skuggi	s k ʏ cː ɪ
skulda	s k ʏ l t a
skuldari	s k ʏ l t aː r ɪ
skulu	s k ʏː l ʏ
skurðaðgerð	s k ʏ r ð a ð c ɛ r ð
skylda	s c ɪ l t a
skyn	s c ɪː n
skynsemi	s c ɪ n s ɛː m ɪ
skyr	s c ɪː r
skytta	s c ɪ h t a
skák	s k a uː k
skál	s k a uː l
skála	s k a uː l a
skáld	s k a u l t
skáldsaga	s k a u l t s aː ɣ a
skán	s k a uː n
skána	s k a uː n a
skápur	s k a uː p ʏ r
skárri	s k a u rː ɪ
skáti	s k a uː t ɪ
skær	s c a iː r
skína	s c iː n a
skíra	s c iː r a
skíta	s c iː t a
skítugur	s c iː t ʏː ɣ ʏ r
skíða	s c iː ð a
skíði	s c iː ð ɪ
skóf	s k o uː v
skólaár	s k o uː l a a uː r
skór	s k o uː r
skósmiður	s k o uː s m ɪː ð ʏ r
skömm	s k œ mː
sköp	s k œː p
ský	s c iː
skýla	s c iː l a
skýli	s c iː l ɪ
skýr	s c iː r
skýra	s c iː r a
skýring	s c iː r i ŋ k
skýrsla	s c i r̥ s t l a
slag	s t l aː ɣ
slagsmál	s t l a x s m a uː l
slakna	s t l a h k n a
slakur	s t l aː k ʏ r
slanga	s t l a u ŋ k a
slasa	s t l aː s a
slefa	s t l ɛː v a
sleikja	s t l e iː c a
sleppa	s t l ɛ h p a
slitna	s t l ɪ h t n a
slydda	s t l ɪ tː a
slys	s t l ɪː s
slá	s t l a uː
slátra	s t l a uː t r a
sláttur	s t l a u h t ʏ r
slátur	s t l a uː t ʏ r
slægur	s l a iː ɣ ʏ r
slésvík	s t l j ɛː s v iː k
slétta	s t l j ɛ h t a
sléttur	s t l j ɛ h t ʏ r
slíkur	s t l iː k ʏ r
slóð	s t l o uː ð
slúður	s t l uː ð ʏ r
smakka	s m a h k a
smali	s m aː l ɪ
smekklegur	s m ɛ h k l ɛː ɣ ʏ r
smekkur	s m ɛ h k ʏ r
smella	s m ɛ t l a
smit	s m ɪː t
smiðja	s m ɪ ð j a
smjör	s m j œː r
smokkur	s m ɔ h k ʏ r
smyrsl	s m ɪ r̥ s t l
smá	s m a uː
smári	s m a uː r ɪ
smásjá	s m a uː s j a uː
smíð	s m iː ð
snarl	s t n a r t l
snarpur	s n a r̥ p ʏ r
snemma	s n ɛ mː a
snerta	s n ɛ r̥ t a
snillingur	s t n ɪ t l i ŋ k ʏ r
snið	s t n ɪː ð
snjall	s t n j a t l
snuð	s t n ʏː ð
snákur	s t n a uː k ʏ r
snæfríður	s t n a iː f r iː ð ʏ r
snæri	s t n a iː r ɪ
sníkja	s n iː c a
snípur	s t n iː p ʏ r
sníða	s n iː ð a
snúður	s t n uː ð ʏ r
sofa	s ɔː v a
soffía	s ɔ fː iː j a
sofna	s ɔ p n a
solla	s ɔː l a
sonur	s ɔː n ʏ r
sorg	s ɔ r k
sortna	s ɔ r̥ t n a
sparka	s p a r̥ k a
sparnaður	s p a r t n aː ð ʏ r
spauga	s p ø yː ɣ a
spað	s p aː ð
spegill	s p e iː j ɪ t l
speki	s p ɛː c ɪ
spendýr	s p ɛ n t iː r
spenna	s p ɛ nː a
spennandi	s p ɛ nː a n t ɪ
spenntur	s p ɛ n̥ t ʏ r
spergilkál	s p ɛ r c ɪ l kʰ a uː l
spil	s p ɪː l
spila	s p ɪː l a
spjald	s p j a l t
spjalla	s p j a t l a
spjót	s p j o uː t
sprauta	s p r ø yː t a
sprettur	s p r ɛ h t ʏ r
springa	s p r i ŋ k a
sprunga	s p r u ŋ k a
spurning	s p ʏ r t n i ŋ k
spá	s p a uː
spámaður	s p a uː m aː ð ʏ r
spánverji	s p a u n v ɛ r j ɪ
spænska	s p a i n s k a
spíra	s p iː r a
spítali	s p iː tʰ aː l ɪ
spói	s p o uː ɪ
spónn	s p o u t n
stafa	s t aː v a
stafafura	s t aː v a f ʏː r a
stafla	s t a p l a
stafur	s t aː v ʏ r
stak	s t aː k
standa	s t a n t a
stansa	s t a n s a
stappa	s t a h p a
starf	s t a r v
starfa	s t a r v a
starfsemi	s t a r v s ɛː m ɪ
staða	s t aː ð a
staðall	s t aː ð a t l
staðhæfa	s t a ð h a iː v a
staður	s t aː ð ʏ r
stef	s t ɛː v
stefna	s t ɛ p n a
stefni	s t ɛ p n ɪ
stefnuljós	s t ɛ p n ʏ l j o uː s
stein	s t e iː n
steindór	s t e i n t o uː r
steinefni	s t e iː n ɛ p n ɪ
steinn	s t e i t n
steinunn	s t e iː n ʏ nː
stella	s t ɛ lː a
stemma	s t ɛ mː a
stephensen	s t ɛː f ɛ n s ɛ n
sterkur	s t ɛ r̥ k ʏ r
steypa	s t e iː p a
steytill	s t e iː t ɪ t l
steðji	s t ɛ ð j ɪ
stilkur	s t ɪ l̥ k ʏ r
stilla	s t ɪ t l a
stilling	s t ɪ t l i ŋ k
stimpill	s t ɪ m̥ p ɪ t l
stinnastör	s t ɪ nː a s t œː r
stjarna	s t j a r t n a
stjórnborð	s t j o u r t n p ɔ r ð
stjórnmál	s t j o u r t n m a uː l
stjörnufræði	s t j œ r t n ʏ f r a iː ð ɪ
stofa	s t ɔː v a
stofn	s t ɔ p n
stofna	s t ɔ p n a
stofnfélagi	s t ɔ p n f j ɛː l aː j ɪ
stofnun	s t ɔ p n ʏ n
stokkhólmur	s t ɔ h k h o u l m ʏ r
stormur	s t ɔ r m ʏ r
stoða	s t ɔː ð a
strand	s t r a n t
stranda	s t r a n t a
strauja	s t r ø yː j a
streita	s t r e iː t a
strengja	s t r e i ɲ c a
stress	s t r ɛ sː
stressa	s t r ɛ sː a
streyma	s t r e iː m a
strik	s t r ɪː k
strokka	s t r ɔ h k a
strá	s t r a uː
strákur	s t r a uː k ʏ r
stríð	s t r iː ð
stríða	s t r iː ð a
stund	s t ʏ n t
stunda	s t ʏ n t a
stundum	s t ʏ n t ʏ m
sturla	s t ʏ r t l a
stutt	s t ʏ h t
stuttur	s t ʏ h t ʏ r
stykkja	s t ɪ h c a
styrja	s t ɪ r j a
styrkja	s t ɪ r̥ c a
styrkur	s t ɪ r̥ k ʏ r
stytta	s t ɪ h t a
stytting	s t ɪ h t i ŋ k
styðja	s t ɪ ð j a
stækka	s t a i h k a
stæla	s t a iː l a
stærð	s t a i r ð
stærðfræði	s t a i r ð f r a iː ð ɪ
stæði	s t a iː ð ɪ
stétt	s t j ɛ h t
stía	s t iː j a
stífa	s t iː v a
stíga	s t iː ɣ a
stígur	s t iː ɣ ʏ r
stígvél	s t i ɣ v j ɛː l
stíll	s t i t l
stóll	s t o u t l
stór	s t o uː r
stóð	s t o uː ð
stökk	s t œ h k
stöng	s t ø y ŋ k
stöngull	s t ø y ŋ k ʏ t l
stöð	s t œː ð
stöðugur	s t œː ð ʏ ɣ ʏ r
stöðva	s t œ ð v a
stöðvun	s t œ ð v ʏ n
stýra	s t iː r a
stýri	s t iː r ɪ
sulla	s ʏ t l a
sulta	s ʏ l̥ t a
sumar	s ʏː m aː r
sundlaug	s ʏ n t l ø yː ɣ
sunnan	s ʏ nː a n
suðaustur	s ʏː ð ø y s t ʏ r
suðvestur	s ʏː ð v ɛ s t ʏ r
svaf	s v aː v
svali	s v aː l ɪ
svalir	s v aː l ɪ r
svalur	s v aː l ʏ r
svandís	s v a n t iː s
svanur	s v aː n ʏ r
svartur	s v a r̥ t ʏ r
svefnherbergi	s v ɛ p n h ɛ r p ɛ r c ɪ
svefnpoki	s v ɛ p n pʰ ɔː c ɪ
sveif	s v e iː v
sveifla	s v e i p l a
sveigja	s v e iː j a
sveigur	s v e iː ɣ ʏ r
sveindís	s v e i n t iː s
sveinn	s v e i t n
sveit	s v e iː t
svelta	s v ɛ l̥ t a
sver	s v ɛː r
sverja	s v ɛ r j a
sverrir	s v ɛ rː ɪ r
sverta	s v ɛ r̥ t a
svigi	s v ɪː j ɪ
svik	s v ɪː k
svindla	s v ɪ n t l a
svipta	s v ɪ f t a
sviss	s v ɪ sː
svitna	s v ɪ h t n a
svið	s v ɪː ð
sviði	s v ɪː ð ɪ
svo	s v ɔː
svæla	s v a iː l a
svæði	s v a iː ð ɪ
svífa	s v iː v a
svíkja	s v iː c a
svínakjöt	s v iː n a cʰ œː t
sykur	s ɪː k ʏ r
sykurreyr	s ɪː k ʏ r r e iː r
synd	s ɪ n t
synda	s ɪ n t a
syndga	s ɪ n t k a
syngja	s i ɲ c a
synjun	s ɪ n j ʏ n
systir	s ɪ s t ɪ r
systur	s ɪ s t ʏ r
sá	s a uː
sál	s a uː l
sálmabók	s a u l m a p o uː k
sáning	s a uː n i ŋ k
sápa	s a uː p a
sár	s a uː r
sáta	s a uː t a
sæl	s a i l̥
sæla	s a iː l a
sælgæti	s a i l c a iː t ɪ
sæll	s a i t l̥
sæma	s a iː m a
sæmundur	s a iː m ʏ n t ʏ r
sæng	s a i ŋ k
sænska	s a i n s k a
sær	s a iː r
særa	s a iː r a
sæta	s a iː t a
sæti	s a iː t ɪ
sætta	s a i h t a
sætur	s a iː t ʏ r
sæunn	s a iː j ʏ nː
sérstaklega	s j ɛ r̥ s t aː k l ɛː ɣ a
sérstakur	s j ɛ r̥ s t aː k ʏ r
séríslenskur	s j ɛː r i s t l ɛ n s k ʏ r
sífellt	s iː f ɛ l̥ t
síga	s iː ɣ a
símasamband	s iː m a s a m p a n t
símon	s iː m ɔː n
sínus	s iː n ʏ s
síra	s iː r a
sís	s iː s
síða	s iː ð a
síður	s iː ð ʏ r
sókn	s o ʊ k n̥
sól	s o uː l
sólarlag	s o uː l a r l aː ɣ
sólbað	s o u l p aː ð
sóley	s o uː l e iː
sólon	s o uː l ɔ n
sólsetur	s o u l s ɛː t ʏ r
sólskin	s o u l s k ɪː n
sólveig	s o u l v e iː ɣ
sópa	s o uː p a
sót	s o uː t
sótt	s o u h t
sóun	s o uː ʏ n
sög	s œː ɣ
sögn	s œ k n
sögumaður	s œː ɣ ʏ m aː ð ʏ r
sögur	s œː ɣ ʏ r
sökk	s œ h k
sökkull	s œ h k ʏ t l
sökkva	s œ h k v a
sölvi	s œ l v ɪ
söngur	s ø y ŋ k ʏ r
söngvari	s ø y ŋ k v aː r ɪ
sönnun	s œ nː ʏ n
súld	s u l t
súr	s uː r
súra	s uː r a
súrkál	s u r̥ kʰ a uː l
sýking	s iː c i ŋ k
sýkna	s i h k n a
sýn	s iː n
sýna	s iː n a
sýning	s iː n i ŋ k
sýrland	s i r l a n t
tafla	tʰ a p l a
tagl	tʰ a k l
tak	tʰ aː k
taka	tʰ aː k a
tal	tʰ aː l
tala	tʰ aː l a
tangi	tʰ a u ɲ c ɪ
tankur	tʰ a u n̥ k ʏ r
tap	tʰ aː p
tapa	tʰ aː p a
taska	tʰ a s k a
taug	tʰ ø yː ɣ
taugafræði	tʰ ø yː ɣ a f r a iː ð ɪ
taugakerfi	tʰ ø yː ɣ a cʰ ɛ r v ɪ
taumur	tʰ ø yː m ʏ r
tauta	tʰ ø yː t a
te	tʰ ɛː
tefja	tʰ ɛ v j a
tefla	tʰ ɛ p l a
tegund	tʰ ɛː ɣ ʏ n t
teikn	tʰ e i h k n
teikna	tʰ e i h k n a
teikning	tʰ e i h k n i ŋ k
telja	tʰ ɛ l j a
telma	tʰ ɛ l m a
telpa	tʰ ɛ l̥ p a
tengdadóttir	tʰ e i ŋ t a t o u h t ɪ r
tengill	tʰ e i ɲ c ɪ t l
tengja	tʰ e i ɲ c a
teskeið	tʰ ɛː s k e iː ð
teygja	tʰ e iː j a
thorarensen	tʰ o uː r aː r ɛ n s ɛ nː
thorlacius	tʰ ɔ r l a s iː j ʏ s
thoroddsen	tʰ o uː r ɔ tː s ɛ nː
tif	tʰ ɪː v
tign	tʰ ɪ k n
til	tʰ ɪː l
tilboð	tʰ ɪ l p ɔː ð
tilgangur	tʰ ɪ l k a u ŋ k ʏ r
tilkynning	tʰ ɪ l cʰ ɪ nː i ŋ k
tillit	tʰ ɪ l l ɪː t
tilraun	t ɪ l r ø yː n
tiltaka	tʰ ɪː l tʰ aː k a
tiltekinn	tʰ ɪː l tʰ ɛː c ɪ nː
tiltekt	tʰ ɪː l tʰ ɛ x t
tilviljun	tʰ ɪ l v ɪ l j ʏ n
tilvitnun	tʰ ɪ l v ɪ h t n ʏ n
tinna	tʰ ɪ nː a
tipla	tʰ ɪ h p l a
tjakkur	tʰ j a h k ʏ r
tjald	tʰ j a l t
tjara	tʰ j aː r a
tjá	tʰ j a uː
tjón	tʰ j o uː n
toga	tʰ ɔː ɣ a
togi	tʰ ɔː j ɪ
tollur	tʰ ɔ t l ʏ r
tomma	tʰ ɔ mː a
torfa	tʰ ɔ r v a
torfi	tʰ ɔ r v ɪ
torg	tʰ ɔ r k
traust	tʰ r ø y s t
tregða	tʰ r ɛ ɣ ð a
trekkja	tʰ r ɛ h c a
treyja	tʰ r e iː j a
treysta	tʰ r e i s t a
trikk	tʰ r ɪ h k
tristan	tʰ r ɪ s t a n
trommari	tʰ r ɔ mː aː r ɪ
trompet	tʰ r ɔ m̥ p ɛː t
troða	tʰ r ɔː ð a
tryggur	tʰ r ɪ kː ʏ r
tryggvi	tʰ r ɪ k v ɪ
tré	tʰ r j ɛː
trésmiður	tʰ r j ɛː s m ɪː ð ʏ r
tröll	tʰ r œ t l
trúa	tʰ r uː a
trúfélag	tʰ r uː f j ɛː l aː ɣ
trúr	t r uː r
tugur	tʰ ʏː ɣ ʏ r
tumi	tʰ ʏː m ɪ
tungumál	tʰ u ŋ k ʏ m a uː l
tvenna	tʰ v ɛ nː a
tvisvar	tʰ v ɪː s v aː r
tvíburi	tʰ v iː p ʏː r ɪ
tvíhliða	tʰ v iː l̥ ɪː ð a
tyggja	tʰ ɪ cː a
tyggjó	tʰ ɪ cː o uː
tyrkland	t ɪ r̥ k l a n t
tyrkneska	tʰ ɪ r̥ k n ɛ s k a
tákn	tʰ a u h k n
táningur	tʰ a uː n i ŋ k ʏ r
tæki	tʰ a iː c ɪ
tækifæri	t a iː c ɪ f a iː r ɪ
tækla	tʰ a i h k l a
tæla	tʰ a iː l a
tæpur	tʰ a iː p ʏ r
tær	tʰ a iː r
tæra	tʰ a iː r a
tæta	tʰ a iː t a
tékkland	t j ɛ h k l a n t
tékkneska	tʰ j ɛ h k n ɛ s k a
tígull	tʰ iː ɣ ʏ t l
tík	tʰ iː k
tímabelti	tʰ iː m a p ɛ l̥ t ɪ
tína	tʰ iː n a
tíska	tʰ i s k a
tíu	t iː ʏ
tíð	tʰ iː ð
tíðahvörf	tʰ iː ð a xʷ œ r v
tíðni	tʰ i ð n ɪ
tíður	tʰ iː ð ʏ r
tól	tʰ o uː l
tóm	tʰ o uː m
tómur	tʰ o uː m ʏ r
tón	tʰ o uː n
tónkvísl	tʰ o u n kʰ v i s t l
tónleikar	tʰ o u n l e iː k a r
tónlist	tʰ o u n l ɪ s t
tónlistarskóli	tʰ o u n l ɪ s t a r s k o uː l ɪ
tónn	tʰ o u t n
töf	tʰ œː v
töff	tʰ œ fː
tögl	tʰ œ k l
tölt	tʰ œ l̥ t
tölustafur	tʰ œː l ʏ s t aː v ʏ r
töluverður	tʰ œː l ʏ v ɛ r ð ʏ r
tölvupóstur	tʰ œ l v ʏ pʰ o u s t ʏ r
tönn	tʰ œ nː
túlkur	tʰ u l̥ k ʏ r
tún	tʰ uː n
túrmerik	tʰ u r m ɛː r ɪ k
týna	tʰ iː n a
týr	tʰ iː r
týra	tʰ iː r a
ufsi	ʏ f s ɪ
umdeildur	ʏ m t e i l t ʏ r
umdæmi	ʏ m t a iː m ɪ
umferð	ʏ m f ɛ r ð
umsókn	ʏ m s o u h k n
umtalsverður	ʏ m tʰ a l s v ɛ r ð ʏ r
una	ʏː n a
undanfarinn	ʏ n t a n f aː r ɪ nː
undarlega	ʏ n t a r l ɛː ɣ a
undirbúa	ʏ n t ɪ r p uː a
undirbúningur	ʏ n t ɪ r p uː n i ŋ k ʏ r
undirlag	ʏ n t ɪ r l aː ɣ
undirlendi	ʏ n t ɪ r l ɛ n t ɪ
undra	ʏ n t r a
undrun	ʏ n t r ʏ n
undur	ʏ n t ʏ r
ungi	u ŋ k ɪ
ungur	u ŋ k ʏ r
ungverska	u ŋ k v ɛ r̥ s k a
upp	ʏ h p
upphaf	ʏ h p h aː v
uppi	ʏ h p ɪ
upplifun	ʏ h p l ɪː v ʏ n
uppsalir	ʏ h p s aː l ɪ r
uppsetning	ʏ h p s ɛ h t n i ŋ k
uppspuni	ʏ h p s p ʏː n ɪ
urra	ʏ rː a
vafi	v aː v ɪ
vafra	v a v r a
vafri	v a v r ɪ
vagga	v a kː a
vagn	v a k n
vaka	v aː k a
vakna	v a h k n a
vakt	v a x t
vald	v a l t
valda	v a l t a
valdís	v a l t iː s
valkostur	v a l kʰ ɔ s t ʏ r
vana	v aː n a
vandi	v a n t ɪ
vanilla	v aː n ɪ lː a
vanur	v aː n ʏ r
var	v aː r
vara	v aː r a
varkárni	v a r̥ kʰ a u r t n ɪ
varla	v a r t l a
varða	v a r ð a
vasaúr	v aː s a uː r
vasi	v aː s ɪ
vatn	v aʰ t n
vaxa	v a x s a
vaða	v aː ð a
vega	v ɛː ɣ a
vegir	v eː j i r
vegna	v ɛ k n a
vegur	v ɛː ɣ ʏ r
veifa	v e iː v a
veigra	v e i ɣ r a
veiki	v e iː c ɪ
veikja	v e iː c a
veikur	v e iː k ʏ r
vein	v e iː n
veira	v e iː r a
veiða	v e iː ð a
veiði	v e iː ð ɪ
veiðimaður	v e iː ð ɪ m aː ð ʏ r
vel	v ɛː l
veldi	v ɛ l t ɪ
velgengni	v ɛ l c e i ŋ k n ɪ
velja	v ɛ l j a
vella	v ɛ t l a
velmegun	v ɛ l m ɛː ɣ ʏ n
venda	v ɛ n t a
venja	v ɛ n j a
venus	v ɛː n ʏ s
vera	v ɛː r a
verja	v ɛ r j a
verk	v ɛ r̥ k
verkfæri	v ɛ r̥ k f a iː r ɪ
verkur	v ɛ r̥ k ʏ r
verma	v ɛ r m a
vernd	v ɛ r n t
vernda	v ɛ r n t a
verndari	v ɛ r n t aː r ɪ
verndun	v ɛ r n t ʏ n
verulega	v ɛː r ʏ l ɛː ɣ a
verulegur	v ɛː r ʏ l ɛː ɣ ʏ r
verð	v ɛ r ð
verða	v ɛ r ð a
verðlaun	v ɛ r ð l ø yː n
verðmæti	v ɛ r ð m a iː t ɪ
verður	v ɛ r ð ʏ r
vestari	v ɛ s t aː r ɪ
vestra	v ɛ s t r a
vestri	v ɛ s t r ɪ
vestur	v ɛ s t ʏ r
vetni	v ɛ h t n ɪ
vetrarbraut	v ɛː t r a r p r ø yː t
vettugi	v ɛ h t ʏ j ɪ
vettvangur	v ɛ h t v a u ŋ k ʏ r
vetur	v ɛː t ʏ r
veð	v ɛː ð
veðja	v ɛ ð j a
veður	v ɛː ð ʏ r
veðurfræði	v e ɛ̯ ð ʏ r f r a i̯ ð ɪ
vigdís	v ɪ ɣ t iː s
vigfús	v ɪ x f uː s
vignir	v ɪ k n ɪ r
vigt	v ɪ x t
vigur	v ɪː ɣ ʏ r
vika	v ɪː k a
vikur	v ɪː k ʏ r
vildís	v ɪ l t iː s
vilhjálmur	v ɪ l ç a u l m ʏ r
vilja	v ɪ l j a
vilji	v ɪ l j ɪ
villtur	v ɪ l̥ t ʏ r
vilmundur	v ɪ l m ʏ n t ʏ r
vin	v ɪː n
vinalegur	v ɪː n a l ɛː ɣ ʏ r
vinda	v ɪ n t a
vindur	v ɪ n t ʏ r
vinkill	v i ɲ̊ c ɪ t l
vinna	v ɪ nː a
vinnumaður	v ɪ nː ʏ m aː ð ʏ r
vinur	v ɪː n ʏ r
vinátta	v ɪː n a u h t a
virka	v ɪ r̥ k a
virki	v ɪ r̥ c ɪ
virkja	v ɪ r̥ c a
virkjun	v ɪ r̥ c ʏ n
virkni	v ɪ r̥ k n ɪ
virkur	v ɪ r̥ k ʏ r
virða	v ɪ r ð a
virði	v ɪ r ð ɪ
viss	v ɪ sː
vissa	v ɪ sː a
vist	v ɪ s t
vista	v ɪ s t a
vistfræði	v ɪ s t f r a iː ð ɪ
vit	v ɪː t
vita	v ɪː t a
viti	v ɪː t ɪ
vitlaus	v ɪ h t l ø yː s
vitni	v ɪ h t n ɪ
við	v ɪ ð
viða	v ɪː ð a
viðar	v ɪː ð aː r
viðbragð	v ɪ ð p r a ɣ ð
viðbrögð	v ɪ ð p r œ ɣ ð
viðja	v ɪ ð j a
viðskiptavinur	v ɪ ð s k ɪ f t a v ɪː n ʏ r
viðtal	v ɪ ð tʰ aː l
viður	v ɪː ð ʏ r
vofa	v ɔː v a
voff	v ɔ fː
voffi	v ɔ fː ɪ
vog	v ɔː ɣ
voga	v ɔː ɣ a
von	v ɔː n
vona	v ɔː n a
vonbrigði	v ɔ n p r ɪ ɣ ð ɪ
vondur	v ɔ n t ʏ r
vopn	v ɔ h p n
votlendi	v ɔː t l ɛ n d ɪ
vá	v a uː
væla	v a iː l a
vænn	v a i t n
vænta	v a i n̥ t a
vél	v j ɛː l
vélbúnaður	v j ɛ l p uː n aː ð ʏ r
vélinda	v j ɛː l ɪ n t a
vídalín	v iː t a l iː n
vídd	v i tː
vígi	v iː j ɪ
vígja	v iː j a
vígður	v i ɣ ð ʏ r
vík	v iː k
víkja	v iː c a
víma	v iː m a
vín	v iː n
víns	v i n s
vís	v iː s
vísifingur	v iː s ɪ f i ŋ k ʏ r
víst	v i s t
víti	v iː t ɪ
víða	v iː ð a
víðir	v iː ð ɪ r
víður	v iː ð ʏ r
vök	v œː k
vökva	v œː k v a
völ	v œː l
völlur	v œ t l ʏ r
vör	v œː r
vörumerki	v œː r ʏ m ɛ r̥ c ɪ
vörður	v œ r ð ʏ r
waage	v ɔː ɣ ɛː
ydd	ɪ tː
yfirlit	ɪː v ɪ r l ɪː t
yfirráð	ɪː v ɪ r r a uː ð
yndi	ɪ n t ɪ
ysta	ɪ s t a
yðar	ɪː ð a r
zoëga	s o uː ɛː k aː
áburður	a uː p ʏ r ð ʏ r
ábyrgur	a uː p ɪ r k ʏ r
ábyrgð	a uː p ɪ r ɣ ð
áfall	a uː f a t l
áflog	a uː f l ɔː ɣ
ágætur	a uː c a iː tʰ ʏ r
áhersla	a uː h ɛ r̥ s t l a
áheyrn	a uː h e i r t n̥
áhrif	a uː r̥ ɪː v
áhugamál	a uː h ʏː ɣ a m a uː l
áhugasamur	a u h ʏː ɣ a s aː m ʏ r
áhugi	a uː h ʏ j ɪ
ákaflega	a uː kʰ a v l ɛː ɣ a
áki	a uː c ɪ
ákveða	a uː kʰ v ɛː ð a
ákveðinn	a uː kʰ v ɛː ð ɪ nː
ál	a uː l
álaborg	a uː l a p ɔ r k
álfadrottning	a u l v a t r ɔ h t n i ŋ k
álfheiður	a u l v h e iː ð ʏ r
álit	a uː l ɪː t
áminna	a uː m ɪ nː a
ára	a uː r a
árabátur	a uː r a p a uː t ʏ r
árangur	a uː r a u ŋ k ʏ r
áreiðanlegur	a uː r e iː ð a n l ɛː ɣ ʏ r
árekstur	a uː r ɛ x s t ʏ r
ári	a uː r ɪ
árna	a u r t n a
árstíð	a u r s tʰ iː ð
árás	a uː r a uː s
áræðinn	a uː r a iː ð ɪ nː
ásamt	a uː s a m̥ t
ásdís	a uː s t iː s
áskrifandi	a uː s k r ɪː v a n t ɪ
áslaug	a uː s l ø yː ɣ
ásmundur	a uː s m ʏ n t ʏ r
ást	a u s t
ástfríður	a u s t f r iː ð ʏ r
ástralía	a u s t r a l iː j a
ástríður	a u s t r iː ð ʏ r
ástæða	a u̯ s t a i̯ ð̠ a
ásókn	a uː s o u h k n
ásýnd	a uː s i n t
át	a uː t
átt	a u h t
átti	a u h t ɪ
ávallt	a uː v a l̥ t
ávarpa	a uː v a r̥ p a
ávísun	a uː v iː s ʏ n
áætlun	a uː a i h t l ʏ n
æfa	a iː v a
æfing	a iː v i ŋ k
ægir	a iː j ɪ r
ær	a iː r
æra	a iː r a
æsa	a iː s a
æstur	a i s t ʏ r
æti	a iː t ɪ
ætla	a i h t l a
ætt	a i h t
ættingi	a i h t i ɲ c ɪ
ættkvísl	a i h t kʰ v i s t l
ævi	a iː v ɪ
æviágrip	a iː v ɪ a uː k r ɪː p
æð	a iː ð
æðri	a i ð r ɪ
ég	j ɛ ɣ
éta	j ɛː t a
ímynd	iː m ɪ n t
ís	iː s
ísbjörn	iː s p j œ r t n
íslam	iː s t l aː m
ísland	i s t l a n t
íslendingur	i s t l ɛ n t i ŋ k ʏ r
ísrael	iː s r aː ɛː l
ítalska	iː tʰ a l s k a
ítalía	iː tʰ aː l iː j a
ítreka	iː tʰ r ɛː k a
ítrekað	iː tʰ r ɛː k a ð
ívar	iː v aː r
íþrótt	iː θ r o u h t
íþróttahús	iː θ r o u h t a h uː s
óaðlaðandi	o uː a ð l aː ð a n t ɪ
óbeinn	o uː p e i t n
óbó	o uː p o uː
ógn	o u k n
ógna	o u k n a
óhapp	o uː h a h p
ók	o uː k
ólafur	o uː l aː v ʏ r
ólafía	o uː l a v iː j a
ólga	o u l k a
óléttur	o uː l j ɛ h t ʏ r
ólöf	o uː l œː v
ómerkilegur	o u m ɛ r̥ c ɪ l ɛː ɣ ʏ r
ómögulegur	o uː m œː ɣ ʏ l ɛː ɣ ʏ r
ós	o uː s
ósk	o u s k
óska	o u s k a
ósló	o uː s t l o uː
óttast	o u h t a s t
óvild	o uː v ɪ l t
óðinsvé	o uː ð ɪ n s v j ɛː
óþarflega	o uː θ a r v l ɛː ɣ a
óþekkt	o uː θ ɛ x t
óþægindi	o uː θ a iː j ɪ n t ɪ
öfga	œ v k a
öfund	œː v ʏ n t
ögn	œ k n
ökumaður	œː k ʏ m aː ð ʏ r
ökuskírteini	œː k ʏ s c i r̥ t e iː n ɪ
ökutæki	œː k ʏ tʰ a iː c ɪ
öld	œ l t
ölvun	œ l v ʏ n
önd	œ n t
önn	œ nː
ör	œː r
örlög	œ r l œː ɣ
örn	œ r t n
örva	œ r v a
örvamælir	œ r v a m a iː l ɪ r
öryggisfyrirtæki	œː r ɪ cː ɪ s f ɪː r ɪ r tʰ a iː c ɪ
öskur	œ s k ʏ r
össur	œ sː ʏ r
öxl	œ x s t l
öðruvísi	œ ð r ʏ v iː s ɪ
úlfaldi	u l v a l t ɪ
úlfur	u l v ʏ r
úr	uː r
úran	uː r aː n
útbreiddur	uː t p r e i tː ʏ r
útbreiða	uː t p r e iː ð a
útbreiðsla	uː t p r e i ð s t l a
útdráttur	uː t t r a u h t ʏ r
útgáfa	uː t k a uː v a
útibú	uː t ɪ p uː
útiloka	uː t ɪ l ɔː k a
útlönd	uː t l œ n t
útsaumur	uː t s ø yː m ʏ r
útskýra	uː t s c iː r a
útsýni	uː t s iː n ɪ
útvarp	uː t v a r̥ p
úði	uː ð ɪ
ýja	iː j a
ýmis	iː m ɪ s
ýsa	iː s a
ýta	iː t a
þak	θ aː k
þakka	θ a h k a
þakklátur	θ a h k l a uː t ʏ r
þannig	θ a nː ɪ ɣ
þar	θ aː r
þaðan	θ aː ð a n
þegja	θ e iː j a
þeir	θ e iː r
þekja	θ ɛː c a
þekking	θ ɛ h c i ŋ k
þekkja	θ ɛ h c a
þema	θ ɛː m a
þenja	θ ɛ n j a
þessi	θ ɛ sː ɪ
þeta	θ ɛː t a
þig	θ ɪː ɣ
þiggja	θ ɪ cː a
þingmaður	θ i ŋ k m aː ð ʏ r
þið	θ ɪ ð
þiðna	θ ɪ ð n a
þjálfa	θ j a u l v a
þjálfun	θ j a u l v ʏ n
þjófnaður	θ j o u p n aː ð ʏ r
þjónusta	θ j o uː n ʏ s t a
þjóð	θ j o uː ð
þjóðerni	θ j o uː ð ɛ r t n ɪ
þoka	θ ɔː k a
þol	θ ɔː l
þola	θ ɔː l a
þolandi	θ ɔː l a n t ɪ
þor	θ ɔː r
þorbjörg	θ ɔ r p j œ r k
þorgerður	θ ɔ r c ɛ r ð ʏ r
þorkell	θ ɔ r̥ cʰ ɛ t l
þorlákur	θ ɔ r l a uː k ʏ r
þorna	θ ɔ r t n a
þorri	θ ɔ rː ɪ
þorskur	θ ɔ r̥ s k ʏ r
þorsteinn	θ ɔ r̥ s t e i t n
þorvaldur	θ ɔ r v a l t ʏ r
þras	θ r aː s
þrasa	θ r aː s a
þrauka	θ r ø yː k a
þraut	θ r ø yː t
þrefa	θ r ɛː v a
þrengja	θ r e i ɲ c a
þrenna	θ r ɛ nː a
þrettán	θ r ɛ h t a uː n
þreyta	θ r e iː t a
þriðji	θ r ɪ ð j ɪ
þrái	θ r a uː ɪ
þrándheimur	θ r a u n t h e iː m ʏ r
þráðlaus	θ r a u ð l ø yː s
þræla	θ r a iː l a
þrífa	θ r iː v a
þríleikur	θ r iː l e iː k ʏ r
þróa	θ r o uː a
þröng	θ r ø y ŋ k
þröngur	θ r ø y ŋ k ʏ r
þröstur	θ r œ s t ʏ r
þrýsta	θ r i s t a
þrýstilína	θ r i s t ɪ l iː n a
þungur	θ u ŋ k ʏ r
þunnur	θ ʏ nː ʏ r
þurfa	θ ʏ r v a
þurr	θ ʏ rː
þurrka	θ ʏ r̥ k a
þuríður	θ ʏː r iː ð ʏ r
þverra	θ v ɛ rː a
þvinga	θ v i ŋ k a
þvo	θ v ɔː
þvottur	θ v ɔ h t ʏ r
þvæla	θ v a iː l a
þvættingur	θ v a i h t i ŋ k ʏ r
þykkja	θ ɪ h c a
þykkur	θ ɪ h k ʏ r
þylja	θ ɪ l j a
þyngd	θ i ŋ t
þyngja	θ i ɲ c a
þynna	θ ɪ nː a
þyrla	θ ɪ r t l a
þáttur	θ a u h t ʏ r
þátíð	θ a uː tʰ iː ð
þægindi	θ a iː j ɪ n t ɪ
þéttur	θ j ɛ h t ʏ r
þó	θ o uː
þór	θ o uː r
þórdís	θ o u r t iː s
þórey	θ o uː r e iː
þórhallur	θ o uː r h a t l ʏ r
þóroddur	θ o uː r ɔ tː ʏ r
þórshöfn	θ o u r̥ s h œ p n
þórunn	θ o uː r ʏ nː
þórður	θ o u r ð ʏ r
þórólfur	θ o uː r o u l v ʏ r
þögull	θ œː ɣ ʏ t l
þökk	θ œ h k
þörf	θ œ r v
þörungur	θ œː r u ŋ k ʏ r
þúsund	θ uː s ʏ n t
þýfi	θ iː v ɪ
þýska	θ i s k a
þýskaland	θ i s k a l a n t
þýskur	θ i s k ʏ r
þýðing	θ iː ð i ŋ k
