あい	a̠ i
あいかわらず	a̠ i k a̠ ɰᵝ a̠ ɾ a̠ z ɨᵝ
あいこくしゃ	a̠ i k o̞ k ɯ̟ᵝ ɕ a̠
あいじん	a̠ i ʑ ĩ ɴ
あいぞうばん	a̠ i z o̞ː b ã̠ ɴ
あいだ	a̠ i d a̠
あいにく	a̠ i ɲ̟ i k ɯ̟ᵝ
あいぶ	a̠ i b ɯ̟ᵝ
あおざめ	a̠ o̞ z a̠ m e̞
あおせん	a̠ o̞ s ẽ̞ ɴ
あおば	a̠ o̞ b a̠
あおもりけん	a̠ o̞ m o̞ ɾʲ i k ẽ̞ ɴ
あかぎつね	a̠ k a̠ ɡʲ i t͡s ɨᵝ n e̞
あかぐろい	a̠ k a̠ ɡ ɯ̟ᵝ ɾ o̞ i
あかし	a̠ k a̠ ɕ i
あかす	a̠ k a̠ s ɨᵝ
あかずきん	a̠ k a̠ z ɨᵝ kʲ ĩ ɴ
あかちゃける	a̠ k a̠ t͡ɕ a̠ k e̞ ɾ ɯ̟ᵝ
あかちゃん	a̠ k a̠ t͡ɕ ã̠ ɴ
あかはな	a̠ k a̠ h a̠ n a̠
あかはら	a̠ k a̠ h a̠ ɾ a̠
あかふじ	a̠ k a̠ ɸ ɯ̟ᵝ ʑ i
あかぼし	a̠ k a̠ b o̞ ɕ i
あかり	a̠ k a̠ ɾʲ i
あかるい	a̠ k a̠ ɾ ɯ̟ᵝ i
あかんぼう	a̠ k ã̠ m b o̞ː
あがる	a̠ ɡ a̠ ɾ ɯ̟ᵝ
あき	a̠ kʲ i
あきす	a̠ kʲ i s ɨᵝ
あきなう	a̠ kʲ i n a̠ ɯ̟ᵝ
あきらか	a̠ kʲ i ɾ a̠ k a̠
あきらめる	a̠ kʲ i ɾ a̠ m e̞ ɾ ɯ̟ᵝ
あくじき	a̠ k ɯ̟ᵝ ʑ i kʲ i
あくみょうだかい	a̠ k ɯ̟ᵝ mʲ o̞ː d a̠ k a̠ i
あくめ	a̠ k ɯ̟ᵝ m e̞
あくろ	a̠ k ɯ̟ᵝ ɾ o̞
あぐり	a̠ ɡ ɯ̟ᵝ ɾʲ i
あけぐれ	a̠ k e̞ ɡ ɯ̟ᵝ ɾ e̞
あけぼの	a̠ k e̞ b o̞ n o̞
あけわたす	a̠ k e̞ ɰᵝ a̠ t a̠ s ɨᵝ
あこがれ	a̠ k o̞ ɡ a̠ ɾ e̞
あこがれる	a̠ k o̞ ɡ a̠ ɾ e̞ ɾ ɯ̟ᵝ
あご	a̠ ɡ o̞
あごひげ	a̠ ɡ o̞ ç i ɡ e̞
あさぎり	a̠ s a̠ ɡʲ i ɾʲ i
あさぬの	a̠ s a̠ n ɯ̟ᵝ n o̞
あさひかわ	a̠ s a̠ ç i k a̠ ɰᵝ a̠
あざやか	a̠ z a̠ j a̠ k a̠
あざらし	a̠ z a̠ ɾ a̠ ɕ i
あしあと	a̠ ɕ i a̠ t o̞
あしか	a̠ ɕ i̥ k a̠
あしざま	a̠ ɕ i z a̠ m a̠
あした	a̠ ɕ i̥ t a̠
あしはら	a̠ ɕ i̥ h a̠ ɾ a̠
あしもと	a̠ ɕ i m o̞ t o̞
あすなろ	a̠ s ɨᵝ n a̠ ɾ o̞
あずき	a̠ z ɨᵝ kʲ i
あずける	a̠ z ɨᵝ k e̞ ɾ ɯ̟ᵝ
あせる	a̠ s e̞ ɾ ɯ̟ᵝ
あそう	a s oː
あたいりく	a̠ t a̠ i ɾʲ i k ɯ̟ᵝ
あたたかい	a̠ t a̠ t a̠ k a̠ i
あたらしい	a̠ t a̠ ɾ a̠ ɕ iː
あちら	a̠ t͡ɕ i ɾ a̠
あつかましい	a̠ t͡s ɨᵝ k a̠ m a̠ ɕ i i
あつひろ	a̠ t͡s ɨᵝ ç i ɾ o̞
あつらえる	a̠ t͡s ɨᵝ ɾ a̠ e̞ ɾ ɯ̟ᵝ
あとさき	a̠ t o̞ s a̠ kʲ i
あとつぎ	a̠ t o̞ t͡s ɨᵝ ɡʲ i
あとり	a̠ t o̞ ɾʲ i
あね	a̠ n e̞
あねったい	a̠ n e̞ t̚ t a̠ i
あねぶん	a̠ n e̞ b ɯ̟̃ᵝ ɴ
あば	a̠ b a̠
あばよ	a̠ b a̠ j o̞
あばら	a̠ b a̠ ɾ a̠
あびる	a̠ bʲ i ɾ ɯ̟ᵝ
あぶなっかしい	a̠ b ɯ̟ᵝ n a̠ k̚ k a̠ ɕ iː
あぶらよたか	a̠ b ɯ̟ᵝ ɾ a̠ j o̞ t a̠ k a̠
あほうどり	a̠ h o̞ː d o̞ ɾʲ i
あま	a̠ m a̠
あまおと	a̠ m a̠ o̞ t o̞
あまからい	a̠ m a̠ k a̠ ɾ a̠ i
あまぐつ	a̠ m a̠ ɡ ɯ̟ᵝ t͡s ɨᵝ
あまぐも	a̠ m a̠ ɡ ɯ̟ᵝ m o̞
あまでら	a̠ m a̠ d e̞ ɾ a̠
あみだぶつ	a̠ mʲ i d a̠ b ɯ̟ᵝ t͡s ɨᵝ
あみてん	a̠ mʲ i t ẽ̞ ɴ
あみの	a̠ mʲ i n o̞
あみもの	a̠ mʲ i m o̞ n o̞
あやか	a̠ j a̠ k a̠
あやとり	a̠ j a̠ t o̞ ɾʲ i
あやまつ	a̠ j a̠ m a̠ t͡s ɨᵝ
あゆこ	a̠ j ɯ̟ᵝ k o̞
あゆむ	a̠ j ɯ̟ᵝ m ɯ̟ᵝ
あらい	a̠ ɾ a̠ i
あらさき	a̠ ɾ a̠ s a̠ kʲ i
あらす	a̠ ɾ a̠ s ɨᵝ
あらためる	a̠ ɾ a̠ t a̠ m e̞ ɾ ɯ̟ᵝ
あらゆる	a̠ ɾ a̠ j ɯ̟ᵝ ɾ ɯ̟ᵝ
ありじごく	a̠ ɾʲ i ʑ i ɡ o̞ k ɯ̟ᵝ
ある	a̠ ɾ ɯ̟ᵝ
あるきまわる	a̠ ɾ ɯ̟ᵝ kʲ i m a̠ ɰᵝ a̠ ɾ ɯ̟ᵝ
あるみ	a r u m i
あれ	a̠ ɾ e̞
あわ	a̠ ɰᵝ a̠
あわうみ	a̠ ɰᵝ a̠ ɯ̟ᵝ mʲ i
あわもり	a̠ ɰᵝ a̠ m o̞ ɾʲ i
あん	ã̠ ɴ
あんうつ	ã̠ ɰ̃ ɯ̟ᵝ t͡s ɨᵝ
あんさつ	ã̠ ɰ̃ s a̠ t͡s ɨᵝ
あんざん	ã̠ n d͡z ã̠ ɴ
あんしん	ã̠ ɰ̃ ɕ ĩ ɴ
あんず	ã̠ n d͡z ɨᵝ
あんぜん	ã̠ n d͡z ẽ̞ ɴ
あんぜんだいいち	ã̠ n d͡z ẽ̞ n d a̠ i i t͡ɕ i
あんた	ã̠ n t a̠
あんてん	ã̠ n t ẽ̞ ɴ
あんのん	ã̠ nː õ̞ ɴ
あんぽんたん	ã̠ m p õ̞ n t ã̠ ɴ
いあんふ	i ã̠ ɰ̃ ɸ ɯ̟ᵝ
いいきかせる	iː kʲ i k a̠ s e̞ ɾ ɯ̟ᵝ
いいん	ĩː ɴ
いえで	i e̞ d e̞
いえでにん	i e̞ d e̞ ɲ̟ ĩ ɴ
いえもち	i e̞ m o̞ t͡ɕ i
いおん	i õ̞ ɴ
いかが	i k a̠ ɡ a̠
いかけ	i k a̠ k e̞
いかり	i k a̠ ɾʲ i
いがく	i ɡ a̠ k ɯ̟ᵝ
いき	i kʲ i
いきおい	i kʲ i o̞ i
いきか	i kʲ i k a̠
いきつぎ	i kʲ i t͡s ɨᵝ ɡʲ i
いきもの	i kʲ i m o̞ n o̞
いきょう	i kʲ o̞ː
いきる	i kʲ i ɾ ɯ̟ᵝ
いくせいそう	i k ɯ̟ᵝ s e̞ː s o̞ː
いくた	i k ɯ̟ᵝ t a̠
いくつ	i k ɯ̟ᵝ t͡s ɨᵝ
いけばな	i k e̞ b a̠ n a̠
いこ	i k o̞
いこう	i k o̞ː
いこみき	i k o̞
いさい	i s a̠ i
いさぎよい	i s a̠ ɡʲ i j o̞ i
いさごむし	i s a̠ ɡ o̞ m ɯ̟ᵝ ɕ i
いざよい	i z a̠ j o̞ i
いざよう	i z a̠ j o̞ː
いしかわけん	i ɕ i k a̠ ɰᵝ a̠ k ẽ̞ ɴ
いしき	i ɕ i̥ kʲ i
いしょう	i ɕ o̞ː
いしょく	i ɕ o̞ k ɯ̟ᵝ
いしりょく	i ɕ i ɾʲ o̞ k ɯ̟̊ᵝ
いじ	i ʑ i
いじける	i ʑ i k e̞ ɾ ɯ̟ᵝ
いじめっこ	i ʑ i m e̞ k̚ k o̞
いじょう	i ʑ o̞ː
いずら	i z ɨᵝ ɾ a̠
いそ	i s o̞
いそぐ	i s o̞ ɡ ɯ̟ᵝ
いそろく	i s o̞ ɾ o̞ k ɯ̟ᵝ
いたむ	i t a̠ m ɯ̟ᵝ
いたわしい	i t a̠ ɰᵝ a̠ ɕ iː
いだい	i d a̠ i
いだてん	i d a̠ t ẽ̞ ɴ
いちごん	i t͡ɕ i ɡ õ̞ ɴ
いちごんほうおん	i t͡ɕ i ɡ õ̞ ɰ̃ h o̞ː õ̞ ɴ
いちじく	i t͡ɕ i ʑ i k ɯ̟ᵝ
いちぜん	i t͡ɕ i z ẽ̞ ɴ
いちぞく	i t͡ɕ i z o̞ k ɯ̟ᵝ
いちだいき	i t͡ɕ i d a̠ i kʲ i
いちなん	i t͡ɕ i n ã̠ ɴ
いちぶ	i t͡ɕ i b ɯ̟ᵝ
いちまつもよう	i t͡ɕ i m a̠ t͡s ɨᵝ m o̞ j o̞ː
いちまん	i t͡ɕ i m ã̠ ɴ
いちよう	i t͡ɕ i j o̞ː
いっこく	i k̚ k o̞ k ɯ̟ᵝ
いったい	i t̚ t a̠ i
いったいか	i t̚ t a̠ i k a̠
いったりきたり	i t̚ t a̠ ɾʲ i kʲ i t a̠ ɾʲ i
いっちょう	i t̚ t͡ɕ o̞ː
いっぱい	i p̚ p a̠ i
いっぱつげい	i p̚ p a̠ t͡s ɨᵝ ɡ e̞ː
いっぱん	i p̚ p ã̠ ɴ
いっぷたさいせい	i p̚ p ɯ̟ᵝ t a̠ s a̠ i s e̞ː
いっぽんみち	i p̚ p õ̞ mʲː i t͡ɕ i
いつくしむ	i t͡s ɨᵝ k ɯ̟ᵝ ɕ i m ɯ̟ᵝ
いつしか	i t͡s ɨᵝ ɕ i k a̠
いでんがく	i d ẽ̞ ŋ ɡ a̠ k ɯ̟ᵝ
いとおしい	i t o̞ː ɕ i i
いとさめ	i t o̞ s a̠ m e̞
いな	i n a̠
いなくなる	i n a̠ k ɯ̟ᵝ n a̠ ɾ ɯ̟ᵝ
いなずま	i n a̠ z ɨᵝ m a̠
いなむ	i n a̠ m ɯ̟ᵝ
いなり	i n a̠ ɾʲ i
いぬい	k ã̠ ɴ
いぬく	i n ɯ̟ᵝ k ɯ̟ᵝ
いのち	i n o̞ t͡ɕ i
いのちとり	i n o̞ t͡ɕ i t o̞ ɾʲ i
いのちびろい	i n o̞ t͡ɕ i bʲ i ɾ o̞ i
いのぶた	i n o̞ b ɯ̟ᵝ t a̠
いのり	i n o̞ ɾʲ i
いはつ	i h a̠ t͡s ɨᵝ
いばらき	i b a̠ ɾ a̠ kʲ i
いびく	i bʲ i k ɯ̟ᵝ
いぶかしい	i b ɯ̟ᵝ k a̠ ɕ i i
いへん	i h ẽ̞ ɴ
いほうじん	i h o̞ː ʑ ĩ ɴ
いぼ	i b o̞
いみろん	i mʲ i ɾ õ̞ ɴ
いもの	i m o̞ n o̞
いやす	i j a̠ s ɨᵝ
いやん	i j ã̠ ɴ
いらい	i ɾ a̠ i
いらっしゃい	i ɾ a̠ ɕː a̠ i
いらっしゃいませ	i ɾ a̠ ɕː a̠ i m a̠ s e̞
いらつこ	i ɾ a̠ t͡s ɨᵝ k o̞
いりえわに	i ɾʲ i e̞ ɰᵝ a̠ ɲ̟ i
いりこむ	i ɾʲ i k o̞ m ɯ̟ᵝ
いりまじり	i ɾʲ i m a̠ ʑ i ɾʲ i
いるかざ	i ɾ ɯ̟ᵝ k a̠ z a̠
いるす	i ɾ ɯ̟ᵝ s ɨᵝ
いれもの	i ɾ e̞ m o̞ n o̞
いろあざやか	i ɾ o̞ a̠ z a̠ j a̠ k a̠
いろう	i ɾ o̞ː
いろざと	i ɾ o̞ z a̠ t o̞
いろづける	i ɾ o̞ z ɨᵝ k e̞ ɾ ɯ̟ᵝ
いろん	i ɾ õ̞ ɴ
いわあな	i ɰᵝ a̠ a̠ n a̠
いわかん	i ɰᵝ a̠ k ã̠ ɴ
いわく	i ɰᵝ a̠ k ɯ̟ᵝ
いわのぼり	i ɰᵝ a̠ n o̞ b o̞ ɾʲ i
いわゆる	i ɰᵝ a̠ j ɯ̟ᵝ ɾ ɯ̟ᵝ
いんが	ĩ ŋ ɡ a̠
いんがし	ĩ ŋ ɡ a̠ ɕ i
いんこ	ĩ ŋ k o̞
いんぜい	ĩ n d͡z e̞ː
いんたい	ĩ n t a̠ i
いんどう	ĩ n d o̞ː
いんねん	ĩ nː ẽ̞ ɴ
いんむ	ĩ mː ɯ̟ᵝ
いんりつ	ĩ n ɾʲ i t͡s ɨᵝ
ういご	ɯ̟ᵝ i ɡ o̞
うえぞの	ɯᵝ e̞ z o̞ n o̞
うえもんふ	ɯ̟ᵝ e̞ m õ̞ ɰ̃ ɸ ɯ̟ᵝ
うきす	ɯ̟ᵝ kʲ i s ɨᵝ
うきわ	ɯ̟ᵝ kʲ i ɰᵝ a̠
うけたまわる	ɯ̟ᵝ k e̞ t a̠ m a̠ ɰᵝ a̠ ɾ ɯ̟ᵝ
うけとりにん	ɯ̟ᵝ k e̞ t o̞ ɾʲ i ɲ̟ ĩ ɴ
うけとる	ɯ̟ᵝ k e̞ t o̞ ɾ ɯ̟ᵝ
うける	ɯ̟ᵝ k e̞ ɾ ɯ̟ᵝ
うし	ɯ̟ᵝ ɕ i
うしかいざ	ɯ̟ᵝ ɕ i̥ k a̠ i z a̠
うじ	ɯ̟ᵝ ʑ i
うそつけ	ɯ̟ᵝ s o̞ t͡s ɨᵝ k e̞
うたう	ɯ̟ᵝ t a̠ ɯ̟ᵝ
うたがい	ɯ̟ᵝ t a̠ ɡ a̠ i
うたってみた	ɯ̟ᵝ t a̠ t̚ t e̞ mʲ i t a̠
うたつぐみ	ɯ̟ᵝ t a̠ t͡s ɨᵝ ɡ ɯ̟ᵝ mʲ i
うたひめ	ɯ̟ᵝ t a̠ ç i m e̞
うちがけ	ɯ̟ᵝ t͡ɕ i ɡ a̠ k e̞
うちがわ	ɯ̟ᵝ t͡ɕ i ɡ a̠ ɰᵝ a̠
うちくび	ɯ̟ᵝ t͡ɕ i k ɯ̟ᵝ bʲ i
うちけす	ɯ̟ᵝ t͡ɕ i k e̞ s ɨᵝ
うちゅう	ɯ̟ᵝ t͡ɕ ɨᵝː
うっとう	ɯ̟ᵝ t̚ t o̞ː
うっとうしい	ɯ̟ᵝ t̚ t o̞ː ɕ i i
うつのみや	ɯ̟ᵝ t͡s ɨᵝ n o̞ mʲ i j a̠
うつぼ	ɯ̟ᵝ t͡s ɨᵝ b o̞
うつりかわる	ɯ̟ᵝ t͡s ɨᵝ ɾʲ i k a̠ ɰᵝ a̠ ɾ ɯ̟ᵝ
うつろ	ɯ̟ᵝ t͡s ɨᵝ ɾ o̞
うでどけい	ɯ̟ᵝ d e̞ d o̞ k e̞ː
うでまえ	ɯ̟ᵝ d e̞ m a̠ e̞
うば	ɯ̟ᵝ b a̠
うばい	ɯ̟ᵝ b a̠ i
うばがい	ɯ̟ᵝ b a̠ ɡ a̠ i
うばたま	ɯ̟ᵝ b a̠ t a̠ m a̠
うまれる	ɯ̟ᵝ m a̠ ɾ e̞ ɾ ɯ̟ᵝ
うみ	ɯ̟ᵝ mʲ i
うみがめ	ɯ̟ᵝ mʲ i ɡ a̠ m e̞
うみがらす	ɯ̟ᵝ mʲ i ɡ a̠ ɾ a̠ s ɨᵝ
うみすずめ	ɯ̟ᵝ mʲ i s ɨᵝ z ɨᵝ m e̞
うみとかげ	ɯ̟ᵝ mʲ i t o̞ k a̠ ɡ e̞
うみぼうず	ɯ̟ᵝ mʲ i b o̞ː z ɨᵝ
うめあわせる	ɯ̟ᵝ m e̞ a̠ ɰᵝ a̠ s e̞ ɾ ɯ̟ᵝ
うめく	ɯ̟ᵝ m e̞ k ɯ̟ᵝ
うめる	ɯ̟ᵝ m e̞ ɾ ɯ̟ᵝ
うゆう	ɯ̟ᵝ j ɯ̟ᵝː
うらぎる	ɯ̟ᵝ ɾ a̠ ɡʲ i ɾ ɯ̟ᵝ
うらばなし	ɯ̟ᵝ ɾ a̠ b a̠ n a̠ ɕ i
うらむ	ɯ̟ᵝ ɾ a̠ m ɯ̟ᵝ
うらやましい	ɯ̟ᵝ ɾ a̠ j a̠ m a̠ ɕ i i
うらわかい	ɯ̟ᵝ ɾ a̠ ɰᵝ a̠ k a̠ i
うるしはら	ɯ̟ᵝ ɾ ɯ̟ᵝ ɕ i h a̠ ɾ a̠
うるわしい	ɯ̟ᵝ ɾ ɯ̟ᵝ ɰᵝ a̠ ɕ iː
うれっこ	ɯ̟ᵝ ɾ e̞ k̚ k o̞
うわまわる	ɯ̟ᵝ ɰᵝ a̠ m a̠ ɰᵝ a̠ ɾ ɯ̟ᵝ
うん	ɯ̟̃ᵝ ɴ
うんげい	ɯ̟̃ᵝ ŋ ɡ e̞ː
うんせい	ɯ̟̃ᵝ ɰ̃ s e̞ː
うんどうぐつ	ɯ̟̃ᵝ n d o̞ː ɡ ɯ̟ᵝ t͡s ɨᵝ
うんどうりょう	ɯ̟̃ᵝ n d o̞ː ɾʲ o̞ː
えいがかん	e̞ː ɡ a̠ k ã̠ ɴ
えいしょう	e̞ː ɕ o̞ː
えいじ	e̞ː ʑ i
えいせい	e̞ː s e̞ː
えいぞう	e̞ː z o̞ː
えいよ	e̞ː j o̞
えいりょく	e̞ː ɾʲ o̞ k ɯ̟ᵝ
えいれんぽう	e̞ː ɾ ẽ̞ m p o̞ː
えいろく	e̞ː ɾ o̞ k ɯ̟ᵝ
えいん	ẽ̞ː ɴ
ええっと	e̞ː t̚ t o̞
えききょう	e̞ kʲ i kʲ o̞ː
えきしゃ	e̞ kʲ i ɕ a̠
えきじゅう	e̞ kʲ i ʑ ɨᵝː
えきそう	e̞ kʲ i s o̞ː
えきちゅう	e̞ kʲ i̥ t͡ɕ ɨᵝː
えくぼ	e̞ k ɯ̟ᵝ b o̞
えこひいき	e̞ k o̞ ç iː kʲ i
えず	e̞ z ɨᵝ
えっへん	e̞ hː ẽ̞ ɴ
えつご	e̞ t͡s ɨᵝ ɡ o̞
えつらんしつ	e̞ t͡s ɨᵝ ɾ ã̠ ɰ̃ ɕ i t͡s ɨᵝ
えど	e̞ d o̞
えどっこ	e̞ d o̞ k̚ k o̞
えのきたけ	e̞ n o̞ kʲ i t a̠ k e̞
えのころぐさ	e̞ n o̞ k o̞ ɾ o̞ ɡ ɯ̟ᵝ s a̠
えひめけん	e̞ ç i m e̞ k ẽ̞ ɴ
えび	e̞ bʲ i
えびな	e̞ bʲ i n a̠
えふで	e̞ ɸ ɯ̟ᵝ d e̞
えみこ	e̞ mʲ i k o̞
えらい	e̞ ɾ a̠ i
えんあん	ẽ̞ ɰ̃ ã̠ ɴ
えんえき	ẽ̞ ɴ e̞ kʲ i
えんきり	ẽ̞ ŋʲ kʲ i ɾʲ i
えんぎ	ẽ̞ ŋʲ ɡʲ i
えんげき	ẽ̞ ŋ ɡ e̞ kʲ i
えんしゅう	ẽ̞ ɰ̃ ɕ ɨᵝː
えんせいしゅぎ	ẽ̞ ɰ̃ s e̞ː ɕ ɨᵝ ɡʲ i
えんそうか	ẽ̞ ɰ̃ s o̞ː k a̠
えんそうかい	ẽ̞ ɰ̃ s o̞ː k a̠ i
えんたく	ẽ̞ n t a̠ k ɯ̟ᵝ
えんだい	ẽ̞ n d a̠ i
えんだん	ẽ̞ n d ã̠ ɴ
えんちょうせん	ẽ̞ ɲ̟ t͡ɕ o̞ː s ẽ̞ ɴ
えんちょく	ẽ̞ ɲ̟ t͡ɕ o̞ k ɯ̟ᵝ
えんでい	ẽ̞ n d e̞ː
えんとうし	ẽ̞ n t o̞ː ɕ i
えんび	ẽ̞ m bʲ i
えんぴつ	ẽ̞ m pʲ i̥ t͡s ɨᵝ
えんぺん	ẽ̞ m p ẽ̞ ɴ
えんりょ	ẽ̞ n ɾʲ o̞
おいうつ	o̞ i ɯ̟ᵝ t͡s ɨᵝ
おいつめる	o̞ i t͡s ɨᵝ m e̞ ɾ ɯ̟ᵝ
おいぼれ	o̞ i b o̞ ɾ e̞
おいる	o̞ i ɾ ɯ̟ᵝ
おう	o̞ ɯ̟ᵝ
おうえんだん	o̞ː ẽ̞ n d ã̠ ɴ
おうごんひ	o̞ː ɡ õ̞ ɰ̃ ç i
おうさか	oː s a k a
おうじつ	o̞ː ʑ i t͡s ɨᵝ
おうじょうぎわ	o̞ː ʑ o̞ː ɡʲ i ɰᵝ a̠
おうてん	o̞ː t ẽ̞ ɴ
おうとうき	o̞ː t o̞ː kʲ i
おうひ	o̞ː ç i
おうふく	o̞ː ɸ ɯ̟ᵝ k ɯ̟ᵝ
おうむ	o̞ː m ɯ̟ᵝ
おえる	o̞ e̞ ɾ ɯ̟ᵝ
おおう	o̞ː ɯ̟ᵝ
おおぎり	o̞ː ɡʲ i ɾʲ i
おおぐまざ	o̞ː ɡ ɯ̟ᵝ m a̠ z a̠
おおさこ	o̞ː s a̠ k o̞
おおさわぎ	o̞ː s a̠ ɰᵝ a̠ ɡʲ i
おおしま	o̞ː ɕ i m a̠
おおじか	o̞ː ʑ i k a̠
おおすじ	o̞ː s ɨᵝ ʑ i
おおぜい	o̞ː z e̞ː
おおちがい	o̞ː t͡ɕ i ɡ a̠ i
おおやけ	o̞ː j a̠ k e̞
おおやまねこ	o̞ː j a̠ m a̠ n e̞ k o̞
おかえりなさい	o̞ k a̠ e̞ ɾʲ i n a̠ s a̠ i
おかげ	o̞ k a̠ ɡ e̞
おかし	o̞ k a̠ ɕ i
おかす	o̞ k a̠ s ɨᵝ
おかね	o̞ k a̠ n e̞
おきあがりこぼし	o̞ kʲ i a̠ ɡ a̠ ɾʲ i k o̞ b o̞ ɕ i
おきごんどう	o̞ kʲ i ɡ õ̞ n d o̞ː
おきて	o̞ kʲ i t e̞
おきなわ	o̞ kʲ i n a̠ ɰᵝ a̠
おきる	o̞ kʲ i ɾ ɯ̟ᵝ
おく	o̞ k ɯ̟ᵝ
おくう	o̞ k ɯ̟ᵝ ɯ̟ᵝ
おくはら	o̞ k ɯ̟ᵝ h a̠ ɾ a̠
おこる	o̞ k o̞ ɾ ɯ̟ᵝ
おごる	o̞ ɡ o̞ ɾ ɯ̟ᵝ
おさえる	o̞ s a̠ e̞ ɾ ɯ̟ᵝ
おさけ	o̞ s a̠ k e̞
おさない	o̞ s a̠ n a̠ i
おさまる	o̞ s a̠ m a̠ ɾ ɯ̟ᵝ
おしい	o̞ ɕ i i
おしえる	o̞ ɕ i e̞ ɾ ɯ̟ᵝ
おしゃべり	o̞ ɕ a̠ b e̞ ɾʲ i
おしゃれ	o̞ ɕ a̠ ɾ e̞
おじか	o̞ ʑ i k a̠
おじさん	o̞ ʑ i s ã̠ ɴ
おせじ	o̞ s e̞ d͡ʑ i
おそい	o̞ s o̞ i
おそう	o̞ s o̞ ɯ̟ᵝ
おそけ	o̞ s o̞ k e̞
おそそ	o̞ s o̞ s o̞
おそらく	o̞ s o̞ ɾ a̠ k ɯ̟ᵝ
おそん	o̞ s õ̞ ɴ
おたがい	o̞ t a̠ ɡ a̠ i
おたまじゃくし	o̞ t a̠ m a̠ ʑ a̠ k ɯ̟̊ᵝ ɕ i
おだやか	o̞ d a̠ j a̠ k a̠
おちど	o̞ t͡ɕ i d o̞
おちびさん	o̞ t͡ɕ i bʲ i s ã̠ ɴ
おっきい	o̞ k̚ʲ kʲ i i
おてあげ	o̞ t e̞ a̠ ɡ e̞
おでかけ	o̞ d e̞ k a̠ k e̞
おでこ	o̞ d e̞ k o̞
おとこ	o̞ t o̞ k o̞
おとこまさり	o̞ t o̞ k o̞ m a̠ s a̠ ɾʲ i
おとさた	o̞ t o̞ s a̠ t a̠
おどす	o̞ d o̞ s ɨᵝ
おどらす	o̞ d o̞ ɾ a̠ s ɨᵝ
おどろく	o̞ d o̞ ɾ o̞ k ɯ̟ᵝ
おないどし	o̞ n a̠ i d o̞ ɕ i
おなが	o̞ n a̠ ɡ a̠
おなががも	o̞ n a̠ ɡ a̠ ɡ a̠ m o̞
おなじ	o̞ n a̠ ʑ i
おにあそび	o̞ ɲ̟ i a̠ s o̞ bʲ i
おにご	o̞ ɲ̟ i ɡ o̞
おの	o̞ n o̞
おふくろ	o̞ ɸ ɯ̟̊ᵝ k ɯ̟ᵝ ɾ o̞
おぶつ	o̞ b ɯ̟ᵝ t͡s ɨᵝ
おぼえる	o̞ b o̞ e̞ ɾ ɯ̟ᵝ
おぼろづき	o̞ b o̞ ɾ o̞ z ɨᵝ kʲ i
おまえら	o̞ m a̠ e̞ ɾ a̠
おもい	o̞ m o̞ i
おもいうかぶ	o̞ m o̞ i ɯ̟ᵝ k a̠ b ɯ̟ᵝ
おもいおもい	o̞ m o̞ i o̞ m o̞ i
おもいたつ	o̞ m o̞ i t a̠ t͡s ɨᵝ
おもいどおり	o̞ m o̞ i d o̞ː ɾʲ i
おもいやり	o̞ m o̞ i j a̠ ɾʲ i
おもさ	o̞ m o̞ s a̠
おもたい	o̞ m o̞ t a̠ i
おもてむき	o̞ m o̞ t e̞ m ɯ̟ᵝ kʲ i
おもねる	o̞ m o̞ n e̞ ɾ ɯ̟ᵝ
おもり	o̞ m o̞ ɾʲ i
おやこ	o̞ j a̠ k o̞
およぐ	o̞ j o̞ ɡ ɯ̟ᵝ
おり	o̞ ɾʲ i
おろか	o̞ ɾ o̞ k a̠
おろがむ	o̞ ɾ o̞ ɡ a̠ m ɯ̟ᵝ
おろしうり	o̞ ɾ o̞ ɕ i ɯ̟ᵝ ɾʲ i
おろしがね	o̞ ɾ o̞ ɕ i ɡ a̠ n e̞
おろす	o̞ ɾ o̞ s ɨᵝ
おろそか	o̞ ɾ o̞ s o̞ k a̠
おろち	o̞ ɾ o̞ t͡ɕ i
おわる	o̞ ɰᵝ a̠ ɾ ɯ̟ᵝ
おん	õ̞ ɴ
おんけん	õ̞ ŋ k ẽ̞ ɴ
おんしん	õ̞ ɰ̃ ɕ ĩ ɴ
おんぞん	õ̞ n d͡z õ̞ ɴ
おんなごころ	õ̞ nː a̠ ɡ o̞ k o̞ ɾ o̞
おんなぶげいしゃ	õ̞ nː a̠ b ɯ̟ᵝ ɡ e̞ː ɕ a̠
おんりょう	õ̞ n ɾʲ o̞ː
かいあげる	k a̠ i a̠ ɡ e̞ ɾ ɯ̟ᵝ
かいい	k a̠ i i
かいうん	k a̠ i ɯ̟̃ᵝ ɴ
かいえん	k a̠ i ẽ̞ ɴ
かいおうせい	k a̠ i o̞ː s e̞ː
かいかい	k a̠ i k a̠ i
かいかけきん	k a̠ i k a̠ k e̞ kʲ ĩ ɴ
かいがら	k a̠ i ɡ a̠ ɾ a̠
かいきょうと	k a̠ i kʲ o̞ː t o̞
かいぎ	k a̠ i ɡʲ i
かいさい	k a̠ i s a̠ i
かいしゃ	k a̠ i ɕ a̠
かいしゃいん	k a̠ i ɕ a̠ ĩ ɴ
かいしゅう	k a̠ i ɕ ɨᵝː
かいしょく	k a̠ i ɕ o̞ k ɯ̟ᵝ
かいじつ	k a̠ i ʑ i t͡s ɨᵝ
かいせきがく	k a̠ i s e̞ kʲ i ɡ a̠ k ɯ̟ᵝ
かいぜん	k a̠ i z ẽ̞ ɴ
かいぞく	k a̠ i z o̞ k ɯ̟ᵝ
かいぞくばん	k a̠ i z o̞ k ɯ̟ᵝ b ã̠ ɴ
かいならす	k a̠ i n a̠ ɾ a̠ s ɨᵝ
かいぶんしょ	k a̠ i b ɯ̟̃ᵝ ɰ̃ ɕ o̞
かいめつ	k a̠ i m e̞ t͡s ɨᵝ
かいらく	k a̠ i ɾ a̠ k ɯ̟ᵝ
かえりみる	k a̠ e̞ ɾʲ i mʲ i ɾ ɯ̟ᵝ
かえる	k a̠ e̞ ɾ ɯ̟ᵝ
かお	k a̠ o̞
かかあでんか	k a̠ k a̠ː d ẽ̞ ŋ k a̠
かかげる	k a̠ k a̠ ɡ e̞ ɾ ɯ̟ᵝ
かかし	k a̠ k a̠ ɕ i
かかる	k a̠ k a̠ ɾ ɯ̟ᵝ
かかわり	k a̠ k a̠ ɰᵝ a̠ ɾʲ i
かがふり	k a̠ ɡ a̠ ɸ ɯ̟ᵝ ɾʲ i
かがふる	k a̠ ɡ a̠ ɸ ɯ̟ᵝ ɾ ɯ̟ᵝ
かき	k a̠ kʲ i
かきとめる	k a̠ kʲ i t o̞ m e̞ ɾ ɯ̟ᵝ
かきみだす	k a̠ kʲ i mʲ i d a̠ s ɨᵝ
かぎ	k a̠ ɡʲ i
かぎる	k a̠ ɡʲ i ɾ ɯ̟ᵝ
かく	k a̠ k ɯ̟ᵝ
かくうん	k a̠ k ɯ̟ᵝ ɯ̟̃ᵝ ɴ
かくしあじ	k a̠ k ɯ̟ᵝ ɕ i a̠ ʑ i
かくしき	k a̠ k ɯ̟ᵝ ɕ i kʲ i
かくしん	k a̠ k ɯ̟ᵝ ɕ ĩ ɴ
かくじん	k a̠ k ɯ̟ᵝ ʑ ĩ ɴ
かくすい	k a̠ k ɯ̟̊ᵝ s ɨᵝ i
かくせいき	k a̠ k ɯ̟ᵝ s e̞ː kʲ i
かくだい	k a̠ k ɯ̟ᵝ d a̠ i
かくちゅう	k a̠ k ɯ̟ᵝ t͡ɕ ɨᵝː
かくづけ	k a̠ k ɯ̟ᵝ z ɨᵝ k e̞
かくとうぎ	k a̠ k ɯ̟ᵝ t o̞ː ɡʲ i
かくり	k a̠ k ɯ̟ᵝ ɾʲ i
かくりつろん	k a̠ k ɯ̟ᵝ ɾʲ i t͡s ɨᵝ ɾ õ̞ ɴ
かぐ	k a̠ ɡ ɯ̟ᵝ
かぐらざか	k a̠ ɡ ɯ̟ᵝ ɾ a̠ z a̠ k a̠
かけうり	k a̠ k e̞ ɯ̟ᵝ ɾʲ i
かけごえ	k a̠ k e̞ ɡ o̞ e̞
かけざん	k a̠ k e̞ z ã̠ ɴ
かけだす	k a̠ k e̞ d a̠ s ɨᵝ
かけまわる	k a̠ k e̞ m a̠ ɰᵝ a̠ ɾ ɯ̟ᵝ
かける	k a̠ k e̞ ɾ ɯ̟ᵝ
かげ	k a̠ ɡ e̞
かげり	k a̠ ɡ e̞ ɾʲ i
かごしま	k a̠ ɡ o̞ ɕ i m a̠
かさぶた	k a̠ s a̠ b ɯ̟ᵝ t a̠
かざかみ	k a̠ z a̠ k a̠ mʲ i
かざけ	k a̠ z a̠ k e̞
かざみどり	k a̠ z a̠ mʲ i d o̞ ɾʲ i
かざりだな	k a̠ z a̠ ɾʲ i d a̠ n a̠
かざる	k a̠ z a̠ ɾ ɯ̟ᵝ
かしかん	k a̠ ɕ i̥ k ã̠ ɴ
かしこまる	k a̠ ɕ i k o̞ m a̠ ɾ ɯ̟ᵝ
かしつ	k a̠ ɕ i t͡s ɨᵝ
かしゃ	k a̠ ɕ a̠
かじば	k a̠ ʑ i b a̠
かじゅう	k a̠ ʑ ɨᵝː
かじょうせっしゅ	k a̠ ʑ o̞ː s e̞ ɕː ɯ̟ᵝ
かじる	k a̠ ʑ i ɾ ɯ̟ᵝ
かすざめ	k a̠ s ɨᵝ z a̠ m e̞
かずお	k a̠ z ɨᵝ o̞
かずゆき	k a̠ z ɨᵝ j ɯ̟ᵝ kʲ i
かせい	k a̠ s e̞ː
かせいふ	k a̠ s e̞ː ɸ ɯ̟̊ᵝ
かせぐ	k a̠ s e̞ ɡ ɯ̟ᵝ
かぜ	k a̠ z e̞
かそくど	k a̠ s o̞ k ɯ̟ᵝ d o̞
かそくどびょう	k a̠ s o̞ k ɯ̟ᵝ d o̞ bʲ o̞ː
かぞえる	k a̠ z o̞ e̞ ɾ ɯ̟ᵝ
かた	k a̠ t a̠
かたがた	k a̠ t a̠ ɡ a̠ t a̠
かたく	k a̠ t a̠ k ɯ̟ᵝ
かたくちいわし	k a̠ t a̠ k ɯ̟̊ᵝ t͡ɕ i i ɰᵝ a̠ ɕ i
かたくるしい	k a̠ t a̠ k ɯ̟ᵝ ɾ ɯ̟ᵝ ɕ iː
かたこと	k a̠ t a̠ k o̞ t o̞
かたなかじ	k a̠ t a̠ n a̠ k a̠ ʑ i
かたぬき	k a̠ t a̠ n ɯ̟ᵝ kʲ i
かたまる	k a̠ t a̠ m a̠ ɾ ɯ̟ᵝ
かちく	k a̠ t͡ɕ i k ɯ̟ᵝ
かちょうふうげつ	k a̠ t͡ɕ o̞ː ɸ ɯ̟ᵝː ɡ e̞ t͡s ɨᵝ
かっこうわるい	k a̠ k̚ k o̞ː ɰᵝ a̠ ɾ ɯ̟ᵝ i
かっそうろ	k a̠ sː o̞ː ɾ o̞
かっそく	k a̠ sː o̞ k ɯ̟ᵝ
かつえき	k a̠ t͡s ɨᵝ e̞ kʲ i
かつぐ	k a̠ t͡s ɨᵝ ɡ ɯ̟ᵝ
かつじたい	k a̠ t͡s ɨᵝ ʑ i t a̠ i
かつぜつ	k a̠ t͡s ɨᵝ z e̞ t͡s ɨᵝ
かつぼう	k a̠ t͡s ɨᵝ b o̞ː
かつやく	k a̠ t͡s ɨᵝ j a̠ k ɯ̟ᵝ
かとう	k a̠ t o̞ː
かとうせい	k a̠ t o̞ː s e̞ː
かとんぼ	k a̠ t õ̞ m b o̞
かない	k a̠ n a̠ i
かなぶみ	k a̠ n a̠ b ɯ̟ᵝ mʲ i
かに	k a̠ ɲ̟ i
かのじょ	k a̠ n o̞ ʑ o̞
かはんのう	k a̠ h ã̠ nː o̞ː
かみがた	k a̠ mʲ i ɡ a̠ t a̠
かみがみ	k a̠ mʲ i ɡ a̠ mʲ i
かみくず	k a̠ mʲ i k ɯ̟ᵝ z ɨᵝ
かみさま	k a̠ mʲ i s a̠ m a̠
かみつ	k a̠ mʲ i t͡s ɨᵝ
かみなり	k a̠ mʲ i n a̠ ɾʲ i
かみひこうき	k a̠ mʲ i ç i̥ k o̞ː kʲ i
かみまき	k a̠ mʲ i m a̠ kʲ i
かみむら	k a̠ mʲ i m ɯ̟ᵝ ɾ a̠
かみやすり	k a̠ mʲ i j a̠ s ɨᵝ ɾʲ i
かもる	k a̠ m o̞ ɾ ɯ̟ᵝ
かもん	k a̠ m õ̞ ɴ
かゆ	k a̠ j ɯ̟ᵝ
からい	k a̠ ɾ a̠ i
からくだもの	k a̠ ɾ a̠ k ɯ̟ᵝ d a̠ m o̞ n o̞
からてか	k a̠ ɾ a̠ t e̞ k a̠
からな	k a̠ ɾ a̠ n a̠
からぶみ	k a r a b u m i
からぼり	k a̠ ɾ a̠ b o̞ ɾʲ i
からもの	k a̠ ɾ a̠ m o̞ n o̞
かりね	k a̠ ɾʲ i n e̞
かりひきすう	k a̠ ɾʲ i ç i kʲ i s ɨᵝː
かりゅう	k a̠ ɾʲ ɨᵝː
かりる	k a̠ ɾʲ i ɾ ɯ̟ᵝ
かわあかり	k a̠ ɰᵝ a̠ a̠ k a̠ ɾʲ i
かわいい	k a̠ ɰᵝ a̠ i i
かわうそ	k a̠ ɰᵝ a̠ ɯ̟ᵝ s o̞
かわかす	k a̠ ɰᵝ a̠ k a̠ s ɨᵝ
かわぐも	k a̠ ɰᵝ a̠ ɡ ɯ̟ᵝ m o̞
かわほりおうぎ	k a̠ ɰᵝ a̠ h o̞ ɾʲ i o̞ː ɡʲ i
かわらばと	k a̠ ɰᵝ a̠ ɾ a̠ b a̠ t o̞
かんぐる	k ã̠ ŋ ɡ ɯ̟ᵝ ɾ ɯ̟ᵝ
かんけつせん	k ã̠ ŋ k e̞ t͡s ɨ̥ᵝ s ẽ̞ ɴ
かんげき	k ã̠ ŋ ɡ e̞ kʲ i
かんこう	k ã̠ ŋ k o̞ː
かんこく	k ã̠ ŋ k o̞ k ɯ̟ᵝ
かんこくじん	k ã̠ ŋ k o̞ k ɯ̟ᵝ ʑ ĩ ɴ
かんこどり	k ã̠ ŋ k o̞ d o̞ ɾʲ i
かんさいじん	k ã̠ ɰ̃ s a̠ i ʑ ĩ ɴ
かんさいべん	k ã̠ ɰ̃ s a̠ i b ẽ̞ ɴ
かんじ	k ã̠ ɲ̟ d͡ʑ i
かんじざい	k ã̠ ɲ̟ d͡ʑ i z a̠ i
かんじょうせん	k ã̠ ɲ̟ d͡ʑ o̞ː s ẽ̞ ɴ
かんじる	k ã̠ ɲ̟ d͡ʑ i ɾ ɯ̟ᵝ
かんせいとう	k ã̠ ɰ̃ s e̞ː t o̞ː
かんせん	k ã̠ ɰ̃ s ẽ̞ ɴ
かんぞう	k ã̠ n d͡z o̞ː
かんたく	k ã̠ n t a̠ k ɯ̟ᵝ
かんたんふ	k ã̠ n t ã̠ ɰ̃ ɸ ɯ̟ᵝ
かんち	k ã̠ ɲ̟ t͡ɕ i
かんつう	k ã̠ n t͡s ɨᵝː
かんてい	k ã̠ n t e̞ː
かんていりゅう	k ã̠ n t e̞ː ɾʲ ɨᵝː
かんてん	k ã̠ n t ẽ̞ ɴ
かんとんご	k ã̠ n t õ̞ ŋ ɡ o̞
かんどうし	k ã̠ n d o̞ː ɕ i
かんび	k ã̠ m bʲ i
かんぷう	k ã̠ m p ɯ̟ᵝː
かんぷく	k ã̠ m p ɯ̟ᵝ k ɯ̟ᵝ
かんむりょう	k ã̠ mː ɯ̟ᵝ ɾʲ o̞ː
かんもん	k ã̠ mː õ̞ ɴ
かんりゃく	k ã̠ n ɾʲ a̠ k ɯ̟ᵝ
かんりょうしゅぎ	k ã̠ n ɾʲ o̞ː ɕ ɨᵝ ɡʲ i
かんりんいん	k ã̠ n ɾʲ ĩ ɰ̃ ĩ ɴ
かんるい	k ã̠ n ɾ ɯ̟ᵝ i
かんれき	k ã̠ n ɾ e̞ kʲ i
か゚	ŋ a̠
がいこう	ɡ a̠ i k o̞ː
がいこくじん	ɡ a̠ i k o̞ k ɯ̟ᵝ ʑ ĩ ɴ
がいせつ	ɡ a̠ i s e̞ t͡s ɨᵝ
がいためほう	ɡ a̠ i t a̠ m e̞ h o̞ː
がいちょう	ɡ a̠ i t͡ɕ o̞ː
がいぶん	ɡ a̠ i b ɯ̟̃ᵝ ɴ
がいや	ɡ a̠ i j a̠
がいやしゅ	ɡ a̠ i j a̠ ɕ ɨᵝ
がいろじゅ	ɡ a̠ i ɾ o̞ ʑ ɨᵝ
がく	ɡ a̠ k ɯ̟ᵝ
がくしゅう	ɡ a̠ k ɯ̟ᵝ ɕ ɨᵝː
がくしょう	ɡ a̠ k ɯ̟ᵝ ɕ o̞ː
がくせつ	ɡ a̠ k ɯ̟̊ᵝ s e̞ t͡s ɨᵝ
がくだん	ɡ a̠ k ɯ̟ᵝ d ã̠ ɴ
がくひ	ɡ a̠ k ɯ̟ᵝ ç i
がこう	ɡ a̠ k o̞ː
がっか	ɡ a̠ k̚ k a̠
がっしゅく	ɡ a̠ ɕː ɯ̟ᵝ k ɯ̟ᵝ
がったい	ɡ a̠ t̚ t a̠ i
がっぺいしゅうごう	ɡ a̠ p̚ p e̞ː ɕ ɨᵝː ɡ o̞ː
がはく	ɡ a̠ h a̠ k ɯ̟ᵝ
がまぐち	ɡ a̠ m a̠ ɡ ɯ̟ᵝ t͡ɕ i
がまんづよい	ɡ a̠ m ã̠ n d͡z ɨᵝ j o̞ i
がろう	ɡ a̠ ɾ o̞ː
がわ	ɡ a̠ ɰᵝ a̠
がんえん	ɡ ã̠ ɰ̃ ẽ̞ ɴ
がんじつ	ɡ ã̠ ɲ̟ d͡ʑ i t͡s ɨᵝ
がんねん	ɡ ã̠ nː ẽ̞ ɴ
がんぼう	ɡ ã̠ m b o̞ː
がんもどき	ɡ ã̠ mː o̞ d o̞ kʲ i
がんやく	ɡ ã̠ ɰ̃ j a̠ k ɯ̟ᵝ
きいっぽん	kʲ iː p̚ p õ̞ ɴ
きおうしょう	kʲ i o̞ː ɕ o̞ː
きかげき	kʲ i̥ k a̠ ɡ e̞ kʲ i
きが	kʲ i ɡ a̠
きき	kʲ i kʲ i
ききいる	kʲ i kʲ iː ɾ ɯ̟ᵝ
ききょう	kʲ i̥ kʲ o̞ː
きぎ	kʲ i ɡʲ i
きくいただき	kʲ i k ɯ̟ᵝ i t a̠ d a̠ kʲ i
きこうがく	kʲ i̥ k o̞ː ɡ a̠ k ɯ̟ᵝ
きごうがく	kʲ i ɡ o̞ː ɡ a̠ k ɯ̟ᵝ
きごうろん	kʲ i ɡ o̞ː ɾ õ̞ ɴ
きし	kʲ i ɕ i
きしだん	kʲ i ɕ i d ã̠ ɴ
きしゃ	kʲ i ɕ a̠
きしゃだん	kʲ i ɕ a̠ d ã̠ ɴ
きしょうがく	kʲ i̥ ɕ o̞ː ɡ a̠ k ɯ̟ᵝ
きじゅう	kʲ i ʑ ɨᵝː
きじゅうき	kʲ i ʑ ɨᵝː kʲ i
きず	kʲ i z ɨᵝ
きずあと	kʲ i z ɨᵝ a̠ t o̞
きずつける	kʲ i z ɨᵝ t͡s ɨᵝ k e̞ ɾ ɯ̟ᵝ
きずな	kʲ i z ɨᵝ n a̠
きせいちゅうがく	kʲ i s e̞ː t͡ɕ ɨᵝː ɡ a̠ k ɯ̟ᵝ
きせん	kʲ i s ẽ̞ ɴ
きそん	kʲ i s õ̞ ɴ
きぞう	kʲ i z o̞ː
きぞくいん	kʲ i z o̞ k ɯ̟ᵝ ĩ ɴ
きたく	kʲ i t a̠ k ɯ̟ᵝ
きたては	kʲ i̥ t a̠ t e̞ h a̠
きだい	kʲ i d a̠ i
きちがいざた	kʲ i t͡ɕ i ɡ a̠ i z a̠ t a̠
きちょうめん	kʲ i̥ t͡ɕ o̞ː m ẽ̞ ɴ
きっと	kʲ i̥ t̚ t o̞
きつね	kʲ i̥ t͡s ɨᵝ n e̞
きつねざる	kʲ i̥ t͡s ɨᵝ n e̞ z a̠ ɾ ɯ̟ᵝ
きづく	kʲ i z ɨᵝ k ɯ̟ᵝ
きづち	kʲ i z ɨᵝ t͡ɕ i
きとうし	kʲ i t o̞ː ɕ i
きぬ	kʲ i n ɯ̟ᵝ
きはつゆ	kʲ i̥ h a̠ t͡s ɨᵝ j ɯ̟ᵝ
きばせん	kʲ i b a̠ s ẽ̞ ɴ
きぶんや	kʲ i b ɯ̟̃ᵝ ɰ̃ j a̠
きまり	kʲ i m a̠ ɾʲ i
きまる	kʲ i m a̠ ɾ ɯ̟ᵝ
きみたち	kʲ i mʲ i t a̠ t͡ɕ i
きもの	kʲ i m o̞ n o̞
きゃく	kʲ a̠ k ɯ̟ᵝ
きゃくたい	kʲ a̠ k ɯ̟ᵝ t a̠ i
きゃくほん	kʲ a̠ k ɯ̟̊ᵝ h õ̞ ɴ
きゃしゃ	kʲ a̠ ɕ a̠
きゅうかん	kʲ ɨᵝː k ã̠ ɴ
きゅうきょう	kʲ ɨᵝː kʲ o̞ː
きゅうこうか	kʲ ɨᵝː k o̞ː k a̠
きゅうごはん	kʲ ɨᵝː ɡ o̞ h ã̠ ɴ
きゅうさい	kʲ ɨᵝː s a̠ i
きゅうしふ	kʲ ɨᵝː ɕ i ɸ ɯ̟ᵝ
きゅうしゅう	kʲ ɨᵝː ɕ ɨᵝː
きゅうそう	kʲ ɨᵝː s o̞ː
きゅうちゃくおん	kʲ ɨᵝː t͡ɕ a̠ k ɯ̟ᵝ õ̞ ɴ
きゅうねん	kʲ ɨᵝː n ẽ̞ ɴ
きゅうはん	kʲ ɨᵝː h ã̠ ɴ
きゅうよう	kʲ ɨᵝː j o̞ː
きゅうり	kʲ ɨᵝː ɾʲ i
きゆう	kʲ i j ɯ̟ᵝː
きょう	kʲ o̞ː
きょうかんかく	kʲ o̞ː k ã̠ ŋ k a̠ k ɯ̟ᵝ
きょうきん	kʲ o̞ː kʲ ĩ ɴ
きょうせい	kʲ o̞ː s e̞ː
きょうだ	kʲ o̞ː d a̠
きょうつうしゅうごう	kʲ o̞ː t͡s ɨᵝː ɕ ɨᵝː ɡ o̞ː
きょうとふ	kʲ o̞ː t o̞ ɸ ɯ̟ᵝ
きょうにん	kʲ o̞ː ɲ̟ ĩ ɴ
きょうべん	kʲ o̞ː b ẽ̞ ɴ
きょうほ	kʲ o̞ː h o̞
きょうぼう	kʲ o̞ː b o̞ː
きょうよ	kʲ o̞ː j o̞
きょうわ	kʲ o̞ː ɰᵝ a̠
きょか	kʲ o̞ k a̠
きょがく	kʲ o̞ ɡ a̠ k ɯ̟ᵝ
きょきん	kʲ o̞ kʲ ĩ ɴ
きょぎ	kʲ o̞ ɡ i
きょだい	kʲ o̞ d a̠ i
きょひる	kʲ o̞ ç i ɾ ɯ̟ᵝ
きょりゅうち	kʲ o̞ ɾʲ ɨᵝː t͡ɕ i
きよい	kʲ i j o̞ i
きらう	kʲ i ɾ a̠ ɯ̟ᵝ
きらめく	kʲ i ɾ a̠ m e̞ k ɯ̟ᵝ
きりさめ	kʲ i ɾʲ i s a̠ m e̞
きりとる	kʲ i ɾʲ i t o̞ ɾ ɯ̟ᵝ
きりはなす	kʲ i ɾʲ i h a̠ n a̠ s ɨᵝ
きりょう	kʲ i ɾʲ o̞ː
きりん	kʲ i ɾʲ ĩ ɴ
きりんざ	kʲ i ɾʲ ĩ n d͡z a̠
きれる	kʲ i ɾ e̞ ɾ ɯ̟ᵝ
きろう	kʲ i ɾ o̞ː
きんきょう	kʲ ĩ ŋʲ kʲ o̞ː
きんし	kʲ ĩ ɰ̃ ɕ i
きんしがん	kʲ ĩ ɰ̃ ɕ i ɡ ã̠ ɴ
きんしじゃく	kʲ ĩ ɰ̃ ɕ i ʑ a̠ k ɯ̟ᵝ
きんじ	kʲ ĩ ɲ̟ d͡ʑ i
きんじつ	kʲ ĩ ɲ̟ d͡ʑ i t͡s ɨᵝ
きんせい	kʲ ĩ ɰ̃ s e̞ː
きんぞく	kʲ ĩ n d͡z o̞ k ɯ̟ᵝ
きんつぎ	kʲ ĩ n t͡s ɨᵝ ɡʲ i
きんもくせい	kʲ ĩ mː o̞ k ɯ̟ᵝ s e̞ː
きんるい	kʲ ĩ n ɾ ɯ̟ᵝ i
きんろう	kʲ ĩ n ɾ o̞ː
ぎおん	ɡʲ i õ̞ ɴ
ぎけつ	ɡʲ i k e̞ t͡s ɨᵝ
ぎざ	ɡʲ i z a̠
ぎしん	ɡʲ i ɕ ĩ ɴ
ぎじょう	ɡʲ i ʑ o̞ː
ぎふん	ɡʲ i ɸ ɯ̟̃ᵝ ɴ
ぎほう	ɡʲ i h o̞ː
ぎぼ	ɡʲ i b o̞
ぎまい	ɡʲ i m a̠ i
ぎもんぶん	ɡʲ i m õ̞ m b ɯ̟̃ᵝ ɴ
ぎゃくすう	ɡʲ a̠ k ɯ̟ᵝ s ɨᵝː
ぎゅうし	ɡʲ ɨᵝː ɕ i
ぎゅうにゅう	ɡʲ ɨᵝː ɲ̟ ɯ̟ᵝː
ぎょう	ɡʲ o̞ː
ぎょうしゅう	ɡʲ o̞ː ɕ ɨᵝː
ぎょうしょ	ɡʲ o̞ː ɕ o̞
ぎょく	ɡʲ o̞ k ɯ̟ᵝ
ぎょくじん	ɡʲ o̞ k ɯ̟ᵝ ʑ ĩ ɴ
ぎょぐん	ɡʲ o̞ ɡ ɯ̟̃ᵝ ɴ
ぎょしゃざ	ɡʲ o̞ ɕ a̠ z a̠
ぎょるいがくてき	ɡʲ o̞ ɾ ɯ̟ᵝ i ɡ a̠ k ɯ̟ᵝ t e̞ kʲ i
ぎんこう	ɡʲ ĩ ŋ k o̞ː
くいき	k ɯ̟ᵝ i kʲ i
くいちがい	k ɯ̟ᵝ i t͡ɕ i ɡ a̠ i
くうい	k ɯ̟ᵝː i
くうさ	k ɯ̟ᵝː s a̠
くうさつ	k ɯ̟ᵝː s a̠ t͡s ɨᵝ
くうちょう	k ɯ̟ᵝː t͡ɕ o̞ː
くうらん	k ɯ̟ᵝː ɾ ã̠ ɴ
くがつ	k ɯ̟ᵝ ɡ a̠ t͡s ɨᵝ
くき	k ɯ̟̊ᵝ kʲ i
くきちゃ	k ɯ̟ᵝ kʲ i t͡ɕ a̠
くきわかめ	k ɯ̟ᵝ kʲ i ɰᵝ a̠ k a̠ m e̞
くぎ	k ɯ̟ᵝ ɡʲ i
くぐつ	k ɯ̟ᵝ ɡ ɯ̟ᵝ t͡s ɨᵝ
くぐりぬける	k ɯ̟ᵝ ɡ ɯ̟ᵝ ɾʲ i n ɯ̟ᵝ k e̞ ɾ ɯ̟ᵝ
くさ	k ɯ̟̊ᵝ s a̠
くさか	k ɯ̟ᵝ s a̠ k a̠
くさる	k ɯ̟ᵝ s a̠ ɾ ɯ̟ᵝ
くじ	k ɯ̟ᵝ ʑ i
くじゃくざ	k ɯ̟ᵝ ʑ a̠ k ɯ̟ᵝ z a̠
くじゃくせき	k ɯ̟ᵝ ʑ a̠ k ɯ̟ᵝ s e̞ kʲ i
くじら	k ɯ̟ᵝ ʑ i ɾ a̠
くすりゆび	k ɯ̟̊ᵝ s ɨᵝ ɾʲ i j ɯ̟ᵝ bʲ i
くず	k ɯ̟ᵝ z ɨᵝ
くずす	k ɯ̟ᵝ z ɨᵝ s ɨᵝ
くずゆ	k ɯ̟ᵝ z ɨᵝ j ɯ̟ᵝ
くずり	k ɯ̟ᵝ z ɨᵝ ɾʲ i
くせげ	k ɯ̟ᵝ s e̞ ɡ e̞
くそぶくろ	k u s o b u k u r o
くたびれる	k ɯ̟ᵝ t a̠ bʲ i ɾ e̞ ɾ ɯ̟ᵝ
くださる	k ɯ̟ᵝ d a̠ s a̠ ɾ ɯ̟ᵝ
くだる	k ɯ̟ᵝ d a̠ ɾ ɯ̟ᵝ
くちさき	k ɯ̟ᵝ t͡ɕ i s a̠ kʲ i
くちはっちょうてはっちょう	k ɯ̟ᵝ t͡ɕ i h a̠ t̚ t͡ɕ o̞ː t e̞ h a̠ t̚ t͡ɕ o̞ː
くちはてる	k ɯ̟ᵝ t͡ɕ i h a̠ t e̞ ɾ ɯ̟ᵝ
くちわ	k ɯ̟ᵝ t͡ɕ i ɰᵝ a̠
くっきょくい	k ɯ̟ᵝ k̚ʲ kʲ o̞ k ɯ̟ᵝ i
くっせつりつ	k ɯ̟̊ᵝ sː e̞ t͡s ɨᵝ ɾʲ i t͡s ɨᵝ
くっぷく	k ɯ̟ᵝ p̚ p ɯ̟ᵝ k ɯ̟ᵝ
くつかくし	k ɯ̟ᵝ t͡s ɨᵝ k a̠ k ɯ̟ᵝ ɕ i
くつがえる	k ɯ̟ᵝ t͡s ɨᵝ ɡ a̠ e̞ ɾ ɯ̟ᵝ
くつちふす	k ɯ̟ᵝ t͡s ɨᵝ t͡ɕ i ɸ ɯ̟ᵝ s ɨᵝ
くつや	k ɯ̟ᵝ t͡s ɨᵝ j a̠
くにふさ	k ɯ̟ᵝ ɲ̟ i ɸ ɯ̟ᵝ s a̠
くのいち	k ɯ̟ᵝ n o̞ i t͡ɕ i
くびかざり	k ɯ̟ᵝ bʲ i k a̠ z a̠ ɾʲ i
くびったけ	k ɯ̟ᵝ bʲ i t̚ t a̠ k e̞
くびつり	k ɯ̟ᵝ bʲ i t͡s ɨᵝ ɾʲ i
くびながりゅう	k ɯ̟ᵝ bʲ i n a̠ ɡ a̠ ɾʲ ɨᵝː
くふう	k ɯ̟ᵝ ɸ ɯ̟ᵝː
くぶん	k ɯ̟ᵝ b ɯ̟̃ᵝ ɴ
くべつ	k ɯ̟ᵝ b e̞ t͡s ɨᵝ
くまで	k ɯ̟ᵝ m a̠ d e̞
くまもと	k ɯ̟ᵝ m a̠ m o̞ t o̞
くまもとけん	k ɯ̟ᵝ m a̠ m o̞ t o̞ k ẽ̞ ɴ
くみあわせ	k ɯ̟ᵝ mʲ i a̠ ɰᵝ a̠ s e̞
くみちょう	k ɯ̟ᵝ mʲ i t͡ɕ o̞ː
くめい	k ɯ̟ᵝ m e̞ː
くもひとで	k ɯ̟ᵝ m o̞ ç i̥ t o̞ d e̞
くもま	k ɯ̟ᵝ m o̞ m a̠
くもる	k ɯ̟ᵝ m o̞ ɾ ɯ̟ᵝ
くらい	k ɯ̟ᵝ ɾ a̠ i
くらべもの	k ɯ̟ᵝ ɾ a̠ b e̞ m o̞ n o̞
くりだす	k ɯ̟ᵝ ɾʲ i d a̠ s ɨᵝ
くるう	k ɯ̟ᵝ ɾ ɯ̟ᵝː
くるおしい	k ɯ̟ᵝ ɾ ɯ̟ᵝ o̞ ɕ iː
くるしみ	k ɯ̟ᵝ ɾ ɯ̟ᵝ ɕ i mʲ i
くるめる	k ɯ̟ᵝ ɾ ɯ̟ᵝ m e̞ ɾ ɯ̟ᵝ
くれがた	k ɯ̟ᵝ ɾ e̞ ɡ a̠ t a̠
くれないいろ	k ɯ̟ᵝ ɾ e̞ n a̠ i i ɾ o̞
くれなずむ	k ɯ̟ᵝ ɾ e̞ n a̠ z ɨᵝ m ɯ̟ᵝ
くろうたどり	k ɯ̟ᵝ ɾ o̞ ɯ̟ᵝ t a̠ d o̞ ɾʲ i
くろがも	k ɯ̟ᵝ ɾ o̞ ɡ a̠ m o̞
くろさい	k ɯ̟ᵝ ɾ o̞ s a̠ i
くろしお	k ɯ̟ᵝ ɾ o̞ ɕ i o̞
くろてん	k ɯ̟ᵝ ɾ o̞ t ẽ̞ ɴ
くろねこ	k ɯ̟ᵝ ɾ o̞ n e̞ k o̞
くろばむ	k ɯ̟ᵝ ɾ o̞ b a̠ m ɯ̟ᵝ
くろめがね	k ɯ̟ᵝ ɾ o̞ m e̞ ɡ a̠ n e̞
くろやなぎ	k ɯ̟ᵝ ɾ o̞ j a̠ n a̠ ɡʲ i
くわい	k ɯ̟ᵝ ɰᵝ a̠ i
くんしゅこく	k ɯ̟̃ᵝ ɰ̃ ɕ ɨ̥ᵝ k o̞ k ɯ̟ᵝ
くんぺん	k ɯ̟̃ᵝ m p ẽ̞ ɴ
ぐうきせい	ɡ ɯ̟ᵝː kʲ i̥ s e̞ː
ぐうぞう	ɡ ɯ̟ᵝː z o̞ː
ぐげん	ɡ ɯ̟ᵝ ɡ ẽ̞ ɴ
ぐしゃ	o̞ ɾ e̞ m o̞ n o̞
ぐち	ɡ ɯ̟ᵝ t͡ɕ i
ぐんか	ɡ ɯ̟̃ᵝ ŋ k a̠
ぐんとう	ɡ ɯ̟̃ᵝ n t o̞ː
ぐんようき	ɡ ɯ̟̃ᵝ ɰ̃ j o̞ː kʲ i
けいえい	k e̞ː e̞ː
けいかちゃ	k e̞ː k a̠ t͡ɕ a̠
けいかんざん	k e̞ː k ã̠ n d͡z ã̠ ɴ
けいこうぎょう	k e̞ː k o̞ː ɡʲ o̞ː
けいさんしき	k e̞ː s ã̠ ɰ̃ ɕ i kʲ i
けいじじょうがく	k e̞ː ʑ i ʑ o̞ː ɡ a̠ k ɯ̟ᵝ
けいじょう	k e̞ː ʑ o̞ː
けいせん	k e̞ː s ẽ̞ ɴ
けいそん	k e̞ː s õ̞ ɴ
けいてき	k e̞ː t e̞ kʲ i
けいひん	k e̞ː ç ĩ ɴ
けいぶ	k e̞ː b ɯ̟ᵝ
けいほう	k e̞ː h o̞ː
けいまい	k e̞ː m a̠ i
けいりん	k e̞ː ɾʲ ĩ ɴ
けえ	k e̞ː
けさ	k e̞ s a̠
けしょうしつ	k e̞ ɕ o̞ː ɕ i t͡s ɨᵝ
けす	k e̞ s ɨᵝ
けだもの	k e̞ d a̠ m o̞ n o̞
けっか	k e̞ k̚ k a̠
けっこんしき	k e̞ k̚ k õ̞ ɰ̃ ɕ i kʲ i
けっしん	k e̞ ɕː ĩ ɴ
けってい	k e̞ t̚ t e̞ː
けっとうち	k e̞ t̚ t o̞ː t͡ɕ i
けっぺき	k e̞ p̚ p e̞ kʲ i
けつあつ	k e̞ t͡s ɨᵝ a̠ t͡s ɨᵝ
けつあつけい	k e̞ t͡s ɨᵝ a̠ t͡s ɨᵝ k e̞ː
けつけつ	k e̞ t͡s ɨᵝ k e̞ t͡s ɨᵝ
けつごう	k e̞ t͡s ɨᵝ ɡ o̞ː
けつぞく	k e̞ t͡s ɨᵝ z o̞ k ɯ̟ᵝ
けつぼう	k e̞ t͡s ɨᵝ b o̞ː
けど	k e̞ d o̞
けながいたち	k e̞ n a̠ ɡ a̠ i t a̠ t͡ɕ i
けはい	k e̞ h a̠ i
けものみみ	k e̞ m o̞ n o̞ mʲ i mʲ i
けんあん	k ẽ̞ ɰ̃ ã̠ ɴ
けんきゅういん	k ẽ̞ ŋʲ kʲ ɨᵝː ĩ ɴ
けんきょ	k ẽ̞ ŋʲ kʲ o̞
けんぎゅうか	k ẽ̞ ŋʲ ɡʲ ɨᵝː k a̠
けんさく	k ẽ̞ ɰ̃ s a̠ k ɯ̟ᵝ
けんしこ	k ẽ̞ ɰ̃ ɕ i̥ k o̞
けんしゃ	k ẽ̞ ɰ̃ ɕ a̠
けんしん	k ẽ̞ ɰ̃ ɕ ĩ ɴ
けんしんてき	k ẽ̞ ɰ̃ ɕ ĩ n t e̞ kʲ i
けんじゃ	k ẽ̞ ɲ̟ d͡ʑ a̠
けんじゅつ	k ẽ̞ ɲ̟ d͡ʑ ɨᵝ t͡s ɨᵝ
けんせつ	k ẽ̞ ɰ̃ s e̞ t͡s ɨᵝ
けんそううん	k ẽ̞ ɰ̃ s o̞ː ɯ̟̃ᵝ ɴ
けんてい	k ẽ̞ n t e̞ː
けんにょう	k ẽ̞ ɲ̟ ɲ̟ o̞ː
けんばい	k ẽ̞ m b a̠ i
けんぶつにん	k ẽ̞ m b ɯ̟ᵝ t͡s ɨᵝ ɲ̟ ĩ ɴ
けんぺい	k ẽ̞ m p e̞ː
けんぽう	k ẽ̞ m p o̞ː
けんもほろろ	k ẽ̞ mː o̞ h o̞ ɾ o̞ ɾ o̞
げいぎ	ɡ e̞ː ɡʲ i
げいこ	ɡ e̞ː k o̞
げき	ɡ e̞ kʲ i
げじ	ɡ e̞ ʑ i
げせる	ɡ e̞ s e̞ ɾ ɯ̟ᵝ
げせん	ɡ e̞ s ẽ̞ ɴ
げっけい	ɡ e̞ k̚ k e̞ː
げっぺい	ɡ e̞ p̚ p e̞ː
げつがく	ɡ e̞ t͡s ɨᵝ ɡ a̠ k ɯ̟ᵝ
げつめん	ɡ e̞ t͡s ɨᵝ m ẽ̞ ɴ
げどく	ɡ e̞ d o̞ k ɯ̟ᵝ
げほうばこ	ɡ e̞ h o̞ː b a̠ k o̞
げん	ɡ ẽ̞ ɴ
げんいん	ɡ ẽ̞ ɰ̃ ĩ ɴ
げんえい	ɡ ẽ̞ ɰ̃ e̞ː
げんがく	ɡ ẽ̞ ŋ ɡ a̠ k ɯ̟ᵝ
げんさん	ɡ ẽ̞ ɰ̃ s ã̠ ɴ
げんざいち	ɡ ẽ̞ n d͡z a̠ i t͡ɕ i
げんしてき	ɡ ẽ̞ ɰ̃ ɕ i t e̞ kʲ i
げんしょく	ɡ ẽ̞ ɰ̃ ɕ o̞ k ɯ̟ᵝ
げんしりょく	ɡ ẽ̞ ɰ̃ ɕ i ɾʲ o̞ k ɯ̟ᵝ
げんじつ	ɡ ẽ̞ ɲ̟ d͡ʑ i t͡s ɨᵝ
げんじゅう	ɡ ẽ̞ ɲ̟ d͡ʑ ɨᵝː
げんじゅうみん	ɡ ẽ̞ ɲ̟ d͡ʑ ɨᵝː mʲ ĩ ɴ
げんそうきょく	ɡ ẽ̞ ɰ̃ s o̞ː kʲ o̞ k ɯ̟ᵝ
げんそく	ɡ ẽ̞ ɰ̃ s o̞ k ɯ̟ᵝ
げんたい	ɡ ẽ̞ n t a̠ i
げんだいご	ɡ ẽ̞ n d a̠ i ɡ o̞
げんてん	ɡ ẽ̞ n t ẽ̞ ɴ
げんどうき	ɡ ẽ̞ n d o̞ː kʲ i
げんば	ɡ ẽ̞ m b a̠
げんぱつせい	ɡ ẽ̞ m p a̠ t͡s ɨᵝ s e̞ː
げんぴん	ɡ ẽ̞ m pʲ ĩ ɴ
げんめつ	ɡ ẽ̞ mː e̞ t͡s ɨᵝ
げんや	ɡ ẽ̞ ɰ̃ j a̠
こういってん	k o̞ː i t̚ t ẽ̞ ɴ
こうおつ	k o̞ː o̞ t͡s ɨᵝ
こうおつへい	k o̞ː o̞ t͡s ɨᵝ h e̞ː
こうおつへいてい	k o̞ː o̞ t͡s ɨᵝ h e̞ː t e̞ː
こうかくろう	k o̞ː k a̠ k ɯ̟ᵝ ɾ o̞ː
こうがく	k o̞ː ɡ a̠ k ɯ̟ᵝ
こうきしん	k o̞ː kʲ i ɕ ĩ ɴ
こうきょ	k o̞ː kʲ o̞
こうくう	k o̞ː k ɯ̟ᵝː
こうぐん	k o̞ː ɡ ɯ̟̃ᵝ ɴ
こうけっとう	k o̞ː k e̞ t̚ t o̞ː
こうけつあつ	k o̞ː k e̞ t͡s ɨᵝ a̠ t͡s ɨᵝ
こうげい	k o̞ː ɡ e̞ː
こうこ	k o̞ː k o̞
こうこう	k o̞ː k o̞ː
こうご	k o̞ː ɡ o̞
こうごう	k o̞ː ɡ o̞ː
こうさつ	k o̞ː s a̠ t͡s ɨᵝ
こうさん	k o̞ː s ã̠ ɴ
こうしき	k o̞ː ɕ i̥ kʲ i
こうしゃく	k o̞ː ɕ a̠ k ɯ̟ᵝ
こうしゅうでんわ	k o̞ː ɕ ɨᵝː d ẽ̞ ɰ̃ ɰᵝ a̠
こうしょ	k o̞ː ɕ o̞
こうじゅん	k o̞ː ʑ ɨ̃ᵝ ɴ
こうじょう	k o̞ː ʑ o̞ː
こうずい	k o̞ː z ɨᵝ i
こうそくい	k o̞ː s o̞ k ɯ̟ᵝ i
こうそくどうろ	k o̞ː s o̞ k ɯ̟ᵝ d o̞ː ɾ o̞
こうぞく	k o̞ː z o̞ k ɯ̟ᵝ
こうちしょ	k o̞ː t͡ɕ i ɕ o̞
こうどう	k o̞ː d o̞ː
こうなん	k o̞ː n ã̠ ɴ
こうばい	k o̞ː b a̠ i
こうひょう	k o̞ː ç o̞ː
こうぶつがく	k o̞ː b ɯ̟ᵝ t͡s ɨᵝ ɡ a̠ k ɯ̟ᵝ
こうへいむし	k o̞ː h e̞ː m ɯ̟ᵝ ɕ i
こうぼう	k o̞ː b o̞ː
こうむしっこうぼうがい	k o̞ː m ɯ̟ᵝ ɕ i k̚ k o̞ː b o̞ː ɡ a̠ i
こうもうじん	k o̞ː m o̞ː ʑ ĩ ɴ
こうもく	k o̞ː m o̞ k ɯ̟ᵝ
こうもり	k o̞ː m o̞ ɾʲ i
こうもりがさ	k o̞ː m o̞ ɾʲ i ɡ a̠ s a̠
こうや	k o̞ː j a̠
こうゆう	k o̞ː j ɯ̟ᵝː
こうよう	k o̞ː j o̞ː
こうりん	k o̞ː ɾʲ ĩ ɴ
こうる	k o̞ː ɾ ɯ̟ᵝ
こおり	k o̞ː ɾʲ i
こがき	k o̞ ɡ a̠ kʲ i
こきゅうき	k o̞ kʲ ɨᵝː kʲ i
こくえい	k o̞ k ɯ̟ᵝ e̞ː
こくくじら	k o̞ k ɯ̟̊ᵝ k ɯ̟ᵝ ʑ i ɾ a̠
こくご	k o̞ k ɯ̟ᵝ ɡ o̞
こくごう	k o̞ k ɯ̟ᵝ ɡ o̞ː
こくしょう	k o̞ k ɯ̟̊ᵝ ɕ o̞ː
こくふく	k o̞ k ɯ̟ᵝ ɸ ɯ̟̊ᵝ k ɯ̟ᵝ
こくゆうか	k o̞ k ɯ̟ᵝ j ɯ̟ᵝː k a̠
こくる	k o̞ k ɯ̟ᵝ ɾ ɯ̟ᵝ
こけむし	k o̞ k e̞ m ɯ̟ᵝ ɕ i
ここち	k o̞ k o̞ t͡ɕ i
こころざす	k o̞ k o̞ ɾ o̞ z a̠ s ɨᵝ
こころぼそい	k o̞ k o̞ ɾ o̞ b o̞ s o̞ i
こころみる	k o̞ k o̞ ɾ o̞ mʲ i ɾ ɯ̟ᵝ
こさけ	k o̞ s a̠ k e̞
こさめ	k o̞ s a̠ m e̞
こさん	k o̞ s ã̠ ɴ
こし	k o̞ ɕ i
こしんとう	k o̞ ɕ ĩ n t o̞ː
こじいん	k o̞ ʑ i ĩ ɴ
こじつよみ	k o̞ ʑ i t͡s ɨᵝ j o̞ mʲ i
こせい	k o̞ s e̞ː
こだいこうこく	k o̞ d a̠ i k o̞ː k o̞ k ɯ̟ᵝ
こちゃ	k o̞ t͡ɕ a̠
こっか	k o̞ k̚ k a̠
こっきょう	k o̞ k̚ʲ kʲ o̞ː
こっくん	k o̞ k̚ k ɯ̟̃ᵝ ɴ
こっし	k o̞ ɕː i
こっそり	k o̞ sː o̞ ɾʲ i
こっち	k o̞ t̚ t͡ɕ i
こっとうひん	k o̞ t̚ t o̞ː ç ĩ ɴ
こづつみ	k o̞ z ɨᵝ t͡s ɨᵝ mʲ i
ことざ	k o̞ t o̞ z a̠
ことは	k o̞ t o̞ h a̠
こどく	k o̞ d o̞ k ɯ̟ᵝ
こどものひ	k o̞ d o̞ m o̞ n o̞ ç i
こなちゃ	k o̞ n a̠ t͡ɕ a̠
こはん	k o̞ h ã̠ ɴ
こび	k o̞ bʲ i
こふう	k o̞ ɸ ɯ̟ᵝː
こぶし	k o̞ b ɯ̟ᵝ ɕ i
こま	k o̞ m a̠
こまち	k o̞ m a̠ t͡ɕ i
こまつ	k o̞ m a̠ t͡s ɨᵝ
こまぶえ	k o̞ m a̠ b ɯ̟ᵝ e̞
こむ	k o̞ m ɯ̟ᵝ
こもりうた	k o̞ m o̞ ɾʲ i ɯ̟ᵝ t a̠
こもりぐま	k o̞ m o̞ ɾʲ i ɡ ɯ̟ᵝ m a̠
こもる	k o̞ m o̞ ɾ ɯ̟ᵝ
こゆび	k o̞ j ɯ̟ᵝ bʲ i
こより	k o̞ j o̞ ɾʲ i
こらす	k o̞ ɾ a̠ s ɨᵝ
こりる	k o̞ ɾʲ i ɾ ɯ̟ᵝ
こりん	k o̞ ɾʲ ĩ ɴ
こる	k o̞ ɾ ɯ̟ᵝ
ころがる	k o̞ ɾ o̞ ɡ a̠ ɾ ɯ̟ᵝ
ころす	k o̞ ɾ o̞ s ɨᵝ
ころも	k o̞ ɾ o̞ m o̞
こわれる	k o̞ ɰᵝ a̠ ɾ e̞ ɾ ɯ̟ᵝ
こん	k õ̞ ɴ
こんご	k õ̞ ŋ ɡ o̞
こんじょう	k õ̞ ɲ̟ d͡ʑ o̞ː
こんぜつ	k õ̞ n d͡z e̞ t͡s ɨᵝ
こんど	k õ̞ n d o̞
こんぶちゃ	k õ̞ m b ɯ̟ᵝ t͡ɕ a̠
こんぺき	k õ̞ m p e̞ kʲ i
こんやく	k õ̞ ɰ̃ j a̠ k ɯ̟ᵝ
こんらん	k õ̞ n ɾ ã̠ ɴ
こんれい	k õ̞ n ɾ e̞ː
こんろ	k õ̞ n ɾ o̞
ごあく	ɡ o̞ a̠ k ɯ̟ᵝ
ごいしゅう	ɡ o̞ i ɕ ɨᵝː
ごいりょく	ɡ o̞ i ɾʲ o̞ k ɯ̟ᵝ
ごうじ	ɡ o̞ː ʑ i
ごうせいすう	ɡ o̞ː s e̞ː s ɨᵝː
ごうてい	ɡ o̞ː t e̞ː
ごうべんがいしゃ	ɡ o̞ː b ẽ̞ ŋ ɡ a̠ i ɕ a̠
ごうよく	ɡ o̞ː j o̞ k ɯ̟ᵝ
ごうりか	ɡ o̞ː ɾʲ i k a̠
ごうりてき	ɡ o̞ː ɾʲ i t e̞ kʲ i
ごえい	ɡ o̞ e̞ː
ごえもんぶろ	ɡ o̞ e̞ m õ̞ m b ɯ̟ᵝ ɾ o̞
ごがつびょう	ɡ o̞ ɡ a̠ t͡s ɨᵝ bʲ o̞ː
ごくあく	ɡ o̞ k ɯ̟ᵝ a̠ k ɯ̟ᵝ
ごくしょ	ɡ o̞ k ɯ̟ᵝ ɕ o̞
ごくじょう	ɡ o̞ k ɯ̟ᵝ ʑ o̞ː
ごくそく	ɡ o̞ k ɯ̟ᵝ s o̞ k ɯ̟ᵝ
ごくらくちょう	ɡ o̞ k ɯ̟ᵝ ɾ a̠ k ɯ̟̊ᵝ t͡ɕ o̞ː
ごけんてい	ɡ o̞ k ẽ̞ n t e̞ː
ごげんてき	ɡ o̞ ɡ ẽ̞ n t e̞ kʲ i
ごこん	ɡ o̞ k õ̞ ɴ
ごしん	ɡ o̞ ɕ ĩ ɴ
ごしんじゅつ	ɡ o̞ ɕ ĩ ɲ̟ d͡ʑ ɨᵝ t͡s ɨᵝ
ごじゅう	ɡ o̞ ʑ ɨᵝː
ごじゅうおん	ɡ o̞ ʑ ɨᵝː õ̞ ɴ
ごじる	ɡ o̞ ʑ i ɾ ɯ̟ᵝ
ごすんくぎ	ɡ o̞ s ɨ̃ᵝ ŋ k ɯ̟ᵝ ɡʲ i
ごぜんちゅう	ɡ o̞ z ẽ̞ ɲ̟ t͡ɕ ɨᵝː
ごっかん	ɡ o̞ k̚ k ã̠ ɴ
ごっこ	ɡ o̞ k̚ k o̞
ごはっと	ɡ o̞ h a̠ t̚ t o̞
ごはん	ɡ o̞ h ã̠ ɴ
ごばん	ɡ o̞ b ã̠ ɴ
ごび	ɡ o̞ bʲ i
ごぼごぼ	ɡ o̞ b o̞ ɡ o̞ b o̞
ごま	ɡ o̞ m a̠
ごろく	ɡ o̞ ɾ o̞ k ɯ̟ᵝ
さいか	s a̠ i k a̠
さいかい	s a̠ i k a̠ i
さいかくにん	s a̠ i k a̠ k ɯ̟ᵝ ɲ̟ ĩ ɴ
さいきんがく	s a̠ i kʲ ĩ ŋ ɡ a̠ k ɯ̟ᵝ
さいこうせい	s a̠ i k o̞ː s e̞ː
さいじょう	s a̠ i ʑ o̞ː
さいた	s a̠ i t a̠
さいちゅう	s a̠ i t͡ɕ ɨᵝː
さいなんじけん	s a̠ i n ã̠ ɲ̟ d͡ʑ i k ẽ̞ ɴ
さいにゅう	s a̠ i ɲ̟ ɯ̟ᵝː
さいぼう	s a̠ i b o̞ː
さいみん	s a̠ i mʲ ĩ ɴ
さいもく	s a̠ i m o̞ k ɯ̟ᵝ
さいゆうせん	s a̠ i j ɯ̟ᵝː s ẽ̞ ɴ
さいりょう	s a̠ i ɾʲ o̞ː
さえぎる	s a̠ e̞ ɡʲ i ɾ ɯ̟ᵝ
さえずる	s a̠ e̞ z ɨᵝ ɾ ɯ̟ᵝ
さえない	s a̠ e̞ n a̠ i
さえもん	s a̠ e̞ m õ̞ ɴ
さえん	s a̠ ẽ̞ ɴ
さかな	s a̠ k a̠ n a̠
さかむけ	s a̠ k a̠ m ɯ̟ᵝ k e̞
さがす	s a̠ ɡ a̠ s ɨᵝ
さき	s a̠ kʲ i
さきだつ	s a̠ kʲ i d a̠ t͡s ɨᵝ
さきん	s a̠ kʲ ĩ ɴ
さぎょうぎ	s a̠ ɡʲ o̞ː ɡʲ i
さく	s a̠ k ɯ̟ᵝ
さくさん	s a̠ k ɯ̟ᵝ s ã̠ ɴ
さくしゃ	s a̠ k ɯ̟̊ᵝ ɕ a̠
さくちょう	s a̠ k ɯ̟ᵝ t͡ɕ o̞ː
さくひん	s a̠ k ɯ̟̊ᵝ ç ĩ ɴ
さくふう	s a̠ k ɯ̟ᵝ ɸ ɯ̟ᵝː
さくらんぼう	s a̠ k ɯ̟ᵝ ɾ ã̠ m b o̞ː
さくりゃく	s a̠ k ɯ̟ᵝ ɾʲ a̠ k ɯ̟ᵝ
さぐりいれる	s a̠ ɡ ɯ̟ᵝ ɾʲ i i ɾ e̞ ɾ ɯ̟ᵝ
さけ	s a̠ k e̞
さけび	s a̠ k e̞ bʲ i
さけぶ	s a̠ k e̞ b ɯ̟ᵝ
さける	s a̠ k e̞ ɾ ɯ̟ᵝ
さこう	s a̠ k o̞ː
さごじょう	s a̠ ɡ o̞ ʑ o̞ː
ささえ	s a̠ s a̠ e̞
ささかまぼこ	s a̠ s a̠ k a̠ m a̠ b o̞ k o̞
ささくれ	s a̠ s a̠ k ɯ̟ᵝ ɾ e̞
ささげる	s a̠ s a̠ ɡ e̞ ɾ ɯ̟ᵝ
ささやく	s a̠ s a̠ j a̠ k ɯ̟ᵝ
さざえ	s a̠ z a̠ e̞
さざなみ	s a̠ z a̠ n a̠ mʲ i
さしつかえる	s a̠ ɕ i t͡s ɨᵝ k a̠ e̞ ɾ ɯ̟ᵝ
さしでがましい	s a̠ ɕ i d e̞ ɡ a̠ m a̠ ɕ iː
さしひかえる	s a̠ ɕ i ç i k a̠ e̞ ɾ ɯ̟ᵝ
さしみぼうちょう	s a̠ ɕ i mʲ i b o̞ː t͡ɕ o̞ː
さすが	s a̠ s ɨᵝ ɡ a̠
さずかりこん	s a̠ z ɨᵝ k a̠ ɾʲ i k õ̞ ɴ
さずける	s a̠ z ɨᵝ k e̞ ɾ ɯ̟ᵝ
さそう	s a̠ s o̞ ɯ̟ᵝ
さだいじん	s a̠ d a̠ i ʑ ĩ ɴ
さっか	s a̠ k k a̠
さっかく	s a̠ k̚ k a̠ k ɯ̟ᵝ
さっきん	s a̠ k̚ʲ kʲ ĩ ɴ
さっそざい	s a̠ sː o̞ z a̠ i
さっちゅうざい	s a̠ t̚ t͡ɕ ɨᵝː z a̠ i
さっぱり	s a̠ p̚ p a̠ ɾʲ i
さっぷうけい	s a̠ p̚ p ɯ̟ᵝː k e̞ː
さっぽろ	s a̠ p̚ p o̞ ɾ o̞
さつじん	s a̠ t͡s ɨᵝ ʑ ĩ ɴ
さつばつ	s a̠ t͡s ɨᵝ b a̠ t͡s ɨᵝ
さと	s a̠ t o̞
さとい	s a̠ t o̞ i
さなだひも	s a̠ n a̠ d a̠ ç i m o̞
さば	s a̠ b a̠
さばおち	s a̠ b a̠ o̞ t͡ɕ i
さばき	s a̠ b a̠ kʲ i
さびつく	s a̠ bʲ i t͡s ɨᵝ k ɯ̟ᵝ
さびる	s a̠ bʲ i ɾ ɯ̟ᵝ
さほひめ	s a̠ h o̞ ç i m e̞
さま	s a̠ m a̠
さます	s a̠ m a̠ s ɨᵝ
さみだれ	s a̠ mʲ i d a̠ ɾ e̞
さむい	s a̠ m ɯ̟ᵝ i
さゆ	s a̠ j ɯ̟ᵝ
さよ	s a̠ j o̞
さよく	s a̠ j o̞ k ɯ̟ᵝ
さよなら	s a̠ j o̞ n a̠ ɾ a̠
さらいしゅう	s a̠ ɾ a̠ i ɕ ɨᵝː
さらう	s a̠ ɾ a̠ ɯ̟ᵝ
さるがく	s a̠ ɾ ɯ̟ᵝ ɡ a̠ k ɯ̟ᵝ
さわやか	s a̠ ɰᵝ a̠ j a̠ k a̠
さんか	s ã̠ ŋ k a̠
さんかん	s ã̠ ŋ k ã̠ ɴ
さんきゅう	s ã̠ ŋʲ kʲ ɨᵝː
さんきょくかん	s ã̠ ŋʲ kʲ o̞ k ɯ̟̊ᵝ k ã̠ ɴ
さんしょう	s ã̠ ɰ̃ ɕ o̞ː
さんしょううお	s ã̠ ɰ̃ ɕ o̞ː ɯ̟ᵝ o̞
さんじゅういち	s ã̠ ɲ̟ d͡ʑ ɨᵝː i t͡ɕ i
さんじゅうにち	s ã̠ ɲ̟ d͡ʑ ɨᵝː ɲ̟ i t͡ɕ i
さんじゅうはち	s ã̠ ɲ̟ d͡ʑ ɨᵝː h a̠ t͡ɕ i
さんじゅうろっけい	s ã̠ ɲ̟ d͡ʑ ɨᵝː ɾ o̞ k̚ k e̞ː
さんじょうき	s ã̠ ɲ̟ d͡ʑ o̞ː kʲ i
さんせい	s ã̠ ɰ̃ s e̞ː
さんそ	s ã̠ ɰ̃ s o̞
さんだんじゅう	s ã̠ n d ã̠ ɲ̟ d͡ʑ ɨᵝː
さんぶさく	s ã̠ m b ɯ̟ᵝ s a̠ k ɯ̟ᵝ
さんぷ	s ã̠ m p ɯ̟ᵝ
さんぼう	s ã̠ m b o̞ː
さんみゃく	s ã̠ mʲː a̠ k ɯ̟ᵝ
さんようき	s ã̠ ɰ̃ j o̞ː kʲ i
さんわ	s ã̠ ɰ̃ ɰᵝ a̠
ざいしょく	d͡z a̠ i ɕ o̞ k ɯ̟ᵝ
ざくろいし	d͡z a̠ k ɯ̟ᵝ ɾ o̞ i ɕ i
ざこね	d͡z a̠ k o̞ n e̞
ざしき	d͡z a̠ ɕ i kʲ i
ざぜん	d͡z a̠ z ẽ̞ ɴ
ざそう	d͡z a̠ s o̞ː
ざだんかい	d͡z a̠ d ã̠ ŋ k a̠ i
ざっこく	d͡z a̠ k̚ k o̞ k ɯ̟ᵝ
ざっし	d͡z a̠ ɕː i
ざっしょく	d͡z a̠ ɕː o̞ k ɯ̟ᵝ
ざった	d͡z a̠ t̚ t a̠
ざっと	d͡z a̠ t̚ t o̞
ざつだん	d͡z a̠ t͡s ɨᵝ d ã̠ ɴ
ざとう	d͡z a̠ t o̞ː
ざとうくじら	d͡z a̠ t o̞ː k ɯ̟ᵝ ʑ i ɾ a̠
ざひょう	d͡z a̠ ç o̞ː
ざぶとん	d͡z a̠ b ɯ̟ᵝ t õ̞ ɴ
ざりがに	d͡z a̠ ɾʲ i ɡ a̠ ɲ̟ i
ざるそば	d͡z a̠ ɾ ɯ̟ᵝ s o̞ b a̠
ざんき	d͡z ã̠ ŋʲ kʲ i
ざんきょう	d͡z ã̠ ŋʲ kʲ o̞ː
ざんこく	d͡z ã̠ ŋ k o̞ k ɯ̟ᵝ
ざんにょうかん	d͡z ã̠ ɲ̟ ɲ̟ o̞ː k ã̠ ɴ
しいてき	ɕ i i t e̞ kʲ i
しいれる	ɕ iː ɾ e̞ ɾ ɯ̟ᵝ
しおきば	ɕ i o̞ kʲ i b a̠
しかい	ɕ i k a̠ i
しかいのしし	ɕ i k a̠ i n o̞ ɕ i ɕ i
しかくい	ɕ i k a̠ k ɯ̟ᵝ i
しかくけい	ɕ i̥ k a̠ k ɯ̟̊ᵝ k e̞ː
しかんしき	ɕ i k ã̠ ɰ̃ ɕ i kʲ i
しがいきょくばん	ɕ i ɡ a̠ i kʲ o̞ k ɯ̟ᵝ b ã̠ ɴ
しがく	ɕ i ɡ a̠ k ɯ̟ᵝ
しきがわら	ɕ i kʲ i ɡ a̠ ɰᵝ a̠ ɾ a̠
しきしゃ	ɕ i kʲ i̥ ɕ a̠
しきものるい	ɕ i kʲ i m o̞ n o̞ ɾ ɯ̟ᵝ i
しぎ	ɕ i ɡʲ i
しくら	ɕ i k ɯ̟ᵝ ɾ a̠
しけん	ɕ i k ẽ̞ ɴ
しげき	ɕ i ɡ e̞ kʲ i
しげゆき	ɕ i ɡ e̞ j ɯ̟ᵝ kʲ i
しこうてい	ɕ i̥ k o̞ː t e̞ː
しご	ɕ i ɡ o̞
しごとりつ	ɕ i ɡ o̞ t o̞ ɾʲ i t͡s ɨᵝ
しざい	ɕ i z a̠ i
ししざ	ɕ i̥ ɕ i z a̠
ししまい	ɕ i ɕ i m a̠ i
ししゅ	ɕ i ɕ ɨᵝ
ししゅんき	ɕ i̥ ɕ ɨ̃ᵝ ŋʲ kʲ i
ししょばこ	ɕ i̥ ɕ o̞ b a̠ k o̞
しじゅうから	ɕ i ʑ ɨᵝː k a̠ ɾ a̠
しじゅうからがん	ɕ i ʑ ɨᵝː k a̠ ɾ a̠ ɡ ã̠ ɴ
しずおかけん	ɕ i z ɨᵝ o̞ k a̠ k ẽ̞ ɴ
しずむ	ɕ i z ɨᵝ m ɯ̟ᵝ
しせいかつ	ɕ i s e̞ː k a̠ t͡s ɨᵝ
しぜん	ɕ i z ẽ̞ ɴ
しぜんてき	ɕ i z ẽ̞ n t e̞ kʲ i
しそつ	ɕ i s o̞ t͡s ɨᵝ
したがう	ɕ i t a̠ ɡ a̠ ɯ̟ᵝ
したごしらえ	ɕ i t a̠ ɡ o̞ ɕ i ɾ a̠ e̞
したしむ	ɕ i t a̠ ɕ i m ɯ̟ᵝ
したじき	ɕ i t a̠ ʑ i kʲ i
したて	ɕ i t a̠ t e̞
しちじゅう	ɕ i t͡ɕ i ʑ ɨᵝː
しちせい	ɕ i t͡ɕ i s e̞ː
しっかく	ɕ i k̚ k a̠ k ɯ̟ᵝ
しっかん	ɕ i k̚ k ã̠ ɴ
しっこう	ɕ i k̚ k o̞ː
しっしょう	ɕ i ɕː o̞ː
しっそう	ɕ i s s o̞ː
しっちょう	ɕ i t̚ t͡ɕ o̞ː
しっぽうやき	ɕ i p̚ p o̞ː j a̠ kʲ i
しつぎおとう	ɕ i t͡s ɨᵝ ɡʲ i o̞ t o̞ː
しつりょう	ɕ i̥ t͡s ɨᵝ ɾʲ o̞ː
してんのう	ɕ i t ẽ̞ nː o̞ː
しとう	ɕ i t o̞ː
しとやか	ɕ i t o̞ j a̠ k a̠
しな	ɕ i n a̠
しながどり	ɕ i n a̠ ɡ a̠ d o̞ ɾʲ i
しなす	ɕ i n a̠ s ɨᵝ
しなやか	ɕ i n a̠ j a̠ k a̠
しにかける	ɕ i ɲ̟ i k a̠ k e̞ ɾ ɯ̟ᵝ
しのびがたな	ɕ i n o̞ bʲ i ɡ a̠ t a̠ n a̠
しのびこむ	ɕ i n o̞ bʲ i k o̞ m ɯ̟ᵝ
しのぶ	ɕ i n o̞ b ɯ̟ᵝ
しはい	ɕ i h a̠ i
しはらい	ɕ i h a̠ ɾ a̠ i
しはらう	ɕ i h a̠ ɾ a̠ ɯ̟ᵝ
しばいごや	ɕ i b a̠ i ɡ o̞ j a̠
しばしば	ɕ i b a̠ ɕ i b a̠
しばん	ɕ i b ã̠ ɴ
しひとめ	ɕ ɨᵝː t o̞ m e̞
しぶん	ɕ i b ɯ̟̃ᵝ ɴ
しへい	ɕ i h e̞ː
しま	ɕ i m a̠
しまぐに	ɕ i m a̠ ɡ ɯ̟ᵝ ɲ̟ i
しまつ	ɕ i m a̠ t͡s ɨᵝ
しめす	ɕ i m e̞ s ɨᵝ
しもつき	ɕ i m o̞ t͡s ɨ̥ᵝ kʲ i
しゃ	ɕ a̠
しゃい	ɕ a̠ i
しゃいん	ɕ a̠ ĩ ɴ
しゃく	ɕ a̠ k ɯ̟ᵝ
しゃくいち	ɕ a̠ k ɯ̟ᵝ i t͡ɕ i
しゃくやく	ɕ a̠ k ɯ̟ᵝ j a̠ k ɯ̟ᵝ
しゃこ	ɕ a̠ k o̞
しゃしゅつ	ɕ a̠ ɕ ɨᵝ t͡s ɨᵝ
しゃしんか	ɕ a̠ ɕ ĩ ŋ k a̠
しゃしんき	ɕ a̠ ɕ ĩ ŋʲ kʲ i
しゃせい	ɕ a̠ s e̞ː
しゃちょう	ɕ a̠ t͡ɕ o̞ː
しゃっくり	ɕ a̠ k̚ k ɯ̟ᵝ ɾʲ i
しゃぶ	ɕ a̠ b ɯ̟ᵝ
しゃみ	ɕ a̠ mʲ i
しゃみせん	ɕ a̠ mʲ i s ẽ̞ ɴ
しゃもじ	ɕ a̠ m o̞ ʑ i
しゃゆうれんせき	ɕ a̠ j ɯ̟ᵝː ɾ ẽ̞ ɰ̃ s e̞ kʲ i
しゃりし	ɕ a̠ ɾʲ i ɕ i
しゅいん	ɕ ɨᵝ ĩ ɴ
しゅう	ɕ ɨᵝː
しゅうかぶつ	ɕ ɨᵝː k a̠ b ɯ̟ᵝ t͡s ɨᵝ
しゅうがくしょう	ɕ ɨᵝː ɡ a̠ k ɯ̟ᵝ ɕ o̞ː
しゅうしゅく	ɕ ɨᵝː ɕ ɨᵝ k ɯ̟ᵝ
しゅうじん	ɕ ɨᵝː ʑ ĩ ɴ
しゅうせい	ɕ ɨᵝː s e̞ː
しゅうだんか	ɕ ɨᵝː d ã̠ ŋ k a̠
しゅうちゃく	ɕ ɨᵝː t͡ɕ a̠ k ɯ̟ᵝ
しゅうにん	ɕ ɨᵝː ɲ̟ ĩ ɴ
しゅうはすう	ɕ ɨᵝː h a̠ s ɨᵝː
しゅうまい	ɕ ɨᵝː m a̠ i
しゅかく	ɕ ɨ̥ᵝ k a̠ k ɯ̟ᵝ
しゅきょう	ɕ ɨ̥ᵝ kʲ o̞ː
しゅくがかい	ɕ ɨᵝ k ɯ̟ᵝ ɡ a̠ k a̠ i
しゅくじょ	ɕ ɨᵝ k ɯ̟ᵝ ʑ o̞
しゅくはく	ɕ ɨᵝ k ɯ̟ᵝ h a̠ k ɯ̟ᵝ
しゅげい	ɕ ɨᵝ ɡ e̞ː
しゅしん	ɕ ɨᵝ ɕ ĩ ɴ
しゅじん	ɕ ɨᵝ ʑ ĩ ɴ
しゅずだま	ɕ ɨᵝ z ɨᵝ d a̠ m a̠
しゅぞう	ɕ ɨᵝ z o̞ː
しゅぞく	ɕ ɨᵝ z o̞ k ɯ̟ᵝ
しゅっちょうじょ	ɕ ɨᵝ t̚ t͡ɕ o̞ː ʑ o̞
しゅてん	ɕ u t e ɴ
しゅみ	ɕ ɨᵝ mʲ i
しゅもく	ɕ ɨᵝ m o̞ k ɯ̟ᵝ
しゅもくざめ	ɕ ɨᵝ m o̞ k ɯ̟ᵝ z a̠ m e̞
しゅゆ	ɕ ɨᵝ j ɯ̟ᵝ
しゅよう	ɕ ɨᵝ j o̞ː
しゅらばる	ɕ ɨᵝ ɾ a̠ b a̠ ɾ ɯ̟ᵝ
しゅんが	ɕ ɨ̃ᵝ ŋ ɡ a̠
しゅんじつ	ɕ ɨ̃ᵝ ɲ̟ d͡ʑ i t͡s ɨᵝ
しょうあん	ɕ o̞ː ã̠ ɴ
しょういんしん	ɕ o̞ː ĩ ɰ̃ ɕ ĩ ɴ
しょううちゅう	ɕ o̞ː ɯ̟ᵝ t͡ɕ ɨᵝː
しょうえんせい	ɕ o̞ː ẽ̞ ɰ̃ s e̞ː
しょうか	ɕ o̞ː k a̠
しょうかい	ɕ o̞ː k a̠ i
しょうかき	ɕ o̞ː k a̠ kʲ i
しょうかせん	ɕ o̞ː k a̠ s ẽ̞ ɴ
しょうかんじゅう	ɕ o̞ː k ã̠ ɲ̟ d͡ʑ ɨᵝː
しょうがいぶつ	ɕ o̞ː ɡ a̠ i b ɯ̟ᵝ t͡s ɨᵝ
しょうがっこう	ɕ o̞ː ɡ a̠ k̚ k o̞ː
しょうけん	ɕ o̞ː k ẽ̞ ɴ
しょうこく	ɕ o̞ː k o̞ k ɯ̟ᵝ
しょうご	ɕ o̞ː ɡ o̞
しょうさ	ɕ o̞ː s a̠
しょうし	ɕ o̞ː ɕ i
しょうしがん	ɕ o̞ː ɕ i ɡ ã̠ ɴ
しょうしょう	ɕ o̞ː ɕ o̞ː
しょうしん	ɕ o̞ː ɕ ĩ ɴ
しょうじゅう	ɕ o̞ː ʑ ɨᵝː
しょうじょ	ɕ o̞ː ʑ o̞
しょうじる	ɕ o̞ː ʑ i ɾ ɯ̟ᵝ
しょうすけ	ɕ o̞ː s ɨᵝ k e̞
しょうせい	ɕ o̞ː s e̞ː
しょうせいぶどうさんえん	ɕ o̞ː s e̞ː b ɯ̟ᵝ d o̞ː s ã̠ ɰ̃ ẽ̞ ɴ
しょうせつ	ɕ o̞ː s e̞ t͡s ɨᵝ
しょうぜんていせん	ɕ o̞ː z ẽ̞ n t e̞ː s ẽ̞ ɴ
しょうそつ	ɕ o̞ː s o̞ t͡s ɨᵝ
しょうぞく	ɕ o̞ː z o̞ k ɯ̟ᵝ
しょうどう	ɕ o̞ː d o̞ː
しょうにん	ɕ o̞ː ɲ̟ ĩ ɴ
しょうひぜい	ɕ o̞ː ç i z e̞ː
しょうひょう	ɕ o̞ː ç o̞ː
しょうふ	ɕ o̞ː ɸ ɯ̟ᵝ
しょうぼう	ɕ o̞ː b o̞ː
しょうまん	ɕ o̞ː m ã̠ ɴ
しょうめい	ɕ o̞ː m e̞ː
しょうやきょく	ɕ o̞ː j a̠ kʲ o̞ k ɯ̟ᵝ
しょうよ	ɕ o̞ː j o̞
しょうらん	ɕ o̞ː ɾ ã̠ ɴ
しょきちょう	ɕ o̞ kʲ i t͡ɕ o̞ː
しょく	ɕ o̞ k ɯ̟ᵝ
しょくがん	ɕ o̞ k ɯ̟ᵝ ɡ ã̠ ɴ
しょくぶつ	ɕ o̞ k ɯ̟ᵝ b ɯ̟ᵝ t͡s ɨᵝ
しょくめい	ɕ o̞ k ɯ̟ᵝ m e̞ː
しょくりょうひんてん	ɕ o̞ k ɯ̟ᵝ ɾʲ o̞ː ç ĩ n t ẽ̞ ɴ
しょじゅん	ɕ o̞ ʑ ɨ̃ᵝ ɴ
しょじょせい	ɕ o̞ ʑ o̞ s e̞ː
しょじょまく	ɕ o̞ ʑ o̞ m a̠ k ɯ̟ᵝ
しょす	ɕ o̞ s ɨᵝ
しょた	ɕ o̞ t a̠
しょっき	ɕ o̞ k̚ʲ kʲ i
しょっきだな	ɕ o̞ k̚ʲ kʲ i d a̠ n a̠
しょとう	ɕ o̞ t o̞ː
しょはん	ɕ o̞ h ã̠ ɴ
しょぶん	ɕ o̞ b ɯ̟̃ᵝ ɴ
しょほ	ɕ o̞ h o̞
しょほう	ɕ o̞ h o̞ː
しょめい	ɕ o̞ m e̞ː
しょり	ɕ o̞ ɾʲ i
しょるい	ɕ o̞ ɾ ɯ̟ᵝ i
しよう	ɕ i j o̞ː
しらたき	ɕ i ɾ a̠ t a̠ kʲ i
しらべる	ɕ i ɾ a̠ b e̞ ɾ ɯ̟ᵝ
しらむ	ɕ i ɾ a̠ m ɯ̟ᵝ
しらゆき	ɕ i ɾ a̠ j ɯ̟ᵝ kʲ i
しりとり	ɕ i ɾʲ i t o̞ ɾʲ i
しろうり	ɕ i ɾ o̞ ɯ̟ᵝ ɾʲ i
しろがしら	ɕ i ɾ o̞ ɡ a̠ ɕ i ɾ a̠
しろざけ	ɕ i ɾ o̞ z a̠ k e̞
しろねずみ	ɕ i ɾ o̞ n e̞ z ɨᵝ mʲ i
しわ	ɕ i ɰᵝ a̠
しんくう	ɕ ĩ ŋ k ɯ̟ᵝː
しんくうかん	ɕ ĩ ŋ k ɯ̟ᵝː k ã̠ ɴ
しんぐ	ɕ ĩ ŋ ɡ ɯ̟ᵝ
しんけいがく	ɕ ĩ ŋ k e̞ː ɡ a̠ k ɯ̟ᵝ
しんこく	ɕ ĩ ŋ k o̞ k ɯ̟ᵝ
しんごうき	ɕ ĩ ŋ ɡ o̞ː kʲ i
しんしゃく	ɕ ĩ ɰ̃ ɕ a̠ k ɯ̟ᵝ
しんしゅ	ɕ ĩ ɰ̃ ɕ ɨᵝ
しんじだい	ɕ ĩ ɲ̟ d͡ʑ i d a̠ i
しんじゅ	ɕ ĩ ɲ̟ d͡ʑ ɨᵝ
しんすい	ɕ ĩ ɰ̃ s ɨᵝ i
しんせいだい	ɕ ĩ ɰ̃ s e̞ː d a̠ i
しんそう	ɕ ĩ ɰ̃ s o̞ː
しんたく	ɕ ĩ n t a̠ k ɯ̟ᵝ
しんだん	ɕ ĩ n d ã̠ ɴ
しんちょうい	ɕ ĩ ɲ̟ t͡ɕ o̞ː i
しんつう	ɕ ĩ n t͡s ɨᵝː
しんにちは	ɕ ĩ ɲ̟ ɲ̟ i t͡ɕ i h a̠
しんねん	ɕ ĩ nː ẽ̞ ɴ
しんはんにん	ɕ ĩ ɰ̃ h ã̠ ɲ̟ ɲ̟ ĩ ɴ
しんぱ	ɕ ĩ m p a̠
しんぱい	ɕ ĩ m p a̠ i
しんぱいごと	ɕ ĩ m p a̠ i ɡ o̞ t o̞
しんぱいしょう	ɕ ĩ m p a̠ i ɕ o̞ː
しんぴん	ɕ ĩ m pʲ ĩ ɴ
しんぺん	ɕ ĩ m p ẽ̞ ɴ
しんぼう	ɕ ĩ m b o̞ː
しんぼうづよい	ɕ ĩ m b o̞ː z ɨᵝ j o̞ i
しんみつ	ɕ ĩ mʲː i t͡s ɨᵝ
しんめい	ɕ ĩ mː e̞ː
しんもん	ɕ ĩ mː õ̞ ɴ
しんよう	ɕ ĩ ɰ̃ j o̞ː
しんようじゅりん	ɕ ĩ ɰ̃ j o̞ː ʑ ɨᵝ ɾʲ ĩ ɴ
しんりょうじょ	ɕ ĩ n ɾʲ o̞ː ʑ o̞
しんわ	ɕ ĩ ɰ̃ ɰᵝ a̠
じかん	d͡ʑ i k ã̠ ɴ
じくさく	d͡ʑ i k ɯ̟ᵝ s a̠ k ɯ̟ᵝ
じけつ	d͡ʑ i k e̞ t͡s ɨᵝ
じげんてき	d͡ʑ i ɡ ẽ̞ n t e̞ kʲ i
じごく	d͡ʑ i ɡ o̞ k ɯ̟ᵝ
じし	d͡ʑ i ɕ i
じしゅう	d͡ʑ i ɕ ɨᵝː
じしょけい	d͡ʑ i ɕ o̞ k e̞ː
じしん	d͡ʑ i ɕ ĩ ɴ
じしんがく	d͡ʑ i ɕ ĩ ŋ ɡ a̠ k ɯ̟ᵝ
じしんがくしゃ	d͡ʑ i ɕ ĩ ɴ ŋ a̠ k ɯ̥ᵝ ɕʲ a̠
じじつ	d͡ʑ i ʑ i t͡s ɨᵝ
じじゅ	d͡ʑ i ʑ ɨᵝ
じすべり	d͡ʑ i s ɨᵝ b e̞ ɾʲ i
じせいしん	d͡ʑ i s e̞ː ɕ ĩ ɴ
じそんしん	d͡ʑ i s õ̞ ɰ̃ ɕ ĩ ɴ
じだ	d͡ʑ i d a̠
じだんだ	d͡ʑ i d ã̠ n d a̠
じっけん	d͡ʑ i k̚ k ẽ̞ ɴ
じっそく	d͡ʑ i sː o̞ k ɯ̟ᵝ
じったい	d͡ʑ i t̚ t a̠ i
じったいか	d͡ʑ i t̚ t a̠ i k a̠
じったいろん	d͡ʑ i t̚ t a̠ i ɾ õ̞ ɴ
じっち	d͡ʑ i t̚ t͡ɕ i
じっちゅうはっく	d͡ʑ i t̚ t͡ɕ ɨᵝː h a̠ k̚ k ɯ̟ᵝ
じっと	d͡ʑ i t̚ t o̞
じつろく	d͡ʑ i t͡s ɨᵝ ɾ o̞ k ɯ̟ᵝ
じつわ	d͡ʑ i t͡s ɨᵝ ɰᵝ a̠
じてんしゃ	d͡ʑ i t ẽ̞ ɰ̃ ɕ a̠
じでん	d͡ʑ i d ẽ̞ ɴ
じどうぎゃくたい	d͡ʑ i d o̞ː ɡʲ a̠ k ɯ̟ᵝ t a̠ i
じはんき	d͡ʑ i h ã̠ ŋʲ kʲ i
じひぶかい	d͡ʑ i ç i b ɯ̟ᵝ k a̠ i
じぶん	d͡ʑ i b ɯ̟̃ᵝ ɴ
じまく	d͡ʑ i m a̠ k ɯ̟ᵝ
じまん	d͡ʑ i m ã̠ ɴ
じみんとう	d͡ʑ i mʲ ĩ n t o̞ː
じめいきん	d͡ʑ i m e̞ː kʲ ĩ ɴ
じゃあく	d͡ʑ a̠ a̠ k ɯ̟ᵝ
じゃくら	d͡ʑ a̠ k ɯ̟ᵝ ɾ a̠
じゃこう	d͡ʑ a̠ k o̞ː
じゃこうじか	d͡ʑ a̠ k o̞ː ʑ i k a̠
じゃこうじゅう	d͡ʑ a̠ k o̞ː ʑ ɨᵝː
じゃっきゅう	d͡ʑ a̠ k̚ʲ kʲ ɨᵝː
じゃび	d͡ʑ a̠ bʲ i
じゅういち	d͡ʑ ɨᵝː i t͡ɕ i
じゅうげきせん	d͡ʑ ɨᵝː ɡ e̞ kʲ i s ẽ̞ ɴ
じゅうこうぎょう	d͡ʑ ɨᵝː k o̞ː ɡʲ o̞ː
じゅうご	d͡ʑ ɨᵝː ɡ o̞
じゅうじせん	d͡ʑ ɨᵝː ʑ i s ẽ̞ ɴ
じゅうじゅう	d͡ʑ ɨᵝː ʑ ɨᵝː
じゅうぜん	d͡ʑ ɨᵝː z ẽ̞ ɴ
じゅうたく	d͡ʑ ɨᵝː t a̠ k ɯ̟ᵝ
じゅうだん	d͡ʑ ɨᵝː d ã̠ ɴ
じゅうてんてき	d͡ʑ ɨᵝː t ẽ̞ n t e̞ kʲ i
じゅうでん	d͡ʑ ɨᵝː d ẽ̞ ɴ
じゅうなんざい	d͡ʑ ɨᵝː n ã̠ n d͡z a̠ i
じゅうに	d͡ʑ ɨᵝː ɲ̟ i
じゅうばこよみ	d͡ʑ ɨᵝː b a̠ k o̞ j o̞ mʲ i
じゅうりょう	d͡ʑ ɨᵝː ɾʲ o̞ː
じゅうりょく	d͡ʑ ɨᵝː ɾʲ o̞ k ɯ̟ᵝ
じゅうりょくは	d͡ʑ ɨᵝː ɾʲ o̞ k ɯ̟ᵝ h a̠
じゅくみん	d͡ʑ ɨᵝ k ɯ̟ᵝ mʲ ĩ ɴ
じゅじょうとっき	d͡ʑ ɨᵝ ʑ o̞ː t o̞ k̚ʲ kʲ i
じゅせい	d͡ʑ ɨᵝ s e̞ː
じゅっかい	d͡ʑ ɯᵝ kː a̠ i
じゅなん	d͡ʑ ɨᵝ n ã̠ ɴ
じゅにゅう	d͡ʑ ɨᵝ ɲ̟ ɯ̟ᵝː
じゅふ	d͡ʑ ɨᵝ ɸ ɯ̟ᵝ
じゅもく	d͡ʑ ɨᵝ m o̞ k ɯ̟ᵝ
じゅりん	d͡ʑ ɨᵝ ɾʲ ĩ ɴ
じゅんかつざい	d͡ʑ ɨ̃ᵝ ŋ k a̠ t͡s ɨᵝ z a̠ i
じゅんかつゆ	d͡ʑ ɨ̃ᵝ ŋ k a̠ t͡s ɨᵝ j ɯ̟ᵝ
じゅんき	d͡ʑ ɨ̃ᵝ ŋʲ kʲ i
じゅんけつ	d͡ʑ ɨ̃ᵝ ŋ k e̞ t͡s ɨᵝ
じゅんしょう	d͡ʑ ɨ̃ᵝ ɰ̃ ɕ o̞ː
じゅんび	d͡ʑ ɨ̃ᵝ m bʲ i
じゆう	d͡ʑ i j ɯ̟ᵝː
じゆうか	d͡ʑ i j ɯ̟ᵝː k a̠
じゆうがた	d͡ʑ i j ɯ̟ᵝː ɡ a̠ t a̠
じゆうとう	d͡ʑ i j ɯ̟ᵝː t o̞ː
じょう	d͡ʑ o̞ː
じょうおう	d͡ʑ o̞ː o̞ː
じょうか	d͡ʑ o̞ː k a̠
じょうかん	d͡ʑ o̞ː k ã̠ ɴ
じょうきげん	d͡ʑ o̞ː kʲ i ɡ ẽ̞ ɴ
じょうく	d͡ʑ o̞ː k ɯ̟ᵝ
じょうげてん	d ʑ oː ɡ e t e ɴ
じょうしゃ	d͡ʑ o̞ː ɕ a̠
じょうしゃけん	d͡ʑ o̞ː ɕ a̠ k ẽ̞ ɴ
じょうしょ	d͡ʑ o̞ː ɕ o̞
じょうじょう	d͡ʑ o̞ː ʑ o̞ː
じょうすう	d͡ʑ o̞ː s ɨᵝː
じょうたい	d͡ʑ o̞ː t a̠ i
じょうちゅう	d͡ʑ o̞ː t͡ɕ ɨᵝː
じょうとう	d͡ʑ o̞ː t o̞ː
じょうねつ	d͡ʑ o̞ː n e̞ t͡s ɨᵝ
じょうねん	d͡ʑ o̞ː n ẽ̞ ɴ
じょうふ	d͡ʑ o̞ː ɸ ɯ̟ᵝ
じょうへき	d͡ʑ o̞ː h e̞ kʲ i
じょうまえや	d͡ʑ o̞ː m a̠ e̞ j a̠
じょうよく	d͡ʑ o̞ː j o̞ k ɯ̟ᵝ
じょがくせい	d͡ʑ o̞ ɡ a̠ k ɯ̟̊ᵝ s e̞ː
じょきょうじゅ	d͡ʑ o̞ kʲ o̞ː ʑ ɨᵝ
じょせい	d͡ʑ o̞ s e̞ː
じょそうざい	d͡ʑ o̞ s o̞ː z a̠ i
じょほう	d͡ʑ o̞ h o̞ː
じょろうぐも	d͡ʑ o̞ ɾ o̞ː ɡ ɯ̟ᵝ m o̞
じりん	d͡ʑ i ɾʲ ĩ ɴ
じんかく	d͡ʑ ĩ ŋ k a̠ k ɯ̟ᵝ
じんぎ	d͡ʑ ĩ ŋʲ ɡʲ i
じんせいかん	d͡ʑ ĩ ɰ̃ s e̞ː k ã̠ ɴ
じんそく	d͡ʑ ĩ ɰ̃ s o̞ k ɯ̟ᵝ
じんぞう	d͡ʑ ĩ n d͡z o̞ː
じんたい	d͡ʑ ĩ n t a̠ i
じんつう	d͡ʑ ĩ n t͡s ɨᵝː
じんぶつ	d͡ʑ ĩ m b ɯ̟ᵝ t͡s ɨᵝ
じんぶん	d͡ʑ ĩ m b ɯ̟̃ᵝ ɴ
じんぼう	d͡ʑ ĩ m b o̞ː
じんめい	d͡ʑ ĩ mː e̞ː
すあし	s ɨᵝ a̠ ɕ i
すいいき	s ɨᵝ i i kʲ i
すいえい	s ɨᵝ i e̞ː
すいおん	s ɨᵝ i õ̞ ɴ
すいか	s ɨᵝ i k a̠
すいかとう	s ɨᵝ i k a̠ t o̞ː
すいかわり	s ɨᵝ i k a̠ ɰᵝ a̠ ɾʲ i
すいがん	s ɨᵝ i ɡ ã̠ ɴ
すいげんち	s ɨᵝ i ɡ ẽ̞ ɲ̟ t͡ɕ i
すいしゅ	s ɨᵝ i ɕ ɨᵝ
すいせいがん	s ɨᵝ i s e̞ː ɡ ã̠ ɴ
すいそうがく	s ɨᵝ i s o̞ː ɡ a̠ k ɯ̟ᵝ
すいそか	s ɨᵝ i s o̞ k a̠
すいそく	s ɨᵝ i s o̞ k ɯ̟ᵝ
すいぞう	s ɨᵝ i z o̞ː
すいてき	s ɨᵝ i t e̞ kʲ i
すいとう	s ɨᵝ i t o̞ː
すいとうがかり	s ɨᵝ i t o̞ː ɡ a̠ k a̠ ɾʲ i
すいとる	s ɨᵝ i t o̞ ɾ ɯ̟ᵝ
すいどうきょう	s ɨᵝ i d o̞ː kʲ o̞ː
すいばく	s ɨᵝ i b a̠ k ɯ̟ᵝ
すいへいせん	s ɨᵝ i h e̞ː s ẽ̞ ɴ
すいみんぶそく	s ɨᵝ i mʲ ĩ m b ɯ̟ᵝ s o̞ k ɯ̟ᵝ
すいよう	s ɨᵝ i j o̞ː
すいらい	s ɨᵝ i ɾ a̠ i
すいりょう	s ɨᵝ i ɾʲ o̞ː
すいりょく	s ɨᵝ i ɾʲ o̞ k ɯ̟ᵝ
すいろ	s ɨᵝ i ɾ o̞
すいろく	s ɨᵝ i ɾ o̞ k ɯ̟ᵝ
すう	s ɨᵝ ɯ̟ᵝ
すうがく	s ɨᵝː ɡ a̠ k ɯ̟ᵝ
すうがくしゃ	s ɨᵝː ɡ a̠ k ɯ̟̊ᵝ ɕ a̠
すうけい	s ɨᵝː k e̞ː
すうこう	s ɨᵝː k o̞ː
すうじ	s ɨᵝː ʑ i
すうせい	s ɨᵝː s e̞ː
すうろん	s ɨᵝː ɾ õ̞ ɴ
すか	s ɨ̥ᵝ k a̠
すがすがしい	s ɨᵝ ɡ a̠ s ɨᵝ ɡ a̠ ɕ i i
すききらい	s ɨ̥ᵝ kʲ i kʲ i ɾ a̠ i
すきずき	s ɨ̥ᵝ kʲ i z ɨᵝ kʲ i
すくう	s ɨ̥ᵝ k ɯ̟ᵝː
すくむ	s ɨ̥ᵝ k ɯ̟ᵝ m ɯ̟ᵝ
すぐれる	s ɨᵝ ɡ ɯ̟ᵝ ɾ e̞ ɾ ɯ̟ᵝ
すこし	s ɨ̥ᵝ k o̞ ɕ i
すこやか	s ɨ̥ᵝ k o̞ j a̠ k a̠
すごい	s ɨᵝ ɡ o̞ i
すごく	s ɨᵝ ɡ o̞ k ɯ̟ᵝ
すさまじい	s ɨᵝ s a̠ m a̠ ʑ iː
すし	s ɨᵝ ɕ i
すじ	s ɨᵝ ʑ i
すす	s ɨᵝ s ɨᵝ
すすめる	s ɨᵝ s ɨᵝ m e̞ ɾ ɯ̟ᵝ
すずなり	s ɨᵝ z ɨᵝ n a̠ ɾʲ i
すっきり	s ɨ̥ᵝ k̚ʲ kʲ i ɾʲ i
すっぽん	s ɨ̥ᵝ p̚ p õ̞ ɴ
すてき	s ɨ̥ᵝ t e̞ kʲ i
すてる	s ɨᵝ t e̞ ɾ ɯ̟ᵝ
すな	s ɨᵝ n a̠
すなわち	s ɨᵝ n a̠ ɰᵝ a̠ t͡ɕ i
すねる	s ɨᵝ n e̞ ɾ ɯ̟ᵝ
すばやい	s ɨᵝ b a̠ j a̠ i
すばる	s ɨᵝ b a̠ ɾ ɯ̟ᵝ
すべて	s ɨᵝ b e̞ t e̞
すまた	s ɨᵝ m a̠ t a̠
すみきる	s ɨᵝ mʲ i kʲ i ɾ ɯ̟ᵝ
すむ	s ɨᵝ m ɯ̟ᵝ
すりこむ	s ɨᵝ ɾʲ i k o̞ m ɯ̟ᵝ
する	s ɨᵝ ɾ ɯ̟ᵝ
ずいこう	d͡z ɨᵝ i k o̞ː
ずいこういん	d͡z ɨᵝ i k o̞ː ĩ ɴ
ずうずうしい	d͡z ɨᵝː z ɨᵝː ɕ i i
ずがい	d͡z ɨᵝ ɡ a̠ i
ずきん	d͡z ɨᵝ kʲ ĩ ɴ
ずぞうがく	d͡z ɨᵝ z o̞ː ɡ a̠ k ɯ̟ᵝ
ずたずた	d͡z ɨᵝ t a̠ z ɨᵝ t a̠
ずばずば	d͡z ɨᵝ b a̠ z ɨᵝ b a̠
ずばり	d͡z ɨᵝ b a̠ ɾʲ i
ずぶぬれ	d͡z ɨᵝ b ɯ̟ᵝ n ɯ̟ᵝ ɾ e̞
ずぼし	d͡z ɨᵝ b o̞ ɕ i
ずる	d͡z ɨᵝ ɾ ɯ̟ᵝ
ずるがしこい	d͡z ɨᵝ ɾ ɯ̟ᵝ ɡ a̠ ɕ i k o̞ i
ずろく	d͡z ɨᵝ ɾ o̞ k ɯ̟ᵝ
せいいき	s e̞ː i kʲ i
せいうん	s e̞ː ɯ̟̃ᵝ ɴ
せいえき	s e̞ː e̞ kʲ i
せいえん	s e̞ː ẽ̞ ɴ
せいかい	s e̞ː k a̠ i
せいかがく	s e̞ː k a̠ ɡ a̠ k ɯ̟ᵝ
せいがいふ	s e̞ː ɡ a̠ i ɸ ɯ̟ᵝ
せいきょういく	s e̞ː kʲ o̞ː i k ɯ̟ᵝ
せいけつ	s e̞ː k e̞ t͡s ɨᵝ
せいけん	s e̞ː k ẽ̞ ɴ
せいげん	s e̞ː ɡ ẽ̞ ɴ
せいこうしょう	s e̞ː k o̞ː ɕ o̞ː
せいご	s e̞ː ɡ o̞
せいさん	s e̞ː s ã̠ ɴ
せいしき	s e̞ː ɕ i kʲ i
せいしゅう	s e̞ː ɕ ɨᵝː
せいしょう	s e̞ː ɕ o̞ː
せいしょほう	s e̞ː ɕ o̞ h o̞ː
せいじがく	s e̞ː ʑ i ɡ a̠ k ɯ̟ᵝ
せいじょう	s e̞ː ʑ o̞ː
せいすい	s e̞ː s ɨᵝ i
せいせき	s e̞ː s e̞ kʲ i
せいせん	s e̞ː s ẽ̞ ɴ
せいぞん	s e̞ː z õ̞ ɴ
せいたいじ	s e̞ː t a̠ i ʑ i
せいち	s e̞ː t͡ɕ i
せいちょう	s e̞ː t͡ɕ o̞ː
せいてんかん	s e̞ː t ẽ̞ ŋ k ã̠ ɴ
せいばい	s e̞ː b a̠ i
せいひつ	s e̞ː ç i t͡s ɨᵝ
せいぶ	s e̞ː b ɯ̟ᵝ
せいぶつ	s e̞ː b ɯ̟ᵝ t͡s ɨᵝ
せいほう	s e̞ː h o̞ː
せいよう	s e̞ː j o̞ː
せいようふう	s e̞ː j o̞ː ɸ ɯ̟ᵝː
せいようわさび	s e̞ː j o̞ː ɰᵝ a̠ s a̠ bʲ i
せいりゅう	s e̞ː ɾʲ o̞ː
せえの	s e̞ː n o̞
せかす	s e̞ k a̠ s ɨᵝ
せき	s e̞ kʲ i
せきとめる	s e̞ kʲ i t o̞ m e̞ ɾ ɯ̟ᵝ
せじ	s e̞ ʑ i
せぞく	s e̞ z o̞ k ɯ̟ᵝ
せたけ	s e̞ t a̠ k e̞
せっかい	s e̞ k̚ k a̠ i
せっきょうしゃ	s e̞ k̚ʲ kʲ o̞ː ɕ a̠
せっきん	s e̞ k̚ʲ kʲ ĩ ɴ
せっこう	s e̞ k̚ k o̞ː
せっこつ	s e̞ k̚ k o̞ t͡s ɨᵝ
せっさく	s e̞ sː a̠ k ɯ̟ᵝ
せっしょうせき	s e̞ ɕː o̞ː s e̞ kʲ i
せっちゅうじ	s e̞ t̚ t͡ɕ ɨᵝː ʑ i
せってん	s e̞ t̚ t ẽ̞ ɴ
せっとうじ	s e̞ t̚ t o̞ː ʑ i
せっぱく	s e̞ p̚ p a̠ k ɯ̟̊ᵝ
せっぱん	s e̞ p̚ p ã̠ ɴ
せっぷく	s e̞ p̚ p ɯ̟̊ᵝ k ɯ̟ᵝ
せっぺん	s e̞ p̚ p ẽ̞ ɴ
せつだん	s e̞ t͡s ɨᵝ d ã̠ ɴ
せめて	s e̞ m e̞ t e̞
せりあげる	s e̞ ɾʲ i a̠ ɡ e̞ ɾ ɯ̟ᵝ
せわしない	s e̞ ɰᵝ a̠ ɕ i n a̠ i
せんか	s ẽ̞ ŋ k a̠
せんきょう	s ẽ̞ ŋʲ kʲ o̞ː
せんくしゃ	s ẽ̞ ŋ k ɯ̟ᵝ ɕ a̠
せんげん	s ẽ̞ ŋ ɡ ẽ̞ ɴ
せんこう	s ẽ̞ ŋ k o̞ː
せんざいいちぐう	s ẽ̞ n d͡z a̠ i i t͡ɕ i ɡ ɯ̟ᵝː
せんし	s ẽ̞ ɰ̃ ɕ i
せんしゅうらく	s ẽ̞ ɰ̃ ɕ ɨᵝː ɾ a̠ k ɯ̟ᵝ
せんじ	s ẽ̞ ɲ̟ d͡ʑ i
せんたい	s ẽ̞ n t a̠ i
せんたくばさみ	s ẽ̞ n t a̠ k ɯ̟ᵝ b a̠ s a̠ mʲ i
せんだい	s ẽ̞ n d a̠ i
せんちょう	s ẽ̞ ɲ̟ t͡ɕ o̞ː
せんてん	s ẽ̞ n t ẽ̞ ɴ
せんとう	s ẽ̞ n t o̞ː
せんにゅう	s ẽ̞ ɲ̟ ɲ̟ ɯ̟ᵝː
せんにょ	s ẽ̞ ɲ̟ ɲ̟ o̞
せんばい	s ẽ̞ m b a̠ i
せんべい	s ẽ̞ m b e̞ː
せんぼうきょう	s ẽ̞ m b o̞ː kʲ o̞ː
せんぼん	s ẽ̞ ɴ b õ̞ ɴ
せんめい	s ẽ̞ mː e̞ː
せんらん	s ẽ̞ n ɾ ã̠ ɴ
せんりゃく	s ẽ̞ n ɾʲ a̠ k ɯ̟ᵝ
せんりゅう	s ẽ̞ n ɾʲ ɨᵝː
ぜったいち	d͡z e̞ t̚ t a̠ i t͡ɕ i
ぜったいてき	d͡z e̞ t̚ t a̠ i t e̞ kʲ i
ぜつえん	d͡z e̞ t͡s ɨᵝ ẽ̞ ɴ
ぜつない	z e t s u n a i
ぜつふちょう	d͡z e̞ t͡s ɨᵝ ɸ ɯ̟ᵝ t͡ɕ o̞ː
ぜんえいてき	d͡z ẽ̞ ɰ̃ e̞ː t e̞ kʲ i
ぜんかい	d͡z ẽ̞ ŋ k a̠ i
ぜんき	d͡z ẽ̞ ŋʲ kʲ i
ぜんげん	d͡z ẽ̞ ŋ ɡ ẽ̞ ɴ
ぜんたいしゅぎ	d͡z ẽ̞ n t a̠ i ɕ ɨᵝ ɡʲ i
ぜんたん	d͡z ẽ̞ n t ã̠ ɴ
ぜんちょう	d͡z ẽ̞ ɲ̟ t͡ɕ o̞ː
ぜんてい	d͡z ẽ̞ n t e̞ː
ぜんとう	d͡z ẽ̞ n t o̞ː
ぜんとようよう	d͡z ẽ̞ n t o̞ j o̞ː j o̞ː
ぜんぼう	d͡z ẽ̞ m b o̞ː
ぜんやさい	d͡z ẽ̞ ɰ̃ j a̠ s a̠ i
そい	s o j
そういくふう	s o̞ː i k ɯ̟ᵝ ɸ ɯ̟ᵝː
そううけ	s o̞ː ɯ̟ᵝ k e̞
そうがく	s o̞ː ɡ a̠ k ɯ̟ᵝ
そうけい	s o̞ː k e̞ː
そうこばん	s o̞ː k o̞ b ã̠ ɴ
そうさせい	s o̞ː s a̠ s e̞ː
そうじふ	s o̞ː ʑ i ɸ ɯ̟ᵝ
そうじゅうかん	s o̞ː ʑ ɨᵝː k ã̠ ɴ
そうじゅうし	s o̞ː ʑ ɨᵝː ɕ i
そうず	s o̞ː z ɨᵝ
そうぞうしゅ	s o̞ː z o̞ː ɕ ɨᵝ
そうたいてき	s o̞ː t a̠ i t e̞ kʲ i
そうだん	s o̞ː d ã̠ ɴ
そうにょう	s o̞ː ɲ̟ o̞ː
そうびょう	s o̞ː bʲ o̞ː
そうめいきょく	s o̞ː m e̞ː kʲ o̞ k ɯ̟ᵝ
そうらい	s o̞ː ɾ a̠ i
そく	s o̞ k ɯ̟ᵝ
そくい	s o̞ k ɯ̟ᵝ i
そくず	s o̞ k ɯ̟ᵝ z ɨᵝ
そくせんりょく	s o̞ k ɯ̟ᵝ s ẽ̞ n ɾʲ o̞ k ɯ̟ᵝ
そくど	s o̞ k ɯ̟ᵝ d o̞
そくばいかい	s o̞ k ɯ̟ᵝ b a̠ i k a̠ i
そこぢから	s o̞ k o̞ ʑ i k a̠ ɾ a̠
そすう	s o̞ s ɨᵝː
そせい	s o̞ s e̞ː
そぜい	s o̞ z e̞ː
そそ	s o̞ s o̞
そだち	s o̞ d a̠ t͡ɕ i
そっきょう	s o̞ k̚ʲ kʲ o̞ː
そつぎょうせい	s o̞ t͡s ɨᵝ ɡʲ o̞ː s e̞ː
そつにゅう	s o̞ t͡s ɨᵝ ɲ̟ ɯ̟ᵝː
そでぐち	s o̞ d e̞ ɡ ɯ̟ᵝ t͡ɕ i
そと	s o̞ t o̞
そとうば	s o̞ t o̞ː b a̠
そとぜい	s o̞ t o̞ z e̞ː
そなえ	s o̞ n a̠ e̞
そなえつける	s o̞ n a̠ e̞ t͡s ɨᵝ k e̞ ɾ ɯ̟ᵝ
そば	s o̞ b a̠
そふ	s o̞ ɸ ɯ̟ᵝ
そほうか	s o̞ h o̞ː k a̠
そむける	s o̞ m ɯ̟ᵝ k e̞ ɾ ɯ̟ᵝ
そもじ	s o̞ m o̞ ʑ i
そや	s o̞ j a̠
そら	s o̞ ɾ a̠
そらいびき	s o̞ ɾ a̠ i bʲ i kʲ i
そろばんだかい	s o̞ ɾ o̞ b ã̠ n d a̠ k a̠ i
そんする	s õ̞ ɰ̃ s ɨᵝ ɾ ɯ̟ᵝ
ぞう	d͡z o̞ː
ぞうけい	d͡z o̞ː k e̞ː
ぞうしょう	d͡z o̞ː ɕ o̞ː
ぞうふく	d͡z o̞ː ɸ ɯ̟̊ᵝ k ɯ̟ᵝ
ぞうりむし	d͡z o̞ː ɾʲ i m ɯ̟ᵝ ɕ i
ぞくしゅつ	d͡z o̞ k ɯ̟ᵝ ɕ ɨᵝ t͡s ɨᵝ
ぞくせ	d͡z o̞ k ɯ̟ᵝ s e̞
ぞろぞろ	d͡z o̞ ɾ o̞ z o̞ ɾ o̞
ぞろめ	d͡z o̞ ɾ o̞ m e̞
たいいくかん	t a̠ i i k ɯ̟ᵝ k ã̠ ɴ
たいいくずわり	t a̠ i i k ɯ̟ᵝ z ɨᵝ ɰᵝ a̠ ɾʲ i
たいいんれき	t a̠ i ĩ n ɾ e̞ kʲ i
たいえき	t a̠ i e̞ kʲ i
たいおん	t a̠ i õ̞ ɴ
たいぎゃく	t a̠ i ɡʲ a̠ k ɯ̟ᵝ
たいぐう	t a̠ i ɡ ɯ̟ᵝː
たいしつ	t a̠ i ɕ i t͡s ɨᵝ
たいしゃ	t a̠ i ɕ a̠
たいしゅう	t a̠ i ɕ ɨᵝː
たいしゅうぶんか	t a̠ i ɕ ɨᵝː b ɯ̟̃ᵝ ŋ k a̠
たいじや	t a̠ i ʑ i j a̠
たいすう	t a̠ i s ɨᵝː
たいせい	t a̠ i s e̞ː
たいせん	t a̠ i s ẽ̞ ɴ
たいだん	t a̠ i d ã̠ ɴ
たいちょう	t a̠ i t͡ɕ o̞ː
たいとう	t a̠ i t o̞ː
たいない	t a̠ i n a̠ i
たいないどけい	t a̠ i n a̠ i d o̞ k e̞ː
たいぺい	t a̠ i p e̞ː
たいほう	t a̠ i h o̞ː
たいまい	t a̠ i m a̠ i
たいめん	t a̠ i m ẽ̞ ɴ
たいりゅう	t a̠ i ɾʲ ɨᵝː
たいわんじん	t a̠ i ɰᵝ ã̠ ɲ̟ d͡ʑ ĩ ɴ
たいわんとら	t a̠ i ɰᵝ ã̠ n t o̞ ɾ a̠
たえる	t a̠ e̞ ɾ ɯ̟ᵝ
たおやか	t a̠ o̞ j a̠ k a̠
たかなる	t a̠ k a̠ n a̠ ɾ ɯ̟ᵝ
たかね	t a̠ k a̠ n e̞
たかのり	t a̠ k a̠ n o̞ ɾʲ i
たかよし	t a̠ k a̠ j o̞ ɕ i
たからか	t a̠ k a̠ ɾ a̠ k a̠
たがる	t a̠ ɡ a̠ ɾ ɯ̟ᵝ
たき	t a̠ kʲ i
たくす	t a̠ k ɯ̟ᵝ s ɨᵝ
たくぜつ	t a̠ k ɯ̟ᵝ z e̞ t͡s ɨᵝ
たくみ	t a̠ k ɯ̟ᵝ mʲ i
たくや	t a̠ k ɯ̟ᵝ j a̠
たけひこ	t a̠ k e̞ ç i k o̞
たざわ	t a̠ z a̠ ɰᵝ a̠
たしなみ	t a̠ ɕ i n a̠ mʲ i
たしょ	t a̠ ɕ o̞
たそくるい	t a̠ s o̞ k ɯ̟ᵝ ɾ ɯ̟ᵝ i
たたきおこす	t a̠ t a̠ kʲ i o̞ k o̞ s ɨᵝ
たたく	t a̠ t a̠ k ɯ̟ᵝ
ただいま	t a̠ d a̠ i m a̠
ただよう	t a̠ d a̠ j o̞ ɯ̟ᵝ
たち	t a̠ t͡ɕ i
たちあがる	t a̠ t͡ɕ i a̠ ɡ a̠ ɾ ɯ̟ᵝ
たちぐい	t a̠ t͡ɕ i ɡ ɯ̟ᵝ i
たちさる	t a̠ t͡ɕ i s a̠ ɾ ɯ̟ᵝ
たちどまる	t a̠ t͡ɕ i d o̞ m a̠ ɾ ɯ̟ᵝ
たちのく	t a̠ t͡ɕ i n o̞ k ɯ̟ᵝ
たっけい	t a̠ k̚ k e̞ː
たって	t a̠ t̚ t e̞
たつたあげ	t a̠ t͡s ɨᵝ t a̠ a̠ ɡ e̞
たつまき	t a̠ t͡s ɨᵝ m a̠ kʲ i
たつみ	t a̠ t͡s ɨᵝ mʲ i
たつや	t a̠ t͡s ɨᵝ j a̠
たつやま	t a̠ t͡s ɨᵝ j a̠ m a̠
たてあみ	t a̠ t e̞ a̠ mʲ i
たてざ	t a̠ t e̞ z a̠
たてぶえ	t a̠ t e̞ b ɯ̟ᵝ e̞
たどりつく	t a̠ d o̞ ɾʲ i t͡s ɨᵝ k ɯ̟ᵝ
たどる	t a̠ d o̞ ɾ ɯ̟ᵝ
たぬきねいり	t a̠ n ɯ̟ᵝ kʲ i n e̞ i ɾʲ i
たねだ	t a̠ n e̞ d a̠
たのしむ	t a̠ n o̞ ɕ i m ɯ̟ᵝ
たば	t a̠ b a̠
たび	t a̠ bʲ i
たびだつ	t a̠ bʲ i d a̠ t͡s ɨᵝ
たべもの	t a̠ b e̞ m o̞ n o̞
たべる	t a̠ b e̞ ɾ ɯ̟ᵝ
たまご	t a̠ m a̠ ɡ o̞
たまつき	t a̠ m a̠ t͡s ɨ̥ᵝ kʲ i
たまる	t a̠ m a̠ ɾ ɯ̟ᵝ
たまわる	t a̠ m a̠ ɰᵝ a̠ ɾ ɯ̟ᵝ
たみ	t a̠ mʲ i
ためかげ	t a̠ m e̞ k a̠ ɡ e̞
ためん	t a̠ m ẽ̞ ɴ
ためんかく	t a̠ m ẽ̞ ŋ k a̠ k ɯ̟ᵝ
たもつ	t a̠ m o̞ t͡s ɨᵝ
たより	t a̠ j o̞ ɾʲ i
たら	t a̠ ɾ a̠
たりつ	t a̠ ɾʲ i t͡s ɨᵝ
たる	t a̠ ɾ ɯ̟ᵝ
たれめ	t a̠ ɾ e̞ m e̞
たれる	t a̠ ɾ e̞ ɾ ɯ̟ᵝ
たん	t ã̠ ɴ
たんいけい	t ã̠ ɰ̃ i k e̞ː
たんけんか	t ã̠ ŋ k ẽ̞ ŋ k a̠
たんご	t ã̠ ŋ ɡ o̞
たんさんすい	t ã̠ ɰ̃ s ã̠ ɰ̃ s ɨᵝ i
たんし	t ã̠ ɰ̃ ɕ i
たんしゃ	t ã̠ ɰ̃ ɕ a̠
たんしょ	t ã̠ ɰ̃ ɕ o̞
たんじゅうさん	t ã̠ ɲ̟ d͡ʑ ɨᵝː s ã̠ ɴ
たんじゅん	t ã̠ ɲ̟ d͡ʑ ɨ̃ᵝ ɴ
たんじゅんりん	t ã̠ ɲ̟ d͡ʑ ɨ̃ᵝ n ɾʲ ĩ ɴ
たんじょうせき	t ã̠ ɲ̟ d͡ʑ o̞ː s e̞ kʲ i
たんち	t ã̠ ɲ̟ t͡ɕ i
たんてい	t ã̠ n t e̞ː
たんとう	t ã̠ n t o̞ː
たんぱく	t ã̠ m p a̠ k ɯ̟ᵝ
たんぱくしつ	t ã̠ m p a̠ k ɯ̟ᵝ ɕ i̥ t͡s ɨᵝ
たんぽぽ	t ã̠ m p o̞ p o̞
たんようき	t ã̠ ɰ̃ j o̞ː kʲ i
だい	d a̠ i
だいえつ	d a̠ i e̞ t͡s ɨᵝ
だいおう	d a̠ i o̞ː
だいがくいん	d a̠ i ɡ a̠ k ɯ̟ᵝ ĩ ɴ
だいけい	d a̠ i k e̞ː
だいじほう	d a̠ i ʑ i h o̞ː
だいじょうぶ	d a̠ i ʑ o̞ː b ɯ̟ᵝ
だいじょうぶっきょう	d a̠ i ʑ o̞ː b ɯ̟ᵝ k̚ʲ kʲ o̞ː
だいそう	d a̠ i s o̞ː
だいたんふてき	d a̠ i t ã̠ ɰ̃ ɸ ɯ̟ᵝ t e̞ kʲ i
だいち	d a̠ i t͡ɕ i
だいちろう	d a̠ i t͡ɕ i ɾ o̞ː
だいていたく	d a̠ i t e̞ː t a̠ k ɯ̟ᵝ
だいとうりょう	d a̠ i t o̞ː ɾʲ o̞ː
だいとうりょうれい	d a̠ i t o̞ː ɾʲ o̞ː ɾ e̞ː
だいにち	d a̠ i ɲ̟ i t͡ɕ i
だいぼ	d a̠ i b o̞
だいみょう	d a̠ i mʲ o̞ː
だいめいし	d a̠ i m e̞ː ɕ i
だいわ	d a̠ i ɰᵝ a̠
だが	d a̠ ɡ a̠
だきしめる	d a̠ kʲ i ɕ i m e̞ ɾ ɯ̟ᵝ
だきまくら	d a̠ kʲ i m a̠ k ɯ̟ᵝ ɾ a̠
だくてん	d a̠ k ɯ̟̊ᵝ t ẽ̞ ɴ
だくひ	d a̠ k ɯ̟ᵝ ç i
だけん	d a̠ k ẽ̞ ɴ
だす	d a̠ s ɨᵝ
だつらく	d a̠ t͡s ɨᵝ ɾ a̠ k ɯ̟ᵝ
だまり	d ã̠ mː a̠ ɾʲ i
だらく	d a̠ ɾ a̠ k ɯ̟ᵝ
だらに	d a̠ ɾ a̠ ɲ̟ i
だんあつ	d ã̠ ɰ̃ a̠ t͡s ɨᵝ
だんかい	d ã̠ ŋ k a̠ i
だんくん	d ã̠ ŋ k ɯ̟̃ᵝ ɴ
だんご	d ã̠ ŋ ɡ o̞
だんしゃく	d ã̠ ɰ̃ ɕ a̠ k ɯ̟ᵝ
だんそう	d ã̠ ɰ̃ s o̞ː
だんちょう	d ã̠ ɲ̟ t͡ɕ o̞ː
だんてい	d ã̠ n t e̞ː
だんとう	d ã̠ n t o̞ː
だんぼう	d ã̠ m b o̞ː
ちいるい	t͡ɕ i i ɾ ɯ̟ᵝ i
ちえぶくろ	t͡ɕ i e̞ b ɯ̟ᵝ k ɯ̟ᵝ ɾ o̞
ちかづける	t͡ɕ i k a̠ z ɨᵝ k e̞ ɾ ɯ̟ᵝ
ちかみち	t͡ɕ i k a̠ mʲ i t͡ɕ i
ちきゅうぎ	t͡ɕ i kʲ ɨᵝː ɡʲ i
ちぎれる	t͡ɕ i ɡʲ i ɾ e̞ ɾ ɯ̟ᵝ
ちく	t͡ɕ i k ɯ̟ᵝ
ちくかん	t͡ɕ i k ɯ̟ᵝ k ã̠ ɴ
ちくごやく	t͡ɕ i k ɯ̟ᵝ ɡ o̞ j a̠ k ɯ̟ᵝ
ちくさつば	t͡ɕ i k ɯ̟ᵝ s a̠ t͡s ɨᵝ b a̠
ちけいがく	t͡ɕ i̥ k e̞ː ɡ a̠ k ɯ̟ᵝ
ちしきじん	t͡ɕ i ɕ i̥ kʲ i ʑ ĩ ɴ
ちせい	t͡ɕ i̥ s e̞ː
ちたいくう	t͡ɕ i t a̠ i k ɯ̟ᵝː
ちちおさえ	t͡ɕ i̥ t͡ɕ i o̞ s a̠ e̞
ちぢまる	t͡ɕ i ʑ i m a̠ ɾ ɯ̟ᵝ
ちとせ	t͡ɕ i̥ t o̞ s e̞
ちどり	t͡ɕ i d o̞ ɾʲ i
ちはや	t͡ɕ i h a̠ j a̠
ちばしる	t͡ɕ i b a̠ ɕ i ɾ ɯ̟ᵝ
ちばなれ	t͡ɕ i b a̠ n a̠ ɾ e̞
ちびっこ	t͡ɕ i bʲ i k̚ k o̞
ちめいてき	t͡ɕ i m e̞ː t e̞ kʲ i
ちゃ	t͡ɕ a̠
ちゃえん	t͡ɕ a̠ ẽ̞ ɴ
ちゃら	t͡ɕ a̠ ɾ a̠
ちやほや	t͡ɕ i j a̠ h o̞ j a̠
ちゅうい	t͡ɕ ɨᵝː i
ちゅうがく	t͡ɕ ɨᵝː ɡ a̠ k ɯ̟ᵝ
ちゅうがっこう	t͡ɕ ɨᵝː ɡ a̠ k̚ k o̞ː
ちゅうごくご	t͡ɕ ɨᵝː ɡ o̞ k ɯ̟ᵝ ɡ o̞
ちゅうさ	t͡ɕ ɨᵝː s a̠
ちゅうさいにん	t͡ɕ ɨᵝː s a̠ i ɲ̟ ĩ ɴ
ちゅうしゃくしぎ	t͡ɕ ɨᵝː ɕ a̠ k ɯ̟̊ᵝ ɕ i ɡʲ i
ちゅうすいえん	t͡ɕ ɨᵝː s ɨᵝ i ẽ̞ ɴ
ちゅうだん	t͡ɕʲ u͍ː d a̠ ɴ
ちゅうひ	t͡ɕ ɨᵝː ç i
ちゅうぼう	t͡ɕ ɨᵝː b o̞ː
ちゅうる	t͡ɕ ɨᵝː ɾ ɯ̟ᵝ
ちょ	t͡ɕ o̞
ちょうおんぷ	t͡ɕ o̞ː õ̞ m p ɯ̟ᵝ
ちょうきょり	t͡ɕ o̞ː kʲ o̞ ɾʲ i
ちょうこくぐざ	t͡ɕ o̞ː k o̞ k ɯ̟ᵝ ɡ ɯ̟ᵝ z a̠
ちょうしつ	t͡ɕ o̞ː ɕ i t͡s ɨᵝ
ちょうじ	t͡ɕ o̞ː ʑ i
ちょうじかん	t͡ɕ o̞ː ʑ i k ã̠ ɴ
ちょうじゅう	t͡ɕ o̞ː ʑ ɨᵝː
ちょうせんじん	t͡ɕ o̞ː s ẽ̞ ɲ̟ d͡ʑ ĩ ɴ
ちょうせんはんとう	t͡ɕ o̞ː s ẽ̞ ɰ̃ h ã̠ n t o̞ː
ちょうなん	t͡ɕ o̞ː n ã̠ ɴ
ちょうへん	t͡ɕ o̞ː h ẽ̞ ɴ
ちょうめい	t͡ɕ o̞ː m e̞ː
ちょうよう	t͡ɕ o̞ː j o̞ː
ちょくご	t͡ɕ o̞ k ɯ̟ᵝ ɡ o̞
ちょくせつ	t͡ɕ o̞ k ɯ̟ᵝ s e̞ t͡s ɨᵝ
ちょくぜん	t͡ɕ o̞ k ɯ̟ᵝ z ẽ̞ ɴ
ちょさくけんしんがい	t͡ɕ o̞ s a̠ k ɯ̟ᵝ k ẽ̞ ɰ̃ ɕ ĩ ŋ ɡ a̠ i
ちょっかん	t͡ɕ o̞ k̚ k ã̠ ɴ
ちょっと	t͡ɕ o̞ t̚ t o̞
ちらす	t͡ɕ i ɾ a̠ s ɨᵝ
ちらっと	t͡ɕ i ɾ a̠ t̚ t o̞
ちりれんげ	t͡ɕ i ɾʲ i ɾ ẽ̞ ŋ ɡ e̞
ちんか	t͡ɕ ĩ ŋ k a̠
ちんぎん	t͡ɕ ĩ ŋʲ ɡʲ ĩ ɴ
ちんこ	t͡ɕ ĩ ŋ k o̞
ちんこう	t͡ɕ ĩ ŋ k o̞ː
ちんこんか	t͡ɕ ĩ ŋ k õ̞ ŋ k a̠
ちんじゅ	t͡ɕ ĩ ɲ̟ d͡ʑ ɨᵝ
ちんじゅつ	t͡ɕ ĩ ɲ̟ d͡ʑ ɨᵝ t͡s ɨᵝ
ちんせいか	t͡ɕ ĩ ɰ̃ s e̞ː k a̠
ちんちろりん	t͡ɕ ĩ ɲ̟ t͡ɕ i ɾ o̞ ɾʲ ĩ ɴ
ちんつうざい	t͡ɕ ĩ n t͡s ɨᵝː z a̠ i
ちんぷんかんぷん	t͡ɕ ĩ m p ɯ̟̃ᵝ ŋ k ã̠ m p ɯ̟̃ᵝ ɴ
ちんぽこ	t͡ɕ ĩ m p o̞ k o̞
ちんもく	t͡ɕ ĩ mː o̞ k ɯ̟ᵝ
ちんれつ	t͡ɕ ĩ n ɾ e̞ t͡s ɨᵝ
ついえる	t͡s ɨᵝ i e̞ ɾ ɯ̟ᵝ
ついか	t͡s ɨᵝ i k a̠
ついしけん	t͡s ɨᵝ i ɕ i k ẽ̞ ɴ
ついずい	t͡s ɨᵝ i z ɨᵝ i
ついたち	t͡s ɨᵝ i t a̠ t͡ɕ i
ついばむ	t͡s ɨᵝ i b a̠ m ɯ̟ᵝ
つうかい	t͡s ɨᵝː k a̠ i
つうきん	t͡s ɨᵝː kʲ ĩ ɴ
つうこく	t͡s ɨᵝː k o̞ k ɯ̟ᵝ
つうさん	t͡s ɨᵝː s ã̠ ɴ
つうしん	t͡s ɨᵝː ɕ ĩ ɴ
つうせつ	t͡s ɨᵝː s e̞ t͡s ɨᵝ
つうやくしゃ	t͡s ɯᵝː j a̠ k ɯᵝ ɕʲ a̠
つうよう	t͡s ɨᵝː j o̞ː
つか	t͡s ɨ̥ᵝ k a̠
つかいふるし	t͡s ɨᵝ k a̠ i ɸ ɯ̟ᵝ ɾ ɯ̟ᵝ ɕ i
つかいわける	t͡s ɨᵝ k a̠ i ɰᵝ a̠ k e̞ ɾ ɯ̟ᵝ
つかう	t͡s ɨ̥ᵝ k a̠ ɯ̟ᵝ
つかる	t͡s ɨᵝ k a̠ ɾ ɯ̟ᵝ
つがざくら	t͡s ɨᵝ ɡ a̠ z a̠ k ɯ̟ᵝ ɾ a̠
つきまとう	t͡s ɨᵝ kʲ i m a̠ t o̞ ɯ̟ᵝ
つきよみ	t͡s ɨ̥ᵝ kʲ i j o̞ mʲ i
つぎめ	t͡s ɨᵝ ɡʲ i m e̞
つく	t͡s ɨᵝ k ɯ̟ᵝ
つくえ	t͡s ɨᵝ k ɯ̟ᵝ e̞
つくりじ	t͡s ɨᵝ k ɯ̟ᵝ ɾʲ i ʑ i
つくりわらい	t͡s ɨᵝ k ɯ̟ᵝ ɾʲ i ɰᵝ a̠ ɾ a̠ i
つくる	t͡s ɨᵝ k ɯ̟ᵝ ɾ ɯ̟ᵝ
つくろいもの	t͡s ɨᵝ k ɯ̟ᵝ ɾ o̞ i m o̞ n o̞
つくろう	t͡s ɨᵝ k ɯ̟ᵝ ɾ o̞ ɯ̟ᵝ
つぐみ	t͡s ɨᵝ ɡ ɯ̟ᵝ mʲ i
つけぶみ	t͡s ɨᵝ k e̞ b ɯ̟ᵝ mʲ i
つけもの	t͡s ɨ̥ᵝ k e̞ m o̞ n o̞
つげる	t͡s ɨᵝ ɡ e̞ ɾ ɯ̟ᵝ
つじうら	t͡s ɨᵝ ʑ i ɯ̟ᵝ ɾ a̠
つじつま	t͡s ɨᵝ ʑ i t͡s ɨᵝ m a̠
つたわる	t͡s ɨᵝ t a̠ ɰᵝ a̠ ɾ ɯ̟ᵝ
つだみ	t͡s ɨᵝ d a̠ mʲ i
つっこみ	t͡s ɨ̥ᵝ k̚ k o̞ mʲ i
つついづつ	t͡s ɨᵝ t͡s ɨᵝ i z ɨᵝ t͡s ɨᵝ
つつむ	t͡s ɨᵝ t͡s ɨᵝ m ɯ̟ᵝ
つづりじ	t͡s ɨᵝ z ɨᵝ ɾʲ i ʑ i
つとまる	t͡s ɨᵝ t o̞ m a̠ ɾ ɯ̟ᵝ
つとめる	t͡s ɨᵝ t o̞ m e̞ ɾ ɯ̟ᵝ
つなぐ	t͡s ɨᵝ n a̠ ɡ ɯ̟ᵝ
つなひき	t͡s ɨᵝ n a̠ ç i̥ kʲ i
つば	t͡s ɨᵝ b a̠
つばき	t͡s ɨᵝ b a̠ kʲ i
つぶす	t͡s ɨᵝ b ɯ̟ᵝ s ɨᵝ
つぶやく	t͡s ɨᵝ b ɯ̟ᵝ j a̠ k ɯ̟ᵝ
つまずく	t͡s ɨᵝ m a̠ z ɨᵝ k ɯ̟ᵝ
つみこむ	t͡s ɨᵝ mʲ i k o̞ m ɯ̟ᵝ
つめかんむり	t͡s ɨᵝ m e̞ k ã̠ mː ɯ̟ᵝ ɾʲ i
つらなる	t͡s ɨᵝ ɾ a̠ n a̠ ɾ ɯ̟ᵝ
つりざお	t͡s ɨᵝ ɾʲ i z a̠ o̞
つるかめざん	t͡s ɨᵝ ɾ ɯ̟ᵝ k a̠ m e̞ z ã̠ ɴ
つるれいし	t͡s ɨᵝ ɾ ɯ̟ᵝ ɾ e̞ː ɕ i
つれだす	t͡s ɨᵝ ɾ e̞ d a̠ s ɨᵝ
つわる	t͡s ɨᵝ ɰᵝ a̠ ɾ ɯ̟ᵝ
てあらい	t e̞ a̠ ɾ a̠ i
ていおん	t e̞ː õ̞ ɴ
ていきけん	t e̞ː kʲ i k ẽ̞ ɴ
ていけつ	t e̞ː k e̞ t͡s ɨᵝ
ていげん	t e̞ː ɡ ẽ̞ ɴ
ていこう	t e̞ː k o̞ː
ていし	t e̞ː ɕ i
ていしき	t e̞ː ɕ i kʲ i
ていしゅつ	t e̞ː ɕ ɨᵝ t͡s ɨᵝ
ていしょとくそう	t e̞ː ɕ o̞ t o̞ k ɯ̟ᵝ s o̞ː
ていじ	t e̞ː ʑ i
ていじゅう	t e̞ː ʑ ɨᵝː
ていせい	t e̞ː s e̞ː
ていそうたい	t e̞ː s o̞ː t a̠ i
ていちょう	t e̞ː t͡ɕ o̞ː
ていゆほう	t e̞ː j ɯ̟ᵝ h o̞ː
てかき	t e̞ k a̠ kʲ i
てがみ	t e̞ ɡ a̠ mʲ i
てきだんへい	t e̞ kʲ i d ã̠ ɰ̃ h e̞ː
てごめ	t e̞ ɡ o̞ m e̞
てせい	t e̞ s e̞ː
てっこうかぎ	t e̞ k̚ k o̞ː k a̠ ɡʲ i
てっこつ	t e̞ k̚ k o̞ t͡s ɨᵝ
てっさ	t e̞ sː a̠
てっせんじゅつ	t e̞ sː ẽ̞ ɲ̟ d͡ʑ ɨᵝ t͡s ɨᵝ
てっぱん	t e̞ p̚ p ã̠ ɴ
てつ	t e̞ t͡s ɨᵝ
てつくず	t e̞ t͡s ɨᵝ k ɯ̟ᵝ z ɨᵝ
てつづき	t e̞ t͡s ɨᵝ z ɨᵝ kʲ i
てどり	t e̞ d o̞ ɾʲ i
てぬかり	t e̞ n ɯ̟ᵝ k a̠ ɾʲ i
てのひら	t e̞ n o̞ ç i ɾ a̠
てふだ	t e̞ ɸ ɯ̟ᵝ d a̠
てりかえす	t e̞ ɾʲ i k a̠ e̞ s ɨᵝ
てんい	t ẽ̞ ɰ̃ i
てんけん	t ẽ̞ ŋ k ẽ̞ ɴ
てんこうせい	t ẽ̞ ŋ k o̞ː s e̞ː
てんざい	t ẽ̞ n d͡z a̠ i
てんじ	t ẽ̞ ɲ̟ d͡ʑ i
てんそ	t ẽ̞ ɰ̃ s o̞
てんてき	t ẽ̞ n t e̞ kʲ i
てんてつしゅ	t ẽ̞ n t e̞ t͡s ɨᵝ ɕ ɨᵝ
てんてん	t ẽ̞ n t ẽ̞ ɴ
てんとうむしだまし	t ẽ̞ n t o̞ː m ɯ̟ᵝ ɕ i d a̠ m a̠ ɕ i
てんねんしげん	t ẽ̞ nː ẽ̞ ɰ̃ ɕ i ɡ ẽ̞ ɴ
てんねんとう	t ẽ̞ nː ẽ̞ n t o̞ː
てんばい	t ẽ̞ m b a̠ i
てんもう	t ẽ̞ mː o̞ː
でかす	d e̞ k a̠ s ɨᵝ
できあい	d e̞ kʲ i a̠ i
できばえ	d e̞ kʲ i b a̠ e̞
でくわす	d e̞ k ɯ̟ᵝ ɰᵝ a̠ s ɨᵝ
でぶでぶ	d e̞ b ɯ̟ᵝ d e̞ b ɯ̟ᵝ
でまえ	d e̞ m a̠ e̞
でんしじゅう	d ẽ̞ ɰ̃ ɕ i ʑ ɨᵝː
でんせつ	d ẽ̞ ɰ̃ s e̞ t͡s ɨᵝ
でんとつ	d ẽ̞ n t o̞ t͡s ɨᵝ
でんどう	d ẽ̞ n d o̞ː
でんのう	d ẽ̞ nː o̞ː
でんりゅうけい	d ẽ̞ n ɾʲ ɨᵝː k e̞ː
でんりょくけい	d ẽ̞ n ɾʲ o̞ k ɯ̟̊ᵝ k e̞ː
でんれい	d ẽ̞ n ɾ e̞ː
とい	t o̞ i
といあわせ	t o̞ i a̠ ɰᵝ a̠ s e̞
といき	t o̞ i kʲ i
といし	t o̞ i ɕ i
とうかく	t o̞ː k a̠ k ɯ̟ᵝ
とうがし	t o̞ː ɡ a̠ ɕ i
とうがらし	t o̞ː ɡ a̠ ɾ a̠ ɕ i
とうきょう	t o̞ː kʲ o̞ː
とうきょうぶ	t o̞ː kʲ o̞ː b ɯ̟ᵝ
とうぎゅう	t o̞ː ɡʲ ɨᵝː
とうけい	t o̞ː k e̞ː
とうげい	t o̞ː ɡ e̞ː
とうげんきょう	t o̞ː ɡ ẽ̞ ŋʲ kʲ o̞ː
とうしき	t o̞ː ɕ i̥ kʲ i
とうしゅう	t o̞ː ɕ ɨᵝː
とうしょく	t o̞ː ɕ o̞ k ɯ̟ᵝ
とうじょう	t o̞ː ʑ o̞ː
とうせき	t o̞ː s e̞ kʲ i
とうち	t o̞ː t͡ɕ i
とうちゃく	t o̞ː t͡ɕ a̠ k ɯ̟ᵝ
とうちょうき	t o̞ː t͡ɕ o̞ː kʲ i
とうちょうよう	t o̞ː t͡ɕ o̞ː j o̞ː
とうてい	t o̞ː t e̞ː
とうとつ	t o̞ː t o̞ t͡s ɨᵝ
とうなん	t o̞ː n ã̠ ɴ
とうは	t o̞ː h a̠
とうばく	t o̞ː b a̠ k ɯ̟ᵝ
とうばん	t o̞ː b ã̠ ɴ
とうひ	t o̞ː ç i
とうびょう	t o̞ː bʲ o̞ː
とうほく	t o̞ː h o̞ k ɯ̟ᵝ
とうほくちほう	t o̞ː h o̞ k ɯ̟ᵝ t͡ɕ i h o̞ː
とうみつ	t o̞ː mʲ i t͡s ɨᵝ
とうみん	t o̞ː mʲ ĩ ɴ
とうよう	t o̞ː j o̞ː
とうろうながし	t o̞ː ɾ o̞ː n a̠ ɡ a̠ ɕ i
とうろく	t o̞ː ɾ o̞ k ɯ̟ᵝ
とおざかる	t o̞ː z a̠ k a̠ ɾ ɯ̟ᵝ
とおせんぼう	t o̞ː s ẽ̞ m b o̞ː
とかげ	t o̞ k a̠ ɡ e̞
とかげざ	t o̞ k a̠ ɡ e̞ z a̠
とき	t o̞ kʲ i
ときあかす	t o̞ kʲ i a̠ k a̠ s ɨᵝ
ときいろ	t o̞ kʲ iː ɾ o̞
ときおり	t o̞ kʲ i o̞ ɾʲ i
ときめく	t o̞ kʲ i m e̞ k ɯ̟ᵝ
ときわ	t o̞ kʲ i ɰᵝ a̠
とぎ	t o̞ ɡʲ i
とぎじる	t o̞ ɡʲ i ʑ i ɾ ɯ̟ᵝ
とくいさき	t o̞ k ɯ̟ᵝ i s a̠ kʲ i
とくさつ	t o̞ k ɯ̟̊ᵝ s a̠ t͡s ɨᵝ
とくしゅ	t o̞ k ɯ̟̊ᵝ ɕ ɨᵝ
とくてん	t o̞ k ɯ̟̊ᵝ t ẽ̞ ɴ
とくとうびょう	t o̞ k ɯ̟̊ᵝ t o̞ː bʲ o̞ː
とくばい	t o̞ k ɯ̟ᵝ b a̠ i
とくひつ	t o̞ k ɯ̟ᵝ ç i̥ t͡s ɨᵝ
とくべつく	t o̞ k ɯ̟ᵝ b e̞ t͡s ɨ̥ᵝ k ɯ̟ᵝ
とくほん	t o̞ k ɯ̟̊ᵝ h õ̞ ɴ
とくめい	t o̞ k ɯ̟ᵝ m e̞ː
とくよう	t o̞ k ɯ̟ᵝ j o̞ː
とくれい	t o̞ k ɯ̟ᵝ ɾ e̞ː
とぐろ	t o̞ ɡ ɯ̟ᵝ ɾ o̞
とけい	t o̞ k e̞ː
とけいざ	t o̞ k e̞ː z a̠
とける	t o̞ k e̞ ɾ ɯ̟ᵝ
とこ	t o̞ k o̞
とこじらみ	t o̞ k o̞ ʑ i ɾ a̠ mʲ i
とこむし	t o̞ k o̞ m ɯ̟ᵝ ɕ i
ところ	k o̞
ところてん	t o̞ k o̞ ɾ o̞ t ẽ̞ ɴ
とざす	t o̞ z a̠ s ɨᵝ
としか	t o̞ ɕ i̥ k a̠
としは	t o̞ ɕ i h a̠
としょ	t o̞ ɕ o̞
とじ	t o̞ ʑ i
とじょう	t o̞ ʑ o̞ː
とす	t o̞ s ɨᵝ
とぜん	t o̞ z ẽ̞ ɴ
とちぎけん	t o̞ t͡ɕ i ɡʲ i k ẽ̞ ɴ
とっか	t o̞ k̚ k a̠
とっき	t o̞ k̚ʲ kʲ i
とっきゅう	t o̞ k̚ʲ kʲ ɨᵝː
とっこ	t o̞ k̚ k o̞
とっさ	t o̞ sː a̠
とって	t o̞ t̚ t e̞
とどける	t o̞ d o̞ k e̞ ɾ ɯ̟ᵝ
となえる	t o̞ n a̠ e̞ ɾ ɯ̟ᵝ
とにち	t o̞ ɲ̟ i t͡ɕ i
とばく	t o̞ b a̠ k ɯ̟ᵝ
とび	t o̞ bʲ i
とびうお	t o̞ bʲ i ɯ̟ᵝ o̞
とびおりる	t o̞ bʲ i o̞ ɾʲ i ɾ ɯ̟ᵝ
とびだす	t o̞ bʲ i d a̠ s ɨᵝ
とまつ	t o̞ m a̠ t͡s ɨᵝ
とめ	t o̞ m e̞
とめがね	t o̞ m e̞ ɡ a̠ n e̞
とめる	t o̞ m e̞ ɾ ɯ̟ᵝ
ともえ	t o̞ m o̞ e̞
ともひろ	t o̞ m o̞ ç i ɾ o̞
ともや	t o̞ m o̞ j a̠
とら	t o̞ ɾ a̠
とらえる	t o̞ ɾ a̠ e̞ ɾ ɯ̟ᵝ
とりあつかう	t o̞ ɾʲ i a̠ t͡s ɨᵝ k a̠ ɯ̟ᵝ
とりかえし	t o̞ ɾʲ i k a̠ e̞ ɕ i
とりかこむ	t o̞ ɾʲ i k a̠ k o̞ m ɯ̟ᵝ
とりかご	t o̞ ɾʲ i k a̠ ɡ o̞
とりきめ	t o̞ ɾʲ i kʲ i m e̞
とりこむ	t o̞ ɾʲ i k o̞ m ɯ̟ᵝ
とりしまりやくかい	t o̞ ɾʲ i ɕ i m a̠ ɾʲ i j a̠ k ɯ̟̊ᵝ k a̠ i
とりしまる	t o̞ ɾʲ i ɕ i m a̠ ɾ ɯ̟ᵝ
とりとめる	t o̞ ɾʲ i t o̞ m e̞ ɾ ɯ̟ᵝ
とりひきさき	t o̞ ɾʲ i ç i̥ kʲ i s a̠ kʲ i
とりひきじょ	t o̞ ɾʲ i ç i̥ kʲ i ʑ o̞
とりもち	t o̞ ɾʲ i m o̞ t͡ɕ i
とりもどす	t o̞ ɾʲ i m o̞ d o̞ s ɨᵝ
とりょう	t o̞ ɾʲ o̞ː
とれる	t o̞ ɾ e̞ ɾ ɯ̟ᵝ
とんそく	t õ̞ ɰ̃ s o̞ k ɯ̟ᵝ
とんでもない	t õ̞ n d e̞ m o̞ n a̠ i
どういたい	d o̞ː i t a̠ i
どういん	d o̞ː ĩ ɴ
どうおんご	d o̞ː õ̞ ŋ ɡ o̞
どうかつ	d o̞ː k a̠ t͡s ɨᵝ
どうかん	d o̞ː k ã̠ ɴ
どうが	d o̞ː ɡ a̠
どうき	d o̞ː kʲ i
どうけ	d o̞ː k e̞
どうざん	d o̞ː z ã̠ ɴ
どうしゅつ	d o̞ː ɕ ɨᵝ t͡s ɨᵝ
どうじ	d o̞ː ʑ i
どうせ	d o̞ː s e̞
どうせいこん	d o̞ː s e̞ː k õ̞ ɴ
どうそうかい	d o̞ː s o̞ː k a̠ i
どうそじん	d o̞ː s o̞ ʑ ĩ ɴ
どうぞう	d o̞ː z o̞ː
どうたい	d o̞ː t a̠ i
どうてい	d o̞ː t e̞ː
どうてん	d o̞ː t ẽ̞ ɴ
どうない	d o̞ː n a̠ i
どうなん	d o̞ː n ã̠ ɴ
どうぶつえん	d o̞ː b ɯ̟ᵝ t͡s ɨᵝ ẽ̞ ɴ
どうぶつかい	d o̞ː b ɯ̟ᵝ t͡s ɨ̥ᵝ k a̠ i
どうほく	d o̞ː h o̞ k ɯ̟ᵝ
どうも	d o̞ː m o̞
どうもう	d o̞ː m o̞ː
どうらん	d o̞ː ɾ ã̠ ɴ
どうりきがく	d o̞ː ɾʲ i kʲ i ɡ a̠ k ɯ̟ᵝ
どうりょう	d o̞ː ɾʲ o̞ː
どうりょく	d o̞ː ɾʲ o̞ k ɯ̟ᵝ
どうろ	d o̞ː ɾ o̞
どうろふうさ	d o̞ː ɾ o̞ ɸ ɯ̟ᵝː s a̠
どく	d o̞ k ɯ̟ᵝ
どくさいしゃ	d o̞ k ɯ̟̊ᵝ s a̠ i ɕ a̠
どくしん	d o̞ k ɯ̟̊ᵝ ɕ ĩ ɴ
どくせい	d o̞ k ɯ̟̊ᵝ s e̞ː
どくせん	d o̞ k ɯ̟̊ᵝ s ẽ̞ ɴ
どくぜつ	d o̞ k ɯ̟ᵝ z e̞ t͡s ɨᵝ
どくだんじょう	d o̞ k ɯ̟ᵝ d ã̠ ɲ̟ d͡ʑ o̞ː
どくりつ	d o̞ k ɯ̟ᵝ ɾʲ i t͡s ɨᵝ
どしゃ	d o̞ ɕ a̠
どすこい	d o̞ s ɨᵝ k o̞ i
どちらさま	d o̞ t͡ɕ i ɾ a̠ s a̠ m a̠
どっきょ	d o̞ k̚ʲ kʲ o̞
どどいつ	d o̞ d o̞ i t͡s ɨᵝ
どぶねずみ	d o̞ b ɯ̟ᵝ n e̞ z ɨᵝ mʲ i
どべい	d o̞ b e̞ː
どもり	d o̞ m o̞ ɾʲ i
どよう	d o̞ j o̞ː
どようび	d o̞ j o̞ː bʲ i
どりょうこう	d o̞ ɾʲ o̞ː k o̞ː
どれどれ	d o̞ ɾ e̞ d o̞ ɾ e̞
どろじあい	d o̞ ɾ o̞ ʑ i a̠ i
どろどろ	d o̞ ɾ o̞ d o̞ ɾ o̞
どんこう	d õ̞ ŋ k o̞ː
どんつう	d õ̞ n t͡s ɨᵝː
どんぶらこ	d õ̞ m b ɯ̟ᵝ ɾ a̠ k o̞
ないがしろ	n a̠ i ɡ a̠ ɕ i ɾ o̞
ないげんご	n a̠ i ɡ ẽ̞ ŋ ɡ o̞
ないこっかく	n a̠ i k o̞ k̚ k a̠ k ɯ̟ᵝ
ないしゅっけつ	n a̠ i ɕ ɨᵝ k̚ k e̞ t͡s ɨᵝ
ないしんのう	n a̠ i ɕ ĩ nː o̞ː
ないせいかんしょう	n a̠ i s e̞ː k ã̠ ɰ̃ ɕ o̞ː
ないせん	n a̠ i s ẽ̞ ɴ
ないそう	n a̠ i s o̞ː
ないもうこ	n a̠ i m o̞ː k o̞
なおれ	n a̠ o̞ ɾ e̞
なかす	n a̠ k a̠ s ɨᵝ
なかだかがた	n a̠ k a̠ d a̠ k a̠ ɡ a̠ t a̠
なかま	n a̠ k a̠ m a̠
なかまはずれ	n a̠ k a̠ m a̠ h a̠ z ɨᵝ ɾ e̞
ながさいふ	n a̠ ɡ a̠ s a̠ i ɸ ɯ̟ᵝ
ながさき	n a̠ ɡ a̠ s a̠ kʲ i
ながす	n a̠ ɡ a̠ s ɨᵝ
ながでんわ	n a̠ ɡ a̠ d ẽ̞ ɰ̃ ɰᵝ a̠
ながめる	n a̠ ɡ a̠ m e̞ ɾ ɯ̟ᵝ
ながら	n a̠ ɡ a̠ ɾ a̠
ながれ	n a̠ ɡ a̠ ɾ e̞
ながれる	n a̠ ɡ a̠ ɾ e̞ ɾ ɯ̟ᵝ
なきすな	n a̠ kʲ i s ɨᵝ n a̠
なぎなた	n a̠ ɡʲ i n a̠ t a̠
なげく	n a̠ ɡ e̞ k ɯ̟ᵝ
なげだす	n a̠ ɡ e̞ d a̠ s ɨᵝ
なずな	n a̠ z ɨᵝ n a̠
なだめ	n a̠ d a̠ m e̞
なだめる	n a̠ d a̠ m e̞ ɾ ɯ̟ᵝ
なっとう	n a̠ t̚ t o̞ː
なつちゅう	n a̠ t͡s ɨᵝ t͡ɕ ɨᵝː
なつめやし	n a̠ t͡s ɨᵝ m e̞ j a̠ ɕ i
なにか	n a̠ ɲ̟ i k a̠
なにせ	n a̠ ɲ̟ i s e̞
なまけぐま	n a̠ m a̠ k e̞ ɡ ɯ̟ᵝ m a̠
なまず	n a̠ m a̠ z ɨᵝ
なまみず	n a̠ m a̠ mʲ i z ɨᵝ
なみ	n a̠ mʲ i
なみき	n a̠ mʲ i kʲ i
なみだめ	n a̠ mʲ i d a̠ m e̞
なみはずれる	n a̠ mʲ i h a̠ z ɨᵝ ɾ e̞ ɾ ɯ̟ᵝ
なめる	n a̠ m e̞ ɾ ɯ̟ᵝ
なら	n a̠ ɾ a̠
ならう	n a̠ ɾ a̠ ɯ̟ᵝ
ならく	n a̠ ɾ a̠ k ɯ̟ᵝ
ならぶ	n a̠ ɾ a̠ b ɯ̟ᵝ
なるとまき	n a̠ ɾ ɯ̟ᵝ t o̞ m a̠ kʲ i
なれあい	n a̠ ɾ e̞ a̠ i
なれっこ	n a̠ ɾ e̞ k̚ k o̞
なんいど	n ã̠ ɰ̃ i d o̞
なんえつ	n ã̠ ɰ̃ e̞ t͡s ɨᵝ
なんきょくかい	n ã̠ ŋʲ kʲ o̞ k ɯ̟ᵝ k a̠ i
なんごく	n ã̠ ŋ ɡ o̞ k ɯ̟ᵝ
なんすい	n ã̠ ɰ̃ s ɨᵝ i
なんたいもり	n ã̠ n t a̠ i m o̞ ɾʲ i
なんて	n ã̠ n t e̞
なんてこった	n ã̠ n t e̞ k o̞ t̚ t a̠
なんでも	n ã̠ n d e̞ m o̞
にいがた	ɲ̟ iː ɡ a̠ t a̠
にいがたけん	ɲ̟ iː ɡ a̠ t a̠ k ẽ̞ ɴ
にいんせい	ɲ̟ i ĩ ɰ̃ s e̞ː
にかよう	ɲ̟ i k a̠ j o̞ ɯ̟ᵝ
にがうり	ɲ̟ i ɡ a̠ ɯ̟ᵝ ɾʲ i
にきょくかん	ɲ̟ i kʲ o̞ k ɯ̟̊ᵝ k ã̠ ɴ
にくい	ɲ̟ i k ɯ̟ᵝ i
にくだんせん	ɲ̟ i k ɯ̟ᵝ d ã̠ ɰ̃ s ẽ̞ ɴ
にくまんじゅう	ɲ̟ i k ɯ̟ᵝ m ã̠ ɲ̟ d͡ʑ ɨᵝː
にくよく	ɲ̟ i k ɯ̟ᵝ j o̞ k ɯ̟ᵝ
にくるい	ɲ̟ i k ɯ̟ᵝ ɾ ɯ̟ᵝ i
にげこし	ɲ̟ i ɡ e̞ k o̞ ɕ i
にげる	ɲ̟ i ɡ e̞ ɾ ɯ̟ᵝ
にこく	ɲ̟ i k o̞ k ɯ̟ᵝ
にこげ	ɲ̟ i k o̞ ɡ e̞
にごろぶな	ɲ̟ i ɡ o̞ ɾ o̞ b ɯ̟ᵝ n a̠
にじむ	ɲ̟ i ʑ i m ɯ̟ᵝ
にじゅう	ɲ̟ i ʑ ɨᵝː
にじゅうご	ɲ̟ i ʑ ɨᵝː ɡ o̞
にじゅうし	ɲ̟ i ʑ ɨᵝː ɕ i
にじゅうに	ɲ̟ i ʑ ɨᵝː ɲ̟ i
にじゅうろく	ɲ̟ i ʑ ɨᵝː ɾ o̞ k ɯ̟ᵝ
にじょうき	ɲ̟ i ʑ o̞ː kʲ i
にちじ	ɲ̟ i t͡ɕ i ʑ i
にちよう	ɲ̟ i t͡ɕ i j o̞ː
にちようび	ɲ̟ i t͡ɕ i j o̞ː bʲ i
にとうきん	ɲ̟ i t o̞ː kʲ ĩ ɴ
にな	ɲ̟ i n a̠
にひゃくとおか	ɲ̟ i ç a̠ k ɯ̟ᵝ t o̞ː k a̠
にほん	ɲ̟ i h õ̞ ɴ
にほんかいりゅう	ɲ̟ i h õ̞ ŋ k a̠ i ɾʲ ɨᵝː
にほんざる	ɲ̟ i h õ̞ n d͡z a̠ ɾ ɯ̟ᵝ
にほんとう	ɲ̟ i h õ̞ n t o̞ː
にやす	ɲ̟ i j a̠ s ɨᵝ
にゅうか	ɲ̟ ɯ̟ᵝː k a̠
にゅうかい	ɲ̟ ɯ̟ᵝː k a̠ i
にゅうきょ	ɲ̟ ɯ̟ᵝː kʲ o̞
にゅうしゃ	ɲ̟ ɯ̟ᵝː ɕ a̠
にゅうしゃかく	ɲ̟ ɯ̟ᵝː ɕ a̠ k a̠ k ɯ̟ᵝ
にゅうしょく	ɲ̟ ɯ̟ᵝː ɕ o̞ k ɯ̟ᵝ
にゅうじ	ɲ̟ ɯ̟ᵝː ʑ i
にゅうじょうけん	ɲ̟ ɯ̟ᵝː ʑ o̞ː k ẽ̞ ɴ
にゅうせい	ɲ̟ ɯ̟ᵝː s e̞ː
にゅうせき	ɲ̟ ɯ̟ᵝː s e̞ kʲ i
にゅうとう	ɲ̟ ɯ̟ᵝː t o̞ː
にゅうどう	ɲ̟ ɯ̟ᵝː d o̞ː
にゅうぶ	ɲ̟ ɯ̟ᵝː b ɯ̟ᵝ
にゅうりょく	ɲ̟ ɯ̟ᵝː ɾʲ o̞ k ɯ̟ᵝ
にゅうわ	ɲ̟ ɯ̟ᵝː ɰᵝ a̠
にょう	ɲ̟ o̞ː
にょうどうきゅうせん	ɲ̟ o̞ː d o̞ː kʲ ɨᵝː s ẽ̞ ɴ
にりん	ɲ̟ i ɾʲ ĩ ɴ
にわか	ɡ a̠
にわとり	ɲ̟ i ɰᵝ a̠ t o̞ ɾʲ i
にんしき	ɲ̟ ĩ ɰ̃ ɕ i̥ kʲ i
にんじゃ	ɲ̟ ĩ ɲ̟ d͡ʑ a̠
にんにく	ɲ̟ ĩ ɲ̟ ɲ̟ i k ɯ̟ᵝ
にんむ	ɲ̟ ĩ mː ɯ̟ᵝ
にんめん	ɲ̟ ĩ mː ẽ̞ ɴ
ぬいめ	n ɯ̟ᵝ i m e̞
ぬかご	n ɯ̟ᵝ k a̠ ɡ o̞
ぬかばえ	n ɯ̟ᵝ k a̠ b a̠ e̞
ぬぐ	n ɯ̟ᵝ ɡ ɯ̟ᵝ
ぬけみち	n ɯ̟ᵝ k e̞ mʲ i t͡ɕ i
ぬすむ	n ɯ̟ᵝ s ɨᵝ m ɯ̟ᵝ
ぬらす	n ɯ̟ᵝ ɾ a̠ s ɨᵝ
ぬる	n ɯ̟ᵝ ɾ ɯ̟ᵝ
ぬるい	n ɯ̟ᵝ ɾ ɯ̟ᵝ i
ぬれそぼつ	n ɯ̟ᵝ ɾ e̞ s o̞ b o̞ t͡s ɨᵝ
ぬれる	n ɯ̟ᵝ ɾ e̞ ɾ ɯ̟ᵝ
ねいき	n e̞ i kʲ i
ねいろ	n e̞ i ɾ o̞
ねえ	n e̞ː
ねがい	n e̞ ɡ a̠ i
ねがえり	n e̞ ɡ a̠ e̞ ɾʲ i
ねくら	n e̞ k ɯ̟ᵝ ɾ a̠
ねぐら	n e̞ ɡ ɯ̟ᵝ ɾ a̠
ねこ	n e̞ k o̞
ねずみざめ	n e̞ z ɨᵝ mʲ i z a̠ m e̞
ねちがえる	n e̞ t͡ɕ i ɡ a̠ e̞ ɾ ɯ̟ᵝ
ねつ	n e̞ t͡s ɨᵝ
ねつい	n e̞ t͡s ɨᵝ i
ねつきうお	n e̞ t͡s ɨᵝ kʲ i ɯ̟ᵝ o̞
ねつききゅう	n e̞ t͡s ɨᵝ kʲ i̥ kʲ ɨᵝː
ねつく	n e̞ t͡s ɨᵝ k ɯ̟ᵝ
ねつど	n e̞ t͡s ɨᵝ d o̞
ねとる	n e̞ t o̞ ɾ ɯ̟ᵝ
ねばねば	n e̞ b a̠ n e̞ b a̠
ねぶる	n e̞ b ɯ̟ᵝ ɾ ɯ̟ᵝ
ねらう	n e̞ ɾ a̠ ɯ̟ᵝ
ねりなおす	n e̞ ɾʲ i n a̠ o̞ s ɨᵝ
ねる	n e̞ ɾ ɯ̟ᵝ
ねんかん	n ẽ̞ ŋ k ã̠ ɴ
ねんがじょう	n ẽ̞ ŋ ɡ a̠ ʑ o̞ː
ねんげん	n ẽ̞ ŋ ɡ ẽ̞ ɴ
ねんぶつ	n ẽ̞ m b ɯ̟ᵝ t͡s ɨᵝ
のうえん	n o̞ː ẽ̞ ɴ
のうきょう	n o̞ː kʲ o̞ː
のうさぎ	n o̞ ɯ̟ᵝ s a̠ ɡʲ i
のうし	n o̞ː ɕ i
のうしょう	n o̞ː ɕ o̞ː
のうじょう	n o̞ː ʑ o̞ː
のうすい	n o̞ː s ɨᵝ i
のうすいさん	n o̞ː s ɨᵝ i s ã̠ ɴ
のうひん	n o̞ː ç ĩ ɴ
のうみん	n o̞ː mʲ ĩ ɴ
のうむ	n o̞ː m ɯ̟ᵝ
のうりつ	n o̞ː ɾʲ i t͡s ɨᵝ
のうりょく	n o̞ː ɾʲ o̞ k ɯ̟ᵝ
のがれ	n o̞ ɡ a̠ ɾ e̞
のこり	n o̞ k o̞ ɾʲ i
のせる	n o̞ s e̞ ɾ ɯ̟ᵝ
のどちんこ	n o̞ d o̞ t͡ɕ ĩ ŋ k o̞
ののしる	n o̞ n o̞ ɕ i ɾ ɯ̟ᵝ
のびのび	n o̞ bʲ i n o̞ bʲ i
のみ	n o̞ mʲ i
のむ	n o̞ m ɯ̟ᵝ
のやま	n o̞ j a̠ m a̠
のらいぬ	n o̞ ɾ a̠ i n ɯ̟ᵝ
のりきる	n o̞ ɾʲ i kʲ i ɾ ɯ̟ᵝ
のりすごす	n o̞ ɾʲ i s ɨᵝ ɡ o̞ s ɨᵝ
のりまさ	n o̞ ɾʲ i m a̠ s a̠
のれん	n o̞ ɾ ẽ̞ ɴ
のろい	n o̞ ɾ o̞ i
はあく	h a̠ː k ɯ̟ᵝ
はいいろ	h a̠ iː ɾ o̞
はいいろぐま	h a̠ i i ɾ o̞ ɡ ɯ̟ᵝ m a̠
はいいん	h a̠ i ĩ ɴ
はいえい	h a̠ i e̞ː
はいがん	h a̠ i ɡ ã̠ ɴ
はいきもの	h a̠ i kʲ i m o̞ n o̞
はいきゅう	h a̠ i kʲ ɨᵝː
はいけい	h a̠ i k e̞ː
はいご	h a̠ i ɡ o̞
はいざら	h a̠ i z a̠ ɾ a̠
はいしゅつ	h a̠ i ɕ ɨᵝ t͡s ɨᵝ
はいせんしゃ	h a̠ i s ẽ̞ ɰ̃ ɕ a̠
はいたつ	h a̠ i t a̠ t͡s ɨᵝ
はいち	h a̠ i t͡ɕ i
はいとく	h a̠ i t o̞ k ɯ̟ᵝ
はいどう	h a̠ i d o̞ː
はう	h a̠ ɯ̟ᵝ
はえじごく	h a̠ e̞ ʑ i ɡ o̞ k ɯ̟ᵝ
はかいし	h a̠ k a̠ i ɕ i
はかいしゃ	h a̠ k a̠ i ɕ a̠
はかた	h a̠ k a̠ t a̠
はかどる	h a̠ k a̠ d o̞ ɾ ɯ̟ᵝ
はかる	h a̠ k a̠ ɾ ɯ̟ᵝ
はがき	h a̠ ɡ a̠ kʲ i
はきだす	h a̠ kʲ i d a̠ s ɨᵝ
はぎ	h a̠ ɡʲ i
はくい	h a̠ k ɯ̟ᵝ i
はくうち	h a̠ k ɯ̟ᵝ ɯ̟ᵝ t͡ɕ i
はくさい	h a̠ k ɯ̟̊ᵝ s a̠ i
はくしゃく	h a̠ k ɯ̟̊ᵝ ɕ a̠ k ɯ̟ᵝ
はくしゅ	h a̠ k ɯ̟̊ᵝ ɕ ɨᵝ
はくしゅう	h a̠ k ɯ̟ᵝ ɕ ɨᵝː
はくぶつ	h a̠ k ɯ̟ᵝ b ɯ̟ᵝ t͡s ɨᵝ
はくぶん	h a̠ k ɯ̟ᵝ b ɯ̟̃ᵝ ɴ
はくめい	h a̠ k ɯ̟ᵝ m e̞ː
はくれん	h a̠ k ɯ̟ᵝ ɾ ẽ̞ ɴ
はぐ	h a̠ ɡ ɯ̟ᵝ
はぐき	h a̠ ɡ ɯ̟ᵝ kʲ i
はけぐち	h a̠ k e̞ ɡ ɯ̟̊ᵝ t͡ɕ i
はげむ	h a̠ ɡ e̞ m ɯ̟ᵝ
はこだて	h a̠ k o̞ d a̠ t e̞
はこびこむ	h a̠ k o̞ bʲ i k o̞ m ɯ̟ᵝ
はごろも	h a̠ ɡ o̞ ɾ o̞ m o̞
はさい	h a̠ s a̠ i
はさまる	h a̠ s a̠ m a̠ ɾ ɯ̟ᵝ
はざくら	h a̠ z a̠ k ɯ̟ᵝ ɾ a̠
はざま	h a̠ z a̠ m a̠
はしござけ	h a̠ ɕ i ɡ o̞ z a̠ k e̞
はしどい	h a̠ ɕ i d o̞ i
はしゅ	h a̠ ɕ ɨᵝ
はしり	h a̠ ɕ i ɾʲ i
はじき	h a̠ ʑ i kʲ i
はじしらず	h a̠ ʑ i ɕ i ɾ a̠ z ɨᵝ
はじめる	h a̠ ʑ i m e̞ ɾ ɯ̟ᵝ
はじゃけんしょう	h a̠ ʑ a̠ k ẽ̞ ɰ̃ ɕ o̞ː
はずかしい	h a̠ z ɨᵝ k a̠ ɕ iː
はずす	h a̠ z ɨᵝ s ɨᵝ
はそん	h a̠ s õ̞ ɴ
はたおりぎょう	h a̠ t a̠ o̞ ɾʲ i ɡʲ o̞ː
はたきこみ	h a̠ t a̠ kʲ i k o̞ mʲ i
はたらきもの	h a̠ t a̠ ɾ a̠ kʲ i m o̞ n o̞
はだし	h a̠ d a̠ ɕ i
はちあわせ	h a̠ t͡ɕ i a̠ ɰᵝ a̠ s e̞
はちじゅう	h a̠ t͡ɕ i ʑ ɨᵝː
はちすか	h a̠ t͡ɕ i s ɨᵝ k a̠
はちみつ	h a̠ t͡ɕ i mʲ i t͡s ɨᵝ
はちゅうるい	h a̠ t͡ɕ ɨᵝː ɾ ɯ̟ᵝ i
はちょう	h a̠ t͡ɕ o̞ː
はっき	h a̠ k̚ʲ kʲ i
はっけん	h a̠ k̚ k ẽ̞ ɴ
はっそう	h a̠ sː o̞ː
はっぽうしゅ	h a̠ p̚ p o̞ː ɕ ɨᵝ
はつか	h a̠ t͡s ɨ̥ᵝ k a̠
はつこい	h a̠ t͡s ɨ̥ᵝ k o̞ i
はつもの	h a̠ t͡s ɨᵝ m o̞ n o̞
はづき	h a̠ z ɨᵝ kʲ i
はてしない	h a̠ t e̞ ɕ i n a̠ i
はとば	h a̠ t o̞ b a̠
はとむね	h a̠ t o̞ m ɯ̟ᵝ n e̞
はどう	h a̠ d o̞ː
はないき	h a̠ n a̠ i kʲ i
はなうど	h a̠ n a̠ ɯ̟ᵝ d o̞
はなぐま	h a̠ n a̠ ɡ ɯ̟ᵝ m a̠
はなみ	h a̠ n a̠ mʲ i
はなよめ	h a̠ n a̠ j o̞ m e̞
はねあげる	h a̠ n e̞ a̠ ɡ e̞ ɾ ɯ̟ᵝ
はねる	h a̠ n e̞ ɾ ɯ̟ᵝ
はばち	h a̠ b a̠ t͡ɕ i
はばつ	h a̠ b a̠ t͡s ɨᵝ
はびこる	h a̠ bʲ i k o̞ ɾ ɯ̟ᵝ
はぶ	h a̠ b ɯ̟ᵝ
はまじゅつ	h a̠ m a̠ ʑ ɨᵝ t͡s ɨᵝ
はまち	h a̠ m a̠ t͡ɕ i
はまや	h a̠ m a̠ j a̠
はみがきこ	h a̠ mʲ i ɡ a̠ kʲ i̥ k o̞
はむ	h a̠ m ɯ̟ᵝ
はもの	h a̠ m o̞ n o̞
はやおき	h a̠ j a̠ o̞ kʲ i
はやぐい	h a̠ j a̠ ɡ ɯ̟ᵝ i
はやる	h a̠ j a̠ ɾ ɯ̟ᵝ
はよ	h a̠ j o̞
はらえど	h a̠ ɾ a̠ e̞ d o̞
はらす	h a̠ ɾ a̠ s ɨᵝ
はらだたしい	h a̠ ɾ a̠ d a̠ t a̠ ɕ iː
はり	h a̠ ɾʲ i
はりがみ	h a̠ ɾʲ i ɡ a̠ mʲ i
はりたおす	h a̠ ɾʲ i t a̠ o̞ s ɨᵝ
はる	h a̠ ɾ ɯ̟ᵝ
はるお	h a̠ ɾ ɯ̟ᵝ o̞
はれる	h a̠ ɾ e̞ ɾ ɯ̟ᵝ
はれんち	h a̠ ɾ ẽ̞ ɲ̟ t͡ɕ i
はろう	h a̠ ɾ o̞ː
はんかい	h ã̠ ŋ k a̠ i
はんかん	h ã̠ ŋ k ã̠ ɴ
はんきゅう	h ã̠ ŋʲ kʲ ɨᵝː
はんぎゃく	h ã̠ ŋʲ ɡʲ a̠ k ɯ̟ᵝ
はんさてつがく	h ã̠ ɰ̃ s a̠ t e̞ t͡s ɨᵝ ɡ a̠ k ɯ̟ᵝ
はんたいじ	h ã̠ n t a̠ i ʑ i
はんだん	h ã̠ n d ã̠ ɴ
はんばいしゃ	h ã̠ m b a̠ i ɕ a̠
はんべつ	h ã̠ m b e̞ t͡s ɨᵝ
ばいしんいん	b a̠ i ɕ ĩ ɰ̃ ĩ ɴ
ばいたい	b a̠ i t a̠ i
ばいたん	b a̠ i t ã̠ ɴ
ばいばい	b a̠ i b a̠ i
ばか	b a̠ k a̠
ばかり	b a̠ k a̠ ɾʲ i
ばく	b a̠ k ɯ̟ᵝ
ばくしん	b a̠ k ɯ̟̊ᵝ ɕ ĩ ɴ
ばくたん	b a̠ k ɯ̟ᵝ t ã̠ ɴ
ばくだい	b a̠ k ɯ̟ᵝ d a̠ i
ばくちく	b a̠ k ɯ̟ᵝ t͡ɕ i̥ k ɯ̟ᵝ
ばくはく	b a̠ k ɯ̟ᵝ h a̠ k ɯ̟ᵝ
ばくはつおん	b a̠ k ɯ̟ᵝ h a̠ t͡s ɨᵝ õ̞ ɴ
ばくふう	b a̠ k ɯ̟̊ᵝ ɸ ɯ̟ᵝː
ばくやく	b a̠ k ɯ̟ᵝ j a̠ k ɯ̟ᵝ
ばくろ	b a̠ k ɯ̟ᵝ ɾ o̞
ばぐ	b a̠ ɡ ɯ̟ᵝ
ばける	b a̠ k e̞ ɾ ɯ̟ᵝ
ばさし	b a̠ s a̠ ɕ i
ばじとうふう	b a̠ ʑ i t o̞ː ɸ ɯ̟ᵝː
ばじゅつ	b a̠ ʑ ɨᵝ t͡s ɨᵝ
ばちがい	b a̠ t͡ɕ i ɡ a̠ i
ばったり	b a̠ t̚ t a̠ ɾʲ i
ばてる	b a̠ t e̞ ɾ ɯ̟ᵝ
ばにゅう	b a̠ ɲ̟ ɯ̟ᵝː
ばね	b a̠ n e̞
ばば	b a̠ b a̠
ばばぬき	b a̠ b a̠ n ɯ̟ᵝ kʲ i
ばびしょう	b a̠ bʲ i ɕ o̞ː
ばふだ	b a̠ ɸ ɯ̟ᵝ d a̠
ばめん	b a̠ m ẽ̞ ɴ
ばらにく	b a̠ ɾ a̠ ɲ̟ i k ɯ̟ᵝ
ばらばら	b a̠ ɾ a̠ b a̠ ɾ a̠
ばんかい	b ã̠ ŋ k a̠ i
ばんき	b ã̠ ŋʲ kʲ i
ばんぐみ	b ã̠ ŋ ɡ ɯ̟ᵝ mʲ i
ばんごはん	b ã̠ ŋ ɡ o̞ h ã̠ ɴ
ばんせん	b ã̠ ɰ̃ s ẽ̞ ɴ
ばんぜい	b ã̠ n d͡z e̞ː
ばんそう	b ã̠ ɰ̃ s o̞ː
ばんそうこう	b ã̠ ɰ̃ s o̞ː k o̞ː
ばんにん	b ã̠ ɲ̟ ɲ̟ ĩ ɴ
ばんのう	b ã̠ nː o̞ː
ばんぺいゆ	b ã̠ m p e̞ː j ɯ̟ᵝ
ばんみんほう	b ã̠ mʲː ĩ ɰ̃ h o̞ː
ひえこみ	ç i e̞ k o̞ mʲ i
ひおうぎ	ç i o̞ː ɡʲ i
ひかきぼう	ç i k a̠ kʲ i b o̞ː
ひかる	ç i k a̠ ɾ ɯ̟ᵝ
ひかれる	ç i k a̠ ɾ e̞ ɾ ɯ̟ᵝ
ひがえり	ç i ɡ a̠ e̞ ɾʲ i
ひがさ	ç i ɡ a̠ s a̠
ひがんばな	ç i ɡ ã̠ m b a̠ n a̠
ひきがね	ç i kʲ i ɡ a̠ n e̞
ひきさく	ç i kʲ i s a̠ k ɯ̟ᵝ
ひきはらう	ç i kʲ i h a̠ ɾ a̠ ɯ̟ᵝ
ひきょうえき	ç i kʲ o̞ː e̞ kʲ i
ひぎ	ç i ɡʲ i
ひくいどり	ç i̥ k ɯ̟ᵝ i d o̞ ɾʲ i
ひぐらし	ç i ɡ ɯ̟ᵝ ɾ a̠ ɕ i
ひけんしゃ	ç i k ẽ̞ ɰ̃ ɕ a̠
ひげんすう	ç i ɡ ẽ̞ ɰ̃ s ɨᵝː
ひこうこうおんか	ç i k o̞ː k o̞ː õ̞ ŋ k a̠
ひこうし	ç i k o̞ː ɕ i
ひさいしゃ	ç i s a̠ i ɕ a̠
ひさびさ	ç i s a̠ bʲ i s a̠
ひさん	ç i̥ s ã̠ ɴ
ひざまくら	ç i z a̠ m a̠ k ɯ̟ᵝ ɾ a̠
ひしゅ	ç i ɕ ɨᵝ
ひじょすう	ç i ʑ o̞ s ɨᵝː
ひそやか	ç i s o̞ j a̠ k a̠
ひだち	ç i d a̠ t͡ɕ i
ひっこめる	ç i k̚ k o̞ m e̞ ɾ ɯ̟ᵝ
ひっし	ç i ɕː i
ひつじゅ	ç i t͡s ɨᵝ ʑ ɨᵝ
ひづめ	ç i z ɨᵝ m e̞
ひでし	ç i d e̞ ɕ i
ひでたか	ç i d e̞ t a̠ k a̠
ひでみつ	ç i d e̞ mʲ i t͡s ɨᵝ
ひでゆき	ç i d e̞ j ɯ̟ᵝ kʲ i
ひときれ	ç i t o̞ kʲ i ɾ e̞
ひところ	ç i t o̞ k o̞ ɾ o̞
ひとしい	ç i t o̞ ɕ i i
ひとじち	ç i̥ t o̞ ʑ i t͡ɕ i
ひとじらみ	ç i̥ t o̞ ʑ i ɾ a̠ mʲ i
ひとたち	ç i̥ t o̞ t a̠ t͡ɕ i
ひとどおり	ç i t o̞ d o̞ː ɾʲ i
ひとなか	ç i t o̞ n a̠ k a̠
ひとびと	ç i t o̞ bʲ i t o̞
ひとめぼれ	ç i̥ t o̞ m e̞ b o̞ ɾ e̞
ひとりごと	ç i t o̞ ɾʲ i ɡ o̞ t o̞
ひとりひとり	ç i t o̞ ɾʲ i ç i t o̞ ɾʲ i
ひどう	ç i d o̞ː
ひな	ç i n a̠
ひなた	ç i n a̠ t a̠
ひなまつり	ç i n a̠ m a̠ t͡s ɨᵝ ɾʲ i
ひねる	ç i n e̞ ɾ ɯ̟ᵝ
ひのくるま	ç i n o̞ k ɯ̟ᵝ ɾ ɯ̟ᵝ m a̠
ひばち	ç i b a̠ t͡ɕ i
ひびく	ç i bʲ i k ɯ̟ᵝ
ひふえん	ç i̥ ɸ ɯ̟ᵝ ẽ̞ ɴ
ひふびょう	ç i ɸ ɯ̟ᵝ bʲ o̞ː
ひまん	ç i m ã̠ ɴ
ひめ	ç i m e̞
ひめはじめ	ç i m e̞ h a̠ ʑ i m e̞
ひめる	ç i m e̞ ɾ ɯ̟ᵝ
ひもの	ç i m o̞ n o̞
ひゃくしょう	ç a̠ k ɯ̟̊ᵝ ɕ o̞ː
ひゃくせん	ç a̠ k ɯ̟ᵝ s ẽ̞ ɴ
ひゃくにちそう	ç a̠ k ɯ̟ᵝ ɲ̟ i t͡ɕ i s o̞ː
ひやかす	ç i j a̠ k a̠ s ɨᵝ
ひょ	ç o̞
ひょうがいかんじ	ç o̞ː ɡ a̠ i k ã̠ ɲ̟ d͡ʑ i
ひょうげんがた	ç o̞ː ɡ ẽ̞ ŋ ɡ a̠ t a̠
ひょうげんしゅぎ	ç o̞ː ɡ ẽ̞ ɰ̃ ɕ ɨᵝ ɡʲ i
ひょうご	ç o̞ː ɡ o̞
ひょうごけん	ç o̞ː ɡ o̞ k ẽ̞ ɴ
ひょうしき	ç o̞ː ɕ i kʲ i
ひょうじゅんへんさ	ç o̞ː ʑ ɨ̃ᵝ ɰ̃ h ẽ̞ ɰ̃ s a̠
ひょうす	ç o̞ː s ɨᵝ
ひょうてき	ç o̞ː t e̞ kʲ i
ひょうはく	ç o̞ː h a̠ k ɯ̟ᵝ
ひょうはくざい	ç o̞ː h a̠ k ɯ̟ᵝ z a̠ i
ひよめき	ç i j o̞ m e̞ kʲ i
ひらいしん	ç i ɾ a̠ i ɕ ĩ ɴ
ひらがな	ç i ɾ a̠ ɡ a̠ n a̠
ひらた	ç i ɾ a̠ t a̠
ひらのすい	ç i ɾ a̠ n o̞ s ɨᵝ i
ひらめく	ç i ɾ a̠ m e̞ k ɯ̟ᵝ
ひるめし	ç i ɾ ɯ̟ᵝ m e̞ ɕ i
ひろい	ç i ɾ o̞ i
ひろう	ç i ɾ o̞ ɯ̟ᵝ
ひろし	ç i ɾ o̞ ɕ i
ひろしまけん	ç i ɾ o̞ ɕ i m a̠ k ẽ̞ ɴ
ひろまる	ç i ɾ o̞ m a̠ ɾ ɯ̟ᵝ
ひんこく	ç ĩ ŋ k o̞ k ɯ̟ᵝ
ひんこんしゃ	ç ĩ ŋ k õ̞ ɰ̃ ɕ a̠
ひんし	ç ĩ ɰ̃ ɕ i
ひんせん	ç ĩ ɰ̃ s ẽ̞ ɴ
ひんだい	ç ĩ n d a̠ i
ひんにゅう	ç ĩ ɲ̟ ɲ̟ ɯ̟ᵝː
ひんのう	ç ĩ nː o̞ː
びいしき	bʲ iː ɕ i kʲ i
びおん	bʲ i õ̞ ɴ
びがく	bʲ i ɡ a̠ k ɯ̟ᵝ
びざい	bʲ i z a̠ i
びしゅく	bʲ i ɕ ɨᵝ k ɯ̟ᵝ
びじゃく	bʲ i ʑ a̠ k ɯ̟ᵝ
びちく	bʲ i t͡ɕ i k ɯ̟ᵝ
びちょうせい	bʲ i t͡ɕ o̞ː s e̞ː
びどう	bʲ i d o̞ː
びもく	bʲ i m o̞ k ɯ̟ᵝ
びゃくだん	bʲ a̠ k ɯ̟ᵝ d ã̠ ɴ
びょうがく	bʲ o̞ː ɡ a̠ k ɯ̟ᵝ
びょうげんたい	bʲ o̞ː ɡ ẽ̞ n t a̠ i
びょうじょく	bʲ o̞ː ʑ o̞ k ɯ̟ᵝ
びょうどう	bʲ o̞ː d o̞ː
びよく	bʲ i j o̞ k ɯ̟ᵝ
びりょこつ	bʲ i ɾʲ o̞ k o̞ t͡s ɨᵝ
びわ	bʲ i ɰᵝ a̠
びん	bʲ ĩ ɴ
びんかん	bʲ ĩ ŋ k ã̠ ɴ
びんざさら	bʲ ĩ n d͡z a̠ s a̠ ɾ a̠
ぴたり	pʲ i t a̠ ɾʲ i
ぴゃ	pʲ a̠
ふうきん	ɸ ɯ̟ᵝː kʲ ĩ ɴ
ふうせん	ɸ ɯ̟ᵝː s ẽ̞ ɴ
ふうふう	ɸ ɯ̟ᵝː ɸ ɯ̟ᵝː
ふおん	ɸ ɯ̟ᵝ õ̞ ɴ
ふか	ɸ ɯ̟ᵝ k a̠
ふかい	ɸ ɯ̟ᵝ k a̠ i
ふかぎゃく	ɸ ɯ̟ᵝ k a̠ ɡʲ a̠ k ɯ̟ᵝ
ふきとばす	ɸ ɯ̟ᵝ kʲ i t o̞ b a̠ s ɨᵝ
ふきょ	ɸ ɯ̟ᵝ kʲ o̞
ふくい	ɸ ɯ̟ᵝ k ɯ̟ᵝ i
ふくぎょう	ɸ ɯ̟ᵝ k ɯ̟ᵝ ɡʲ o̞ː
ふくごう	ɸ ɯ̟̊ᵝ k ɯ̟ᵝ ɡ o̞ː
ふくさんぶつ	ɸ ɯ̟ᵝ k ɯ̟ᵝ s ã̠ m b ɯ̟ᵝ t͡s ɨᵝ
ふくしまけん	ɸ ɯ̟ᵝ k ɯ̟ᵝ ɕ i m a̠ k ẽ̞ ɴ
ふくそう	ɸ ɯ̟ᵝ k ɯ̟ᵝ s o̞ː
ふくへい	ɸ ɯ̟ᵝ k ɯ̟ᵝ h e̞ː
ふくわじゅつ	ɸ ɯ̟̊ᵝ k ɯ̟ᵝ ɰᵝ a̠ ʑ ɨᵝ t͡s ɨᵝ
ふぐ	ɸ ɯ̟ᵝ ɡ ɯ̟ᵝ
ふけ	ɸ ɯ̟ᵝ k e̞
ふけい	ɸ ɯ̟ᵝ k e̞ː
ふける	ɸ ɯ̟ᵝ k e̞ ɾ ɯ̟ᵝ
ふこくしゃ	ɸ ɯ̟ᵝ k o̞ k ɯ̟ᵝ ɕ a̠
ふごう	ɸ ɯ̟ᵝ ɡ o̞ː
ふしゃ	ɸ ɯ̟ᵝ ɕ a̠
ふしょう	ɸ ɯ̟ᵝ ɕ o̞ː
ふしん	ɸ ɯ̟ᵝ ɕ ĩ ɴ
ふしんかん	ɸ ɯ̟ᵝ ɕ ĩ ŋ k ã̠ ɴ
ふじ	ɸ ɯ̟ᵝ ʑ i
ふじいろ	ɸ ɯ̟ᵝ ʑ iː ɾ o̞
ふじさん	ɸ ɯ̟ᵝ ʑ i s ã̠ ɴ
ふじとう	ɸ ɯ̟ᵝ ʑ i t o̞ː
ふじばかま	ɸ ɯ̟ᵝ ʑ i b a̠ k a̠ m a̠
ふじゅんぶつ	ɸ ɯ̟ᵝ ʑ ɨ̃ᵝ m b ɯ̟ᵝ t͡s ɨᵝ
ふじん	ɸ ɯ̟ᵝ ʑ ĩ ɴ
ふじんふく	ɸ ɯ̟ᵝ ʑ ĩ ɰ̃ ɸ ɯ̟ᵝ k ɯ̟ᵝ
ふすう	ɸ ɯ̟̊ᵝ s ɨᵝː
ふせいじょう	ɸ ɯ̟̊ᵝ s e̞ː ʑ o̞ː
ふた	ɸ ɯ̟ᵝ t a̠
ふたなり	ɸ ɯ̟ᵝ t a̠ n a̠ ɾʲ i
ふちゅうい	ɸ ɯ̟ᵝ t͡ɕ ɨᵝː i
ふちょう	ɸ ɯ̟ᵝ t͡ɕ o̞ː
ふっかつ	ɸ ɯ̟̊ᵝ k̚ k a̠ t͡s ɨᵝ
ふっけん	ɸ ɯ̟ᵝ k̚ k ẽ̞ ɴ
ふつうわ	ɸ ɯ̟ᵝ t͡s ɨᵝː ɰᵝ a̠
ふていかんし	ɸ ɯ̟ᵝ t e̞ː k ã̠ ɰ̃ ɕ i
ふてきとう	ɸ ɯ̟ᵝ t e̞ kʲ i t o̞ː
ふとうこう	ɸ ɯ̟ᵝ t o̞ː k o̞ː
ふとうしき	ɸ ɯ̟̊ᵝ t o̞ː ɕ i̥ kʲ i
ふな	ɸ ɯ̟ᵝ n a̠
ふはい	ɸ ɯ̟ᵝ h a̠ i
ふはつ	ɸ ɯ̟ᵝ h a̠ t͡s ɨᵝ
ふひょうばん	ɸ ɯ̟ᵝ ç o̞ː b ã̠ ɴ
ふほうわ	ɸ ɯ̟ᵝ h o̞ː ɰᵝ a̠
ふぼ	ɸ ɯ̟ᵝ b o̞
ふみこむ	ɸ ɯ̟ᵝ mʲ i k o̞ m ɯ̟ᵝ
ふみだす	ɸ ɯ̟ᵝ mʲ i d a̠ s ɨᵝ
ふめい	ɸ ɯ̟ᵝ m e̞ː
ふめいよ	ɸ ɯ̟ᵝ m e̞ː j o̞
ふめつ	ɸ ɯ̟ᵝ m e̞ t͡s ɨᵝ
ふもう	ɸ ɯ̟ᵝ m o̞ː
ふりかけ	ɸ ɯ̟ᵝ ɾʲ i k a̠ k e̞
ふりそで	ɸ ɯ̟ᵝ ɾʲ i s o̞ d e̞
ふれあう	ɸ ɯ̟ᵝ ɾ e̞ a̠ ɯ̟ᵝ
ふれる	ɸ ɯ̟ᵝ ɾ e̞ ɾ ɯ̟ᵝ
ふわ	ɸ ɯ̟ᵝ ɰᵝ a̠
ふんにょう	ɸ ɯ̟̃ᵝ ɲ̟ ɲ̟ o̞ː
ふんまつ	ɸ ɯ̟̃ᵝ mː a̠ t͡s ɨᵝ
ふんむき	ɸ ɯ̟̃ᵝ mː ɯ̟ᵝ kʲ i
ぶおんな	b ɯ̟ᵝ õ̞ nː a̠
ぶかい	b ɯ̟ᵝ k a̠ i
ぶげいしゃ	b ɯ̟ᵝ ɡ e̞ː ɕ a̠
ぶごう	b ɯ̟ᵝ ɡ o̞ː
ぶさいく	b ɯ̟ᵝ s a̠ i k ɯ̟ᵝ
ぶさた	b ɯ̟ᵝ s a̠ t a̠
ぶしょう	b ɯ̟ᵝ ɕ o̞ː
ぶぜん	b ɯ̟ᵝ z ẽ̞ ɴ
ぶたいうら	b ɯ̟ᵝ t a̠ i ɯ̟ᵝ ɾ a̠
ぶたにく	b ɯ̟ᵝ t a̠ ɲ̟ i k ɯ̟ᵝ
ぶっかだか	b ɯ̟ᵝ k̚ k a̠ d a̠ k a̠
ぶっし	b ɯ̟ᵝ ɕː i
ぶったくり	b ɯ̟ᵝ t̚ t a̠ k ɯ̟ᵝ ɾʲ i
ぶっとう	b ɯ̟ᵝ t̚ t o̞ː
ぶつける	b ɯ̟ᵝ t͡s ɨᵝ k e̞ ɾ ɯ̟ᵝ
ぶどうえん	b ɯ̟ᵝ d o̞ː ẽ̞ ɴ
ぶどうかん	b ɯ̟ᵝ d o̞ː k ã̠ ɴ
ぶどうだん	b ɯ̟ᵝ d o̞ː d ã̠ ɴ
ぶな	b ɯ̟ᵝ n a̠
ぶらさがる	b ɯ̟ᵝ ɾ a̠ s a̠ ɡ a̠ ɾ ɯ̟ᵝ
ぶらつく	b ɯ̟ᵝ ɾ a̠ t͡s ɨᵝ k ɯ̟ᵝ
ぶり	b ɯ̟ᵝ ɾʲ i
ぶん	b ɯ̟̃ᵝ ɴ
ぶんかざい	b ɯ̟̃ᵝ ŋ k a̠ z a̠ i
ぶんきゅう	b ɯ̟̃ᵝ ŋʲ kʲ ɨᵝː
ぶんぐ	b ɯ̟̃ᵝ ŋ ɡ ɯ̟ᵝ
ぶんこ	b ɯ̟̃ᵝ ŋ k o̞
ぶんこうき	b ɯ̟̃ᵝ ŋ k o̞ː kʲ i
ぶんし	b ɯ̟̃ᵝ ɰ̃ ɕ i
ぶんしゅう	b ɯ̟̃ᵝ ɰ̃ ɕ ɨᵝː
ぶんしょうだい	b ɯ̟̃ᵝ ɰ̃ ɕ o̞ː d a̠ i
ぶんたい	b ɯ̟̃ᵝ n t a̠ i
ぶんどき	b ɯ̟̃ᵝ n d o̞ kʲ i
ぶんぼうしほう	b ɯ̟̃ᵝ m b o̞ː ɕ i h o̞ː
ぶんるいがく	b ɯ̟̃ᵝ n ɾ ɯ̟ᵝ i ɡ a̠ k ɯ̟ᵝ
ぶんるいほう	b ɯ̟̃ᵝ n ɾ ɯ̟ᵝ i h o̞ː
へいおん	h e̞ː õ̞ ɴ
へいきしょう	h e̞ː kʲ i ɕ o̞ː
へいきんりつ	h e̞ː kʲ ĩ n ɾʲ i t͡s ɨᵝ
へいごう	h e̞ː ɡ o̞ː
へいざん	h e̞ː z ã̠ ɴ
へいし	h e̞ː ɕ i
へいじょう	h e̞ː ʑ o̞ː
へいそん	h e̞ː s õ̞ ɴ
へそ	h e̞ s o̞
へだたる	h e̞ d a̠ t a̠ ɾ ɯ̟ᵝ
へびくいわし	h e̞ bʲ i k ɯ̟ᵝ i ɰᵝ a̠ ɕ i
へへ	h e̞ h e̞
へらさぎ	h e̞ ɾ a̠ s a̠ ɡʲ i
へんか	h ẽ̞ ŋ k a̠
へんがん	h ẽ̞ ŋ ɡ ã̠ ɴ
へんし	h ẽ̞ ɰ̃ ɕ i
へんしつしゃ	h ẽ̞ ɰ̃ ɕ i t͡s ɨᵝ ɕ a̠
へんしょう	h ẽ̞ ɰ̃ ɕ o̞ː
へんしん	h ẽ̞ ɰ̃ ɕ ĩ ɴ
へんせいき	h ẽ̞ ɰ̃ s e̞ː kʲ i
へんてつ	h ẽ̞ n t e̞ t͡s ɨᵝ
べっけい	b e̞ k̚ k e̞ː
べっと	b e̞ t̚ t o̞
べつくち	b e̞ t͡s ɨᵝ k ɯ̟ᵝ t͡ɕ i
べつじん	b e̞ t͡s ɨᵝ ʑ ĩ ɴ
べつだん	b e̞ t͡s ɨᵝ d ã̠ ɴ
べつばら	b e̞ t͡s ɨᵝ b a̠ ɾ a̠
べんきょう	b ẽ̞ ŋʲ kʲ o̞ː
べんじょ	b ẽ̞ ɲ̟ d͡ʑ o̞
ほうい	h o̞ː i
ほういじしん	h o̞ː i ʑ i ɕ ĩ ɴ
ほうおん	h o̞ː õ̞ ɴ
ほうかご	h o̞ː k a̠ ɡ o̞
ほうき	h o̞ː kʲ i
ほうきぼし	h o̞ː kʲ i b o̞ ɕ i
ほうけんてき	h o̞ː k ẽ̞ n t e̞ kʲ i
ほうこくしょ	h o̞ː k o̞ k ɯ̟ᵝ ɕ o̞
ほうざい	h o̞ː z a̠ i
ほうしゃのう	h o̞ː ɕ a̠ n o̞ː
ほうしゅつおん	h o̞ː ɕ ɨᵝ t͡s ɨᵝ õ̞ ɴ
ほうじゅう	h o̞ː ʑ ɨᵝː
ほうせん	h o̞ː s ẽ̞ ɴ
ほうそう	h o̞ː s o̞ː
ほうだん	h o̞ː d ã̠ ɴ
ほうでん	h o̞ː d ẽ̞ ɴ
ほうとう	h o̞ː t o̞ː
ほうのう	h o̞ː n o̞ː
ほうぶつせん	h o̞ː b ɯ̟ᵝ t͡s ɨ̥ᵝ s ẽ̞ ɴ
ほうほう	h o̞ː h o̞ː
ほうほうろん	h o̞ː h o̞ː ɾ õ̞ ɴ
ほうやく	h o̞ː j a̠ k ɯ̟ᵝ
ほうゆう	h o̞ː j ɯ̟ᵝː
ほうよう	h o̞ː j o̞ː
ほお	h o̞ː
ほおずき	h o̞ː z ɨᵝ kʲ i
ほおづえ	h o̞ː z ɨᵝ e̞
ほかん	h o̞ k ã̠ ɴ
ほくおう	h o̞ k ɯ̟ᵝ o̞ː
ほこる	h o̞ k o̞ ɾ ɯ̟ᵝ
ほごれる	h o̞ ɡ o̞ ɾ e̞ ɾ ɯ̟ᵝ
ほしい	h o̞ ɕ iː
ほしゅとう	h o̞ ɕ ɨ̥ᵝ t o̞ː
ほしょく	h o̞ ɕ o̞ k ɯ̟ᵝ
ほす	h o̞ s ɨᵝ
ほすうけい	h o̞ s ɨᵝː k e̞ː
ほせつ	h o̞ s e̞ t͡s ɨᵝ
ほちょうき	h o̞ t͡ɕ o̞ː kʲ i
ほっかいどう	h o̞ k̚ k a̠ i d o̞ː
ほっきょくぎつね	h o̞ k̚ʲ kʲ o̞ k ɯ̟ᵝ ɡʲ i t͡s ɨᵝ n e̞
ほっぽらかす	h o̞ p̚ p o̞ ɾ a̠ k a̠ s ɨᵝ
ほどこし	h o̞ d o̞ k o̞ ɕ i
ほどこす	h o̞ d o̞ k o̞ s ɨᵝ
ほな	h o̞ n a̠
ほのぼの	h o̞ n o̞ b o̞ n o̞
ほふる	h o̞ ɸ ɯ̟ᵝ ɾ ɯ̟ᵝ
ほめる	h o̞ m e̞ ɾ ɯ̟ᵝ
ほよういん	h o̞ j o̞ː ĩ ɴ
ほようち	h o̞ j o̞ː t͡ɕ i
ほらがい	h o̞ ɾ a̠ ɡ a̠ i
ほろぶ	h o̞ ɾ o̞ b ɯ̟ᵝ
ほろほろちょう	h o̞ ɾ o̞ h o̞ ɾ o̞ t͡ɕ o̞ː
ほんしん	h õ̞ ɰ̃ ɕ ĩ ɴ
ほんじ	h õ̞ ɲ̟ d͡ʑ i
ほんたい	h õ̞ n t a̠ i
ほんだい	h õ̞ n d a̠ i
ほんちょ	h õ̞ ɴ t͡ɕʲ o̞
ほんや	h õ̞ ɰ̃ j a̠
ほんらい	h õ̞ n ɾ a̠ i
ぼうえき	b o̞ː e̞ kʲ i
ぼうえんきょう	b o̞ː ẽ̞ ŋʲ kʲ o̞ː
ぼうしゅ	b o̞ː ɕ ɨᵝ
ぼうしん	b o̞ː ɕ ĩ ɴ
ぼうじん	b o̞ː ʑ ĩ ɴ
ぼうせつえん	b o̞ː s e̞ t͡s ɨᵝ ẽ̞ ɴ
ぼうぜん	b o̞ː z ẽ̞ ɴ
ぼうちょうざい	b o̞ː t͡ɕ o̞ː z a̠ i
ぼうてん	k ẽ̞ n t ẽ̞ ɴ
ぼうろう	b o̞ː ɾ o̞ː
ぼくたち	b o̞ k ɯ̟ᵝ t a̠ t͡ɕ i
ぼけ	b o̞ k e̞
ぼけい	b o̞ k e̞ː
ぼこく	b o̞ k o̞ k ɯ̟ᵝ
ぼじゅつ	b o̞ ʑ ɨᵝ t͡s ɨᵝ
ぼたもち	b o̞ t a̠ m o̞ t͡ɕ i
ぼち	b o̞ t͡ɕ i
ぼっとう	b o̞ t̚ t o̞ː
ぼはん	b o̞ h ã̠ ɴ
ぽい	p o̞ i
ぽこく	p o̞ k o̞ k ɯ̟ᵝ
ぽご	p o̞ ɡ o̞
まあたらしい	m a̠ː t a̠ ɾ a̠ ɕ iː
まいおちる	m a̠ i o̞ t͡ɕ i ɾ ɯ̟ᵝ
まいご	m a̠ i ɡ o̞
まいとし	m a̠ i t o̞ ɕ i
まいど	m a̠ i d o̞
まう	m a̠ ɯ̟ᵝ
まえかけ	m a̠ e̞ k a̠ k e̞
まえがみ	m a̠ e̞ ɡ a̠ mʲ i
まえづけ	m a̠ e̞ z ɨᵝ k e̞
まえぶれ	m a̠ e̞ b ɯ̟ᵝ ɾ e̞
まかつきゅう	m a̠ k a̠ t͡s ɨ̥ᵝ kʲ ɨᵝː
まがう	m a̠ ɡ a̠ ɯ̟ᵝ
まきぞえ	m a̠ kʲ i z o̞ e̞
まきゅう	m a̠ kʲ ɨᵝː
まきょう	m a̠ kʲ o̞ː
まぐさ	m a̠ ɡ ɯ̟ᵝ s a̠
まぐろ	m a̠ ɡ ɯ̟ᵝ ɾ o̞
まけ	m a̠ k e̞
まけいぬ	m a̠ k e̞ː n ɯ̟ᵝ
まける	m a̠ k e̞ ɾ ɯ̟ᵝ
まげる	m a̠ ɡ e̞ ɾ ɯ̟ᵝ
まさし	m a̠ s a̠ ɕ i
まさじ	m a̠ s a̠ ʑ i
まさと	m a̠ s a̠ t o̞
まさゆき	m a̠ s a̠ j ɯ̟ᵝ kʲ i
まさゆめ	m a̠ s a̠ j ɯ̟ᵝ m e̞
ましお	m a̠ ɕ i o̞
まじえる	m a̠ ʑ i e̞ ɾ ɯ̟ᵝ
まじょ	m a̠ ʑ o̞
まじる	m a̠ ʑ i ɾ ɯ̟ᵝ
まじん	m a̠ ʑ ĩ ɴ
ますい	m a̠ s ɨᵝ i
まぜる	m a̠ z e̞ ɾ ɯ̟ᵝ
まだに	m a̠ d a̠ ɲ̟ i
まだら	m a̠ d a̠ ɾ a̠
まちあい	m a̠ t͡ɕ i a̠ i
まちあわせ	m a̠ t͡ɕ i a̠ ɰᵝ a̠ s e̞
まちがい	m a̠ t͡ɕ i ɡ a̠ i
まちのぞむ	m a̠ t͡ɕ i n o̞ z o̞ m ɯ̟ᵝ
まぢか	m a̠ ʑ i k a̠
まっか	m a̠ k̚ k a̠
まっこうくじら	m a̠ k̚ k o̞ː k ɯ̟ᵝ ʑ i ɾ a̠
まっさお	m a̠ sː a̠ o̞
まっさき	m a̠ sː a̠ kʲ i
まっさつ	m a̠ sː a̠ t͡s ɨᵝ
まつび	m a̠ t͡s ɨᵝ bʲ i
まなこ	m a̠ n a̠ k o̞
まなざし	m a̠ n a̠ z a̠ ɕ i
まなびや	m a̠ n a̠ bʲ i j a̠
まにゅう	m a̠ ɲ̟ ɯ̟ᵝː
まぬかれる	m a̠ n ɯ̟ᵝ k a̠ ɾ e̞ ɾ ɯ̟ᵝ
まね	m a̠ n e̞
まねき	m a̠ n e̞ kʲ i
まねく	m a̠ n e̞ k ɯ̟ᵝ
まねごと	m a̠ n e̞ ɡ o̞ t o̞
まふゆ	m a̠ ɸ ɯ̟ᵝ j ɯ̟ᵝ
まぶしい	m a̠ b ɯ̟ᵝ ɕ i i
まぶた	m a̠ b ɯ̟ᵝ t a̠
まめまわし	m a̠ m e̞ m a̠ ɰᵝ a̠ ɕ i
まもり	m a̠ m o̞ ɾʲ i
まよなか	m a̠ j o̞ n a̠ k a̠
まら	m a r a
まるい	m a̠ ɾ ɯ̟ᵝ i
まるかじり	m a̠ ɾ ɯ̟ᵝ k a̠ ʑ i ɾʲ i
まわり	k a̠ i
まわりみち	m a̠ ɰᵝ a̠ ɾʲ i mʲ i t͡ɕ i
まんえい	m ã̠ ɰ̃ e̞ː
まんがじ	m ã̠ ŋ ɡ a̠ ʑ i
まんげつ	m ã̠ ŋ ɡ e̞ t͡s ɨᵝ
まんざい	m ã̠ n d͡z a̠ i
まんざら	m ã̠ n d͡z a̠ ɾ a̠
まんしゅうご	m ã̠ ɰ̃ ɕ ɨᵝː ɡ o̞
まんしん	m ã̠ ɰ̃ ɕ ĩ ɴ
まんじゅしゃげ	m ã̠ ɲ̟ d͡ʑ ɨᵝ ɕ a̠ ɡ e̞
まんまえ	m ã̠ mː a̠ e̞
まんよう	m ã̠ ɰ̃ j o̞ː
みいら	mʲ iː ɾ a̠
みうける	mʲ i ɯ̟ᵝ k e̞ ɾ ɯ̟ᵝ
みおくる	mʲ i o̞ k ɯ̟ᵝ ɾ ɯ̟ᵝ
みおさめ	mʲ i o̞ s a̠ m e̞
みおつくし	mʲ i o̞ t͡s ɨᵝ k ɯ̟ᵝ ɕ i
みおろす	mʲ i o̞ ɾ o̞ s ɨᵝ
みかん	mʲ i k ã̠ ɴ
みがら	mʲ i ɡ a̠ ɾ a̠
みきこ	mʲ i kʲ i k o̞
みきわめる	mʲ i kʲ i ɰᵝ a̠ m e̞ ɾ ɯ̟ᵝ
みぎ	mʲ i ɡʲ i
みぎがわ	mʲ i ɡʲ i ɡ a̠ ɰᵝ a̠
みくだりはん	mʲ i k ɯ̟ᵝ d a̠ ɾʲ i h ã̠ ɴ
みさこ	mʲ i s a̠ k o̞
みじかい	mʲ i ʑ i k a̠ i
みずから	mʲ i z ɨᵝ k a̠ ɾ a̠
みずがね	mʲ i z ɨᵝ ɡ a̠ n e̞
みずすまし	mʲ i z ɨᵝ s ɨᵝ m a̠ ɕ i
みせ	mʲ i s e̞
みせかける	mʲ i s e̞ k a̠ k e̞ ɾ ɯ̟ᵝ
みそち	mʲ i s o̞ t͡ɕ i
みちすじ	mʲ i t͡ɕ i s ɨᵝ ʑ i
みちたか	mʲ i t͡ɕ i t a̠ k a̠
みちたりる	mʲ i t͡ɕ i t a̠ ɾʲ i ɾ ɯ̟ᵝ
みちのり	mʲ i t͡ɕ i n o̞ ɾʲ i
みっかん	mʲ i k̚ k ã̠ ɴ
みっちゃく	mʲ i t̚ t͡ɕ a̠ k ɯ̟ᵝ
みっつう	mʲ i t̚ t͡s ɨᵝː
みつくりざめ	mʲ i t͡s ɨ̥ᵝ k ɯ̟ᵝ ɾʲ i z a̠ m e̞
みつばち	mʲ i t͡s ɨᵝ b a̠ t͡ɕ i
みつめる	mʲ i t͡s ɨᵝ m e̞ ɾ ɯ̟ᵝ
みつもり	mʲ i t͡s ɨᵝ m o̞ ɾʲ i
みと	mʲ i t o̞
みとめる	mʲ i t o̞ m e̞ ɾ ɯ̟ᵝ
みなごろし	mʲ i n a̠ ɡ o̞ ɾ o̞ ɕ i
みなす	mʲ i n a̠ s ɨᵝ
みなづき	mʲ i n a̠ z ɨᵝ kʲ i
みなみ	mʲ i n a̠ mʲ i
みなみかいきせん	mʲ i n a̠ mʲ i k a̠ i kʲ i̥ s ẽ̞ ɴ
みなもと	mʲ i n a̠ m o̞ t o̞
みまちがえる	mʲ i m a̠ t͡ɕ i ɡ a̠ e̞ ɾ ɯ̟ᵝ
みまん	mʲ i m ã̠ ɴ
みみ	mʲ i mʲ i
みみかざり	mʲ i mʲ i k a̠ z a̠ ɾʲ i
みみなり	mʲ i mʲ i n a̠ ɾʲ i
みゃく	mʲ a̠ k ɯ̟ᵝ
みゃくらく	mʲ a̠ k ɯ̟ᵝ ɾ a̠ k ɯ̟ᵝ
みや	mʲ i j a̠
みやぎ	mʲ i j a̠ ɡʲ i
みやぎけん	mʲ i j a̠ ɡʲ i k ẽ̞ ɴ
みやこおち	mʲ i j a̠ k o̞ o̞ t͡ɕ i
みやこのじょう	mʲ i j a̠ k o̞ n o̞ ʑ o̞ː
みやざき	mʲ i j a̠ z a̠ kʲ i
みやの	mʲ i j a̠ n o̞
みやびやか	mʲ i j a̠ bʲ i j a̠ k a̠
みやぶる	mʲ i j a̠ b ɯ̟ᵝ ɾ ɯ̟ᵝ
みょうおう	mʲ o̞ː o̞ː
みよ	mʲ i j o̞
みりょくてき	mʲ i ɾʲ o̞ k ɯ̟ᵝ t e̞ kʲ i
みれん	mʲ i ɾ ẽ̞ ɴ
みんしゅく	mʲ ĩ ɰ̃ ɕ ɨᵝ k ɯ̟ᵝ
みんしゅしゅぎしゃ	mʲ ĩ ɰ̃ ɕ ɨᵝ ɕ ɨᵝ ɡʲ i ɕ a̠
みんぞくがく	mʲ ĩ n d͡z o̞ k ɯ̟ᵝ ɡ a̠ k ɯ̟ᵝ
みんぺい	mʲ ĩ m p e̞ː
むいちもん	m ɯ̟ᵝ i t͡ɕ i m õ̞ ɴ
むかい	m ɯ̟ᵝ k a̠ i
むかえる	m ɯ̟ᵝ k a̠ e̞ ɾ ɯ̟ᵝ
むかし	m ɯ̟ᵝ k a̠ ɕ i
むかんどう	m ɯ̟ᵝ k ã̠ n d o̞ː
むが	m ɯ̟ᵝ ɡ a̠
むきかごうぶつ	m ɯ̟̊ᵝ kʲ i k a̠ ɡ o̞ː b ɯ̟ᵝ t͡s ɨᵝ
むぎ	m ɯ̟ᵝ ɡʲ i
むぎょう	m ɯ̟ᵝ ɡʲ o̞ː
むげんしょう	m ɯ̟ᵝ ɡ ẽ̞ ɰ̃ ɕ o̞ː
むげんだい	m ɯ̟ᵝ ɡ ẽ̞ n d a̠ i
むこくせき	m ɯ̟ᵝ k o̞ k ɯ̟ᵝ s e̞ kʲ i
むごん	m ɯ̟ᵝ ɡ õ̞ ɴ
むさいしょく	m ɯ̟ᵝ s a̠ i ɕ o̞ k ɯ̟ᵝ
むさぼりくう	m ɯ̟ᵝ s a̠ b o̞ ɾʲ i k ɯ̟ᵝː
むさぼる	m ɯ̟ᵝ s a̠ b o̞ ɾ ɯ̟ᵝ
むし	m ɯ̟ᵝ ɕ i
むしめがね	m ɯ̟ᵝ ɕ i m e̞ ɡ a̠ n e̞
むしんけい	m ɯ̟ᵝ ɕ ĩ ŋ k e̞ː
むじゅうりょく	m ɯ̟ᵝ ʑ ɨᵝː ɾʲ o̞ k ɯ̟ᵝ
むじゅん	m ɯ̟ᵝ ʑ ɨ̃ᵝ ɴ
むじょう	m ɯ̟ᵝ ʑ o̞ː
むすびつき	m ɯ̟ᵝ s ɨᵝ bʲ i t͡s ɨᵝ kʲ i
むだ	m ɯ̟ᵝ d a̠
むっくり	m ɯ̟ᵝ k̚ k ɯ̟ᵝ ɾʲ i
むつう	m ɯ̟ᵝ t͡s ɨᵝː
むとう	m ɯ̟ᵝ t o̞ː
むな	m ɯ̟ᵝ n a̠
むなげ	m ɯ̟ᵝ n a̠ ɡ e̞
むね	m ɯ̟ᵝ n e̞
むねあて	m ɯ̟ᵝ n e̞ a̠ t e̞
むひょうじょう	m ɯ̟ᵝ ç o̞ː ʑ o̞ː
むら	m ɯ̟ᵝ ɾ a̠
むらさきずいしょう	m ɯ̟ᵝ ɾ a̠ s a̠ kʲ i z ɨᵝ i ɕ o̞ː
むらまつ	m ɯ̟ᵝ ɾ a̠ m a̠ t͡s ɨᵝ
むらむら	m ɯ̟ᵝ ɾ a̠ m ɯ̟ᵝ ɾ a̠
むろん	m ɯ̟ᵝ ɾ õ̞ ɴ
めいかい	m e̞ː k a̠ i
めいさん	m e̞ː s ã̠ ɴ
めいそう	m e̞ː s o̞ː
めいり	m e̞ː ɾʲ i
めいりょう	m e̞ː ɾʲ o̞ː
めいろ	m e̞ː ɾ o̞
めがねざる	m e̞ ɡ a̠ n e̞ z a̠ ɾ ɯ̟ᵝ
めがねっこ	m e̞ ɡ a̠ n e̞ k̚ k o̞
めざめる	m e̞ z a̠ m e̞ ɾ ɯ̟ᵝ
めしべ	m e̞ ɕ i b e̞
めじるし	m e̞ ʑ i ɾ ɯ̟ᵝ ɕ i
めす	m e̞ s ɨᵝ
めず	m e̞ z ɨᵝ
めだつ	m e̞ d a̠ t͡s ɨᵝ
めっき	m e̞ k̚ʲ kʲ i
めった	m e̞ t̚ t a̠
めはな	m e̞ h a̠ n a̠
めめしい	m e̞ m e̞ ɕ iː
めやに	m e̞ j a̠ ɲ̟ i
めんたい	m ẽ̞ n t a̠ i
めんたいこ	m ẽ̞ n t a̠ i k o̞
もうける	m o̞ː k e̞ ɾ ɯ̟ᵝ
もうさいかん	m o̞ː s a̠ i k ã̠ ɴ
もうしこみ	m o̞ː ɕ i k o̞ mʲ i
もうしゃ	m o̞ː ɕ a̠
もうしょ	m o̞ː ɕ o̞
もうす	m o̞ː s ɨᵝ
もうちょう	m o̞ː t͡ɕ o̞ː
もうふぶき	m o̞ː ɸ ɯ̟ᵝ b ɯ̟ᵝ kʲ i
もうもく	m o̞ː m o̞ k ɯ̟ᵝ
もえそで	m o̞ e̞ s o̞ d e̞
もえぶた	m o̞ e̞ b ɯ̟ᵝ t a̠
もおんな	m o̞ õ̞ nː a̠
もがく	m o̞ ɡ a̠ k ɯ̟ᵝ
もくば	m o̞ k ɯ̟ᵝ b a̠
もぐ	m o̞ ɡ ɯ̟ᵝ
もさく	m o̞ s a̠ k ɯ̟ᵝ
もし	m o̞ ɕ i
もしも	m o̞ ɕ i m o̞
もじばけ	m o̞ ʑ i b a̠ k e̞
もぞう	m o̞ z o̞ː
もたらす	m o̞ t a̠ ɾ a̠ s ɨᵝ
もちあげる	m o̞ t͡ɕ i a̠ ɡ e̞ ɾ ɯ̟ᵝ
もちいる	m o̞ t͡ɕ iː ɾ ɯ̟ᵝ
もちきたる	m o̞ t͡ɕ i kʲ i t a̠ ɾ ɯ̟ᵝ
もちぬし	m o̞ t͡ɕ i n ɯ̟ᵝ ɕ i
もっとも	m o̞ t̚ t o̞ m o̞
もてあそぶ	m o̞ t e̞ a̠ s o̞ b ɯ̟ᵝ
ものごい	m o̞ n o̞ ɡ o̞ i
ものみだかい	m o̞ n o̞ mʲ i d a̠ k a̠ i
ものもち	m o̞ n o̞ m o̞ t͡ɕ i
もみじ	m o̞ mʲ i ʑ i
ももか	m o̞ m o̞ k a̠
もやす	m o̞ j a̠ s ɨᵝ
もりひろ	m o̞ ɾʲ i ç i ɾ o̞
もろこし	m o̞ ɾ o̞ k o̞ ɕ i
もんじ	m õ̞ ɲ̟ d͡ʑ i
もんと	m õ̞ n t o̞
やあ	j a̠ː
やえば	j a̠ e̞ b a̠
やお	j a̠ o̞
やかい	j a̠ k a̠ i
やきぶた	j a̠ kʲ i b ɯ̟ᵝ t a̠
やく	j a̠ k ɯ̟ᵝ
やくすう	j a̠ k ɯ̟̊ᵝ s ɨᵝː
やくにん	j a̠ k ɯ̟ᵝ ɲ̟ ĩ ɴ
やくりがく	j a̠ k ɯ̟ᵝ ɾʲ i ɡ a̠ k ɯ̟ᵝ
やける	j a̠ k e̞ ɾ ɯ̟ᵝ
やしがに	j a̠ ɕ i ɡ a̠ ɲ̟ i
やすっぽい	j a̠ s ɨᵝ p̚ p o̞ i
やすなが	j a̠ s ɨᵝ n a̠ ɡ a̠
やすみ	j a̠ s ɨᵝ mʲ i
やすもの	j a̠ s ɨᵝ m o̞ n o̞
やせおとこ	j a̠ s e̞ o̞ t o̞ k o̞
やせん	j a̠ s ẽ̞ ɴ
やそきょう	j a̠ s o̞ kʲ o̞ː
やたがらす	j a̠ t a̠ ɡ a̠ ɾ a̠ s ɨᵝ
やだ	j a̠ d a̠
やつあたり	j a̠ t͡s ɨᵝ a̠ t a̠ ɾʲ i
やつめうなぎ	j a̠ t͡s ɨᵝ m e̞ ɯ̟ᵝ n a̠ ɡʲ i
やつら	j a̠ t͡s ɨᵝ ɾ a̠
やといぬし	j a̠ t o̞ i n ɯ̟ᵝ ɕ i
やどかり	j a̠ d o̞ k a̠ ɾʲ i
やどりぎ	j a̠ d o̞ ɾʲ i ɡʲ i
やに	j a̠ ɲ̟ i
やのあさって	j a̠ n o̞ a̠ s a̠ t̚ t e̞
やまあるき	j a̠ m a̠ a̠ ɾ ɯ̟ᵝ kʲ i
やまい	j a̠ m a̠ i
やまいも	j a̠ m a̠ i m o̞
やまうば	j a̠ m a̠ ɯ̟ᵝ b a̠
やまかじ	j a̠ m a̠ k a̠ ʑ i
やまがた	j a̠ m a̠ ɡ a̠ t a̠
やまじ	j a̠ m a̠ ʑ i
やますいぎゅう	j a̠ m a̠ s ɨᵝ i ɡʲ ɨᵝː
やまたかぼうし	j a̠ m a̠ t a̠ k a̠ b o̞ː ɕ i
やまとぐち	j a̠ m a̠ t o̞ ɡ ɯ̟ᵝ t͡ɕ i
やまふだ	j a̠ m a̠ ɸ ɯ̟ᵝ d a̠
やまほど	j a̠ m a̠ h o̞ d o̞
やみよ	j a̠ mʲ i j o̞
やむ	j a̠ m ɯ̟ᵝ
ややこしい	j a̠ j a̠ k o̞ ɕ iː
やよう	j a̠ j o̞ː
やらい	j a̠ ɾ a̠ i
やりとおす	j a̠ ɾʲ i t o̞ː s ɨᵝ
やりとげる	j a̠ ɾʲ i t o̞ ɡ e̞ ɾ ɯ̟ᵝ
やんま	j ã̠ mː a̠
ゆいのう	j ɯ̟ᵝ i n o̞ː
ゆう	j ɯ̟ᵝː
ゆういぎ	j ɯ̟ᵝː i ɡʲ i
ゆうえつかん	j ɯ̟ᵝː e̞ t͡s ɨ̥ᵝ k ã̠ ɴ
ゆうきゅうきゅうか	j ɯ̟ᵝː kʲ ɨᵝː kʲ ɨᵝː k a̠
ゆうし	j ɯ̟ᵝː ɕ i
ゆうしゅう	j ɯ̟ᵝː ɕ ɨᵝː
ゆうじ	j ɯ̟ᵝː ʑ i
ゆうじょ	j ɯ̟ᵝː ʑ o̞
ゆうそくよみ	j ɯ̟ᵝː s o̞ k ɯ̟ᵝ j o̞ mʲ i
ゆうのう	j ɯ̟ᵝː n o̞ː
ゆうびんきょく	j ɯ̟ᵝː bʲ ĩ ŋʲ kʲ o̞ k ɯ̟ᵝ
ゆうぼくみん	j ɯ̟ᵝː b o̞ k ɯ̟ᵝ mʲ ĩ ɴ
ゆうゆう	j ɯ̟ᵝː j ɯ̟ᵝː
ゆうり	j ɯ̟ᵝː ɾʲ i
ゆうれいやしき	j ɯ̟ᵝː ɾ e̞ː j a̠ ɕ i̥ kʲ i
ゆかいはん	j ɯ̟ᵝ k a̠ i h ã̠ ɴ
ゆかた	j ɯ̟ᵝ k a̠ t a̠
ゆが	j ɯ̟ᵝ ɡ a̠
ゆきづまり	j ɯ̟ᵝ kʲ i z ɨᵝ m a̠ ɾʲ i
ゆきとし	j ɯ̟ᵝ kʲ i t o̞ ɕ i
ゆきひょう	j ɯ̟ᵝ kʲ i̥ ç o̞ː
ゆず	j ɯ̟ᵝ z ɨᵝ
ゆずる	j ɯ̟ᵝ z ɨᵝ ɾ ɯ̟ᵝ
ゆだん	j ɯ̟ᵝ d ã̠ ɴ
ゆっくり	j ɯ̟ᵝ k̚ k ɯ̟ᵝ ɾʲ i
ゆでん	j ɯ̟ᵝ d ẽ̞ ɴ
ゆとう	j ɯ̟ᵝ t o̞ː
ゆびぬき	j ɯ̟ᵝ bʲ i n ɯ̟ᵝ kʲ i
ゆびわ	j ɯ̟ᵝ bʲ i ɰᵝ a̠
ゆめがたり	j ɯ̟ᵝ m e̞ ɡ a̠ t a̠ ɾʲ i
ゆめみる	j ɯ̟ᵝ m e̞ mʲ i ɾ ɯ̟ᵝ
ゆらぐ	j ɯ̟ᵝ ɾ a̠ ɡ ɯ̟ᵝ
ゆらす	j ɯ̟ᵝ ɾ a̠ s ɨᵝ
ゆりいす	j ɯ̟ᵝ ɾʲ i i s ɨᵝ
ゆる	j ɯ̟ᵝ ɾ ɯ̟ᵝ
ゆるやか	j ɯ̟ᵝ ɾ ɯ̟ᵝ j a̠ k a̠
よい	j o̞ i
よいっぱり	j o̞ i p̚ p a̠ ɾʲ i
ようえん	j o̞ː ẽ̞ ɴ
ようきょく	j o̞ː kʲ o̞ k ɯ̟ᵝ
ようきん	j o̞ː kʲ ĩ ɴ
ようぎん	j o̞ː ɡʲ ĩ ɴ
ようけん	j o̞ː k ẽ̞ ɴ
ようこそ	j o̞ː k o̞ s o̞
ようご	j o̞ː ɡ o̞
ようさん	j o̞ː s ã̠ ɴ
ようし	j o̞ː ɕ i
ようしょ	j o̞ː ɕ o̞
ようすい	j oː s u i
ようずみ	j o̞ː z ɨᵝ mʲ i
ようせい	j o̞ː s e̞ː
ようせき	j o̞ː s e̞ kʲ i
ようそ	j o̞ː s o̞
ようそう	j o̞ː s o̞ː
ようそん	j o̞ː s õ̞ ɴ
ようふう	j o̞ː ɸ ɯ̟ᵝː
ようよう	j o̞ː j o̞ː
ようりょく	j o̞ː ɾʲ o̞ k ɯ̟ᵝ
よかく	k o̞ k a̠ k ɯ̟ᵝ
よく	j o̞ k ɯ̟ᵝ
よくばる	j o̞ k ɯ̟ᵝ b a̠ ɾ ɯ̟ᵝ
よこく	j o̞ k o̞ k ɯ̟ᵝ
よこはま	j o̞ k o̞ h a̠ m a̠
よこぶえ	j o̞ k o̞ b ɯ̟ᵝ e̞
よご	j o̞ ɡ o̞
よごす	j o̞ ɡ o̞ s ɨᵝ
よしお	j o̞ ɕ i o̞
よしとも	j o̞ ɕ i t o̞ m o̞
よじょうはん	j o̞ ʑ o̞ː h ã̠ ɴ
よすが	j o̞ s ɨᵝ ɡ a̠
よせい	j o̞ s e̞ː
よそく	j o̞ s o̞ k ɯ̟ᵝ
よたか	j o̞ t a̠ k a̠
よっぱらう	j o̞ p̚ p a̠ ɾ a̠ ɯ̟ᵝ
よとう	j o t oː
よばい	j o̞ b a̠ i
よばわり	j o̞ b a̠ ɰᵝ a̠ ɾʲ i
よふね	j o̞ ɸ ɯ̟ᵝ n e̞
よぶ	j o̞ b ɯ̟ᵝ
よみかける	j o̞ mʲ i k a̠ k e̞ ɾ ɯ̟ᵝ
よみきる	j o̞ mʲ i kʲ i ɾ ɯ̟ᵝ
よみくだす	j o̞ mʲ i k ɯ̟ᵝ d a̠ s ɨᵝ
よみじ	j o̞ mʲ i ʑ i
よめ	j o̞ m e̞
よろいぐさ	j o̞ ɾ o̞ i ɡ ɯ̟ᵝ s a̠
よろける	j o̞ ɾ o̞ k e̞ ɾ ɯ̟ᵝ
よわまる	j o̞ ɰᵝ a̠ m a̠ ɾ ɯ̟ᵝ
よわる	j o̞ ɰᵝ a̠ ɾ ɯ̟ᵝ
よんじゅういち	j õ̞ ɲ̟ d͡ʑ ɨᵝː i t͡ɕ i
らい	ɾ a̠ i
らいじょう	ɾ a̠ i ʑ o̞ː
らいじんちょう	ɾ a̠ i ʑ ĩ ɲ̟ t͡ɕ o̞ː
らいてん	ɾ a̠ i t ẽ̞ ɴ
らく	ɾ a̠ k ɯ̟ᵝ
らくえつ	ɾ a̠ k ɯ̟ᵝ e̞ t͡s ɨᵝ
らくせん	ɾ a̠ k ɯ̟ᵝ s ẽ̞ ɴ
らくだ	ɾ a̠ k ɯ̟ᵝ d a̠
らくだい	ɾ a̠ k ɯ̟ᵝ d a̠ i
らくてん	ɾ a̠ k ɯ̟ᵝ t ẽ̞ ɴ
らしんばん	ɾ a̠ ɕ ĩ m b ã̠ ɴ
らせつ	ɾ a̠ s e̞ t͡s ɨᵝ
らち	ɾ a̠ t͡ɕ i
らっかさん	ɾ a̠ k̚ k a̠ s ã̠ ɴ
らっかせい	ɾ a̠ k̚ k a̠ s e̞ː
らっかりゅうすい	ɾ a̠ k̚ k a̠ ɾʲ ɨᵝː s ɨᵝ i
らっこ	ɾ a̠ k̚ k o̞
らっぱすいせん	ɾ a̠ p̚ p a̠ z ɨᵝ i s ẽ̞ ɴ
らんかく	ɾ ã̠ ŋ k a̠ k ɯ̟ᵝ
らんさいぼう	ɾ ã̠ ɰ̃ s a̠ i b o̞ː
らんしゃ	ɾ ã̠ ɰ̃ ɕ a̠
らんそうがん	ɾ ã̠ ɰ̃ s o̞ː ɡ ã̠ ɴ
らんぱつ	ɾ ã̠ m p a̠ t͡s ɨᵝ
りかん	ɾʲ i k ã̠ ɴ
りがく	ɾʲ i ɡ a̠ k ɯ̟ᵝ
りき	ɾʲ i kʲ i
りきがく	ɾʲ i kʲ i ɡ a̠ k ɯ̟ᵝ
りくぐん	ɾʲ i k ɯ̟ᵝ ɡ ɯ̟̃ᵝ ɴ
りくじょう	ɾʲ i k ɯ̟ᵝ ʑ o̞ː
りけい	ɾʲ i k e̞ː
りさい	ɾʲ i s a̠ i
りしょく	ɾʲ i ɕ o̞ k ɯ̟ᵝ
りそうぞう	ɾʲ i s o̞ː z o̞ː
りっきゃくてん	ɾʲ i k̚ʲ kʲ a̠ k ɯ̟ᵝ t ẽ̞ ɴ
りっぽうこん	ɾʲ i p̚ p o̞ː k õ̞ ɴ
りっぽうしゃ	ɾʲ i p̚ p o̞ː ɕ a̠
りと	ɾʲ i t o̞
りめん	ɾʲ i m ẽ̞ ɴ
りゃくご	ɾʲ a̠ k ɯ̟ᵝ ɡ o̞
りゃくす	ɾʲ a̠ k ɯ̟ᵝ s ɨᵝ
りゅうがくせい	ɾʲ ɨᵝː ɡ a̠ k ɯ̟ᵝ s e̞ː
りゅうさん	ɾʲ ɨᵝː s ã̠ ɴ
りゅうしゃ	ɾʲ ɨᵝː ɕ a̠
りゅうせいぐん	ɾʲ ɨᵝː s e̞ː ɡ ɯ̟̃ᵝ ɴ
りゅうせんけい	ɾʲ ɨᵝː s ẽ̞ ŋ k e̞ː
りゅうぜんこう	ɾʲ ɨᵝː z ẽ̞ ŋ k o̞ː
りゅうたろう	ɾʲ ɨᵝː t a̠ ɾ o̞ː
りゅうちょう	ɾʲ ɨᵝː t͡ɕ o̞ː
りゅうどう	ɾʲ ɨᵝː d o̞ː
りゆう	ɾʲ i j ɯ̟ᵝː
りょうきんじょ	ɾʲ o̞ː kʲ ĩ ɲ̟ d͡ʑ o̞
りょうげんのひ	ɾʲ o̞ː ɡ ẽ̞ nː o̞ ç i
りょうしつ	ɾʲ o̞ː ɕ i t͡s ɨᵝ
りょうじ	ɾʲ o̞ː ʑ i
りょかくき	ɾʲ o̞ k a̠ k ɯ̟̊ᵝ kʲ i
りょくしょく	ɾʲ o̞ k ɯ̟̊ᵝ ɕ o̞ k ɯ̟ᵝ
りょくせんこう	ɾʲ o̞ k ɯ̟ᵝ s ẽ̞ ŋ k o̞ː
りょこうしゃ	ɾʲ o̞ k o̞ː ɕ a̠
りろ	ɾʲ i ɾ o̞
りん	ɾʲ ĩ ɴ
りんかい	ɾʲ ĩ ŋ k a̠ i
りんかく	ɾʲ ĩ ŋ k a̠ k ɯ̟ᵝ
りんさんひりょう	ɾʲ ĩ ɰ̃ s ã̠ ɰ̃ ç i ɾʲ o̞ː
れいきゅうしゃ	ɾ e̞ː kʲ ɨᵝː ɕ a̠
れいぎょ	ɾ e̞ː ɡʲ o̞
れいしょく	ɾ e̞ː ɕ o̞ k ɯ̟ᵝ
れいすい	ɾ e̞ː s ɨᵝ i
れいせい	ɾ e̞ː s e̞ː
れいぞう	ɾ e̞ː z o̞ː
れいちょう	ɾ e̞ː t͡ɕ o̞ː
れいはい	ɾ e̞ː h a̠ i
れいびょう	ɾ e̞ː bʲ o̞ː
れっせき	ɾ e̞ sː e̞ kʲ i
れつあく	ɾ e̞ t͡s ɨᵝ a̠ k ɯ̟ᵝ
れんが	ɾ ẽ̞ ŋ ɡ a̠
れんきゅう	ɾ ẽ̞ ŋʲ kʲ ɨᵝː
れんごう	ɾ ẽ̞ ŋ ɡ o̞ː
れんさ	ɾ ẽ̞ ɰ̃ s a̠
れんしゅう	ɾ ẽ̞ ɰ̃ ɕ ɨᵝː
れんしゅうきょく	ɾ ẽ̞ ɰ̃ ɕ ɨᵝː kʲ o̞ k ɯ̟ᵝ
れんじつれんや	ɾ ẽ̞ ɲ̟ d͡ʑ i t͡s ɨᵝ ɾ ẽ̞ ɰ̃ j a̠
れんせんれんばい	ɾ ẽ̞ ɰ̃ s ẽ̞ n ɾ ẽ̞ m b a̠ i
れんたいかく	ɾ ẽ̞ n t a̠ i k a̠ k ɯ̟ᵝ
れんぽう	ɾ ẽ̞ m p o̞ː
ろうあ	ɾ o̞ː a̠
ろうし	ɾ o̞ː ɕ i
ろうしゃ	ɾ o̞ː ɕ a̠
ろうじん	ɾ o̞ː ʑ ĩ ɴ
ろうはいぶつ	ɾ o̞ː h a̠ i b ɯ̟ᵝ t͡s ɨᵝ
ろうばい	ɾ o̞ː b a̠ i
ろうほう	ɾ o̞ː h o̞ː
ろくぶんぎ	ɾ o̞ k ɯ̟ᵝ b ɯ̟̃ᵝ ŋʲ ɡʲ i
ろくめんたい	ɾ o̞ k ɯ̟ᵝ m ẽ̞ n t a̠ i
ろしゅつけい	ɾ o̞ ɕ ɨᵝ t͡s ɨᵝ k e̞ː
ろしん	ɾ o̞ ɕ ĩ ɴ
ろてんぶろ	ɾ o̞ t ẽ̞ m b ɯ̟ᵝ ɾ o̞
ろばん	ɾ o̞ b ã̠ ɴ
ろんずる	ɾ õ̞ n d͡z ɨᵝ ɾ ɯ̟ᵝ
ろんそう	ɾ õ̞ ɰ̃ s o̞ː
ろんばく	ɾ õ̞ m b a̠ k ɯ̟ᵝ
ろんりがく	ɾ õ̞ n ɾʲ i ɡ a̠ k ɯ̟ᵝ
わいろ	ɰᵝ a̠ i ɾ o̞
わかす	ɰᵝ a̠ k a̠ s ɨᵝ
わがし	ɰᵝ a̠ ɡ a̠ ɕ i
わきあいあい	ɰᵝ a̠ kʲ i a̠ i a̠ i
わきざし	ɰᵝ a̠ kʲ i z a̠ ɕ i
わごん	ɰᵝ a̠ ɡ õ̞ ɴ
わさんぼん	ɰᵝ a̠ s ã̠ m b õ̞ ɴ
わし	ɰᵝ a̠ ɕ i
わしづかみ	ɰᵝ a̠ ɕ i z ɨᵝ k a̠ mʲ i
わじん	ɰᵝ a̠ ʑ ĩ ɴ
わすれなぐさ	ɰᵝ a̠ s ɨᵝ ɾ e̞ n a̠ ɡ ɯ̟ᵝ s a̠
わすれる	ɰᵝ a̠ s ɨᵝ ɾ e̞ ɾ ɯ̟ᵝ
わそう	ɰᵝ a̠ s o̞ː
わた	ɰᵝ a̠ t a̠
わたがし	ɰᵝ a̠ t a̠ ɡ a̠ ɕ i
わたくし	ɰᵝ a̠ t a̠ k ɯ̟̊ᵝ ɕ i
わたくしする	ɰᵝ a̠ t a̠ k ɯ̟ᵝ ɕ i s ɨᵝ ɾ ɯ̟ᵝ
わたくしども	ɰᵝ a̠ t a̠ k ɯ̟̊ᵝ ɕ i d o̞ m o̞
わたぐも	ɰᵝ a̠ t a̠ ɡ ɯ̟ᵝ m o̞
わたげ	ɰᵝ a̠ t a̠ ɡ e̞
わたりどり	ɰᵝ a̠ t a̠ ɾʲ i d o̞ ɾʲ i
わぬ	ɰᵝ a̠ n ɯ̟ᵝ
わめく	ɰᵝ a̠ m e̞ k ɯ̟ᵝ
わら	ɰᵝ a̠ ɾ a̠
わらい	ɰᵝ a̠ ɾ a̠ i
わらう	ɰᵝ a̠ ɾ a̠ ɯ̟ᵝ
わらぶき	ɰᵝ a̠ ɾ a̠ b ɯ̟ᵝ kʲ i
わらべ	ɰᵝ a̠ ɾ a̠ b e̞
わり	k a̠ t͡s ɨᵝ
わりちゅう	ɰᵝ a̠ ɾʲ i t͡ɕ ɨᵝː
わる	ɰᵝ a̠ ɾ ɯ̟ᵝ
わんさ	ɰᵝ ã̠ ɰ̃ s a̠
をことてん	o̞ k o̞ t o̞ t ẽ̞ ɴ
ゔぇ	b e̞
