가감	k a̠ ɡ a̠ m
가강수량	k a̠ ɡ a̠ ŋ sʰ u ɾ j a̠ ŋ
가게	k a̠ː ɡ e̞
가계	k a̠ ɡ j e̞
가공	k a̠ ɡ o̞ ŋ
가관	k a̠ː ɡ w a̠ n
가구	k a̠ ɡ u
가까이	k a̠ k͈ a̠ i
가깝다	k a̠ k͈ a̠ p̚ t͈ a̠
가끔씩	k a̠ k͈ ɯ m ɕ͈ i k̚
가나	k a̠ n a̠
가난	k a̠ n a̠ n
가난하다	k a̠ n a̠ n ɦ a̠ d a̠
가능	k a̠ː n ɯ ŋ
가능하다	k a̠ː n ɯ ŋ ɦ a̠ d a̠
가드	k a̠ d ɯ
가득하다	k a̠ d ɯ kʰ a̠ d a̠
가락	k a̠ ɾ a̠ k̚
가랑비	k a̠ ɾ a̠ ŋ b i
가렵다	k a̠ ɾ j ʌ̹ p̚ t͈ a̠
가로	k a̠ ɾ o̞
가로등	k a̠ ɾ o̞ d ɯ ŋ
가르침	k a̠ ɾ ɯ t͡ɕʰ i m
가만히	k a̠ m a̠ n ʝ i
가면	k a̠ː m j ʌ̹ n
가뭄	k a̠ m u m
가브리엘	k a̠ b ɯ ɾ i e̞ ɭ
가사	k a̠ sʰ a̠
가산	k a̠ sʰ a̠ n
가수	k a̠ sʰ u
가스	k͈ a̠ sʰ ɯ
가슴	k a̠ sʰ ɯ m
가야	k a̠ j a̠
가요	k a̠ j o
가위	k a̠ ɥ i
가을	k a̠ ɯ ɭ
가이드	k a̠ i d ɯ
가자	k a̠ d͡ʑ a̠
가정부	k a̠ d͡ʑ ʌ̹ ŋ b u
가족	k a̠ d͡ʑ o̞ k̚
가지고	k a̠ d͡ʑ i ɡ o̞
가지다	k a̠ d͡ʑ i d a̠
가짜	k a̠ː t͡ɕ͈ a̠
가치	k a̠ t͡ɕʰ i
가치관	k a̠ t͡ɕʰ i ɡ w a̠ n
가톨릭	k a̠ tʰ o̞ ɭ ʎ i k̚
가히	k a̠ː ʝ i
각각	k a̠ k̚ k͈ a̠ k̚
각국	k a̠ k̚ k͈ u k̚
각기	k a̠ k̚ k͈ i
각도	k a̠ k̚ t͈ o̞
각본	k a̠ k̚ p͈ o̞ n
각자	k a̠ k̚ t͡ɕ͈ a̠
각종	k a̠ k̚ t͡ɕ͈ o̞ ŋ
간단히	k a̠ n d a̠ n ʝ i
간사	k a̠ n sʰ a̠
간섭	k a̠ n sʰ ʌ̹ p̚
간접	k a̠ n d͡ʑ ʌ̹ p̚
간주	k a̠ n d͡ʑ u
간첩	k a̠ː n t͡ɕʰ ʌ̹ p̚
간판	k a̠ n pʰ a̠ n
간호사	k a̠ n β o̞ sʰ a̠
갈고	k a̠ ɭ ɡ o̞
갈등	k a̠ ɭ t͈ ɯ ŋ
갈매기	k a̠ ɭ m e̞ ɡ i
갈비	k a̠ ɭ b i
갈비뼈	k a̠ ɭ b i p͈ j ʌ̹
갈수록	k a̠ ɭ s͈ u ɾ o̞ k̚
갈증	k a̠ ɭ t͡ɕ͈ ɯ ŋ
감각	k a̠ː m ɡ a̠ k̚
감기	k a̠ː m ɡ i
감독	k a̠ m d o̞ k̚
감사	k a̠ː m sʰ a̠
감사하다	k a̠ː m sʰ a̠ ɦ a̠ d a̠
감상	k a̠ m sʰ a̠ ŋ
감소	k a̠ː m sʰ o̞
감시	k a̠ m ɕʰ i
감염	k a̠ː m j ʌ̹ m
감옥	k a̠ m o̞ k̚
감정	k a̠ː m d͡ʑ ʌ̹ ŋ
감히	k a̠ː m ʝ i
갑작스레	k a̠ p̚ t͡ɕ͈ a̠ k s͈ ɯ ɾ e̞
갑판	k a̠ p̚ pʰ a̠ n
강간	k a̠ː ŋ ɡ a̠ n
강당	k a̠ː ŋ d a̠ ŋ
강도	k a̠ː ŋ d o̞
강사	k a̠ː ŋ sʰ a̠
강세	k a̠ ŋ sʰ e̞
강아지	k a̠ ŋ a̠ d͡ʑ i
강원도	k a̠ ŋ w ʌ̹ n d o̞
강의	k a̠ː ŋ ɰ i
강정	k a̠ ŋ d͡ʑ ʌ̹ ŋ
강제	k a̠ː ŋ d͡ʑ e̞
강하다	k a̠ ŋ ɦ a̠ d a̠
강화도	k a̠ ŋ β w a̠ d o̞
갖가지	k a̠ t̚ k͈ a̠ d͡ʑ i
갖다	k a̠ t̚ t͈ a̠
같다	k a̠ t̚ t͈ a̠
같은	k a̠ tʰ ɯ n
같이	k a̠ t͡ɕʰ i
개량	k e̞ː ɾ j a̠ ŋ
개리	k e̞ ɾ i
개미	k e̞ː m i
개발	k e̞ b a̠ ɭ
개발자	k e̞ b a̠ ɭ d͡ʑ a̠
개선	k e̞ː sʰ ʌ̹ n
개시	k e̞ ɕʰ i
개인	k e̞ː i n
개인적	k e̞ː i n d͡ʑ ʌ̹ k̚
개정	k e̞ː d͡ʑ ʌ̹ ŋ
개천	k e̞ː t͡ɕʰ ʌ̹ n
개체	k e̞ː t͡ɕʰ e̞
객관적	k e̞ k̚ k͈ w a̠ n d͡ʑ ʌ̹ k̚
객실	k e̞ k ɕ͈ i ɭ
객차	k e̞ k̚ t͡ɕʰ a̠
거기	k ʌ̹ ɡ i
거듭	k ʌ̹ d ɯ p̚
거래	k ɘː ɾ e̞
거실	k ʌ̹ ɕʰ i ɭ
거울	k ʌ̹ u ɭ
거의	k ʌ̹ ɰ i
거인	k ɘː i n
거주	k ʌ̹ d͡ʑ u
거짓	k ɘː d͡ʑ i t̚
거짓말	k ɘː d͡ʑ i n m a̠ ɭ
거짓말쟁이	k ɘː d͡ʑ i n m a̠ ɭ d͡ʑ e̞ ŋ i
거품	k ʌ̹ pʰ u m
걱정	k ʌ̹ k̚ t͡ɕ͈ ʌ̹ ŋ
건너다	k ɘː n n ʌ̹ d a̠
건너편	k ɘː n n ʌ̹ pʰ j ʌ̹ n
건물	k ɘː n m u ɭ
건설	k ɘː n sʰ ʌ̹ ɭ
건의	k ɘː n ɰ i
건조	k ʌ̹ n d͡ʑ o̞
건축	k ɘː n t͡ɕʰ u k̚
걷기	k ɘː t̚ k͈ i
걸다	k ɘː ɭ d a̠
걸어	k ʌ̹ ɾ ʌ̹
걸음	k ʌ̹ ɾ ɯ m
걸음마	k ʌ̹ ɾ ɯ m m a̠
걸작	k ʌ̹ ɭ t͡ɕ͈ a̠ k̚
검사	k ɘː m sʰ a̠
검색	k ɘː m sʰ e̞ k̚
검열	k ɘː m ɲ j ʌ̹ ɭ
검정	k ʌ̹ m d͡ʑ ʌ̹ ŋ
검정색	k ʌ̹ m d͡ʑ ʌ̹ ŋ sʰ e̞ k̚
검증	k ɘː m d͡ʑ ɯ ŋ
검찰청	k ɘː m t͡ɕʰ a̠ ɭ t͡ɕʰ ʌ̹ ŋ
검토	k ɘː m tʰ o̞
겁대가리	k ʌ̹ p̚ t͈ e̞ ɡ a̠ ɾ i
게다가	k e̞ d a̠ ɡ a̠
게릴라	k e̞ ɾ i ɭ ɭ a̠
게시판	k e̞ː ɕʰ i pʰ a̠ n
게이	k e̞ i
게이트	k e̞ i tʰ ɯ
게임	k͈ e̞ i m
겨우	k j ʌ̹ u
겨울	k j ʌ̹ u ɭ
견해	k j ɘː n ɦ e̞
결과	k j ʌ̹ ɭ ɡ w a̠
결과적	k j ʌ̹ ɭ ɡ w a̠ d͡ʑ ʌ̹ k̚
결심	k j ʌ̹ ɭ ɕ͈ i m
결장	k j ʌ̹ ɭ t͡ɕ͈ a̠ ŋ
결정	k j ʌ̹ ɭ t͡ɕ͈ ʌ̹ ŋ
결합	k j ʌ̹ ɾ ɦ a̠ p̚
결핵	k j ʌ̹ ɾ ɦ e̞ k̚
결혼	k j ʌ̹ ɾ β o̞ n
결혼식	k j ʌ̹ ɾ β o̞ n ɕʰ i k̚
경고	k j ɘː ŋ ɡ o̞
경관	k j ʌ̹ ŋ ɡ w a̠ n
경기도	k j ʌ̹ ŋ ɡ i d o̞
경마	k j ɘː ŋ m a̠
경매	k j ɘː ŋ m e̞
경비원	k j ɘː ŋ b i w ʌ̹ n
경상남도	k j ɘː ŋ sʰ a̠ ŋ n a̠ m d o̞
경상도	k j ʌ̹ ŋ sʰ a̠ ŋ d o̞
경상북도	k j ɘː ŋ sʰ a̠ ŋ b u k̚ t͈ o̞
경성	k j ʌ̹ ŋ sʰ ʌ̹ ŋ
경시	k j ʌ̹ ŋ ɕʰ i
경쟁	k j ɘː ŋ d͡ʑ e̞ ŋ
경쟁력	k j ɘː ŋ d͡ʑ e̞ ŋ ɲ j ʌ̹ k̚
경제	k j ʌ̹ ŋ d͡ʑ e̞
경제적	k j ʌ̹ ŋ d͡ʑ e̞ d͡ʑ ʌ̹ k̚
경제학	k j ʌ̹ ŋ d͡ʑ e̞ ɦ a̠ k̚
경찰	k j ɘː ŋ t͡ɕʰ a̠ ɭ
경찰관	k j ɘː ŋ t͡ɕʰ a̠ ɭ ɡ w a̠ n
경찰서	k j ɘː ŋ t͡ɕʰ a̠ ɭ s͈ ʌ̹
경향	k j ʌ̹ ŋ ʝ j a̠ ŋ
경험	k j ʌ̹ ŋ ɦ ʌ̹ m
계곡	k j e̞ ɡ o̞ k̚
계단	k j e̞ d a̠ n
계란	k j e̞ ɾ a̠ n
계산	k j e̞ː sʰ a̠ n
계속	k j e̞ː sʰ o̞ k̚
계속하다	k j e̞ː sʰ o̞ kʰ a̠ d a̠
계승	k j e̞ sʰ ɯ ŋ
계약	k j e̞ j a̠ k̚
계열	k j e̞ j ʌ̹ ɭ
계절	k j e̞ː d͡ʑ ʌ̹ ɭ
계층	k j e̞ t͡ɕʰ ɯ ŋ
고객	k o̞ ɡ e̞ k̚
고구려	k o̞ ɡ u ɾ j ʌ̹
고구마	k o̞ː ɡ u m a̠
고급	k o̞ ɡ ɯ p̚
고난	k o̞ n a̠ n
고대	k o̞ː d e̞
고등어	k o̞ d ɯ ŋ ʌ̹
고래	k o̞ ɾ e̞
고려	k o̞ ɾ j ʌ̹
고려말	k o̞ ɾ j ʌ̹ m a̠ ɭ
고맙다	k o̞ː m a̠ p̚ t͈ a̠
고맙습니다	k o̞ m a̠ p s͈ ɯ m n i d a̠
고모	k o̞ m o̞
고무	k o̞ m u
고문	k o̞ m u n
고생	k o̞ sʰ e̞ ŋ
고생하다	k o̞ sʰ e̞ ŋ ɦ a̠ d a̠
고소하다	k o̞ː sʰ o̞ ɦ a̠ d a̠
고속	k o̞ sʰ o̞ k̚
고슴도치	k o̞ sʰ ɯ m d o̞ t͡ɕʰ i
고시	k o̞ː ɕʰ i
고양이	k o̞ j a̠ ŋ i
고유	k o̞ j u
고전	k o̞ː d͡ʑ ʌ̹ n
고정	k o̞ d͡ʑ ʌ̹ ŋ
고조	k o̞ d͡ʑ o̞
고조선	k o̞ d͡ʑ o̞ sʰ ʌ̹ n
고지	k o̞ d͡ʑ i
고체	k o̞ t͡ɕʰ e̞
고추	k o̞ t͡ɕʰ u
고치다	k o̞ t͡ɕʰ i d a̠
고통	k o̞ tʰ o̞ ŋ
고해	k o̞ː ɦ e̞
고향	k o̞ ʝ j a̠ ŋ
고혈압	k o̞ ʝ j ʌ̹ ɾ a̠ p̚
곤란하다	k o̞ː ɭ ɭ a̠ n ɦ a̠ d a̠
곤충	k o̞ n t͡ɕʰ u ŋ
곧바로	k o̞ t̚ p͈ a̠ ɾ o̞
곧장	k o̞ t̚ t͡ɕ͈ a̠ ŋ
골목	k o̞ː ɭ m o̞ k̚
골반	k o̞ ɭ b a̠ n
골키퍼	k͈ o̞ ɭ k ç i pʰ ʌ̹
골프	k͈ o̞ ɭ pʰ ɯ
곰팡이	k o̞ m pʰ a̠ ŋ i
공개	k o̞ ŋ ɡ e̞
공격	k o̞ː ŋ ɡ j ʌ̹ k̚
공공	k o̞ ŋ ɡ o̞ ŋ
공구	k o̞ ŋ ɡ u
공군	k o̞ ŋ ɡ u n
공급	k o̞ː ŋ ɡ ɯ p̚
공동	k o̞ː ŋ d o̞ ŋ
공룡	k o̞ː ŋ ɲ j o ŋ
공모	k o̞ː ŋ m o̞
공무원	k o̞ ŋ m u w ʌ̹ n
공부자	k o̞ː ŋ b u d͡ʑ a̠
공사	k o̞ ŋ sʰ a̠
공산당	k o̞ ŋ sʰ a̠ n d a̠ ŋ
공산주의	k o̞ː ŋ sʰ a̠ n d͡ʑ u ɰ i
공식	k o̞ ŋ ɕʰ i k̚
공인	k o̞ ŋ i n
공작	k o̞ː ŋ d͡ʑ a̠ k̚
공장	k o̞ ŋ d͡ʑ a̠ ŋ
공정	k o̞ ŋ d͡ʑ ʌ̹ ŋ
공정하다	k o̞ ŋ d͡ʑ ʌ̹ ŋ ɦ a̠ d a̠
공주	k o̞ ŋ d͡ʑ u
공직자	k o̞ ŋ d͡ʑ i k̚ t͡ɕ͈ a̠
공짜	k o̞ ŋ t͡ɕ͈ a̠
공책	k o̞ ŋ t͡ɕʰ e̞ k̚
공통	k o̞ː ŋ tʰ o̞ ŋ
공통점	k o̞ː ŋ tʰ o̞ ŋ t͡ɕ͈ ʌ̹ m
공포	k o̞ː ŋ pʰ o̞
공항	k o̞ ŋ ɦ a̠ ŋ
공해	k o̞ ŋ ɦ e̞
공화국	k o̞ː ŋ β w a̠ ɡ u k̚
공황	k o̞ː ŋ β w a̠ ŋ
과로	k w a̠ ɾ o̞
과목	k w a̠ m o̞ k̚
과연	k w a̠ː j ʌ̹ n
과자	k w a̠ː d͡ʑ a̠
과장	k w a̠ d͡ʑ a̠ ŋ
과정	k w a̠ː d͡ʑ ʌ̹ ŋ
과제	k w a̠ d͡ʑ e̞
과태료	k w a̠ː tʰ e̞ ɾ j o
과테말라	k w a̠ tʰ e̞ m a̠ ɭ ɭ a̠
과학	k w a̠ ɦ a̠ k̚
과학적	k w a̠ ɦ a̠ k̚ t͡ɕ͈ ʌ̹ k̚
관객	k w a̠ n ɡ e̞ k̚
관계	k w a̠ n ɡ j e̞
관계없이	k w a̠ n ɡ j e̞ ʌ̹ p ɕ͈ i
관계자	k w a̠ n ɡ j e̞ d͡ʑ a̠
관광	k w a̠ n ɡ w a̠ ŋ
관광객	k w a̠ n ɡ w a̠ ŋ ɡ e̞ k̚
관련	k w a̠ ɭ ʎ j ʌ̹ n
관련성	k w a̠ ɭ ʎ j ʌ̹ n s͈ ʌ̹ ŋ
관리	k w a̠ ɭ ʎ i
관문	k w a̠ n m u n
관세	k w a̠ n sʰ e̞
관절	k w a̠ n d͡ʑ ʌ̹ ɭ
관절염	k w a̠ n d͡ʑ ʌ̹ ɾ j ʌ̹ m
관점	k w a̠ n t͡ɕ͈ ʌ̹ m
관찰	k w a̠ n t͡ɕʰ a̠ ɭ
관할	k w a̠ n ɦ a̠ ɭ
광견병	k w a̠ ŋ ɡ j ʌ̹ n p͈ j ʌ̹ ŋ
광고	k w a̠ː ŋ ɡ o̞
광대	k w a̠ː ŋ d e̞
광대뼈	k w a̠ː ŋ d e̞ p͈ j ʌ̹
광둥	k w a̠ ŋ d u ŋ
광물	k w a̠ː ŋ m u ɭ
광부	k w a̠ ŋ b u
광역시	k w a̠ː ŋ j ʌ̹ k ɕ͈ i
광장	k w a̠ː ŋ d͡ʑ a̠ ŋ
괜찮다	k w e̞ n t͡ɕʰ a̠ n tʰ a̠
괴물	k w e̞ː m u ɭ
교각	k j o ɡ a̠ k̚
교과서	k j oː k͈ w a̠ sʰ ʌ̹
교대	k j o d e̞
교도소	k j oː d o̞ sʰ o̞
교량	k j o ɾ j a̠ ŋ
교류	k j o ɾ j u
교사	k j oː sʰ a̠
교섭	k j o sʰ ʌ̹ p̚
교실	k j oː ɕʰ i ɭ
교양	k j o j a̠ ŋ
교외	k j oː w e̞
교원	k j o w ʌ̹ n
교육	k j oː j u k̚
교육학	k j oː j u kʰ a̠ k̚
교재	k j oː d͡ʑ e̞
교전	k j o d͡ʑ ʌ̹ n
교정	k j o d͡ʑ ʌ̹ ŋ
교차로	k j o t͡ɕʰ a̠ ɾ o̞
교체	k j o t͡ɕʰ e̞
교통	k j o tʰ o̞ ŋ
교통사고	k j o tʰ o̞ ŋ sʰ a̠ ɡ o̞
교포	k j o pʰ o̞
교향곡	k j o ʝ j a̠ ŋ ɡ o̞ k̚
교환	k j o β w a̠ n
교황	k j oː β w a̠ ŋ
구강	k u ɡ a̠ ŋ
구경	k uː ɡ j ʌ̹ ŋ
구글	k u ɡ ɯ ɭ
구더기	k u d ʌ̹ ɡ i
구두쇠	k u d u sʰ w e̞
구름	k u ɾ ɯ m
구매	k u m e̞
구멍	k u m ʌ̹ ŋ
구별	k u b j ʌ̹ ɭ
구분	k u b u n
구상	k u sʰ a̠ ŋ
구석	k u sʰ ʌ̹ k̚
구성	k u sʰ ʌ̹ ŋ
구성원	k u sʰ ʌ̹ ŋ w ʌ̹ n
구속	k u sʰ o̞ k̚
구역	k u j ʌ̹ k̚
구입	k u i p̚
구조	k u d͡ʑ o̞
구체적	k u t͡ɕʰ e̞ d͡ʑ ʌ̹ k̚
구치소	k u t͡ɕʰ i sʰ o̞
국가	k u k̚ k͈ a̠
국고	k u k̚ k͈ o̞
국립	k u ŋ n i p̚
국면	k u ŋ m j ʌ̹ n
국물	k u ŋ m u ɭ
국민	k u ŋ m i n
국어	k u ɡ ʌ̹
국왕	k u ɡ w a̠ ŋ
국장	k u k̚ t͡ɕ͈ a̠ ŋ
국적	k u k̚ t͡ɕ͈ ʌ̹ k̚
국제	k u k̚ t͡ɕ͈ e̞
국토	k u k̚ tʰ o̞
국화	k u kʰ w a̠
국회의원	k u kʰ w e̞ ɰ i w ʌ̹ n
군단	k u n d a̠ n
군대	k u n d e̞
군도	k u n d o̞
군복	k u n b o̞ k̚
군사	k u n sʰ a̠
군인	k u n i n
굳이	k u d͡ʑ i
굴뚝	k uː ɭ t͈ u k̚
굴비	k u ɭ b i
굵다	k uː k̚ t͈ a̠
궁극적	k u ŋ ɡ ɯ k̚ t͡ɕ͈ ʌ̹ k̚
궁금하다	k u ŋ ɡ ɯ m ɦ a̠ d a̠
궁전	k u ŋ d͡ʑ ʌ̹ n
권고	k w ɘː n ɡ o̞
권고하다	k w ɘː n ɡ o̞ ɦ a̠ d a̠
권당	k w ʌ̹ n d a̠ ŋ
권력	k w ɘː ɭ ʎ j ʌ̹ k̚
권리	k w ʌ̹ ɭ ʎ i
권위주의	k w ʌ̹ n ɥ i d͡ʑ u ɰ i
권총	k w ɘː n t͡ɕʰ o̞ ŋ
권투	k w ʌ̹ n tʰ u
귀국	k ɥ iː ɡ u k̚
귀신	k ɥ iː ɕʰ i n
귀하다	k ɥ iː ɦ a̠ d a̠
귓불	k ɥ i t̚ p͈ u ɭ
규모	k j u m o̞
규범	k j u b ʌ̹ m
규정	k j u d͡ʑ ʌ̹ ŋ
규칙	k j u t͡ɕʰ i k̚
균형	k j u n ʝ j ʌ̹ ŋ
그게	k ɯ ɡ e̞
그곳	k ɯ ɡ o̞ t̚
그나마	k ɯ n a̠ m a̠
그녀	k ɯ ɲ j ʌ̹
그늘	k ɯ n ɯ ɭ
그다지	k ɯ d a̠ d͡ʑ i
그동안	k ɯ d o̞ ŋ a̠ n
그들	k ɯ d ɯ ɭ
그때	k ɯ t͈ e̞
그래	k ɯ ɾ e̞
그래도	k ɯ ɾ e̞ d o̞
그래서	k ɯ ɾ e̞ sʰ ʌ̹
그래픽	k ɯ ɾ e̞ pʰ i k̚
그러나	k ɯ ɾ ʌ̹ n a̠
그러니까	k ɯ ɾ ʌ̹ n i k͈ a̠
그러다	k ɯ ɾ ʌ̹ d a̠
그러므로	k ɯ ɾ ʌ̹ m ɯ ɾ o̞
그런데	k ɯ ɾ ʌ̹ n d e̞
그럼	k ɯ ɾ ʌ̹ m
그렇게	k ɯ ɾ ʌ̹ kʰ e̞
그렇다	k ɯ ɾ ʌ̹ tʰ a̠
그렇지	k ɯ ɾ ʌ̹ t͡ɕʰ i
그렇지만	k ɯ ɾ ʌ̹ t͡ɕʰ i m a̠ n
그루지야	k ɯ ɾ u d͡ʑ i j a̠
그룹	k ɯ ɾ u p̚
그리	k ɯ ɾ i
그리고	k ɯ ɾ i ɡ o̞
그리스	k ɯ ɾ i sʰ ɯ
그리스어	k ɯ ɾ i sʰ ɯ ʌ̹
그릴	k ɯ ɾ i ɭ
그림자	k ɯː ɾ i m d͡ʑ a̠
그만	k ɯ m a̠ n
그만큼	k ɯ m a̠ n k x ɯ m
그분	k ɯ b u n
그야말로	k ɯ j a̠ m a̠ ɭ ɭ o̞
그저	k ɯ d͡ʑ ʌ̹
그제	k ɯ d͡ʑ e̞
그중	k ɯ d͡ʑ u ŋ
그쪽	k ɯ t͡ɕ͈ o̞ k̚
그토록	k ɯ tʰ o̞ ɾ o̞ k̚
극단주의	k ɯ k̚ t͈ a̠ n d͡ʑ u ɰ i
극동	k ɯ k̚ t͈ o̞ ŋ
극작가	k ɯ k̚ t͡ɕ͈ a̠ k̚ k͈ a̠
극장	k ɯ k̚ t͡ɕ͈ a̠ ŋ
근거	k ɯ n ɡ ʌ̹
근래	k ɯː ɭ ɭ e̞
근로	k ɯː ɭ ɭ o̞
근로자	k ɯ ɭ ɭ o̞ d͡ʑ a̠
근무	k ɯː n m u
근무하다	k ɯː n m u ɦ a̠ d a̠
근본	k ɯ n b o̞ n
근본적	k ɯ n b o̞ n d͡ʑ ʌ̹ k̚
근육	k ɯ ɲ j u k̚
근접	k ɯː n d͡ʑ ʌ̹ p̚
글쓰기	k ɯ ɭ s͈ ɯ ɡ i
글씨	k ɯ ɭ ɕ͈ i
글자	k ɯ ɭ t͡ɕ͈ a̠
금고	k ɯ m ɡ o̞
금년	k ɯ m ɲ j ʌ̹ n
금방	k ɯ m b a̠ ŋ
금세	k ɯ m sʰ e̞
금속	k ɯ m sʰ o̞ k̚
금액	k ɯ m e̞ k̚
금연	k ɯː m j ʌ̹ n
금요일	k ɯ m j o i ɭ
금욕	k ɯː m j o k̚
금일	k ɯ m i ɭ
금전	k ɯ m d͡ʑ ʌ̹ n
금주	k ɯ m d ʑ u
금지	k ɯː m d͡ʑ i
급기야	k ɯ p̚ k͈ i j a̠
급여	k ɯ b j ʌ̹
급하다	k ɯ pʰ a̠ d a̠
기간	k i ɡ a̠ n
기계	k i ɡ j e̞
기관	k i ɡ w a̠ n
기구	k i ɡ u
기기	k i ɡ i
기꺼이	k i k͈ ʌ̹ i
기능	k i n ɯ ŋ
기다리다	k i d a̠ ɾ i d a̠
기대	k i d e̞
기대다	k iː d e̞ d a̠
기독	k i d o̞ k̚
기독교	k i d o̞ k̚ k͈ j o
기둥	k i d u ŋ
기러기	k i ɾ ʌ̹ ɡ i
기록	k i ɾ o̞ k̚
기름	k i ɾ ɯ m
기린	k i ɾ i n
기물	k i m u ɭ
기법	k i p͈ ʌ̹ p̚
기본	k i b o̞ n
기본적	k i b o̞ n d͡ʑ ʌ̹ k̚
기부	k i b u
기분	k i b u n
기쁘다	k i p͈ ɯ d a̠
기쁨	k i p͈ ɯ m
기생충	k i sʰ e̞ ŋ t͡ɕʰ u ŋ
기술	k i sʰ u ɭ
기술자	k i sʰ u ɭ t͡ɕ͈ a̠
기아	k i a̠
기억	k i ʌ̹ k̚
기억력	k i ʌ̹ ŋ ɲ j ʌ̹ k̚
기업	k i ʌ̹ p̚
기업가	k i ʌ̹ p̚ k͈ a̠
기업인	k i ʌ̹ b i n
기온	k i o̞ n
기운	k i u n
기울이다	k i u ɾ i d a̠
기원전	k i w ʌ̹ n d͡ʑ ʌ̹ n
기자	k i d͡ʑ a̠
기지	k i d͡ʑ i
기차	k i t͡ɕʰ a̠
기초	k i t͡ɕʰ o̞
기타	k i tʰ a̠
기호	k i β o̞
기회	k i β w e̞
기획	k i β w e̞ k̚
기후	k i β u
긴급	k i n ɡ ɯ p̚
긴장	k i n d͡ʑ a̠ ŋ
길다	k iː ɭ d a̠
김밥	k iː m p͈ a̠ p̚
김치	k i m t͡ɕʰ i
깃발	k i t̚ p͈ a̠ ɭ
깃털	k i t̚ tʰ ʌ̹ ɭ
깊다	k i p̚ t͈ a̠
깊이	k i pʰ i
까다롭다	k͈ a̠ː d a̠ ɾ o̞ p̚ t͈ a̠
까닭	k͈ a̠ d a̠ k̚
깜짝	k͈ a̠ m t͡ɕ͈ a̠ k̚
깡통	k͈ a̠ ŋ tʰ o̞ ŋ
깡패	k͈ a̠ ŋ pʰ e̞
깨끗한	k͈ e̞ k͈ ɯ tʰ a̠ n
껍질	k͈ ʌ̹ p̚ t͡ɕ͈ i ɭ
꼬리	k͈ o̞ ɾ i
꼬마	k͈ o̞ m a̠
꽃가루	k͈ o̞ t̚ k͈ a̠ ɾ u
꽃미남	k͈ o̞ n m i n a̠ m
꽃집	k͈ o̞ t̚ t͡ɕ͈ i p̚
꾸다	k͈ u d a̠
꾸준히	k͈ u d͡ʑ u n ʝ i
꿋꿋하다	k͈ u t̚ k͈ u tʰ a̠ d a̠
끊임없이	k͈ ɯ n i m ʌ̹ p ɕ͈ i
끝내	k͈ ɯ n n e̞
끼니	k͈ i n i
나누다	n a̠ n u d a̠
나라	n a̠ ɾ a̠
나란히	n a̠ ɾ a̠ n ʝ i
나름	n a̠ ɾ ɯ m
나리	n a̠ ɾ i
나물	n a̠ m u ɭ
나비	n a̠ b i
나쁘다	n a̠ p͈ ɯ d a̠
나선	n a̠ sʰ ʌ̹ n
나소	n a̠ sʰ o̞
나오다	n a̠ o̞ d a̠
나이트	n a̠ i tʰ ɯ
나중	n a̠ː d͡ʑ u ŋ
나치	n a̠ t͡ɕʰ i
나흘	n a̠ ɣ ɯ ɭ
낙타	n a̠ k̚ tʰ a̠
낙태	n a̠ k̚ tʰ e̞
낙하산	n a̠ kʰ a̠ sʰ a̠ n
난민	n a̠ n m i n
날개	n a̠ ɭ ɡ e̞
남극	n a̠ m ɡ ɯ k̚
남녀	n a̠ m ɲ j ʌ̹
남녀노소	n a̠ m ɲ j ʌ̹ n o̞ sʰ o̞
남동생	n a̠ m d o̞ ŋ sʰ e̞ ŋ
남미	n a̠ m m i
남방	n a̠ m b a̠ ŋ
남부	n a̠ m b u
남서부	n a̠ m sʰ ʌ̹ b u
남성	n a̠ m sʰ ʌ̹ ŋ
남아프리카	n a̠ m a̠ pʰ ɯ ɾ i kʰ a̠
남용	n a̠ː m j o ŋ
남장	n a̠ m d͡ʑ a̠ ŋ
남조선	n a̠ m d͡ʑ o̞ sʰ ʌ̹ n
남쪽	n a̠ m t͡ɕ͈ o̞ k̚
남포	n a̠ m pʰ o̞
남학생	n a̠ m ɦ a̠ k s͈ e̞ ŋ
남한	n a̠ m ɦ a̠ n
남해	n a̠ m ɦ e̞
납치	n a̠ p̚ t͡ɕʰ i
낫다	n a̠ː t̚ t͈ a̠
낭비	n a̠ː ŋ b i
낮다	n a̠ t̚ t͈ a̠
내내	n e̞ː n e̞
내년	n e̞ ɲ j ʌ̹ n
내다	n e̞ː d a̠
내려가다	n e̞ ɾ j ʌ̹ ɡ a̠ d a̠
내부	n e̞ː b u
내심	n e̞ː ɕʰ i m
내일	n e̞ i ɭ
내장	n e̞ d͡ʑ a̠ ŋ
내주	n e̞ d͡ʑ u
냄비	n e̞ m b i
냄새	n e̞ː m sʰ e̞
냉면	n e̞ː ŋ m j ʌ̹ n
냉장고	n e̞ː ŋ d͡ʑ a̠ ŋ ɡ o̞
냉전	n e̞ ŋ d͡ʑ ʌ̹ n
너무	n ʌ̹ m u
너무나	n ʌ̹ m u n a̠
널뛰기	n ʌ̹ ɭ t͈ ɥ i ɡ i
널리	n ʌ̹ ɭ ʎ i
넓다	n ʌ̹ ɭ t͈ a̠
네다섯	n e̞ː d a̠ sʰ ʌ̹ t̚
네트워크	n e̞ tʰ ɯ w ʌ̹ k x ɯ
네티즌	n e̞ tʰ i d͡ʑ ɯ n
넥타이	n e̞ k̚ tʰ a̠ i
녀석	ɲ j ʌ̹ sʰ ʌ̹ k̚
노동	n o̞ d o̞ ŋ
노동자	n o̞ d o̞ ŋ d͡ʑ a̠
노랑	n o̞ ɾ a̠ ŋ
노래	n o̞ ɾ e̞
노래방	n o̞ ɾ e̞ b a̠ ŋ
노력	n o̞ ɾ j ʌ̹ k̚
노르웨이	n o̞ ɾ ɯ w e̞ i
노선	n o̞ sʰ ʌ̹ n
노예	n o̞ j e̞
노처녀	n o̞ː t͡ɕʰ ʌ̹ ɲ j ʌ̹
노출	n o̞ t͡ɕʰ u ɭ
노트	n o̞ tʰ ɯ
노트북	n o̞ tʰ ɯ b u k̚
노화	n o̞ β w a̠
녹말	n o̞ ŋ m a̠ ɭ
녹음	n o̞ ɡ ɯ m
녹음기	n o̞ ɡ ɯ m ɡ i
녹차	n o̞ k̚ t͡ɕʰ a̠
논리	n o̞ ɭ ʎ i
논문	n o̞ n m u n
논평	n o̞ n pʰ j ʌ̹ ŋ
놀랍다	n o̞ː ɭ ɭ a̠ p̚ t͈ a̠
놀이	n o̞ ɾ i
놀이공원	n o̞ ɾ i ɡ o̞ ŋ w ʌ̹ n
농구	n o̞ ŋ ɡ u
농민	n o̞ ŋ m i n
농부	n o̞ ŋ b u
농산물	n o̞ ŋ sʰ a̠ n m u ɭ
농어	n o̞ ŋ ʌ̹
농업	n o̞ ŋ ʌ̹ p̚
농장	n o̞ ŋ d͡ʑ a̠ ŋ
농촌	n o̞ ŋ t͡ɕʰ o̞ n
높다	n o̞ p̚ t͈ a̠
높이	n o̞ pʰ i
뇌관	n w e̞ ɡ w a̠ n
뇌물	n w e̞ m u ɭ
누구	n u ɡ u
누군가	n u ɡ u n ɡ a̠
누나	n uː n a̠
누이	n u i
눈길	n u n k͈ i ɭ
눈꺼풀	n u n k͈ ʌ̹ pʰ u ɭ
눈물	n u n m u ɭ
눈빛	n u n p͈ i t̚
눈치	n u n t͡ɕʰ i
뉴델리	ɲ j u d e̞ ɭ ʎ i
뉴질랜드	ɲ j u d͡ʑ i ɭ ɭ e̞ n d ɯ
느낌	n ɯ k͈ i m
느낌표	n ɯ k͈ i m pʰ j o
느리다	n ɯ ɾ i d a̠
늑대인간	n ɯ k̚ t͈ e̞ i n ɡ a̠ n
는다	n ɯ n d a̠
늘어서다	n ɯ ɾ ʌ̹ sʰ ʌ̹ d a̠
능력	n ɯ ŋ ɲ j ʌ̹ k̚
능률	n ɯ ŋ ɲ j u ɭ
니카라과	n i kʰ a̠ ɾ a̠ ɡ w a̠
니호늄	n i β o̞ ɲ j u m
닉네임	n i ŋ n e̞ i m
다다미	t a̠ d a̠ m i
다들	t a̠ d ɯ ɭ
다롄	t a̠ ɾ j e̞ n
다른	t a̠ ɾ ɯ n
다름없다	t a̠ ɾ ɯ m ʌ̹ p̚ t͈ a̠
다리	t a̠ ɾ i
다만	t a̠ː m a̠ n
다발	t a̠ b a̠ ɭ
다섯	t a̠ sʰ ʌ̹ t̚
다섯째	t a̠ sʰ ʌ̹ t̚ t͡ɕ͈ e̞
다소	t a̠ sʰ o̞
다수	t a̠ sʰ u
다스	t a̠ sʰ ɯ
다시	t a̠ ɕʰ i
다양하다	t a̠ j a̠ ŋ ɦ a̠ d a̠
다운로드	t a̠ u n n o̞ d ɯ
다음	t a̠ ɯ m
다이아몬드	t a̠ i a̠ m o̞ n d ɯ
다이어트	t a̠ i ʌ̹ tʰ ɯ
다짐	t a̠ d͡ʑ i m
다큐멘터리	t a̠ k ç j u m e̞ n tʰ ʌ̹ ɾ i
다툼	t a̠ tʰ u m
단계	t a̠ n ɡ j e̞
단백질	t a̠ː n b e̞ k̚ t͡ɕ͈ i ɭ
단수	t a̠ n sʰ u
단순	t a̠ n sʰ u n
단순히	t a̠ n sʰ u n ʝ i
단어	t a̠ n ʌ̹
단위	t a̠ n ɥ i
단일	t a̠ n i ɭ
단지	t a̠ n d͡ʑ i
단천	t a̠ n t͡ɕʰ ʌ̹ n
단체	t a̠ n t͡ɕʰ e̞
단풍	t a̠ n pʰ u ŋ
단풍나무	t a̠ n pʰ u ŋ n a̠ m u
달러	t a̠ ɭ ɭ ʌ̹
달력	t a̠ ɭ ʎ j ʌ̹ k̚
달리	t a̠ ɭ ʎ i
달콤하다	t a̠ ɭ kʰ o̞ m ɦ a̠ d a̠
담당	t a̠ m d a̠ ŋ
담배	t a̠ː m b e̞
담임	t a̠ m i m
답답하다	t a̠ p̚ t͈ a̠ pʰ a̠ d a̠
답장	t a̠ p̚ t͡ɕ͈ a̠ ŋ
닷새	t a̠ t̚ s͈ e̞
당뇨병	t a̠ ŋ ɲ j o p͈ j ʌ̹ ŋ
당당하다	t a̠ ŋ d a̠ ŋ ɦ a̠ d a̠
당대	t a̠ ŋ d e̞
당시	t a̠ ŋ ɕʰ i
당신	t a̠ ŋ ɕʰ i n
당연	t a̠ ŋ j ʌ̹ n
당연히	t a̠ ŋ j ʌ̹ n ʝ i
당장	t a̠ ŋ d͡ʑ a̠ ŋ
대가	t e̞ː ɡ a̠
대개	t e̞ː ɡ e̞
대관령	t e̞ː ɡ w a̠ ɭ ʎ j ʌ̹ ŋ
대국	t e̞ː ɡ u k̚
대규모	t e̞ː ɡ j u m o̞
대기	t e̞ː ɡ i
대기업	t e̞ː ɡ i ʌ̹ p̚
대나무	t e̞ n a̠ m u
대다수	t e̞ː d a̠ sʰ u
대단하다	t e̞ː d a̠ n ɦ a̠ d a̠
대두	t e̞ d u
대략	t e̞ː ɾ j a̠ k̚
대량	t e̞ː ɾ j a̠ ŋ
대로	t e̞ ɾ o̞
대륙	t e̞ː ɾ j u k̚
대리인	t e̞ː ɾ i i n
대리점	t e̞ː ɾ i d͡ʑ ʌ̹ m
대만	t e̞ m a̠ n
대명사	t e̞ m j ʌ̹ ŋ sʰ a̠
대박	t e̞ː b a̠ k̚
대변	t e̞ː b j ʌ̹ n
대부분	t e̞ː b u b u n
대북	t e̞ b u k̚
대사	t e̞ː sʰ a̠
대사관	t e̞ː sʰ a̠ ɡ w a̠ n
대상	t e̞ sʰ a̠ ŋ
대상자	t e̞ sʰ a̠ ŋ d͡ʑ a̠
대서양	t e̞ː sʰ ʌ̹ j a̠ ŋ
대신	t e̞ː ɕʰ i n
대우	t e̞ u
대응	t e̞ː ɯ ŋ
대중	t e̞ː d͡ʑ u ŋ
대중문화	t e̞ː d͡ʑ u ŋ m u n β w a̠
대지	t e̞ː d͡ʑ i
대체로	t e̞ː t͡ɕʰ e̞ ɾ o̞
대출	t e̞ː t͡ɕʰ u ɭ
대충	t e̞ː t͡ɕʰ u ŋ
대통령	t e̞ː tʰ o̞ ŋ ɲ j ʌ̹ ŋ
대포	t e̞ː pʰ o̞
대표	t e̞ː pʰ j o
대표단	t e̞ː pʰ j o d a̠ n
대표적	t e̞ː pʰ j o d͡ʑ ʌ̹ k̚
대학	t e̞ː ɦ a̠ k̚
대학생	t e̞ː ɦ a̠ k s͈ e̞ ŋ
대학수학능력시험	t e̞ː ɦ a̠ k s͈ u ɦ a̠ ŋ n ɯ ŋ ɲ j ʌ̹ k ɕ͈ i ɦ ʌ̹ m
대학원	t e̞ː ɦ a̠ ɡ w ʌ̹ n
대한민국	t e̞ː ɦ a̠ n m i n ɡ u k̚
대한제국	t e̞ː ɦ a̠ n d͡ʑ e̞ ɡ u k̚
대합실	t e̞ː ɦ a̠ p ɕ͈ i ɭ
대회	t e̞ː β w e̞
댈러스	t e̞ ɭ ɭ ʌ̹ sʰ ɯ
댓글	t e̞ t̚ k͈ ɯ ɭ
더구나	t ʌ̹ ɡ u n a̠
더불어	t ʌ̹ b u ɾ ʌ̹
더욱	t ʌ̹ u k̚
더욱이	t ʌ̹ u ɡ i
더위	t ʌ̹ ɥ i
덕분	t ʌ̹ k̚ p͈ u n
덥다	t ɘː p̚ t͈ a̠
덧셈	t ʌ̹ t̚ s͈ e̞ m
덩어리	t ʌ̹ ŋ ʌ̹ ɾ i
덮개	t ʌ̹ p̚ k͈ e̞
데리다	t e̞ ɾ i d a̠
데뷔	t e̞ b ɥ i
데이터	t e̞ i tʰ ʌ̹
데이트	t e̞ i tʰ ɯ
덴마크	t e̞ n m a̠ k x ɯ
도기	t o̞ ɡ i
도대체	t o̞ d e̞ t͡ɕʰ e̞
도둑	t o̞ d u k̚
도마뱀	t o̞ m a̠ b e̞ m
도박	t o̞ b a̠ k̚
도움	t o̞ u m
도입	t o̞ː i p̚
도자기	t o̞ d͡ʑ a̠ ɡ i
도작	t o̞ d͡ʑ a̠ k̚
도장	t o̞ d͡ʑ a̠ ŋ
도저히	t o̞ː d͡ʑ ʌ̹ ʝ i
도쿄	t o̞ k ç j o
도토리	t o̞ tʰ o̞ ɾ i
독도	t o̞ k̚ t͈ o̞
독살	t o̞ k s͈ a̠ ɭ
독서	t o̞ k s͈ ʌ̹
독소	t o̞ k s͈ o̞
독일	t o̞ ɡ i ɭ
독일어	t o̞ ɡ i ɾ ʌ̹
독재	t o̞ k̚ t͡ɕ͈ e̞
독특하다	t o̞ k̚ tʰ ɯ kʰ a̠ d a̠
돌격	t o̞ ɭ ɡ j ʌ̹ k̚
돌아다니다	t o̞ ɾ a̠ d a̠ n i d a̠
돌아오다	t o̞ ɾ a̠ o̞ d a̠
돌연	t o̞ ɾ j ʌ̹ n
돌잔치	t o̞ ɭ d͡ʑ a̠ n t͡ɕʰ i
동거	t o̞ ŋ ɡ ʌ̹
동굴	t o̞ː ŋ ɡ u ɭ
동기	t o̞ ŋ ɡ i
동남	t o̞ ŋ n a̠ m
동남아시아	t o̞ ŋ n a̠ m a̠ ɕʰ i a̠
동네	t o̞ː ŋ n e̞
동력	t o̞ː ŋ ɲ j ʌ̹ k̚
동료	t o̞ ŋ ɲ j o
동맥	t o̞ː ŋ m e̞ k̚
동맹	t o̞ ŋ m e̞ ŋ
동물	t o̞ː ŋ m u ɭ
동반자	t o̞ ŋ b a̠ n d͡ʑ a̠
동생	t o̞ ŋ sʰ e̞ ŋ
동성	t o̞ ŋ sʰ ʌ̹ ŋ
동성애	t o̞ ŋ sʰ ʌ̹ ŋ e̞
동성애자	t o̞ ŋ sʰ ʌ̹ ŋ e̞ d͡ʑ a̠
동안	t o̞ ŋ a̠ n
동양	t o̞ ŋ j a̠ ŋ
동의	t o̞ ŋ ɰ i
동이	t o̞ ŋ i
동일	t o̞ ŋ i ɭ
동일하다	t o̞ ŋ i ɾ ɦ a̠ d a̠
동정	t o̞ ŋ d͡ʑ ʌ̹ ŋ
동지	t o̞ ŋ d͡ʑ i
동티모르	t o̞ ŋ tʰ i m o̞ ɾ ɯ
돼지고기	t w e̞ː d͡ʑ i ɡ o̞ ɡ i
되게	t w e̞ː ɡ e̞
되풀이	t w e̞ pʰ u ɾ i
된장녀	t w e̞ː n d͡ʑ a̠ ŋ ɲ j ʌ̹
두개골	t u ɡ e̞ ɡ o̞ ɭ
두꺼비	t u k͈ ʌ̹ b i
두껍다	t u k͈ ʌ̹ p̚ t͈ a̠
두뇌	t u n w e̞
두드러기	t u d ɯ ɾ ʌ̹ ɡ i
두려움	t u ɾ j ʌ̹ u m
두목	t u m o̞ k̚
두바이	t u b a̠ i
두세	t u sʰ e̞
두어	t u ʌ̹
두째	t u t͡ɕ͈ e̞
두통	t u tʰ o̞ ŋ
둘째	t uː ɭ t͡ɕ͈ e̞
뒷다리	t ɥ i t̚ t͈ a̠ ɾ i
뒷모습	t ɥ iː n m o̞ sʰ ɯ p̚
듀오	t j u o̞
드디어	t ɯ d i ʌ̹
드라마	t ɯ ɾ a̠ m a̠
드라이브	t ɯ ɾ a̠ i b ɯ
드레스	t ɯ ɾ e̞ sʰ ɯ
듣다	t ɯ t̚ t͈ a̠
들소	t ɯː ɭ s͈ o̞
듯싶다	t ɯ t̚ ɕ͈ i p̚ t͈ a̠
듯이	t ɯ ɕʰ i
듯하다	t ɯ tʰ a̠ d a̠
등대	t ɯ ŋ d e̞
등등	t ɯː ŋ d ɯ ŋ
등록	t ɯ ŋ n o̞ k̚
등반	t ɯ ŋ b a̠ n
등산	t ɯ ŋ sʰ a̠ n
등유	t ɯ ŋ j u
등장인물	t ɯ ŋ d͡ʑ a̠ ŋ i n m u ɭ
디스코	t i sʰ ɯ kʰ o̞
디스크	t i sʰ ɯ k x ɯ
디스플레이	t i sʰ ɯ pʰ ɯ ɭ ɭ e̞ i
디자이너	t i d͡ʑ a̠ i n ʌ̹
디자인	t i d͡ʑ a̠ i n
디지털	t i d͡ʑ i tʰ ʌ̹ ɭ
디카	t i kʰ a̠
따다	t͈ a̠ d a̠
따라서	t͈ a̠ ɾ a̠ sʰ ʌ̹
따르다	t͈ a̠ ɾ ɯ d a̠
때때로	t͈ e̞ t͈ e̞ ɾ o̞
때로	t͈ e̞ ɾ o̞
때문	t͈ e̞ m u n
떡볶이	t͈ ʌ̹ k̚ p͈ o̞ k͈ i
떨다	t͈ ɘː ɭ d a̠
떨어지다	t͈ ʌ̹ ɾ ʌ̹ d͡ʑ i d a̠
또는	t͈ o̞ n ɯ n
또다시	t͈ o̞ d a̠ ɕʰ i
또한	t͈ o̞ ɦ a̠ n
똑같다	t͈ o̞ k̚ k͈ a̠ t̚ t͈ a̠
똑바로	t͈ o̞ k̚ p͈ a̠ ɾ o̞
뜨겁다	t͈ ɯ ɡ ʌ̹ p̚ t͈ a̠
뜸하다	t͈ ɯ m ɦ a̠ d a̠
뜻밖에	t͈ ɯ t̚ p͈ a̠ k͈ e̞
라고	ɾ a̠ ɡ o̞
라디에이터	ɾ a̠ d i e̞ i tʰ ʌ̹
라디오	ɾ a̠ d i o̞
라며	ɾ a̠ m j ʌ̹
라오스	ɾ a̠ o̞ sʰ ɯ
라이벌	ɾ a̠ i b ʌ̹ ɭ
라이선스	ɾ a̠ i sʰ ʌ̹ n sʰ ɯ
라인	ɾ a̠ i n
라임	ɾ a̠ i m
라틴	ɾ a̠ tʰ i n
라파엘	ɾ a̠ pʰ a̠ e̞ ɭ
랴오닝	ɾ j a̠ o̞ n i ŋ
러시아어	ɾ ʌ̹ ɕʰ i a̠ ʌ̹
럭비	ɾ ʌ̹ k̚ p͈ i
런던	ɾ ʌ̹ n d ʌ̹ n
레몬	ɾ e̞ m o̞ n
레스토랑	ɾ e̞ sʰ ɯ tʰ o̞ ɾ a̠ ŋ
레슬링	ɾ e̞ sʰ ɯ ɭ ʎ i ŋ
레이스	ɾ e̞ i sʰ ɯ
레이저	ɾ e̞ i d͡ʑ ʌ̹
레퍼토리	ɾ e̞ pʰ ʌ̹ tʰ o̞ ɾ i
로고	ɾ o̞ ɡ o̞
로그	ɾ o̞ ɡ ɯ
로마	ɾ o̞ m a̠
로망스	ɾ o̞ m a̠ ŋ sʰ ɯ
로봇	ɾ o̞ b o̞ t̚
로스앤젤레스	ɾ o̞ sʰ ɯ e̞ n d͡ʑ e̞ ɭ ɭ e̞ sʰ ɯ
로켓	ɾ o̞ kʰ e̞ t̚
롤러코스터	ɾ o̞ ɭ ɭ ʌ̹ kʰ o̞ sʰ ɯ tʰ ʌ̹
료리	ɾ j o ɾ i
루마니아	ɾ u m a̠ n i a̠
루안다	ɾ u a̠ n d a̠
르네상스	ɾ ɯ n e̞ sʰ a̠ ŋ sʰ ɯ
리눅스	ɾ i n u k s͈ ɯ
리더	ɾ i d ʌ̹
리모컨	ɾ i m o̞ kʰ ʌ̹ n
리본	ɾ i b o̞ n
리비아	ɾ i b i a̠
리튬	ɾ i tʰ j u m
마구	m a̠ ɡ u
마녀	m a̠ ɲ j ʌ̹
마늘	m a̠ n ɯ ɭ
마다	m a̠ d a̠
마다가스카르	m a̠ d a̠ ɡ a̠ sʰ ɯ kʰ a̠ ɾ ɯ
마당	m a̠ d a̠ ŋ
마드리드	m a̠ d ɯ ɾ i d ɯ
마디	m a̠ d i
마땅하다	m a̠ t͈ a̠ ŋ ɦ a̠ d a̠
마라톤	m a̠ ɾ a̠ tʰ o̞ n
마르코	m a̠ ɾ ɯ kʰ o̞
마법사	m a̠ b ʌ̹ p s͈ a̠
마사지	m a̠ sʰ a̠ d͡ʑ i
마약	m a̠ j a̠ k̚
마을	m a̠ ɯ ɭ
마음대로	m a̠ ɯ m d e̞ ɾ o̞
마이너스	m a̠ i n ʌ̹ sʰ ɯ
마이애미	m a̠ i e̞ m i
마이크	m a̠ i k x ɯ
마주	m a̠ d͡ʑ u
마지막	m a̠ d͡ʑ i m a̠ k̚
마찬가지	m a̠ t͡ɕʰ a̠ n ɡ a̠ d͡ʑ i
마취	m a̠ t͡ɕʰ ɥ i
마치	m a̠ t͡ɕʰ i
마침	m a̠ t͡ɕʰ i m
마침내	m a̠ t͡ɕʰ i m n e̞
마카오	m a̠ kʰ a̠ o̞
마케팅	m a̠ kʰ e̞ tʰ i ŋ
마크	m a̠ k x ɯ
마피아	m a̠ pʰ i a̠
마흔	m a̠ ɣ ɯ n
막걸리	m a̠ k̚ k͈ ʌ̹ ɭ ʎ i
막내	m a̠ ŋ n e̞
막바지	m a̠ k̚ p͈ a̠ d͡ʑ i
만날	m a̠ː n n a̠ ɭ
만남	m a̠ n n a̠ m
만년	m a̠ː n ɲ j ʌ̹ n
만능	m a̠ n n ɯ ŋ
만들다	m a̠ n d ɯ ɭ d a̠
만약	m a̠ː ɲ j a̠ k̚
만일	m a̠ː n i ɭ
만큼	m a̠ n k x ɯ m
만하다	m a̠ n ɦ a̠ d a̠
만화가	m a̠ n β w a̠ ɡ a̠
많다	m a̠ː n tʰ a̠
많은	m a̠ː n ɯ n
많이	m a̠ː n i
말기	m a̠ ɭ ɡ i
말뚝	m a̠ ɭ t͈ u k̚
말라위	m a̠ ɭ ɭ a̠ ɥ i
말레이시아	m a̠ ɭ ɭ e̞ i ɕʰ i a̠
말벌	m a̠ ɭ b ʌ̹ ɭ
말씀	m a̠ː ɭ s͈ ɯ m
말하기	m a̠ː ɾ ɦ a̠ ɡ i
망명	m a̠ ŋ m j ʌ̹ ŋ
맞다	m a̠ t̚ t͈ a̠
맞벌이	m a̠ t̚ p͈ ʌ̹ ɾ i
맞은편	m a̠ d͡ʑ ɯ n pʰ j ʌ̹ n
맞춤	m a̠ t̚ t͡ɕʰ u m
맞춤법	m a̠ t̚ t͡ɕʰ u m p͈ ʌ̹ p̚
매년	m e̞ː ɲ j ʌ̹ n
매니저	m e̞ n i d͡ʑ ʌ̹
매달	m e̞ː d a̠ ɭ
매듭	m e̞ d ɯ p̚
매력	m e̞ ɾ j ʌ̹ k̚
매매	m e̞ m e̞
매섭다	m e̞ sʰ ʌ̹ p̚ t͈ a̠
매실주	m e̞ ɕʰ i ɭ t͡ɕ͈ u
매우	m e̞ u
매일	m e̞ː i ɭ
매점	m e̞ː d͡ʑ ʌ̹ m
매주	m e̞ː d͡ʑ u
매체	m e̞ t͡ɕʰ e̞
매출	m e̞ː t͡ɕʰ u ɭ
매트리스	m e̞ tʰ ɯ ɾ i sʰ ɯ
매화	m e̞ β w a̠
맥주	m e̞ k̚ t͡ɕ͈ u
맨날	m e̞ː n n a̠ ɭ
맹자	m e̞ ŋ d͡ʑ a̠
머리	m ʌ̹ ɾ i
머리띠	m ʌ̹ ɾ i t͈ i
머리카락	m ʌ̹ ɾ i kʰ a̠ ɾ a̠ k̚
먹다	m ʌ̹ k̚ t͈ a̠
먹이다	m ʌ̹ ɡ i d a̠
먼저	m ʌ̹ n d͡ʑ ʌ̹
먼지	m ʌ̹ n d͡ʑ i
멀다	m ɘː ɭ d a̠
멀리	m ɘː ɭ ʎ i
멀찌감치	m ʌ̹ ɭ t͡ɕ͈ i ɡ a̠ m t͡ɕʰ i
멍청이	m ʌ̹ ŋ t͡ɕʰ ʌ̹ ŋ i
메뉴	m e̞ ɲ j u
메모	m e̞ m o̞
메모리	m e̞ m o̞ ɾ i
메시지	m e̞ ɕʰ i d͡ʑ i
메일	m e̞ i ɭ
멕시코	m e̞ k ɕ͈ i kʰ o̞
멜라닌	m e̞ ɭ ɭ a̠ n i n
멜론	m e̞ ɭ ɭ o̞ n
멜버른	m e̞ ɭ b ʌ̹ ɾ ɯ n
멤버	m e̞ m b ʌ̹
멧돼지	m e̞ t̚ t͈ w e̞ d͡ʑ i
며느리	m j ʌ̹ n ɯ ɾ i
며칠	m j ʌ̹ t͡ɕʰ i ɭ
면도	m j ɘː n d o̞
면서	m j ʌ̹ n sʰ ʌ̹
면세	m j ɘː n sʰ e̞
면역	m j ɘː ɲ j ʌ̹ k̚
면적	m j ɘː n d͡ʑ ʌ̹ k̚
면접	m j ɘː n d͡ʑ ʌ̹ p̚
멸치	m j ʌ̹ ɭ t͡ɕʰ i
명곡	m j ʌ̹ ŋ ɡ o̞ k̚
명관	m j ʌ̹ ŋ ɡ w a̠ n
명령	m j ɘː ŋ ɲ j ʌ̹ ŋ
명명	m j ɘː ŋ m j ʌ̹ ŋ
명부	m j ʌ̹ ŋ b u
명성	m j ʌ̹ ŋ sʰ ʌ̹ ŋ
명예	m j ʌ̹ ŋ j e̞
명인	m j ʌ̹ ŋ i n
명절	m j ʌ̹ ŋ d͡ʑ ʌ̹ ɭ
명칭	m j ʌ̹ ŋ t͡ɕʰ i ŋ
명함	m j ʌ̹ ŋ ɦ a̠ m
몇몇	m j ʌ̹ n m j ʌ̹ t̚
모기	m o̞ː ɡ i
모나코	m o̞ n a̠ kʰ o̞
모니터	m o̞ n i tʰ ʌ̹
모델	m o̞ d e̞ ɭ
모뎀	m o̞ d e̞ m
모듈	m o̞ d j u ɭ
모래	m o̞ ɾ e̞
모레	m o̞ː ɾ e̞
모서리	m o̞ sʰ ʌ̹ ɾ i
모순	m o̞ sʰ u n
모스크바	m o̞ sʰ ɯ k x ɯ b a̠
모습	m o̞ sʰ ɯ p̚
모양	m o̞ j a̠ ŋ
모임	m o̞ i m
모자	m o̞ d͡ʑ a̠
모처럼	m o̞ t͡ɕʰ ʌ̹ ɾ ʌ̹ m
모터	m o̞ tʰ ʌ̹
모텔	m o̞ tʰ e̞ ɭ
모피	m o̞ pʰ i
모험	m o̞ː ɦ ʌ̹ m
모형	m o̞ ʝ j ʌ̹ ŋ
목격자	m o̞ k̚ k͈ j ʌ̹ k̚ t͡ɕ͈ a̠
목마르다	m o̞ ŋ m a̠ ɾ ɯ d a̠
목사	m o̞ k s͈ a̠
목소리	m o̞ k s͈ o̞ ɾ i
목요일	m o̞ ɡ j o i ɭ
목욕	m o̞ ɡ j o k̚
목적	m o̞ k̚ t͡ɕ͈ ʌ̹ k̚
목적지	m o̞ k̚ t͡ɕ͈ ʌ̹ k̚ t͡ɕ͈ i
목차	m o̞ k̚ t͡ɕʰ a̠
목표	m o̞ k̚ pʰ j o
목화	m o̞ kʰ w a̠
몬트리올	m o̞ n tʰ ɯ ɾ i o̞ ɭ
몰디브	m o̞ ɭ d i b ɯ
몰라	m o̞ ɭ ɭ a̠
몰래	m o̞ː ɭ ɭ e̞
몸매	m o̞ m m e̞
몸짓	m o̞ m t͡ɕ͈ i t̚
몹시	m o̞ː p ɕ͈ i
못지않다	m o̞ː t̚ t͡ɕ͈ i a̠ n tʰ a̠
못하다	m o̞ tʰ a̠ d a̠
몽골	m o̞ ŋ ɡ o̞ ɭ
묘사	m j oː sʰ a̠
무겁다	m u ɡ ʌ̹ p̚ t͈ a̠
무게	m u ɡ e̞
무궁화	m u ɡ u ŋ β w a̠
무기	m uː ɡ i
무늬	m u n i
무당개구리	m uː d a̠ ŋ ɡ e̞ ɡ u ɾ i
무대	m uː d e̞
무덤	m u d ʌ̹ m
무렵	m u ɾ j ʌ̹ p̚
무료	m u ɾ j o
무릎	m u ɾ ɯ p̚
무리	m u ɾ i
무빙워크	m u b i ŋ w ʌ̹ k x ɯ
무선	m u sʰ ʌ̹ n
무술	m uː sʰ u ɭ
무슨	m u sʰ ɯ n
무슬림	m u sʰ ɯ ɭ ʎ i m
무어	m u ʌ̹
무언가	m u ʌ̹ n ɡ a̠
무엇	m u ʌ̹ t̚
무제한	m u d͡ʑ e̞ ɦ a̠ n
무죄	m u d͡ʑ w e̞
무척	m u t͡ɕʰ ʌ̹ k̚
묵묵히	m u ŋ m u k ç i
문득	m u n d ɯ k̚
문법	m u n p͈ ʌ̹ p̚
문서	m u n sʰ ʌ̹
문의	m uː n ɰ i
문자	m u n t͡ɕ͈ a̠
문절망둑	m u n d͡ʑ ʌ̹ ɭ m a̠ ŋ d u k̚
문제	m uː n d͡ʑ e̞
문제점	m u n d͡ʑ e̞ d͡ʑ ʌ̹ m
문학	m u n ɦ a̠ k̚
문화	m u n β w a̠
문화재	m u n β w a̠ d͡ʑ e̞
문화적	m u n β w a̠ d͡ʑ ʌ̹ k̚
물가	m u ɭ k͈ a̠
물건	m u ɭ ɡ ʌ̹ n
물결	m u ɭ k͈ j ʌ̹ ɭ
물고기	m u ɭ k͈ o̞ ɡ i
물음	m u ɾ ɯ m
물증	m u ɭ d͡ʑ ɯ ŋ
물질	m u ɭ t͡ɕ͈ i ɭ
미국	m i ɡ u k̚
미국인	m i ɡ u ɡ i n
미남	m iː n a̠ m
미녀	m iː ɲ j ʌ̹
미디어	m i d i ʌ̹
미래	m iː ɾ e̞
미리	m i ɾ i
미리보기	m i ɾ i b o̞ ɡ i
미분	m i b u n
미사일	m i sʰ a̠ i ɭ
미소	m i sʰ o̞
미술관	m iː sʰ u ɭ ɡ w a̠ n
미스	m i sʰ ɯ
미스터	m i sʰ ɯ tʰ ʌ̹
미아	m i a̠
미안하다	m i a̠ n ɦ a̠ d a̠
미얀마	m i j a̠ n m a̠
미용실	m iː j o ŋ ɕʰ i ɭ
미처	m i t͡ɕʰ ʌ̹
미혼모	m iː β o̞ n m o̞
민요	m i ɲ j o
민족	m i n d͡ʑ o̞ k̚
민족주의	m i n d͡ʑ o̞ k̚ t͡ɕ͈ u ɰ i
민주주의	m i n d͡ʑ u d͡ʑ u ɰ i
민주화	m i n d͡ʑ u β w a̠
민중	m i n d͡ʑ u ŋ
믿다	m i t̚ t͈ a̠
믿음	m i d ɯ m
밀어	m i ɾ ʌ̹
밀월	m i ɾ w ʌ̹ ɭ
바구니	p a̠ ɡ u n i
바그다드	p a̠ ɡ ɯ d a̠ d ɯ
바깥	p a̠ k͈ a̠ t̚
바깥쪽	p a̠ k͈ a̠ t̚ t͡ɕ͈ o̞ k̚
바다	p a̠ d a̠
바다사자	p a̠ d a̠ sʰ a̠ d͡ʑ a̠
바닥	p a̠ d a̠ k̚
바닷가	p a̠ d a̠ t̚ k͈ a̠
바둑	p a̠ d u k̚
바람	p a̠ ɾ a̠ m
바람둥이	p a̠ ɾ a̠ m d u ŋ i
바람직하다	p a̠ ɾ a̠ m d͡ʑ i kʰ a̠ d a̠
바로	p a̠ ɾ o̞
바비큐	p a̠ b i k ç j u
바위	p a̠ ɥ i
바이올린	p a̠ i o̞ ɭ ʎ i n
바지	p a̠ d͡ʑ i
바퀴	p a̠ kʰ ɥ i
바탕	p a̠ tʰ a̠ ŋ
박람회	p a̠ ŋ n a̠ m β w e̞
박물관	p a̠ ŋ m u ɭ ɡ w a̠ n
박스	p a̠ k s͈ ɯ
박차	p a̠ k̚ t͡ɕʰ a̠
박치기	p a̠ k̚ t͡ɕʰ i ɡ i
밖에	p a̠ k͈ e̞
반경	p a̠ː n ɡ j ʌ̹ ŋ
반년	p a̠ː n ɲ j ʌ̹ n
반대	p a̠ː n d e̞
반도체	p a̠ n d o̞ t͡ɕʰ e̞
반드시	p a̠ n d ɯ ɕʰ i
반란	p a̠ː ɭ ɭ a̠ n
반면	p a̠ː n m j ʌ̹ n
반발	p a̠ː n b a̠ ɭ
반복	p a̠ː n b o̞ k̚
반성	p a̠ n s͈ ʌ̹ ŋ
반영	p a̠ː ɲ j ʌ̹ ŋ
반응	p a̠ː n ɯ ŋ
반지름	p a̠ː n d͡ʑ i ɾ ɯ m
반지하	p a̠ n d͡ʑ i ɦ a̠
반찬	p a̠ n t͡ɕʰ a̠ n
반칙	p a̠ː n t͡ɕʰ i k̚
받다	p a̠ t̚ t͈ a̠
받아쓰기	p a̠ d a̠ s͈ ɯ ɡ i
발가락	p a̠ ɭ k͈ a̠ ɾ a̠ k̚
발견	p a̠ ɭ ɡ j ʌ̹ n
발구지	p a̠ ɭ ɡ u d͡ʑ i
발끝	p a̠ ɭ k͈ ɯ t̚
발달	p a̠ ɭ t͈ a̠ ɭ
발라드	p a̠ ɭ ɭ a̠ d ɯ
발레	p a̠ ɭ ɭ e̞
발매	p a̠ ɭ m e̞
발바닥	p a̠ ɭ b a̠ d a̠ k̚
발사	p a̠ ɭ s͈ a̠
발생	p a̠ ɭ s͈ e̞ ŋ
발열	p a̠ ɾ j ʌ̹ ɭ
발음	p a̠ ɾ ɯ m
발인	p a̠ ɾ i n
발자국	p a̠ ɭ t͡ɕ͈ a̠ ɡ u k̚
발전	p a̠ ɭ t͡ɕ͈ ʌ̹ n
발효	p a̠ ɾ ʝ j o
밝다	p a̠ k̚ t͈ a̠
밤낮	p a̠ m n a̠ t̚
밤새	p a̠ m s͈ e̞
밤샘	p a̠ m sʰ e̞ m
밥집	p a̠ p̚ t͡ɕ͈ i p̚
방과후	p a̠ ŋ ɡ w a̠ β u
방귀	p a̠ː ŋ ɡ ɥ i
방글라데시	p a̠ ŋ ɡ ɯ ɭ ɭ a̠ d e̞ ɕʰ i
방금	p a̠ ŋ ɡ ɯ m
방면	p a̠ ŋ m j ʌ̹ n
방사능	p a̠ː ŋ sʰ a̠ n ɯ ŋ
방사선	p a̠ː ŋ sʰ a̠ sʰ ʌ̹ n
방송	p a̠ː ŋ sʰ o̞ ŋ
방송국	p a̠ː ŋ sʰ o̞ ŋ ɡ u k̚
방송사	p a̠ː ŋ sʰ o̞ ŋ sʰ a̠
방아쇠	p a̠ ŋ a̠ sʰ w e̞
방안	p a̠ ŋ a̠ n
방언	p a̠ ŋ ʌ̹ n
방지	p a̠ ŋ d͡ʑ i
방콕	p a̠ ŋ kʰ o̞ k̚
방해	p a̠ ŋ ɦ e̞
방향	p a̠ ŋ ʝ j a̠ ŋ
배구	p e̞ ɡ u
배꼽	p e̞ k͈ o̞ p̚
배달	p e̞ː d a̠ ɭ
배우다	p e̞ u d a̠
배우자	p e̞ː u d͡ʑ a̠
배추	p e̞ː t͡ɕʰ u
배터리	p e̞ tʰ ʌ̹ ɾ i
백내장	p e̞ ŋ n e̞ d͡ʑ a̠ ŋ
백두산	p e̞ k̚ t͈ u sʰ a̠ n
백마	p e̞ ŋ m a̠
백설	p e̞ k s͈ ʌ̹ ɭ
백악관	p e̞ ɡ a̠ k̚ k͈ w a̠ n
백악기	p e̞ ɡ a̠ k̚ k͈ i
백은	p e̞ ɡ ɯ n
백인	p e̞ ɡ i n
백혈병	p e̞ k ç j ʌ̹ ɭ b j ʌ̹ ŋ
백화점	p e̞ kʰ w a̠ d͡ʑ ʌ̹ m
밴드	p e̞ n d ɯ
버마	p ʌ̹ m a̠
버버리	p ʌ̹ b ʌ̹ ɾ i
버전	p ʌ̹ d͡ʑ ʌ̹ n
버지니아	p ʌ̹ d͡ʑ i n i a̠
버튼	p ʌ̹ tʰ ɯ n
버팔로	p ʌ̹ pʰ a̠ ɭ ɭ o̞
번개	p ʌ̹ n ɡ e̞
번역	p ʌ̹ ɲ j ʌ̹ k̚
번역가	p ʌ̹ ɲ j ʌ̹ k̚ k͈ a̠
번호	p ʌ̹ n β o̞
벌금	p ʌ̹ ɭ ɡ ɯ m
벌써	p ʌ̹ ɭ s͈ ʌ̹
벌이다	p ɘː ɾ i d a̠
범위	p ɘː m ɥ i
범인	p ɘː m i n
범죄	p ɘː m d͡ʑ w e̞
범죄자	p ɘː m d͡ʑ w e̞ d͡ʑ a̠
법관	p ʌ̹ p̚ k͈ w a̠ n
법률	p ʌ̹ m ɲ j u ɭ
법무부	p ʌ̹ m m u b u
법안	p ʌ̹ b a̠ n
법원	p ʌ̹ b w ʌ̹ n
법인	p ʌ̹ b i n
법정	p ʌ̹ p̚ t͡ɕ͈ ʌ̹ ŋ
법칙	p ʌ̹ p̚ t͡ɕʰ i k̚
베네수엘라	p e̞ n e̞ sʰ u e̞ ɭ ɭ a̠
베란다	p e̞ ɾ a̠ n d a̠
베를린	p e̞ ɾ ɯ ɭ ʎ i n
베트남	p e̞ tʰ ɯ n a̠ m
벼락	p j ʌ̹ ɾ a̠ k̚
벼랑	p j ʌ̹ ɾ a̠ ŋ
변동	p j ɘː n d o̞ ŋ
변비	p j ʌ̹ n b i
변소	p j ʌ̹ n sʰ o̞
변수	p j ɘː n sʰ u
변환	p j ɘː n β w a̠ n
별도	p j ʌ̹ ɭ t͈ o̞
별로	p j ʌ̹ ɭ ɭ o̞
별빛	p j ɘː ɭ p͈ i t̚
별세	p j ʌ̹ ɭ s͈ e̞
병아리	p j ʌ̹ ŋ a̠ ɾ i
병원	p j ɘː ŋ w ʌ̹ n
보건	p o̞ ɡ ʌ̹ n
보고	p o̞ː ɡ o̞
보급	p o̞ː ɡ ɯ p̚
보기	p o̞ ɡ i
보너스	p o̞ n ʌ̹ sʰ ɯ
보다	p o̞ d a̠
보도	p o̞ː d o̞
보드	p o̞ d ɯ
보따리	p o̞ t͈ a̠ ɾ i
보름	p o̞ ɾ ɯ m
보리	p o̞ ɾ i
보물	p o̞ː m u ɭ
보살	p o̞ sʰ a̠ ɭ
보상	p o̞ː sʰ a̠ ŋ
보석	p o̞ː sʰ ʌ̹ k̚
보신탕	p o̞ː ɕʰ i n tʰ a̠ ŋ
보온병	p o̞ː o̞ n b j ʌ̹ ŋ
보이다	p o̞ i d a̠
보일러	p o̞ i ɭ ɭ ʌ̹
보존	p o̞ː d͡ʑ o̞ n
보증	p o̞ d͡ʑ ɯ ŋ
보지	p o̞ː d͡ʑ i
보통	p o̞ː tʰ o̞ ŋ
보편적	p o̞ː pʰ j ʌ̹ n d͡ʑ ʌ̹ k̚
보험	p o̞ː ɦ ʌ̹ m
보호	p o̞ː β o̞
복권	p o̞ k̚ k͈ w ʌ̹ n
복수	p o̞ k s͈ u
복숭아	p o̞ k s͈ u ŋ a̠
복싱	p o̞ k ɕ͈ i ŋ
복잡하다	p o̞ k̚ t͡ɕ͈ a̠ pʰ a̠ d a̠
복지	p o̞ k̚ t͡ɕ͈ i
본격적	p o̞ n k͈ j ʌ̹ k̚ t͡ɕ͈ ʌ̹ k̚
본관	p o̞ n ɡ w a̠ n
본래	p o̞ ɭ ɭ e̞
본부	p o̞ n b u
볼리비아	p o̞ ɭ ʎ i b i a̠
볼일	p o̞ ɾ i ɭ
봉사	p o̞ː ŋ sʰ a̠
봉지	p o̞ ŋ d͡ʑ i
봉투	p o̞ ŋ tʰ u
부다페스트	p u d a̠ pʰ e̞ sʰ ɯ tʰ ɯ
부담	p uː d a̠ m
부동산	p u d o̞ ŋ sʰ a̠ n
부드럽다	p u d ɯ ɾ ʌ̹ p̚ t͈ a̠
부모	p u m o̞
부문	p u m u n
부부	p u b u
부분	p u b u n
부산	p u sʰ a̠ n
부상	p u sʰ a̠ ŋ
부시	p u ɕʰ i
부여	p u j ʌ̹
부자	p uː d͡ʑ a̠
부작용	p uː d͡ʑ a̠ ɡ j o ŋ
부장	p u d͡ʑ a̠ ŋ
부재	p u d͡ʑ e̞
부적	p uː d͡ʑ ʌ̹ k̚
부정	p u d͡ʑ ʌ̹ ŋ
부정적	p uː d͡ʑ ʌ̹ ŋ d͡ʑ ʌ̹ k̚
부족	p u d͡ʑ o̞ k̚
부족하다	p u d͡ʑ o̞ kʰ a̠ d a̠
부처	p u t͡ɕʰ ʌ̹
부처님	p u t͡ɕʰ ʌ̹ n i m
부통령	p uː tʰ o̞ ŋ ɲ j ʌ̹ ŋ
부패	p u pʰ e̞
부품	p u pʰ u m
부하	p u ɦ a̠
부활	p uː β w a̠ ɭ
북극	p u k̚ k͈ ɯ k̚
북미	p u ŋ m i
북부	p u k̚ p͈ u
북아메리카	p u ɡ a̠ m e̞ ɾ i kʰ a̠
분노	p uː n n o̞
분단	p u n d a̠ n
분리	p u ɭ ʎ i
분리주의	p u ɭ ʎ i d͡ʑ u ɰ i
분명	p u n m j ʌ̹ ŋ
분명하다	p u n m j ʌ̹ ŋ ɦ a̠ d a̠
분명히	p u n m j ʌ̹ ŋ ʝ i
분석	p u n sʰ ʌ̹ k̚
분수	p uː n sʰ u
분야	p u ɲ j a̠
분위기	p u n ɥ i ɡ i
분자	p u n d͡ʑ a̠
분쟁	p u n d͡ʑ e̞ ŋ
분주하다	p u n d͡ʑ u ɦ a̠ d a̠
분포	p u n pʰ o̞
분홍색	p uː n β o̞ ŋ sʰ e̞ k̚
불가능하다	p u ɭ ɡ a̠ n ɯ ŋ ɦ a̠ d a̠
불가리아어	p u ɭ ɡ a̠ ɾ i a̠ ʌ̹
불가사리	p u ɭ ɡ a̠ sʰ a̠ ɾ i
불가피	p u ɭ ɡ a̠ pʰ i
불가피하다	p u ɭ ɡ a̠ pʰ i ɦ a̠ d a̠
불고기	p u ɭ ɡ o̞ ɡ i
불과	p u ɭ ɡ w a̠
불과하다	p u ɭ ɡ w a̠ ɦ a̠ d a̠
불교	p u ɭ ɡ j o
불구	p u ɭ ɡ u
불꽃	p u ɭ k͈ o̞ t̚
불꽃놀이	p u ɭ k͈ o̞ n n o̞ ɾ i
불다	p uː ɭ d a̠
불륜	p u ɭ ʎ j u n
불리다	p u ɭ ʎ i d a̠
불면증	p u ɭ m j ʌ̹ n t͡ɕ͈ ɯ ŋ
불법	p u ɭ b ʌ̹ p̚
불사조	p u ɭ s͈ a̠ d͡ʑ o̞
불쌍하다	p u ɭ s͈ a̠ ŋ ɦ a̠ d a̠
불안	p u ɾ a̠ n
불안하다	p u ɾ a̠ n ɦ a̠ d a̠
불어	p u ɾ ʌ̹
불편	p u ɭ pʰ j ʌ̹ n
불편하다	p u ɭ pʰ j ʌ̹ n ɦ a̠ d a̠
불현듯	p u ɾ ʝ j ʌ̹ n d ɯ t̚
붕어	p uː ŋ ʌ̹
브라우저	p ɯ ɾ a̠ u d͡ʑ ʌ̹
브라이언	p ɯ ɾ a̠ i ʌ̹ n
브라질	p ɯ ɾ a̠ d͡ʑ i ɭ
브라티슬라바	p ɯ ɾ a̠ tʰ i sʰ ɯ ɭ ɭ a̠ b a̠
브랜드	p ɯ ɾ e̞ n d ɯ
브로치	p ɯ ɾ o̞ t͡ɕʰ i
브로커	p ɯ ɾ o̞ kʰ ʌ̹
브리지	p ɯ ɾ i d͡ʑ i
브리핑	p ɯ ɾ i pʰ i ŋ
블라디미르	p ɯ ɭ ɭ a̠ d i m i ɾ ɯ
블라디보스토크	p ɯ ɭ ɭ a̠ d i b o̞ sʰ ɯ tʰ o̞ k x ɯ
블랙홀	p ɯ ɭ ɭ e̞ kʰ o̞ ɭ
비교	p iː ɡ j o
비난	p iː n a̠ n
비단	p iː d a̠ n
비로소	p i ɾ o̞ sʰ o̞
비료	p iː ɾ j o
비린내	p i ɾ i n n e̞
비밀	p iː m i ɭ
비빔밥	p i b i m p͈ a̠ p̚
비상사태	p iː sʰ a̠ ŋ sʰ a̠ tʰ e̞
비소	p i sʰ o̞
비슷하다	p i sʰ ɯ tʰ a̠ d a̠
비싸다	p i s͈ a̠ d a̠
비엔나	p i e̞ n n a̠
비용	p iː j o ŋ
비유	p i j u
비율	p iː j u ɭ
비자	p i d͡ʑ a̠
비중	p iː d͡ʑ u ŋ
비키니	p i k ç i n i
비타민	p i tʰ a̠ m i n
비평가	p i pʰ j ʌ̹ ŋ ɡ a̠
비행기	p i ɦ e̞ ŋ ɡ i
비행장	p i ɦ e̞ ŋ d͡ʑ a̠ ŋ
빅토리아	p i k̚ tʰ o̞ ɾ i a̠
빈곤	p i n ɡ o̞ n
빈도	p i n d o̞
빈민	p i n m i n
빈민가	p i n m i n ɡ a̠
빌딩	p i ɭ d i ŋ
빙하	p i ŋ ɦ a̠
빨강	p͈ a̠ ɭ ɡ a̠ ŋ
빨리	p͈ a̠ ɭ ʎ i
빼앗다	p͈ e̞ a̠ t̚ t͈ a̠
뺑소니	p͈ e̞ ŋ sʰ o̞ n i
뻔하다	p͈ ɘː n ɦ a̠ d a̠
뿌리	p͈ u ɾ i
사거리	sʰ a̠ː ɡ ʌ̹ ɾ i
사건	sʰ a̠ː k͈ ʌ̹ n
사계	sʰ a̠ k͈ j e̞
사기	sʰ a̠ ɡ i
사기꾼	sʰ a̠ ɡ i k͈ u n
사나이	sʰ a̠ n a̠ i
사내	sʰ a̠ n e̞
사냥	sʰ a̠ ɲ j a̠ ŋ
사다	sʰ a̠ d a̠
사단	sʰ a̠ d a̠ n
사람	sʰ a̠ː ɾ a̠ m
사람들	sʰ a̠ ɾ a̠ m d ɯ ɭ
사랑	sʰ a̠ ɾ a̠ ŋ
사랑스럽다	sʰ a̠ ɾ a̠ ŋ sʰ ɯ ɾ ʌ̹ p̚ t͈ a̠
사랑해	sʰ a̠ ɾ a̠ ŋ ɦ e̞
사례	sʰ a̠ː ɾ j e̞
사르르	sʰ a̠ ɾ ɯ ɾ ɯ
사립	sʰ a̠ ɾ i p̚
사막화	sʰ a̠ː m a̠ kʰ w a̠
사면	sʰ a̠ m j ʌ̹ n
사무실	sʰ a̠ː m u ɕʰ i ɭ
사법	sʰ a̠ b ʌ̹ p̚
사상	sʰ a̠ː sʰ a̠ ŋ
사설	sʰ a̠ sʰ ʌ̹ ɭ
사슴	sʰ a̠ sʰ ɯ m
사시	sʰ a̠ ɕʰ i
사실	sʰ a̠ː ɕʰ i ɭ
사실상	sʰ a̠ː ɕʰ i ɭ s͈ a̠ ŋ
사업	sʰ a̠ː ʌ̹ p̚
사용	sʰ a̠ː j o ŋ
사용자	sʰ a̠ j o ŋ d͡ʑ a̠
사용하다	sʰ a̠ː j o ŋ ɦ a̠ d a̠
사우나	sʰ a̠ u n a̠
사원	sʰ a̠ w ʌ̹ n
사위	sʰ a̠ ɥ i
사이	sʰ a̠ i
사이다	sʰ a̠ i d a̠
사이즈	sʰ a̠ i d͡ʑ ɯ
사이트	sʰ a̠ i tʰ ɯ
사임	sʰ a̠ i m
사정	sʰ a̠ː d͡ʑ ʌ̹ ŋ
사제	sʰ a̠ d͡ʑ e̞
사진	sʰ a̠ d͡ʑ i n
사찰	sʰ a̠ t͡ɕʰ a̠ ɭ
사천	sʰ a̠ t͡ɕʰ ʌ̹ n
사철	sʰ a̠ t͡ɕʰ ʌ̹ ɭ
사촌	sʰ a̠ː t͡ɕʰ o̞ n
사춘기	sʰ a̠ t͡ɕʰ u n ɡ i
사태	sʰ a̠ tʰ e̞
사투리	sʰ a̠ tʰ u ɾ i
사하라	sʰ a̠ ɦ a̠ ɾ a̠
사학	sʰ a̠ ɦ a̠ k̚
사할린	sʰ a̠ ɦ a̠ ɭ ʎ i n
사형	sʰ a̠ː ʝ j ʌ̹ ŋ
사회	sʰ a̠ β w e̞
사회적	sʰ a̠ β w e̞ d͡ʑ ʌ̹ k̚
사회주의	sʰ a̠ β w e̞ d͡ʑ u ɰ i
사흘	sʰ a̠ ɣ ɯ ɭ
산둥	sʰ a̠ n d u ŋ
산불	sʰ a̠ n b u ɭ
산업	sʰ a̠ː n ʌ̹ p̚
산장	sʰ a̠ n d͡ʑ a̠ ŋ
산책	sʰ a̠ː n t͡ɕʰ e̞ k̚
살다	sʰ a̠ː ɭ d a̠
살인	sʰ a̠ ɾ i n
살짝	sʰ a̠ ɭ t͡ɕ͈ a̠ k̚
살해	sʰ a̠ ɾ ɦ e̞
삼겹살	sʰ a̠ m ɡ j ʌ̹ p s͈ a̠ ɭ
삼계탕	sʰ a̠ m ɡ j e̞ tʰ a̠ ŋ
삼바	sʰ a̠ m b a̠
삼성	sʰ a̠ m sʰ ʌ̹ ŋ
삿갓	sʰ a̠ t̚ k͈ a̠ t̚
상견례	sʰ a̠ ŋ ɡ j ʌ̹ ɭ ʎ j e̞
상담	sʰ a̠ ŋ d a̠ m
상당	sʰ a̠ ŋ d a̠ ŋ
상당하다	sʰ a̠ ŋ d a̠ ŋ ɦ a̠ d a̠
상대	sʰ a̠ ŋ d e̞
상대적	sʰ a̠ ŋ d e̞ d͡ʑ ʌ̹ k̚
상상	sʰ a̠ː ŋ sʰ a̠ ŋ
상업	sʰ a̠ ŋ ʌ̹ p̚
상원	sʰ a̠ː ŋ w ʌ̹ n
상인	sʰ a̠ ŋ i n
상자	sʰ a̠ ŋ d͡ʑ a̠
상처	sʰ a̠ ŋ t͡ɕʰ ʌ̹
상태	sʰ a̠ ŋ tʰ e̞
상표	sʰ a̠ ŋ pʰ j o
상품	sʰ a̠ ŋ pʰ u m
상황	sʰ a̠ ŋ β w a̠ ŋ
샅샅이	sʰ a̠ t̚ s͈ a̠ t͡ɕʰ i
새끼	sʰ e̞ k͈ i
새로	sʰ e̞ ɾ o̞
새매	sʰ e̞ː m e̞
새미	sʰ e̞ m i
새벽	sʰ e̞ b j ʌ̹ k̚
새우	sʰ e̞ u
색깔	sʰ e̞ k̚ k͈ a̠ ɭ
샌드위치	sʰ e̞ n d ɯ ɥ i t͡ɕʰ i
샌들	sʰ e̞ n d ɯ ɭ
샐러리맨	s͈ e̞ ɭ ɭ ʌ̹ ɾ i m e̞ n
샘플	sʰ e̞ m pʰ ɯ ɭ
샛별	sʰ e̞ t̚ p͈ j ʌ̹ ɭ
생각	sʰ e̞ ŋ ɡ a̠ k̚
생강	sʰ e̞ ŋ ɡ a̠ ŋ
생물	sʰ e̞ ŋ m u ɭ
생물체	sʰ e̞ ŋ m u ɭ t͡ɕʰ e̞
생방송	sʰ e̞ː ŋ b a̠ ŋ sʰ o̞ ŋ
생산	sʰ e̞ ŋ sʰ a̠ n
생선	sʰ e̞ ŋ sʰ ʌ̹ n
생신	sʰ e̞ ŋ ɕʰ i n
생애	sʰ e̞ ŋ e̞
생일	sʰ e̞ ŋ i ɭ
생쥐	sʰ e̞ː ŋ d͡ʑ ɥ i
생태계	sʰ e̞ ŋ tʰ e̞ ɡ j e̞
생활	sʰ e̞ ŋ β w a̠ ɭ
샤워	ɕʰ j a̠ w ʌ̹
샴페인	ɕʰ j a̠ m pʰ e̞ i n
서고	sʰ ʌ̹ ɡ o̞
서귀포	sʰ ʌ̹ ɡ ɥ i pʰ o̞
서럽다	sʰ ɘː ɾ ʌ̹ p̚ t͈ a̠
서로	sʰ ʌ̹ ɾ o̞
서류	sʰ ʌ̹ ɾ j u
서른	sʰ ʌ̹ ɾ ɯ n
서문	sʰ ɘː m u n
서방	sʰ ʌ̹ b a̠ ŋ
서버	s͈ ʌ̹ b ʌ̹
서부	sʰ ʌ̹ b u
서비스	s͈ ʌ̹ b i sʰ ɯ
서서히	sʰ ɘː sʰ ʌ̹ ʝ i
서식지	sʰ ʌ̹ ɕʰ i k̚ t͡ɕ͈ i
서양	sʰ ʌ̹ j a̠ ŋ
서예	sʰ ʌ̹ j e̞
서울	sʰ ʌ̹ u ɭ
서점	sʰ ʌ̹ d͡ʑ ʌ̹ m
서쪽	sʰ ʌ̹ t͡ɕ͈ o̞ k̚
석관	sʰ ʌ̹ k̚ k͈ w a̠ n
석방	sʰ ʌ̹ k̚ p͈ a̠ ŋ
석유	sʰ ʌ̹ ɡ j u
석의	sʰ ʌ̹ ɡ ɰ i
선교	sʰ ʌ̹ n ɡ j o
선교사	sʰ ʌ̹ n ɡ j o sʰ a̠
선물	sʰ ɘː n m u ɭ
선배	sʰ ʌ̹ n b e̞
선생	sʰ ʌ̹ n sʰ e̞ ŋ
선생님	sʰ ʌ̹ n sʰ e̞ ŋ n i m
선수	sʰ ɘː n sʰ u
선실	sʰ ʌ̹ n ɕʰ i ɭ
선언	sʰ ʌ̹ n ʌ̹ n
선장	sʰ ʌ̹ n d͡ʑ a̠ ŋ
선종	sʰ ʌ̹ n d͡ʑ o̞ ŋ
선진국	sʰ ʌ̹ n d͡ʑ i n ɡ u k̚
선택	sʰ ɘː n tʰ e̞ k̚
설계	sʰ ʌ̹ ɭ ɡ j e̞
설사	sʰ ʌ̹ ɭ s͈ a̠
설정	sʰ ʌ̹ ɭ t͡ɕ͈ ʌ̹ ŋ
설화	sʰ ʌ̹ ɾ β w a̠
섭씨	sʰ ʌ̹ p ɕ͈ i
성격	sʰ ɘː ŋ k͈ j ʌ̹ k̚
성경	sʰ ɘː ŋ ɡ j ʌ̹ ŋ
성과	sʰ ʌ̹ ŋ k͈ w a̠
성교하다	sʰ ɘː ŋ ɡ j o ɦ a̠ d a̠
성남	sʰ ʌ̹ ŋ n a̠ m
성당	sʰ ɘː ŋ d a̠ ŋ
성대	sʰ ʌ̹ ŋ d e̞
성립	sʰ ʌ̹ ŋ n i p̚
성매매	sʰ ɘː ŋ m e̞ m e̞
성명	sʰ ɘː ŋ m j ʌ̹ ŋ
성별	sʰ ɘː ŋ b j ʌ̹ ɭ
성분	sʰ ʌ̹ ŋ b u n
성생활	sʰ ɘː ŋ sʰ e̞ ŋ β w a̠ ɭ
성인	sʰ ʌ̹ ŋ i n
성장	sʰ ʌ̹ ŋ d͡ʑ a̠ ŋ
성적	sʰ ʌ̹ ŋ d͡ʑ ʌ̹ k̚
성전환	sʰ ɘː ŋ d͡ʑ ʌ̹ n β w a̠ n
성찬	sʰ ʌ̹ ŋ t͡ɕʰ a̠ n
성탄절	sʰ ɘː ŋ tʰ a̠ n d͡ʑ ʌ̹ ɭ
성폭행	sʰ ɘː ŋ pʰ o̞ kʰ e̞ ŋ
성행위	sʰ ɘː ŋ ɦ e̞ ŋ ɥ i
세계	sʰ e̞ː ɡ j e̞
세계적	sʰ e̞ː ɡ j e̞ d͡ʑ ʌ̹ k̚
세금	sʰ e̞ː ɡ ɯ m
세네갈	s͈ e̞ n e̞ ɡ a̠ ɭ
세력	sʰ e̞ ɾ j ʌ̹ k̚
세르비아	s͈ e̞ ɾ ɯ b i a̠
세상	sʰ e̞ː sʰ a̠ ŋ
세상에	sʰ e̞ː sʰ a̠ ŋ e̞
세수	sʰ e̞ː sʰ u
세월	sʰ e̞ w ʌ̹ ɭ
세입자	sʰ e̞ː i p̚ t͡ɕ͈ a̠
세제	sʰ e̞ː d͡ʑ e̞
세종	sʰ e̞ d͡ʑ o̞ ŋ
세탁	sʰ e̞ː tʰ a̠ k̚
세탁기	sʰ e̞ː tʰ a̠ k̚ k͈ i
세트	sʰ e̞ tʰ ɯ
세포	sʰ e̞ː pʰ o̞
센터	sʰ e̞ n tʰ ʌ̹
셔츠	ɕʰ j ʌ̹ t͡ɕʰ ɯ
소개	sʰ o̞ ɡ e̞
소개팅	sʰ o̞ ɡ e̞ tʰ i ŋ
소고기	sʰ o̞ ɡ o̞ ɡ i
소나기	sʰ o̞ n a̠ ɡ i
소나무	sʰ o̞ n a̠ m u
소나타	sʰ o̞ n a̠ tʰ a̠
소녀	sʰ o̞ː ɲ j ʌ̹
소년	sʰ o̞ː ɲ j ʌ̹ n
소득	sʰ o̞ː d ɯ k̚
소련	sʰ o̞ ɾ j ʌ̹ n
소리	sʰ o̞ ɾ i
소말리아	s͈ o̞ m a̠ ɭ ʎ i a̠
소방관	sʰ o̞ b a̠ ŋ ɡ w a̠ n
소방서	sʰ o̞ b a̠ ŋ sʰ ʌ̹
소방차	sʰ o̞ b a̠ ŋ t͡ɕʰ a̠
소변	sʰ o̞ b j ʌ̹ n
소비	sʰ o̞ b i
소비에트	sʰ o̞ b i e̞ tʰ ɯ
소비자	sʰ o̞ b i d͡ʑ a̠
소설	sʰ o̞ː sʰ ʌ̹ ɭ
소속	sʰ o̞ː sʰ o̞ k̚
소송	sʰ o̞ sʰ o̞ ŋ
소수민족	sʰ o̞ sʰ u m i n d͡ʑ o̞ k̚
소스	sʰ o̞ sʰ ɯ
소시지	sʰ o̞ ɕʰ i d͡ʑ i
소식	sʰ o̞ ɕʰ i k̚
소용돌이	sʰ o̞ j o ŋ d o̞ ɾ i
소위	sʰ o̞ː ɥ i
소유	sʰ o̞ː j u
소유자	sʰ o̞ː j u d͡ʑ a̠
소음	sʰ o̞ ɯ m
소주	s͈ o̞ d͡ʑ u
소중하다	sʰ o̞ː d͡ʑ u ŋ ɦ a̠ d a̠
소책자	sʰ o̞ː t͡ɕʰ e̞ k̚ t͡ɕ͈ a̠
소프트웨어	sʰ o̞ pʰ ɯ tʰ ɯ w e̞ ʌ̹
소화	sʰ o̞ β w a̠
소환	sʰ o̞ β w a̠ n
속담	sʰ o̞ k̚ t͈ a̠ m
속도	sʰ o̞ k̚ t͈ o̞
속삭임	sʰ o̞ k s͈ a̠ ɡ i m
속칭	sʰ o̞ k̚ t͡ɕʰ i ŋ
손가락	sʰ o̞ n k͈ a̠ ɾ a̠ k̚
손님	sʰ o̞ n n i m
손목	sʰ o̞ n m o̞ k̚
손자	sʰ o̞ n d͡ʑ a̠
솔로몬	sʰ o̞ ɭ ɭ o̞ m o̞ n
솔직히	sʰ o̞ ɭ t͡ɕ͈ i k ç i
솜씨	sʰ o̞ m ɕ͈ i
송도	sʰ o̞ ŋ d o̞
송두리째	sʰ o̞ ŋ d u ɾ i t͡ɕ͈ e̞
송아지	sʰ o̞ ŋ a̠ d͡ʑ i
쇠고기	sʰ w e̞ ɡ o̞ ɡ i
쇼케이스	ɕʰ j o kʰ e̞ i sʰ ɯ
쇼크	ɕʰ j o k x ɯ
쇼핑	ɕ͈ j o pʰ i ŋ
수급	sʰ u ɡ ɯ p̚
수녀	sʰ u ɲ j ʌ̹
수능	sʰ u n ɯ ŋ
수다쟁이	sʰ uː d a̠ d͡ʑ e̞ ŋ i
수도	sʰ u d o̞
수도권	sʰ u d o̞ k͈ w ʌ̹ n
수로	sʰ u ɾ o̞
수록	sʰ u ɾ o̞ k̚
수명	sʰ u m j ʌ̹ ŋ
수법	sʰ u b ʌ̹ p̚
수석	sʰ u sʰ ʌ̹ k̚
수성	sʰ u sʰ ʌ̹ ŋ
수소	sʰ u sʰ o̞
수습	sʰ u sʰ ɯ p̚
수심	sʰ u ɕʰ i m
수십	sʰ uː ɕʰ i p̚
수없이	sʰ uː ʌ̹ p ɕ͈ i
수영	sʰ u j ʌ̹ ŋ
수영장	sʰ u j ʌ̹ ŋ d͡ʑ a̠ ŋ
수요	sʰ u j o
수요일	sʰ u j o i ɭ
수원	sʰ u w ʌ̹ n
수입	sʰ u i p̚
수조	sʰ u d͡ʑ o̞
수준	sʰ u d͡ʑ u n
수질	sʰ u d͡ʑ i ɭ
수출	sʰ u t͡ɕʰ u ɭ
수치	sʰ u t͡ɕʰ i
수태	sʰ u tʰ e̞
수필	sʰ u pʰ i ɭ
수학	sʰ u ɦ a̠ k̚
수학여행	sʰ u ɦ a̠ ŋ ɲ j ʌ̹ ɦ e̞ ŋ
수행하다	sʰ u ɦ e̞ ŋ ɦ a̠ d a̠
수호	sʰ u β o̞
숙명	sʰ u ŋ m j ʌ̹ ŋ
숙박	sʰ u k̚ p͈ a̠ k̚
숙소	sʰ u k s͈ o̞
숙제	sʰ u k̚ t͡ɕ͈ e̞
순간	sʰ u n ɡ a̠ n
순천	sʰ uː n t͡ɕʰ ʌ̹ n
숟가락	sʰ u t̚ k͈ a̠ ɾ a̠ k̚
숨통	sʰ u m tʰ o̞ ŋ
숫자	sʰ uː t̚ t͡ɕ͈ a̠
쉽사리	ʃʰ ɥ iː p s͈ a̠ ɾ i
슈퍼	ɕʰ j u pʰ ʌ̹
스노보드	sʰ ɯ n o̞ b o̞ d ɯ
스님	sʰ ɯ n i m
스도쿠	sʰ ɯ d o̞ kʰ u
스모그	sʰ ɯ m o̞ ɡ ɯ
스스로	sʰ ɯ sʰ ɯ ɾ o̞
스웨덴	sʰ ɯ w e̞ d e̞ n
스위스	sʰ ɯ ɥ i sʰ ɯ
스위치	sʰ ɯ ɥ i t͡ɕʰ i
스카프	sʰ ɯ kʰ a̠ pʰ ɯ
스캔들	sʰ ɯ kʰ e̞ n d ɯ ɭ
스케이트보드	sʰ ɯ kʰ e̞ i tʰ ɯ b o̞ d ɯ
스키	sʰ ɯ k ç i
스타	sʰ ɯ tʰ a̠
스타일	sʰ ɯ tʰ a̠ i ɭ
스태프	sʰ ɯ tʰ e̞ pʰ ɯ
스텝	sʰ ɯ tʰ e̞ p̚
스톡홀름	sʰ ɯ tʰ o̞ kʰ o̞ ɭ ɭ ɯ m
스튜디오	s͈ ɯ tʰ j u d i o̞
스트레스	sʰ ɯ tʰ ɯ ɾ e̞ s͈ ɯ
스파이	sʰ ɯ pʰ a̠ i
스펀지	sʰ ɯ pʰ ʌ̹ n d͡ʑ i
스페이드	sʰ ɯ pʰ e̞ i d ɯ
스페인어	sʰ ɯ pʰ e̞ i n ʌ̹
스포츠	sʰ ɯ pʰ o̞ t͡ɕʰ ɯ
스푼	sʰ ɯ pʰ u n
스피커	s͈ ɯ pʰ i kʰ ʌ̹
슬로바키아	sʰ ɯ ɭ ɭ o̞ b a̠ k ç i a̠
슬로베니아	sʰ ɯ ɭ ɭ o̞ b e̞ n i a̠
슬슬	sʰ ɯ ɭ sʰ ɯ ɭ
슬픔	sʰ ɯ ɭ pʰ ɯ m
습관	sʰ ɯ p̚ k͈ w a̠ n
습도	sʰ ɯ p̚ t͈ o̞
습지	sʰ ɯ p̚ t͡ɕ͈ i
승강기	sʰ ɯ ŋ ɡ a̠ ŋ ɡ i
승객	sʰ ɯ ŋ ɡ e̞ k̚
승무원	sʰ ɯ ŋ m u w ʌ̹ n
승용차	sʰ ɯ ŋ j o ŋ t͡ɕʰ a̠
승진	sʰ ɯ ŋ d͡ʑ i n
승합차	sʰ ɯ ŋ ɦ a̠ p̚ t͡ɕʰ a̠
시간	ɕʰ i ɡ a̠ n
시골	ɕʰ i ɡ o̞ ɭ
시기	ɕʰ i ɡ i
시끄럽다	ɕʰ i k͈ ɯ ɾ ʌ̹ p̚ t͈ a̠
시도	ɕʰ iː d o̞
시도하다	ɕʰ iː d o̞ ɦ a̠ d a̠
시드니	ɕʰ i d ɯ n i
시디	ɕʰ i d i
시리아	ɕʰ i ɾ i a̠
시리즈	ɕʰ i ɾ i d͡ʑ ɯ
시립	ɕʰ iː ɾ i p̚
시민	ɕʰ iː m i n
시민권	ɕʰ iː m i n k͈ w ʌ̹ n
시베리아	ɕʰ i b e̞ ɾ i a̠
시선	ɕʰ iː sʰ ʌ̹ n
시설	ɕʰ iː sʰ ʌ̹ ɭ
시스템	ɕ͈ i sʰ ɯ tʰ e̞ m
시아버지	ɕʰ i a̠ b ʌ̹ d͡ʑ i
시애틀	ɕʰ i e̞ tʰ ɯ ɭ
시에라리온	ɕ͈ i e̞ ɾ a̠ ɾ i o̞ n
시원하다	ɕʰ i w ʌ̹ n ɦ a̠ d a̠
시위	ɕʰ iː ɥ i
시작	ɕʰ iː d͡ʑ a̠ k̚
시작하다	ɕʰ iː d͡ʑ a̠ kʰ a̠ d a̠
시절	ɕʰ i d͡ʑ ʌ̹ ɭ
시점	ɕʰ i d͡ʑ ʌ̹ m
시중	ɕʰ iː d͡ʑ u ŋ
시집	ɕʰ i d͡ʑ i p̚
시청자	ɕʰ iː t͡ɕʰ ʌ̹ ŋ d͡ʑ a̠
시험	ɕʰ i ɦ ʌ̹ m
식당	ɕʰ i k̚ t͈ a̠ ŋ
식량	ɕʰ i ŋ ɲ j a̠ ŋ
식료품	ɕʰ i ŋ ɲ j o pʰ u m
식물	ɕʰ i ŋ m u ɭ
식민주의	ɕʰ i ŋ m i n d͡ʑ u ɰ i
식민지	ɕʰ i ŋ m i n d͡ʑ i
식사	ɕʰ i k s͈ a̠
식용유	ɕʰ i ɡ j o ŋ ɲ j u
식품	ɕʰ i k̚ pʰ u m
신경	ɕʰ i n ɡ j ʌ̹ ŋ
신고	ɕʰ i n ɡ o̞
신념	ɕʰ iː n ɲ j ʌ̹ m
신라	ɕʰ i ɭ ɭ a̠
신랑	ɕʰ i ɭ ɭ a̠ ŋ
신뢰	ɕʰ iː ɭ ɭ w e̞
신문	ɕʰ i n m u n
신부	ɕʰ i n b u
신분	ɕʰ i n b u n
신분증	ɕʰ i n b u n t͡ɕ͈ ɯ ŋ
신사	ɕʰ iː n sʰ a̠
신수	ɕʰ i n sʰ u
신어	ɕʰ i n ʌ̹
신용	ɕʰ iː ɲ j o ŋ
신자	ɕʰ iː n d͡ʑ a̠
신조어	ɕʰ i n d͡ʑ o̞ ʌ̹
신주	ɕʰ i n d͡ʑ u
신중하다	ɕʰ iː n d͡ʑ u ŋ ɦ a̠ d a̠
신청자	ɕʰ i n t͡ɕʰ ʌ̹ ŋ d͡ʑ a̠
신체	ɕʰ i n t͡ɕʰ e̞
신형	ɕʰ iː n ʝ j ʌ̹ ŋ
신호	ɕʰ iː n β o̞
신호등	ɕʰ iː n β o̞ d ɯ ŋ
신화	ɕʰ i n β w a̠
실력	ɕʰ i ɭ ʎ j ʌ̹ k̚
실린더	ɕʰ i ɭ ʎ i n d ʌ̹
실수	ɕʰ i ɭ s͈ u
실습	ɕʰ i ɭ s͈ ɯ p̚
실시	ɕʰ i ɭ ɕ͈ i
실업	ɕʰ i ɾ ʌ̹ p̚
실재	ɕʰ i ɭ d͡ʑ e̞
실정	ɕʰ i ɭ t͡ɕ͈ ʌ̹ ŋ
실제로	ɕʰ i ɭ t͡ɕ͈ e̞ ɾ o̞
실천	ɕʰ i ɭ t͡ɕʰ ʌ̹ n
실체	ɕʰ i ɭ t͡ɕʰ e̞
실컷	ɕʰ i ɭ kʰ ʌ̹ t̚
실태	ɕʰ i ɭ tʰ e̞
실험	ɕʰ i ɾ ɦ ʌ̹ m
실현	ɕʰ i ɾ ʝ j ʌ̹ n
싫다	ɕʰ i ɭ tʰ a̠
심각하다	ɕʰ iː m ɡ a̠ kʰ a̠ d a̠
심리	ɕʰ i m n i
심리학	ɕʰ i m n i ɦ a̠ k̚
심사	ɕʰ i m sʰ a̠
심연	ɕʰ iː m j ʌ̹ n
심장	ɕʰ i m d͡ʑ a̠ ŋ
싱가포르	ɕʰ i ŋ ɡ a̠ pʰ o̞ ɾ ɯ
싶다	ɕʰ i p̚ t͈ a̠
싸다	s͈ a̠ d a̠
싸움	s͈ a̠ u m
쌀밥	s͈ a̠ ɭ b a̠ p̚
쌍꺼풀	s͈ a̠ ŋ k͈ ʌ̹ pʰ u ɭ
쌍둥이	s͈ a̠ ŋ d u ŋ i
쌩얼	s͈ e̞ ŋ ʌ̹ ɭ
쓰다	s͈ ɯ d a̠
쓰레기	s͈ ɯ ɾ e̞ ɡ i
씨름	ɕ͈ i ɾ ɯ m
아기	a̠ ɡ i
아깝다	a̠ k͈ a̠ p̚ t͈ a̠
아나운서	a̠ n a̠ u n sʰ ʌ̹
아낙	a̠ n a̠ k̚
아냐	a̠ ɲ j a̠
아니	a̠ n i
아니야	a̠ n i j a̠
아담	a̠ d a̠ m
아들	a̠ d ɯ ɭ
아라비아	a̠ ɾ a̠ b i a̠
아랍에미리트	a̠ ɾ a̠ b e̞ m i ɾ i tʰ ɯ
아래	a̠ ɾ e̞
아련히	a̠ ɾ j ʌ̹ n ʝ i
아론	a̠ ɾ o̞ n
아르바이트	a̠ ɾ ɯ b a̠ i tʰ ɯ
아르헨티나	a̠ ɾ ɯ ɦ e̞ n tʰ i n a̠
아름답다	a̠ ɾ ɯ m d a̠ p̚ t͈ a̠
아리랑	a̠ ɾ i ɾ a̠ ŋ
아리수	a̠ ɾ i sʰ u
아마도	a̠ m a̠ d o̞
아메리카	a̠ m e̞ ɾ i kʰ a̠
아무래도	a̠ː m u ɾ e̞ d o̞
아무튼	a̠ː m u tʰ ɯ n
아바나	a̠ b a̠ n a̠
아버지	a̠ b ʌ̹ d͡ʑ i
아부다비	a̠ b u d a̠ b i
아비	a̠ b i
아빠	a̠ p͈ a̠
아서	a̠ sʰ ʌ̹
아쉽다	a̠ ʃʰ ɥ i p̚ t͈ a̠
아시아	a̠ ɕʰ i a̠
아연	a̠ j ʌ̹ n
아우	a̠ u
아울러	a̠ u ɭ ɭ ʌ̹
아웃	a̠ u t̚
아이	a̠ i
아이고	a̠ i ɡ o̞
아이들	a̠ i d ɯ ɭ
아이스크림	a̠ i sʰ ɯ k x ɯ ɾ iː m
아이스하키	a̠ i sʰ ɯ ɦ a̠ k ç i
아이슬란드	a̠ i sʰ ɯ ɭ ɭ a̠ n d ɯ
아이폰	a̠ i pʰ o̞ n
아일랜드	a̠ i ɭ ɭ e̞ n d ɯ
아쟁	a̠ d͡ʑ e̞ ŋ
아제르바이잔	a̠ d͡ʑ e̞ ɾ ɯ b a̠ i d͡ʑ a̠ n
아줌마	a̠ d͡ʑ u m m a̠
아직	a̠ d͡ʑ i k̚
아카데미	a̠ kʰ a̠ d e̞ m i
아테네	a̠ tʰ e̞ n e̞
아티스트	a̠ tʰ i sʰ ɯ tʰ ɯ
아파트	a̠ pʰ a̠ tʰ ɯ
아편	a̠ pʰ j ʌ̹ n
아프가니스탄	a̠ pʰ ɯ ɡ a̠ n i sʰ ɯ tʰ a̠ n
아프다	a̠ pʰ ɯ d a̠
아프리카	a̠ pʰ ɯ ɾ i kʰ a̠
아홉	a̠ β o̞ p̚
악동	a̠ k̚ t͈ o̞ ŋ
악몽	a̠ ŋ m o̞ ŋ
악성	a̠ k s͈ ʌ̹ ŋ
악어	a̠ ɡ ʌ̹
악영향	a̠ ɡ j ʌ̹ ŋ ʝ j a̠ ŋ
악한	a̠ kʰ a̠ n
안경	a̠ː n ɡ j ʌ̹ ŋ
안내	a̠ː n n e̞
안녕하세요	a̠ n ɲ j ʌ̹ ŋ ɦ a̠ sʰ e̞ j o
안다	a̠ː n t͈ a̠
안락사	a̠ ɭ ɭ a̠ k s͈ a̠
안방	a̠ n b a̠ ŋ
안심	a̠ n ɕʰ i m
안전	a̠ n d͡ʑ ʌ̹ n
안전하다	a̠ n d͡ʑ ʌ̹ n ɦ a̠ d a̠
안정	a̠ n d͡ʑ ʌ̹ ŋ
안쪽	a̠ n t͡ɕ͈ o̞ k̚
안타깝다	a̠ n tʰ a̠ k͈ a̠ p̚ t͈ a̠
안해	a̠ n ɦ e̞
알고리즘	a̠ ɭ ɡ o̞ ɾ i d͡ʑ ɯ m
알곡	a̠ ɭ ɡ o̞ k̚
알라	a̠ ɭ ɭ a̠
알레르기	a̠ ɭ ɭ e̞ ɾ ɯ ɡ i
알루미늄	a̠ ɭ ɭ u m i ɲ j u m
알리고	a̠ ɭ ʎ i ɡ o̞
알코올	a̠ ɭ kʰ o̞ o̞ ɭ
알파	a̠ ɭ pʰ a̠
알파벳	a̠ ɭ pʰ a̠ b e̞ t̚
암기	a̠ː m ɡ i
암말	a̠ m m a̠ ɭ
암살	a̠ m sʰ a̠ ɭ
암석	a̠ m sʰ ʌ̹ k̚
암컷	a̠ m kʰ ʌ̹ t̚
암호	a̠ː m β o̞
압력	a̠ m ɲ j ʌ̹ k̚
압록강	a̠ m n o̞ k̚ k͈ a̠ ŋ
압박	a̠ p̚ p͈ a̠ k̚
앙상블	a̠ ŋ sʰ a̠ ŋ b ɯ ɭ
앞서	a̠ p s͈ ʌ̹
앞서다	a̠ p s͈ ʌ̹ d a̠
애국심	e̞ː ɡ u k ɕ͈ i m
애국주의	e̞ː ɡ u k̚ t͡ɕ͈ u ɰ i
애인	e̞ː i n
애초	e̞ t͡ɕʰ o̞
애플	e̞ pʰ ɯ ɭ
액수	e̞ k s͈ u
앨범	e̞ ɭ b ʌ̹ m
야간	j a̠ː ɡ a̠ n
야구	j a̠ː ɡ u
야구장	j a̠ː ɡ u d͡ʑ a̠ ŋ
야금야금	j a̠ ɡ ɯ m j a̠ ɡ ɯ m
야채	j a̠ː t͡ɕʰ e̞
약물	j a̠ ŋ m u ɭ
약속	j a̠ k s͈ o̞ k̚
약자	j a̠ k̚ t͡ɕ͈ a̠
약점	j a̠ k̚ t͡ɕ͈ ʌ̹ m
양곤	j a̠ ŋ ɡ o̞ n
양국	j a̠ ŋ ɡ u k̚
양념	j a̠ ŋ ɲ j ʌ̹ m
양다리	j a̠ ŋ d a̠ ɾ i
양력	j a̠ ŋ ɲ j ʌ̹ k̚
양면	j a̠ ŋ m j ʌ̹ n
양반	j a̠ ŋ b a̠ n
양복	j a̠ ŋ b o̞ k̚
양상	j a̠ ŋ sʰ a̠ ŋ
양식	j a̠ ŋ ɕʰ i k̚
양심	j a̠ ŋ ɕʰ i m
양자	j a̠ ŋ d͡ʑ a̠
양주	j a̠ ŋ d͡ʑ u
양쪽	j a̠ː ŋ t͡ɕ͈ o̞ k̚
양파	j a̠ ŋ pʰ a̠
어깨	ʌ̹ k͈ e̞
어느	ʌ̹ n ɯ
어느새	ʌ̹ n ɯ sʰ e̞
어댑터	ʌ̹ d e̞ p̚ tʰ ʌ̹
어둠	ʌ̹ d u m
어디	ʌ̹ d i
어떤	ʌ̹ t͈ ʌ̹ n
어떻게	ʌ̹ t͈ ʌ̹ kʰ e̞
어려움	ʌ̹ ɾ j ʌ̹ u m
어렵다	ʌ̹ ɾ j ʌ̹ p̚ t͈ a̠
어렵사리	ʌ̹ ɾ j ʌ̹ p s͈ a̠ ɾ i
어른	ɘː ɾ ɯ n
어린이	ʌ̹ ɾ i n i
어머니	ʌ̹ m ʌ̹ n i
어부	ʌ̹ b u
어서	ʌ̹ sʰ ʌ̹
어원학	ɘː w ʌ̹ n ɦ a̠ k̚
어제	ʌ̹ d͡ʑ e̞
어젯밤	ʌ̹ d͡ʑ e̞ t̚ p͈ a̠ m
어쨌든	ʌ̹ t͡ɕ͈ e̞ t̚ t͈ ɯ n
어쩌다	ʌ̹ t͡ɕ͈ ʌ̹ d a̠
어쩌면	ʌ̹ t͡ɕ͈ ʌ̹ m j ʌ̹ n
어차피	ʌ̹ t͡ɕʰ a̠ pʰ i
억류	ʌ̹ ŋ ɲ j u
억울하다	ʌ̹ ɡ u ɾ ɦ a̠ d a̠
언니	ʌ̹ n n i
언덕	ʌ̹ n d ʌ̹ k̚
언뜻	ʌ̹ n t͈ ɯ t̚
언론	ʌ̹ ɭ ɭ o̞ n
언어	ʌ̹ n ʌ̹
언제	ɘː n d͡ʑ e̞
언젠가	ɘː n d͡ʑ e̞ n ɡ a̠
얼굴	ʌ̹ ɭ ɡ u ɭ
얼른	ʌ̹ ɭ ɭ ɯ n
얼마	ʌ̹ ɭ m a̠
얼마나	ʌ̹ ɭ m a̠ n a̠
얼음	ʌ̹ ɾ ɯ m
얼짱	ʌ̹ ɭ t͡ɕ͈ a̠ ŋ
얼핏	ʌ̹ ɭ pʰ i t̚
엄격하다	ʌ̹ m k͈ j ʌ̹ kʰ a̠ d a̠
엄니	ɘː m n i
엄마	ʌ̹ m m a̠
엄지	ʌ̹ m d͡ʑ i
엄지손가락	ʌ̹ m d͡ʑ i sʰ o̞ n ɡ a̠ ɾ a̠ k̚
엄청나다	ʌ̹ m t͡ɕʰ ʌ̹ ŋ n a̠ d a̠
업그레이드	ʌ̹ p̚ k͈ ɯ ɾ e̞ i d ɯ
업동이	ʌ̹ p̚ t͈ o̞ ŋ i
업무	ʌ̹ m m u
업종	ʌ̹ p̚ t͡ɕ͈ o̞ ŋ
업체	ʌ̹ p̚ t͡ɕʰ e̞
없다	ɘː p̚ t͈ a̠
없었다	ʌ̹ p s͈ ʌ̹ t̚ t͈ a̠
없이	ɘː p ɕ͈ i
엉엉	ʌ̹ ŋ ʌ̹ ŋ
에게	e̞ ɡ e̞
에너지	e̞ n ʌ̹ d͡ʑ i
에미	e̞ m i
에미리트	e̞ m i ɾ i tʰ ɯ
에스컬레이터	e̞ sʰ ɯ kʰ ʌ̹ ɭ ɭ e̞ i tʰ ʌ̹
에어컨	e̞ ʌ̹ kʰ ʌ̹ n
에티오피아	e̞ tʰ i o̞ pʰ i a̠
에피소드	e̞ pʰ i sʰ o̞ d ɯ
엔진	e̞ n d͡ʑ i n
엘리베이터	e̞ ɭ ʎ i b e̞ i tʰ ʌ̹
여가	j ʌ̹ ɡ a̠
여객	j ʌ̹ ɡ e̞ k̚
여객기	j ʌ̹ ɡ e̞ k̚ k͈ i
여건	j ɘː ɡ ʌ̹ n
여고생	j ʌ̹ ɡ o̞ sʰ e̞ ŋ
여권	j ʌ̹ k͈ w ʌ̹ n
여대생	j ʌ̹ d e̞ sʰ e̞ ŋ
여동생	j ʌ̹ d o̞ ŋ sʰ e̞ ŋ
여드름	j ʌ̹ d ɯ ɾ ɯ m
여러	j ʌ̹ ɾ ʌ̹
여러분	j ʌ̹ ɾ ʌ̹ b u n
여론	j ɘː ɾ o̞ n
여름	j ʌ̹ ɾ ɯ m
여배우	j ʌ̹ b e̞ u
여보	j ʌ̹ b o̞
여섯	j ʌ̹ sʰ ʌ̹ t̚
여성	j ʌ̹ sʰ ʌ̹ ŋ
여신	j ʌ̹ ɕʰ i n
여왕	j ʌ̹ w a̠ ŋ
여울	j ʌ̹ u ɭ
여유	j ʌ̹ j u
여인	j ʌ̹ i n
여자	j ʌ̹ d͡ʑ a̠
여자친구	j ʌ̹ d͡ʑ a̠ t͡ɕʰ i n ɡ u
여장	j ʌ̹ d͡ʑ a̠ ŋ
여행	j ʌ̹ ɦ e̞ ŋ
여행사	j ʌ̹ ɦ e̞ ŋ sʰ a̠
여행자	j ʌ̹ ɦ e̞ ŋ d͡ʑ a̠
역량	j ʌ̹ ŋ ɲ j a̠ ŋ
역사가	j ʌ̹ k s͈ a̠ ɡ a̠
역사적	j ʌ̹ k s͈ a̠ d͡ʑ ʌ̹ k̚
역시	j ʌ̹ k ɕ͈ i
역할	j ʌ̹ kʰ a̠ ɭ
연골	j ɘː n ɡ o̞ ɭ
연구	j ɘː n ɡ u
연구원	j ɘː n ɡ u w ʌ̹ n
연금	j ʌ̹ n ɡ ɯ m
연기자	j ɘː n ɡ i d͡ʑ a̠
연대	j ʌ̹ n d e̞
연령	j ʌ̹ ɭ ʎ j ʌ̹ ŋ
연료	j ʌ̹ ɭ ʎ j o
연루	j ʌ̹ ɭ ɭ u
연말	j ʌ̹ n m a̠ ɭ
연못	j ʌ̹ n m o̞ t̚
연방	j ʌ̹ n b a̠ ŋ
연상	j ʌ̹ n sʰ a̠ ŋ
연설	j ɘː n sʰ ʌ̹ ɭ
연습	j ɘː n sʰ ɯ p̚
연습곡	j ɘː n sʰ ɯ p̚ k͈ o̞ k̚
연안	j ʌ̹ n a̠ n
연주	j ɘː n d͡ʑ u
연주하다	j ɘː n d͡ʑ u ɦ a̠ d a̠
연출	j ɘː n t͡ɕʰ u ɭ
연합	j ʌ̹ n ɦ a̠ p̚
연회	j ɘː n β w e̞
열대	j ɘː ɭ d e̞
열심히	j ʌ̹ ɭ ɕ͈ i m ʝ i
열여섯	j ʌ̹ ɭ ʎ j ʌ̹ sʰ ʌ̹ t̚
열정	j ʌ̹ ɭ d͡ʑ ʌ̹ ŋ
열차	j ʌ̹ ɭ t͡ɕʰ a̠
열흘	j ʌ̹ ɾ ɣ ɯ ɭ
염증	j ʌ̹ m d͡ʑ ɯ ŋ
엿새	j ʌ̹ t̚ s͈ e̞
영구	j ɘː ŋ ɡ u
영사관	j ʌ̹ ŋ sʰ a̠ ɡ w a̠ n
영상	j ʌ̹ ŋ sʰ a̠ ŋ
영성	j ʌ̹ ŋ sʰ ʌ̹ ŋ
영양	j ʌ̹ ŋ j a̠ ŋ
영어	j ʌ̹ ŋ ʌ̹
영업	j ʌ̹ ŋ ʌ̹ p̚
영원히	j ɘː ŋ w ʌ̹ n ʝ i
영토	j ʌ̹ ŋ tʰ o̞
영하	j ʌ̹ ŋ ɦ a̠
영향	j ɘː ŋ ʝ j a̠ ŋ
영향력	j ɘː ŋ ʝ j a̠ ŋ ɲ j ʌ̹ k̚
영화	j ʌ̹ ŋ β w a̠
영화관	j ʌ̹ ŋ β w a̠ ɡ w a̠ n
옆집	j ʌ̹ p̚ t͡ɕ͈ i p̚
예능	j e̞ː n ɯ ŋ
예멘	j e̞ m e̞ n
예방	j e̞ː b a̠ ŋ
예배당	j e̞ b e̞ d a̠ ŋ
예산	j e̞ː sʰ a̠ n
예상	j e̞ː sʰ a̠ ŋ
예술	j e̞ː sʰ u ɭ
예술가	j e̞ː sʰ u ɭ ɡ a̠
예언자	j e̞ː ʌ̹ n d͡ʑ a̠
예외	j e̞ː w e̞
예의	j e̞ ɰ i
예전	j e̞ː d͡ʑ ʌ̹ n
예정	j e̞ː d͡ʑ ʌ̹ ŋ
옛날	j e̞ː n n a̠ ɭ
오가다	o̞ ɡ a̠ d a̠
오늘	o̞ n ɯ ɭ
오다	o̞ d a̠
오락	o̞ː ɾ a̠ k̚
오래다	o̞ ɾ e̞ d a̠
오래전	o̞ ɾ e̞ d͡ʑ ʌ̹ n
오랜	o̞ ɾ e̞ n
오렌지	o̞ ɾ e̞ n d͡ʑ i
오렌지색	o̞ ɾ e̞ n d͡ʑ i sʰ e̞ k̚
오르간	o̞ ɾ ɯ ɡ a̠ n
오르다	o̞ ɾ ɯ d a̠
오른	o̞ ɾ ɯ n
오리	o̞ː ɾ i
오바마	o̞ b a̠ m a̠
오사카	o̞ sʰ a̠ kʰ a̠
오스트레일리아	o̞ sʰ ɯ tʰ ɯ ɾ e̞ i ɭ ʎ i a̠
오스트리아	o̞ sʰ ɯ tʰ ɯ ɾ i a̠
오염	o̞ː j ʌ̹ m
오전	o̞ː d͡ʑ ʌ̹ n
오줌	o̞ d͡ʑ u m
오케스트라	o̞ kʰ e̞ sʰ ɯ tʰ ɯ ɾ a̠
오페라	o̞ pʰ e̞ ɾ a̠
오페레타	o̞ pʰ e̞ ɾ e̞ tʰ a̠
오피스텔	o̞ pʰ i sʰ ɯ tʰ e̞ ɭ
오하이오	o̞ ɦ a̠ i o̞
오후	o̞ː β u
오히려	o̞ ʝ i ɾ j ʌ̹
온갖	o̞ n ɡ a̠ t̚
온도	o̞ n d o̞
온돌	o̞ n d o̞ ɭ
온두라스	o̞ n d u ɾ a̠ sʰ ɯ
온라인	o̞ n n a̠ i n
온수	o̞ n sʰ u
온실	o̞ n ɕʰ i ɭ
온천	o̞ n t͡ɕʰ ʌ̹ n
올겨울	o̞ ɭ k͈ j ʌ̹ u ɭ
올라가다	o̞ ɭ ɭ a̠ ɡ a̠ d a̠
올리고	o̞ ɭ ʎ i ɡ o̞
올리브	o̞ ɭ ʎ i b ɯ
올림픽	o̞ ɭ ʎ i m pʰ i k̚
올여름	o̞ ɭ ʎ j ʌ̹ ɾ ɯ m
올해	o̞ ɾ ɦ e̞
옳다	o̞ ɭ tʰ a̠
와인	w a̠ i n
완곡한	w a̠ː n ɡ o̞ kʰ a̠ n
완벽하다	w a̠ n b j ʌ̹ kʰ a̠ d a̠
완전	w a̠ n d͡ʑ ʌ̹ n
왈츠	w a̠ ɭ t͡ɕʰ ɯ
왕국	w a̠ ŋ ɡ u k̚
왕복	w a̠ ŋ b o̞ k̚
왕실	w a̠ ŋ ɕʰ i ɭ
왕자	w a̠ː ŋ d͡ʑ a̠
왜냐하면	w e̞ ɲ j a̠ ɦ a̠ m j ʌ̹ n
왠지	w e̞ n d͡ʑ i
외교관	w e̞ː ɡ j o ɡ w a̠ n
외국	w e̞ː ɡ u k̚
외국어	w e̞ː ɡ u ɡ ʌ̹
외국인	w e̞ː ɡ u ɡ i n
외동딸	w e̞ d o̞ ŋ t͈ a̠ ɭ
외래어	w e̞ː ɾ e̞ ʌ̹
외로	w e̞ ɾ o̞
외면	w e̞ː m j ʌ̹ n
외모	w e̞ m o̞
외부	w e̞ː b u
외손자	w e̞ː sʰ o̞ n d͡ʑ a̠
외아들	w e̞ a̠ d ɯ ɭ
외치다	w e̞ t͡ɕʰ i d a̠
외화	w e̞ː β w a̠
왼쪽	w e̞ː n t͡ɕ͈ o̞ k̚
요구르트	j o ɡ u ɾ ɯ tʰ ɯ
요구하다	j o ɡ u ɦ a̠ d a̠
요금	j oː ɡ ɯ m
요리	j o ɾ i
요리사	j o ɾ i sʰ a̠
요새	j o sʰ e̞
요소	j o sʰ o̞
요정	j o d͡ʑ ʌ̹ ŋ
요즘	j o d͡ʑ ɯ m
요청	j o t͡ɕʰ ʌ̹ ŋ
요한	j o ɦ a̠ n
욕실	j o k ɕ͈ i ɭ
욕심	j o k ɕ͈ i m
용돈	j oː ŋ d o̞ n
용어	j oː ŋ ʌ̹
용의자	j o ŋ ɰ i d͡ʑ a̠
용이	j o ŋ i
용접하다	j o ŋ d͡ʑ ʌ̹ pʰ a̠ d a̠
용지	j o ŋ d͡ʑ i
우려	u ɾ j ʌ̹
우리	u ɾ i
우리나라	u ɾ i n a̠ ɾ a̠
우리말	u ɾ i m a̠ ɭ
우먼	u m ʌ̹ n
우물	u m u ɭ
우산	uː sʰ a̠ n
우선	u sʰ ʌ̹ n
우세	u sʰ e̞
우엉	u ʌ̹ ŋ
우연히	u j ʌ̹ n ʝ i
우울증	u u ɭ t͡ɕ͈ ɯ ŋ
우의	uː ɰ i
우정	uː d͡ʑ ʌ̹ ŋ
우주	uː d͡ʑ u
우주선	uː d͡ʑ u sʰ ʌ̹ n
우주인	uː d͡ʑ u i n
우즈베키스탄	u d͡ʑ ɯ b e̞ k ç i sʰ ɯ tʰ a̠ n
우체국	u t͡ɕʰ e̞ ɡ u k̚
우크라이나	u k x ɯ ɾ a̠ i n a̠
우편	u pʰ j ʌ̹ n
우표	u pʰ j o
운동	uː n d o̞ ŋ
운동복	uː n d o̞ ŋ b o̞ k̚
운동장	uː n d o̞ ŋ d͡ʑ a̠ ŋ
운동화	uː n d o̞ ŋ β w a̠
운반	u n b a̠ n
운송	u n sʰ o̞ ŋ
운수	u n sʰ u
운전대	uː n d͡ʑ ʌ̹ n d e̞
운전사	uː n d͡ʑ ʌ̹ n sʰ a̠
운전자	uː n d͡ʑ ʌ̹ n d͡ʑ a̠
운전하다	u n d͡ʑ ʌ̹ n ɦ a̠ d a̠
운하	uː n ɦ a̠
울산	u ɭ s͈ a̠ n
울타리	u ɭ tʰ a̠ ɾ i
움직임	u m d͡ʑ i ɡ i m
웃음	u sʰ ɯ m
웅덩이	u ŋ d ʌ̹ ŋ i
워싱턴	w ʌ̹ ɕʰ i ŋ tʰ ʌ̹ n
원기둥	w ʌ̹ n ɡ i d u ŋ
원료	w ʌ̹ ɭ ʎ j o
원리	w ʌ̹ ɭ ʎ i
원숭이	w ɘː n sʰ u ŋ i
원인	w ʌ̹ n i n
원자력	w ʌ̹ n d͡ʑ a̠ ɾ j ʌ̹ k̚
원조	w ɘː n d͡ʑ o̞
원칙	w ʌ̹ n t͡ɕʰ i k̚
원폭	w ʌ̹ n pʰ o̞ k̚
원피스	w ʌ̹ n pʰ i sʰ ɯ
월경	w ʌ̹ ɭ ɡ j ʌ̹ ŋ
월드컵	w ʌ̹ ɭ d ɯ kʰ ʌ̹ p̚
월세	w ʌ̹ ɭ s͈ e̞
웨이터	w e̞ i tʰ ʌ̹
웬일	w e̞ː n n i ɭ
웹사이트	w e̞ p s͈ a̠ i tʰ ɯ
위기	ɥ i ɡ i
위생	ɥ i sʰ e̞ ŋ
위성	ɥ i sʰ ʌ̹ ŋ
위스키	ɥ i sʰ ɯ k ç i
위원	ɥ i w ʌ̹ n
위원장	ɥ i w ʌ̹ n d͡ʑ a̠ ŋ
위원회	ɥ i w ʌ̹ n β w e̞
위주	ɥ i d͡ʑ u
위치	ɥ i t͡ɕʰ i
위탁	ɥ i tʰ a̠ k̚
위험	ɥ i ɦ ʌ̹ m
위험하다	ɥ i ɦ ʌ̹ m ɦ a̠ d a̠
위협	ɥ i ʝ j ʌ̹ p̚
윈도우	ɥ i n d o̞ u
유가	j u ɡ a̠
유가증권	j uː ɡ a̠ d͡ʑ ɯ ŋ k͈ w ʌ̹ n
유감	j u ɡ a̠ m
유곽	j u ɡ w a̠ k̚
유권자	j uː ɡ w ʌ̹ n d͡ʑ a̠
유난히	j uː n a̠ n ʝ i
유니폼	j u n i pʰ o̞ m
유대	j u d e̞
유대인	j u d e̞ i n
유도	j u d o̞
유독	j uː d o̞ k̚
유럽	j u ɾ ʌ̹ p̚
유령	j u ɾ j ʌ̹ ŋ
유로	j u ɾ o̞
유리하다	j uː ɾ i ɦ a̠ d a̠
유명	j uː m j ʌ̹ ŋ
유명하다	j uː m j ʌ̹ ŋ ɦ a̠ d a̠
유물	j u m u ɭ
유방	j u b a̠ ŋ
유서	j u sʰ ʌ̹
유엔	j u e̞ n
유역	j u j ʌ̹ k̚
유용하다	j uː j o ŋ ɦ a̠ d a̠
유원지	j u w ʌ̹ n d͡ʑ i
유전자	j u d͡ʑ ʌ̹ n d͡ʑ a̠
유죄	j uː d͡ʑ w e̞
유지	j u d͡ʑ i
유진	j u d͡ʑ i n
유탄	j u tʰ a̠ n
유태인	j u tʰ e̞ i n
유튜브	j u tʰ j u b ɯ
유학	j u ɦ a̠ k̚
유행	j u ɦ e̞ ŋ
유형	j uː ʝ j ʌ̹ ŋ
유혹	j u β o̞ k̚
육군	j u k̚ k͈ u n
윤년	j uː n ɲ j ʌ̹ n
윤리	j u ɭ ʎ i
윷놀이	j uː n n o̞ ɾ i
으로	ɯ ɾ o̞
은하수	ɯ n ɦ a̠ sʰ u
은행	ɯ n ɦ e̞ ŋ
은혜	ɯ n ʝ j e̞
음경	ɯ m ɡ j ʌ̹ ŋ
음료	ɯː m ɲ j o
음모	ɯ m m o̞
음반	ɯ m b a̠ n
음성	ɯ m sʰ ʌ̹ ŋ
음식	ɯː m ɕʰ i k̚
음악	ɯ m a̠ k̚
음악학	ɯ m a̠ kʰ a̠ k̚
응당	ɯ ŋ d a̠ ŋ
응시	ɯ ŋ ɕʰ i
응용	ɯː ŋ j o ŋ
응원	ɯː ŋ w ʌ̹ n
응집력	ɯː ŋ d͡ʑ i m ɲ j ʌ̹ k̚
의견	ɰ iː ɡ j ʌ̹ n
의도	ɰ iː d o̞
의미	ɰ iː m i
의상	ɰ i sʰ a̠ ŋ
의식	ɰ iː ɕʰ i k̚
의심	ɰ i ɕʰ i m
의의	ɰ iː ɰ i
의자	ɰ i d͡ʑ a̠
의장	ɰ i d͡ʑ a̠ ŋ
의제	ɰ i d͡ʑ e̞
의존하다	ɰ i d͡ʑ o̞ n ɦ a̠ d a̠
의지	ɰ iː d͡ʑ i
의혹	ɰ i β o̞ k̚
의회	ɰ i β w e̞
이거	i ɡ ʌ̹
이게	i ɡ e̞
이곳	i ɡ o̞ t̚
이끼	i k͈ i
이나	i n a̠
이날	i n a̠ ɭ
이내	iː n e̞
이념	iː ɲ j ʌ̹ m
이다	i d a̠
이달	i d a̠ ɭ
이대로	i d e̞ ɾ o̞
이도	i d o̞
이동	i d o̞ ŋ
이때	i t͈ e̞
이라크	i ɾ a̠ k x ɯ
이러다	i ɾ ʌ̹ d a̠
이렇게	i ɾ ʌ̹ kʰ e̞
이렇다	i ɾ ʌ̹ tʰ a̠
이론	iː ɾ o̞ n
이르다	i ɾ ɯ d a̠
이름	i ɾ ɯ m
이마	i m a̠
이맘	i m a̠ m
이메일	i m e̞ i ɭ
이며	i m j ʌ̹
이미	i m i
이민	i m i n
이발소	iː b a̠ ɭ s͈ o̞
이번	i b ʌ̹ n
이벤트	i b e̞ n tʰ ɯ
이별	i b j ʌ̹ ɭ
이불	i b u ɭ
이사회	iː sʰ a̠ β w e̞
이산화탄소	iː sʰ a̠ n β w a̠ tʰ a̠ n sʰ o̞
이삼	iː sʰ a̠ m
이스라엘	i sʰ ɯ ɾ a̠ e̞ ɭ
이슬람	i sʰ ɯ ɭ ɭ a̠ m
이슬람교	i sʰ ɯ ɭ ɭ a̠ m ɡ j o
이야기	i j a̠ ɡ i
이어	i ʌ̹
이어폰	i ʌ̹ pʰ o̞ n
이외	iː w e̞
이용	iː j o ŋ
이웃	i u t̚
이웃집	i u t̚ t͡ɕ͈ i p̚
이유	iː j u
이윽고	i ɯ k̚ k͈ o̞
이익	iː i k̚
이자	i d͡ʑ a̠
이전	iː d͡ʑ ʌ̹ n
이점	iː d͡ʑ ʌ̹ m
이제	i d͡ʑ e̞
이주	i d͡ʑ u
이집트	i d͡ʑ i p̚ tʰ ɯ
이탈리아	i tʰ a̠ ɭ ʎ i a̠
이태리	i tʰ e̞ ɾ i
이틀	i tʰ ɯ ɭ
이하	iː ɦ a̠
이해	iː ɦ e̞
이행	iː ɦ e̞ ŋ
이혼	iː β o̞ n
이후	i β u
인간	i n ɡ a̠ n
인구	i n ɡ u
인권	i n k͈ w ʌ̹ n
인근	i n ɡ ɯ n
인기	i n k͈ i
인내	i n n e̞
인대	i n d e̞
인도네시아	i n d o̞ n e̞ ɕʰ i a̠
인도양	i n d o̞ j a̠ ŋ
인력	i ɭ ʎ j ʌ̹ k̚
인명	i n m j ʌ̹ ŋ
인생	i n sʰ e̞ ŋ
인쇄	i n sʰ w e̞
인수	i n sʰ u
인식	i n ɕʰ i k̚
인어	i n ʌ̹
인연	i ɲ j ʌ̹ n
인용	i ɲ j o ŋ
인재	i n d͡ʑ e̞
인정	i n d͡ʑ ʌ̹ ŋ
인제	i n d͡ʑ e̞
인종	i n d͡ʑ o̞ ŋ
인종차별	i n d͡ʑ o̞ ŋ t͡ɕʰ a̠ b j ʌ̹ ɭ
인질	i n d͡ʑ i ɭ
인천	i n t͡ɕʰ ʌ̹ n
인체	i n t͡ɕʰ e̞
인치	i n t͡ɕʰ i
인터넷	i n tʰ ʌ̹ n e̞ t̚
인터뷰	i n tʰ ʌ̹ b j u
인플레이션	i n pʰ ɯ ɭ ɭ e̞ i ɕʰ j ʌ̹ n
인플루엔자	i n pʰ ɯ ɭ ɭ u e̞ n d͡ʑ a̠
일곱	i ɭ ɡ o̞ p̚
일군	i ɭ k͈ u n
일기	i ɭ ɡ i
일단	i ɭ t͈ a̠ n
일대일	i ɭ t͈ e̞ i ɭ
일반	i ɭ b a̠ n
일반인	i ɭ b a̠ n i n
일반적	i ɭ b a̠ n d͡ʑ ʌ̹ k̚
일보	i ɭ b o̞
일본	i ɭ b o̞ n
일본어	i ɭ b o̞ n ʌ̹
일본인	i ɭ b o̞ n i n
일부러	iː ɭ b u ɾ ʌ̹
일상	i ɭ sʰ a̠ ŋ
일왕	i ɾ w a̠ ŋ
일요일	i ɾ j o i ɭ
일정	i ɭ t͡ɕ͈ ʌ̹ ŋ
일주일	i ɭ t͡ɕ͈ u i ɭ
일찍	i ɭ t͡ɕ͈ i k̚
일찍이	i ɭ t͡ɕ͈ i ɡ i
일체	i ɭ t͡ɕʰ e̞
일화	i ɾ β w a̠
임대	iː m d e̞
임산부	iː m sʰ a̠ n b u
임시	i m ɕʰ i
임신	iː m ɕʰ i n
입구	i p̚ k͈ u
입다	i p̚ t͈ a̠
입대	i p̚ t͈ e̞
입력	i m ɲ j ʌ̹ k̚
입법	i p̚ p͈ ʌ̹ p̚
입시	i p ɕ͈ i
입장료	i p̚ t͡ɕ͈ a̠ ŋ ɲ j o
잇다	iː t̚ t͈ a̠
있다	i t̚ t͈ a̠
있어	i s͈ ʌ̹
잉글랜드	i ŋ ɡ ɯ ɭ ɭ e̞ n d ɯ
자격	t͡ɕ a̠ ɡ j ʌ̹ k̚
자궁	t͡ɕ a̠ ɡ u ŋ
자기	t͡ɕ a̠ ɡ i
자꾸	t͡ɕ a̠ k͈ u
자꾸만	t͡ɕ a̠ k͈ u m a̠ n
자네	t͡ɕ a̠ n e̞
자녀	t͡ɕ a̠ ɲ j ʌ̹
자동차	t͡ɕ a̠ d o̞ ŋ t͡ɕʰ a̠
자랑스럽다	t͡ɕ a̠ ɾ a̠ ŋ sʰ ɯ ɾ ʌ̹ p̚ t͈ a̠
자리	t͡ɕ a̠ ɾ i
자매	t͡ɕ a̠ m e̞
자본	t͡ɕ a̠ b o̞ n
자본주의	t͡ɕ a̠ b o̞ n d͡ʑ u ɰ i
자살	t͡ɕ a̠ sʰ a̠ ɭ
자선	t͡ɕ a̠ sʰ ʌ̹ n
자세	t͡ɕ a̠ sʰ e̞
자식	t͡ɕ a̠ ɕʰ i k̚
자신	t͡ɕ a̠ ɕʰ i n
자아	t͡ɕ a̠ a̠
자연	t͡ɕ a̠ j ʌ̹ n
자원	t͡ɕ a̠ w ʌ̹ n
자유	t͡ɕ a̠ j u
자의	t͡ɕ a̠ ɰ i
자전거	t͡ɕ a̠ d͡ʑ ʌ̹ n ɡ ʌ̹
자정	t͡ɕ a̠ d͡ʑ ʌ̹ ŋ
자존심	t͡ɕ a̠ d͡ʑ o̞ n ɕʰ i m
자주	t͡ɕ a̠ d͡ʑ u
자체	t͡ɕ a̠ t͡ɕʰ e̞
자치	t͡ɕ a̠ t͡ɕʰ i
자칫하면	t͡ɕ a̠ t͡ɕʰ i tʰ a̠ m j ʌ̹ n
자카르타	t͡ɕ a̠ kʰ a̠ ɾ ɯ tʰ a̠
자판기	t͡ɕ a̠ pʰ a̠ n ɡ i
작가	t͡ɕ a̠ k̚ k͈ a̠
작곡가	t͡ɕ a̠ k̚ k͈ o̞ k̚ k͈ a̠
작년	t͡ɕ a̠ ŋ ɲ j ʌ̹ n
작다	t͡ɕ a̠ː k̚ t͈ a̠
작동	t͡ɕ a̠ k̚ t͈ o̞ ŋ
작성	t͡ɕ a̠ k s͈ ʌ̹ ŋ
작업	t͡ɕ a̠ ɡ ʌ̹ p̚
작업복	t͡ɕ a̠ ɡ ʌ̹ p̚ p͈ o̞ k̚
작용	t͡ɕ a̠ ɡ j o ŋ
작은	t͡ɕ a̠ ɡ ɯ n
작품	t͡ɕ a̠ k̚ pʰ u m
잔디	t͡ɕ a̠ n d i
잔뜩	t͡ɕ a̠ n t͈ ɯ k̚
잔류	t͡ɕ a̠ ɭ ʎ j u
잔치	t͡ɕ a̠ n t͡ɕʰ i
잔혹	t͡ɕ a̠ n β o̞ k̚
잠깐	t͡ɕ a̠ m k͈ a̠ n
잠수함	t͡ɕ a̠ m sʰ u ɦ a̠ m
잠시	t͡ɕ a̠ː m ɕʰ i
잡지	t͡ɕ a̠ p̚ t͡ɕ͈ i
잡초	t͡ɕ a̠ p̚ t͡ɕʰ o̞
장갑	t͡ɕ a̠ː ŋ ɡ a̠ p̚
장과	t͡ɕ a̠ ŋ ɡ w a̠
장관	t͡ɕ a̠ː ŋ ɡ w a̠ n
장군	t͡ɕ a̠ ŋ ɡ u n
장기	t͡ɕ a̠ː ŋ ɡ i
장난	t͡ɕ a̠ ŋ n a̠ n
장난감	t͡ɕ a̠ ŋ n a̠ n k͈ a̠ m
장래	t͡ɕ a̠ ŋ n e̞
장례	t͡ɕ a̠ː ŋ ɲ j e̞
장르	t͡ɕ a̠ ŋ n ɯ
장비	t͡ɕ a̠ ŋ b i
장사	t͡ɕ a̠ ŋ sʰ a̠
장시	t͡ɕ a̠ ŋ ɕʰ i
장식	t͡ɕ a̠ ŋ ɕʰ i k̚
장애	t͡ɕ a̠ ŋ e̞
장인	t͡ɕ a̠ː ŋ i n
장치	t͡ɕ a̠ ŋ t͡ɕʰ i
장화	t͡ɕ a̠ ŋ β w a̠
잦다	t͡ɕ a̠ t̚ t͈ a̠
재규어	t͡ɕ e̞ ɡ j u ʌ̹
재능	t͡ɕ e̞ n ɯ ŋ
재미	t͡ɕ e̞ m i
재미없다	t͡ɕ e̞ m i ʌ̹ p̚ t͈ a̠
재미있다	t͡ɕ e̞ m i i t̚ t͈ a̠
재벌	t͡ɕ e̞ b ʌ̹ ɭ
재빨리	t͡ɕ e̞ p͈ a̠ ɭ ʎ i
재산	t͡ɕ e̞ sʰ a̠ n
재수	t͡ɕ e̞ sʰ u
재킷	t͡ɕ e̞ k ç i t̚
재판	t͡ɕ e̞ pʰ a̠ n
재판소	t͡ɕ e̞ pʰ a̠ n sʰ o̞
재해	t͡ɕ e̞ ɦ e̞
저곳	t͡ɕ ʌ̹ ɡ o̞ t̚
저녁	t͡ɕ ʌ̹ ɲ j ʌ̹ k̚
저런	t͡ɕ ʌ̹ ɾ ʌ̹ n
저렇게	t͡ɕ ʌ̹ ɾ ʌ̹ kʰ e̞
저수지	t͡ɕ ɘː sʰ u d͡ʑ i
저자	t͡ɕ ʌ̹ d͡ʑ a̠
저장	t͡ɕ ʌ̹ d͡ʑ a̠ ŋ
저절로	t͡ɕ ʌ̹ d͡ʑ ʌ̹ ɭ ɭ o̞
저주	t͡ɕ ɘː d͡ʑ u
저지	t͡ɕ ʌ̹ d͡ʑ i
저쪽	t͡ɕ ʌ̹ t͡ɕ͈ o̞ k̚
저항	t͡ɕ ɘː ɦ a̠ ŋ
저희	t͡ɕ ʌ̹ ʝ i
적극	t͡ɕ ʌ̹ k̚ k͈ ɯ k̚
적당	t͡ɕ ʌ̹ k̚ t͈ a̠ ŋ
적당하다	t͡ɕ ʌ̹ k̚ t͈ a̠ ŋ ɦ a̠ d a̠
적당히	t͡ɕ ʌ̹ k̚ t͈ a̠ ŋ ʝ i
적도	t͡ɕ ʌ̹ k̚ t͈ o̞
적어도	t͡ɕ ɘː ɡ ʌ̹ d o̞
적외선	t͡ɕ ʌ̹ ɡ w e̞ sʰ ʌ̹ n
적용	t͡ɕ ʌ̹ ɡ j o ŋ
전개	t͡ɕ ɘː n ɡ e̞
전국적	t͡ɕ ʌ̹ n ɡ u k̚ t͡ɕ͈ ʌ̹ k̚
전기	t͡ɕ ɘː n ɡ i
전날	t͡ɕ ʌ̹ n n a̠ ɭ
전도	t͡ɕ ʌ̹ n d o̞
전도사	t͡ɕ ʌ̹ n d o̞ sʰ a̠
전도서	t͡ɕ ʌ̹ n d o̞ sʰ ʌ̹
전라남도	t͡ɕ ʌ̹ ɭ ɭ a̠ n a̠ m d o̞
전라도	t͡ɕ ʌ̹ ɭ ɭ a̠ d o̞
전력	t͡ɕ ɘː ɭ ʎ j ʌ̹ k̚
전망	t͡ɕ ɘː n m a̠ ŋ
전모	t͡ɕ ʌ̹ n m o̞
전문	t͡ɕ ʌ̹ n m u n
전문가	t͡ɕ ʌ̹ n m u n ɡ a̠
전보	t͡ɕ ɘː n b o̞
전부	t͡ɕ ʌ̹ n b u
전사	t͡ɕ ɘː n sʰ a̠
전설	t͡ɕ ɘː n sʰ ʌ̹ ɭ
전술	t͡ɕ ɘː n sʰ u ɭ
전시	t͡ɕ ɘː n ɕʰ i
전시회	t͡ɕ ɘː n ɕʰ i β w e̞
전어	t͡ɕ ɘː n ʌ̹
전역	t͡ɕ ɘː ɲ j ʌ̹ k̚
전쟁	t͡ɕ ɘː n d͡ʑ e̞ ŋ
전지	t͡ɕ ɘː n d͡ʑ i
전철	t͡ɕ ɘː n t͡ɕʰ ʌ̹ ɭ
전체	t͡ɕ ʌ̹ n t͡ɕʰ e̞
전체주의	t͡ɕ ʌ̹ n t͡ɕʰ e̞ d͡ʑ u ɰ i
전통	t͡ɕ ʌ̹ n tʰ o̞ ŋ
전투	t͡ɕ ʌ̹ n tʰ u
전혀	t͡ɕ ʌ̹ n ʝ j ʌ̹
전화	t͡ɕ ɘː n β w a̠
전환	t͡ɕ ɘː n β w a̠ n
절대	t͡ɕ ʌ̹ ɭ t͈ e̞
절대적	t͡ɕ ʌ̹ ɭ t͈ e̞ d͡ʑ ʌ̹ k̚
절망	t͡ɕ ʌ̹ ɭ m a̠ ŋ
절반	t͡ɕ ʌ̹ ɭ b a̠ n
절차	t͡ɕ ʌ̹ ɭ t͡ɕʰ a̠
젊음	t͡ɕ ɘː ɭ m ɯ m
점검	t͡ɕ ʌ̹ m ɡ ʌ̹ m
점수	t͡ɕ ʌ̹ m s͈ u
점심	t͡ɕ ɘː m ɕʰ i m
점점	t͡ɕ ɘː m d͡ʑ ʌ̹ m
점차	t͡ɕ ɘː m t͡ɕʰ a̠
점포	t͡ɕ ɘː m pʰ o̞
점프	t͡ɕ ʌ̹ m pʰ ɯ
접근	t͡ɕ ʌ̹ p̚ k͈ ɯ n
접속	t͡ɕ ʌ̹ p s͈ o̞ k̚
접전	t͡ɕ ʌ̹ p̚ t͡ɕ͈ ʌ̹ n
정강이	t͡ɕ ʌ̹ ŋ ɡ a̠ ŋ i
정구	t͡ɕ ʌ̹ ŋ ɡ u
정규	t͡ɕ ʌ̹ ŋ ɡ j u
정글	t͡ɕ ʌ̹ ŋ ɡ ɯ ɭ
정기	t͡ɕ ɘː ŋ ɡ i
정도	t͡ɕ ʌ̹ ŋ d o̞
정류장	t͡ɕ ʌ̹ ŋ ɲ j u d͡ʑ a̠ ŋ
정리	t͡ɕ ʌ̹ ŋ n i
정말	t͡ɕ ɘː ŋ m a̠ ɭ
정말로	t͡ɕ ɘː ŋ m a̠ ɭ ɭ o̞
정보	t͡ɕ ʌ̹ ŋ b o̞
정비	t͡ɕ ɘː ŋ b i
정상회담	t͡ɕ ʌ̹ ŋ sʰ a̠ ŋ β w e̞ d a̠ m
정수리	t͡ɕ ʌ̹ ŋ sʰ u ɾ i
정식	t͡ɕ ɘː ŋ ɕʰ i k̚
정신적	t͡ɕ ʌ̹ ŋ ɕʰ i n d͡ʑ ʌ̹ k̚
정오	t͡ɕ ɘː ŋ o̞
정원	t͡ɕ ʌ̹ ŋ w ʌ̹ n
정유	t͡ɕ ʌ̹ ŋ j u
정은	t͡ɕ ɘː ŋ ɯ n
정장	t͡ɕ ɘː ŋ d͡ʑ a̠ ŋ
정적분	t͡ɕ ʌ̹ ŋ d͡ʑ ʌ̹ k̚ p͈ u n
정전	t͡ɕ ʌ̹ ŋ d͡ʑ ʌ̹ n
정조	t͡ɕ ʌ̹ ŋ d͡ʑ o̞
정직	t͡ɕ ɘː ŋ d͡ʑ i k̚
정책	t͡ɕ ɘː ŋ t͡ɕʰ e̞ k̚
정치가	t͡ɕ ʌ̹ ŋ t͡ɕʰ i ɡ a̠
정치권	t͡ɕ ʌ̹ ŋ t͡ɕʰ i k͈ w ʌ̹ n
정치인	t͡ɕ ʌ̹ ŋ t͡ɕʰ i i n
정치적	t͡ɕ ʌ̹ ŋ t͡ɕʰ i d͡ʑ ʌ̹ k̚
정치판	t͡ɕ ʌ̹ ŋ t͡ɕʰ i pʰ a̠ n
정확하다	t͡ɕ ɘː ŋ β w a̠ kʰ a̠ d a̠
정확히	t͡ɕ ɘː ŋ β w a̠ k ç i
정황	t͡ɕ ʌ̹ ŋ β w a̠ ŋ
제거	t͡ɕ e̞ ɡ ʌ̹
제공	t͡ɕ e̞ ɡ o̞ ŋ
제국주의	t͡ɕ e̞ː ɡ u k̚ t͡ɕ͈ u ɰ i
제네바	t͡ɕ e̞ n e̞ b a̠
제대	t͡ɕ e̞ d e̞
제대로	t͡ɕ e̞ d e̞ ɾ o̞
제로	t͡ɕ e̞ ɾ o̞
제명	t͡ɕ e̞ m j ʌ̹ ŋ
제목	t͡ɕ e̞ m o̞ k̚
제발	t͡ɕ e̞ː b a̠ ɭ
제보	t͡ɕ e̞ b o̞
제비	t͡ɕ e̞ b i
제사	t͡ɕ e̞ː sʰ a̠
제안	t͡ɕ e̞ a̠ n
제약	t͡ɕ e̞ː j a̠ k̚
제우스	t͡ɕ e̞ u sʰ ɯ
제의	t͡ɕ e̞ ɰ i
제일	t͡ɕ e̞ː i ɭ
제자	t͡ɕ e̞ː d͡ʑ a̠
제작	t͡ɕ e̞ː d͡ʑ a̠ k̚
제작자	t͡ɕ e̞ː d͡ʑ a̠ k̚ t͡ɕ͈ a̠
제재	t͡ɕ e̞ː d͡ʑ e̞
제조업	t͡ɕ e̞ː d͡ʑ o̞ ʌ̹ p̚
제주	t͡ɕ e̞ː d͡ʑ u
제주도	t͡ɕ e̞ː d͡ʑ u d o̞
제주어	t͡ɕ e̞ː d͡ʑ u ʌ̹
제출	t͡ɕ e̞ t͡ɕʰ u ɭ
제한	t͡ɕ e̞ː ɦ a̠ n
조각	t͡ɕ o̞ ɡ a̠ k̚
조개	t͡ɕ o̞ ɡ e̞
조계종	t͡ɕ o̞ ɡ j e̞ d͡ʑ o̞ ŋ
조금씩	t͡ɕ o̞ ɡ ɯ m ɕ͈ i k̚
조례	t͡ɕ o̞ ɾ j e̞
조류	t͡ɕ o̞ ɾ j u
조리	t͡ɕ o̞ ɾ i
조리개	t͡ɕ o̞ ɾ i ɡ e̞
조미료	t͡ɕ o̞ m i ɾ j o
조사	t͡ɕ o̞ sʰ a̠
조상	t͡ɕ o̞ sʰ a̠ ŋ
조선인	t͡ɕ o̞ sʰ ʌ̹ n i n
조성	t͡ɕ o̞ sʰ ʌ̹ ŋ
조심	t͡ɕ o̞ː ɕʰ i m
조심하다	t͡ɕ o̞ː ɕʰ i m ɦ a̠ d a̠
조약	t͡ɕ o̞ j a̠ k̚
조언	t͡ɕ o̞ː ʌ̹ n
조의	t͡ɕ o̞ ɰ i
조작	t͡ɕ o̞ː d͡ʑ a̠ k̚
조종사	t͡ɕ o̞ d͡ʑ o̞ ŋ sʰ a̠
조차	t͡ɕ o̞ t͡ɕʰ a̠
조치	t͡ɕ o̞ t͡ɕʰ i
조카	t͡ɕ o̞ kʰ a̠
조폭	t͡ɕ o̞ pʰ o̞ k̚
조합	t͡ɕ o̞ ɦ a̠ p̚
존재	t͡ɕ o̞ n d͡ʑ e̞
존중	t͡ɕ o̞ n d͡ʑ u ŋ
졸다	t͡ɕ o̞ː ɭ d a̠
졸업식	t͡ɕ o̞ ɾ ʌ̹ p ɕ͈ i k̚
좀비	t͡ɕ o̞ m b i
종교	t͡ɕ o̞ ŋ ɡ j o
종로	t͡ɕ o̞ ŋ n o̞
종료	t͡ɕ o̞ ŋ ɲ j o
종류	t͡ɕ o̞ː ŋ ɲ j u
종양	t͡ɕ o̞ː ŋ j a̠ ŋ
종업원	t͡ɕ o̞ ŋ ʌ̹ b w ʌ̹ n
종이	t͡ɕ o̞ ŋ i
종일	t͡ɕ o̞ ŋ i ɭ
종종	t͡ɕ o̞ ŋ d͡ʑ o̞ ŋ
종합	t͡ɕ o̞ ŋ ɦ a̠ p̚
좋다	t͡ɕ o̞ː tʰ a̠
좌우	t͡ɕ w a̠ː u
죄송	t͡ɕ w e̞ː sʰ o̞ ŋ
주거	t͡ɕ uː ɡ ʌ̹
주권	t͡ɕ u k͈ w ʌ̹ n
주말	t͡ɕ u m a̠ ɭ
주먹	t͡ɕ u m ʌ̹ k̚
주문	t͡ɕ uː m u n
주민	t͡ɕ uː m i n
주방	t͡ɕ u b a̠ ŋ
주변	t͡ɕ u b j ʌ̹ n
주부	t͡ɕ u b u
주석	t͡ɕ u sʰ ʌ̹ k̚
주소	t͡ɕ uː sʰ o̞
주스	t͡ɕ u sʰ ɯ
주식	t͡ɕ u ɕʰ i k̚
주연	t͡ɕ u j ʌ̹ n
주요	t͡ɕ u j o
주위	t͡ɕ u ɥ i
주인공	t͡ɕ u i n ɡ o̞ ŋ
주장	t͡ɕ u d͡ʑ a̠ ŋ
주제	t͡ɕ u d͡ʑ e̞
주중	t͡ɕ u d͡ʑ u ŋ
주차장	t͡ɕ uː t͡ɕʰ a̠ d͡ʑ a̠ ŋ
주체	t͡ɕ u t͡ɕʰ e̞
주택	t͡ɕ uː tʰ e̞ k̚
주황색	t͡ɕ u β w a̠ ŋ sʰ e̞ k̚
죽음	t͡ɕ u ɡ ɯ m
준비	t͡ɕ uː n b i
줄곧	t͡ɕ u ɭ ɡ o̞ t̚
줄기	t͡ɕ u ɭ ɡ i
줄몰개	t͡ɕ u ɭ m o̞ ɭ ɡ e̞
줄어들다	t͡ɕ u ɾ ʌ̹ d ɯ ɭ d a̠
중간	t͡ɕ u ŋ ɡ a̠ n
중계	t͡ɕ u ŋ ɡ j e̞
중공	t͡ɕ u ŋ ɡ o̞ ŋ
중국	t͡ɕ u ŋ ɡ u k̚
중국인	t͡ɕ u ŋ ɡ u ɡ i n
중대	t͡ɕ u ŋ d e̞
중도	t͡ɕ u ŋ d o̞
중독	t͡ɕ u ŋ d o̞ k̚
중동	t͡ɕ u ŋ d o̞ ŋ
중립	t͡ɕ u ŋ n i p̚
중부	t͡ɕ u ŋ b u
중순	t͡ɕ u ŋ sʰ u n
중앙	t͡ɕ u ŋ a̠ ŋ
중요	t͡ɕ uː ŋ j o
중요성	t͡ɕ uː ŋ j o sʰ ʌ̹ ŋ
중죄	t͡ɕ uː ŋ d͡ʑ w e̞
중학교	t͡ɕ u ŋ ɦ a̠ k̚ k͈ j o
중화민국	t͡ɕ u ŋ β w a̠ m i n ɡ u k̚
쥐다	t͡ɕ ɥ i d a̠
즉시	t͡ɕ ɯ k ɕ͈ i
즐거움	t͡ɕ ɯ ɭ ɡ ʌ̹ u m
증가	t͡ɕ ɯ ŋ ɡ a̠
증권	t͡ɕ ɯ ŋ k͈ w ʌ̹ n
증권사	t͡ɕ ɯ ŋ k͈ w ʌ̹ n sʰ a̠
증상	t͡ɕ ɯ ŋ sʰ a̠ ŋ
증인	t͡ɕ ɯ ŋ i n
증후군	t͡ɕ ɯ ŋ β u ɡ u n
지각	t͡ɕ i ɡ a̠ k̚
지갑	t͡ɕ i ɡ a̠ p̚
지구대	t͡ɕ i ɡ u d e̞
지구의	t͡ɕ i ɡ u ɰ i
지금	t͡ɕ i ɡ ɯ m
지난	t͡ɕ i n a̠ n
지난달	t͡ɕ i n a̠ n d a̠ ɭ
지난번	t͡ɕ i n a̠ n b ʌ̹ n
지난주	t͡ɕ i n a̠ n d͡ʑ u
지난해	t͡ɕ i n a̠ n ɦ e̞
지내다	t͡ɕ iː n e̞ d a̠
지능	t͡ɕ i n ɯ ŋ
지도	t͡ɕ i d o̞
지도자	t͡ɕ i d o̞ d͡ʑ a̠
지름	t͡ɕ i ɾ ɯ m
지명	t͡ɕ i m j ʌ̹ ŋ
지방	t͡ɕ i b a̠ ŋ
지불	t͡ɕ i b u ɭ
지사	t͡ɕ i sʰ a̠
지속적	t͡ɕ i sʰ o̞ k̚ t͡ɕ͈ ʌ̹ k̚
지시	t͡ɕ i ɕʰ i
지식	t͡ɕ i ɕʰ i k̚
지식인	t͡ɕ i ɕʰ i ɡ i n
지역	t͡ɕ i j ʌ̹ k̚
지원	t͡ɕ i w ʌ̹ n
지원자	t͡ɕ i w ʌ̹ n d͡ʑ a̠
지위	t͡ɕ i ɥ i
지중해	t͡ɕ i d͡ʑ u ŋ ɦ e̞
지지	t͡ɕ i d͡ʑ i
지지자	t͡ɕ i d͡ʑ i d͡ʑ a̠
지진	t͡ɕ i d͡ʑ i n
지질	t͡ɕ i d͡ʑ i ɭ
지출	t͡ɕ i t͡ɕʰ u ɭ
지키다	t͡ɕ i k ç i d a̠
지팡이	t͡ɕ i pʰ a̠ ŋ i
지퍼	t͡ɕ i pʰ ʌ̹
지폐	t͡ɕ i pʰ j e̞
지휘자	t͡ɕ i ɦ ɥ i d͡ʑ a̠
직물	t͡ɕ i ŋ m u ɭ
직업	t͡ɕ i ɡ ʌ̹ p̚
직위	t͡ɕ i ɡ ɥ i
직장	t͡ɕ i k̚ t͡ɕ͈ a̠ ŋ
직전	t͡ɕ i k̚ t͡ɕ͈ ʌ̹ n
직접적	t͡ɕ i k̚ t͡ɕ͈ ʌ̹ p̚ t͡ɕ͈ ʌ̹ k̚
진단	t͡ɕ iː n d a̠ n
진동수	t͡ɕ i n d o̞ ŋ sʰ u
진보	t͡ɕ iː n b o̞
진실	t͡ɕ i n ɕʰ i ɭ
진심	t͡ɕ i n ɕʰ i m
진원지	t͡ɕ i n w ʌ̹ n d͡ʑ i
진주	t͡ɕ i n d͡ʑ u
진짜	t͡ɕ i n t͡ɕ͈ a̠
진행	t͡ɕ iː n ɦ e̞ ŋ
진흙	t͡ɕ i n ɣ ɯ k̚
질서	t͡ɕ i ɭ s͈ ʌ̹
질소	t͡ɕ i ɭ sʰ o̞
질환	t͡ɕ i ɾ β w a̠ n
짐바브웨	t͡ɕ i m b a̠ b ɯ w e̞
짐승	t͡ɕ i m sʰ ɯ ŋ
집게	t͡ɕ i p̚ k͈ e̞
집단	t͡ɕ i p̚ t͈ a̠ n
집들	t͡ɕ i p̚ t͈ ɯ ɭ
집사람	t͡ɕ i p s͈ a̠ ɾ a̠ m
집안	t͡ɕ i b a̠ n
집중	t͡ɕ i p̚ t͡ɕ͈ u ŋ
집회	t͡ɕ i pʰ w e̞
징계	t͡ɕ i ŋ ɡ j e̞
짙다	t͡ɕ i t̚ t͈ a̠
짝사랑	t͡ɕ͈ a̠ k s͈ a̠ ɾ a̠ ŋ
짧다	t͡ɕ͈ a̠ ɭ t͈ a̠
찍다	t͡ɕ͈ i k̚ t͈ a̠
찜질방	t͡ɕ͈ i m d͡ʑ i ɭ b a̠ ŋ
차고	t͡ɕʰ a̠ ɡ o̞
차다	t͡ɕʰ a̠ d a̠
차드	t͡ɕʰ a̠ d ɯ
차라리	t͡ɕʰ a̠ ɾ a̠ ɾ i
차량	t͡ɕʰ a̠ ɾ j a̠ ŋ
차례	t͡ɕʰ a̠ ɾ j e̞
차례차례	t͡ɕʰ a̠ ɾ j e̞ t͡ɕʰ a̠ ɾ j e̞
차원	t͡ɕʰ a̠ w ʌ̹ n
차이	t͡ɕʰ a̠ i
차이니스	t͡ɕʰ a̠ i n i sʰ ɯ
차츰	t͡ɕʰ a̠ t͡ɕʰ ɯ m
차트	t͡ɕʰ a̠ tʰ ɯ
착각	t͡ɕʰ a̠ k̚ k͈ a̠ k̚
찬사	t͡ɕʰ a̠ː n sʰ a̠
참가	t͡ɕʰ a̠ m ɡ a̠
참고	t͡ɕʰ a̠ m ɡ o̞
참고서	t͡ɕʰ a̠ m ɡ o̞ sʰ ʌ̹
창고	t͡ɕʰ a̠ ŋ k͈ o̞
창문	t͡ɕʰ a̠ ŋ m u n
창원	t͡ɕʰ a̠ ŋ w ʌ̹ n
창조적	t͡ɕʰ a̠ː ŋ d͡ʑ o̞ d͡ʑ ʌ̹ k̚
찾다	t͡ɕʰ a̠ t̚ t͈ a̠
채널	t͡ɕʰ e̞ n ʌ̹ ɭ
채소	t͡ɕʰ e̞ː sʰ o̞
채우다	t͡ɕʰ e̞ u d a̠
채팅	t͡ɕʰ e̞ tʰ i ŋ
책들	t͡ɕʰ e̞ k̚ t͈ ɯ ɭ
책상	t͡ɕʰ e̞ k s͈ a̠ ŋ
책임자	t͡ɕʰ e̞ ɡ i m d͡ʑ a̠
책장	t͡ɕʰ e̞ k̚ t͡ɕ͈ a̠ ŋ
챌린지	t͡ɕʰ e̞ ɭ ʎ i n d͡ʑ i
챔피언	t͡ɕʰ e̞ m pʰ i ʌ̹ n
처남	t͡ɕʰ ʌ̹ n a̠ m
처럼	t͡ɕʰ ʌ̹ ɾ ʌ̹ m
처리	t͡ɕʰ ɘː ɾ i
처방	t͡ɕʰ ʌ̹ b a̠ ŋ
처벌	t͡ɕʰ ɘː b ʌ̹ ɭ
처음	t͡ɕʰ ʌ̹ ɯ m
척수	t͡ɕʰ ʌ̹ k s͈ u
척추	t͡ɕʰ ʌ̹ k̚ t͡ɕʰ u
천당	t͡ɕʰ ʌ̹ n d a̠ ŋ
천도	t͡ɕʰ ɘː n d o̞
천둥	t͡ɕʰ ʌ̹ n d u ŋ
천만	t͡ɕʰ ʌ̹ n m a̠ n
천사	t͡ɕʰ ʌ̹ n sʰ a̠
천적	t͡ɕʰ ʌ̹ n d͡ʑ ʌ̹ k̚
천지	t͡ɕʰ ʌ̹ n d͡ʑ i
천지인	t͡ɕʰ ʌ̹ n d͡ʑ i i n
천체	t͡ɕʰ ʌ̹ n t͡ɕʰ e̞
철갑	t͡ɕʰ ʌ̹ ɭ ɡ a̠ p̚
철도	t͡ɕʰ ʌ̹ ɭ t͈ o̞
철밥통	t͡ɕʰ ʌ̹ ɭ b a̠ p̚ tʰ o̞ ŋ
철저하다	t͡ɕʰ ʌ̹ ɭ t͡ɕ͈ ʌ̹ ɦ a̠ d a̠
철저히	t͡ɕʰ ʌ̹ ɭ t͡ɕ͈ ʌ̹ ʝ i
철판	t͡ɕʰ ʌ̹ ɭ pʰ a̠ n
철폐	t͡ɕʰ ʌ̹ ɭ pʰ j e̞
첨가물	t͡ɕʰ ʌ̹ m ɡ a̠ m u ɭ
첫날	t͡ɕʰ ʌ̹ n n a̠ ɭ
첫사랑	t͡ɕʰ ʌ̹ t̚ s͈ a̠ ɾ a̠ ŋ
첫째	t͡ɕʰ ʌ̹ t̚ t͡ɕ͈ e̞
청각	t͡ɕʰ ʌ̹ ŋ ɡ a̠ k̚
청국장	t͡ɕʰ ʌ̹ ŋ ɡ u k̚ t͡ɕ͈ a̠ ŋ
청바지	t͡ɕʰ ʌ̹ ŋ b a̠ d͡ʑ i
청소년	t͡ɕʰ ʌ̹ ŋ sʰ o̞ ɲ j ʌ̹ n
청와대	t͡ɕʰ ʌ̹ ŋ w a̠ d e̞
청춘	t͡ɕʰ ʌ̹ ŋ t͡ɕʰ u n
체내	t͡ɕʰ e̞ n e̞
체력	t͡ɕʰ e̞ ɾ j ʌ̹ k̚
체리	t͡ɕʰ e̞ ɾ i
체육	t͡ɕʰ e̞ j u k̚
체육관	t͡ɕʰ e̞ j u k̚ k͈ w a̠ n
체제	t͡ɕʰ e̞ d͡ʑ e̞
체조	t͡ɕʰ e̞ d͡ʑ o̞
체질	t͡ɕʰ e̞ d͡ʑ i ɭ
체코	t͡ɕʰ e̞ kʰ o̞
체포	t͡ɕʰ e̞ pʰ o̞
체험	t͡ɕʰ e̞ ɦ ʌ̹ m
체형	t͡ɕʰ e̞ ʝ j ʌ̹ ŋ
쳐다보다	t͡ɕʰ j ɘː d a̠ b o̞ d a̠
초고속	t͡ɕʰ o̞ ɡ o̞ sʰ o̞ k̚
초대	t͡ɕʰ o̞ d e̞
초대형	t͡ɕʰ o̞ d e̞ ʝ j ʌ̹ ŋ
초록색	t͡ɕʰ o̞ ɾ o̞ k s͈ e̞ k̚
초반	t͡ɕʰ o̞ b a̠ n
초상	t͡ɕʰ o̞ sʰ a̠ ŋ
초신성	t͡ɕʰ o̞ː ɕʰ i n sʰ ʌ̹ ŋ
초원	t͡ɕʰ o̞ w ʌ̹ n
초음파	t͡ɕʰ o̞ ɯ m pʰ a̠
초점	t͡ɕʰ o̞ t͡ɕ͈ ʌ̹ m
초콜릿	t͡ɕʰ o̞ kʰ o̞ ɭ ʎ i t̚
촉각	t͡ɕʰ o̞ k̚ k͈ a̠ k̚
총알	t͡ɕʰ o̞ ŋ a̠ ɭ
총영사관	t͡ɕʰ o̞ ŋ j ʌ̹ ŋ sʰ a̠ ɡ w a̠ n
총장	t͡ɕʰ o̞ː ŋ d͡ʑ a̠ ŋ
촬영	t͡ɕʰ w a̠ ɾ j ʌ̹ ŋ
최강	t͡ɕʰ w e̞ː ɡ a̠ ŋ
최근	t͡ɕʰ w e̞ː ɡ ɯ n
최대	t͡ɕʰ w e̞ː d e̞
최대한	t͡ɕʰ w e̞ː d e̞ ɦ a̠ n
최소한	t͡ɕʰ w e̞ː sʰ o̞ ɦ a̠ n
최종	t͡ɕʰ w e̞ː d͡ʑ o̞ ŋ
최초	t͡ɕʰ w e̞ː t͡ɕʰ o̞
추가	t͡ɕʰ u ɡ a̠
추격	t͡ɕʰ u ɡ j ʌ̹ k̚
추구	t͡ɕʰ u ɡ u
추락	t͡ɕʰ u ɾ a̠ k̚
추석	t͡ɕʰ u sʰ ʌ̹ k̚
추억	t͡ɕʰ u ʌ̹ k̚
추위	t͡ɕʰ u ɥ i
추진	t͡ɕʰ u d͡ʑ i n
추천	t͡ɕʰ u t͡ɕʰ ʌ̹ n
축구	t͡ɕʰ u k̚ k͈ u
축사	t͡ɕʰ u k s͈ a̠
축제	t͡ɕʰ u k̚ t͡ɕ͈ e̞
출구	t͡ɕʰ u ɭ ɡ u
출생	t͡ɕʰ u ɭ s͈ e̞ ŋ
출석	t͡ɕʰ u ɭ s͈ ʌ̹ k̚
출신	t͡ɕʰ u ɭ ɕ͈ i n
출연	t͡ɕʰ u ɾ j ʌ̹ n
출장	t͡ɕʰ u ɭ t͡ɕ͈ a̠ ŋ
춤추다	t͡ɕʰ u m t͡ɕʰ u d a̠
춥다	t͡ɕʰ u p̚ t͈ a̠
충격	t͡ɕʰ u ŋ ɡ j ʌ̹ k̚
충돌	t͡ɕʰ u ŋ d o̞ ɭ
충분하다	t͡ɕʰ u ŋ b u n ɦ a̠ d a̠
충분히	t͡ɕʰ u ŋ b u n ʝ i
충성	t͡ɕʰ u ŋ sʰ ʌ̹ ŋ
충청북도	t͡ɕʰ u ŋ t͡ɕʰ ʌ̹ ŋ b u k̚ t͈ o̞
취급	t͡ɕʰ ɥ i ɡ ɯ p̚
취나물	t͡ɕʰ ɥ i n a̠ m u ɭ
취직	t͡ɕʰ ɥ iː d͡ʑ i k̚
취향	t͡ɕʰ ɥ iː ʝ j a̠ ŋ
치는	t͡ɕʰ i n ɯ n
치료	t͡ɕʰ i ɾ j o
치마	t͡ɕʰ i m a̠
치아	t͡ɕʰ i a̠
치안	t͡ɕʰ i a̠ n
치즈	t͡ɕʰ i d͡ʑ ɯ
치킨	t͡ɕʰ i k ç i n
친구	t͡ɕʰ i n ɡ u
친척	t͡ɕʰ i n t͡ɕʰ ʌ̹ k̚
칠레	t͡ɕʰ i ɭ ɭ e̞
침공	t͡ɕʰ iː m ɡ o̞ ŋ
침대	t͡ɕʰ iː m d e̞
침략	t͡ɕʰ iː m ɲ j a̠ k̚
침묵	t͡ɕʰ i m m u k̚
침실	t͡ɕʰ iː m ɕʰ i ɭ
침입	t͡ɕʰ iː m i p̚
카드	kʰ a̠ d ɯ
카드뮴	kʰ a̠ d ɯ m j u m
카란	kʰ a̠ ɾ a̠ n
카메라	kʰ a̠ m e̞ ɾ a̠
카메룬	kʰ a̠ m e̞ ɾ u n
카불	kʰ a̠ b u ɭ
카운터	kʰ a̠ u n tʰ ʌ̹
카지노	kʰ a̠ d͡ʑ i n o̞
카타르	kʰ a̠ tʰ a̠ ɾ ɯ
카트	kʰ a̠ tʰ ɯ
카페	k͈ a̠ pʰ e̞
카페인	kʰ a̠ pʰ e̞ i n
칵테일	kʰ a̠ k̚ tʰ e̞ i ɭ
칼날	kʰ a̠ ɭ ɭ a̠ ɭ
칼라	kʰ a̠ ɭ ɭ a̠
칼럼	kʰ a̠ ɭ ɭ ʌ̹ m
칼슘	kʰ a̠ ɭ ɕʰ j u m
캄보디아	kʰ a̠ m b o̞ d i a̠
캐나다	kʰ e̞ n a̠ d a̠
캐릭터	kʰ e̞ ɾ i k̚ tʰ ʌ̹
캐스팅	kʰ e̞ sʰ ɯ tʰ i ŋ
캔디	kʰ e̞ n d i
캠퍼스	kʰ e̞ m pʰ ʌ̹ sʰ ɯ
캠페인	kʰ e̞ m pʰ e̞ i n
커뮤니티	kʰ ʌ̹ m j u n i tʰ i
커서	kʰ ʌ̹ sʰ ʌ̹
커플	kʰ ʌ̹ pʰ ɯ ɭ
커피	kʰ ʌ̹ pʰ i
커피숍	kʰ ʌ̹ pʰ i ɕʰ j o p̚
컴퓨터	kʰ ʌ̹ m pʰ j u tʰ ʌ̹
케냐	kʰ e̞ ɲ j a̠
케이블	kʰ e̞ i b ɯ ɭ
코끼리	kʰ o̞ k͈ i ɾ i
코너	kʰ o̞ n ʌ̹
코발트	kʰ o̞ b a̠ ɭ tʰ ɯ
코소보	kʰ o̞ sʰ o̞ b o̞
코스	kʰ o̞ sʰ ɯ
코치	kʰ o̞ t͡ɕʰ i
코트	kʰ o̞ tʰ ɯ
콘서트	kʰ o̞ n sʰ ʌ̹ tʰ ɯ
콘크리트	kʰ o̞ n k x ɯ ɾ i tʰ ɯ
콜레스테롤	kʰ o̞ ɭ ɭ e̞ sʰ ɯ tʰ e̞ ɾ o̞ ɭ
콜카타	kʰ o̞ ɭ kʰ a̠ tʰ a̠
콤플렉스	kʰ o̞ m pʰ ɯ ɭ ɭ e̞ k s͈ ɯ
콩나물	kʰ o̞ ŋ n a̠ m u ɭ
쿠데타	kʰ u d e̞ tʰ a̠
쿠바	kʰ u b a̠
쿠션	kʰ u ɕʰ j ʌ̹ n
쿠웨이트	kʰ u w e̞ i tʰ ɯ
쿠키	kʰ u k ç i
쿨라크	kʰ u ɭ ɭ a̠ k x ɯ
퀴즈	kʰ ɥ i d͡ʑ ɯ
크다	k x ɯ d a̠
크레디트	k x ɯ ɾ e̞ d i tʰ ɯ
크레파스	k x ɯ ɾ e̞ pʰ a̠ sʰ ɯ
크롬	k x ɯ ɾ o̞ m
크리스마스	k x ɯ ɾ i sʰ ɯ m a̠ sʰ ɯ
큰일	k x ɯ n n i ɭ
클래스	k x ɯ ɭ ɭ e̞ sʰ ɯ
클럽	k x ɯ ɭ ɭ ʌ̹ p̚
키다리	k ç i d a̠ ɾ i
키보드	k ç i b o̞ d ɯ
키스	k ç i sʰ ɯ
킬로그램	k ç i ɭ ɭ o̞ ɡ ɯ ɾ e̞ m
타이	tʰ a̠ i
타이어	tʰ a̠ i ʌ̹
타이틀곡	tʰ a̠ i tʰ ɯ ɭ ɡ o̞ k̚
타이페이	tʰ a̠ i pʰ e̞ i
타입	tʰ a̠ i p̚
타조	tʰ a̠ː d͡ʑ o̞
탁자	tʰ a̠ k̚ t͡ɕ͈ a̠
탄도	tʰ a̠ː n d o̞
탄소	tʰ a̠ː n sʰ o̞
탄수화물	tʰ a̠ː n sʰ u β w a̠ m u ɭ
탄자니아	tʰ a̠ n d͡ʑ a̠ n i a̠
탄핵	tʰ a̠ː n ɦ e̞ k̚
탈락	tʰ a̠ ɭ ɭ a̠ k̚
탈북자	tʰ a̠ ɭ b u k̚ t͡ɕ͈ a̠
탈의실	tʰ a̠ ɾ ɰ i ɕʰ i ɭ
탐사	tʰ a̠ m sʰ a̠
탐험	tʰ a̠ m ɦ ʌ̹ m
탐험가	tʰ a̠ m ɦ ʌ̹ m ɡ a̠
태국	tʰ e̞ ɡ u k̚
태권도	tʰ e̞ k͈ w ʌ̹ n d o̞
태극	tʰ e̞ ɡ ɯ k̚
태극기	tʰ e̞ ɡ ɯ k̚ k͈ i
태도	tʰ e̞ː d o̞
태양	tʰ e̞ j a̠ ŋ
태우다	tʰ e̞ u d a̠
택배	tʰ e̞ k̚ p͈ e̞
택시	tʰ e̞ k ɕ͈ i
탤런트	tʰ e̞ ɭ ɭ ʌ̹ n tʰ ɯ
탱크	tʰ e̞ ŋ k x ɯ
터널	tʰ ʌ̹ n ʌ̹ ɭ
텅스텐	tʰ ʌ̹ ŋ sʰ ɯ tʰ e̞ n
테니스	tʰ e̞ n i sʰ ɯ
테러	tʰ e̞ ɾ ʌ̹
테러리스트	tʰ e̞ ɾ ʌ̹ ɾ i sʰ ɯ tʰ ɯ
테스트	tʰ e̞ sʰ ɯ tʰ ɯ
테이블	tʰ e̞ i b ɯ ɭ
테이프	tʰ e̞ i pʰ ɯ
텍스트	tʰ e̞ k s͈ ɯ tʰ ɯ
텔레비전	tʰ e̞ ɭ ɭ e̞ b i d͡ʑ ʌ̹ n
토끼	tʰ o̞ k͈ i
토네이도	tʰ o̞ n e̞ i d o̞
토대	tʰ o̞ d e̞
토론	tʰ o̞ː ɾ o̞ n
토론토	tʰ o̞ ɾ o̞ n tʰ o̞
토마스	tʰ o̞ m a̠ sʰ ɯ
토요일	tʰ o̞ j o i ɭ
토지	tʰ o̞ d͡ʑ i
토하다	tʰ o̞ː ɦ a̠ d a̠
통계	tʰ o̞ː ŋ ɡ j e̞
통상	tʰ o̞ ŋ sʰ a̠ ŋ
통신	tʰ o̞ ŋ ɕʰ i n
통일	tʰ o̞ː ŋ i ɭ
통조림	tʰ o̞ ŋ d͡ʑ o̞ ɾ i m
통증	tʰ o̞ː ŋ d͡ʑ ɯ ŋ
통지	tʰ o̞ ŋ d͡ʑ i
통화	tʰ o̞ ŋ β w a̠
퇴근	tʰ w e̞ː ɡ ɯ n
퇴직금	tʰ w e̞ː d͡ʑ i k̚ k͈ ɯ m
퇴진	tʰ w e̞ː d͡ʑ i n
투기	tʰ u ɡ i
투명	tʰ u m j ʌ̹ ŋ
투발루	tʰ u b a̠ ɭ ɭ u
투자	tʰ u d͡ʑ a̠
투쟁	tʰ u d͡ʑ e̞ ŋ
트러스트	tʰ ɯ ɾ ʌ̹ sʰ ɯ tʰ ɯ
트럭	tʰ ɯ ɾ ʌ̹ k̚
트럼펫	tʰ ɯ ɾ ʌ̹ m pʰ e̞ t̚
트레이너	tʰ ɯ ɾ e̞ i n ʌ̹
트로트	tʰ ɯ ɾ o̞ tʰ ɯ
트로피	tʰ ɯ ɾ o̞ pʰ i
트리니다드	tʰ ɯ ɾ i n i d a̠ d ɯ
특권	tʰ ɯ k̚ k͈ w ʌ̹ n
특별	tʰ ɯ k̚ p͈ j ʌ̹ ɭ
특별하다	tʰ ɯ k̚ p͈ j ʌ̹ ɾ ɦ a̠ d a̠
특별히	tʰ ɯ k̚ p͈ j ʌ̹ ɾ ʝ i
특성	tʰ ɯ k s͈ ʌ̹ ŋ
특수	tʰ ɯ k s͈ u
특정	tʰ ɯ k̚ t͡ɕ͈ ʌ̹ ŋ
특징	tʰ ɯ k̚ t͡ɕ͈ i ŋ
특히	tʰ ɯ k ç i
틀림없다	tʰ ɯ ɭ ʎ i m ʌ̹ p̚ t͈ a̠
티베트	tʰ i b e̞ tʰ ɯ
티켓	tʰ i kʰ e̞ t̚
파괴	pʰ a̠ː ɡ w e̞
파나마	pʰ a̠ n a̠ m a̠
파동	pʰ a̠ d o̞ ŋ
파라과이	pʰ a̠ ɾ a̠ ɡ w a̠ i
파라솔	pʰ a̠ ɾ a̠ sʰ o̞ ɭ
파문	pʰ a̠ː m u n
파벌	pʰ a̠ b ʌ̹ ɭ
파산	pʰ a̠ː sʰ a̠ n
파업	pʰ a̠ː ʌ̹ p̚
파운데이션	pʰ a̠ u n d e̞ i ɕʰ j ʌ̹ n
파운드	pʰ a̠ u n d ɯ
파이팅	pʰ a̠ i tʰ i ŋ
파일	pʰ a̠ i ɭ
파장	pʰ a̠ d͡ʑ a̠ ŋ
파출소	pʰ a̠ t͡ɕʰ u ɭ sʰ o̞
파키스탄	pʰ a̠ k ç i sʰ ɯ tʰ a̠ n
파트너	pʰ a̠ tʰ ɯ n ʌ̹
파티	pʰ a̠ tʰ i
파파라치	pʰ a̠ pʰ a̠ ɾ a̠ t͡ɕʰ i
파피루스	pʰ a̠ pʰ i ɾ u sʰ ɯ
판단	pʰ a̠ n d a̠ n
판도라	pʰ a̠ n d o̞ ɾ a̠
판매원	pʰ a̠ n m e̞ w ʌ̹ n
판매점	pʰ a̠ n m e̞ d͡ʑ ʌ̹ m
판문점	pʰ a̠ n m u n d͡ʑ ʌ̹ m
판소리	pʰ a̠ n s͈ o̞ ɾ i
팔꿈치	pʰ a̠ ɭ k͈ u m t͡ɕʰ i
팔뚝	pʰ a̠ ɭ t͈ u k̚
패배	pʰ e̞ː b e̞
패션	pʰ e̞ ɕʰ j ʌ̹ n
페놀	pʰ e̞ n o̞ ɭ
페달	pʰ e̞ d a̠ ɭ
페루	pʰ e̞ ɾ u
페인트	pʰ e̞ i n tʰ ɯ
펩티드	pʰ e̞ p̚ tʰ i d ɯ
펴다	pʰ j ʌ̹ d a̠
편도	pʰ j ʌ̹ n d o̞
편의	pʰ j ʌ̹ n ɰ i
편의점	pʰ j ʌ̹ n ɰ i d͡ʑ ʌ̹ m
편자	pʰ j ʌ̹ n d͡ʑ a̠
편지	pʰ j ɘː n d͡ʑ i
편집	pʰ j ʌ̹ n d͡ʑ i p̚
편집자	pʰ j ʌ̹ n d͡ʑ i p̚ t͡ɕ͈ a̠
편하다	pʰ j ʌ̹ n ɦ a̠ d a̠
평가	pʰ j ɘː ŋ k͈ a̠
평생	pʰ j ʌ̹ ŋ sʰ e̞ ŋ
평소	pʰ j ʌ̹ ŋ sʰ o̞
평양	pʰ j ʌ̹ ŋ j a̠ ŋ
평일	pʰ j ʌ̹ ŋ i ɭ
평창	pʰ j ʌ̹ ŋ t͡ɕʰ a̠ ŋ
평화	pʰ j ʌ̹ ŋ β w a̠
폐기종	pʰ j e̞ː ɡ i d͡ʑ o̞ ŋ
폐단	pʰ j e̞ː d a̠ n
폐렴	pʰ j e̞ː ɾ j ʌ̹ m
포도당	pʰ o̞ d o̞ d a̠ ŋ
포도주	pʰ o̞ d o̞ d͡ʑ u
포럼	pʰ o̞ ɾ ʌ̹ m
포르투갈	pʰ o̞ ɾ ɯ tʰ u ɡ a̠ ɭ
포스터	pʰ o̞ sʰ ɯ tʰ ʌ̹
포크	pʰ o̞ k x ɯ
포털	pʰ o̞ tʰ ʌ̹ ɭ
포트	pʰ o̞ tʰ ɯ
포피	pʰ o̞ pʰ i
폭격기	pʰ o̞ k̚ k͈ j ʌ̹ k̚ k͈ i
폭군	pʰ o̞ k̚ k͈ u n
폭동	pʰ o̞ k̚ t͈ o̞ ŋ
폭발	pʰ o̞ k̚ p͈ a̠ ɭ
폭발물	pʰ o̞ k̚ p͈ a̠ ɭ m u ɭ
폭포	pʰ o̞ k̚ pʰ o̞
폭행	pʰ o̞ kʰ e̞ ŋ
폴더	pʰ o̞ ɭ d ʌ̹
폴란드	pʰ o̞ ɭ ɭ a̠ n d ɯ
표면	pʰ j o m j ʌ̹ n
표절	pʰ j o d͡ʑ ʌ̹ ɭ
표준	pʰ j o d͡ʑ u n
표준화	pʰ j oː d͡ʑ u n β w a̠
표현	pʰ j o ʝ j ʌ̹ n
품목	pʰ uː m m o̞ k̚
품질	pʰ uː m d͡ʑ i ɭ
풍선	pʰ u ŋ sʰ ʌ̹ n
프놈펜	pʰ ɯ n o̞ m pʰ e̞ n
프랑스	pʰ ɯ ɾ a̠ ŋ sʰ ɯ
프러포즈	pʰ ɯ ɾ ʌ̹ pʰ o̞ d͡ʑ ɯ
프런트	pʰ ɯ ɾ ʌ̹ n tʰ ɯ
프레젠테이션	pʰ ɯ ɾ e̞ d͡ʑ e̞ n tʰ e̞ i ɕʰ j ʌ̹ n
프로	pʰ ɯ ɾ o̞
프로그램	pʰ ɯ ɾ o̞ ɡ ɯ ɾ e̞ m
프로세서	pʰ ɯ ɾ o̞ sʰ e̞ sʰ ʌ̹
프로세스	pʰ ɯ ɾ o̞ sʰ e̞ sʰ ɯ
프로젝트	pʰ ɯ ɾ o̞ d͡ʑ e̞ k̚ tʰ ɯ
프로펠러	pʰ ɯ ɾ o̞ pʰ e̞ ɭ ɭ ʌ̹
플라스틱	pʰ ɯ ɭ ɭ a̠ sʰ ɯ tʰ i k̚
플랫폼	pʰ ɯ ɭ ɭ e̞ t̚ pʰ o̞ m
플루토늄	pʰ ɯ ɭ ɭ u tʰ o̞ ɲ j u m
피난	pʰ iː n a̠ n
피다	pʰ i d a̠
피라미드	pʰ i ɾ a̠ m i d ɯ
피로	pʰ i ɾ o̞
피부	pʰ i b u
피시	pʰ i ɕ͈ i
피아노	pʰ i a̠ n o̞
피지	pʰ i d͡ʑ i
피트	pʰ i tʰ ɯ
피해자	pʰ iː ɦ e̞ d͡ʑ a̠
핀란드	pʰ i ɭ ɭ a̠ n d ɯ
필름	pʰ i ɭ ɭ ɯ m
필리핀	pʰ i ɭ ʎ i pʰ i n
필수	pʰ i ɭ sʰ u
필수적	pʰ i ɭ s͈ u d͡ʑ ʌ̹ k̚
필승	pʰ iː ɭ sʰ ɯ ŋ
필요	pʰ i ɾ j o
필요하다	pʰ i ɾ j o ɦ a̠ d a̠
하긴	h a̠ ɡ i n
하나	h a̠ n a̠
하남	h a̠ n a̠ m
하노이	h a̠ n o̞ i
하늘	h a̠ n ɯ ɭ
하다	h a̠ d a̠
하도	h a̠ d o̞
하루	h a̠ ɾ u
하룻밤	h a̠ ɾ u t̚ p͈ a̠ m
하양	h a̠ j a̠ ŋ
하얼빈	h a̠ ʌ̹ ɭ b i n
하원	h a̠ː w ʌ̹ n
하인	h a̠ː i n
하지만	h a̠ d͡ʑ i m a̠ n
하천	h a̠ t͡ɕʰ ʌ̹ n
하프	h a̠ pʰ ɯ
하하	h a̠ ɦ a̠
학교	h a̠ k̚ k͈ j o
학급	h a̠ k̚ k͈ ɯ p̚
학기	h a̠ k̚ k͈ i
학문	h a̠ ŋ m u n
학번	h a̠ k̚ p͈ ʌ̹ n
학부	h a̠ k̚ p͈ u
학사	h a̠ k s͈ a̠
학살	h a̠ k s͈ a̠ ɭ
학생	h a̠ k s͈ e̞ ŋ
학술	h a̠ k s͈ u ɭ
학습	h a̠ k s͈ ɯ p̚
학원	h a̠ ɡ w ʌ̹ n
학자	h a̠ k̚ t͡ɕ͈ a̠
한가운데	h a̠ n ɡ a̠ u n d e̞
한가위	h a̠ n ɡ a̠ ɥ i
한겨레	h a̠ n ɡ j ʌ̹ ɾ e̞
한국말	h a̠ː n ɡ u ŋ m a̠ ɭ
한국어	h a̠ː n ɡ u ɡ ʌ̹
한국인	h a̠ n ɡ u ɡ i n
한글	h a̠ː n ɡ ɯ ɭ
한꺼번에	h a̠ n k͈ ʌ̹ b ʌ̹ n e̞
한동안	h a̠ n d o̞ ŋ a̠ n
한두	h a̠ n d u
한때	h a̠ n t͈ e̞
한마디	h a̠ n m a̠ d i
한물	h a̠ n m u ɭ
한반도	h a̠ n b a̠ n d o̞
한번	h a̠ n b ʌ̹ n
한복	h a̠ n b o̞ k̚
한숨	h a̠ n sʰ u m
한여름	h a̠ n ɲ j ʌ̹ ɾ ɯ m
한자	h a̠ː n t͡ɕ͈ a̠
한족	h a̠ː n d͡ʑ o̞ k̚
한중	h a̠ː n d͡ʑ u ŋ
한쪽	h a̠ n t͡ɕ͈ o̞ k̚
한편	h a̠ n pʰ j ʌ̹ n
할머니	h a̠ ɭ m ʌ̹ n i
할인	h a̠ ɾ i n
함께	h a̠ m k͈ e̞
함부로	h a̠ m b u ɾ o̞
합격	h a̠ p̚ k͈ j ʌ̹ k̚
합금	h a̠ p̚ k͈ ɯ m
합리적	h a̠ m n i d͡ʑ ʌ̹ k̚
합의	h a̠ b ɰ i
합창단	h a̠ p̚ t͡ɕʰ a̠ ŋ d a̠ n
핫라인	h a̠ n n a̠ i n
항공기	h a̠ː ŋ ɡ o̞ ŋ ɡ i
항공사	h a̠ː ŋ ɡ o̞ ŋ sʰ a̠
항목	h a̠ː ŋ m o̞ k̚
항문	h a̠ ŋ m u n
항상	h a̠ ŋ sʰ a̠ ŋ
항생제	h a̠ː ŋ sʰ e̞ ŋ d͡ʑ e̞
항성	h a̠ ŋ sʰ ʌ̹ ŋ
해결	h e̞ː ɡ j ʌ̹ ɭ
해고	h e̞ː ɡ o̞
해남	h e̞ n a̠ m
해당	h e̞ d a̠ ŋ
해도	h e̞ː d o̞
해마다	h e̞ m a̠ d a̠
해발	h e̞ː b a̠ ɭ
해방	h e̞ː b a̠ ŋ
해변	h e̞ː b j ʌ̹ n
해병	h e̞ː b j ʌ̹ ŋ
해부학	h e̞ː b u ɦ a̠ k̚
해산물	h e̞ sʰ a̠ n m u ɭ
해안	h e̞ː a̠ n
해양	h e̞ː j a̠ ŋ
해외	h e̞ː w e̞
해요체	h e̞ j o t͡ɕʰ e̞
해적	h e̞ d͡ʑ ʌ̹ k̚
해질녘	h e̞ d͡ʑ i ɭ ʎ j ʌ̹ k̚
해체	h e̞ t͡ɕʰ e̞
해태	h e̞ tʰ e̞
핵무기	h e̞ ŋ m u ɡ i
핵심	h e̞ k ɕ͈ i m
핵폭탄	h e̞ k̚ pʰ o̞ k̚ tʰ a̠ n
핸드볼	h e̞ n d ɯ b o̞ ɭ
핸드폰	h e̞ n d ɯ pʰ o̞ n
햇빛	h e̞ t̚ p͈ i t̚
행군	h e̞ ŋ ɡ u n
행동	h e̞ ŋ d o̞ ŋ
행복	h e̞ː ŋ b o̞ k̚
행사	h e̞ ŋ sʰ a̠
행위	h e̞ ŋ ɥ i
행주	h e̞ ŋ d͡ʑ u
향기	ç j a̠ ŋ ɡ i
향년	ç j a̠ː ŋ ɲ j ʌ̹ n
향상	ç j a̠ː ŋ sʰ a̠ ŋ
향수	ç j a̠ ŋ sʰ u
허가	h ʌ̹ ɡ a̠
허락	h ʌ̹ ɾ a̠ k̚
허리	h ʌ̹ ɾ i
허리띠	h ʌ̹ ɾ i t͈ i
허리케인	h ʌ̹ ɾ i kʰ e̞ i n
허베이	h ʌ̹ b e̞ i
허브티	h ʌ̹ b ɯ tʰ i
헌법	h ɘː n p͈ ʌ̹ p̚
헛소리	h ʌ̹ t̚ s͈ o̞ ɾ i
헝가리	h ʌ̹ ŋ ɡ a̠ ɾ i
헬기	h e̞ ɭ ɡ i
헬리콥터	h e̞ ɭ ʎ i kʰ o̞ p̚ tʰ ʌ̹
헬멧	h e̞ ɭ m e̞ t̚
헬스	h e̞ ɭ sʰ ɯ
헬스클럽	h e̞ ɭ sʰ ɯ k x ɯ ɭ ɭ ʌ̹ p̚
헬싱키	h e̞ ɭ ɕʰ i ŋ k ç i
헷갈리다	h e̞ t̚ k͈ a̠ ɭ ʎ i d a̠
혁신	ç j ʌ̹ k ɕ͈ i n
현관	ç j ʌ̹ n ɡ w a̠ n
현대	ç j ɘː n d e̞
현대적	ç j ɘː n d e̞ d͡ʑ ʌ̹ k̚
현미경	ç j ɘː n m i ɡ j ʌ̹ ŋ
현실	ç j ɘː n ɕʰ i ɭ
현실적	ç j ɘː n ɕʰ i ɭ t͡ɕ͈ ʌ̹ k̚
현지	ç j ɘː n d͡ʑ i
현행	ç j ɘː n ɦ e̞ ŋ
혈압	ç j ʌ̹ ɾ a̠ p̚
혈액	ç j ʌ̹ ɾ e̞ k̚
혐의	ç j ʌ̹ m ɰ i
협박	ç j ʌ̹ p̚ p͈ a̠ k̚
협상	ç j ʌ̹ p s͈ a̠ ŋ
형님	ç j ʌ̹ ŋ n i m
형사	ç j ʌ̹ ŋ sʰ a̠
형성	ç j ʌ̹ ŋ sʰ ʌ̹ ŋ
형식	ç j ʌ̹ ŋ ɕʰ i k̚
형제	ç j ʌ̹ ŋ d͡ʑ e̞
형편	ç j ʌ̹ ŋ pʰ j ʌ̹ n
혜산	ç j e̞ː sʰ a̠ n
혜택	ç j e̞ː tʰ e̞ k̚
호기심	ɸʷ o̞ː ɡ i ɕʰ i m
호남	ɸʷ o̞ n a̠ m
호랑이	ɸʷ o̞ː ɾ a̠ ŋ i
호르몬	ɸʷ o̞ ɾ ɯ m o̞ n
호밀	ɸʷ o̞ m i ɭ
호박	ɸʷ o̞ː b a̠ k̚
호주	ɸʷ o̞ d͡ʑ u
호치민	ɸʷ o̞ t͡ɕʰ i m i n
호텔	ɸʷ o̞ tʰ e̞ ɭ
혹시	ɸʷ o̞ k ɕ͈ i
혹은	ɸʷ o̞ ɡ ɯ n
혼인	ɸʷ o̞ n i n
혼자	ɸʷ o̞ n d͡ʑ a̠
홋카이도	ɸʷ o̞ t̚ kʰ a̠ i d o̞
홍보	ɸʷ o̞ ŋ b o̞
홍수	ɸʷ o̞ ŋ sʰ u
홍차	ɸʷ o̞ ŋ t͡ɕʰ a̠
홍콩	ɸʷ o̞ ŋ kʰ o̞ ŋ
화가	ɸ w a̠ː ɡ a̠
화단	ɸ w a̠ d a̠ n
화려하다	ɸ w a̠ ɾ j ʌ̹ ɦ a̠ d a̠
화면	ɸ w a̠ː m j ʌ̹ n
화물	ɸ w a̠ː m u ɭ
화분	ɸ w a̠ b u n
화성	ɸ w a̠ː sʰ ʌ̹ ŋ
화요일	ɸ w a̠ j o i ɭ
화장실	ɸ w a̠ d͡ʑ a̠ ŋ ɕʰ i ɭ
화장장	ɸ w a̠ː d͡ʑ a̠ ŋ d͡ʑ a̠ ŋ
화장품	ɸ w a̠ d͡ʑ a̠ ŋ pʰ u m
화재	ɸ w a̠ː d͡ʑ e̞
화제	ɸ w a̠ d͡ʑ e̞
화학	ɸ w a̠ː ɦ a̠ k̚
확대	ɸ w a̠ k̚ t͈ e̞
확률	ɸ w a̠ ŋ ɲ j u ɭ
확보	ɸ w a̠ k̚ p͈ o̞
확신	ɸ w a̠ k ɕ͈ i n
확실히	ɸ w a̠ k ɕ͈ i ɾ ʝ i
확인	ɸ w a̠ ɡ i n
환경	ɸ w a̠ n ɡ j ʌ̹ ŋ
환상	ɸ w a̠ː n sʰ a̠ ŋ
환승하다	ɸ w a̠ː n sʰ ɯ ŋ ɦ a̠ d a̠
환율	ɸ w a̠ ɲ j u ɭ
환자	ɸ w a̠ː n d͡ʑ a̠
환전	ɸ w a̠ n d͡ʑ ʌ̹ n
활동	ɸ w a̠ ɭ t͈ o̞ ŋ
활발하다	ɸ w a̠ ɭ b a̠ ɾ ɦ a̠ d a̠
활용	ɸ w a̠ ɾ j o ŋ
황금	ɸ w a̠ ŋ ɡ ɯ m
황도	ɸ w a̠ː ŋ d o̞
회계	ɸ w e̞ː ɡ j e̞
회관	ɸ w e̞ː ɡ w a̠ n
회기	ɸ w e̞ː ɡ i
회담	ɸ w e̞ː d a̠ m
회복	ɸ w e̞ b o̞ k̚
회사	ɸ w e̞ː sʰ a̠
회사원	ɸ w e̞ː sʰ a̠ w ʌ̹ n
회색	ɸ w e̞ sʰ e̞ k̚
회음	ɸ w e̞ː ɯ m
회장	ɸ w e̞ː d͡ʑ a̠ ŋ
회화	ɸ w e̞ː β w a̠
횡령	ɸ w e̞ ŋ ɲ j ʌ̹ ŋ
효과	ç j oː k͈ w a̠
효과적	ç j oː k͈ w a̠ d͡ʑ ʌ̹ k̚
후계자	ɸʷ u ɡ j e̞ d͡ʑ a̠
후기	ɸʷ uː ɡ i
후반	ɸʷ uː b a̠ n
후배	ɸʷ uː b e̞
후보	ɸʷ u b o̞
후보자	ɸʷ u b o̞ d͡ʑ a̠
후유증	ɸʷ uː j u t͡ɕ͈ ɯ ŋ
후지	ɸʷ u d͡ʑ i
훈련	ɸʷ uː ɭ ʎ j ʌ̹ n
훈장	ɸʷ u n d͡ʑ a̠ ŋ
휠체어	h ɥ i ɭ t͡ɕʰ e̞ ʌ̹
휴가	ç j u ɡ a̠
휴게실	ç j u ɡ e̞ ɕʰ i ɭ
휴대전화	ç j u d e̞ d͡ʑ ʌ̹ n β w a̠
휴대폰	ç j u d e̞ pʰ o̞ n
휴일	ç j u i ɭ
휴지	ç j u d͡ʑ i
휴학	ç j u ɦ a̠ k̚
흉내	ç j u ŋ n e̞
흐름	x ɯ ɾ ɯ m
흑자	x ɯ k̚ t͡ɕ͈ a̠
흔적	x ɯ n d͡ʑ ʌ̹ k̚
흔하다	x ɯ n ɦ a̠ d a̠
흠결	x ɯ m ɡ j ʌ̹ ɭ
흡연	x ɯ b j ʌ̹ n
흥미롭다	x ɯː ŋ m i ɾ o̞ p̚ t͈ a̠
흥분	x ɯ ŋ b u n
흥분하다	x ɯ ŋ b u n ɦ a̠ d a̠
흥행	x ɯ ŋ ɦ e̞ ŋ
희망	ç i m a̠ ŋ
희생	ç i sʰ e̞ ŋ
희생자	ç i sʰ e̞ ŋ d͡ʑ a̠
희한히	ç i ɦ a̠ n ʝ i
흰색	ç i n sʰ e̞ k̚
히터	ç i tʰ ʌ̹
힌두교	ç i n d u ɡ j o
힘들다	ç i m d ɯ ɭ d a̠
힙합	ç i pʰ a̠ p̚
