abatai	ɐ b aː t ɐ ɪ̯ˑ
abato	ɐ b aː t oː
abatuose	ɐ b aː t u ə sʲ ɛ
abchazai	ɐ p x aː z ɐ ɪ̯ˑ
abchaze	ɐ p x aː zʲ ɛ
abchazuose	ɐ p x aː z u ə sʲ ɛ
abchazės	ɐ p x aː zʲ eː s
abejinga	ɐ bʲ ɛ j ɪ n ɡ ɐ
abejingais	ɐ bʲ ɛ j ɪ n ɡ ɐ j s
abejingam	ɐ bʲ ɛ j ɪ n ɡ ɐ m
abejingas	ɐ bʲ ɛ j ɪ ŋ ɡ ɐ s
abejingesnei	ɐ bʲ ɛ j ɪ n ɡʲ ɛ sʲ nʲ ɛ j
abejingesniam	ɐ bʲ ɛ j ɪ n ɡʲ ɛ sʲ nʲ æː m
abejingi	ɐ bʲ ɛ j ɪ nʲ ɡʲ ɪ
abejingiausiems	ɐ bʲ ɛ j ɪ n ɡʲ æː ʊ sʲ j ɛ m s
abejingiausio	ɐ bʲ ɛ j ɪ n ɡʲ æː ʊ sʲ o
abejingiems	ɐ bʲ ɛ j ɪ nʲ ɡʲ j ɛ m s
abejingo	ɐ bʲ ɛ j ɪ n ɡ o
abejingoms	ɐ bʲ ɛ j ɪ n ɡ o m s
abejingu	ɐ bʲ ɛ j ɪ n ɡ ʊ
abejingumas	ɐ bʲ ɛ j ɪ ŋ ɡ ʊ m ɐ s
abejingą	ɐ bʲ ɛ j ɪ n ɡ aː
abejingų	ɐ bʲ ɛ j ɪ n ɡ uː
abėcėle	ɐ bʲ eː tʲ sʲ eː lʲ ɛ
abėcėles	ɐ bʲ eː tʲ sʲ eː lʲ ɛ s
abėcėlėms	ɐ bʲ eː tʲ sʲ eː lʲ eː m s
abėcėlę	ɐ bʲ eː tʲ sʲ eː lʲ æː
agresija	ɐ ɡʲ rʲ ɛ sʲ ɪ j ɛ
airijai	ɐ j rʲ ɪ j ɛ j
airijoje	ɐ j rʲ ɪ j o j ɛ
airiška	ɐ j rʲ ɪ ʃ k ɐ
airiškas	ɐ j rʲ ɪ ʃ k ɐ s
airiškasis	ɐ j rʲ ɪ ʃ k ɐ sʲ ɪ s
airiško	ɐ j rʲ ɪ ʃ k o
airiškos	ɐ j rʲ ɪ ʃ k o s
airišku	ɐ j rʲ ɪ ʃ k ʊ
akis	ɐ kʲ ɪ s
aklais	ɐ k l ɐ j s
aklaisiais	ɐ k l ɐ j sʲ ɛ j s
aklajai	aː k l ɐ j ɛ j
aklajam	ɐ k l aː j ɛ m
aklam	ɐ k l aː m
aklame	ɐ k l ɐ mʲ ɛ
aklas	aː k l ɐ s
akli	ɐ k lʲ ɪ
aklieji	ɐ k lʲ j ɛ j ɪ
akliesiems	ɐ k lʲ j ɛ sʲ j e m s
aklo	aː k l o
akloje	ɐ k l o j ɛ
akloji	ɐ k l oː j ɪ
aklojo	aː k l o j o
aklu	ɐ k l ʊ
akluoju	ɐ k l u ɔ j ʊ
akluose	ɐ k l ʊ o sʲ ɛ
akluosius	ɐ k l u ɔ sʲ ʊ s
aklą	aː k l aː
aklų	ɐ k l uː
aklųjų	ɐ k l uː j uː
albanija	ɐ l b aː nʲ ɪ j ɛ
albaniškai	ɐ l b aː nʲ ɪ ʃ k ɐ j
albaniškasis	ɐ l b aː nʲ ɪ ʃ k ɐ sʲ ɪ s
albaniško	ɐ l b aː nʲ ɪ ʃ k o
albaniškoje	ɐ l b aː nʲ ɪ ʃ k o j ɛ
albaniškose	ɐ l b aː nʲ ɪ ʃ k o sʲ ɛ
albaniškąja	ɐ l b aː nʲ ɪ ʃ k aː j ɛ
albaniškųjų	ɐ l b aː nʲ ɪ ʃ k uː j uː
algoritmai	ɐ l ɡ o rʲ ɪ t m ɐ j
algoritmams	ɐ l ɡ o rʲ ɪ t m ɐ m s
algoritmas	ɐ l ɡ o rʲ ɪ t m ɐ s
algoritmo	ɐ l ɡ o rʲ ɪ t m o
algoritmu	ɐ l ɡ o rʲ ɪ t m ʊ
algoritmui	ɐ l ɡ o rʲ ɪ t m ʊ ɪ
algoritmuose	ɐ l ɡ o rʲ ɪ t m ʊ o sʲ ɛ
algoritmus	ɐ l ɡ o rʲ ɪ t m ʊ s
algoritmą	ɐ l ɡ o rʲ ɪ t m aː
algoritmų	ɐ l ɡ o rʲ ɪ t m uː
alus	ɐ l ʊ s
amatas	ä̌ː m ɐ t̪ ɐ s̪
ana	ɐ n ɐ
angelais	ɐ n ɡʲ ɛ l ɑ j s
angelas	ɑ n ɡʲ ɛ l ɐ s
angelus	ɑ n ɡʲ ɛ l ʊ s
angelą	ɑ n ɡʲ ɛ l ɑː
angelų	ɐ n ɡʲ ɛ l uː
angliškasis	aː nʲ ɡʲ lʲ ɪ ʃ k ɐ sʲ ɪ s
angliškosios	aː nʲ ɡʲ lʲ ɪ ʃ k o sʲ o s
anie	ɐ nʲ j ɛ
anomalija	ɐ n ɔ m aː l ɪ j ɛ
anos	ɐ n o s
ant	ɐ n t
antklodė	ɐ n t k l ɔ dʲ eː
anyta	ɐ nʲ iː t ɐ
anytai	ɐ nʲ iː t ɐ j
anytos	ɐ nʲ iː t o s
apgalėti	ɐ p ɡ ɐ lʲ eː tʲ ɪ
apie	ɐ pʲ ɪ͡ə
apipjausto	ɐ pʲ ɪ pʲ j æ u s t o
apipjaustykite	ɐ pʲ ɪ pʲ j æ u sʲ tʲ i kʲ ɪ tʲ ɛ
apipjaustymas	ɐ pʲ ɪ pʲ j æ uː sʲ tʲ iː m ɐ s
apipjaustymo	ɐ pʲ ɪ pʲ j æ uː sʲ tʲ iː m o
apipjaustymuose	ɐ pʲ ɪ pʲ j æ uː sʲ tʲ iː m ʊ o sʲ ɛ
apipjaustymą	ɐ pʲ ɪ pʲ j æ uː sʲ tʲ iː m aː
apipjaustymų	ɐ pʲ ɪ pʲ j æ uː sʲ tʲ iː m uː
apipjaustysite	ɐ pʲ ɪ pʲ j æ u sʲ tʲ i sʲ ɪ tʲ ɛ
apipjaustysiu	ɐ pʲ ɪ pʲ j æ u sʲ tʲ i sʲ ʊ
apipjaustyti	ɐ pʲ ɪ pʲ j æ u sʲ tʲ i tʲ ɪ
apipjaustyčiau	ɐ pʲ ɪ pʲ j æ u sʲ tʲ i tʲ ʃʲ ɛ ʊ
apkalbėti	ɐ p k ɐ lʲ bʲ eː tʲ ɪ
apkeliaujančiajame	ɐ p kʲ ɛ lʲ æ ʊ j ɛ nʲ tʲ ʃʲ ɛ j ɛ mʲ ɛ
apkeliaujančiojo	ɐ p kʲ ɛ lʲ æ ʊ j ɛ nʲ tʲ ʃʲ o j o
apkeliaujančiuosius	ɐ p kʲ ɛ lʲ æ ʊ j ɛ nʲ tʲ ʃʲ ʊ o sʲ ʊ s
apkeliaujančią	ɐ p kʲ ɛ lʲ æ ʊ j ɛ nʲ tʲ ʃʲ æː
apkeliauti	ɐ pʲ kʲ ɛ lʲ æ ʊ tʲ ɪ
apmirti	ɐ p mʲ ɪ rʲ tʲ ɪ
apsiūti	ɐ p sʲ uː tʲ ɪ
aptarimai	ɐ p t ɐ ɾʲ ɪ m ɐ j
aptarimas	ɐ p t ɐ ɾʲ ɪ m ɐ s
aptarimo	ɐ p t ɐ ɾʲ ɪ m o
aptarimu	ɐ p t ɐ ɾʲ ɪ m ʊ
aptarimui	ɐ p t ɐ ɾʲ ɪ m ʊ ɪ
aptarimus	ɐ p t ɐ ɾʲ ɪ m ʊ s
aptarimą	ɐ p t ɐ ɾʲ ɪ m aː
aptarimų	ɐ p t ɐ ɾʲ ɪ m uː
aptarti	ɐ p t ɐ ɾ tʲ ɪ
apyvarpė	ɐ pʲ iː ʋ ɐ ɾʲ pʲ eː
apyvarpės	ɐ pʲ iː ʋ ɐ ɾʲ pʲ eː s
arabijoje	ɐ r aː bʲ ɪ j o j ɛ
arabijos	ɐ r aː bʲ ɪ j o s
arabiją	ɐ r aː bʲ ɪ j æː
arabiškai	ɐ r aː bʲ ɪ ʃ k ɐ j
arabiškais	ɐ r aː bʲ ɪ ʃ k ɐ j s
arabiškaisiais	ɐ r aː bʲ ɪ ʃ k ɐ j sʲ ɛ j s
arabiškame	ɐ r aː bʲ ɪ ʃ k ɐ mʲ ɛ
arabiškas	ɐ r aː bʲ ɪ ʃ k ɐ s
arabiški	ɐ r aː bʲ ɪ ʃʲ kʲ ɪ
arabiško	ɐ r aː bʲ ɪ ʃ k o
arabiškojo	ɐ r aː bʲ ɪ ʃ k o j o
arabiškos	ɐ r aː bʲ ɪ ʃ k o s
arabiškosioms	ɐ r aː bʲ ɪ ʃ k o sʲ o m s
arabiškosios	ɐ r aː bʲ ɪ ʃ k o sʲ o s
arabišku	ɐ r aː bʲ ɪ ʃ k ʊ
arabiškuose	ɐ r aː bʲ ɪ ʃ k ʊ o sʲ ɛ
arabiškus	ɐ r aː bʲ ɪ ʃ k ʊ s
arabišką	ɐ r aː bʲ ɪ ʃ k aː
arabiškąją	ɐ r aː bʲ ɪ ʃ k aː j æː
arabiškų	ɐ r aː bʲ ɪ ʃ k uː
archyvais	ɐ rʲ xʲ iː ʋ ɐ j s
archyvams	ɐ rʲ xʲ iː ʋ ɐ m s
archyvas	ɐ rʲ xʲ iː ʋ ɐ s
archyve	ɐ rʲ xʲ iː ʋʲ ɛ
archyvo	ɐ rʲ xʲ iː ʋ o
archyvu	ɐ rʲ xʲ iː ʋ ʊ
archyvui	ɐ rʲ xʲ iː ʋ ʊ ɪ
archyvuose	ɐ rʲ xʲ iː ʋ ʊ o sʲ ɛ
archyvus	ɐ rʲ xʲ iː ʋ ʊ s
archyvą	ɐ rʲ xʲ iː ʋ aː
archyvų	ɐ rʲ xʲ iː ʋ uː
arkangelas	ɐ r k ɑ n ɡʲ ɛ l ɐ s
armėnijoje	ɐ r mʲ eː nʲ ɪ j o j ɛ
armėnijos	ɐ r mʲ eː nʲ ɪ j o s
armėniją	ɐ r mʲ eː nʲ ɪ j æː
armėniškai	ɐ rʲ mʲ eː nʲ ɪ ʃ k ɐ j
armėniškais	ɐ rʲ mʲ eː nʲ ɪ ʃ k ɐ j s
armėniškąjį	ɐ rʲ mʲ eː nʲ ɪ ʃ k aː j iː
armėniškų	ɐ rʲ mʲ eː nʲ ɪ ʃ k uː
asmenine	ɐ sʲ mʲ ɛ nʲ ɪ nʲ ɛ
asmeninei	ɐ sʲ mʲ ɛ nʲ ɪ nʲ ɛ j
asmenines	ɐ sʲ mʲ ɛ nʲ ɪ nʲ ɛ s
asmeniniai	ɐ sʲ mʲ ɛ nʲ ɪ nʲ ɛ j
asmeniniais	ɐ sʲ mʲ ɛ nʲ ɪ nʲ ɛ j s
asmeniniam	ɐ sʲ mʲ ɛ nʲ ɪ nʲ ɛ m
asmeniniame	ɐ sʲ mʲ ɛ nʲ ɪ nʲ ɛ mʲ ɛ
asmeniniams	ɐ sʲ mʲ ɛ nʲ ɪ nʲ ɛ m s
asmeninio	ɐ sʲ mʲ ɛ nʲ ɪ nʲ o
asmeninis	ɐ sʲ mʲ ɛ nʲ ɪ nʲ ɪ s
asmeniniu	ɐ sʲ mʲ ɛ nʲ ɪ nʲ ʊ
asmeniniuose	ɐ sʲ mʲ ɛ nʲ ɪ nʲ ʊ o sʲ ɛ
asmeninius	ɐ sʲ mʲ ɛ nʲ ɪ nʲ ʊ s
asmeninių	ɐ sʲ mʲ ɛ nʲ ɪ nʲ uː
asmeninė	ɐ sʲ mʲ ɛ nʲ ɪ nʲ eː
asmeninėje	ɐ sʲ mʲ ɛ nʲ ɪ nʲ eː j ɛ
asmeninėmis	ɐ sʲ mʲ ɛ nʲ ɪ nʲ eː mʲ ɪ s
asmeninėms	ɐ sʲ mʲ ɛ nʲ ɪ nʲ eː m s
asmeninės	ɐ sʲ mʲ ɛ nʲ ɪ nʲ eː s
asmeninėse	ɐ sʲ mʲ ɛ nʲ ɪ nʲ eː sʲ ɛ
asmeninę	ɐ sʲ mʲ ɛ nʲ ɪ nʲ æː
asmeninį	ɐ sʲ mʲ ɛ nʲ ɪ nʲ iː
ateiti	ɐ tʲ ɛ jː tʲ ɪ
atidavusi	ɐ tʲ ɪ d aː ʋ ʊ sʲ ɪ
atidavusiam	ɐ tʲ ɪ d aː ʋ ʊ sʲ ɛ m
atidavusiesiems	ɐ tʲ ɪ d aː ʋ ʊ sʲ j ɛ sʲ j ɛ m s
atidavusioms	ɐ tʲ ɪ d aː ʋ ʊ sʲ o m s
atidavusiuosius	ɐ tʲ ɪ d aː ʋ ʊ sʲ ʊ o sʲ ʊ s
atidavusius	ɐ tʲ ɪ d aː ʋ ʊ sʲ ʊ s
atidavę	ɐ tʲ ɪ d aː ʋʲ æː
atiduodanti	ɐ tʲ ɪ d u ɔ d ɐ nʲ tʲ ɪ
atiduodantis	ɐ tʲ ɪ d u ɔ d ɐ nʲ tʲ ɪ s
atiduodantys	ɐ tʲ ɪ d u ɔ d ɐ nʲ tʲ iː s
atiduodančiosios	ɐ tʲ ɪ d u ɔ d ɐ nʲ tʲ ʃʲ o sʲ o s
atiduodančiuosius	ɐ tʲ ɪ d u ɔ d ɐ nʲ tʲ ʃʲ ʊ o sʲ ʊ s
atiduodančių	ɐ tʲ ɪ d u ɔ d ɐ nʲ tʲ ʃʲ uː
atiduosiantis	ɐ tʲ ɪ d u ɔ sʲ ɛ nʲ tʲ ɪ s
atiduosiančio	ɐ tʲ ɪ d u ɔ sʲ ɛ nʲ tʲ ʃʲ o
atiduosiančiuoju	ɐ tʲ ɪ d u ɔ sʲ ɛ nʲ tʲ ʃʲ ʊ o j ʊ
atkeliaujanti	ɐ t kʲ ɛ lʲ æ ʊ j ɛ nʲ tʲ ɪ
atkeliaujantys	ɐ t kʲ ɛ lʲ æ ʊ j ɛ nʲ tʲ iː s
atkeliaujantį	ɐ t kʲ ɛ lʲ æ ʊ j ɛ nʲ tʲ iː
atkeliaujančiai	ɐ t kʲ ɛ lʲ æ ʊ j ɛ nʲ tʲ ʃʲ ɛ j
atkeliaujančiajam	ɐ t kʲ ɛ lʲ æ ʊ j ɛ nʲ tʲ ʃʲ ɛ j ɛ m
atkeliaujančių	ɐ t kʲ ɛ lʲ æ ʊ j ɛ nʲ tʲ ʃʲ uː
atrasti	ɐ t r ɐ sʲ tʲ ɪ
atstovas	ɐ t̪ s̪ t̪ ǒː v ɐ s̪
atėnė	ɐ tʲ eː nʲ eː
audinė	ɐ ʊ dʲ ɪ nʲ eː
auga	äˑ ʊ̯ ɡ ɐ
augalas	âˑ ʊ̯ ɡ ɐ l ɐ s
augti	äˑ ʊ̯ kʲ tʲ ɪ
aukso	a u k s o
auksu	a u k s ʊ
auksui	a u k s ʊ ɪ
auksą	a u k s a
aukštaites	ɐ ʊ k ʃ t ɐ j tʲ ɛ s
aukštaitiškosiomis	ɐ ʊ k ʃ t ɐ j tʲ ɪ ʃ k o sʲ o mʲ ɪ s
aukštaitiškąjį	ɐ ʊ k ʃ t ɐ j tʲ ɪ ʃ k aː j iː
aukštaityje	ɐ ʊ k ʃ t ɐ j tʲ iː j ɛ
aukštaitė	ɐ ʊ k ʃ t ɐ j tʲ eː
aukštaitę	ɐ ʊ k ʃ t ɐ j tʲ æː
aukštaičiai	ɐ ʊ k ʃ t ɐ j tʲ ʃʲ ɛ j
aukštaičio	ɐ ʊ k ʃ t ɐ j tʲ ʃʲ o
aukštaičiui	ɐ ʊ k ʃ t ɐ j tʲ ʃʲ ʊ ɪ
aukštaičių	ɐ ʊ k ʃ t ɐ j tʲ ʃʲ uː
aulas	ɐ uː l ɐ s
austi	ä̂ˑ ʊ̯ sʲ tʲ ɪ
aušra	ɐ u ʃ r ɐ
avėti	ɐ vʲ eː tʲ ɪ
ačiū	aː t ʃʲ uː
ašara	aː ʃ ɐ ɾ ɐ
aštrus	ɐ ʃ t̪ r ʊ s̪
baigti	b ɐ j ɡʲ tʲ ɪ
balnas	b ɐ l n̪ ɐ s̪
balnoti	b ɐ l n̪ ôː tʲ ɪ
balsais	b ɐ l s ɐ j s
balsams	b ɐ l s aː m s
balse	b ɐ lʲ sʲ ɛ
balso	b ɐ l s o
balsu	b ɐ l s ʊ
balsui	b ɐ l s ʊ ɪ
balsuose	b ɐ l s ʊ o sʲ ɛ
balsus	b ɐ l s ʊ s
balsų	b ɐ l s uː
baltajam	b ɐ l t aː j ɛ m
baltas	b aː l t ɐ s
baltesni	b ɐ lʲ tʲ ɛ sʲ nʲ ɪ
baltesniame	b ɐ lʲ tʲ ɛ sʲ nʲ ɛ mʲ ɛ
baltesnis	b ɐ lʲ tʲ ɛ sʲ nʲ ɪ s
baltesnių	b ɐ lʲ tʲ ɛ sʲ nʲ uː
baltesnįjį	b ɐ lʲ tʲ ɛ sʲ nʲ iː j iː
baltieji	b ɐ lʲ tʲ j ɛ j ɪ
baltojo	b aː l t o j o
baltojoje	b ɐ l t oː j o j ɛ
baltuoju	b ɐ l t u ɔ j ʊ
baltuosius	b ɐ l t u ɔ sʲ ʊ s
baltąja	b ɐ l t aː j ɛ
baltąją	b aː l t aː j æː
baltąjį	b aː l t aː j iː
baltųjų	b ɐ l t uː j uː
balčiausia	b ɐ lʲ tʲ ʃʲ æː ʊ sʲ ɛ
balčiausias	b ɐ lʲ tʲ ʃʲ æː ʊ sʲ ɛ s
balčiausioje	b ɐ lʲ tʲ ʃʲ æː ʊ sʲ o j ɛ
balčiausiosioms	b ɐ lʲ tʲ ʃʲ æː ʊ sʲ o sʲ o m s
balčiausiąją	b ɐ lʲ tʲ ʃʲ æː ʊ sʲ æː j æː
bamba	b a m b ɐ
basas	b äː s̪ ɐ s̪
be	bʲ ɛ
bebaimis	bʲ ɛ b ɐ j mʲ ɪ s
bedieviška	bʲ ɛ dʲ j ɛ ʋʲ ɪ ʃ k ɐ
bedieviškai	bʲ ɛ dʲ j ɛ ʋʲ ɪ ʃ k ɐ j
bedieviškajam	bʲ ɛ dʲ j ɛ ʋʲ ɪ ʃ k ɐ j ɛ m
bedieviškesniojo	bʲ ɛ dʲ j ɛ ʋʲ ɪ ʃʲ kʲ ɛ sʲ nʲ o j o
bedieviškesnius	bʲ ɛ dʲ j ɛ ʋʲ ɪ ʃʲ kʲ ɛ sʲ nʲ ʊ s
bedieviškesnė	bʲ ɛ dʲ j ɛ ʋʲ ɪ ʃʲ kʲ ɛ sʲ nʲ eː
bedieviški	bʲ ɛ dʲ j ɛ ʋʲ ɪ ʃʲ kʲ ɪ
bedieviškiausi	bʲ ɛ dʲ j ɛ ʋʲ ɪ ʃʲ kʲ æː ʊ sʲ ɪ
bedieviškiausioje	bʲ ɛ dʲ j ɛ ʋʲ ɪ ʃʲ kʲ æː ʊ sʲ o j ɛ
bedieviškiausioms	bʲ ɛ dʲ j ɛ ʋʲ ɪ ʃʲ kʲ æː ʊ sʲ o m s
bedieviškiausios	bʲ ɛ dʲ j ɛ ʋʲ ɪ ʃʲ kʲ æː ʊ sʲ o s
bedieviškiausiosioms	bʲ ɛ dʲ j ɛ ʋʲ ɪ ʃʲ kʲ æː ʊ sʲ o sʲ o m s
bedieviškieji	bʲ ɛ dʲ j ɛ ʋʲ ɪ ʃʲ kʲ j ɛ j ɪ
bedieviškumas	bʲ ɛ dʲ j ɛ ʋʲ ɪ ʃ k ʊ m ɐ s
bedieviškume	bʲ ɛ dʲ j ɛ ʋʲ ɪ ʃ k ʊ mʲ ɛ
bedieviškuose	bʲ ɛ dʲ j ɛ ʋʲ ɪ ʃ k ʊ o sʲ ɛ
bedieviškų	bʲ ɛ dʲ j ɛ ʋʲ ɪ ʃ k uː
bedugnis	bʲ ɛ d ʊ ɡʲ nʲ ɪ s
beformis	bʲ ɛ f ɔ rʲ mʲ ɪ s
begalinis	bʲ ɛ ɡ ɐ lʲ ɪ nʲ ɪ s
benamis	bʲ ɛ n aː mʲ ɪ s
bendras	bʲ ɛ n d r ɐ s
berti	bʲ æː ɾʲ tʲ ɪ
beržas	b æː r ʒ ɐ s
bevaikis	bʲ ɛ ʋ ɐ j kʲ ɪ s
bevandenis	bʲ ɛ ʋ ɐ nʲ dʲ æː nʲ ɪ s
bevardis	bʲ ɛ ʋ ɐ rʲ dʲ ɪ s
beveidis	bʲ ɛ ʋʲ ɛ j dʲ ɪ s
bevielis	bʲ ɛ ʋʲ j æː lʲ ɪ s
bijūnas	bʲ ɪ j ǔː n̪ ɐ s̪
bitė	bʲ ɪ tʲ eː
blizganti	bʲ lʲ ɪ z ɡ ɐ nʲ tʲ ɪ
blizgantieji	bʲ lʲ ɪ z ɡ ɐ nʲ tʲ j ɛ j ɪ
blizgantiems	bʲ lʲ ɪ z ɡ ɐ nʲ tʲ j ɛ m s
blizgantis	bʲ lʲ ɪ z ɡ ɐ nʲ tʲ ɪ s
blizgantys	bʲ lʲ ɪ z ɡ ɐ nʲ tʲ iː s
blizgantį	bʲ lʲ ɪ z ɡ ɐ nʲ tʲ iː
blizgančia	bʲ lʲ ɪ z ɡ ɐ nʲ tʲ ʃʲ ɛ
blizgančiais	bʲ lʲ ɪ z ɡ ɐ nʲ tʲ ʃʲ ɛ j s
blizgančiam	bʲ lʲ ɪ z ɡ ɐ nʲ tʲ ʃʲ ɛ m
blizgančio	bʲ lʲ ɪ z ɡ ɐ nʲ tʲ ʃʲ o
blizgančiomis	bʲ lʲ ɪ z ɡ ɐ nʲ tʲ ʃʲ o mʲ ɪ s
blizgančios	bʲ lʲ ɪ z ɡ ɐ nʲ tʲ ʃʲ o s
blizgančiu	bʲ lʲ ɪ z ɡ ɐ nʲ tʲ ʃʲ ʊ
blizgančius	bʲ lʲ ɪ z ɡ ɐ nʲ tʲ ʃʲ ʊ s
blizgančių	bʲ lʲ ɪ z ɡ ɐ nʲ tʲ ʃʲ uː
blogai	b l oː ɡ ɐ j
blogais	b l o ɡ ɐ j s
blogam	b l o ɡ aː m
blogame	b l o ɡ ɐ mʲ ɛ
blogasis	b l o ɡ ɐ sʲ ɪ s
blogesne	b l o ɡʲ ɛ sʲ nʲ ɛ
blogesnes	b l o ɡʲ ɛ sʲ nʲ ɛ s
blogesniais	b l o ɡʲ ɛ sʲ nʲ ɛ j s
blogesniosioms	b l o ɡʲ ɛ sʲ nʲ oː sʲ o m s
blogesnis	b l o ɡʲ ɛ sʲ nʲ ɪ s
blogesniu	b l o ɡʲ ɛ sʲ nʲ ʊ
blogesnius	b l o ɡʲ ɛ sʲ nʲ ʊ s
blogesnė	b l o ɡʲ ɛ sʲ nʲ eː
blogesnėje	b l o ɡʲ ɛ sʲ nʲ eː j ɛ
blogesnėmis	b l o ɡʲ ɛ sʲ nʲ eː mʲ ɪ s
blogesnės	b l o ɡʲ ɛ sʲ nʲ eː s
blogesnį	b l o ɡʲ ɛ sʲ nʲ iː
blogi	b l o ɡʲ ɪ
blogiausi	b l o ɡʲ æː ʊ sʲ ɪ
blogiausiais	b l o ɡʲ æː ʊ sʲ ɛ j s
blogiausias	b l o ɡʲ æː ʊ sʲ ɛ s
blogiausiems	b l o ɡʲ æː ʊ sʲ j ɛ m s
blogiausio	b l o ɡʲ æː ʊ sʲ o
blogiausiojoje	b l o ɡʲ æː ʊ sʲ o j o j ɛ
blogiausiomis	b l o ɡʲ æː ʊ sʲ o mʲ ɪ s
blogiausioms	b l o ɡʲ æː ʊ sʲ o m s
blogiausiu	b l o ɡʲ æː ʊ sʲ ʊ
blogiausius	b l o ɡʲ æː ʊ sʲ ʊ s
blogiausių	b l o ɡʲ æː ʊ sʲ uː
blogiausiųjų	b l o ɡʲ æː ʊ sʲ uː j uː
blogieji	b l o ɡʲ j ɛ j ɪ
blogiesiems	b l o ɡʲ j ɛ sʲ j e m s
blogojo	b l oː ɡ o j o
blogoms	b l o ɡ oː m s
blogosiomis	b l o ɡ oː sʲ o mʲ ɪ s
blogosioms	b l o ɡ oː sʲ o m s
blogu	b l o ɡ ʊ
bloguoju	b l o ɡ u ɔ j ʊ
bloguose	b l o ɡ ʊ o sʲ ɛ
bloguosiuose	b l o ɡ ʊ o sʲ ʊ o sʲ ɛ
blogus	b l o ɡ ʊ s
blogą	b l oː ɡ aː
blogąja	b l o ɡ aː j ɛ
blogąją	b l oː ɡ aː j æː
blogąjį	b l oː ɡ aː j iː
blogąsias	b l o ɡ aː sʲ ɛ s
blogųjų	b l o ɡ uː j uː
bokalas	b oː k ä̌ː l ɐ s̪
brazilija	b r ɐ zʲ ɪ lʲ ɪ j ɛ
brenda	bʲ rʲ ɛ n̪ d̪ ɐ
brendi	bʲ rʲ ɛ nʲ dʲ ɪ
bris	bʲ rʲ ɪ s̪
bristi	bʲ rʲ ɪ sʲ tʲ ɪ
broli	b ɾ oː lʲ ɪ
broliai	b ɾ oː lʲ ɛ j
broliams	b ɾ oː lʲ ɛ m s
brolio	b ɾ oː lʲ o
brolis	b ɾ oː lʲ ɪ s
broliu	b ɾ oː lʲ ʊ
broliui	b ɾ oː lʲ ʊ ɪ
brolius	b ɾ oː lʲ ʊ s
brolį	b ɾ oː lʲ iː
bruka	b r ʊ k ɐ
bruks	b r ʊ k s̪
bruku	b r ʊ k ʊ
bręsti	bʲ rʲ æː sʲ tʲ ɪ
bukas	b ʊ k ɐ s̪
buldogai	b ʊ l d o ɡ ɐ j
buldogais	b ʊ l d o ɡ ɐ j s
buldogas	b ʊ l d o ɡ ɐ s
bulgarija	b ʊ l ɡ aː rʲ ɪ j ɛ
bulgarijoje	b ʊ l ɡ aː rʲ ɪ j o j ɛ
bulgariją	b ʊ l ɡ aː rʲ ɪ j æː
bulgariškai	b ʊ l ɡ aː rʲ ɪ ʃ k ɐ j
bulgariško	b ʊ l ɡ aː rʲ ɪ ʃ k o
bulgariškosiomis	b ʊ l ɡ aː rʲ ɪ ʃ k o sʲ o mʲ ɪ s
bulgariškų	b ʊ l ɡ aː rʲ ɪ ʃ k uː
burna	b ʊ r n ɐ
burė	b ʊ rʲ eː
bus	b ʊ s
buvai	b ʊ ʋ ɐ j
buvau	b ʊ ʋ ɐ u
buvo	b u ʋ ɔ
buvusi	b ʊ ʋ ʊ sʲ ɪ
buvusiais	b ʊ ʋ ʊ sʲ ɛ j s
buvusiam	b ʊ ʋ ʊ sʲ ɛ m
buvusiame	b ʊ ʋ ʊ sʲ ɛ mʲ ɛ
buvusias	b ʊ ʋ ʊ sʲ ɛ s
buvusieji	b ʊ ʋ ʊ sʲ j ɛ j ɪ
buvusiems	b ʊ ʋ ʊ sʲ j ɛ m s
buvusio	b ʊ ʋ ʊ sʲ o
buvusioji	b ʊ ʋ ʊ sʲ o j ɪ
buvusiojo	b ʊ ʋ ʊ sʲ o j o
buvusiomis	b ʊ ʋ ʊ sʲ o mʲ ɪ s
buvusioms	b ʊ ʋ ʊ sʲ o m s
buvusios	b ʊ ʋ ʊ sʲ o s
buvusiose	b ʊ ʋ ʊ sʲ o sʲ ɛ
buvusiosios	b ʊ ʋ ʊ sʲ o sʲ o s
buvusiu	b ʊ ʋ ʊ sʲ ʊ
buvusiuoju	b ʊ ʋ ʊ sʲ ʊ o j ʊ
buvusiuose	b ʊ ʋ ʊ sʲ ʊ o sʲ ɛ
buvusią	b ʊ ʋ ʊ sʲ æ
buvusiąją	b ʊ ʋ ʊ sʲ æ j æ
buvusių	b ʊ ʋ ʊ sʲ u
buvusiųjų	b ʊ ʋ ʊ sʲ u j u
buvusį	b ʊ ʋ ʊ sʲ i
buvę	b ʊ ʋʲ æ
buvęs	b ʊ ʋʲ æ s
bučinys	b ʊ t͡ʃʲ ɪ n̪ʲ iː s̪
bučiuojantis	b ʊ tʲ ʃʲ u ɔ j ɛ nʲ tʲ ɪ s
bučiuojančiais	b ʊ tʲ ʃʲ u ɔ j ɛ nʲ tʲ ʃʲ ɛ j s
bučiuojančio	b ʊ tʲ ʃʲ u ɔ j ɛ nʲ tʲ ʃʲ o
bučiuojančiojo	b ʊ tʲ ʃʲ u ɔ j ɛ nʲ tʲ ʃʲ o j o
bučiuojančiuoju	b ʊ tʲ ʃʲ u ɔ j ɛ nʲ tʲ ʃʲ ʊ o j ʊ
bučiuojančiųjų	b ʊ tʲ ʃʲ u ɔ j ɛ nʲ tʲ ʃʲ uː j uː
bučiuoją	b ʊ tʲ ʃʲ u ɔ j æː
bučiuosiančiai	b ʊ tʲ ʃʲ u ɔ sʲ ɛ nʲ tʲ ʃʲ ɛ j
bučiuosiančią	b ʊ tʲ ʃʲ u ɔ sʲ ɛ nʲ tʲ ʃʲ æː
bučiuoti	b ʊ tʲ ʃʲ u ɔ tʲ ɪ
bybys	bʲ i bʲ iː s
bėgantiems	bʲ eː ɡ ɐ nʲ tʲ j ɛ m s
bėgantis	bʲ eː ɡ ɐ nʲ tʲ ɪ s
bėgantys	bʲ eː ɡ ɐ nʲ tʲ iː s
bėgantį	bʲ eː ɡ ɐ nʲ tʲ iː
bėgančiai	bʲ eː ɡ ɐ nʲ tʲ ʃʲ ɛ j
bėgančiajam	bʲ eː ɡ ɐ nʲ tʲ ʃʲ ɛ j ɛ m
bėgančiajame	bʲ eː ɡ ɐ nʲ tʲ ʃʲ ɛ j ɛ mʲ ɛ
bėgančias	bʲ eː ɡ ɐ nʲ tʲ ʃʲ ɛ s
bėgančio	bʲ eː ɡ ɐ nʲ tʲ ʃʲ o
bėgančiomis	bʲ eː ɡ ɐ nʲ tʲ ʃʲ o mʲ ɪ s
bėgančios	bʲ eː ɡ ɐ nʲ tʲ ʃʲ o s
bėgančiuosius	bʲ eː ɡ ɐ nʲ tʲ ʃʲ ʊ o sʲ ʊ s
bėgančią	bʲ eː ɡ ɐ nʲ tʲ ʃʲ æː
bėgančiąją	bʲ eː ɡ ɐ nʲ tʲ ʃʲ æː j æː
bėgančių	bʲ eː ɡ ɐ nʲ tʲ ʃʲ uː
bėgdavusiosiomis	bʲ eː ɡ d ɐ ʋ ʊ sʲ o sʲ o mʲ ɪ s
bėgdavusysis	bʲ eː ɡ d ɐ ʋ ʊ sʲ iː sʲ ɪ s
bėgsiantiesiems	bʲ eː ɡʲ sʲ ɛ nʲ tʲ j ɛ sʲ j ɛ m s
bėgsiantis	bʲ eː ɡʲ sʲ ɛ nʲ tʲ ɪ s
bėgsiančios	bʲ eː ɡʲ sʲ ɛ nʲ tʲ ʃʲ o s
bėgsią	bʲ eː ɡʲ sʲ æː
bėgusia	bʲ eː ɡ ʊ sʲ ɛ
bėgę	bʲ eː ɡʲ æː
bėgęs	bʲ eː ɡʲ æː s
būdama	b uː d ɐ m ɐ
būdamas	b uː d ɐ m ɐ s
būdami	b uː d ɐ mʲ ɪ
būdamos	b uː d ɐ m o s
būdas	b ǔː d̪ ɐ s̪
būdavusia	b uː d ɐ ʋ ʊ sʲ ɛ
būdavusiojoje	b uː d ɐ ʋ ʊ sʲ o j o j ɛ
būdavusioms	b uː d ɐ ʋ ʊ sʲ o m s
būdavusiuosiuose	b uː d ɐ ʋ ʊ sʲ ʊ o sʲ ʊ o sʲ ɛ
būdavę	b uː d ɐ ʋʲ æ
būdavęs	b uː d ɐ ʋʲ æ s
būsiančia	b u sʲ ɛ nʲ tʲ ʃʲ ɛ
būsiančiajam	b u sʲ ɛ nʲ tʲ ʃʲ ɛ j ɛ m
būsiančio	b u sʲ ɛ nʲ tʲ ʃʲ o
būsią	b u sʲ æː
būsiąs	b uː sʲ æ s
būti	b uː tʲ ɪ
būtinai	b uː tʲ ɪ n ɐ j
būtų	b uː t uː
cukrus	t s ʊ k r ʊ s
daiktavardis	d ɐ j k t aː ʋ ɐ rʲ dʲ ɪ s
daina	d̪ ɐ ɪ̯ˑ n̪ ɐ
dainuojanti	d ɐ j n u ɔ j ɛ nʲ tʲ ɪ
dainuojantį	d ɐ j n u ɔ j ɛ nʲ tʲ iː
dainuojančia	d ɐ j n u ɔ j ɛ nʲ tʲ ʃʲ ɛ
dainuojančiam	d ɐ j n u ɔ j ɛ nʲ tʲ ʃʲ ɛ m
dainuojančio	d ɐ j n u ɔ j ɛ nʲ tʲ ʃʲ o
dainuojančiojo	d ɐ j n u ɔ j ɛ nʲ tʲ ʃʲ o j o
dainuojančios	d ɐ j n u ɔ j ɛ nʲ tʲ ʃʲ o s
dainuojančiose	d ɐ j n u ɔ j ɛ nʲ tʲ ʃʲ o sʲ ɛ
dainuojančiosiose	d ɐ j n u ɔ j ɛ nʲ tʲ ʃʲ o sʲ o sʲ ɛ
dainuojančiuose	d ɐ j n u ɔ j ɛ nʲ tʲ ʃʲ ʊ o sʲ ɛ
dainuojančius	d ɐ j n u ɔ j ɛ nʲ tʲ ʃʲ ʊ s
dainuojančią	d ɐ j n u ɔ j ɛ nʲ tʲ ʃʲ æː
dainuojančiąja	d ɐ j n u ɔ j ɛ nʲ tʲ ʃʲ æː j ɛ
dainuoti	d ɐ j n u ɔ tʲ ɪ
dalijimas	d ɐ lʲ ɪ j ɪ m ɐ s
dalykas	d ɐ lʲ iː k ɐ s
dalyvis	d ɐ lʲ iː ʋʲ ɪ s
dangoraižis	d̪ ɐ ŋ ɡ ôː r ɐ ɪ̯ˑ ʒʲ ɪ s̪
danijai	d aː nʲ ɪ j ɛ j
danijoje	d aː nʲ ɪ j o j ɛ
daniška	d aː nʲ ɪ ʃ k ɐ
daniškas	d aː nʲ ɪ ʃ k ɐ s
daniško	d aː nʲ ɪ ʃ k o
daniškų	d aː nʲ ɪ ʃ k uː
daro	d a ɾ ɔ
daryti	d ɐ ɾʲ iː tʲ ɪ
darė	d a ɾ e
daug	d ɐ u ɡ
davusi	d aː ʋ ʊ sʲ ɪ
davusiam	d aː ʋ ʊ sʲ ɛ m
davusiems	d aː ʋ ʊ sʲ j ɛ m s
davusios	d aː ʋ ʊ sʲ o s
davusiosios	d aː ʋ ʊ sʲ o sʲ o s
davusių	d aː ʋ ʊ sʲ uː
davusįjį	d aː ʋ ʊ sʲ iː j iː
davė	d a v e
davėjai	d ɐ ʋʲ eː j ɛ j
davėjais	d ɐ ʋʲ eː j ɛ j s
davėjas	d ɐ ʋʲ eː j ɛ s
davėjo	d ɐ ʋʲ eː j o
davėjomis	d ɐ ʋʲ eː j o mʲ ɪ s
davėjose	d ɐ ʋʲ eː j o sʲ ɛ
davėju	d ɐ ʋʲ eː j ʊ
davėjui	d ɐ ʋʲ eː j ʊ ɪ
davėjus	d ɐ ʋʲ eː j ʊ s
davėjų	d ɐ ʋʲ eː j uː
davėte	d a v e t ɛ
davę	d aː ʋʲ æː
davęs	d aː ʋʲ æː s
dega	dʲ æː ɡ ɐ
degi	dʲ ɛ ɡʲ ɪ
degu	dʲ ɛ ɡ ʊ
degutas	d̪ʲ ɛ ɡ ʊ t̪ ɐ s̪
deimantas	dʲ ɛ j m ɐ n t ɐ s
diegti	dʲ î ə kʲ tʲ ɪ
dieviškajai	dʲ j ɛ ʋʲ ɪ ʃ k ɐ j ɛ j
dieviškajame	dʲ j ɛ ʋʲ ɪ ʃ k ɐ j ɛ mʲ ɛ
dieviškesnioji	dʲ j ɛ ʋʲ ɪ ʃʲ kʲ ɛ sʲ nʲ oː j ɪ
dieviškesniosiomis	dʲ j ɛ ʋʲ ɪ ʃʲ kʲ ɛ sʲ nʲ oː sʲ o mʲ ɪ s
dieviškesniąsias	dʲ j ɛ ʋʲ ɪ ʃʲ kʲ ɛ sʲ nʲ æː sʲ ɛ s
dieviškiausiuosiuose	dʲ j ɛ ʋʲ ɪ ʃʲ kʲ æː ʊ sʲ ʊ o sʲ ʊ o sʲ ɛ
dieviškieji	dʲ j ɛ ʋʲ ɪ ʃʲ kʲ j ɛ j ɪ
dieviškoji	dʲ j ɛ ʋʲ ɪ ʃ k o j ɪ
dieviškojo	dʲ j ɛ ʋʲ ɪ ʃ k o j o
dieviškosios	dʲ j ɛ ʋʲ ɪ ʃ k o sʲ o s
dieviškumo	dʲ j ɛ ʋʲ ɪ ʃ k ʊ m o
dieviškumu	dʲ j ɛ ʋʲ ɪ ʃ k ʊ m ʊ
dieviškumą	dʲ j ɛ ʋʲ ɪ ʃ k ʊ m aː
dieviškuosius	dʲ j ɛ ʋʲ ɪ ʃ k ʊ o sʲ ʊ s
dieviškąją	dʲ j ɛ ʋʲ ɪ ʃ k aː j æː
dieviškąjį	dʲ j ɛ ʋʲ ɪ ʃ k aː j iː
dieviškųjų	dʲ j ɛ ʋʲ ɪ ʃ k uː j uː
diržas	dʲ ɪ r ʒ ɐ s̪
dobilas	d̪ ôː bʲ ɪ ɫ ɐ s̪
dogai	d o ɡ ɐ j
dogas	d o ɡ ɐ s
doge	d o ɡʲ ɛ
draugas	d ɾ a u ɡ ɐ s
drebėti	dʲ ɾʲ ɛ bʲ eː tʲ ɪ
driežas	dʲ ɾʲ i ɛ ʒ ɐ s
druskininkai	d̪ r ʊ sʲ kʲ ɪ nʲ ɪ ŋ k ɐ ɪ̯ˑ
dubuo	d ʊ b u ɔ
dugnas	d ʊ ɡ n ɐ s
duoda	d u ɔ d ɐ
duodamas	d u ɔ d ɐ m ɐ s
duodame	d u ɔ d ɐ m ɛ
duodantiems	d u ɔ d ɐ nʲ tʲ j ɛ m s
duodantis	d u ɔ d ɐ nʲ tʲ ɪ s
duodantys	d u ɔ d ɐ nʲ tʲ iː s
duodantysis	d u ɔ d ɐ nʲ tʲ iː sʲ ɪ s
duodančia	d u ɔ d ɐ nʲ tʲ ʃʲ ɛ
duodančiajam	d u ɔ d ɐ nʲ tʲ ʃʲ ɛ j ɛ m
duodančiame	d u ɔ d ɐ nʲ tʲ ʃʲ ɛ mʲ ɛ
duodančiosios	d u ɔ d ɐ nʲ tʲ ʃʲ o sʲ o s
duodančius	d u ɔ d ɐ nʲ tʲ ʃʲ ʊ s
duodančią	d u ɔ d ɐ nʲ tʲ ʃʲ æː
duodančių	d u ɔ d ɐ nʲ tʲ ʃʲ uː
duodančiųjų	d u ɔ d ɐ nʲ tʲ ʃʲ uː j uː
duodate	d u ɔ d ɐ t ɛ
duodavusiais	d u ɔ d ɐ ʋ ʊ sʲ ɛ j s
duodavusiaisiais	d u ɔ d ɐ ʋ ʊ sʲ ɛ j sʲ ɛ j s
duodavusieji	d u ɔ d ɐ ʋ ʊ sʲ ɛ j ɪ
duodi	d u ɔ d ɪ
duodu	d u ɔ d ʊ
duodą	d u ɔ d aː
duok	d u ɔ k
duokite	d u ɔ k ɪ t ɛ
duos	d u ɔ s
duosi	d u ɔ sʲ ɪ
duosiantiesiems	d u ɔ sʲ ɛ nʲ tʲ j ɛ sʲ j ɛ m s
duosiančiojo	d u ɔ sʲ ɛ nʲ tʲ ʃʲ o j o
duosiančiomis	d u ɔ sʲ ɛ nʲ tʲ ʃʲ o mʲ ɪ s
duosiančiose	d u ɔ sʲ ɛ nʲ tʲ ʃʲ o sʲ ɛ
duosiančius	d u ɔ sʲ ɛ nʲ tʲ ʃʲ ʊ s
duosiančią	d u ɔ sʲ ɛ nʲ tʲ ʃʲ æː
duosiančiųjų	d u ɔ sʲ ɛ nʲ tʲ ʃʲ uː j uː
duosime	d u ɔ sʲ ɪ mʲ ɛ
duosite	d u ɔ sʲ ɪ tʲ ɛ
duosiu	d u ɔ sʲ ʊ
duosią	d u ɔ sʲ æː
duosiąs	d u ɔ sʲ æː s
duotas	d u ɔ t ɐ s
duoti	d u ɔ tʲ ɪ
duotum	d u ɔ t ʊ m
duotų	d u ɔ t u
duočiau	d u ɔ t ʃ ɐ u
dvaras	d̪ v ä̌ː r ɐ s̪
dviratis	d̪ʲ vʲ ɪ r ɐ t̪ʲ ɪ s̪
dėme	dʲ eː mʲ ɛ
dėmei	dʲ eː mʲ ɛ j
dėmes	dʲ eː mʲ ɛ s
dėmių	dʲ eː mʲ uː
dėmėje	dʲ eː mʲ eː j ɛ
dėmėmis	dʲ eː mʲ eː mʲ ɪ s
dėmės	dʲ eː mʲ eː s
džiaugsmas	d͡ʒ ɛ ʊ ɡʲ sʲ m ɐ s
džiaugsmingas	d͡ʒ ɛ ʊ ɡʲ sʲ mʲ ɪ n ɡ ɐ s
eglė	æː ɡʲ lʲ eː
ejakuliacija	ɛ j ɛ k ʊ lʲ æː tʲ sʲ ɪ j ɛ
ejakuliavusiosiose	ɛ j ɛ k ʊ lʲ æː ʋ ʊ sʲ o sʲ o sʲ ɛ
ejakuliavusysis	ɛ j ɛ k ʊ lʲ æː ʋ ʊ sʲ iː sʲ ɪ s
ejakuliavusį	ɛ j ɛ k ʊ lʲ æː ʋ ʊ sʲ iː
ejakuliuodavusiais	ɛ j ɛ k ʊ lʲ u o d ɐ ʋ ʊ sʲ ɛ j s
ejakuliuodavusiajai	ɛ j ɛ k ʊ lʲ u o d ɐ ʋ ʊ sʲ ɛ j ɛ j
ejakuliuodavusios	ɛ j ɛ k ʊ lʲ u o d ɐ ʋ ʊ sʲ o s
ejakuliuodavusiosioms	ɛ j ɛ k ʊ lʲ u o d ɐ ʋ ʊ sʲ o sʲ o m s
ejakuliuojantiems	ɛ j ɛ k ʊ lʲ u o j ɛ nʲ tʲ j ɛ m s
ejakuliuojančiais	ɛ j ɛ k ʊ lʲ u o j ɛ nʲ tʲ ʃʲ ɛ j s
ejakuliuojančiuosius	ɛ j ɛ k ʊ lʲ u o j ɛ nʲ tʲ ʃʲ ʊ o sʲ ʊ s
ejakuliuosiant	ɛ j ɛ k ʊ lʲ u o sʲ ɛ n t
ejakuliuosiančiais	ɛ j ɛ k ʊ lʲ u o sʲ ɛ nʲ tʲ ʃʲ ɛ j s
ejakuliuosiančiaisiais	ɛ j ɛ k ʊ lʲ u o sʲ ɛ nʲ tʲ ʃʲ ɛ j sʲ ɛ j s
ejakuliuosiančio	ɛ j ɛ k ʊ lʲ u o sʲ ɛ nʲ tʲ ʃʲ o
ejakuliuotum	ɛ j ɛ k ʊ lʲ u o t ʊ m
ejakuliuotų	ɛ j ɛ k ʊ lʲ u o t uː
ekonominis	ɛ k ɔ n ɔ mʲ ɪ nʲ ɪ s
elnias	æ l nʲ ɛ s
epicentrais	ɛ pʲ ɪ tʲ sʲ ɛ n t r ɐ j s
epicentras	ɛ pʲ ɪ tʲ sʲ ɛ n t r ɐ s
epicentro	ɛ pʲ ɪ tʲ sʲ ɛ n t r o
epicentru	ɛ pʲ ɪ tʲ sʲ ɛ n t r ʊ
erekcija	ɛ rʲ ɛ kʲ t sʲ ɪ j ɐ
ereliai	ɛ ɾʲ æː lʲ ɐ j
erelio	ɛ ɾʲ æː lʲ o
erelis	ɛ ɾʲ æː lʲ ɪ s
ereliu	ɛ ɾʲ ɛ lʲ ʊ
ereliui	ɛ ɾʲ æː lʲ ʊ ɪ
erelių	ɛ ɾʲ æː lʲ u
erelį	ɛ ɾʲ æː lʲ i
erkei	æː ɾʲ kʲ ɛ j
erkių	æː ɾʲ kʲ uː
erkė	æː ɾʲ kʲ eː
erkės	æː ɾʲ kʲ eː s
erkę	æː ɾʲ kʲ æː
erotika	ɛ ɾ ɔ tʲ ɪ k ɐ
erotines	ɛ ɾ o tʲ ɪ nʲ ɛ s
erotiniai	ɛ ɾ o tʲ ɪ nʲ ɛ j
erotiniame	ɛ ɾ o tʲ ɪ nʲ ɛ mʲ ɛ
erotiniams	ɛ ɾ o tʲ ɪ nʲ ɛ m s
erotinio	ɛ ɾ o tʲ ɪ nʲ o
erotinis	ɛ ɾ o tʲ ɪ nʲ ɪ s
erotiniu	ɛ ɾ o tʲ ɪ nʲ ʊ
erotinius	ɛ ɾ o tʲ ɪ nʲ ʊ s
erotinių	ɛ ɾ o tʲ ɪ nʲ uː
erotinė	ɛ ɾ o tʲ ɪ nʲ eː
erotinėmis	ɛ ɾ o tʲ ɪ nʲ eː mʲ ɪ s
erotinėms	ɛ ɾ o tʲ ɪ nʲ eː m s
erotinės	ɛ ɾ o tʲ ɪ nʲ eː s
erotinę	ɛ ɾ o tʲ ɪ nʲ æː
erotinį	ɛ ɾ o tʲ ɪ nʲ iː
erotiška	ɛ ɾ o tʲ ɪ ʃ k ɐ
erotiškai	ɛ ɾ o tʲ ɪ ʃ k ɐ j
erotiškajam	ɛ ɾ o tʲ ɪ ʃ k ɐ j ɛ m
erotiškame	ɛ ɾ o tʲ ɪ ʃ k ɐ mʲ ɛ
erotiškesnes	ɛ ɾ o tʲ ɪ ʃʲ kʲ ɛ sʲ nʲ ɛ s
erotiškesniame	ɛ ɾ o tʲ ɪ ʃʲ kʲ ɛ sʲ nʲ ɛ mʲ ɛ
erotiškesnėje	ɛ ɾ o tʲ ɪ ʃʲ kʲ ɛ sʲ nʲ eː j ɛ
erotiški	ɛ ɾ o tʲ ɪ ʃʲ kʲ ɪ
erotiškiausiuoju	ɛ ɾ o tʲ ɪ ʃʲ kʲ æː ʊ sʲ ʊ o j ʊ
erotiškiausiuose	ɛ ɾ o tʲ ɪ ʃʲ kʲ æː ʊ sʲ ʊ o sʲ ɛ
erotiškomis	ɛ ɾ o tʲ ɪ ʃ k o mʲ ɪ s
erotiškos	ɛ ɾ o tʲ ɪ ʃ k o s
erotišku	ɛ ɾ o tʲ ɪ ʃ k ʊ
erotiškus	ɛ ɾ o tʲ ɪ ʃ k ʊ s
erotišką	ɛ ɾ o tʲ ɪ ʃ k aː
esame	æː s ɐ mʲ ɛ
esanti	ɛ s ɐ nʲ tʲ ɪ
esantiems	ɛ s ɐ nʲ tʲ j ɛ m s
esantiesiems	ɛ s ɐ nʲ tʲ j ɛ sʲ j ɛ m s
esantis	ɛ s ɐ nʲ tʲ ɪ s
esantys	ɛ s ɐ nʲ tʲ i s
esančia	ɛ s ɐ nʲ tʲ ʃʲ ɛ
esančiai	ɛ s ɐ nʲ tʲ ʃʲ ɛ j
esančiais	ɛ s ɐ nʲ tʲ ʃʲ ɛ j s
esančiam	ɛ s ɐ nʲ tʲ ʃʲ ɛ m
esančiame	ɛ s ɐ nʲ tʲ ʃʲ ɛ mʲ ɛ
esančias	ɛ s ɐ nʲ tʲ ʃʲ ɛ s
esančio	ɛ s ɐ nʲ tʲ ʃʲ o
esančioje	ɛ s ɐ nʲ tʲ ʃʲ o j ɛ
esančiojo	ɛ s ɐ nʲ tʲ ʃʲ o j o
esančiomis	ɛ s ɐ nʲ tʲ ʃʲ o mʲ ɪ s
esančioms	ɛ s ɐ nʲ tʲ ʃʲ o m s
esančios	ɛ s ɐ nʲ tʲ ʃʲ o s
esančiose	ɛ s ɐ nʲ tʲ ʃʲ o sʲ ɛ
esančiosios	ɛ s ɐ nʲ tʲ ʃʲ o sʲ o s
esančiu	ɛ s ɐ nʲ tʲ ʃʲ ʊ
esančiuose	ɛ s ɐ nʲ tʲ ʃʲ ʊ o sʲ ɛ
esančių	ɛ s ɐ nʲ tʲ ʃʲ u
esančiųjų	ɛ s ɐ nʲ tʲ ʃʲ u j u
esate	æ s ɐ tʲ ɛ
esi	ɛ sʲ ɪ
estija	ɛ sʲ tʲ ɪ j ɛ
estijai	ɛ sʲ tʲ ɪ j ɛ j
estijos	ɛ sʲ tʲ ɪ j o s
estiją	ɛ sʲ tʲ ɪ j æː
estiška	ɛ sʲ tʲ ɪ ʃ k ɐ
estiškai	ɛ sʲ tʲ ɪ ʃ k ɐ j
estiškais	ɛ sʲ tʲ ɪ ʃ k ɐ j s
estiškas	ɛ sʲ tʲ ɪ ʃ k ɐ s
estiško	ɛ sʲ tʲ ɪ ʃ k o
estiškos	ɛ sʲ tʲ ɪ ʃ k o s
estiškuosius	ɛ sʲ tʲ ɪ ʃ k ʊ o sʲ ʊ s
estišką	ɛ sʲ tʲ ɪ ʃ k aː
estiškąsias	ɛ sʲ tʲ ɪ ʃ k aː sʲ ɛ s
esu	ɛ s ʊ
esąs	ɛ s aː s
ežerai	ɛ ʒʲ ɛ ɾ ɐ j
ežerais	ɛ ʒʲ ɛ ɾ ɐ j s
ežeras	æː ʒʲ ɛ ɾ ɐ s
ežerų	ɛ ʒʲ ɛ ɾ uː
faktas	f aː k t ɐ s
gabalas	ɡ ä̌ː b ɐ ɫ ɐ s̪
gaidrus	ɡ ɐ j d r ʊ s
gaidys	ɡ ɐ j dʲ iː s
gal	ɡ aː l
galas	ɡ aː l ɐ s
galininkas	ɡ ɐ lʲ ɪ nʲ ɪ ŋ k ɐ s
galinti	ɡ aː lʲ ɪ nʲ tʲ ɪ
galintieji	ɡ aː lʲ ɪ nʲ tʲ j ɛ j ɪ
galintiems	ɡ aː lʲ ɪ nʲ tʲ j ɛ m s
galintis	ɡ aː lʲ ɪ nʲ tʲ ɪ s
galintys	ɡ aː lʲ ɪ nʲ tʲ iː s
galintį	ɡ aː lʲ ɪ nʲ tʲ iː
galinčiais	ɡ aː lʲ ɪ nʲ tʲ ʃʲ ɛ j s
galinčiaisiais	ɡ aː lʲ ɪ nʲ tʲ ʃʲ ɛ j sʲ ɛ j s
galinčias	ɡ aː lʲ ɪ nʲ tʲ ʃʲ ɛ s
galinčiomis	ɡ aː lʲ ɪ nʲ tʲ ʃʲ o mʲ ɪ s
galinčios	ɡ aː lʲ ɪ nʲ tʲ ʃʲ o s
galinčius	ɡ aː lʲ ɪ nʲ tʲ ʃʲ ʊ s
galinčių	ɡ aː lʲ ɪ nʲ tʲ ʃʲ uː
galėdama	ɡ ɐ lʲ eː d ɐ m ɐ
galėdamas	ɡ ɐ lʲ eː d ɐ m ɐ s
galėdami	ɡ ɐ lʲ eː d ɐ mʲ ɪ
galėti	ɡ ɐ lʲ eː tʲ ɪ
galįs	ɡ aː lʲ iː s
garas	ɡ ä̌ː r ɐ s̪
garsas	ɡ ɐ r s̪ ɐ s̪
gatvių	ɡ aː tʲ ʋʲ uː
gatvė	ɡ aː tʲ ʋʲ eː
gatvėmis	ɡ aː tʲ ʋʲ eː mʲ ɪ s
gatvėms	ɡ aː tʲ ʋʲ eː m s
gatvėse	ɡ aː tʲ ʋʲ eː sʲ ɛ
geisti	ɡʲ ɛ j sʲ tʲ ɪ
geografija	ɡʲ ɛ o ɡ ɾ aː f ɪ j ɐ
gerklė	ɡʲ ɛ rʲ kʲ lʲ ěː
gerti	ɡʲ ɛ rʲ tʲ ɪ
getai	ɡʲ ɛ t ɐ j
gete	ɡʲ ɛ tʲ ɛ
geto	ɡʲ ɛ t o
getuose	ɡʲ ɛ t ʊ o sʲ ɛ
getus	ɡʲ ɛ t ʊ s
getų	ɡʲ ɛ t uː
gilaus	ɡʲ ɪ l ɐ u s
gilesne	ɡʲ ɪ lʲ ɛ sʲ nʲ ɛ
gilesnes	ɡʲ ɪ lʲ ɛ sʲ nʲ ɛ s
gilesni	ɡʲ ɪ lʲ ɛ sʲ nʲ ɪ
gilesniais	ɡʲ ɪ lʲ ɛ sʲ nʲ ɛ j s
gilesniam	ɡʲ ɪ lʲ ɛ sʲ nʲ æː m
gilesnieji	ɡʲ ɪ lʲ ɛ sʲ nʲ j ɛ j ɪ
gilesniems	ɡʲ ɪ lʲ ɛ sʲ nʲ j ɛ m s
gilesnio	ɡʲ ɪ lʲ ɛ sʲ nʲ o
gilesnis	ɡʲ ɪ lʲ ɛ sʲ nʲ ɪ s
gilesniu	ɡʲ ɪ lʲ ɛ sʲ nʲ ʊ
gilesniuose	ɡʲ ɪ lʲ ɛ sʲ nʲ ʊ o sʲ ɛ
gilesnius	ɡʲ ɪ lʲ ɛ sʲ nʲ ʊ s
gilesnių	ɡʲ ɪ lʲ ɛ sʲ nʲ uː
gilesniųjų	ɡʲ ɪ lʲ ɛ sʲ nʲ uː j uː
gilesnė	ɡʲ ɪ lʲ ɛ sʲ nʲ eː
gilesnėmis	ɡʲ ɪ lʲ ɛ sʲ nʲ eː mʲ ɪ s
gilesnės	ɡʲ ɪ lʲ ɛ sʲ nʲ eː s
gilesnėse	ɡʲ ɪ lʲ ɛ sʲ nʲ eː sʲ ɛ
gilesnę	ɡʲ ɪ lʲ ɛ sʲ nʲ æː
gilesnį	ɡʲ ɪ lʲ ɛ sʲ nʲ iː
gili	ɡʲ ɪ lʲ ɪ
gilia	ɡʲ ɪ lʲ ɛ
giliai	ɡʲ ɪ lʲ ɛ j
giliais	ɡʲ ɪ lʲ ɛ j s
giliajame	ɡʲ ɪ lʲ æː j ɛ mʲ ɛ
giliam	ɡʲ ɪ lʲ æː m
giliame	ɡʲ ɪ lʲ ɛ mʲ ɛ
gilias	ɡʲ ɪ lʲ ɛ s
giliausi	ɡʲ ɪ lʲ æː ʊ sʲ ɪ
giliausia	ɡʲ ɪ lʲ æː ʊ sʲ ɛ
giliausiais	ɡʲ ɪ lʲ æː ʊ sʲ ɛ j s
giliausias	ɡʲ ɪ lʲ æː ʊ sʲ ɛ s
giliausiems	ɡʲ ɪ lʲ æː ʊ sʲ j ɛ m s
giliausio	ɡʲ ɪ lʲ æː ʊ sʲ o
giliausioje	ɡʲ ɪ lʲ æː ʊ sʲ o j ɛ
giliausiojoje	ɡʲ ɪ lʲ æː ʊ sʲ o j o j ɛ
giliausiomis	ɡʲ ɪ lʲ æː ʊ sʲ o mʲ ɪ s
giliausius	ɡʲ ɪ lʲ æː ʊ sʲ ʊ s
giliausią	ɡʲ ɪ lʲ æː ʊ sʲ æː
giliausių	ɡʲ ɪ lʲ æː ʊ sʲ uː
gilieji	ɡʲ ɪ lʲ j ɛ j ɪ
giliems	ɡʲ ɪ lʲ j ɛ m s
gilioje	ɡʲ ɪ lʲ o j ɛ
giliomis	ɡʲ ɪ lʲ o mʲ ɪ s
gilioms	ɡʲ ɪ lʲ oː m s
giliu	ɡʲ ɪ lʲ ʊ
giliuoju	ɡʲ ɪ lʲ u ɔ j ʊ
giliuose	ɡʲ ɪ lʲ ʊ o sʲ ɛ
giliuosiuose	ɡʲ ɪ lʲ ʊ oː sʲ ʊ o sʲ ɛ
giliuosius	ɡʲ ɪ lʲ u ɔ sʲ ʊ s
gilius	ɡʲ ɪ lʲ ʊ s
gilią	ɡʲ ɪ lʲ æː
giliąją	ɡʲ ɪ lʲ æː j æː
gilių	ɡʲ ɪ lʲ uː
gilu	ɡʲ ɪ l ʊ
gilus	ɡʲ ɪ l ʊ s
gilūs	ɡʲ ɪ l uː s
gilų	ɡʲ ɪ l uː
gimtas	ɡʲ ɪ m t ɐ s
giria	ɡʲ ɪ rʲ ɛ
graikija	ɡ r ɐ j kʲ ɪ j ɛ
graikijai	ɡ r ɐ j kʲ ɪ j ɛ j
graikijoje	ɡ r ɐ j kʲ ɪ j o j ɛ
graikijos	ɡ r ɐ j kʲ ɪ j o s
graikiją	ɡ r ɐ j kʲ ɪ j æː
graikiška	ɡ r ɐ j kʲ ɪ ʃ k ɐ
graikiškai	ɡ r ɐ j kʲ ɪ ʃ k ɐ j
graikiškame	ɡ r ɐ j kʲ ɪ ʃ k ɐ mʲ ɛ
graikiškas	ɡ r ɐ j kʲ ɪ ʃ k ɐ s
graikiški	ɡ r ɐ j kʲ ɪ ʃʲ kʲ ɪ
graikiškieji	ɡ r ɐ j kʲ ɪ ʃʲ kʲ j ɛ j ɪ
graikiško	ɡ r ɐ j kʲ ɪ ʃ k o
graikiškos	ɡ r ɐ j kʲ ɪ ʃ k o s
graikiškosios	ɡ r ɐ j kʲ ɪ ʃ k o sʲ o s
graikiškosiose	ɡ r ɐ j kʲ ɪ ʃ k o sʲ o sʲ ɛ
graikišku	ɡ r ɐ j kʲ ɪ ʃ k ʊ
graikiškuoju	ɡ r ɐ j kʲ ɪ ʃ k ʊ o j ʊ
graikiškus	ɡ r ɐ j kʲ ɪ ʃ k ʊ s
graikišką	ɡ r ɐ j kʲ ɪ ʃ k aː
graikiškąjį	ɡ r ɐ j kʲ ɪ ʃ k aː j iː
graikiškų	ɡ r ɐ j kʲ ɪ ʃ k uː
gramas	ɡ r ä̌ː m ɐ s̪
gražaus	ɡ ɾ ɐ ʒ ɐ u s
gražesne	ɡ ɾ ɐ ʒʲ ɛ sʲ nʲ ɛ
gražesnes	ɡ ɾ ɐ ʒʲ ɛ sʲ nʲ ɛ s
gražesni	ɡ ɾ ɐ ʒʲ ɛ sʲ nʲ ɪ
gražesniais	ɡ ɾ ɐ ʒʲ ɛ sʲ nʲ ɛ j s
gražesniam	ɡ ɾ ɐ ʒʲ ɛ sʲ nʲ æː m
gražesnio	ɡ ɾ ɐ ʒʲ ɛ sʲ nʲ o
gražesnis	ɡ ɾ ɐ ʒʲ ɛ sʲ nʲ ɪ s
gražesniu	ɡ ɾ ɐ ʒʲ ɛ sʲ nʲ ʊ
gražesnius	ɡ ɾ ɐ ʒʲ ɛ sʲ nʲ ʊ s
gražesnių	ɡ ɾ ɐ ʒʲ ɛ sʲ nʲ uː
gražesnė	ɡ ɾ ɐ ʒʲ ɛ sʲ nʲ eː
gražesnės	ɡ ɾ ɐ ʒʲ ɛ sʲ nʲ eː s
gražesnę	ɡ ɾ ɐ ʒʲ ɛ sʲ nʲ æː
gražesnį	ɡ ɾ ɐ ʒʲ ɛ sʲ nʲ iː
graži	ɡ ɾ ɐ ʒʲ ɪ
gražia	ɡ ɾ ɐ ʒʲ ɛ
gražiais	ɡ ɾ ɐ ʒʲ ɛ j s
gražiajame	ɡ ɾ ɐ ʒʲ æː j ɛ mʲ ɛ
gražiam	ɡ ɾ ɐ ʒʲ æː m
gražiame	ɡ ɾ ɐ ʒʲ ɛ mʲ ɛ
gražias	ɡ ɾ ɐ ʒʲ ɛ s
gražiau	ɡ ɾ ɐ ʒʲ ɛ u
gražiausi	ɡ ɾ ɐ ʒʲ æː ʊ sʲ ɪ
gražiausia	ɡ ɾ ɐ ʒʲ æː ʊ sʲ ɛ
gražiausiais	ɡ ɾ ɐ ʒʲ æː ʊ sʲ ɛ j s
gražiausias	ɡ ɾ ɐ ʒʲ æː ʊ sʲ ɛ s
gražiausio	ɡ ɾ ɐ ʒʲ æː ʊ sʲ o
gražiausioje	ɡ ɾ ɐ ʒʲ æː ʊ sʲ o j ɛ
gražiausiomis	ɡ ɾ ɐ ʒʲ æː ʊ sʲ o mʲ ɪ s
gražiausioms	ɡ ɾ ɐ ʒʲ æː ʊ sʲ o m s
gražiausios	ɡ ɾ ɐ ʒʲ æː ʊ sʲ o s
gražiausiose	ɡ ɾ ɐ ʒʲ æː ʊ sʲ o sʲ ɛ
gražiausiu	ɡ ɾ ɐ ʒʲ æː ʊ sʲ ʊ
gražiausiuose	ɡ ɾ ɐ ʒʲ æː ʊ sʲ ʊ o sʲ ɛ
gražiausius	ɡ ɾ ɐ ʒʲ æː ʊ sʲ ʊ s
gražiausią	ɡ ɾ ɐ ʒʲ æː ʊ sʲ æː
gražiausių	ɡ ɾ ɐ ʒʲ æː ʊ sʲ uː
gražiems	ɡ ɾ ɐ ʒʲ j ɛ m s
gražinti	ɡ ɾ aː ʒʲ ɪ nʲ t ɪ
gražioje	ɡ ɾ ɐ ʒʲ o j ɛ
gražioji	ɡ ɾ ɐ ʒʲ oː j ɪ
gražiomis	ɡ ɾ ɐ ʒʲ o mʲ ɪ s
gražioms	ɡ ɾ ɐ ʒʲ oː m s
gražiose	ɡ ɾ ɐ ʒʲ o sʲ ɛ
gražiosioms	ɡ ɾ ɐ ʒʲ oː sʲ o m s
gražiu	ɡ ɾ ɐ ʒʲ ʊ
gražiuoju	ɡ ɾ ɐ ʒʲ u ɔ j ʊ
gražiuose	ɡ ɾ ɐ ʒʲ ʊ o sʲ ɛ
gražiuosius	ɡ ɾ ɐ ʒʲ u ɔ sʲ ʊ s
gražius	ɡ ɾ ɐ ʒʲ ʊ s
gražią	ɡ ɾ aː ʒʲ æː
gražiąja	ɡ ɾ ɐ ʒʲ æː j ɛ
gražiąsias	ɡ ɾ ɐ ʒʲ æː sʲ ɛ s
gražių	ɡ ɾ ɐ ʒʲ uː
gražiųjų	ɡ ɾ ɐ ʒʲ uː j uː
gražu	ɡ ɾ ɐ ʒ ʊ
gražumas	ɡ ɾ ɐ ʒ ʊ m ɐ s
gražume	ɡ ɾ ɐ ʒ ʊ mʲ ɛ
gražumu	ɡ ɾ ɐ ʒ ʊ m ʊ
gražumą	ɡ ɾ ɐ ʒ ʊ m aː
gražus	ɡ ɾ ɐ ʒ ʊ s
gražūs	ɡ ɾ aː ʒ uː s
gražų	ɡ ɾ aː ʒ uː
gražųjį	ɡ ɾ aː ʒ uː j iː
greita	ɡ ɾ ɛ j t ɐ
greitais	ɡ ɾ ɛ j t ɐ j s
greitajai	ɡ ɾ ɛ j t ɐ j ɛ j
greitajam	ɡ ɾ ɛ j t aː j ɛ m
greitam	ɡ ɾ ɛ j t aː m
greitame	ɡ ɾ ɛ j t ɐ mʲ ɛ
greitas	ɡ ɾ ɛ j t ɐ s
greitasis	ɡ ɾ ɛ j t ɐ sʲ ɪ s
greiti	ɡ ɾ ɛ j tʲ ɪ
greitieji	ɡ ɾ ɛ j tʲ j ɛ j ɪ
greitiems	ɡ ɾ ɛ j tʲ j ɛ m s
greito	ɡ ɾ ɛ j t o
greitoje	ɡ ɾ ɛ j t o j ɛ
greitoji	ɡ ɾ ɛ j t oː j ɪ
greitojo	ɡ ɾ ɛ j t o j o
greitojoje	ɡ ɾ ɛ j t oː j o j ɛ
greitomis	ɡ ɾ ɛ j t o mʲ ɪ s
greitoms	ɡ ɾ ɛ j t oː m s
greitosiomis	ɡ ɾ ɛ j t oː sʲ o mʲ ɪ s
greitu	ɡ ɾ ɛ j t ʊ
greituoju	ɡ ɾ ɛ j t u ɔ j ʊ
greituose	ɡ ɾ ɛ j t ʊ o sʲ ɛ
greitus	ɡ ɾ ɛ j t ʊ s
greitą	ɡ ɾ ɛ j t aː
greitąją	ɡ ɾ ɛ j t aː j æː
greitąjį	ɡ ɾ ɛ j t aː j iː
greitąsias	ɡ ɾ ɛ j t aː sʲ ɛ s
greitų	ɡ ɾ ɛ j t uː
greitųjų	ɡ ɾ ɛ j t uː j uː
gruzija	ɡ r ʊ zʲ ɪ j ɛ
gruzijai	ɡ r ʊ zʲ ɪ j ɛ j
gruzijoje	ɡ r ʊ zʲ ɪ j o j ɛ
gruzijos	ɡ r ʊ zʲ ɪ j o s
gruziją	ɡ r ʊ zʲ ɪ j æː
grybas	ɡʲ ɾʲ iː b ɐ s
grįžti	ɡʲ rʲ ǐː ʃʲ tʲ ɪ
grūdas	ɡ r ûː d̪ ɐ s̪
gudri	ɡ ʊ dʲ rʲ ɪ
gudrus	ɡ ʊ d̪ r ʊ s̪
gulbe	ɡ ʊ lʲ bʲ ɛ
gulbei	ɡ ʊ lʲ bʲ ɛ j
gulbių	ɡ ʊ lʲ bʲ uː
gulbė	ɡ ʊ lʲ bʲ eː
gulbėje	ɡ ʊ lʲ bʲ eː j ɛ
gulbėms	ɡ ʊ lʲ bʲ eː m s
gulbės	ɡ ʊ lʲ bʲ eː s
gyvatė	ɡʲ iː ʋ aː tʲ eː
gyventi	ɡ i ʋ æ n t ɪ
gyvulys	ɡʲ iː v ʊ lʲ î s̪
gyvūnai	ɡʲ iː ʋ uː n ɐ j
gyvūnais	ɡʲ iː ʋ uː n ɐ j s
gyvūnams	ɡʲ iː ʋ uː n ɐ m s
gyvūno	ɡʲ iː ʋ uː n o
gyvūnu	ɡʲ iː ʋ uː n ʊ
gyvūnui	ɡʲ iː ʋ uː n ʊ ɪ
gyvūnuose	ɡʲ iː ʋ uː n ʊ o sʲ ɛ
gyvūnus	ɡʲ iː ʋ uː n ʊ s
gyvūną	ɡʲ iː ʋ uː n aː
gyvūnų	ɡʲ iː ʋ uː n uː
gėjus	ɡʲ eː j ʊ s
gėle	ɡʲ eː lʲ ɛ
gėles	ɡʲ eː lʲ ɛ s
gėlių	ɡʲ eː lʲ uː
gėlė	ɡʲ eː lʲ eː
gėlėmis	ɡʲ eː lʲ eː mʲ ɪ s
gėlėms	ɡʲ eː lʲ eː m s
gėlės	ɡʲ eː lʲ eː s
gėlę	ɡʲ eː lʲ æː
gęsta	ɡʲ æ̌ː s̪ t̪ ɐ
haliucinacija	h ɐ lʲ ʊ tʲ sʲ ɪ n aː tʲ sʲ ɪ j ɛ
haliucinacijas	h ɐ lʲ ʊ tʲ sʲ ɪ n aː tʲ sʲ ɪ j ɛ s
haliucinacijos	h ɐ lʲ ʊ tʲ sʲ ɪ n aː tʲ sʲ ɪ j o s
haliucinaciją	h ɐ lʲ ʊ tʲ sʲ ɪ n aː tʲ sʲ ɪ j æː
haliucinacijų	h ɐ lʲ ʊ tʲ sʲ ɪ n aː tʲ sʲ ɪ j uː
haliucinavusiaisiais	h ɐ lʲ ʊ tʲ sʲ ɪ n aː ʋ ʊ sʲ ɛ j sʲ ɛ j s
haliucinavusiajame	h ɐ lʲ ʊ tʲ sʲ ɪ n aː ʋ ʊ sʲ ɛ j ɛ mʲ ɛ
haliucinavusiu	h ɐ lʲ ʊ tʲ sʲ ɪ n aː ʋ ʊ sʲ ʊ
haliucinavusiuosiuose	h ɐ lʲ ʊ tʲ sʲ ɪ n aː ʋ ʊ sʲ ʊ o sʲ ʊ o sʲ ɛ
haliucinavusiąją	h ɐ lʲ ʊ tʲ sʲ ɪ n aː ʋ ʊ sʲ æː j æː
haliucinavusiąsias	h ɐ lʲ ʊ tʲ sʲ ɪ n aː ʋ ʊ sʲ æː sʲ ɛ s
haliucinuodavusiai	h ɐ lʲ ʊ tʲ sʲ ɪ n u o d ɐ ʋ ʊ sʲ ɛ j
haliucinuodavusiame	h ɐ lʲ ʊ tʲ sʲ ɪ n u o d ɐ ʋ ʊ sʲ ɛ mʲ ɛ
haliucinuodavusio	h ɐ lʲ ʊ tʲ sʲ ɪ n u o d ɐ ʋ ʊ sʲ o
haliucinuodavusios	h ɐ lʲ ʊ tʲ sʲ ɪ n u o d ɐ ʋ ʊ sʲ o s
haliucinuodavusią	h ɐ lʲ ʊ tʲ sʲ ɪ n u o d ɐ ʋ ʊ sʲ æː
haliucinuodavusiąją	h ɐ lʲ ʊ tʲ sʲ ɪ n u o d ɐ ʋ ʊ sʲ æː j æː
haliucinuojantį	h ɐ lʲ ʊ tʲ sʲ ɪ n u o j ɛ nʲ tʲ iː
haliucinuojančiajai	h ɐ lʲ ʊ tʲ sʲ ɪ n u o j ɛ nʲ tʲ ʃʲ ɛ j ɛ j
haliucinuojančiojo	h ɐ lʲ ʊ tʲ sʲ ɪ n u o j ɛ nʲ tʲ ʃʲ o j o
haliucinuojančiosiomis	h ɐ lʲ ʊ tʲ sʲ ɪ n u o j ɛ nʲ tʲ ʃʲ o sʲ o mʲ ɪ s
haliucinuosi	h ɐ lʲ ʊ tʲ sʲ ɪ n u o sʲ ɪ
haliucinuosiantįjį	h ɐ lʲ ʊ tʲ sʲ ɪ n u o sʲ ɛ nʲ tʲ iː j iː
haliucinuosiančiam	h ɐ lʲ ʊ tʲ sʲ ɪ n u o sʲ ɛ nʲ tʲ ʃʲ ɛ m
haliucinuosiančiame	h ɐ lʲ ʊ tʲ sʲ ɪ n u o sʲ ɛ nʲ tʲ ʃʲ ɛ mʲ ɛ
haliucinuosiančiuose	h ɐ lʲ ʊ tʲ sʲ ɪ n u o sʲ ɛ nʲ tʲ ʃʲ ʊ o sʲ ɛ
haliucinuosite	h ɐ lʲ ʊ tʲ sʲ ɪ n u o sʲ ɪ tʲ ɛ
homoseksualumas	h ɔ m ɔ sʲ ɛ k s ʊ ɐ l ʊ m ɐ s
impotencija	ɪ m p o t ɛ n t s ɪ j ɐ
informacija	ɪ n f o ɾ m aː t s ɪ j ɐ
instrukcija	ɪ n s t r ʊ k t s ɪ j ɐ
instrukcijai	ɪ n s t r ʊ k t sʲ ɪ j ɐ j
instrukcijas	ɪ n s t r ʊ k t sʲ ɪ j ɐ s
instrukcijoje	ɪ n s t r ʊ k t sʲ ɪ j ɔ j æ
instrukcijomis	ɪ n s t r ʊ k t sʲ ɪ j ɔ mʲ ɪ s
instrukcijos	ɪ n s t r ʊ k t sʲ ɪ j ɔ s
instrukcijose	ɪ n s t r ʊ k t sʲ ɪ j ɔ sʲ æ
instrukciją	ɪ n s t r ʊ k t sʲ ɪ j aː
instrukcijų	ɪ n s t r ʊ k t sʲ ɪ j uː
ispaniška	ɪ s p aː nʲ ɪ ʃ k ɐ
ispaniškai	ɪ s p aː nʲ ɪ ʃ k ɐ j
ispaniškais	ɪ s p aː nʲ ɪ ʃ k ɐ j s
ispaniškame	ɪ s p aː nʲ ɪ ʃ k ɐ mʲ ɛ
ispaniškas	ɪ s p aː nʲ ɪ ʃ k ɐ s
ispaniški	ɪ s p aː nʲ ɪ ʃʲ kʲ ɪ
ispaniško	ɪ s p aː nʲ ɪ ʃ k o
ispaniškoji	ɪ s p aː nʲ ɪ ʃ k o j ɪ
ispaniškos	ɪ s p aː nʲ ɪ ʃ k o s
ispaniškosiomis	ɪ s p aː nʲ ɪ ʃ k o sʲ o mʲ ɪ s
ispaniškosios	ɪ s p aː nʲ ɪ ʃ k o sʲ o s
ispanišku	ɪ s p aː nʲ ɪ ʃ k ʊ
ispaniškus	ɪ s p aː nʲ ɪ ʃ k ʊ s
ispanišką	ɪ s p aː nʲ ɪ ʃ k aː
ispaniškąja	ɪ s p aː nʲ ɪ ʃ k aː j ɛ
ispaniškų	ɪ s p aː nʲ ɪ ʃ k uː
ispaniškųjų	ɪ s p aː nʲ ɪ ʃ k uː j uː
italija	ɪ t aː lʲ ɪ j ɛ
italijai	ɪ t aː lʲ ɪ j ɛ j
italijoje	ɪ t aː lʲ ɪ j o j ɛ
italiją	ɪ t aː lʲ ɪ j æː
itališkaisiais	ɪ t aː lʲ ɪ ʃ k ɐ j sʲ ɛ j s
itališkasis	ɪ t aː lʲ ɪ ʃ k ɐ sʲ ɪ s
itališkuosius	ɪ t aː lʲ ɪ ʃ k ʊ o sʲ ʊ s
itališkąsias	ɪ t aː lʲ ɪ ʃ k aː sʲ ɛ s
izoterminiu	ɪ z o tʲ ɛ rʲ mʲ ɪ nʲ ʊ
izoterminių	ɪ z o tʲ ɛ rʲ mʲ ɪ nʲ uː
izoterminę	ɪ z o tʲ ɛ rʲ mʲ ɪ nʲ æː
izotopais	ɪ z o t o p ɐ j s
izotopas	ɪ z o t o p ɐ s
iš	ɪ ʃ
išbučiavo	ɪ ʃ b ʊ tʲ ʃʲ æː ʋ o
išbučiuoja	ɪ ʃ b ʊ tʲ ʃʲ u o j ɛ
išbučiuosianti	ɪ ʃ b ʊ tʲ ʃʲ u ɔ sʲ ɛ nʲ tʲ ɪ
išbučiuosiantį	ɪ ʃ b ʊ tʲ ʃʲ u ɔ sʲ ɛ nʲ tʲ iː
išbučiuosiantįjį	ɪ ʃ b ʊ tʲ ʃʲ u ɔ sʲ ɛ nʲ tʲ iː j iː
išbučiuosiančiuose	ɪ ʃ b ʊ tʲ ʃʲ u ɔ sʲ ɛ nʲ tʲ ʃʲ ʊ o sʲ ɛ
išbūti	ɪ ʃ b uː tʲ ɪ
išdaigiajai	ɪ ʃ d ɐ j ɡʲ ɛ j ɛ j
išdaigiuosius	ɪ ʃ d ɐ j ɡʲ u ɔ sʲ ʊ s
išdaigiąją	ɪ ʃ d ɐ j ɡʲ æː j æː
išdaigų	ɪ ʃ d ɐ j ɡ uː
išdaigųjį	ɪ ʃ d ɐ j ɡ uː j iː
išdavėjui	ɪ ʃ d ɐ ʋʲ eː j ʊ ɪ
išduosiančiu	ɪ ʃ d u ɔ sʲ ɛ nʲ tʲ ʃʲ ʊ
išduosią	ɪ ʃ d u ɔ sʲ æː
iškalbiajai	ɪ ʃ k ɐ l bʲ ɛ j ɛ j
iškalbiausiajai	ɪ ʃ k ɐ l bʲ æː ʊ sʲ ɛ j ɛ j
iškalbiausiasis	ɪ ʃ k ɐ l bʲ æː ʊ sʲ ɛ sʲ ɪ s
iškalbiausiuosiuose	ɪ ʃ k ɐ l bʲ æː ʊ sʲ ʊ o sʲ ʊ o sʲ ɛ
iškalbiuoju	ɪ ʃ k ɐ l bʲ u ɔ j ʊ
iškeliaujančiosiomis	ɪ ʃʲ kʲ ɛ lʲ æ ʊ j ɛ nʲ tʲ ʃʲ o sʲ o mʲ ɪ s
iškeliaujančiąsias	ɪ ʃʲ kʲ ɛ lʲ æ ʊ j ɛ nʲ tʲ ʃʲ æː sʲ ɛ s
iškeliauti	ɪ ʃʲ kʲ ɛ lʲ æ ʊ tʲ ɪ
išnaudotojai	ɪ ʃ n ɐ ʊ d oː t o j ɛ j
išnaudotojais	ɪ ʃ n ɐ ʊ d oː t o j ɛ j s
išnaudotojau	ɪ ʃ n ɐ ʊ d oː t o j ɛ ʊ
išnaudotojos	ɪ ʃ n ɐ ʊ d oː t o j o s
išnaudotojus	ɪ ʃ n ɐ ʊ d oː t o j ʊ s
išparduoti	ɪ ʃ p ɐ ɾ d u ɔ tʲ ɪ
išsiveržimai	ɪ ʃʲ sʲ ɪ ʋʲ ɛ rʲ ʒʲ ɪ m ɐ j
išsiveržimais	ɪ ʃʲ sʲ ɪ ʋʲ ɛ rʲ ʒʲ ɪ m ɐ j s
išsiveržimas	ɪ ʃʲ sʲ ɪ ʋʲ ɛ rʲ ʒʲ ɪ m ɐ s
išsiveržimo	ɪ ʃʲ sʲ ɪ ʋʲ ɛ rʲ ʒʲ ɪ m o
išsiveržimą	ɪ ʃʲ sʲ ɪ ʋʲ ɛ rʲ ʒʲ ɪ m aː
išsiveržimų	ɪ ʃʲ sʲ ɪ ʋʲ ɛ rʲ ʒʲ ɪ m uː
išsiveržti	ɪ sʲ vʲ ɛ rʲ ʃʲ tʲ ɪ
išsiūti	ɪ ʃʲ sʲ uː tʲ ɪ
ištarimas	ɪ ʃ t ɐ ɾʲ ɪ m ɐ s
ištatuiravo	ɪ ʃ t ɐ t ʊ ɪ ɾ aː ʋ o
ištatuiravusi	ɪ ʃ t ɐ t ʊ ɪ r aː ʋ ʊ sʲ ɪ
ištatuiravusiosioms	ɪ ʃ t ɐ t ʊ ɪ r aː ʋ ʊ sʲ o sʲ o m s
ištatuiravusįjį	ɪ ʃ t ɐ t ʊ ɪ r aː ʋ ʊ sʲ iː j iː
ištatuiruojančiuosiuose	ɪ ʃ t ɐ t ʊ ɪ ɾ u ɔ j ɛ nʲ tʲ ʃʲ ʊ o sʲ ʊ o sʲ ɛ
ištatuiruojančiąja	ɪ ʃ t ɐ t ʊ ɪ ɾ u ɔ j ɛ nʲ tʲ ʃʲ æː j ɛ
ištatuiruokite	ɪ ʃ t ɐ t ʊ ɪ ɾ u o kʲ ɪ tʲ ɛ
ištatuiruosiu	ɪ ʃ t ɐ t ʊ ɪ ɾ u o sʲ ʊ
ištatuiruosiąs	ɪ ʃ t ɐ t ʊ ɪ ɾ u o sʲ æː s
ištatuiruoti	ɪ ʃ t ɐ t ʊ ɪ ɾ u ɔ tʲ ɪ
išvalyti	ɪ ʃ ʋ ɐ lʲ iː tʲ ɪ
iššūkis	ɪ ʃ uː k ɪ s
išžiūrinti	ɪ ʃʲ ʒʲ uː rʲ ɪ nʲ tʲ ɪ
išžiūrinčia	ɪ ʃʲ ʒʲ uː rʲ ɪ nʲ tʲ ʃʲ ɛ
išžiūrinčioji	ɪ ʃʲ ʒʲ uː rʲ ɪ nʲ tʲ ʃʲ o j ɪ
išžiūrinčius	ɪ ʃʲ ʒʲ uː rʲ ɪ nʲ tʲ ʃʲ ʊ s
japoniškasis	j ɛ p o nʲ ɪ ʃ k ɐ sʲ ɪ s
jei	j æ j
jo	j o
jonvabali	j oː n ʋ ɐ b ɐ lʲ ɪ
jonvabalio	j oː n ʋ ɐ b ɐ lʲ o
jonvabalis	j oː n ʋ ɐ b ɐ lʲ ɪ s
jonvabaliu	j oː n ʋ ɐ b ɐ lʲ ʊ
jonvabalių	j oː n ʋ ɐ b ɐ lʲ uː
jonvabalį	j oː n ʋ ɐ b ɐ lʲ iː
joti	j ôː tʲ ɪ
judinti	j ʊ dʲ ɪ n tʲ ɪ
judėti	j ʊ dʲ eː tʲ ɪ
jungti	j ʊ ŋʲ kʲ tʲ ɪ
juosta	j û ə s̪ t̪ ɐ
jurginas	j ʊ ɾʲ ɡʲ ɪ n ɐ s
jėgainė	j eː ɡ ɐ ɪ n eː
jūra	j uː r ɐ
jūrai	j uː r ɐ j
jūras	j uː r ɐ s
jūroje	j uː r o j ɛ
jūromis	j uː r o mʲ ɪ s
jūros	j uː r o s
jūrose	j uː r o sʲ ɛ
jūrų	j uː r uː
jūsų	j uː s uː
kadagys	k ɐ d̪ ɐ ɡʲ ǐː s̪
kaitra	k ɐ ɪ̯ˑ t̪ r ɐ
kaklas	k ä̌ː k l ɐ s̪
kaktusas	k a k t ʊ s ɐ s
kaladė	k ɐ l aː d eː
kalavijas	k ɐ l ɐ ʋʲ ɪ j ɐ s
kalbanti	k ɐ l b ɐ nʲ tʲ ɪ
kalbantieji	k ɐ l b ɐ nʲ tʲ j ɛ j ɪ
kalbantiems	k ɐ l b ɐ nʲ tʲ j ɛ m s
kalbantis	k ɐ l b ɐ nʲ tʲ ɪ s
kalbantysis	k ɐ l b ɐ nʲ tʲ i sʲ ɪ s
kalbantį	k ɐ l b ɐ nʲ tʲ i
kalbančiam	k ɐ l b ɐ nʲ tʲ ʃʲ ɛ m
kalbančiame	k ɐ l b ɐ nʲ tʲ ʃʲ ɛ mʲ ɛ
kalbančias	k ɐ l b ɐ nʲ tʲ ʃʲ ɛ s
kalbančio	k ɐ l b ɐ nʲ tʲ ʃʲ o
kalbančiomis	k ɐ l b ɐ nʲ tʲ ʃʲ o mʲ ɪ s
kalbančios	k ɐ l b ɐ nʲ tʲ ʃʲ o s
kalbančiu	k ɐ l b ɐ nʲ tʲ ʃʲ ʊ
kalbančiuosius	k ɐ l b ɐ nʲ tʲ ʃʲ ʊ o sʲ ʊ s
kalbančių	k ɐ l b ɐ nʲ tʲ ʃʲ u
kalbančiųjų	k ɐ l b ɐ nʲ tʲ ʃʲ u j u
kalbiais	k ɐ l bʲ ɛ j s
kalbėsiančiose	k ɐ l bʲ eː sʲ ɛ nʲ tʲ ʃʲ o sʲ ɛ
kalbėsiančiąsias	k ɐ l bʲ eː sʲ ɛ nʲ tʲ ʃʲ æ sʲ ɛ s
kalbūs	k ɐ l b uː s
kalnagūbriai	k ɐ l n aː ɡ uː bʲ rʲ ɛ j
kalnagūbrių	k ɐ l n aː ɡ uː bʲ rʲ uː
kalnagūbrį	k ɐ l n aː ɡ uː bʲ rʲ iː
kalnais	k ɐ l n ɐ j s
kalnams	k ɐ l n aː m s
kalnas	k a͡l n ɐ s
kalno	k aː l n o
kalnodarų	k ɐ l n oː d ɐ r uː
kalnu	k aː l n ʊ
kalnui	k aː l n ʊ ɪ
kalnuose	k ɐ l n ʊ o sʲ ɛ
kalnus	k aː l n ʊ s
kalnynais	k ɐ lʲ nʲ iː n ɐ j s
kalnyne	k ɐ lʲ nʲ iː n ɛ
kalnyno	k ɐ lʲ nʲ iː n o
kalnynų	k ɐ lʲ nʲ iː n uː
kalną	k aː l n aː
kalti	k ɐ lʲ tʲ ɪ
kaltinti	k aː lʲ tʲ ɪ nʲ tʲ ɪ
kalva	k ɐ l ʋ ɐ
kankina	k ɐ ŋʲ kʲ ɪ n̪ ɐ
kapšeliai	k ɐ pʲ ʃʲ æː lʲ ɛ j
kapšelio	k ɐ pʲ ʃʲ æː lʲ o
kapšelis	k ɐ pʲ ʃʲ æː lʲ ɪ s
kapšelius	k ɐ pʲ ʃʲ ɛ lʲ ʊ s
kapšu	k ɐ p ʃ ʊ
karalius	k ɐ r aː lʲ ʊ s
karališkas	k ɐ r aː lʲ ɪ ʃ k ɐ s
kartoti	k ɐ ɾ t oː t ɪ
kartus	k ɐ ɾ t ʊ s
karvė	k a ɾ ʋʲ e
katedra	k a t ɛ d r ɐ
katei	k aː tʲ ɛ j
kates	k ɐ tʲ ɛ s
katė	k ɐ tʲ eː
katėms	k ɐ tʲ eː m s
katėse	k ɐ tʲ eː sʲ ɛ
keistas	kʲ ɛ j s t ɐ s
kelias	k æ lʲ ɐ s
keliaujanti	kʲ ɛ lʲ æ ʊ j ɛ nʲ tʲ ɪ
keliaujantieji	kʲ ɛ lʲ æ ʊ j ɛ nʲ tʲ j ɛ j ɪ
keliaujantiesiems	kʲ ɛ lʲ æ ʊ j ɛ nʲ tʲ j ɛ sʲ j ɛ m s
keliaujantys	kʲ ɛ lʲ æ ʊ j ɛ nʲ tʲ iː s
keliaujantį	kʲ ɛ lʲ æ ʊ j ɛ nʲ tʲ iː
keliaujančiam	kʲ ɛ lʲ æ ʊ j ɛ nʲ tʲ ʃʲ ɛ m
keliaujančio	kʲ ɛ lʲ æ ʊ j ɛ nʲ tʲ ʃʲ o
keliaujančiojo	kʲ ɛ lʲ æ ʊ j ɛ nʲ tʲ ʃʲ o j o
keliaujančiosios	kʲ ɛ lʲ æ ʊ j ɛ nʲ tʲ ʃʲ o sʲ o s
keliaujančiu	kʲ ɛ lʲ æ ʊ j ɛ nʲ tʲ ʃʲ ʊ
keliaujančius	kʲ ɛ lʲ æ ʊ j ɛ nʲ tʲ ʃʲ ʊ s
keliaujančią	kʲ ɛ lʲ æ ʊ j ɛ nʲ tʲ ʃʲ æː
keliaujančių	kʲ ɛ lʲ æ ʊ j ɛ nʲ tʲ ʃʲ uː
keliaujančiųjų	kʲ ɛ lʲ æ ʊ j ɛ nʲ tʲ ʃʲ uː j uː
keliauti	kʲ ɛ lʲ æ ʊ tʲ ɪ
kelio	k æ lʲ o
kepti	kʲ ɛ pʲ t̪ʲ ɪ
keturi	kʲ ɛ t̪ ʊ rʲ ɪ
kiaulė	kʲ ɛ ʊ̯ˑ lʲ eː
kiaunės	kʲ æ ʊ nʲ eː s
kieme	kʲ i ə mʲ ɛ
kietas	kʲ ɪ̂ ə t̪ ɐ s̪
kilmininkas	kʲ ɪ lʲ mʲ ɪ nʲ ɪ ŋ k ɐ s
kilmė	kʲ ɪ lʲ mʲ ěː
kilpa	kʲ ɪ l p ɐ
kinija	kʲ ɪ nʲ ɪ j ɛ
kiniška	kʲ ɪ nʲ ɪ ʃ k ɐ
kiniškai	kʲ ɪ nʲ ɪ ʃ k ɐ j
kiniškame	kʲ ɪ nʲ ɪ ʃ k ɐ mʲ ɛ
kiniškas	kʲ ɪ nʲ ɪ ʃ k ɐ s
kiniški	kʲ ɪ nʲ ɪ ʃʲ kʲ ɪ
kiniško	kʲ ɪ nʲ ɪ ʃ k o
kiniškoms	kʲ ɪ nʲ ɪ ʃ k o m s
kiniškuoju	kʲ ɪ nʲ ɪ ʃ k ʊ o j ʊ
kiniškų	kʲ ɪ nʲ ɪ ʃ k uː
klaidinga	k l ɐ j dʲ ɪ n ɡ ɐ
klaidingai	k l ɐ j dʲ ɪ n ɡ ɐ j
klaidingais	k l ɐ j dʲ ɪ n ɡ ɐ j s
klaidingesniaisiais	k l ɐ j dʲ ɪ nʲ ɡʲ ɛ sʲ nʲ ɛ j sʲ ɛ j s
klaidingesnio	k l ɐ j dʲ ɪ nʲ ɡʲ ɛ sʲ nʲ o
klaidingesnioji	k l ɐ j dʲ ɪ nʲ ɡʲ ɛ sʲ nʲ oː j ɪ
klaidingesnis	k l ɐ j dʲ ɪ nʲ ɡʲ ɛ sʲ nʲ ɪ s
klaidingesniu	k l ɐ j dʲ ɪ nʲ ɡʲ ɛ sʲ nʲ ʊ
klaidingesniuoju	k l ɐ j dʲ ɪ nʲ ɡʲ ɛ sʲ nʲ u ɔ j ʊ
klaidingesniąją	k l ɐ j dʲ ɪ nʲ ɡʲ ɛ sʲ nʲ æː j æː
klaidingesnėje	k l ɐ j dʲ ɪ nʲ ɡʲ ɛ sʲ nʲ eː j ɛ
klaidingesnės	k l ɐ j dʲ ɪ nʲ ɡʲ ɛ sʲ nʲ eː s
klaidingi	k l ɐ j dʲ ɪ nʲ ɡʲ ɪ
klaidingiausiais	k l ɐ j dʲ ɪ nʲ ɡʲ æː ʊ sʲ ɛ j s
klaidingiausios	k l ɐ j dʲ ɪ nʲ ɡʲ æː ʊ sʲ o s
klaidingiausiuosius	k l ɐ j dʲ ɪ nʲ ɡʲ æː ʊ sʲ ʊ o sʲ ʊ s
klaidingiausiąją	k l ɐ j dʲ ɪ nʲ ɡʲ æː ʊ sʲ æː j æː
klaidingo	k l ɐ j dʲ ɪ n ɡ o
klaidingoje	k l ɐ j dʲ ɪ n ɡ o j ɛ
klaidingomis	k l ɐ j dʲ ɪ n ɡ o mʲ ɪ s
klaidingos	k l ɐ j dʲ ɪ n ɡ o s
klaidingu	k l ɐ j dʲ ɪ n ɡ ʊ
klaidinguose	k l ɐ j dʲ ɪ n ɡ ʊ o sʲ ɛ
klaidingą	k l ɐ j dʲ ɪ n ɡ aː
klaidingų	k l ɐ j dʲ ɪ n ɡ uː
klasifikacija	k l ɐ sʲ ɪ fʲ ɪ k aː tʲ sʲ ɪ j ɐ
klausti	k l a ʊ s t ɪ
klausyti	k l ɐ u sʲ iː tʲ ɪ
klusnus	k ɫ ʊ s̪ n̪ ʊ s̪
knygas	kʲ nʲ iː ɡ ɐ s
knygoje	kʲ nʲ iː ɡ o j ɛ
knygomis	kʲ nʲ iː ɡ o mʲ ɪ s
knygoms	kʲ nʲ iː ɡ o m s
knygos	kʲ nʲ iː ɡ o s
knygose	kʲ nʲ iː ɡ o sʲ ɛ
knygą	kʲ nʲ iː ɡ a
knygų	kʲ nʲ iː ɡ uː
kodėl	k o dʲ eː l
koks	k o k s
kompiuteri	k o mʲ pʲ ʊ tʲ ɛ rʲ ɪ
kompiuteriai	k o mʲ pʲ ʊ tʲ ɛ rʲ ɛ j
kompiuteriais	k o mʲ pʲ ʊ tʲ ɛ rʲ ɛ j s
kompiuteriams	k o mʲ pʲ ʊ tʲ ɛ rʲ ɛ m s
kompiuterio	k o mʲ pʲ ʊ tʲ ɛ rʲ o
kompiuteris	k o mʲ pʲ ʊ tʲ ɛ rʲ ɪ s
kompiuteriui	k o mʲ pʲ ʊ tʲ ɛ rʲ ʊ ɪ
kompiuteryje	k o mʲ pʲ ʊ tʲ ɛ rʲ iː j ɛ
kompiuterį	k o mʲ pʲ ʊ tʲ ɛ rʲ iː
kopėčios	k ôː pʲ eː t͡ʃʲ oː s̪
koralas	k ɔ ɾ aː l ɐ s
korėjietiška	k o rʲ eː j ɛː tʲ ɪ ʃ k ɐ
korėjietiškame	k o rʲ eː j ɛː tʲ ɪ ʃ k ɐ mʲ ɛ
korėjietiškos	k o rʲ eː j ɛː tʲ ɪ ʃ k o s
korėjietiškosioms	k o rʲ eː j ɛː tʲ ɪ ʃ k o sʲ o m s
korėjietiškus	k o rʲ eː j ɛː tʲ ɪ ʃ k ʊ s
korėjietišką	k o rʲ eː j ɛː tʲ ɪ ʃ k aː
korėjietiškąja	k o rʲ eː j ɛː tʲ ɪ ʃ k aː j ɛ
korėjietiškų	k o rʲ eː j ɛː tʲ ɪ ʃ k uː
košė	k oː ʃʲ eː
kraujas	k r ɒ͜úˑ j æ s
kriaušė	kʲ rʲ æː u̯ ʃʲ eː
krikščionybė	kʲ ɾʲ ɪ kʲ ʃʲ t ʃ ɪ o nʲ iː bʲ eː
kroatija	k r o aː tʲ ɪ j ɛ
kroatiškasis	k r o aː tʲ ɪ ʃ k ɐ sʲ ɪ s
kroatiškose	k r o aː tʲ ɪ ʃ k o sʲ ɛ
kroatišku	k r o aː tʲ ɪ ʃ k ʊ
kroatiškuosius	k r o aː tʲ ɪ ʃ k ʊ o sʲ ʊ s
kroatiškųjų	k r o aː tʲ ɪ ʃ k uː j uː
krėslas	kʲ rʲ êː s̪ l ɐ s̪
krūmas	k r ûː m ɐ s̪
krūtine	k ɾ uː tʲ ɪ nʲ ɛ
krūtinei	k ɾ uː tʲ ɪ nʲ ɛ j
krūtines	k ɾ uː tʲ ɪ nʲ ɛ s
krūtinė	k ɾ uː tʲ ɪ nʲ eː
krūtinėje	k ɾ uː tʲ ɪ nʲ eː j ɛ
krūtinės	k ɾ uː tʲ ɪ nʲ eː s
krūtinėse	k ɾ uː tʲ ɪ nʲ eː sʲ ɛ
krūtinę	k ɾ uː tʲ ɪ nʲ æː
kukurūzas	k u k u r ǔː z̪ ɐ s̪
kultūra	k ʊ l t u r ɐ
kur	k ʊ r
kurti	k ʊ rʲ tʲ ɪ
kvietys	kʲ vʲ ɪ ə t̪ʲ iː s̪
ką	k a
kūnai	k uː n ɐ j
kūnais	k uː n ɐ j s
kūnams	k uː n ɐ m s
kūnas	k uː n ɐ s
kūne	k uː nʲ ɛ
kūno	k uː n o
kūnui	k uː n ʊ ɪ
kūnuose	k uː n ʊ o sʲ ɛ
kūną	k uː n a
kūnų	k uː n u
labai	l ɐ b ɐ j
laisvė	l aː j sʲ ʋʲ eː
laiškas	l a j ʃ k ɐ s
laižyti	l ɐ j ʒʲ iː tʲ ɪ
lapes	l ɐ pʲ ɛ s
lapių	l aː pʲ uː
lapėje	l aː pʲ eː j ɛ
lapės	l aː pʲ eː s
lapę	l aː pʲ æː
latakas	l ɐ t aː k ɐ s
latvija	l aː tʲ ʋʲ ɪ j ɛ
latviškai	l aː tʲ ʋʲ ɪ ʃ k ɐ j
latviškas	l aː tʲ ʋʲ ɪ ʃ k ɐ s
latviški	l aː tʲ ʋʲ ɪ ʃʲ kʲ ɪ
latviško	l aː tʲ ʋʲ ɪ ʃ k o
latviškos	l aː tʲ ʋʲ ɪ ʃ k o s
latviškosioms	l aː tʲ ʋʲ ɪ ʃ k o sʲ o m s
latvišku	l aː tʲ ʋʲ ɪ ʃ k ʊ
latviškuose	l aː tʲ ʋʲ ɪ ʃ k ʊ o sʲ ɛ
latvė	l aː tʲ ʋʲ eː
laukimas	l ɐ ʊ kʲ ɪ m ɐ s
laukti	l a ʊ kʲ tʲ ɪ
lavonas	l ɐ ʋ oː n ɐ s
lavono	l ɐ ʋ oː n o
lavonu	l ɐ ʋ oː n ʊ
lavonus	l ɐ ʋ oː n ʊ s
lavoną	l ɐ ʋ oː n aː
lavonų	l ɐ ʋ oː n uː
lazdas	l ɐ z d ɐ s
lazdomis	l ɐ z d o mʲ ɪ s
lazdų	l ɐ z d uː
lelija	lʲ ɛ lʲ ɪ j ɐ
lenkija	l æː nʲ kʲ ɪ j ɛ
lenkiška	lʲ æː nʲ kʲ ɪ ʃ k ɐ
lenkiškai	lʲ æː nʲ kʲ ɪ ʃ k ɐ j
lenkiškame	lʲ æː nʲ kʲ ɪ ʃ k ɐ mʲ ɛ
lenkiškas	lʲ æː nʲ kʲ ɪ ʃ k ɐ s
lenkiški	lʲ æː nʲ kʲ ɪ ʃʲ kʲ ɪ
lenkiškiems	lʲ æː nʲ kʲ ɪ ʃʲ kʲ j ɛ m s
lenkiško	lʲ æː nʲ kʲ ɪ ʃ k o
lenkiškoje	lʲ æː nʲ kʲ ɪ ʃ k o j ɛ
lenkiškoji	lʲ æː nʲ kʲ ɪ ʃ k o j ɪ
lenkiškomis	lʲ æː nʲ kʲ ɪ ʃ k o mʲ ɪ s
lenkiškos	lʲ æː nʲ kʲ ɪ ʃ k o s
lenkiškose	lʲ æː nʲ kʲ ɪ ʃ k o sʲ ɛ
lenkišku	lʲ æː nʲ kʲ ɪ ʃ k ʊ
lenkiškuoju	lʲ æː nʲ kʲ ɪ ʃ k ʊ o j ʊ
lenkiškuose	lʲ æː nʲ kʲ ɪ ʃ k ʊ o sʲ ɛ
lenkiškuosius	lʲ æː nʲ kʲ ɪ ʃ k ʊ o sʲ ʊ s
lenkiškus	lʲ æː nʲ kʲ ɪ ʃ k ʊ s
lenkišką	lʲ æː nʲ kʲ ɪ ʃ k aː
lenkiškąjį	lʲ æː nʲ kʲ ɪ ʃ k aː j iː
lenkiškų	lʲ æː nʲ kʲ ɪ ʃ k uː
lentelė	lʲ ɛ nʲ tʲ æː lʲ eː
liepsna	l j ɛ p s n ɐ
lietuviškai	lʲ ɛ t ʊ ʋʲ ɪ ʃ k ɐ j
lietuviškais	lʲ j ɛ t ʊ ʋʲ ɪ ʃ k ɐ j s
lietuviškajam	lʲ j ɛ t ʊ ʋʲ ɪ ʃ k ɐ j ɛ m
lietuviškajame	lʲ j ɛ t ʊ ʋʲ ɪ ʃ k ɐ j ɛ mʲ ɛ
lietuviškas	lʲ j ɛ t ʊ ʋʲ ɪ ʃ k ɐ s
lietuviškasis	lʲ j ɛ t ʊ ʋʲ ɪ ʃ k ɐ sʲ ɪ s
lietuviški	lʲ j ɛ t ʊ ʋʲ ɪ ʃʲ kʲ ɪ
lietuviškieji	lʲ j ɛ t ʊ ʋʲ ɪ ʃʲ kʲ j ɛ j ɪ
lietuviškiems	lʲ j ɛ t ʊ ʋʲ ɪ ʃʲ kʲ j ɛ m s
lietuviško	lʲ j ɛ t ʊ ʋʲ ɪ ʃ k o
lietuviškoje	lʲ j ɛ t ʊ ʋʲ ɪ ʃ k o j ɛ
lietuviškoji	lʲ j ɛ t ʊ ʋʲ ɪ ʃ k o j ɪ
lietuviškomis	lʲ j ɛ t ʊ ʋʲ ɪ ʃ k o mʲ ɪ s
lietuviškoms	lʲ j ɛ t ʊ ʋʲ ɪ ʃ k o m s
lietuviškos	lʲ j ɛ t ʊ ʋʲ ɪ ʃ k o s
lietuviškose	lʲ j ɛ t ʊ ʋʲ ɪ ʃ k o sʲ ɛ
lietuviškosios	lʲ j ɛ t ʊ ʋʲ ɪ ʃ k o sʲ o s
lietuviškuoju	lʲ j ɛ t ʊ ʋʲ ɪ ʃ k ʊ o j ʊ
lietuviškuose	lʲ j ɛ t ʊ ʋʲ ɪ ʃ k ʊ o sʲ ɛ
lietuviškus	lʲ j ɛ t ʊ ʋʲ ɪ ʃ k ʊ s
lietuvišką	lʲ j ɛ t ʊ ʋʲ ɪ ʃ k aː
lietuviškąja	lʲ j ɛ t ʊ ʋʲ ɪ ʃ k aː j ɛ
lietuviškąją	lʲ j ɛ t ʊ ʋʲ ɪ ʃ k aː j æː
lietuviškąsias	lʲ j ɛ t ʊ ʋʲ ɪ ʃ k aː sʲ ɛ s
lietuviškųjų	lʲ j ɛ t ʊ ʋʲ ɪ ʃ k uː j uː
lietuvių	lʲ j ɛ t ʊ ʋʲ uː
lietuvė	lʲ j ɛ t ʊ ʋʲ eː
lietų	l j ɛ t u
lijo	lʲ ɪ j o
linas	lʲ ɪ n̪ ɐ s̪
link	l i ŋ k
lis	lʲ ɪ s̪
lizdas	lʲ ɪ z̪ d̪ ɐ s̪
liūte	lʲ uː tʲ ɛ
liūtukams	lʲ uː t ʊ k ɐ m s
liūtė	lʲ uː tʲ eː
liūčių	lʲ uː tʲ ʃʲ uː
lobis	ɫ ǒː bʲ ɪ s̪
lokys	l o kʲ iː s
lotosai	l o t o s ɐ j
lotosas	l o t o s ɐ s
lotoso	l o t o s o
lotosus	l o t o s ʊ s
lubos	ɫ ʊ b oː s̪
luomas	ɫ û ə m ɐ s̪
lyja	lʲ iː j ɐ
makštis	m ɐ kʲ ʃʲ tʲ ɪ s
mala	m ä̌ː l ɐ
malda	m ɐ l d ɐ
maloni	m ɐ l ɔ n ɪ
malonus	m ɐ l ɔ n ʊ s
maltietiška	m ɐ lʲ tʲ j ɛ tʲ ɪ ʃ k ɐ
maltietiškieji	m ɐ lʲ tʲ j ɛ tʲ ɪ ʃʲ kʲ j ɛ j ɪ
maltietiškuoju	m ɐ lʲ tʲ j ɛ tʲ ɪ ʃ k ʊ o j ʊ
malūnas	m ɐ ɫ ǔː n̪ ɐ s̪
man	m a n
maniau	m ɐ nʲ ɛ ʊ̯ˑ
manimi	m ɐ n ɪ mʲ ɪ
manęs	m ɐ nʲ æː s
marihuana	m ɐ rʲ ɪ ɣ ʊ ɐ n ɐ
marios	m ä̌ː rʲ oː s̪
marmuras	m aː ɾ m ʊ ɾ ɐ s
matanti	m aː t ɐ nʲ tʲ ɪ
matantiems	m aː t ɐ nʲ tʲ j ɛ m s
matantis	m aː t ɐ nʲ tʲ ɪ s
matantysis	m aː t ɐ nʲ tʲ iː sʲ ɪ s
matantįjį	m aː t ɐ nʲ tʲ iː j iː
matančia	m aː t ɐ nʲ tʲ ʃʲ ɛ
matančiais	m aː t ɐ nʲ tʲ ʃʲ ɛ j s
matančiam	m aː t ɐ nʲ tʲ ʃʲ ɛ m
matančio	m aː t ɐ nʲ tʲ ʃʲ o
matančiomis	m aː t ɐ nʲ tʲ ʃʲ o mʲ ɪ s
matančiosiomis	m aː t ɐ nʲ tʲ ʃʲ o sʲ o mʲ ɪ s
mato	m aː t ɔ
matyti	m ɐ tʲ îː tʲ ɪ
matė	m aː t e
matėme	m aː t e mʲ ɛ
matėte	m aː t e tʲ ɛ
mažai	m aː ʒ ɐ j
mažais	m ɐ ʒ ɐ j s
mažajai	m aː ʒ ɐ j ɛ j
mažajam	m ɐ ʒ aː j ɛ m
mažam	m ɐ ʒ aː m
mažame	m ɐ ʒ ɐ mʲ ɛ
mažas	m aː ʒ ɐ s
mažasis	m ɐ ʒ ɐ sʲ ɪ s
maždaug	m ɐ ʒ d ɐ u ɡ
mažesne	m ɐ ʒʲ ɛ sʲ nʲ ɛ
mažesnei	m ɐ ʒʲ ɛ sʲ nʲ ɛ j
mažesnes	m ɐ ʒʲ ɛ sʲ nʲ ɛ s
mažesni	m ɐ ʒʲ ɛ sʲ nʲ ɪ
mažesniais	m ɐ ʒʲ ɛ sʲ nʲ ɛ j s
mažesniaisiais	m ɐ ʒʲ ɛ sʲ nʲ ɛ j sʲ ɛ j s
mažesniam	m ɐ ʒʲ ɛ sʲ nʲ æː m
mažesniame	m ɐ ʒʲ ɛ sʲ nʲ ɛ mʲ ɛ
mažesnieji	m ɐ ʒʲ ɛ sʲ nʲ j ɛ j ɪ
mažesniems	m ɐ ʒʲ ɛ sʲ nʲ j ɛ m s
mažesniesiems	m ɐ ʒʲ ɛ sʲ nʲ j ɛ sʲ j e m s
mažesnio	m ɐ ʒʲ ɛ sʲ nʲ o
mažesnioji	m ɐ ʒʲ ɛ sʲ nʲ oː j ɪ
mažesniojo	m ɐ ʒʲ ɛ sʲ nʲ o j o
mažesnis	m ɐ ʒʲ ɛ sʲ nʲ ɪ s
mažesniu	m ɐ ʒʲ ɛ sʲ nʲ ʊ
mažesniuoju	m ɐ ʒʲ ɛ sʲ nʲ u ɔ j ʊ
mažesniuose	m ɐ ʒʲ ɛ sʲ nʲ ʊ o sʲ ɛ
mažesnius	m ɐ ʒʲ ɛ sʲ nʲ ʊ s
mažesniąją	m ɐ ʒʲ ɛ sʲ nʲ æː j æː
mažesnių	m ɐ ʒʲ ɛ sʲ nʲ uː
mažesniųjų	m ɐ ʒʲ ɛ sʲ nʲ uː j uː
mažesnė	m ɐ ʒʲ ɛ sʲ nʲ eː
mažesnėje	m ɐ ʒʲ ɛ sʲ nʲ eː j ɛ
mažesnėmis	m ɐ ʒʲ ɛ sʲ nʲ eː mʲ ɪ s
mažesnėms	m ɐ ʒʲ ɛ sʲ nʲ eː m s
mažesnės	m ɐ ʒʲ ɛ sʲ nʲ eː s
mažesnėse	m ɐ ʒʲ ɛ sʲ nʲ eː sʲ ɛ
mažesnę	m ɐ ʒʲ ɛ sʲ nʲ æː
mažesnį	m ɐ ʒʲ ɛ sʲ nʲ iː
maži	m ɐ ʒʲ ɪ
mažiausi	m ɐ ʒʲ æː ʊ sʲ ɪ
mažiausia	m ɐ ʒʲ æː ʊ sʲ ɛ
mažiausiai	m ɐ ʒʲ æː ʊ sʲ ɛ j
mažiausiais	m ɐ ʒʲ æː ʊ sʲ ɛ j s
mažiausiajam	m ɐ ʒʲ æː ʊ sʲ ɛ j ɛ m
mažiausiam	m ɐ ʒʲ æː ʊ sʲ ɛ m
mažiausias	m ɐ ʒʲ æː ʊ sʲ ɛ s
mažiausiasis	m ɐ ʒʲ æː ʊ sʲ ɛ sʲ ɪ s
mažiausieji	m ɐ ʒʲ æː ʊ sʲ j ɛ j ɪ
mažiausiems	m ɐ ʒʲ æː ʊ sʲ j ɛ m s
mažiausiesiems	m ɐ ʒʲ æː ʊ sʲ j ɛ sʲ j ɛ m s
mažiausio	m ɐ ʒʲ æː ʊ sʲ o
mažiausioje	m ɐ ʒʲ æː ʊ sʲ o j ɛ
mažiausioji	m ɐ ʒʲ æː ʊ sʲ o j ɪ
mažiausiomis	m ɐ ʒʲ æː ʊ sʲ o mʲ ɪ s
mažiausioms	m ɐ ʒʲ æː ʊ sʲ o m s
mažiausios	m ɐ ʒʲ æː ʊ sʲ o s
mažiausiu	m ɐ ʒʲ æː ʊ sʲ ʊ
mažiausius	m ɐ ʒʲ æː ʊ sʲ ʊ s
mažiausią	m ɐ ʒʲ æː ʊ sʲ æː
mažiausių	m ɐ ʒʲ æː ʊ sʲ uː
mažiems	m ɐ ʒʲ j ɛ m s
mažiesiems	m ɐ ʒʲ j ɛ sʲ j e m s
mažo	m aː ʒ o
mažoje	m ɐ ʒ o j ɛ
mažoji	m ɐ ʒ oː j ɪ
mažojo	m aː ʒ o j o
mažomis	m ɐ ʒ o mʲ ɪ s
mažoms	m ɐ ʒ oː m s
mažose	m ɐ ʒ o sʲ ɛ
mažosioms	m ɐ ʒ oː sʲ o m s
mažosiose	m ɐ ʒ oː sʲ o sʲ ɛ
mažu	m ɐ ʒ ʊ
mažuoju	m ɐ ʒ u ɔ j ʊ
mažuose	m ɐ ʒ ʊ o sʲ ɛ
mažuosiuose	m ɐ ʒ ʊ oː sʲ ʊ o sʲ ɛ
mažus	m ɐ ʒ ʊ s
mažą	m aː ʒ aː
mažąja	m ɐ ʒ aː j ɛ
mažąją	m aː ʒ aː j æː
mažąjį	m aː ʒ aː j iː
mažąsias	m ɐ ʒ aː sʲ ɛ s
mažų	m ɐ ʒ uː
mažųjų	m ɐ ʒ uː j uː
medus	mʲ ɛ d ʊ s
medvarlių	mʲ æː d ʋ ɐ ɾʲ lʲ uː
medvarlės	mʲ æː d ʋ ɐ ɾʲ lʲ eː s
medyje	m æː d iː j ɛ
medį	m æː d iː
medūza	mʲ ɛ d uː z ɐ
medžiai	mʲ æː dʲ ʒʲ ɛ j
medžiais	m æː d ʒ ɛ j s
medžiams	m æː d ʒ ɛ m s
medžio	m æː d ʒ o
medžiojančiame	mʲ ɛ dʲ ʒʲ oː j ɛ nʲ tʲ ʃʲ ɛ mʲ ɛ
medžiojančiomis	mʲ ɛ dʲ ʒʲ oː j ɛ nʲ tʲ ʃʲ o mʲ ɪ s
medžiojančiosiomis	mʲ ɛ dʲ ʒʲ oː j ɛ nʲ tʲ ʃʲ o sʲ o mʲ ɪ s
medžiojančius	mʲ ɛ dʲ ʒʲ oː j ɛ nʲ tʲ ʃʲ ʊ s
medžiojančių	mʲ ɛ dʲ ʒʲ oː j ɛ nʲ tʲ ʃʲ uː
medžioti	mʲ ɛ dʲ ʒʲ o tʲ ɪ
medžiu	m ɛ d ʒ ʊ
medžiuose	m æː d ʒ ʊ ɔ s ɛ
medžius	m ɛ d ʒ ʊ s
medžių	m æː d ʒ uː
meile	mʲ æː j lʲ ɛ
meilei	mʲ æː j lʲ ɛ j
meilių	mʲ æː j lʲ uː
meilėje	mʲ æː j lʲ eː j ɛ
meilės	mʲ æː j lʲ eː s
meilę	mʲ æː j lʲ æː
mena	mʲ æ̌ː n̪ ɐ
meni	mʲ ɛ nʲ ɪ
meniška	mʲ æː nʲ ɪ ʃ k ɐ
meniškai	mʲ æː nʲ ɪ ʃ k ɐ j
meniškais	mʲ æː nʲ ɪ ʃ k ɐ j s
meniškaisiais	mʲ æː nʲ ɪ ʃ k ɐ j sʲ ɛ j s
meniškas	mʲ æː nʲ ɪ ʃ k ɐ s
meniškesne	mʲ ɛ nʲ ɪ ʃʲ kʲ ɛ sʲ nʲ ɛ
meniškesniems	mʲ ɛ nʲ ɪ ʃʲ kʲ ɛ sʲ nʲ j ɛ m s
meniškesnis	mʲ ɛ nʲ ɪ ʃʲ kʲ ɛ sʲ nʲ ɪ s
meniškesnėmis	mʲ ɛ nʲ ɪ ʃʲ kʲ ɛ sʲ nʲ eː mʲ ɪ s
meniškesnėms	mʲ ɛ nʲ ɪ ʃʲ kʲ ɛ sʲ nʲ eː m s
meniški	mʲ æː nʲ ɪ ʃʲ kʲ ɪ
meniškiausia	mʲ ɛ nʲ ɪ ʃʲ kʲ æː ʊ sʲ ɛ
meniškiausiojo	mʲ ɛ nʲ ɪ ʃʲ kʲ æː ʊ sʲ o j o
meniškiausiosioms	mʲ ɛ nʲ ɪ ʃʲ kʲ æː ʊ sʲ o sʲ o m s
meniškiausiuosiuose	mʲ ɛ nʲ ɪ ʃʲ kʲ æː ʊ sʲ ʊ o sʲ ʊ o sʲ ɛ
meniškiausiąsias	mʲ ɛ nʲ ɪ ʃʲ kʲ æː ʊ sʲ æː sʲ ɛ s
meniškiausių	mʲ ɛ nʲ ɪ ʃʲ kʲ æː ʊ sʲ uː
meniško	mʲ æː nʲ ɪ ʃ k o
meniškoje	mʲ æː nʲ ɪ ʃ k o j ɛ
meniškos	mʲ æː nʲ ɪ ʃ k o s
meniškosiomis	mʲ æː nʲ ɪ ʃ k o sʲ o mʲ ɪ s
meniškosios	mʲ æː nʲ ɪ ʃ k o sʲ o s
menišku	mʲ æː nʲ ɪ ʃ k ʊ
meniškus	mʲ æː nʲ ɪ ʃ k ʊ s
menišką	mʲ æː nʲ ɪ ʃ k aː
meniškąja	mʲ æː nʲ ɪ ʃ k aː j ɛ
meniškų	mʲ æː nʲ ɪ ʃ k uː
menu	mʲ ɛ n̪ ʊ
mesti	mʲ ɛ sʲ tʲ ɪ
meta	mʲ æː t̪ ɐ
miegas	mʲ j æ ɡ ɐ s
minti	mʲ ɪ nʲ tʲ ɪ
mirti	mʲ ɪ rʲ tʲ ɪ
mokyklai	m o kʲ iː k l ɐ j
mokyklas	m o kʲ iː k l ɐ s
mokyklines	m o kʲ iː kʲ lʲ ɪ nʲ ɛ s
mokykliniai	m o kʲ iː kʲ lʲ ɪ nʲ ɛ j
mokykliniais	m o kʲ iː kʲ lʲ ɪ nʲ ɛ j s
mokykliniam	m o kʲ iː kʲ lʲ ɪ nʲ ɛ m
mokykliniame	m o kʲ iː kʲ lʲ ɪ nʲ ɛ mʲ ɛ
mokykliniams	m o kʲ iː kʲ lʲ ɪ nʲ ɛ m s
mokyklinio	m o kʲ iː kʲ lʲ ɪ nʲ o
mokyklinis	m o kʲ iː kʲ lʲ ɪ nʲ ɪ s
mokykliniu	m o kʲ iː kʲ lʲ ɪ nʲ ʊ
mokyklinius	m o kʲ iː kʲ lʲ ɪ nʲ ʊ s
mokyklinių	m o kʲ iː kʲ lʲ ɪ nʲ uː
mokyklinė	m o kʲ iː kʲ lʲ ɪ nʲ eː
mokyklinėmis	m o kʲ iː kʲ lʲ ɪ nʲ eː mʲ ɪ s
mokyklinėms	m o kʲ iː kʲ lʲ ɪ nʲ eː m s
mokyklinės	m o kʲ iː kʲ lʲ ɪ nʲ eː s
mokyklinėse	m o kʲ iː kʲ lʲ ɪ nʲ eː sʲ ɛ
mokyklinę	m o kʲ iː kʲ lʲ ɪ nʲ æː
mokyklinį	m o kʲ iː kʲ lʲ ɪ nʲ iː
mokykloje	m o kʲ iː k l o j ɛ
mokyklomis	m o kʲ iː k l o mʲ ɪ s
mokyklose	m o kʲ iː k l o sʲ ɛ
mokyklų	m o kʲ iː k l uː
mokyti	m ôː kʲ iː t̪ʲ ɪ
moteris	m oː tʲ ɛ rʲ ɪ s
moteriška	m oː tʲ ɛ ɾʲ ɪ ʃ k ɐ
moteriškai	m oː tʲ ɛ ɾʲ ɪ ʃ k ɐ j
moteriškais	m oː tʲ ɛ ɾʲ ɪ ʃ k ɐ j s
moteriškam	m oː tʲ ɛ ɾʲ ɪ ʃ k ɐ m
moteriškame	m oː tʲ ɛ ɾʲ ɪ ʃ k ɐ mʲ ɛ
moteriškas	m oː tʲ ɛ ɾʲ ɪ ʃ k ɐ s
moteriškasis	m oː tʲ ɛ ɾʲ ɪ ʃ k ɐ sʲ ɪ s
moteriškesniame	m o tʲ ɛ ɾʲ ɪ ʃʲ kʲ ɛ sʲ nʲ ɛ mʲ ɛ
moteriškesnioji	m o tʲ ɛ ɾʲ ɪ ʃʲ kʲ ɛ sʲ nʲ oː j ɪ
moteriškesniuoju	m o tʲ ɛ ɾʲ ɪ ʃʲ kʲ ɛ sʲ nʲ u ɔ j ʊ
moteriškesnė	m o tʲ ɛ ɾʲ ɪ ʃʲ kʲ ɛ sʲ nʲ eː
moteriškesnį	m o tʲ ɛ ɾʲ ɪ ʃʲ kʲ ɛ sʲ nʲ iː
moteriški	m oː tʲ ɛ ɾʲ ɪ ʃʲ kʲ ɪ
moteriškiausi	m o tʲ ɛ ɾʲ ɪ ʃ kʲ æː ʊ sʲ ɪ
moteriškiausiajam	m o tʲ ɛ ɾʲ ɪ ʃʲ kʲ æː ʊ sʲ ɛ j ɛ m
moteriškiausias	m o tʲ ɛ ɾʲ ɪ ʃ kʲ æː ʊ sʲ ɛ s
moteriškiausio	m o tʲ ɛ ɾʲ ɪ ʃ kʲ æː ʊ sʲ o
moteriškiausioms	m o tʲ ɛ ɾʲ ɪ ʃ kʲ æː ʊ sʲ o m s
moteriškiausiuosiuose	m o tʲ ɛ ɾʲ ɪ ʃʲ kʲ æː ʊ sʲ ʊ o sʲ ʊ o sʲ ɛ
moteriškiausiuosius	m o tʲ ɛ ɾʲ ɪ ʃʲ kʲ æː ʊ sʲ ʊ o sʲ ʊ s
moteriškieji	m oː tʲ ɛ ɾʲ ɪ ʃʲ kʲ j ɛ j ɪ
moteriškiems	m oː tʲ ɛ ɾʲ ɪ ʃʲ kʲ ɛ m s
moteriškiesiems	m oː tʲ ɛ ɾʲ ɪ ʃʲ kʲ j ɛ sʲ j e m s
moteriško	m oː tʲ ɛ ɾʲ ɪ ʃ k o
moteriškoji	m oː tʲ ɛ ɾʲ ɪ ʃ k o j ɪ
moteriškomis	m oː tʲ ɛ ɾʲ ɪ ʃ k o mʲ ɪ s
moteriškoms	m oː tʲ ɛ ɾʲ ɪ ʃ k o m s
moteriškos	m oː tʲ ɛ ɾʲ ɪ ʃ k o s
moteriškosioms	m oː tʲ ɛ ɾʲ ɪ ʃ k o sʲ o m s
moteriškosios	m oː tʲ ɛ ɾʲ ɪ ʃ k o sʲ o s
moteriškosiose	m oː tʲ ɛ ɾʲ ɪ ʃ k o sʲ o sʲ ɛ
moterišku	m oː tʲ ɛ ɾʲ ɪ ʃ k ʊ
moteriškumas	m o t ɛ ɾ ɪ ʃ k ʊ m ɐ s
moteriškuose	m oː tʲ ɛ ɾʲ ɪ ʃ k ʊ o sʲ ɛ
moteriškus	m oː tʲ ɛ ɾʲ ɪ ʃ k ʊ s
moterišką	m oː tʲ ɛ ɾʲ ɪ ʃ k aː
moteriškąja	m oː tʲ ɛ ɾʲ ɪ ʃ k aː j ɛ
moteriškąją	m oː tʲ ɛ ɾʲ ɪ ʃ k aː j æː
moteriškąjį	m oː tʲ ɛ ɾʲ ɪ ʃ k aː j iː
moteriškų	m oː tʲ ɛ ɾʲ ɪ ʃ k uː
moteriškųjų	m oː tʲ ɛ ɾʲ ɪ ʃ k uː j uː
moterį	m oː tʲ ɛ rʲ i
muitas	m ʊ ɪ̯ˑ t̪ ɐ s̪
mumyse	m ʊ m i s ɛ
mus	m ʊ s
muzika	m ʊ zʲ ɪ k ɐ
muša	m ʊ ʃ ɐ
mylinti	mʲ iː lʲ ɪ nʲ tʲ ɪ
mylintiems	mʲ iː lʲ ɪ nʲ tʲ j ɛ m s
mylintis	mʲ iː lʲ ɪ nʲ tʲ ɪ s
mylintys	mʲ iː lʲ ɪ nʲ tʲ iː s
mylintį	mʲ iː lʲ ɪ nʲ tʲ iː
mylinčiai	mʲ iː lʲ ɪ nʲ tʲ ʃʲ ɛ j
mylinčiais	mʲ iː lʲ ɪ nʲ tʲ ʃʲ ɛ j s
mylinčiam	mʲ iː lʲ ɪ nʲ tʲ ʃʲ ɛ m
mylinčias	mʲ iː lʲ ɪ nʲ tʲ ʃʲ ɛ s
mylinčio	mʲ iː lʲ ɪ nʲ tʲ ʃʲ o
mylinčiojo	mʲ iː lʲ ɪ nʲ tʲ ʃʲ o j o
mylinčiomis	mʲ iː lʲ ɪ nʲ tʲ ʃʲ o mʲ ɪ s
mylinčios	mʲ iː lʲ ɪ nʲ tʲ ʃʲ o s
mylinčiuose	mʲ iː lʲ ɪ nʲ tʲ ʃʲ ʊ o sʲ ɛ
mylinčiuosius	mʲ iː lʲ ɪ nʲ tʲ ʃʲ ʊ o sʲ ʊ s
mylinčius	mʲ iː lʲ ɪ nʲ tʲ ʃʲ ʊ s
mylinčių	mʲ iː lʲ ɪ nʲ tʲ ʃʲ uː
mylėdama	mʲ iː lʲ eː d ɐ m ɐ
mylėdami	mʲ iː lʲ eː d ɐ mʲ ɪ
mylėdavusia	mʲ iː lʲ eː d ɐ ʋ ʊ sʲ ɛ
mylėdavusiąsias	mʲ iː lʲ eː d ɐ ʋ ʊ sʲ æː sʲ ɛ s
mylėdavusysis	mʲ iː lʲ eː d ɐ ʋ ʊ sʲ iː sʲ ɪ s
mylėjusi	mʲ iː lʲ eː j ʊ sʲ ɪ
mylėjusiems	mʲ iː lʲ eː j ʊ sʲ j ɛ m s
mylėję	mʲ iː lʲ eː j æː
mylėsianti	mʲ iː lʲ eː sʲ ɛ nʲ tʲ ɪ
mylėsiančia	mʲ iː lʲ eː sʲ ɛ nʲ tʲ ʃʲ ɛ
mylėsiančias	mʲ iː lʲ eː sʲ ɛ nʲ tʲ ʃʲ ɛ s
mylėsiančios	mʲ iː lʲ eː sʲ ɛ nʲ tʲ ʃʲ o s
mylėsiančiąja	mʲ iː lʲ eː sʲ ɛ nʲ tʲ ʃʲ æː j ɛ
myžti	mʲ iː ʒʲ tʲ ɪ
mėnuo	mʲ êː n̪ u ə
mįslinga	mʲ iː sʲ lʲ ɪ n ɡ ɐ
mįslingai	mʲ iː sʲ lʲ ɪ n ɡ ɐ j
mįslingas	mʲ iː sʲ lʲ ɪ n ɡ ɐ s
mįslingesnis	mʲ iː sʲ lʲ ɪ nʲ ɡʲ ɛ sʲ nʲ ɪ s
mįslingesniuosius	mʲ iː sʲ lʲ ɪ nʲ ɡʲ ɛ sʲ nʲ u ɔ sʲ ʊ s
mįslingesnysis	mʲ iː sʲ lʲ ɪ nʲ ɡʲ ɛ sʲ nʲ iː sʲ ɪ s
mįslingi	mʲ iː sʲ lʲ ɪ nʲ ɡʲ ɪ
mįslingiausiais	mʲ iː sʲ lʲ ɪ nʲ ɡʲ æː ʊ sʲ ɛ j s
mįslingiausiąsias	mʲ iː sʲ lʲ ɪ nʲ ɡʲ æː ʊ sʲ æː sʲ ɛ s
mįslingiausių	mʲ iː sʲ lʲ ɪ nʲ ɡʲ æː ʊ sʲ uː
mįslingojo	mʲ iː sʲ lʲ ɪ n ɡ o j o
mįslingos	mʲ iː sʲ lʲ ɪ n ɡ o s
mįslingose	mʲ iː sʲ lʲ ɪ n ɡ o sʲ ɛ
mįslingus	mʲ iː sʲ lʲ ɪ n ɡ ʊ s
mįslingą	mʲ iː sʲ lʲ ɪ n ɡ aː
mįslingų	mʲ iː sʲ lʲ ɪ n ɡ uː
mįslė	mʲ iː sʲ lʲ eː
mūsų	m uː s uː
naktis	n ɐ k t ɪ s
naktys	n aː k t i s
narkotikai	n ɐ ɾ k o tʲ ɪ k ɐ j
narkotikais	n ɐ ɾ k o tʲ ɪ k ɐ j s
narkotikams	n ɐ ɾ k o tʲ ɪ k ɐ m s
narkotiko	n ɐ ɾ k o tʲ ɪ k o
narkotiku	n ɐ ɾ k o tʲ ɪ k ʊ
narkotikuose	n ɐ ɾ k o tʲ ɪ k ʊ o sʲ ɛ
narkotikus	n ɐ ɾ k o tʲ ɪ k ʊ s
narkotikų	n ɐ ɾ k o tʲ ɪ k uː
naudininkas	n ɐ ʊ dʲ ɪ nʲ ɪ ŋ k ɐ s
naudotoja	n ɐ ʊ d oː t o j ɛ
naudotojai	n ɐ ʊ d oː t o j ɛ j
naudotojais	n ɐ ʊ d oː t o j ɛ j s
naudotojams	n ɐ ʊ d oː t o j ɛ m s
naudotojas	n ɐ ʊ d oː t o j ɛ s
naudotojo	n ɐ ʊ d oː t o j o
naudotojomis	n ɐ ʊ d oː t o j o mʲ ɪ s
naudotojos	n ɐ ʊ d oː t o j o s
naudotoju	n ɐ ʊ d oː t o j ʊ
naudotojui	n ɐ ʊ d oː t o j ʊ ɪ
naudotoją	n ɐ ʊ d oː t o j æː
naujiena	n̪ ɐ ʊ̯ˑ j î ə n̪ ɐ
nebeprisikiškiakopūsteliaudavusiais	nʲ ɛ bʲ ɛ pʲ rʲ ɪ sʲ ɪ kʲ ɪ ʃʲ kʲ ɛ k o p uː sʲ tʲ ɛ lʲ æ ʊ d ɐ ʋ ʊ sʲ ɛ j s
nebeprisikiškiakopūsteliaudavusius	nʲ ɛ bʲ ɛ pʲ rʲ ɪ sʲ ɪ kʲ ɪ ʃʲ kʲ ɛ k o p uː sʲ tʲ ɛ lʲ æ ʊ d ɐ ʋ ʊ sʲ ʊ s
nebeprisikiškiakopūsteliaudavusią	nʲ ɛ bʲ ɛ pʲ rʲ ɪ sʲ ɪ kʲ ɪ ʃʲ kʲ ɛ k o p uː sʲ tʲ ɛ lʲ æ ʊ d ɐ ʋ ʊ sʲ æː
nebeprisikiškiakopūsteliaudavusysis	nʲ ɛ bʲ ɛ pʲ rʲ ɪ sʲ ɪ kʲ ɪ ʃʲ kʲ ɛ k o p uː sʲ tʲ ɛ lʲ æ ʊ d ɐ ʋ ʊ sʲ iː sʲ ɪ s
nebeprisikiškiakopūsteliaujanti	nʲ ɛ bʲ ɛ pʲ rʲ ɪ sʲ ɪ kʲ ɪ ʃʲ kʲ ɛ k o p uː sʲ tʲ ɛ lʲ æ ʊ j ɛ nʲ tʲ ɪ
nebeprisikiškiakopūsteliaujantiems	nʲ ɛ bʲ ɛ pʲ rʲ ɪ sʲ ɪ kʲ ɪ ʃʲ kʲ ɛ k o p uː sʲ tʲ ɛ lʲ æ ʊ j ɛ nʲ tʲ j ɛ m s
nebeprisikiškiakopūsteliaujantįjį	nʲ ɛ bʲ ɛ pʲ rʲ ɪ sʲ ɪ kʲ ɪ ʃʲ kʲ ɛ k o p uː sʲ tʲ ɛ lʲ æ ʊ j ɛ nʲ tʲ iː j iː
nebeprisikiškiakopūsteliaujančiaisiais	nʲ ɛ bʲ ɛ pʲ rʲ ɪ sʲ ɪ kʲ ɪ ʃʲ kʲ ɛ k o p uː sʲ tʲ ɛ lʲ æ ʊ j ɛ nʲ tʲ ʃʲ ɛ j sʲ ɛ j s
nebeprisikiškiakopūsteliaujančiojoje	nʲ ɛ bʲ ɛ pʲ rʲ ɪ sʲ ɪ kʲ ɪ ʃʲ kʲ ɛ k o p uː sʲ tʲ ɛ lʲ æ ʊ j ɛ nʲ tʲ ʃʲ o j o j ɛ
nebeprisikiškiakopūsteliausiantysis	nʲ ɛ bʲ ɛ pʲ rʲ ɪ sʲ ɪ kʲ ɪ ʃʲ kʲ ɛ k o p uː sʲ tʲ ɛ lʲ æ ʊ sʲ ɛ nʲ tʲ iː sʲ ɪ s
nebeprisikiškiakopūsteliausiančiam	nʲ ɛ bʲ ɛ pʲ rʲ ɪ sʲ ɪ kʲ ɪ ʃʲ kʲ ɛ k o p uː sʲ tʲ ɛ lʲ æ ʊ sʲ ɛ nʲ tʲ ʃʲ ɛ m
nebeprisikiškiakopūsteliausiančiosios	nʲ ɛ bʲ ɛ pʲ rʲ ɪ sʲ ɪ kʲ ɪ ʃʲ kʲ ɛ k o p uː sʲ tʲ ɛ lʲ æ ʊ sʲ ɛ nʲ tʲ ʃʲ o sʲ o s
nebeprisikiškiakopūsteliausiančiu	nʲ ɛ bʲ ɛ pʲ rʲ ɪ sʲ ɪ kʲ ɪ ʃʲ kʲ ɛ k o p uː sʲ tʲ ɛ lʲ æ ʊ sʲ ɛ nʲ tʲ ʃʲ ʊ
nebeprisikiškiakopūsteliausiančių	nʲ ɛ bʲ ɛ pʲ rʲ ɪ sʲ ɪ kʲ ɪ ʃʲ kʲ ɛ k o p uː sʲ tʲ ɛ lʲ æ ʊ sʲ ɛ nʲ tʲ ʃʲ uː
nebeprisikiškiakopūsteliausią	nʲ ɛ bʲ ɛ pʲ rʲ ɪ sʲ ɪ kʲ ɪ ʃʲ kʲ ɛ k o p uː sʲ tʲ ɛ lʲ æ ʊ sʲ æː
nebeprisikiškiakopūsteliavusioje	nʲ ɛ bʲ ɛ pʲ rʲ ɪ sʲ ɪ kʲ ɪ ʃʲ kʲ ɛ k o p uː sʲ tʲ ɛ lʲ æ ʋ ʊ sʲ o j ɛ
nekrologas	nʲ ɛ k r o l o ɡ ɐ s
nekrologe	nʲ ɛ k r o l o ɡʲ ɛ
nekrologų	nʲ ɛ k r o l o ɡ uː
nekęsti	n ɛ k æː s t ɪ
nepadorus	nʲ ɛ p ɐ d ɔ r ʊ s
nesąmonė	nʲ ɛ s̪ ä̂ː m oː nʲ eː
netvarka	nʲ ɛ t ʋ ɐ ɾ k ɐ
netvarkinga	nʲ ɛ t ʋ ɐ ɾʲ kʲ ɪ n ɡ ɐ
netvarkingai	nʲ ɛ t ʋ ɐ ɾʲ kʲ ɪ n ɡ ɐ j
netvarkingame	nʲ ɛ t ʋ ɐ ɾʲ kʲ ɪ n ɡ ɐ mʲ ɛ
netvarkingas	nʲ ɛ t ʋ ɐ ɾʲ kʲ ɪ n ɡ ɐ s
netvarkingesniajam	nʲ ɛ t ʋ ɐ ɾʲ kʲ ɪ nʲ ɡʲ ɛ sʲ nʲ æː j ɛ m
netvarkingesniam	nʲ ɛ t ʋ ɐ ɾʲ kʲ ɪ nʲ ɡʲ ɛ sʲ nʲ æː m
netvarkingesnieji	nʲ ɛ t ʋ ɐ ɾʲ kʲ ɪ nʲ ɡʲ ɛ sʲ nʲ j ɛ j ɪ
netvarkingesniojo	nʲ ɛ t ʋ ɐ ɾʲ kʲ ɪ nʲ ɡʲ ɛ sʲ nʲ o j o
netvarkingesnysis	nʲ ɛ t ʋ ɐ ɾʲ kʲ ɪ nʲ ɡʲ ɛ sʲ nʲ iː sʲ ɪ s
netvarkingi	nʲ ɛ t ʋ ɐ ɾʲ kʲ ɪ nʲ ɡʲ ɪ
netvarkingo	nʲ ɛ t ʋ ɐ ɾʲ kʲ ɪ n ɡ o
netvarkingoje	nʲ ɛ t ʋ ɐ ɾʲ kʲ ɪ n ɡ o j ɛ
netvarkingos	nʲ ɛ t ʋ ɐ ɾʲ kʲ ɪ n ɡ o s
netvarkingose	nʲ ɛ t ʋ ɐ ɾʲ kʲ ɪ n ɡ o sʲ ɛ
netvarkingu	nʲ ɛ t ʋ ɐ ɾʲ kʲ ɪ n ɡ ʊ
netvarkingus	nʲ ɛ t ʋ ɐ ɾʲ kʲ ɪ n ɡ ʊ s
netvarkingą	nʲ ɛ t ʋ ɐ ɾʲ kʲ ɪ n ɡ aː
netvarkingąjį	nʲ ɛ t ʋ ɐ ɾʲ kʲ ɪ n ɡ aː j iː
netvarkingų	nʲ ɛ t ʋ ɐ ɾʲ kʲ ɪ n ɡ uː
netvarkoje	nʲ ɛ t ʋ ɐ ɾ k o j ɛ
netvarką	nʲ ɛ t ʋ ɐ ɾ k aː
nokti	n̪ ôː kʲ tʲ ɪ
nori	n̪ ôː rʲ ɪ
norvegiška	n o r ʋʲ ɛ ɡʲ ɪ ʃ k ɐ
norvegiškai	n o r ʋʲ ɛ ɡʲ ɪ ʃ k ɐ j
norvegiškajam	n o r ʋʲ ɛ ɡʲ ɪ ʃ k ɐ j ɛ m
norvegiškas	n o r ʋʲ ɛ ɡʲ ɪ ʃ k ɐ s
norvegiški	n o r ʋʲ ɛ ɡʲ ɪ ʃʲ kʲ ɪ
norvegiškiems	n o r ʋʲ ɛ ɡʲ ɪ ʃʲ kʲ j ɛ m s
norvegiško	n o r ʋʲ ɛ ɡʲ ɪ ʃ k o
norvegiškoje	n o r ʋʲ ɛ ɡʲ ɪ ʃ k o j ɛ
norvegiškoji	n o r ʋʲ ɛ ɡʲ ɪ ʃ k o j ɪ
norvegiškoms	n o r ʋʲ ɛ ɡʲ ɪ ʃ k o m s
norvegiškos	n o r ʋʲ ɛ ɡʲ ɪ ʃ k o s
norvegiškuoju	n o r ʋʲ ɛ ɡʲ ɪ ʃ k ʊ o j ʊ
norvegiškuose	n o r ʋʲ ɛ ɡʲ ɪ ʃ k ʊ o sʲ ɛ
norvegišką	n o r ʋʲ ɛ ɡʲ ɪ ʃ k aː
norvegiškąsias	n o r ʋʲ ɛ ɡʲ ɪ ʃ k aː sʲ ɛ s
norėti	n ɔ rʲ eː tʲ ɪ
nuduodamas	n ʊ d u ɔ d ɐ m ɐ s
nuduosiančias	n ʊ d u ɔ sʲ ɛ nʲ tʲ ʃʲ ɛ s
nuduosiančiuoju	n ʊ d u ɔ sʲ ɛ nʲ tʲ ʃʲ ʊ o j ʊ
nugalėti	n ʊ ɡ ɐ lʲ eː tʲ ɪ
nugara	n̪ ʊ ɡ ɐ r ɐ
nukeliaujantys	n ʊ kʲ ɛ lʲ æ ʊ j ɛ nʲ tʲ iː s
nukeliaujantįjį	n ʊ kʲ ɛ lʲ æ ʊ j ɛ nʲ tʲ iː j iː
nukeliaujančiame	n ʊ kʲ ɛ lʲ æ ʊ j ɛ nʲ tʲ ʃʲ ɛ mʲ ɛ
nukeliaujančias	n ʊ kʲ ɛ lʲ æ ʊ j ɛ nʲ tʲ ʃʲ ɛ s
nukeliaujančiojo	n ʊ kʲ ɛ lʲ æ ʊ j ɛ nʲ tʲ ʃʲ o j o
nukeliauti	n ʊ kʲ ɛ lʲ æ ʊ tʲ ɪ
nuodai	n̪ u ə d̪ ɐ ɪ̯ˑ
nuodinga	n u ɔ dʲ ɪ n ɡ ɐ
nuodingais	n u ɔ dʲ ɪ n ɡ ɐ j s
nuodingaisiais	n u ɔ dʲ ɪ n ɡ ɐ j sʲ ɛ j s
nuodingame	n u ɔ dʲ ɪ n ɡ ɐ mʲ ɛ
nuodingas	n u ɔ dʲ ɪ ŋ ɡ ɐ s
nuodingesne	n u ɔ dʲ ɪ nʲ ɡʲ ɛ sʲ nʲ ɛ
nuodingesnes	n u ɔ dʲ ɪ nʲ ɡʲ ɛ sʲ nʲ ɛ s
nuodingesni	n u ɔ dʲ ɪ nʲ ɡʲ ɛ sʲ nʲ ɪ
nuodingesniaisiais	n u ɔ dʲ ɪ nʲ ɡʲ ɛ sʲ nʲ ɛ j sʲ ɛ j s
nuodingesniems	n u ɔ dʲ ɪ nʲ ɡʲ ɛ sʲ nʲ j ɛ m s
nuodingesnėmis	n u ɔ dʲ ɪ nʲ ɡʲ ɛ sʲ nʲ eː mʲ ɪ s
nuodingesnės	n u ɔ dʲ ɪ nʲ ɡʲ ɛ sʲ nʲ eː s
nuodingesnėse	n u ɔ dʲ ɪ nʲ ɡʲ ɛ sʲ nʲ eː sʲ ɛ
nuodingesnį	n u ɔ dʲ ɪ nʲ ɡʲ ɛ sʲ nʲ iː
nuodingi	n u ɔ dʲ ɪ nʲ ɡʲ ɪ
nuodingiausiajame	n u ɔ dʲ ɪ nʲ ɡʲ æː ʊ sʲ ɛ j ɛ mʲ ɛ
nuodingiausiame	n u ɔ dʲ ɪ nʲ ɡʲ æː ʊ sʲ ɛ mʲ ɛ
nuodingiausias	n u ɔ dʲ ɪ nʲ ɡʲ æː ʊ sʲ ɛ s
nuodingiausiąja	n u ɔ dʲ ɪ nʲ ɡʲ æː ʊ sʲ æː j ɛ
nuodingieji	n u ɔ dʲ ɪ nʲ ɡʲ j ɛ j ɪ
nuodingo	n u ɔ dʲ ɪ n ɡ o
nuodingoji	n u ɔ dʲ ɪ n ɡ o j ɪ
nuodingojo	n u ɔ dʲ ɪ n ɡ o j o
nuodingomis	n u ɔ dʲ ɪ n ɡ o mʲ ɪ s
nuodingos	n u ɔ dʲ ɪ n ɡ o s
nuodingu	n u ɔ dʲ ɪ n ɡ ʊ
nuodingumas	n u ɔ d ɪ ŋ ɡ ʊ m ɐ s
nuodingus	n u ɔ dʲ ɪ n ɡ ʊ s
nuodingą	n u ɔ dʲ ɪ n ɡ aː
nuodingąją	n u ɔ dʲ ɪ n ɡ aː j æː
nuodingąsias	n u ɔ dʲ ɪ n ɡ aː sʲ ɛ s
nuodingų	n u ɔ dʲ ɪ n ɡ uː
nuodingųjų	n u ɔ dʲ ɪ n ɡ uː j uː
nuogas	n u ɔ ɡ ɐ s
nuolat	n̪ u ə ɫ ɐ t̪
nuomonė	n u ɔ m o nʲ eː
nuosmukiai	n u ɔ s m ʊ kʲ ɛ j
nuosmukiais	n u ɔ s m ʊ kʲ ɛ j s
nuosmukiams	n u ɔ s m ʊ kʲ ɛ m s
nuosmukio	n u ɔ s m ʊ kʲ o
nuosmukiu	n u ɔ s m ʊ kʲ ʊ
nuosmukius	n u ɔ s m ʊ kʲ ʊ s
nuosmukių	n u ɔ s m ʊ kʲ uː
nuosmukyje	n u ɔ s m ʊ kʲ iː j ɛ
nuosmukį	n u ɔ s m ʊ kʲ iː
nutarimams	n ʊ t ɐ ɾʲ ɪ m ɐ m s
nutarimas	n ʊ t ɐ ɾʲ ɪ m ɐ s
nutarime	n ʊ t ɐ ɾʲ ɪ mʲ ɛ
nutarimo	n ʊ t ɐ ɾʲ ɪ m o
nutarimui	n ʊ t ɐ ɾʲ ɪ m ʊ ɪ
nutarimuose	n ʊ t ɐ ɾʲ ɪ m ʊ o sʲ ɛ
nutarimus	n ʊ t ɐ ɾʲ ɪ m ʊ s
nutarimą	n ʊ t ɐ ɾʲ ɪ m aː
nutarimų	n ʊ t ɐ ɾʲ ɪ m uː
nutarti	n ʊ t ɐ ɾ tʲ ɪ
nutylėti	n ʊ tʲ iː lʲ eː tʲ ɪ
nėra	n eː ɾ ɐ
oda	ôː d̪ ɐ
odą	ôː d̪ aː
olandija	o l aː nʲ dʲ ɪ j ɛ
olandiška	o l aː nʲ dʲ ɪ ʃ k ɐ
olandiškai	o l aː nʲ dʲ ɪ ʃ k ɐ j
olandiškais	o l aː nʲ dʲ ɪ ʃ k ɐ j s
olandiškame	o l aː nʲ dʲ ɪ ʃ k ɐ mʲ ɛ
olandiškas	o l aː nʲ dʲ ɪ ʃ k ɐ s
olandiškieji	o l aː nʲ dʲ ɪ ʃʲ kʲ j ɛ j ɪ
olandiško	o l aː nʲ dʲ ɪ ʃ k o
olandiškos	o l aː nʲ dʲ ɪ ʃ k o s
olandiškosiomis	o l aː nʲ dʲ ɪ ʃ k o sʲ o mʲ ɪ s
olandišku	o l aː nʲ dʲ ɪ ʃ k ʊ
olandiškuoju	o l aː nʲ dʲ ɪ ʃ k ʊ o j ʊ
olandiškų	o l aː nʲ dʲ ɪ ʃ k uː
opa	o p ɐ
opijus	o pʲ i j ʊ s
oras	o ɾ ɐ s
orchidėja	o ɾʲ xʲ ɪ dʲ eː j ɐ
orgija	o rʲ ɡʲ ɪ j ɛ
orgiškam	o rʲ ɡʲ ɪ ʃ k ɐ m
orgiškas	o rʲ ɡʲ ɪ ʃ k ɐ s
orgiškesnėse	o rʲ ɡʲ ɪ ʃʲ kʲ ɛ sʲ nʲ eː sʲ ɛ
orgiškiausia	o rʲ ɡʲ ɪ ʃʲ kʲ æː ʊ sʲ ɛ
orgiškiausiam	o rʲ ɡʲ ɪ ʃʲ kʲ æː ʊ sʲ ɛ m
orgiškiausio	o rʲ ɡʲ ɪ ʃʲ kʲ æː ʊ sʲ o
orgiškiausiąjį	o rʲ ɡʲ ɪ ʃʲ kʲ æː ʊ sʲ æː j iː
orgiškiausiųjų	o rʲ ɡʲ ɪ ʃʲ kʲ æː ʊ sʲ uː j uː
orgiškieji	o rʲ ɡʲ ɪ ʃʲ kʲ j ɛ j ɪ
orgiškoms	o rʲ ɡʲ ɪ ʃ k o m s
orgišką	o rʲ ɡʲ ɪ ʃ k aː
ožys	ɔ ʒʲ iː s
pabūti	p ɐ b uː tʲ ɪ
padalyvis	p aː d ɐ lʲ i ʋʲ ɪ s
padorus	p ɐ d ɔ r ʊ s
paduoti	p ɐ d u ɔ tʲ ɪ
pagonybė	p ɐ ɡ o nʲ iː bʲ eː
palaukti	p ɐ l a ʊ kʲ tʲ ɪ
panaudotojomis	p ɐ n ɐ ʊ d oː t o j o mʲ ɪ s
panaudotojui	p ɐ n ɐ ʊ d oː t o j ʊ ɪ
paplūdimys	p ɐ p l uː dʲ ɪ mʲ iː s
parama	p ɐ ɾ ɐ m ɐ
paramai	p aː ɾ ɐ m ɐ j
paramą	p aː ɾ ɐ m aː
paramų	p ɐ ɾ ɐ m uː
pardavėja	p ɐ r d ɐ ʋʲ eː j ɛ
pardavėjai	p ɐ ɾ d ɐ ʋʲ eː j ɛ j
pardavėjais	p ɐ ɾ d ɐ ʋʲ eː j ɛ j s
pardavėjas	p ɐ ɾ d ɐ ʋʲ eː j ɛ s
pardavėjo	p ɐ ɾ d ɐ ʋʲ eː j o
pardavėjomis	p ɐ ɾ d ɐ ʋʲ eː j o mʲ ɪ s
pardavėjos	p ɐ ɾ d ɐ ʋʲ eː j o s
pardavėju	p ɐ ɾ d ɐ ʋʲ eː j ʊ
pardavėjui	p ɐ ɾ d ɐ ʋʲ eː j ʊ ɪ
pardavėjus	p ɐ ɾ d ɐ ʋʲ eː j ʊ s
pardavėją	p ɐ ɾ d ɐ ʋʲ eː j æː
pardavėjų	p ɐ ɾ d ɐ ʋʲ eː j uː
parduoti	p ɐ ɾ d u ɔ tʲ ɪ
parkeliaujantį	p ɐ rʲ kʲ ɛ lʲ æ ʊ j ɛ nʲ tʲ iː
parkeliaujančiai	p ɐ rʲ kʲ ɛ lʲ æ ʊ j ɛ nʲ tʲ ʃʲ ɛ j
parkeliaujančią	p ɐ rʲ kʲ ɛ lʲ æ ʊ j ɛ nʲ tʲ ʃʲ æː
parkeliaujančių	p ɐ rʲ kʲ ɛ lʲ æ ʊ j ɛ nʲ tʲ ʃʲ uː
pas	p ɐ s
pasakiškas	p aː s ɐ kʲ ɪ ʃ k ɐ s
pasakyti	p ɐ s ɐ kʲ iː tʲ ɪ
pasauli	p ɐ s a ʊ lʲ ɪ
pasauliai	p ɐ s a ʊ lʲ ɛ j
pasauliams	p ɐ s a ʊ lʲ ɛ m s
pasaulio	p ɐ s a ʊ lʲ o
pasaulis	p ɐ s a ʊ lʲ ɪ s
pasauliu	p ɐ s a ʊ lʲ ʊ
pasauliui	p ɐ s a ʊ lʲ ʊ ɪ
pasauliuose	p ɐ s a ʊ lʲ ʊ o sʲ ɛ
pasaulius	p ɐ s a ʊ lʲ ʊ s
pasaulių	p ɐ s a ʊ lʲ uː
pasaulyje	p ɐ s a ʊ lʲ iː j ɛ
pasaulį	p ɐ s a ʊ lʲ iː
paslaptinga	p ɐ s l ɐ p tʲ ɪ n ɡ ɐ
paslaptingai	p ɐ s l ɐ p tʲ ɪ n ɡ ɐ j
paslaptingais	p ɐ s l ɐ p tʲ ɪ n ɡ ɐ j s
paslaptingajam	p ɐ s l ɐ p tʲ ɪ n ɡ ɐ j ɛ m
paslaptingame	p ɐ s l ɐ p tʲ ɪ n ɡ ɐ mʲ ɛ
paslaptingas	p ɐ s l ɐ p tʲ ɪ n ɡ ɐ s
paslaptingesni	p ɐ s l ɐ p tʲ ɪ nʲ ɡʲ ɛ sʲ nʲ ɪ
paslaptingesniam	p ɐ s l ɐ p tʲ ɪ nʲ ɡʲ ɛ sʲ nʲ æː m
paslaptingesnieji	p ɐ s l ɐ p tʲ ɪ nʲ ɡʲ ɛ sʲ nʲ j ɛ j ɪ
paslaptingesniojo	p ɐ s l ɐ p tʲ ɪ nʲ ɡʲ ɛ sʲ nʲ o j o
paslaptingesniosiomis	p ɐ s l ɐ p tʲ ɪ nʲ ɡʲ ɛ sʲ nʲ oː sʲ o mʲ ɪ s
paslaptingesniosioms	p ɐ s l ɐ p tʲ ɪ nʲ ɡʲ ɛ sʲ nʲ oː sʲ o m s
paslaptingesnė	p ɐ s l ɐ p tʲ ɪ nʲ ɡʲ ɛ sʲ nʲ eː
paslaptingesnės	p ɐ s l ɐ p tʲ ɪ nʲ ɡʲ ɛ sʲ nʲ eː s
paslaptingi	p ɐ s l ɐ p tʲ ɪ nʲ ɡʲ ɪ
paslaptingiausia	p ɐ s l ɐ p tʲ ɪ nʲ ɡʲ æː ʊ sʲ ɛ
paslaptingiausiojoje	p ɐ s l ɐ p tʲ ɪ nʲ ɡʲ æː ʊ sʲ o j o j ɛ
paslaptingiausių	p ɐ s l ɐ p tʲ ɪ nʲ ɡʲ æː ʊ sʲ uː
paslaptingo	p ɐ s l ɐ p tʲ ɪ n ɡ o
paslaptingoji	p ɐ s l ɐ p tʲ ɪ n ɡ o j ɪ
paslaptingojo	p ɐ s l ɐ p tʲ ɪ n ɡ o j o
paslaptingomis	p ɐ s l ɐ p tʲ ɪ n ɡ o mʲ ɪ s
paslaptingos	p ɐ s l ɐ p tʲ ɪ n ɡ o s
paslaptingosios	p ɐ s l ɐ p tʲ ɪ n ɡ o sʲ o s
paslaptingu	p ɐ s l ɐ p tʲ ɪ n ɡ ʊ
paslaptinguosiuose	p ɐ s l ɐ p tʲ ɪ n ɡ ʊ o sʲ ʊ o sʲ ɛ
paslaptingus	p ɐ s l ɐ p tʲ ɪ n ɡ ʊ s
paslaptingą	p ɐ s l ɐ p tʲ ɪ n ɡ aː
paslaptingąją	p ɐ s l ɐ p tʲ ɪ n ɡ aː j æː
paslaptingų	p ɐ s l ɐ p tʲ ɪ n ɡ uː
pastebėti	p ɐ sʲ tʲ ɛ bʲ eː tʲ ɪ
patarimai	p ɐ t ɐ ɾʲ ɪ m ɐ j
patarimais	p ɐ t ɐ ɾʲ ɪ m ɐ j s
patarimas	p ɐ t ɐ ɾʲ ɪ m ɐ s
patarimo	p ɐ t ɐ ɾʲ ɪ m o
patarimu	p ɐ t ɐ ɾʲ ɪ m ʊ
patarimuose	p ɐ t ɐ ɾʲ ɪ m ʊ o sʲ ɛ
patarimus	p ɐ t ɐ ɾʲ ɪ m ʊ s
patarimą	p ɐ t ɐ ɾʲ ɪ m aː
patarimų	p ɐ t ɐ ɾʲ ɪ m uː
patarti	p ɐ t ɐ ɾ tʲ ɪ
patikti	p ɐ tʲ ɪ kʲ tʲ ɪ
patylėti	p ɐ tʲ iː lʲ eː tʲ ɪ
paupines	p ɐ ʊ pʲ ɪ nʲ ɛ s
paupiniais	p ɐ ʊ pʲ ɪ nʲ ɛ j s
peilis	pʲ ɛ ɪ̯ˑ lʲ ɪ s̪
pelkė	pʲ æː lʲ kʲ eː
pelėda	pʲ ɛ lʲ eː d ɐ
pelėdai	pʲ ɛ lʲ eː d ɐ j
pelėdas	pʲ ɛ lʲ eː d ɐ s
pelėdoms	pʲ ɛ lʲ eː d o m s
pelėdos	pʲ ɛ lʲ eː d o s
pelėdą	pʲ ɛ lʲ eː d aː
pelėsis	pʲ ɛ lʲ ěː s̪ʲ ɪ s̪
per	pʲ ɛ r
perka	pʲ ɛ r k ɐ
perkalbėti	pʲ æː ɾ k ɐ l bʲ eː tʲ ɪ
pernelyg	pʲ ɛ r nʲ ɛ lʲ iː ɡ
perparduoti	pʲ æː r p ɐ ɾ d ʊ ɔ tʲ ɪ
piemuo	pʲ ɪ ə m u ə
pietūs	pʲ ɪ ɛ t̪ uː s̪
pieštukai	pʲ i ɛ ʃ t ʊ k ɐ j
pieštukais	pʲ i ɛ ʃ t ʊ k ɐ j s
pieštukas	pʲ i ɛ ʃ t ʊ k ɐ s
pieštuko	pʲ i ɛ ʃ t ʊ k o
pieštuku	pʲ i ɛ ʃ t ʊ k ʊ
pieštukui	pʲ i ɛ ʃ t ʊ k ʊ ɪ
pieštuką	pʲ i ɛ ʃ t ʊ k aː
pieštukų	pʲ i ɛ ʃ t ʊ k uː
pigus	pʲ ɪ ɡ ʊ s̪
piktas	pʲ ɪ k t̪ ɐ s̪
pilkas	pʲ ɪ l k ɐ s
pilnatis	pʲ ɪ l n ɐ tʲ ɪ s
pina	pʲ ɪ n̪ ɐ
pingvinai	pʲ ɪ nʲ ɡʲ ʋʲ ɪ n ɐ j
pingvinas	pʲ ɪ nʲ ɡʲ ʋʲ ɪ n ɐ s
pingvinus	pʲ ɪ nʲ ɡʲ ʋʲ ɪ n ʊ s
pingviną	pʲ ɪ nʲ ɡʲ ʋʲ ɪ n aː
pingvinų	pʲ ɪ nʲ ɡʲ ʋʲ ɪ n uː
pinti	pʲ ɪ nʲ tʲ ɪ
pinu	pʲ ɪ n̪ ʊ
piratas	pʲ ɪ r ä̌ː t̪ ɐ s̪
pirkti	pʲ ɪ rʲ kʲ tʲ ɪ
pisantieji	pʲ ɪ s ɐ nʲ tʲ j ɛ j ɪ
pisančiąja	pʲ ɪ s ɐ nʲ tʲ ʃʲ æː j ɛ
pisti	pʲ ɪ sʲ tʲ ɪ
pistis	pʲ ɪ sʲ tʲ ɪ s
pjaustau	pʲ j æ u s t ɐ ʊ
pjausto	pʲ j æ u s t o
pjaustome	pʲ j æ u s t o mʲ ɛ
pjaustydavote	pʲ j æ u sʲ tʲ i d ɐ ʋ o tʲ ɛ
pjaustyk	pʲ j æ u sʲ tʲ i k
pjaustykite	pʲ j æ u sʲ tʲ i kʲ ɪ tʲ ɛ
pjaustymais	pʲ j æ uː sʲ tʲ iː m ɐ j s
pjaustymas	pʲ j æ uː sʲ tʲ iː m ɐ s
pjaustymo	pʲ j æ uː sʲ tʲ iː m o
pjaustymui	pʲ j æ uː sʲ tʲ iː m ʊ ɪ
pjaustymus	pʲ j æ uː sʲ tʲ iː m ʊ s
pjaustymą	pʲ j æ uː sʲ tʲ iː m aː
pjaustysi	pʲ j æ u sʲ tʲ i sʲ ɪ
pjaustysiu	pʲ j æ u sʲ tʲ i sʲ ʊ
pjaustyti	pʲ j æ u sʲ tʲ i tʲ ɪ
pjaustytum	pʲ j æ u sʲ tʲ i t ʊ m
pjaustytų	pʲ j æ u sʲ tʲ i t u
pjaustė	pʲ j æ u sʲ tʲ e
pjausčiau	pʲ j æ u sʲ tʲ ʃʲ ɛ ʊ
planeta	p l ɐ n e t ɐ
plaukas	p ɫ ä̂ˑ ʊ̯ k ɐ s̪
plikas	pʲ lʲ ɪ k ɐ s̪
pluta	p ɫ ʊ t̪ ɐ
pornografine	p o ɾ n o ɡ ɾ aː fʲ ɪ nʲ ɛ
pornografiniams	p o ɾ n o ɡ ɾ aː fʲ ɪ nʲ ɛ m s
pornografinio	p o ɾ n o ɡ ɾ aː fʲ ɪ nʲ o
pornografiniu	p o ɾ n o ɡ ɾ aː fʲ ɪ nʲ ʊ
pornografiniuose	p o ɾ n o ɡ ɾ aː fʲ ɪ nʲ ʊ o sʲ ɛ
pornografinius	p o ɾ n o ɡ ɾ aː fʲ ɪ nʲ ʊ s
pornografinių	p o ɾ n o ɡ ɾ aː fʲ ɪ nʲ uː
pornografinė	p o ɾ n o ɡ ɾ aː fʲ ɪ nʲ eː
pornografinę	p o ɾ n o ɡ ɾ aː fʲ ɪ nʲ æː
pornografinį	p o ɾ n o ɡ ɾ aː fʲ ɪ nʲ iː
pornografiškesniosioms	p o r n o ɡ r ɐ fʲ ɪ ʃʲ kʲ ɛ sʲ nʲ oː sʲ o m s
pornografiškiausiajai	p o r n o ɡ r ɐ fʲ ɪ ʃʲ kʲ æː ʊ sʲ ɛ j ɛ j
pornografiškiausiesiems	p o r n o ɡ r ɐ fʲ ɪ ʃʲ kʲ æː ʊ sʲ j ɛ sʲ j ɛ m s
pornografiškiesiems	p o r n o ɡ r aː fʲ ɪ ʃʲ kʲ j ɛ sʲ j e m s
portugališkai	p o r t ʊ ɡ aː lʲ ɪ ʃ k ɐ j
povas	p oː ʋ ɐ s
pragaras	p r aː ɡ ɐ r ɐ s
prakaitas	p r aː k ɐ j t ɐ s
prakaituotas	p r ɐ k ɐ j t u ɔ t ɐ s
prakeliaujantį	p r ɐ kʲ ɛ lʲ æ ʊ j ɛ nʲ tʲ iː
prakeliaujančia	p r ɐ kʲ ɛ lʲ æ ʊ j ɛ nʲ tʲ ʃʲ ɛ
prakeliaujančiose	p r ɐ kʲ ɛ lʲ æ ʊ j ɛ nʲ tʲ ʃʲ o sʲ ɛ
prancūzija	p r ɐ n t s uː zʲ ɪ j ɛ
prancūziška	p r ɐ n t s uː zʲ ɪ ʃ k ɐ
prancūziškai	p r ɐ n t s uː zʲ ɪ ʃ k ɐ j
prancūziškais	p r ɐ n t s uː zʲ ɪ ʃ k ɐ j s
prancūziškam	p r ɐ n t s uː zʲ ɪ ʃ k ɐ m
prancūziškame	p r ɐ n t s uː zʲ ɪ ʃ k ɐ mʲ ɛ
prancūziškas	p r ɐ n t s uː zʲ ɪ ʃ k ɐ s
prancūziškasis	p r ɐ n t s uː zʲ ɪ ʃ k ɐ sʲ ɪ s
prancūziški	p r ɐ n t s uː zʲ ɪ ʃʲ kʲ ɪ
prancūziško	p r ɐ n t s uː zʲ ɪ ʃ k o
prancūziškoje	p r ɐ n t s uː zʲ ɪ ʃ k o j ɛ
prancūziškos	p r ɐ n t s uː zʲ ɪ ʃ k o s
prancūziškosios	p r ɐ n t s uː zʲ ɪ ʃ k o sʲ o s
prancūzišku	p r ɐ n t s uː zʲ ɪ ʃ k ʊ
prancūziškuoju	p r ɐ n t s uː zʲ ɪ ʃ k ʊ o j ʊ
prancūziškuosiuose	p r ɐ n t s uː zʲ ɪ ʃ k ʊ o sʲ ʊ o sʲ ɛ
prancūziškus	p r ɐ n t s uː zʲ ɪ ʃ k ʊ s
prancūzišką	p r ɐ n t s uː zʲ ɪ ʃ k aː
prancūziškąjį	p r ɐ n t s uː zʲ ɪ ʃ k aː j iː
prancūziškų	p r ɐ n t s uː zʲ ɪ ʃ k uː
prausti	p r ɒ ʊ̯ˑ sʲ tʲ ɪ
prekė	pʲ rʲ æ̌ː kʲ eː
prielipais	pʲ rʲ i ɛ lʲ ɪ p ɐ j s
prielipo	pʲ rʲ i ɛ lʲ ɪ p o
prielipus	pʲ rʲ i ɛ lʲ ɪ p ʊ s
prielipų	pʲ rʲ i ɛ lʲ ɪ p uː
prietaisas	pʲ rʲ ɪ̂ ə t̪ ɐ ɪ̯ˑ s̪ ɐ s̪
prietaras	pʲ rʲ ɪ̂ ə t̪ ä̌ː r ɐ s̪
pritarimas	pʲ ɾʲ ɪ t ɐ ɾʲ ɪ m ɐ s
pritarimo	pʲ ɾʲ ɪ t ɐ ɾʲ ɪ m o
pritarimu	pʲ ɾʲ ɪ t ɐ ɾʲ ɪ m ʊ
pritarimui	pʲ ɾʲ ɪ t ɐ ɾʲ ɪ m ʊ ɪ
pritarimą	pʲ ɾʲ ɪ t ɐ ɾʲ ɪ m aː
pritarti	pʲ ɾʲ ɪ t ɐ ɾ tʲ ɪ
profesijai	p r o fʲ ɛ sʲ ɪ j ɛ j
profesijas	p r o fʲ ɛ sʲ ɪ j ɛ s
profesijoje	p r o fʲ ɛ sʲ ɪ j o j ɛ
profesijomis	p r o fʲ ɛ sʲ ɪ j o mʲ ɪ s
profesijoms	p r o fʲ ɛ sʲ ɪ j o m s
profesijose	p r o fʲ ɛ sʲ ɪ j o sʲ ɛ
profesiją	p r o fʲ ɛ sʲ ɪ j æː
proga	p r ôː ɡ ɐ
proporcija	p r ɔ p ɔ r t̪͡s̪ ɪ j ɐ
proporcijos	p r ɔ p ɔ r t̪͡s̪ ɪ j oː s
prostitucija	p r o sʲ tʲ ɪ t ʊ tʲ sʲ ɪ j ɛ
prostitucijai	p r o sʲ tʲ ɪ t ʊ tʲ sʲ ɪ j ɛ j
prostitucijoje	p r o sʲ tʲ ɪ t ʊ tʲ sʲ ɪ j o j ɛ
prostitucijos	p r o sʲ tʲ ɪ t ʊ tʲ sʲ ɪ j o s
prostituciją	p r o sʲ tʲ ɪ t ʊ tʲ sʲ ɪ j æː
pudeliai	p ʊ dʲ ɛ lʲ ɛ j
pudelis	p ʊ dʲ ɛ lʲ ɪ s
pudelius	p ʊ dʲ ɛ lʲ ʊ s
pudelių	p ʊ dʲ ɛ lʲ uː
pudelį	p ʊ dʲ ɛ lʲ iː
pusakliai	p ʊ s ɐ kʲ lʲ ɛ j
pusakliame	p ʊ s ɐ kʲ lʲ ɛ mʲ ɛ
pusakliams	p ʊ s ɐ kʲ lʲ ɛ m s
pusaklių	p ʊ s ɐ kʲ lʲ uː
pusaklė	p ʊ s ɐ kʲ lʲ eː
pusaklėms	p ʊ s ɐ kʲ lʲ eː m s
pusaklę	p ʊ s ɐ kʲ lʲ æː
pusbroli	p ʊ s b r o lʲ ɪ
pusbroliai	p ʊ s b r o lʲ ɛ j
pusbroliais	p ʊ s b r o lʲ ɛ j s
pusbrolio	p ʊ s b r o lʲ o
pusbrolis	p ʊ s b r o lʲ ɪ s
pusbroliu	p ʊ s b r o lʲ ʊ
pusbrolių	p ʊ s b r o lʲ uː
pusbrolį	p ʊ s b r o lʲ iː
pusdievius	p ʊ sʲ dʲ j ɛ ʋʲ ʊ s
puslapi	p ʊ s l ɐ pʲ ɪ
puslapiais	p ʊ s l ɐ pʲ ɛ j s
puslapiams	p ʊ s l ɐ pʲ ɛ m s
puslapio	p ʊ s l ɐ pʲ o
puslapis	p ʊ s l ɐ pʲ ɪ s
puslapiu	p ʊ s l ɐ pʲ ʊ
puslapiui	p ʊ s l ɐ pʲ ʊ ɪ
puslapiuose	p ʊ s l ɐ pʲ ʊ o sʲ ɛ
puslapių	p ʊ s l ɐ pʲ uː
puslapyje	p ʊ s l ɐ pʲ iː j ɛ
puslapį	p ʊ s l ɐ pʲ iː
pusseserė	p ʊ sʲ ɛ sʲ ɛ rʲ eː
pusseserės	p ʊ sʲ ɛ sʲ ɛ rʲ eː s
pusseserėse	p ʊ sʲ ɛ sʲ ɛ rʲ eː sʲ ɛ
pušis	p ʊ ʃʲ ɪ s̪
pūslelė	p uː sʲ lʲ æː lʲ eː
ragas	r ä̌ː ɡ ɐ s̪
raktas	ɾ aː k t ɐ s
ramus	r ɐ m ʊ s̪
ranka	ɾ ɐ ŋ k ɐ
rankai	ɾ ɐ ŋ k ɐ j
rankas	ɾ ɐ ŋ k ɐ s
rankoje	ɾ ɐ ŋ k oː j ɛ
rankomis	ɾ ɐ ŋ k oː mʲ ɪ s
rankoms	ɾ ɐ ŋ k oː m s
rankos	ɾ ɐ ŋ k oː s
rankose	ɾ ɐ n k o sʲ ɛ
ranką	ɾ ɐ ŋ k aː
rankų	ɾ ɐ ŋ k uː
raudonas	r ɐ ʊ d oː n ɐ s
raudoti	r ɐ ʊ̯ˑ d̪ ôː t̪ʲ ɪ
reikalingas	rʲ ɛ j k ɐ lʲ ɪ n ɡ ɐ s
reikia	rʲ ɛ j kʲ ɛ
reikšmė	r e ɪ k ʃ m eː
respublika	ɾʲ ɛ s p ʊ bʲ lʲ ɪ k ɐ
respublikas	ɾʲ ɛ s p ʊ bʲ lʲ ɪ k ɐ s
respublikoje	ɾʲ ɛ s p ʊ bʲ lʲ ɪ k o j ɛ
respublikomis	ɾʲ ɛ s p ʊ bʲ lʲ ɪ k o mʲ ɪ s
respublikoms	ɾʲ ɛ s p ʊ bʲ lʲ ɪ k o m s
respublikos	ɾʲ ɛ s p ʊ bʲ lʲ ɪ k o s
respublikose	ɾʲ ɛ s p ʊ bʲ lʲ ɪ k o sʲ ɛ
respubliką	ɾʲ ɛ s p ʊ bʲ lʲ ɪ k a
respublikų	ɾʲ ɛ s p ʊ bʲ lʲ ɪ k u
rezultatais	ɾʲ ɛ z ʊ l t aː t ɐ j s
rezultatams	ɾʲ ɛ z ʊ l t aː t ɐ m s
rezultatas	ɾʲ ɛ z ʊ l t aː t ɐ s
rezultato	ɾʲ ɛ z ʊ l t aː t o
rezultatu	ɾʲ ɛ z ʊ l t ɐ t ʊ
rezultatui	ɾʲ ɛ z ʊ l t aː t ʊ ɪ
rezultatus	ɾʲ ɛ z ʊ l t ɐ t ʊ s
rezultatą	ɾʲ ɛ z ʊ l t aː t aː
rezultatų	ɾʲ ɛ z ʊ l t aː t uː
riba	rʲ ɪ b ɐ
riebalai	rʲ ɪ ə b ɐ l ɐ ɪ̯ˑ
rikis	rʲ ɪ kʲ ɪ s
rita	rʲ ɪ t̪ ɐ
rišti	rʲ ɪ ʃʲ tʲ ɪ
rojalis	ɾ o j æː lʲ ɪ s
rojalyje	ɾ o j æː lʲ i j ɛ
rojalį	ɾ o j æː lʲ i
rožė	ɾ oː ʒʲ eː
ruduo	ɾ ʊ d u ɔ
rugys	r ʊ ɡʲ ǐː s̪
rumunija	r ʊ m ʊ nʲ ɪ j ɛ
rumunijos	r ʊ m ʊ nʲ ɪ jʲ ɪ j o s
rumuniją	r ʊ m ʊ nʲ ɪ jʲ ɪ j æː
rumuniškam	r ʊ m ʊ nʲ ɪ ʃ k ɐ m
rupūžė	ɾ ʊ p u ʒʲ e
rupūžės	ɾ ʊ p u ʒʲ e s
rusiškieji	r ʊ sʲ ɪ ʃʲ kʲ j ɛ j ɪ
rusiškoji	r ʊ sʲ ɪ ʃ k o j ɪ
rusiškojo	r ʊ sʲ ɪ ʃ k o j o
rusiškosios	r ʊ sʲ ɪ ʃ k o sʲ o s
rusiškuoju	r ʊ sʲ ɪ ʃ k ʊ o j ʊ
rusiškuosius	r ʊ sʲ ɪ ʃ k ʊ o sʲ ʊ s
rytai	rʲ iː t̪ ɐ ɪ̯ˑ
rąstas	r äː s̪ t̪ ɐ s̪
rūkas	r uː k ɐ s
sabalo	s aː b ɐ l o
sabalu	s a b ɐ l ʊ
sabalus	s ɐ b ɐ l ʊ s
sakanti	s aː k ɐ nʲ tʲ ɪ
sakantiems	s aː k ɐ nʲ tʲ j ɛ m s
sakantis	s aː k ɐ nʲ tʲ ɪ s
sakantys	s aː k ɐ nʲ tʲ iː s
sakančiais	s aː k ɐ nʲ tʲ ʃʲ ɛ j s
sakančiu	s aː k ɐ nʲ tʲ ʃʲ ʊ
sakančių	s aː k ɐ nʲ tʲ ʃʲ uː
sakyti	s ɐ kʲ iː tʲ ɪ
saldus	s ɐ l d ʊ s
sapnai	s ɐ p n a j
sapnais	s ɐ p n a j s
sapnams	s ɐ p n a m s
sapnas	s aː p n ɐ s
sapnavusi	s ɐ p n aː ʋ ʊ sʲ ɪ
sapnavusiajame	s ɐ p n aː ʋ ʊ sʲ ɛ j ɛ mʲ ɛ
sapnavusiuosiuose	s ɐ p n aː ʋ ʊ sʲ ʊ o sʲ ʊ o sʲ ɛ
sapnavusiųjų	s ɐ p n aː ʋ ʊ sʲ uː j uː
sapno	s aː p n ɔ
sapnu	s ɐ p n ʊ
sapnuodavusi	s ɐ p n u ɔ d ɐ ʋ ʊ sʲ ɪ
sapnuodavusiam	s ɐ p n u ɔ d ɐ ʋ ʊ sʲ ɛ m
sapnuodavusiuosiuose	s ɐ p n u ɔ d ɐ ʋ ʊ sʲ ʊ o sʲ ʊ o sʲ ɛ
sapnuodavusią	s ɐ p n u ɔ d ɐ ʋ ʊ sʲ æː
sapnus	s ɐ p n ʊ s
sapną	s aː p n aː
saugaus	s ɐ ʊ ɡ ɐ u s
saugesne	s ɐ ʊ ɡʲ ɛ sʲ nʲ ɛ
saugesnes	s ɐ ʊ ɡʲ ɛ sʲ nʲ ɛ s
saugesni	s ɐ ʊ ɡʲ ɛ sʲ nʲ ɪ
saugesniais	s ɐ ʊ ɡʲ ɛ sʲ nʲ ɛ j s
saugesniam	s ɐ ʊ ɡʲ ɛ sʲ nʲ æː m
saugesniems	s ɐ ʊ ɡʲ ɛ sʲ nʲ j ɛ m s
saugesnio	s ɐ ʊ ɡʲ ɛ sʲ nʲ o
saugesniosiomis	s ɐ ʊ ɡʲ ɛ sʲ nʲ oː sʲ o mʲ ɪ s
saugesnis	s ɐ ʊ ɡʲ ɛ sʲ nʲ ɪ s
saugesniuosius	s ɐ ʊ ɡʲ ɛ sʲ nʲ u ɔ sʲ ʊ s
saugesniąsias	s ɐ ʊ ɡʲ ɛ sʲ nʲ æː sʲ ɛ s
saugesnių	s ɐ ʊ ɡʲ ɛ sʲ nʲ uː
saugesnysis	s ɐ ʊ ɡʲ ɛ sʲ nʲ iː sʲ ɪ s
saugesnė	s ɐ ʊ ɡʲ ɛ sʲ nʲ eː
saugesnėje	s ɐ ʊ ɡʲ ɛ sʲ nʲ eː j ɛ
saugesnėmis	s ɐ ʊ ɡʲ ɛ sʲ nʲ eː mʲ ɪ s
saugesnės	s ɐ ʊ ɡʲ ɛ sʲ nʲ eː s
saugesnę	s ɐ ʊ ɡʲ ɛ sʲ nʲ æː
saugesnį	s ɐ ʊ ɡʲ ɛ sʲ nʲ iː
saugi	s ɐ ʊ ɡʲ ɪ
saugia	s ɐ ʊ ɡʲ ɛ
saugiai	s ɐ u ɡʲ ɛ j
saugiais	s ɐ ʊ ɡʲ ɛ j s
saugiam	s ɐ ʊ ɡʲ æː m
saugiame	s ɐ ʊ ɡʲ ɛ mʲ ɛ
saugias	s ɐ ʊ ɡʲ ɛ s
saugiausia	s ɐ ʊ ɡʲ æː ʊ sʲ ɛ
saugiausiai	s ɐ ʊ ɡʲ æː ʊ sʲ ɛ j
saugiausias	s ɐ ʊ ɡʲ æː ʊ sʲ ɛ s
saugiausio	s ɐ ʊ ɡʲ æː ʊ sʲ o
saugiausiojoje	s ɐ ʊ ɡʲ æː ʊ sʲ o j o j ɛ
saugiausios	s ɐ ʊ ɡʲ æː ʊ sʲ o s
saugiausiu	s ɐ ʊ ɡʲ æː ʊ sʲ ʊ
saugiausią	s ɐ ʊ ɡʲ æː ʊ sʲ æː
saugiausių	s ɐ ʊ ɡʲ æː ʊ sʲ uː
saugiems	s ɐ ʊ ɡʲ j ɛ m s
saugioje	s ɐ ʊ ɡʲ o j ɛ
saugiojo	s ɐ u ɡʲ o j o
saugiomis	s ɐ ʊ ɡʲ o mʲ ɪ s
saugioms	s ɐ ʊ ɡʲ oː m s
saugiose	s ɐ ʊ ɡʲ o sʲ ɛ
saugiu	s ɐ ʊ ɡʲ ʊ
saugiuose	s ɐ ʊ ɡʲ ʊ o sʲ ɛ
saugius	s ɐ ʊ ɡʲ ʊ s
saugią	s ɐ u ɡʲ æː
saugių	s ɐ ʊ ɡʲ uː
saugu	s ɐ ʊ ɡ ʊ
saugus	s ɐ ʊ ɡ ʊ s
saugusis	s ɐ ʊ ɡ ʊ sʲ ɪ s
saugūs	s ɐ u ɡ uː s
saugų	s ɐ u ɡ uː
saulėgrįža	s ɐ ʊ lʲ eː ɡʲ ɾʲ iː ʒ ɐ
sausis	s̪ ɐ ʊ̯ˑ s̪ʲ ɪ s̪
savitvarda	s ɐ ʋʲ ɪ t ʋ ɐ r d ɐ
seksas	s ɛ k s ɐ s
senaisiais	sʲ ɛ n ɐ j sʲ ɛ j s
senajam	sʲ ɛ n aː j ɛ m
senajame	sʲ ɛ n aː j ɛ mʲ ɛ
senasis	sʲ ɛ n ɐ sʲ ɪ s
senesniajam	sʲ ɛ nʲ ɛ sʲ nʲ æː j ɛ m
senesnieji	sʲ ɛ nʲ ɛ sʲ nʲ j ɛ j ɪ
senesnioji	sʲ ɛ nʲ ɛ sʲ nʲ oː j ɪ
senesniojo	sʲ ɛ nʲ ɛ sʲ nʲ o j o
senesniąja	sʲ ɛ nʲ ɛ sʲ nʲ æː j ɛ
senesniųjų	sʲ ɛ nʲ ɛ sʲ nʲ uː j uː
seniausiajam	sʲ ɛ nʲ æː ʊ sʲ ɛ j ɛ m
seniausiesiems	sʲ ɛ nʲ æː ʊ sʲ j ɛ sʲ j ɛ m s
seniausiąją	sʲ ɛ nʲ æː ʊ sʲ æː j æː
seniausiąsias	sʲ ɛ nʲ æː ʊ sʲ æː sʲ ɛ s
seniausiųjų	sʲ ɛ nʲ æː ʊ sʲ uː j uː
seniesiems	sʲ ɛ nʲ j ɛ sʲ j e m s
senoji	sʲ ɛ n oː j ɪ
senojo	sʲ æː n o j o
senojoje	sʲ ɛ n oː j o j ɛ
senosiomis	sʲ ɛ n oː sʲ o mʲ ɪ s
senosioms	sʲ ɛ n oː sʲ o m s
senosiose	sʲ ɛ n oː sʲ o sʲ ɛ
senąja	sʲ ɛ n aː j ɛ
senąją	sʲ æː n aː j æː
serbiškąja	sʲ ɛ rʲ bʲ ɪ ʃ k aː j ɛ
siena	s̪ʲ ɪ́ ə n̪ ɐ
sistematinis	sʲ ɪ sʲ tʲ ɛ m aː tʲ ɪ nʲ ɪ s
siuvanti	sʲ ʊ ʋ ɐ nʲ tʲ ɪ
siuvantis	sʲ ʊ ʋ ɐ nʲ tʲ ɪ s
siuvantį	sʲ ʊ ʋ ɐ nʲ tʲ iː
siuvančiosioms	sʲ ʊ ʋ ɐ nʲ tʲ ʃʲ o sʲ o m s
siuvančiu	sʲ ʊ ʋ ɐ nʲ tʲ ʃʲ ʊ
siūlai	sʲ uː l ɐ j
siūlas	sʲ uː l ɐ s
siūles	sʲ uː lʲ ɛ s
siūlių	sʲ uː lʲ uː
siūlo	sʲ uː l o
siūlu	sʲ uː l ʊ
siūlui	sʲ uː l ʊ ɪ
siūluose	sʲ uː l ʊ o sʲ ɛ
siūlą	sʲ uː l aː
siūlė	sʲ uː lʲ eː
siūlėmis	sʲ uː lʲ eː mʲ ɪ s
siūlėms	sʲ uː lʲ eː m s
siūlės	sʲ uː lʲ eː s
siūlę	sʲ uː lʲ æː
siūlų	sʲ uː l uː
siūti	sʲ uː tʲ ɪ
skaistykla	s k ɐ j sʲ tʲ iː k l ɐ
skaliko	s k ɐ lʲ ɪ k o
skalikui	s k ɐ lʲ ɪ k ʊ ɪ
skara	s̪ k ɐ r ɐ
skaudėti	s̪ k ɐ ʊ̯ˑ dʲ êː tʲ ɪ
skina	sʲ kʲ ɪ n̪ ɐ
skirtumai	sʲ kʲ ɪ ɾ t ʊ m ɐ j
skirtumais	sʲ kʲ ɪ ɾ t ʊ m ɐ j s
skirtumams	sʲ kʲ ɪ ɾ t ʊ m ɐ m s
skirtumas	sʲ kʲ ɪ ɾ t ʊ m ɐ s
skirtume	sʲ kʲ ɪ ɾ t ʊ mʲ ɛ
skirtumo	sʲ kʲ ɪ ɾ t ʊ m o
skirtumu	sʲ kʲ ɪ ɾ t ʊ m ʊ
skirtumui	sʲ kʲ ɪ ɾ t ʊ m ʊ ɪ
skirtumus	sʲ kʲ ɪ ɾ t ʊ m ʊ s
skirtumų	sʲ kʲ ɪ ɾ t ʊ m u
skorpionas	s k ɔ ɾ p j ɔ n ɐ s
skristi	sʲ kʲ ɾʲ ɪ sʲ tʲ ɪ
skulptūra	s k ʊ l p t uː ɾ ɐ
skyle	sʲ kʲ iː lʲ ɛ
skylei	sʲ kʲ iː lʲ ɛ j
skyles	sʲ kʲ iː lʲ ɛ s
skylių	sʲ kʲ iː lʲ uː
skylė	sʲ kʲ iː lʲ eː
skylėje	sʲ kʲ iː lʲ eː j ɛ
skylėmis	sʲ kʲ iː lʲ eː mʲ ɪ s
skylės	sʲ kʲ iː lʲ eː s
skylėse	sʲ kʲ iː lʲ eː sʲ ɛ
skylę	sʲ kʲ iː lʲ æː
skystis	s k iː s t ɪ s
slovakiškai	s l o ʋ aː kʲ ɪ ʃ k ɐ j
slovakiškoje	s l o ʋ aː kʲ ɪ ʃ k o j ɛ
slovakiškoji	s l o ʋ aː kʲ ɪ ʃ k o j ɪ
slovakiškose	s l o ʋ aː kʲ ɪ ʃ k o sʲ ɛ
slovakiškuosius	s l o ʋ aː kʲ ɪ ʃ k ʊ o sʲ ʊ s
slovakiškąja	s l o ʋ aː kʲ ɪ ʃ k aː j ɛ
slovakiškų	s l o ʋ aː kʲ ɪ ʃ k uː
slovėniškai	s l o ʋʲ eː nʲ ɪ ʃ k ɐ j
slovėniškajai	s l o ʋʲ eː nʲ ɪ ʃ k ɐ j ɛ j
slovėniškasis	s l o ʋʲ eː nʲ ɪ ʃ k ɐ sʲ ɪ s
slovėniškojo	s l o ʋʲ eː nʲ ɪ ʃ k o j o
slovėniškąsias	s l o ʋʲ eː nʲ ɪ ʃ k aː sʲ ɛ s
slyva	s l i ʋ ɐ
slėpti	sʲ lʲ eː pʲ tʲ ɪ
slėptis	sʲ lʲ eː pʲ tʲ ɪ s
smegenys	s̪ʲ mʲ æ̌ː ɡʲ ɛ n̪ʲ iː s̪
smulkmena	s m ʊ l k m ɛ n ɐ
smulkmenai	s m ʊ lʲ kʲ mʲ ɛ n ɐ j
smulkmeniškai	s m ʊ lʲ kʲ mʲ ɛ nʲ ɪ ʃ k ɐ j
smulkmeniškaisiais	s m ʊ lʲ kʲ mʲ ɛ nʲ ɪ ʃ k ɐ j sʲ ɛ j s
smulkmeniškam	s m ʊ lʲ kʲ mʲ ɛ nʲ ɪ ʃ k ɐ m
smulkmeniškesniems	s m ʊ lʲ kʲ mʲ ɛ nʲ ɪ ʃʲ kʲ ɛ sʲ nʲ j ɛ m s
smulkmeniškesniesiems	s m ʊ lʲ kʲ mʲ ɛ nʲ ɪ ʃʲ kʲ ɛ sʲ nʲ j ɛ sʲ j e m s
smulkmeniškesniojo	s m ʊ lʲ kʲ mʲ ɛ nʲ ɪ ʃʲ kʲ ɛ sʲ nʲ o j o
smulkmeniškesniuoju	s m ʊ lʲ kʲ mʲ ɛ nʲ ɪ ʃʲ kʲ ɛ sʲ nʲ u ɔ j ʊ
smulkmeniškesnėmis	s m ʊ lʲ kʲ mʲ ɛ nʲ ɪ ʃʲ kʲ ɛ sʲ nʲ eː mʲ ɪ s
smulkmeniški	s m ʊ lʲ kʲ mʲ ɛ nʲ ɪ ʃʲ kʲ ɪ
smulkmeniškiausiojo	s m ʊ lʲ kʲ mʲ ɛ nʲ ɪ ʃʲ kʲ æː ʊ sʲ o j o
smulkmeniškiausiosiomis	s m ʊ lʲ kʲ mʲ ɛ nʲ ɪ ʃʲ kʲ æː ʊ sʲ o sʲ o mʲ ɪ s
smulkmeniško	s m ʊ lʲ kʲ mʲ ɛ nʲ ɪ ʃ k o
smulkmeniškojoje	s m ʊ lʲ kʲ mʲ ɛ nʲ ɪ ʃ k o j o j ɛ
smulkmeniškoms	s m ʊ lʲ kʲ mʲ ɛ nʲ ɪ ʃ k o m s
smulkmeniškumas	s m ʊ lʲ kʲ mʲ ɛ nʲ ɪ ʃ k ʊ m ɐ s
smulkmeniškumu	s m ʊ lʲ kʲ mʲ ɛ nʲ ɪ ʃ k ʊ m ʊ
smulkmeniškus	s m ʊ lʲ kʲ mʲ ɛ nʲ ɪ ʃ k ʊ s
smulkmenišką	s m ʊ lʲ kʲ mʲ ɛ nʲ ɪ ʃ k aː
smulkmeniškąją	s m ʊ lʲ kʲ mʲ ɛ nʲ ɪ ʃ k aː j æː
smulkmenomis	s m ʊ lʲ kʲ mʲ ɛ n o mʲ ɪ s
smulkmenoms	s m ʊ lʲ kʲ mʲ ɛ n o m s
smulkmenos	s m ʊ lʲ kʲ mʲ ɛ n o s
smulkmenose	s m ʊ lʲ kʲ mʲ ɛ n o sʲ ɛ
smulkmeną	s m ʊ lʲ kʲ mʲ ɛ n a
smulkmenų	s m ʊ lʲ kʲ mʲ ɛ n u
snapas	s̪ n̪ ä̌ː p ɐ s̪
sniegas	sʲ nʲ j æ ɡ ɐ s
snukis	s n ʊ kʲ ɪ s
sodas	s oː d ɐ s
sopa	s̪ ôː p ɐ
speneliai	sʲ pʲ ɛ nʲ æː lʲ ɛ j
spenelio	sʲ pʲ ɛ nʲ æː lʲ o
spenelis	sʲ pʲ ɛ nʲ æː lʲ ɪ s
speneliu	sʲ pʲ ɛ nʲ ɛ lʲ ʊ
spenelius	sʲ pʲ ɛ nʲ ɛ lʲ ʊ s
spenelių	sʲ pʲ ɛ nʲ æː lʲ u
spenelį	sʲ pʲ ɛ nʲ æː lʲ i
sperma	sʲ pʲ ɛ ɾ m ɐ
spermatozoidai	sʲ pʲ ɛ ɾ m ɐ t o z o j d ɐ j
spermatozoidams	sʲ pʲ ɛ ɾ m ɐ t o z o j d ɐ m s
spermatozoidas	sʲ pʲ ɛ ɾ m ɐ t o z o j d ɐ s
spermatozoido	sʲ pʲ ɛ ɾ m ɐ t o z o j d o
spermatozoidus	sʲ pʲ ɛ ɾ m ɐ t o z o j d ʊ s
spermatozoidų	sʲ pʲ ɛ ɾ m ɐ t o z o j d uː
spermoje	sʲ pʲ ɛ ɾ m o j ɛ
spermomis	sʲ pʲ ɛ ɾ m o mʲ ɪ s
spermos	sʲ pʲ ɛ ɾ m o s
spermą	sʲ pʲ ɛ ɾ m a
spermų	sʲ pʲ ɛ ɾ m u
spyglys	sʲ pʲ iː ɡʲ lʲ ǐː s̪
sraigtas	s̪ r ä̂ˑ ɪ̯ k t̪ ɐ s̪
srautai	s r ɐ u t ɐ j
srautais	s r ɐ u t ɐ j s
srautams	s r ɐ u t ɐ m s
srautas	s r ɐ u t ɐ s
srauto	s r ɐ u t o
srautui	s r ɐ u t ʊ ɪ
srautus	s r ɐ ʊ t ʊ s
srautų	s r ɐ u t uː
sritis	sʲ rʲ ɪ tʲ ɪ s̪
srovė	s̪ r oː vʲ eː
stabdys	s̪ t̪ ɐ bʲ dʲ ǐː s̪
stalas	s̪ t̪ ä̌ː ɫ ɐ s̪
stebi	sʲ tʲ æː bʲ ɪ
stebinti	sʲ tʲ æː bʲ ɪ nʲ tʲ ɪ
stebintieji	sʲ tʲ æː bʲ ɪ nʲ tʲ j ɛ j ɪ
stebintiems	sʲ tʲ æː bʲ ɪ nʲ tʲ j ɛ m s
stebintis	sʲ tʲ æː bʲ ɪ nʲ tʲ ɪ s
stebintys	sʲ tʲ æː bʲ ɪ nʲ tʲ iː s
stebintį	sʲ tʲ æː bʲ ɪ nʲ tʲ iː
stebinčio	sʲ tʲ æː bʲ ɪ nʲ tʲ ʃʲ o
stebinčiojoje	sʲ tʲ æː bʲ ɪ nʲ tʲ ʃʲ o j o j ɛ
stebinčiose	sʲ tʲ æː bʲ ɪ nʲ tʲ ʃʲ o sʲ ɛ
stebinčiu	sʲ tʲ æː bʲ ɪ nʲ tʲ ʃʲ ʊ
stebinčiuoju	sʲ tʲ æː bʲ ɪ nʲ tʲ ʃʲ ʊ o j ʊ
stebinčius	sʲ tʲ æː bʲ ɪ nʲ tʲ ʃʲ ʊ s
stebinčią	sʲ tʲ æː bʲ ɪ nʲ tʲ ʃʲ æː
stebinčių	sʲ tʲ æː bʲ ɪ nʲ tʲ ʃʲ uː
stebinčiųjų	sʲ tʲ æː bʲ ɪ nʲ tʲ ʃʲ uː j uː
stebėti	sʲ tʲ ɛ bʲ eː tʲ ɪ
stiklas	sʲ tʲ ɪ k l ɐ s
stiprus	s̪ʲ t̪ʲ ɪ p r ʊ s̪
storas	s̪ t̪ ôː r ɐ s̪
stuburais	s t ʊ b ʊ ɾ ɐ j s
stuburas	s t ʊ b ʊ ɾ ɐ s
stubure	s t ʊ b ʊ ɾʲ ɛ
stuburo	s t ʊ b ʊ ɾ o
stuburui	s t ʊ b ʊ ɾ ʊ ɪ
stuburą	s t ʊ b ʊ ɾ aː
stuburų	s t ʊ b ʊ ɾ uː
styga	s t iː ɡ a
su	s ʊ
subręsti	s ʊ bʲ rʲ æː sʲ tʲ ɪ
sulaukti	s ʊ l a ʊ kʲ tʲ ɪ
sunaudotoja	s ʊ n ɐ ʊ d oː t o j ɛ
sunaudotojose	s ʊ n ɐ ʊ d oː t o j o sʲ ɛ
suomiška	s u ɔ mʲ ɪ ʃ k ɐ
suomiškais	s u ɔ mʲ ɪ ʃ k ɐ j s
suomiškajam	s u ɔ mʲ ɪ ʃ k ɐ j ɛ m
suomiškas	s u ɔ mʲ ɪ ʃ k ɐ s
suomiški	s u ɔ mʲ ɪ ʃʲ kʲ ɪ
suomiškoje	s u ɔ mʲ ɪ ʃ k o j ɛ
suomiškos	s u ɔ mʲ ɪ ʃ k o s
suomiškus	s u ɔ mʲ ɪ ʃ k ʊ s
suomišką	s u ɔ mʲ ɪ ʃ k aː
suprasti	s ʊ p ɾ ɐ sʲ tʲ ɪ
susiūti	s ʊ sʲ uː tʲ ɪ
sutarimo	s ʊ t ɐ ɾʲ ɪ m o
sutarimu	s ʊ t ɐ ɾʲ ɪ m ʊ
sutarimui	s ʊ t ɐ ɾʲ ɪ m ʊ ɪ
sutarimus	s ʊ t ɐ ɾʲ ɪ m ʊ s
sutarimą	s ʊ t ɐ ɾʲ ɪ m aː
sutarimų	s ʊ t ɐ ɾʲ ɪ m uː
sutrukdyti	s ʊ t ɾ ʊ kʲ dʲ iː tʲ ɪ
sušlampančia	s ʊ ʃ l ɐ m p ɐ nʲ tʲ ʃʲ ɛ
sušlampančiajame	s ʊ ʃ l ɐ m p ɐ nʲ tʲ ʃʲ ɛ j ɛ mʲ ɛ
sušlampančių	s ʊ ʃ l ɐ m p ɐ nʲ tʲ ʃʲ uː
svajones	s ʋ ɐ j o nʲ ɛ s
svajonėje	s ʋ ɐ j oː nʲ eː j ɛ
svajonėmis	s ʋ ɐ j oː nʲ eː mʲ ɪ s
svajonėms	s ʋ ɐ j oː nʲ eː m s
svajonės	s ʋ ɐ j oː nʲ eː s
svajonėse	s ʋ ɐ j oː nʲ eː sʲ ɛ
svajonę	s ʋ ɐ j oː nʲ æː
svarbus	s ʋ ɐ r b ʊ s
svastika	s ʋ aː sʲ tʲ ɪ k ɐ
svastikos	s ʋ aː sʲ tʲ ɪ k o s
svastikose	s ʋ aː sʲ tʲ ɪ k o sʲ ɛ
svastiką	s ʋ aː sʲ tʲ ɪ k aː
svastikų	s ʋ aː sʲ tʲ ɪ k uː
sviestas	s̪ʲ vʲ ɪ̂ ə s̪ t̪ ɐ s̪
sąsmauka	s aː s m ɐ ʊ k ɐ
sąveika	s aː ʋʲ ɛ j k ɐ
sąveikauti	s aː ʋʲ ɛ j k ɐ ʊ tʲ ɪ
sėdintieji	sʲ eː dʲ ɪ nʲ tʲ j ɛ j ɪ
sėdintiems	sʲ eː dʲ ɪ nʲ tʲ j ɛ m s
sėdintiesiems	sʲ eː dʲ ɪ nʲ tʲ j ɛ sʲ j ɛ m s
sėdintis	sʲ eː dʲ ɪ nʲ tʲ ɪ s
sėdintys	sʲ eː dʲ ɪ nʲ tʲ iː s
sėdintį	sʲ eː dʲ ɪ nʲ tʲ iː
sėdinčiai	sʲ eː dʲ ɪ nʲ tʲ ʃʲ ɛ j
sėdinčiais	sʲ eː dʲ ɪ nʲ tʲ ʃʲ ɛ j s
sėdinčiajame	sʲ eː dʲ ɪ nʲ tʲ ʃʲ ɛ j ɛ mʲ ɛ
sėdinčiam	sʲ eː dʲ ɪ nʲ tʲ ʃʲ ɛ m
sėdinčiame	sʲ eː dʲ ɪ nʲ tʲ ʃʲ ɛ mʲ ɛ
sėdinčio	sʲ eː dʲ ɪ nʲ tʲ ʃʲ o
sėdinčiojo	sʲ eː dʲ ɪ nʲ tʲ ʃʲ o j o
sėdinčios	sʲ eː dʲ ɪ nʲ tʲ ʃʲ o s
sėdinčiuoju	sʲ eː dʲ ɪ nʲ tʲ ʃʲ ʊ o j ʊ
sėdinčius	sʲ eː dʲ ɪ nʲ tʲ ʃʲ ʊ s
sėdinčią	sʲ eː dʲ ɪ nʲ tʲ ʃʲ æː
sėdinčių	sʲ eː dʲ ɪ nʲ tʲ ʃʲ uː
sėdinčiųjų	sʲ eː dʲ ɪ nʲ tʲ ʃʲ uː j uː
sėdėti	sʲ eː dʲ eː tʲ ɪ
sėkla	sʲ eː k l ɐ
sėklai	sʲ eː k l ɐ j
sėklas	sʲ eː k l ɐ s
sėklidė	sʲ eː kʲ lʲ ɪ dʲ eː
sėkliniai	sʲ eː kʲ lʲ ɪ nʲ ɛ j
sėkliniais	sʲ eː kʲ lʲ ɪ nʲ ɛ j s
sėklinis	sʲ eː kʲ lʲ ɪ nʲ ɪ s
sėkliniuose	sʲ eː kʲ lʲ ɪ nʲ ʊ o sʲ ɛ
sėklinius	sʲ eː kʲ lʲ ɪ nʲ ʊ s
sėklinių	sʲ eː kʲ lʲ ɪ nʲ uː
sėklinė	sʲ eː kʲ lʲ ɪ nʲ eː
sėklinėms	sʲ eː kʲ lʲ ɪ nʲ eː m s
sėklinės	sʲ eː kʲ lʲ ɪ nʲ eː s
sėklinį	sʲ eː kʲ lʲ ɪ nʲ iː
sėkloje	sʲ eː k l o j ɛ
sėklomis	sʲ eː k l o mʲ ɪ s
sėkloms	sʲ eː k l o m s
sėklos	sʲ eː k l o s
sėklą	sʲ eː k l aː
sėklų	sʲ eː k l uː
sūnus	s uː n ʊ s
taip	t ɐ j p
talka	t ɐ l k ɐ
tamsa	t a m s ɐ
taps	t ɐ p s
taria	t aː rʲ ɛ
tarimai	t ɐ ɾʲ ɪ m ɐ j
tarime	t ɐ ɾʲ ɪ mʲ ɛ
tarimo	t ɐ ɾʲ ɪ m o
tarimą	t ɐ ɾʲ ɪ m aː
tarnai	t ɐ r n ɐ j
tarnais	t ɐ r n ɐ j s
tarnams	t ɐ r n aː m s
tarne	t ɐ r nʲ ɛ
tarno	t ɐ r n o
tarnu	t ɐ r n ʊ
tarnus	t ɐ r n ʊ s
tarnų	t ɐ r n uː
tarpvietei	t ɐ ɾʲ pʲ ʋʲ i ɛ tʲ ɛ j
tarpvietė	t ɐ ɾʲ pʲ ʋʲ i ɛ tʲ e
tarpvietėje	t ɐ ɾʲ pʲ ʋʲ i ɛ tʲ e j ɛ
tarpvietės	t ɐ ɾʲ pʲ ʋʲ i ɛ tʲ e s
tarti	t ɐ r tʲ ɪ
tarė	t aː rʲ eː
tatuiravusiame	t ɐ t ʊ ɪ r aː ʋ ʊ sʲ ɛ mʲ ɛ
tatuiravusioms	t ɐ t ʊ ɪ r aː ʋ ʊ sʲ o m s
tatuiravusiu	t ɐ t ʊ ɪ r aː ʋ ʊ sʲ ʊ
tatuiravusį	t ɐ t ʊ ɪ r aː ʋ ʊ sʲ iː
tatuiravęs	t ɐ t ʊ ɪ r aː ʋʲ æ s
tatuiruojančiojoje	t ɐ t ʊ ɪ r u ɔ j ɛ nʲ tʲ ʃʲ o j o j ɛ
tatuiruotojas	t ɐ t ʊ ɪ r u ɔ t o j ɛ s
taukai	t̪ ɐ ʊ̯ˑ k ɐ ɪ̯ˑ
tavimi	t ɐ ʋʲ ɪ mʲ ɪ
tavo	t a ʋ ɔ
teigti	tʲ ɛ ɪ̯ˑ kʲ tʲ ɪ
teikti	tʲ ɛ ɪ̯ˑ kʲ tʲ ɪ
teka	tʲ æː k ɐ
tekti	t̪ʲ ɛ kʲ t̪ʲ ɪ
tekėti	tʲ ɛ kʲ êː tʲ ɪ
tiesiog	tʲ j ɛ sʲ o ɡ
tik	tʲ ɪ k
toks	t o k s
trikampis	tʲ rʲ ɪ k ɐ mʲ pʲ ɪ s
turgus	t ʊ ɾ ɡ ʊ s
turinti	t ʊ rʲ ɪ nʲ tʲ ɪ
turintiems	t ʊ rʲ ɪ nʲ tʲ j ɛ m s
turintiesiems	t ʊ rʲ ɪ nʲ tʲ j ɛ sʲ j ɛ m s
turintis	t ʊ rʲ ɪ nʲ tʲ ɪ s
turintys	t ʊ rʲ ɪ nʲ tʲ iː s
turintį	t ʊ rʲ ɪ nʲ tʲ iː
turinčia	t ʊ rʲ ɪ nʲ tʲ ʃʲ ɛ
turinčiai	t ʊ rʲ ɪ nʲ tʲ ʃʲ ɛ j
turinčiais	t ʊ rʲ ɪ nʲ tʲ ʃʲ ɛ j s
turinčiam	t ʊ rʲ ɪ nʲ tʲ ʃʲ ɛ m
turinčiame	t ʊ rʲ ɪ nʲ tʲ ʃʲ ɛ mʲ ɛ
turinčias	t ʊ rʲ ɪ nʲ tʲ ʃʲ ɛ s
turinčio	t ʊ rʲ ɪ nʲ tʲ ʃʲ o
turinčioje	t ʊ rʲ ɪ nʲ tʲ ʃʲ o j ɛ
turinčioji	t ʊ rʲ ɪ nʲ tʲ ʃʲ o j ɪ
turinčioms	t ʊ rʲ ɪ nʲ tʲ ʃʲ o m s
turinčios	t ʊ rʲ ɪ nʲ tʲ ʃʲ o s
turinčiose	t ʊ rʲ ɪ nʲ tʲ ʃʲ o sʲ ɛ
turinčiosiomis	t ʊ rʲ ɪ nʲ tʲ ʃʲ o sʲ o mʲ ɪ s
turinčiu	t ʊ rʲ ɪ nʲ tʲ ʃʲ ʊ
turinčiuose	t ʊ rʲ ɪ nʲ tʲ ʃʲ ʊ o sʲ ɛ
turinčiuosius	t ʊ rʲ ɪ nʲ tʲ ʃʲ ʊ o sʲ ʊ s
turinčius	t ʊ rʲ ɪ nʲ tʲ ʃʲ ʊ s
turinčią	t ʊ rʲ ɪ nʲ tʲ ʃʲ æː
turinčių	t ʊ rʲ ɪ nʲ tʲ ʃʲ uː
turinčiųjų	t ʊ rʲ ɪ nʲ tʲ ʃʲ uː j uː
turkija	t ʊ rʲ kʲ ɪ j ɛ
turkiška	t ʊ rʲ kʲ ɪ ʃ k ɐ
turkiškai	t ʊ rʲ kʲ ɪ ʃ k ɐ j
turkiškais	t ʊ rʲ kʲ ɪ ʃ k ɐ j s
turkiškame	t ʊ rʲ kʲ ɪ ʃ k ɐ mʲ ɛ
turkiškas	t ʊ rʲ kʲ ɪ ʃ k ɐ s
turkiški	t ʊ rʲ kʲ ɪ ʃʲ kʲ ɪ
turkiškoje	t ʊ rʲ kʲ ɪ ʃ k o j ɛ
turkiškojoje	t ʊ rʲ kʲ ɪ ʃ k o j o j ɛ
turkiškomis	t ʊ rʲ kʲ ɪ ʃ k o mʲ ɪ s
turkiškos	t ʊ rʲ kʲ ɪ ʃ k o s
turkiškose	t ʊ rʲ kʲ ɪ ʃ k o sʲ ɛ
turkišku	t ʊ rʲ kʲ ɪ ʃ k ʊ
turkiškus	t ʊ rʲ kʲ ɪ ʃ k ʊ s
turkišką	t ʊ rʲ kʲ ɪ ʃ k aː
turkiškų	t ʊ rʲ kʲ ɪ ʃ k uː
turėdama	t ʊ rʲ eː d ɐ m ɐ
turėdami	t ʊ rʲ eː d ɐ mʲ ɪ
turėdamos	t ʊ rʲ eː d ɐ m o s
turėdavusia	t ʊ rʲ eː d ɐ ʋ ʊ sʲ ɛ
turėdavusiajame	t ʊ rʲ eː d ɐ ʋ ʊ sʲ ɛ j ɛ mʲ ɛ
turėdavusioji	t ʊ rʲ eː d ɐ ʋ ʊ sʲ o j ɪ
turėdavusiosios	t ʊ rʲ eː d ɐ ʋ ʊ sʲ o sʲ o s
turėdavusiąją	t ʊ rʲ eː d ɐ ʋ ʊ sʲ æː j æː
turėdavusių	t ʊ rʲ eː d ɐ ʋ ʊ sʲ uː
turėdavę	t ʊ rʲ eː d ɐ ʋʲ æː
turėjusi	t ʊ rʲ eː j ʊ sʲ ɪ
turėjusiais	t ʊ rʲ eː j ʊ sʲ ɛ j s
turėjusiam	t ʊ rʲ eː j ʊ sʲ ɛ m
turėjusiame	t ʊ rʲ eː j ʊ sʲ ɛ mʲ ɛ
turėjusiems	t ʊ rʲ eː j ʊ sʲ j ɛ m s
turėjusioms	t ʊ rʲ eː j ʊ sʲ o m s
turėjusios	t ʊ rʲ eː j ʊ sʲ o s
turėjusiose	t ʊ rʲ eː j ʊ sʲ o sʲ ɛ
turėjusiu	t ʊ rʲ eː j ʊ sʲ ʊ
turėjusius	t ʊ rʲ eː j ʊ sʲ ʊ s
turėjusią	t ʊ rʲ eː j ʊ sʲ æː
turėjusiąsias	t ʊ rʲ eː j ʊ sʲ æː sʲ ɛ s
turėjusių	t ʊ rʲ eː j ʊ sʲ uː
turėjusiųjų	t ʊ rʲ eː j ʊ sʲ uː j uː
turėjusį	t ʊ rʲ eː j ʊ sʲ iː
turėję	t ʊ rʲ eː j æː
turėsianti	t ʊ rʲ eː sʲ ɛ nʲ tʲ ɪ
turėsiantiems	t ʊ rʲ eː sʲ ɛ nʲ tʲ j ɛ m s
turėsiančioms	t ʊ rʲ eː sʲ ɛ nʲ tʲ ʃʲ o m s
turėsiančiuosiuose	t ʊ rʲ eː sʲ ɛ nʲ tʲ ʃʲ ʊ o sʲ ʊ o sʲ ɛ
turėsiančius	t ʊ rʲ eː sʲ ɛ nʲ tʲ ʃʲ ʊ s
turėsiančių	t ʊ rʲ eː sʲ ɛ nʲ tʲ ʃʲ uː
tuščias	t̪ ʊ ʃʲ t͡ʃʲ ɛ s̪
tvarkai	t ʋ ɐ ɾ k ɐ j
tvarkas	t ʋ ɐ ɾ k ɐ s
tvarkinga	t ʋ ɐ ɾʲ kʲ ɪ n ɡ ɐ
tvarkingai	t ʋ ɐ ɾʲ kʲ ɪ n ɡ ɐ j
tvarkingais	t ʋ ɐ ɾʲ kʲ ɪ n ɡ ɐ j s
tvarkingaisiais	t ʋ ɐ ɾʲ kʲ ɪ n ɡ ɐ j sʲ ɛ j s
tvarkingajai	t ʋ ɐ ɾʲ kʲ ɪ n ɡ ɐ j ɛ j
tvarkingajam	t ʋ ɐ ɾʲ kʲ ɪ n ɡ ɐ j ɛ m
tvarkingam	t ʋ ɐ ɾʲ kʲ ɪ n ɡ ɐ m
tvarkingame	t ʋ ɐ ɾʲ kʲ ɪ n ɡ ɐ mʲ ɛ
tvarkingas	t ʋ ɐ ɾʲ kʲ ɪ n ɡ ɐ s
tvarkingesniam	t ʋ ɐ ɾʲ kʲ ɪ nʲ ɡʲ ɛ sʲ nʲ æː m
tvarkingesnioji	t ʋ ɐ ɾʲ kʲ ɪ nʲ ɡʲ ɛ sʲ nʲ oː j ɪ
tvarkingesnis	t ʋ ɐ ɾʲ kʲ ɪ nʲ ɡʲ ɛ sʲ nʲ ɪ s
tvarkingesniuosiuose	t ʋ ɐ ɾʲ kʲ ɪ nʲ ɡʲ ɛ sʲ nʲ ʊ oː sʲ ʊ o sʲ ɛ
tvarkingesnius	t ʋ ɐ ɾʲ kʲ ɪ nʲ ɡʲ ɛ sʲ nʲ ʊ s
tvarkingesniąsias	t ʋ ɐ ɾʲ kʲ ɪ nʲ ɡʲ ɛ sʲ nʲ æː sʲ ɛ s
tvarkingesnėje	t ʋ ɐ ɾʲ kʲ ɪ nʲ ɡʲ ɛ sʲ nʲ eː j ɛ
tvarkingesnįjį	t ʋ ɐ ɾʲ kʲ ɪ nʲ ɡʲ ɛ sʲ nʲ iː j iː
tvarkingi	t ʋ ɐ ɾʲ kʲ ɪ nʲ ɡʲ ɪ
tvarkingiausi	t ʋ ɐ ɾʲ kʲ ɪ nʲ ɡʲ æː ʊ sʲ ɪ
tvarkingiausias	t ʋ ɐ ɾʲ kʲ ɪ nʲ ɡʲ æː ʊ sʲ ɛ s
tvarkingiausioms	t ʋ ɐ ɾʲ kʲ ɪ nʲ ɡʲ æː ʊ sʲ o m s
tvarkingiausiose	t ʋ ɐ ɾʲ kʲ ɪ nʲ ɡʲ æː ʊ sʲ o sʲ ɛ
tvarkingiausiąsias	t ʋ ɐ ɾʲ kʲ ɪ nʲ ɡ æː ʊ sʲ æː sʲ ɛ s
tvarkingiems	t ʋ ɐ ɾʲ kʲ ɪ nʲ ɡʲ j ɛ m s
tvarkingiesiems	t ʋ ɐ ɾʲ kʲ ɪ nʲ ɡʲ j ɛ sʲ j e m s
tvarkingoje	t ʋ ɐ ɾʲ kʲ ɪ n ɡ o j ɛ
tvarkingomis	t ʋ ɐ ɾʲ kʲ ɪ n ɡ o mʲ ɪ s
tvarkingos	t ʋ ɐ ɾʲ kʲ ɪ n ɡ o s
tvarkingose	t ʋ ɐ ɾʲ kʲ ɪ n ɡ o sʲ ɛ
tvarkingu	t ʋ ɐ ɾʲ kʲ ɪ n ɡ ʊ
tvarkingumas	t ʋ ɐ rʲ kʲ ɪ n ɡ ʊ m ɐ s
tvarkingumu	t ʋ ɐ rʲ kʲ ɪ n ɡ ʊ m ʊ
tvarkinguose	t ʋ ɐ ɾʲ kʲ ɪ n ɡ ʊ o sʲ ɛ
tvarkinguosius	t ʋ ɐ ɾʲ kʲ ɪ n ɡ ʊ o sʲ ʊ s
tvarkingus	t ʋ ɐ ɾʲ kʲ ɪ n ɡ ʊ s
tvarkingą	t ʋ ɐ ɾʲ kʲ ɪ n ɡ aː
tvarkingų	t ʋ ɐ ɾʲ kʲ ɪ n ɡ uː
tvarkoje	t ʋ ɐ ɾ k o j ɛ
tvarkose	t ʋ ɐ ɾ k o sʲ ɛ
tvarką	t ʋ ɐ ɾ k aː
tvarkų	t ʋ ɐ ɾ k uː
tvartas	t̪ v äˑ r t̪ ɐ s̪
tylinti	tʲ iː lʲ ɪ nʲ tʲ ɪ
tylintieji	tʲ iː lʲ ɪ nʲ tʲ j ɛ j ɪ
tylintys	tʲ iː lʲ ɪ nʲ tʲ iː s
tylintį	tʲ iː lʲ ɪ nʲ tʲ iː
tylintįjį	tʲ iː lʲ ɪ nʲ tʲ iː j iː
tylinčiajai	tʲ iː lʲ ɪ nʲ tʲ ʃʲ ɛ j ɛ j
tylinčiuosiuose	tʲ iː lʲ ɪ nʲ tʲ ʃʲ ʊ o sʲ ʊ o sʲ ɛ
tėvas	tʲ eː v ɐ s
ugdyti	ʊ ɡʲ d̪ʲ îː t̪ʲ ɪ
ugnikalniai	ʊ ɡʲ nʲ ɪ k ɐ lʲ nʲ ɛ j
ugnikalniais	ʊ ɡʲ nʲ ɪ k ɐ lʲ nʲ ɛ j s
ugnikalniams	ʊ ɡʲ nʲ ɪ k ɐ lʲ nʲ ɛ m s
ugnikalninius	ʊ ɡʲ nʲ ɪ k ɐ lʲ nʲ ɪ nʲ ʊ s
ugnikalninių	ʊ ɡʲ nʲ ɪ k ɐ lʲ nʲ ɪ nʲ uː
ugnikalninėse	ʊ ɡʲ nʲ ɪ k ɐ lʲ nʲ ɪ nʲ eː sʲ ɛ
ugnikalnio	ʊ ɡʲ nʲ ɪ k ɐ lʲ nʲ o
ugnikalnis	ʊ ɡʲ nʲ ɪ k ɐ lʲ nʲ ɪ s
ugnikalniu	ʊ ɡʲ nʲ ɪ k ɐ lʲ nʲ ʊ
ugnikalniui	ʊ ɡʲ nʲ ɪ k ɐ lʲ nʲ ʊ ɪ
ugnikalnių	ʊ ɡʲ nʲ ɪ k ɐ lʲ nʲ uː
ugnikalnį	ʊ ɡʲ nʲ ɪ k ɐ lʲ nʲ iː
ugninga	ʊ ɡʲ nʲ ɪ n ɡ ɐ
ugningai	ʊ ɡʲ nʲ ɪ n ɡ ɐ j
ugningas	ʊ ɡʲ nʲ ɪ n ɡ ɐ s
ugningesnio	ʊ ɡʲ nʲ ɪ nʲ ɡʲ ɛ sʲ nʲ o
ugningesnis	ʊ ɡʲ nʲ ɪ nʲ ɡʲ ɛ sʲ nʲ ɪ s
ugningesnė	ʊ ɡʲ nʲ ɪ nʲ ɡʲ ɛ sʲ nʲ eː
ugningesnės	ʊ ɡʲ nʲ ɪ nʲ ɡʲ ɛ sʲ nʲ eː s
ugningesnėse	ʊ ɡʲ nʲ ɪ nʲ ɡʲ ɛ sʲ nʲ eː sʲ ɛ
ugningi	ʊ ɡʲ nʲ ɪ nʲ ɡʲ ɪ
ugningiausiai	ʊ ɡʲ nʲ ɪ nʲ ɡʲ æː ʊ sʲ ɛ j
ugningiausiajam	ʊ ɡʲ nʲ ɪ nʲ ɡʲ æː ʊ sʲ ɛ j ɛ m
ugningiausiame	ʊ ɡʲ nʲ ɪ nʲ ɡʲ æː ʊ sʲ ɛ mʲ ɛ
ugningiausiuoju	ʊ ɡʲ nʲ ɪ nʲ ɡʲ æː ʊ sʲ ʊ o j ʊ
ugningiausią	ʊ ɡʲ nʲ ɪ nʲ ɡʲ æː ʊ sʲ æː
ugningiausiąjį	ʊ ɡʲ nʲ ɪ nʲ ɡʲ æː ʊ sʲ æː j iː
ugningiausiąsias	ʊ ɡʲ nʲ ɪ nʲ ɡʲ æː ʊ sʲ æː sʲ ɛ s
ugningoms	ʊ ɡʲ nʲ ɪ n ɡ o m s
ugningos	ʊ ɡʲ nʲ ɪ n ɡ o s
ugninguose	ʊ ɡʲ nʲ ɪ n ɡ ʊ o sʲ ɛ
ugningą	ʊ ɡʲ nʲ ɪ n ɡ aː
ugningąją	ʊ ɡʲ nʲ ɪ n ɡ aː j æː
ugningų	ʊ ɡʲ nʲ ɪ n ɡ uː
ungurys	ʊ ŋ ɡ ʊ rʲ iː s̪
uodegikaulio	ʊ o dʲ ɛ ɡʲ ɪ k ɐ ʊ lʲ o
uodegikaulį	ʊ o dʲ ɛ ɡʲ ɪ k ɐ ʊ lʲ iː
uoga	û ɔ ɡ ɐ
uostai	u ɔ s t ɐ j
uostais	u ɔ s t ɐ j s
uostams	u ɔ s t ɐ m s
uostas	u ɔ s t ɐ s
uoste	u ɔ s t ɛ
uosto	u ɔ s t o
uostus	u ɔ s t ʊ s
uostų	u ɔ s t uː
upei	ʊ pʲ ɛ j
upeliai	ʊ pʲ æː lʲ ɛ j
upeliais	ʊ pʲ æː lʲ ɛ j s
upelio	ʊ pʲ æː lʲ o
upelis	ʊ pʲ æː lʲ ɪ s
upeliuose	ʊ pʲ æː lʲ ʊ o sʲ ɛ
upelius	ʊ pʲ ɛ lʲ ʊ s
upelyje	ʊ pʲ æː lʲ iː j ɛ
upelį	ʊ pʲ æː lʲ iː
upių	ʊ pʲ uː
upė	ʊ pʲ eː
upėje	ʊ pʲ eː j ɛ
upėms	ʊ pʲ eː m s
upės	ʊ pʲ eː s
upėse	ʊ pʲ eː sʲ ɛ
upėtaki	ʊ pʲ eː t ɐ kʲ ɪ
upėtakiai	ʊ pʲ eː t ɐ kʲ ɛ j
upėtakiams	ʊ pʲ eː t ɐ kʲ ɛ m s
upėtakio	ʊ pʲ eː t ɐ kʲ o
upėtakis	ʊ pʲ eː t ɐ kʲ ɪ s
upėtakiu	ʊ pʲ eː t ɐ kʲ ʊ
upėtakius	ʊ pʲ eː t ɐ kʲ ʊ s
upėtakių	ʊ pʲ eː t ɐ kʲ uː
upėtakį	ʊ pʲ eː t ɐ kʲ iː
uraganas	ʊ r ɐ ɡ aː n ɐ s
už	ʊ ʒ
užmigti	ʊ ʒʲ mʲ ɪ ɡʲ tʲ ɪ
užsimerki	ʊ ʒʲ sʲ ɪ m æ ɾʲ kʲ ɪ
užsimerkiame	ʊ ʒʲ sʲ ɪ m æ ɾʲ kʲ ɐ m ɛ
užsimerkiu	ʊ ʒʲ sʲ ɪ m æ ɾʲ kʲ ʊ
užsimerkti	ʊ ʒʲ sʲ ɪ mʲ æː rʲ kʲ tʲ ɪ
užsimerkė	ʊ ʒʲ sʲ ɪ m æ ɾʲ kʲ e
užtarimas	ʊ ʒ t ɐ ɾʲ ɪ m ɐ s
užtarimo	ʊ ʒ t ɐ ɾʲ ɪ m o
užtarimu	ʊ ʒ t ɐ ɾʲ ɪ m ʊ
užtarimui	ʊ ʒ t ɐ ɾʲ ɪ m ʊ ɪ
užtarimą	ʊ ʒ t ɐ ɾʲ ɪ m aː
užtarti	ʊ ʒ t ɐ ɾ tʲ ɪ
užtemimas	ʊ ʒʲ tʲ ɛ mʲ ɪ m ɐ s
užvakar	ʊ ʒ ʋ ɐ k ɐ ɾ
vabzdys	ʋ ɐ bʲ zʲ dʲ iː s
vaikas	v ɐ ɪ̯ˑ k ɐ s̪
vaikinas	ʋ ɐ j kʲ ɪ n ɐ s
vaisius	v a i̯ sʲ ʊ s
vaistais	ʋ aː j s t ɐ j s
vaistams	ʋ aː j s t ɐ m s
vaistas	ʋ aː j s t ɐ s
vaiste	ʋ aː j s tʲ ɛ
vaisto	ʋ aː j s t o
vaistu	ʋ aː j s t ʊ
vaistui	ʋ aː j s tʲ ʊ ɪ
vaistuose	ʋ aː j s t ʊ o sʲ ɛ
vaistą	ʋ aː j s t aː
vaistų	ʋ aː j s t uː
vaivorykštė	ʋ ɐ j ʋ oː rʲ iː kʲ ʃʲ tʲ eː
vaivorykštės	ʋ ɐ j ʋ oː rʲ iː kʲ ʃʲ tʲ eː s
vaivorykštę	ʋ ɐ j ʋ oː rʲ iː kʲ ʃʲ tʲ æː
vaivorykščių	ʋ ɐ j ʋ oː rʲ iː kʲ ʃʲ tʲ ʃʲ uː
vaizdas	ʋ ɐ j z d ɐ s
vaizdinga	ʋ ɐ j zʲ dʲ ɪ n ɡ ɐ
vaizdingai	ʋ ɐ j zʲ dʲ ɪ n ɡ ɐ j
vaizdingais	ʋ ɐ j zʲ dʲ ɪ n ɡ ɐ j s
vaizdingame	ʋ ɐ j zʲ dʲ ɪ n ɡ ɐ mʲ ɛ
vaizdingas	ʋ ɐ j zʲ dʲ ɪ n ɡ ɐ s
vaizdingesni	ʋ ɐ j zʲ dʲ ɪ nʲ ɡʲ ɛ sʲ nʲ ɪ
vaizdingesnė	ʋ ɐ j zʲ dʲ ɪ nʲ ɡʲ ɛ sʲ nʲ eː
vaizdingesnėse	ʋ ɐ j zʲ dʲ ɪ nʲ ɡʲ ɛ sʲ nʲ eː sʲ ɛ
vaizdingesnį	ʋ ɐ j zʲ dʲ ɪ nʲ ɡʲ ɛ sʲ nʲ iː
vaizdingi	ʋ ɐ j zʲ dʲ ɪ nʲ ɡʲ ɪ
vaizdingiausiai	ʋ ɐ j zʲ dʲ ɪ nʲ ɡʲ æː ʊ sʲ ɛ j
vaizdingiausiais	ʋ ɐ j zʲ dʲ ɪ nʲ ɡʲ æː ʊ sʲ ɛ j s
vaizdingiausiajame	ʋ ɐ j zʲ dʲ ɪ nʲ ɡʲ æː ʊ sʲ ɛ j ɛ mʲ ɛ
vaizdingiausias	ʋ ɐ j zʲ dʲ ɪ nʲ ɡʲ æː ʊ sʲ ɛ s
vaizdingiausiomis	ʋ ɐ j zʲ dʲ ɪ nʲ ɡʲ æː ʊ sʲ o mʲ ɪ s
vaizdingiausios	ʋ ɐ j zʲ dʲ ɪ nʲ ɡʲ æː ʊ sʲ o s
vaizdingiausiose	ʋ ɐ j zʲ dʲ ɪ nʲ ɡʲ æː ʊ sʲ o sʲ ɛ
vaizdingiausiu	ʋ ɐ j zʲ dʲ ɪ nʲ ɡʲ æː ʊ sʲ ʊ
vaizdingiausiuose	ʋ ɐ j zʲ dʲ ɪ nʲ ɡʲ æː ʊ sʲ ʊ o sʲ ɛ
vaizdingiausius	ʋ ɐ j zʲ dʲ ɪ nʲ ɡʲ æː ʊ sʲ ʊ s
vaizdingiausių	ʋ ɐ j zʲ dʲ ɪ nʲ ɡʲ æː ʊ sʲ uː
vaizdingiems	ʋ ɐ j zʲ dʲ ɪ nʲ ɡʲ j ɛ m s
vaizdingo	ʋ ɐ j zʲ dʲ ɪ n ɡ o
vaizdingoje	ʋ ɐ j zʲ dʲ ɪ n ɡ o j ɛ
vaizdingomis	ʋ ɐ j zʲ dʲ ɪ n ɡ o mʲ ɪ s
vaizdingos	ʋ ɐ j zʲ dʲ ɪ n ɡ o s
vaizdingose	ʋ ɐ j zʲ dʲ ɪ n ɡ o sʲ ɛ
vaizdingosios	ʋ ɐ j zʲ dʲ ɪ n ɡ o sʲ o s
vaizdingu	ʋ ɐ j zʲ dʲ ɪ n ɡ ʊ
vaizdingumu	ʋ ɐ j zʲ dʲ ɪ n ɡ ʊ m ʊ
vaizdingumą	ʋ ɐ j zʲ dʲ ɪ n ɡ ʊ m aː
vaizdingus	ʋ ɐ j zʲ dʲ ɪ n ɡ ʊ s
vaizdingą	ʋ ɐ j zʲ dʲ ɪ n ɡ aː
vaizdingąjį	ʋ ɐ j zʲ dʲ ɪ n ɡ aː j iː
vaizdingų	ʋ ɐ j zʲ dʲ ɪ n ɡ uː
vaizdingųjų	ʋ ɐ j zʲ dʲ ɪ n ɡ uː j uː
vaizdinis	ʋ ɐ j zʲ dʲ ɪ nʲ ɪ s
vaizdinys	ʋ ɐ j zʲ dʲ ɪ nʲ iː s
vakar	ʋ aː k ɐ ɾ
vakarai	v ɐ k ɐ r ɐ ɪ̯ˑ
vakaras	ʋ aː k ɐ r ɐ s
valdovė	ʋ ɐ l d oː ʋʲ eː
valgantieji	ʋ aː l ɡ ɐ nʲ tʲ j ɛ j ɪ
valgantiems	ʋ aː l ɡ ɐ nʲ tʲ j ɛ m s
valgantis	ʋ aː l ɡ ɐ nʲ tʲ ɪ s
valgantys	ʋ aː l ɡ ɐ nʲ tʲ iː s
valgantį	ʋ aː l ɡ ɐ nʲ tʲ iː
valgančiaisiais	ʋ aː l ɡ ɐ nʲ tʲ ʃʲ ɛ j sʲ ɛ j s
valgančiuose	ʋ aː l ɡ ɐ nʲ tʲ ʃʲ ʊ o sʲ ɛ
valgančius	ʋ aː l ɡ ɐ nʲ tʲ ʃʲ ʊ s
valgančiųjų	ʋ aː l ɡ ɐ nʲ tʲ ʃʲ uː j uː
valgyti	ʋ aː lʲ ɡʲ iː tʲ ɪ
valgytojai	ʋ aː lʲ ɡʲ iː t o j ɛ j
valgytojams	ʋ aː lʲ ɡʲ iː t o j ɛ m s
valgytoją	ʋ aː lʲ ɡʲ iː t o j æː
valstybė	ʋ ɐ lʲ sʲ tʲ iː bʲ eː
vampyras	v ɐ m p iː r ɐ s
vandenims	ʋ ɐ nʲ dʲ ɛ nʲ ɪ m s
vandenis	ʋ aː nʲ dʲ ɛ nʲ ɪ s
vandeniu	ʋ aː nʲ dʲ ɛ nʲ ʊ
vandeniui	ʋ aː nʲ dʲ ɛ nʲ ʊ ɪ
vandens	ʋ ɐ nʲ dʲ ɛ n s
vandenys	ʋ aː nʲ dʲ ɛ nʲ iː s
vandenį	ʋ aː nʲ dʲ ɛ nʲ iː
varai	v ɐ r ɐ ɪ̯ˑ
vardininkas	ʋ ɐ ɾʲ dʲ ɪ nʲ ɪ ŋ k ɐ s
varis	v ä̌ː rʲ ɪ s̪
varles	v ɐ ɾʲ lʲ ɛ s
varlių	v ɐ ɾʲ lʲ uː
varlė	ʋ ɐ ɾʲ lʲ e
varlėmis	ʋ ɐ ɾʲ lʲ e mʲ ɪ s
varlę	ʋ aː ɾʲ lʲ æ
varo	v ǎː r oː
varpa	ʋ aː ɾ p ɐ
varpai	ʋ aː ɾ p ɐ j
varpoje	ʋ aː ɾ p o j ɛ
varpomis	ʋ aː ɾ p o mʲ ɪ s
varpos	ʋ aː ɾ p o s
varputes	ʋ aː ɾ p ʊ tʲ ɛ s
varputėje	ʋ aː ɾ p ʊ tʲ eː j ɛ
varpų	ʋ aː ɾ p u
vartojanti	ʋ ɐ r t oː j ɛ nʲ tʲ ɪ
vartojantieji	ʋ ɐ r t oː j ɛ nʲ tʲ j ɛ j ɪ
vartojantis	ʋ ɐ r t oː j ɛ nʲ tʲ ɪ s
vartojančiais	ʋ ɐ r t oː j ɛ nʲ tʲ ʃʲ ɛ j s
vartojančiam	ʋ ɐ r t oː j ɛ nʲ tʲ ʃʲ ɛ m
vartojančias	ʋ ɐ r t oː j ɛ nʲ tʲ ʃʲ ɛ s
vartojančio	ʋ ɐ r t oː j ɛ nʲ tʲ ʃʲ o
vartojančioji	ʋ ɐ r t oː j ɛ nʲ tʲ ʃʲ o j ɪ
vartojančioms	ʋ ɐ r t oː j ɛ nʲ tʲ ʃʲ o m s
vartojančios	ʋ ɐ r t oː j ɛ nʲ tʲ ʃʲ o s
vartojančiu	ʋ ɐ r t oː j ɛ nʲ tʲ ʃʲ ʊ
vartojančių	ʋ ɐ r t oː j ɛ nʲ tʲ ʃʲ uː
vartojančiųjų	ʋ ɐ r t oː j ɛ nʲ tʲ ʃʲ uː j uː
vartoją	ʋ ɐ r t oː j æː
vartoti	ʋ ɐ r t oː tʲ ɪ
varyti	v ɐ rʲ îː tʲ ɪ
varžtas	v ɐ r ʃ t̪ ɐ s̪
vaškas	ʋ aː ʃ k ɐ s
veidas	ʋʲ æ j d ɐ s
veidrodis	ʋʲ æ j d ɾ o dʲ ɪ s
vengrija	ʋ ɛ nʲ ɡʲ rʲ ɪ j ɛ
vengriškai	ʋʲ ɛ nʲ ɡʲ rʲ ɪ ʃ k ɐ j
vengriškas	ʋʲ ɛ nʲ ɡʲ rʲ ɪ ʃ k ɐ s
vengriškoji	ʋʲ ɛ nʲ ɡʲ rʲ ɪ ʃ k o j ɪ
vengriškos	ʋʲ ɛ nʲ ɡʲ rʲ ɪ ʃ k o s
vengriškose	ʋʲ ɛ nʲ ɡʲ rʲ ɪ ʃ k o sʲ ɛ
vengriškosiose	ʋʲ ɛ nʲ ɡʲ rʲ ɪ ʃ k o sʲ o sʲ ɛ
vengrišką	ʋʲ ɛ nʲ ɡʲ rʲ ɪ ʃ k aː
vengriškųjų	ʋʲ ɛ nʲ ɡʲ rʲ ɪ ʃ k uː j uː
vesti	vʲ ɛ sʲ tʲ ɪ
vieta	vʲ ɪ ə t̪ ɐ
vietininkai	ʋʲ j ɛ tʲ ɪ nʲ ɪ n k ɐ j
vietininkais	ʋʲ j ɛ tʲ ɪ nʲ ɪ n k ɐ j s
vietininkas	ʋʲ j ɛ tʲ ɪ nʲ ɪ n k ɐ s
vietininko	ʋʲ j ɛ tʲ ɪ nʲ ɪ n k o
vietininku	ʋʲ j ɛ tʲ ɪ nʲ ɪ n k ʊ
vietininkus	ʋʲ j ɛ tʲ ɪ nʲ ɪ n k ʊ s
vietininką	ʋʲ j ɛ tʲ ɪ nʲ ɪ n k aː
vilkai	ʋʲ ɪ l k ɐ j
vilkais	ʋʲ ɪ l k ɐ j s
vilkas	ʋʲ ɪ l k ɐ s
vilke	ʋʲ ɪ lʲ kʲ ɛ
vilko	ʋʲ ɪ l k o
vilkti	vʲ ɪ lʲ kʲ tʲ ɪ
vilku	ʋʲ ɪ l k ʊ
vilkui	ʋʲ ɪ l k ʊ ɪ
vilkus	ʋʲ ɪ l k ʊ s
vilkų	ʋʲ ɪ l k uː
vinis	vʲ ɪ nʲ ɪ s̪
visuomenė	v ɪ s u ɔ m ɛ n eː
vištai	ʋʲ ɪ ʃ t ɐ j
vištas	ʋʲ ɪ ʃ t ɐ s
vištoms	ʋʲ ɪ ʃ t o m s
vištos	ʋʲ ɪ ʃ t o s
vištą	ʋʲ ɪ ʃ t aː
vištų	ʋʲ ɪ ʃ t uː
vokietes	ʋ oː kʲ j ɛ tʲ ɛ s
vokietis	ʋ oː kʲ j ɛ tʲ ɪ s
vokietė	ʋ oː kʲ j ɛ tʲ eː
vokietėje	ʋ oː kʲ j ɛ tʲ eː j ɛ
vokietėmis	ʋ oː kʲ j ɛ tʲ eː mʲ ɪ s
vokietį	ʋ oː kʲ j ɛ tʲ iː
vokiečiai	ʋ oː kʲ j ɛ tʲ ʃʲ ɛ j
vokiečiais	ʋ oː kʲ j ɛ tʲ ʃʲ ɛ j s
vokiečiams	ʋ oː kʲ j ɛ tʲ ʃʲ ɛ m s
vokiečio	ʋ oː kʲ j ɛ tʲ ʃʲ o
vokiečiu	ʋ oː kʲ j ɛ tʲ ʃʲ ʊ
vokiečiui	ʋ oː kʲ j ɛ tʲ ʃʲ ʊ ɪ
vokiečiuose	ʋ oː kʲ j ɛ tʲ ʃʲ ʊ o sʲ ɛ
vokiečius	ʋ oː kʲ j ɛ tʲ ʃʲ ʊ s
vokiečių	ʋ oː kʲ j ɛ tʲ ʃʲ uː
vokiška	ʋ oː kʲ ɪ ʃ k ɐ
vokiškai	ʋ oː kʲ ɪ ʃ k ɐ j
vokiškais	ʋ oː kʲ ɪ ʃ k ɐ j s
vokiškajai	ʋ oː kʲ ɪ ʃ k ɐ j ɛ j
vokiškam	ʋ oː kʲ ɪ ʃ k ɐ m
vokiškame	ʋ oː kʲ ɪ ʃ k ɐ mʲ ɛ
vokiškas	ʋ oː kʲ ɪ ʃ k ɐ s
vokiškasis	ʋ oː kʲ ɪ ʃ k ɐ sʲ ɪ s
vokiški	ʋ oː kʲ ɪ ʃʲ kʲ ɪ
vokiškiems	ʋ oː kʲ ɪ ʃʲ kʲ j ɛ m s
vokiško	ʋ oː kʲ ɪ ʃ k o
vokiškojo	ʋ oː kʲ ɪ ʃ k o j o
vokiškomis	ʋ oː kʲ ɪ ʃ k o mʲ ɪ s
vokiškoms	ʋ oː kʲ ɪ ʃ k o m s
vokiškos	ʋ oː kʲ ɪ ʃ k o s
vokiškose	ʋ oː kʲ ɪ ʃ k o sʲ ɛ
vokiškosios	ʋ oː kʲ ɪ ʃ k o sʲ o s
vokiškosiose	ʋ oː kʲ ɪ ʃ k o sʲ o sʲ ɛ
vokišku	ʋ oː kʲ ɪ ʃ k ʊ
vokiškus	ʋ oː kʲ ɪ ʃ k ʊ s
vokišką	ʋ oː kʲ ɪ ʃ k aː
vokiškąjį	ʋ oː kʲ ɪ ʃ k aː j iː
vokiškų	ʋ oː kʲ ɪ ʃ k uː
vokiškųjų	ʋ oː kʲ ɪ ʃ k uː j uː
vorai	ʋ ɔ ɾ ɐ j
vorams	ʋ ɔ ɾ a m s
voro	ʋ o r ɔ
voru	ʋ o r ʊ
vorui	ʋ o ɾ ʊ ɪ
vorus	ʋ o r ʊ s
vorų	ʋ ɔ ɾ u
vos	v o s
vovere	ʋ oː ʋʲ ɛ ɾʲ ɛ
voveres	ʋ oː ʋʲ ɛ ɾʲ ɛ s
voverių	ʋ o ʋʲ ɛ ɾʲ uː
voverė	ʋ o ʋʲ ɛ ɾʲ eː
voverėse	ʋ o ʋʲ ɛ ɾʲ eː sʲ ɛ
vyras	ʋʲ iː r ɐ s
vyriškas	ʋ iː ɾ ɪ ʃ k ɐ s
vyriškumas	ʋʲ iː ɾʲ ɪ ʃ k ʊ m ɐ s
vystyti	ʋ iː s t iː t ɪ
vėjas	ʋʲ eː j ɛ s
ydingas	iː dʲ ɪ n ɡ ɐ s
yla	îː l ɐ
ypatingaisiais	iː p ɐ tʲ ɪ n ɡ ɐ j sʲ ɛ j s
ypatingajai	iː p ɐ tʲ ɪ n ɡ ɐ j ɛ j
ypatingajame	iː p ɐ tʲ ɪ n ɡ ɐ j ɛ mʲ ɛ
ypatingasis	iː p ɐ tʲ ɪ n ɡ ɐ sʲ ɪ s
ypatingesniojoje	iː p ɐ tʲ ɪ nʲ ɡʲ ɛ sʲ nʲ oː j o j ɛ
ypatingiausiosiomis	iː p ɐ tʲ ɪ nʲ ɡʲ æː ʊ sʲ o sʲ o mʲ ɪ s
ypatingiausiuosiuose	iː p ɐ tʲ ɪ nʲ ɡʲ æː ʊ sʲ ʊ o sʲ ʊ o sʲ ɛ
ypatingieji	iː p ɐ tʲ ɪ nʲ ɡʲ j ɛ j ɪ
ypatingoji	iː p ɐ tʲ ɪ n ɡ o j ɪ
ypatingojo	iː p ɐ tʲ ɪ n ɡ o j o
ypatingosiomis	iː p ɐ tʲ ɪ n ɡ o sʲ o mʲ ɪ s
ypatingosios	iː p ɐ tʲ ɪ n ɡ o sʲ o s
ypatingumas	iː p ɐ tʲ ɪ ŋ ɡ ʊ m ɐ s
ypatinguoju	iː p ɐ tʲ ɪ n ɡ ʊ o j ʊ
ypatingąją	iː p ɐ tʲ ɪ n ɡ aː j æː
ypatingąsias	iː p ɐ tʲ ɪ n ɡ aː sʲ ɛ s
ypatingųjų	iː p ɐ tʲ ɪ n ɡ uː j uː
ypatumas	iː p ɐ t ʊ m ɐ s
ypatybė	iː p ɐ tʲ iː bʲ eː
ypač	iː p ɐ t ʃ
yra	i r ɐ
ąžuolais	aː ʒ ʊ ɔ ɫ ɐ j s
ąžuolams	aː ʒ ʊ ɔ ɫ aː m s
ąžuolas	ä̂ː ʒ ʊ ə ɫ ɐ s̪
ąžuole	aː ʒ ʊ ɔ lʲ ɛ
ąžuolui	aː ʒ ʊ ɔ ɫ ʊ j
ąžuoluose	aː ʒ ʊ ɔ ɫ ʊ o sʲ ɛ
ąžuolus	aː ʒ ʊ ɔ ɫ ʊ s
ąžuolą	aː ʒ ʊ ɔ ɫ aː
čekija	tʲ ʃʲ ɛ kʲ ɪ j ɛ
čekijos	tʲ ʃʲ ɛ kʲ ɪ j o s
čekiją	tʲ ʃʲ ɛ kʲ ɪ j æː
čekiškieji	tʲ ʃʲ ɛ kʲ ɪ ʃʲ kʲ j ɛ j ɪ
čekiškojo	tʲ ʃʲ ɛ kʲ ɪ ʃ k o j o
čekiškąjį	tʲ ʃʲ ɛ kʲ ɪ ʃ k aː j iː
čia	t ʃʲ ɛ
čiulpti	tʲ ʃʲ ʊ lʲ pʲ tʲ ɪ
įbrolis	iː b r o lʲ ɪ s
įdavėjas	iː d ɐ ʋʲ eː j ɛ s
įdomesnei	iː d o mʲ ɛ sʲ nʲ ɛ j
įdomesni	iː d o mʲ ɛ sʲ nʲ ɪ
įdomesniais	iː d o mʲ ɛ sʲ nʲ ɛ j s
įdomesnio	iː d o mʲ ɛ sʲ nʲ o
įdomesnis	iː d o mʲ ɛ sʲ nʲ ɪ s
įdomesniu	iː d o mʲ ɛ sʲ nʲ ʊ
įdomesnių	iː d o mʲ ɛ sʲ nʲ uː
įdomesnė	iː d o mʲ ɛ sʲ nʲ eː
įdomesnėje	iː d o mʲ ɛ sʲ nʲ eː j ɛ
įdomesnėmis	iː d o mʲ ɛ sʲ nʲ eː mʲ ɪ s
įdomesnės	iː d o mʲ ɛ sʲ nʲ eː s
įdomesnėse	iː d o mʲ ɛ sʲ nʲ eː sʲ ɛ
įdomesnę	iː d o mʲ ɛ sʲ nʲ æː
įdomesnį	iː d o mʲ ɛ sʲ nʲ iː
įdomiai	iː d oː m ɛ j
įdomiais	iː d o mʲ ɛ j s
įdomiam	iː d o mʲ æː m
įdomiame	iː d o mʲ ɛ mʲ ɛ
įdomias	iː d o mʲ ɛ s
įdomiems	iː d o mʲ j ɛ m s
įdomioje	iː d o mʲ o j ɛ
įdomiomis	iː d o mʲ o mʲ ɪ s
įdomioms	iː d o mʲ oː m s
įdomiu	iː d o mʲ ʊ
įdomiuose	iː d o mʲ ʊ o sʲ ɛ
įdomius	iː d o mʲ ʊ s
įdomią	iː d oː mʲ æː
įdomių	iː d o mʲ uː
įdomu	iː d o m ʊ
įdomus	iː d o m ʊ s
įdomūs	iː d oː m uː s
įdomų	iː d oː m uː
įduodantiesiems	iː d u ɔ d ɐ nʲ tʲ j ɛ sʲ j ɛ m s
įduodančioje	iː d u ɔ d ɐ nʲ tʲ ʃʲ o j ɛ
įduosiančius	iː d u ɔ sʲ ɛ nʲ tʲ ʃʲ ʊ s
įduosiančiąsias	iː d u ɔ sʲ ɛ nʲ tʲ ʃʲ æː sʲ ɛ s
įduosią	iː d u ɔ sʲ æː
įkalbėti	iː k ɐ lʲ bʲ eː tʲ ɪ
įkeliaujančio	iː kʲ ɛ lʲ æ ʊ j ɛ nʲ tʲ ʃʲ o
įkeliaujančiojoje	iː kʲ ɛ lʲ æ ʊ j ɛ nʲ tʲ ʃʲ o j o j ɛ
įkeliaujančioms	iː kʲ ɛ lʲ æ ʊ j ɛ nʲ tʲ ʃʲ o m s
įkeliaujančiosios	iː kʲ ɛ lʲ æ ʊ j ɛ nʲ tʲ ʃʲ o sʲ o s
įmonė	îː m oː n̪ʲ eː
įnagininko	iː n ɐ ɡʲ ɪ nʲ ɪ n k o
įnagininką	iː n ɐ ɡʲ ɪ nʲ ɪ n k aː
įrankis	îː r ɐ ŋʲ kʲ ɪ s̪
įsakyti	iː s̪ ɐ kʲ îː t̪ʲ ɪ
įsesere	iː sʲ ɛ sʲ ɛ rʲ ɛ
įseserei	iː sʲ ɛ sʲ ɛ rʲ ɛ j
įseserę	iː sʲ ɛ sʲ ɛ rʲ æː
įsigalėti	iː sʲ ɪ ɡ ɐ lʲ eː tʲ ɪ
įsiklausyti	iː sʲ ɪ k l ɐ u sʲ iː tʲ ɪ
įsiūti	iː sʲ uː tʲ ɪ
įspūdinga	iː s p uː dʲ ɪ n ɡ ɐ
įspūdingai	iː s p uː dʲ ɪ n ɡ ɐ j
įspūdingais	iː s p uː dʲ ɪ n ɡ ɐ j s
įspūdingam	iː s p uː dʲ ɪ n ɡ ɐ m
įspūdingame	iː s p uː dʲ ɪ n ɡ ɐ mʲ ɛ
įspūdingas	iː s p uː dʲ ɪ n ɡ ɐ s
įspūdingesni	iː s p uː dʲ ɪ nʲ ɡʲ ɛ sʲ nʲ ɪ
įspūdingesnieji	iː s p uː dʲ ɪ nʲ ɡʲ ɛ sʲ nʲ j ɛ j ɪ
įspūdingesnio	iː s p uː dʲ ɪ nʲ ɡʲ ɛ sʲ nʲ o
įspūdingesnis	iː s p uː dʲ ɪ nʲ ɡʲ ɛ sʲ nʲ ɪ s
įspūdingesniu	iː s p uː dʲ ɪ nʲ ɡʲ ɛ sʲ nʲ ʊ
įspūdingesnius	iː s p uː dʲ ɪ nʲ ɡʲ ɛ sʲ nʲ ʊ s
įspūdingesnių	iː s p uː dʲ ɪ nʲ ɡʲ ɛ sʲ nʲ uː
įspūdingesnė	iː s p uː dʲ ɪ nʲ ɡʲ ɛ sʲ nʲ eː
įspūdingesnėms	iː s p uː dʲ ɪ nʲ ɡʲ ɛ sʲ nʲ eː m s
įspūdingesnėse	iː s p uː dʲ ɪ nʲ ɡʲ ɛ sʲ nʲ eː sʲ ɛ
įspūdingesnę	iː s p uː dʲ ɪ nʲ ɡʲ ɛ sʲ nʲ æː
įspūdingi	iː s p uː dʲ ɪ nʲ ɡʲ ɪ
įspūdingiausi	iː s p uː dʲ ɪ nʲ ɡʲ æː ʊ sʲ ɪ
įspūdingiausia	iː s p uː dʲ ɪ nʲ ɡʲ æː ʊ sʲ ɛ
įspūdingiausiai	iː s p uː dʲ ɪ nʲ ɡʲ æː ʊ sʲ ɛ j
įspūdingiausias	iː s p uː dʲ ɪ nʲ ɡʲ æː ʊ sʲ ɛ s
įspūdingiausios	iː s p uː dʲ ɪ nʲ ɡʲ æː ʊ sʲ o s
įspūdingiausiuosius	iː s p uː dʲ ɪ nʲ ɡʲ æː ʊ sʲ ʊ o sʲ ʊ s
įspūdingiausius	iː s p uː dʲ ɪ nʲ ɡʲ æː ʊ sʲ ʊ s
įspūdingiausių	iː s p uː dʲ ɪ nʲ ɡʲ æː ʊ sʲ uː
įspūdingo	iː s p uː dʲ ɪ n ɡ o
įspūdingoje	iː s p uː dʲ ɪ n ɡ o j ɛ
įspūdingomis	iː s p uː dʲ ɪ n ɡ o mʲ ɪ s
įspūdingos	iː s p uː dʲ ɪ n ɡ o s
įspūdingose	iː s p uː dʲ ɪ n ɡ o sʲ ɛ
įspūdingu	iː s p uː dʲ ɪ n ɡ ʊ
įspūdingumams	iː s p uː dʲ ɪ n ɡ ʊ m ɐ m s
įspūdingumo	iː s p uː dʲ ɪ n ɡ ʊ m o
įspūdingumu	iː s p uː dʲ ɪ n ɡ ʊ m ʊ
įspūdingumus	iː s p uː dʲ ɪ n ɡ ʊ m ʊ s
įspūdingus	iː s p uː dʲ ɪ n ɡ ʊ s
įspūdingą	iː s p uː dʲ ɪ n ɡ aː
įspūdingų	iː s p uː dʲ ɪ n ɡ uː
įtarimai	iː t ɐ ɾʲ ɪ m ɐ j
įtarimais	iː t ɐ ɾʲ ɪ m ɐ j s
įtarimams	iː t ɐ ɾʲ ɪ m ɐ m s
įtarimas	i t ɐ ɾʲ ɪ m ɐ s
įtarimo	iː t ɐ ɾʲ ɪ m o
įtarimu	iː t ɐ ɾʲ ɪ m ʊ
įtarimui	iː t ɐ ɾʲ ɪ m ʊ ɪ
įtarimus	iː t ɐ ɾʲ ɪ m ʊ s
įtarimą	iː t ɐ ɾʲ ɪ m aː
įtarti	i t ɐ ɾ tʲ ɪ
įvardis	iː ʋ ɐ ɾʲ dʲ ɪ s
įvykiais	iː ʋʲ iː kʲ ɛ j s
įvykio	iː ʋʲ iː kʲ o
įvykis	iː ʋʲ iː kʲ ɪ s
įvykiu	iː ʋʲ iː kʲ ʊ
įvykiui	iː ʋʲ iː kʲ ʊ ɪ
įvykiuose	iː ʋʲ iː kʲ ʊ o sʲ ɛ
įvykius	iː ʋʲ iː kʲ ʊ s
įvykių	iː ʋʲ iː kʲ uː
įvykyje	iː ʋʲ iː kʲ iː j ɛ
šaka	ʃ ɐ k ɐ
šakai	ʃ aː k ɐ j
šakalai	ʃ ɐ k aː l ɐ j
šakalams	ʃ ɐ k aː l ɐ m s
šakalus	ʃ ɐ k ɐ l ʊ s
šakalą	ʃ ɐ k aː l aː
šakalų	ʃ ɐ k aː l uː
šakas	ʃ ɐ k ɐ s
šaknis	ʃ ɐ kʲ n̪ʲ ɪ s̪
šakoje	ʃ ɐ k o j ɛ
šakoms	ʃ ɐ k oː m s
šakose	ʃ ɐ k o sʲ ɛ
šaką	ʃ aː k aː
šakų	ʃ ɐ k uː
šalina	ʃ ä̌ː lʲ ɪ n̪ ɐ
šalis	ʃ ɐ lʲ ɪ s
šarvas	ʃ a ɾ v ɐ s
šašas	ʃ ä̌ː ʃ ɐ s̪
šeškai	ʃʲ ɛ ʃ k ɐ j
šeškais	ʃʲ ɛ ʃ k ɐ j s
šeškams	ʃʲ ɛ ʃ k aː m s
šeškas	ʃʲ æː ʃ k ɐ s
šeško	ʃʲ æː ʃ k o
šeškui	ʃʲ æː ʃ k ʊ ɪ
šeškuose	ʃʲ ɛ ʃ k ʊ o sʲ ɛ
šeškus	ʃʲ ɛ ʃ k ʊ s
šešką	ʃʲ æː ʃ k aː
šeškų	ʃʲ ɛ ʃ k uː
šiaurė	ʃʲ ä̂ˑ ʊ̯ rʲ eː
šikna	ʃʲ ɪ k n ɐ
šiknai	ʃʲ ɪ k n ɐ j
šiknalaižis	ʃʲ ɪ k n ɐ l ɐ j ʒʲ ɪ s
šiknalaižyje	ʃʲ ɪ k n ɐ l ɐ j ʒʲ iː j ɛ
šiknalaižė	ʃʲ ɪ k n ɐ l ɐ j ʒʲ eː
šiknalaižės	ʃʲ ɪ k n ɐ l ɐ j ʒʲ eː s
šiknalaižėse	ʃʲ ɪ k n ɐ l ɐ j ʒʲ eː sʲ ɛ
šiknaranke	ʃʲ ɪ k n ɐ ɾ ɐ nʲ kʲ ɛ
šiknarankei	ʃʲ ɪ k n ɐ ɾ ɐ nʲ kʲ ɛ j
šiknas	ʃʲ ɪ k n ɐ s
šilas	ʃʲ ɪ ɫ ɐ s̪
šilkai	ʃʲ ɪ l k ɐ j
šilkais	ʃʲ ɪ l k ɐ j s
šilkas	ʃʲ ɪ l k ɐ s
šilko	ʃʲ ɪ l k o
šilku	ʃʲ ɪ l k ʊ
šilkui	ʃʲ ɪ l k ʊ ɪ
šilką	ʃʲ ɪ l k aː
širdis	ʃʲ ɪ rʲ dʲ ɪ s
šizofrenija	ʃʲ ɪ z o fʲ rʲ ɛ nʲ ɪ j ɛ
škotiškas	ʃ kʲ ɔʲ tʲ ɪ ʃ k ɐ s
šlapimas	ʃ l ɐ pʲ ɪ m ɐ s
šlaplė	ʃ l ɐ p l eː
šluota	ʃ l û ə t̪ ɐ
šmėkla	ʃʲ mʲ eː k l ɐ
šokame	ʃ oː k ɐ mʲ ɛ
šokantis	ʃ oː k ɐ nʲ tʲ ɪ s
šokantys	ʃ oː k ɐ nʲ tʲ iː s
šokančiame	ʃ oː k ɐ nʲ tʲ ʃʲ ɛ mʲ ɛ
šokančio	ʃ oː k ɐ nʲ tʲ ʃʲ o
šokančiomis	ʃ oː k ɐ nʲ tʲ ʃʲ o mʲ ɪ s
šokančios	ʃ oː k ɐ nʲ tʲ ʃʲ o s
šokančiuosiuose	ʃ oː k ɐ nʲ tʲ ʃʲ ʊ o sʲ ʊ o sʲ ɛ
šokančią	ʃ oː k ɐ nʲ tʲ ʃʲ æː
šokančiąsias	ʃ oː k ɐ nʲ tʲ ʃʲ æː sʲ ɛ s
šokančių	ʃ oː k ɐ nʲ tʲ ʃʲ uː
šokančiųjų	ʃ oː k ɐ nʲ tʲ ʃʲ uː j uː
šokau	ʃ oː k ɐ ʊ
šoki	ʃ oː kʲ ɪ
šoko	ʃ oː k o
šokome	ʃ oː k o mʲ ɛ
šoks	ʃ oː k s
šoksime	ʃ oː kʲ sʲ ɪ mʲ ɛ
šoksite	ʃ oː kʲ sʲ ɪ tʲ ɛ
šoktumėte	ʃ oː k t ʊ mʲ eː tʲ ɛ
šoku	ʃ oː k ʊ
šokusi	ʃ oː k ʊ sʲ ɪ
šokusiems	ʃ oː k ʊ sʲ j ɛ m s
šokusiojo	ʃ oː k ʊ sʲ o j o
šokusiųjų	ʃ oː k ʊ sʲ uː j uː
šoką	ʃ oː k aː
šokčiau	ʃ oː kʲ tʲ ʃʲ ɛ ʊ
šokęs	ʃ oː kʲ æː s
šonas	ʃ ôː n̪ ɐ s̪
šunys	ʃ ʊ n iː s
švarus	ʃ v ä̌ː r ʊ s̪
švediškaisiais	ʃʲ ʋʲ ɛ dʲ ɪ ʃ k ɐ j sʲ ɛ j s
švediškasis	ʃʲ ʋʲ ɛ dʲ ɪ ʃ k ɐ sʲ ɪ s
švediškąja	ʃʲ ʋʲ ɛ dʲ ɪ ʃ k aː j ɛ
švelnaus	ʃʲ ʋʲ ɛ l n ɐ u s
švelnesne	ʃʲ ʋʲ ɛ l nʲ ɛ sʲ nʲ ɛ
švelnesnes	ʃʲ ʋʲ ɛ l nʲ ɛ sʲ nʲ ɛ s
švelnesni	ʃʲ ʋʲ ɛ l nʲ ɛ sʲ nʲ ɪ
švelnesniais	ʃʲ ʋʲ ɛ l nʲ ɛ sʲ nʲ ɛ j s
švelnesnio	ʃʲ ʋʲ ɛ l nʲ ɛ sʲ nʲ o
švelnesnis	ʃʲ ʋʲ ɛ l nʲ ɛ sʲ nʲ ɪ s
švelnesnius	ʃʲ ʋʲ ɛ l nʲ ɛ sʲ nʲ ʊ s
švelnesniąją	ʃʲ ʋʲ ɛ lʲ nʲ ɛ sʲ nʲ æː j æː
švelnesnių	ʃʲ ʋʲ ɛ l nʲ ɛ sʲ nʲ uː
švelnesniųjų	ʃʲ ʋʲ ɛ lʲ nʲ ɛ sʲ nʲ uː j uː
švelnesnė	ʃʲ ʋʲ ɛ l nʲ ɛ sʲ nʲ eː
švelnesnėms	ʃʲ ʋʲ ɛ l nʲ ɛ sʲ nʲ eː m s
švelnesnės	ʃʲ ʋʲ ɛ l nʲ ɛ sʲ nʲ eː s
švelnesnę	ʃʲ ʋʲ ɛ l nʲ ɛ sʲ nʲ æː
švelnesnį	ʃʲ ʋʲ ɛ l nʲ ɛ sʲ nʲ iː
švelni	ʃʲ ʋʲ ɛ l nʲ ɪ
švelnia	ʃʲ ʋʲ ɛ l nʲ ɛ
švelniai	ʃʲ ʋʲ ɛ l nʲ ɛ j
švelniais	ʃʲ ʋʲ ɛ l nʲ ɛ j s
švelniam	ʃʲ ʋʲ ɛ l nʲ æː m
švelniame	ʃʲ ʋʲ ɛ l nʲ ɛ mʲ ɛ
švelnias	ʃʲ ʋʲ ɛ l nʲ ɛ s
švelniausia	ʃʲ ʋʲ ɛ l nʲ æː ʊ sʲ ɛ
švelniausiais	ʃʲ ʋʲ ɛ l nʲ æː ʊ sʲ ɛ j s
švelniausiame	ʃʲ ʋʲ ɛ l nʲ æː ʊ sʲ ɛ mʲ ɛ
švelniausias	ʃʲ ʋʲ ɛ l nʲ æː ʊ sʲ ɛ s
švelniausio	ʃʲ ʋʲ ɛ l nʲ æː ʊ sʲ o
švelniausiosiomis	ʃʲ ʋʲ ɛ l nʲ æː ʊ sʲ o sʲ o mʲ ɪ s
švelniausius	ʃʲ ʋʲ ɛ l nʲ æː ʊ sʲ ʊ s
švelniems	ʃʲ ʋʲ ɛ l nʲ j ɛ m s
švelnioje	ʃʲ ʋʲ ɛ l nʲ o j ɛ
švelnioji	ʃʲ ʋʲ ɛ l nʲ oː j ɪ
švelniojo	ʃʲ ʋʲ ɛ l nʲ o j o
švelniomis	ʃʲ ʋʲ ɛ l nʲ o mʲ ɪ s
švelnioms	ʃʲ ʋʲ ɛ l nʲ oː m s
švelniosiomis	ʃʲ ʋʲ ɛ l nʲ oː sʲ o mʲ ɪ s
švelniu	ʃʲ ʋʲ ɛ l nʲ ʊ
švelniuose	ʃʲ ʋʲ ɛ l nʲ ʊ o sʲ ɛ
švelnius	ʃʲ ʋʲ ɛ l nʲ ʊ s
švelnią	ʃʲ ʋʲ ɛ l nʲ æː
švelniąją	ʃʲ ʋʲ ɛ l nʲ æː j æː
švelniąsias	ʃʲ ʋʲ ɛ l nʲ æː sʲ ɛ s
švelnių	ʃʲ ʋʲ ɛ l nʲ uː
švelniųjų	ʃʲ ʋʲ ɛ l nʲ uː j uː
švelnus	ʃʲ ʋʲ ɛ l n ʊ s
švelnūs	ʃʲ ʋʲ ɛ l n uː s
švelnų	ʃʲ ʋʲ ɛ l n uː
šviesa	ʃʲ ʋʲ j ɛ s ɐ
šviesus	ʃʲ vʲ ɪ ə s̪ ʊ s̪
šykštus	ʃʲ iː k ʃ t̪ ʊ s̪
šypsena	ʃʲ iː pʲ sʲ ɛ n ɐ
šypsenas	ʃʲ iː pʲ sʲ ɛ n ɐ s
šypsenomis	ʃʲ iː pʲ sʲ ɛ n o mʲ ɪ s
šypsenos	ʃʲ iː pʲ sʲ ɛ n o s
šypsotis	ʃʲ iː p s ôː tʲ ɪ s
ūkai	uː k ɐ j
ūkais	uː k ɐ j s
ūkui	uː k ʊ ɪ
ūką	uː k aː
žaidimas	ʒ ɐ ɪ d i m ɐ s
žaidė	ʒ ɐ j dʲ eː
žaidžia	ʒ ɐ j dʲ ʒʲ ɐ
žais	ʒ ɐ j s
žaisti	ʒ ɐ j sʲ tʲ ɪ
žaistų	ʒ ɐ j s t u
žaizda	ʒ ɐ ɪ̯ˑ z̪ d̪ ɐ
žavus	ʒ ɐ ʋ ʊ s
žebenkštis	ʒʲ ɛ bʲ ɛ ŋ kʲ ʃʲ tʲ ɪ s
žemaite	ʒʲ ɛ m ɐ j tʲ ɛ
žemaitei	ʒʲ ɛ m ɐ j tʲ ɛ j
žemaiti	ʒʲ ɛ m ɐ j tʲ ɪ
žemaitis	ʒʲ ɛ m ɐ j tʲ ɪ s
žemaitiška	ʒʲ ɛ m ɐ j tʲ ɪ ʃ k ɐ
žemaitiškai	ʒʲ ɛ m ɐ j tʲ ɪ ʃ k ɐ j
žemaitiškaisiais	ʒʲ ɛ m ɐ j tʲ ɪ ʃ k ɐ j sʲ ɛ j s
žemaitiškam	ʒʲ ɛ m ɐ j tʲ ɪ ʃ k ɐ m
žemaitiškas	ʒʲ ɛ m ɐ j tʲ ɪ ʃ k ɐ s
žemaitiškieji	ʒʲ ɛ m ɐ j tʲ ɪ ʃʲ kʲ j ɛ j ɪ
žemaitiško	ʒʲ ɛ m ɐ j tʲ ɪ ʃ k o
žemaitiškoje	ʒʲ ɛ m ɐ j tʲ ɪ ʃ k o j ɛ
žemaitiškoms	ʒʲ ɛ m ɐ j tʲ ɪ ʃ k o m s
žemaitiškos	ʒʲ ɛ m ɐ j tʲ ɪ ʃ k o s
žemaitiškose	ʒʲ ɛ m ɐ j tʲ ɪ ʃ k o sʲ ɛ
žemaitišku	ʒʲ ɛ m ɐ j tʲ ɪ ʃ k ʊ
žemaitiškuosiuose	ʒʲ ɛ m ɐ j tʲ ɪ ʃ k ʊ o sʲ ʊ o sʲ ɛ
žemaitiškus	ʒʲ ɛ m ɐ j tʲ ɪ ʃ k ʊ s
žemaitišką	ʒʲ ɛ m ɐ j tʲ ɪ ʃ k aː
žemaitiškąja	ʒʲ ɛ m ɐ j tʲ ɪ ʃ k aː j ɛ
žemaitiškų	ʒʲ ɛ m ɐ j tʲ ɪ ʃ k uː
žemaityje	ʒʲ ɛ m ɐ j tʲ iː j ɛ
žemaitė	ʒʲ ɛ m ɐ j tʲ eː
žemaitėmis	ʒʲ ɛ m ɐ j tʲ eː mʲ ɪ s
žemaitės	ʒʲ ɛ m ɐ j tʲ eː s
žemaitę	ʒʲ ɛ m ɐ j tʲ æː
žemaičiai	ʒʲ ɛ m ɐ j tʲ ʃʲ ɛ j
žemaičiams	ʒʲ ɛ m ɐ j tʲ ʃʲ ɛ m s
žemaičio	ʒʲ ɛ m ɐ j tʲ ʃʲ o
žemaičiui	ʒʲ ɛ m ɐ j tʲ ʃʲ ʊ ɪ
žemaičiuose	ʒʲ ɛ m ɐ j tʲ ʃʲ ʊ o sʲ ɛ
žemaičius	ʒʲ ɛ m ɐ j tʲ ʃʲ ʊ s
žemaičių	ʒʲ ɛ m ɐ j tʲ ʃʲ uː
žemynas	ʒʲ ɛ mʲ iː n ɐ s
žemyno	ʒʲ ɛ mʲ iː n o
žemynui	ʒʲ ɛ mʲ iː n ʊ ɪ
žemynus	ʒʲ ɛ mʲ iː n ʊ s
žemyną	ʒʲ ɛ mʲ iː n aː
žemynų	ʒʲ ɛ mʲ iː n uː
žiedynai	ʒʲ j ɛ dʲ iː n ɐ j
žiedynais	ʒʲ j ɛ dʲ iː n ɐ j s
žiedynas	ʒʲ j ɛ dʲ iː n ɐ s
žiedynus	ʒʲ j ɛ dʲ iː n ʊ s
žiedynų	ʒʲ j ɛ dʲ iː n uː
žiema	ʒ i ɛ m ɐ
žiemoje	ʒʲ i ɛ m ɔ j æ
žiemomis	ʒʲ i ɛ m ɔ mʲ ɪ s
žiemoms	ʒʲ i ɛ m ɔ m s
žiemos	ʒʲ i ɛ m ɔ s
žiemą	ʒʲ i ɛ m aː
žiemų	ʒʲ i ɛ m uː
žievė	ʒʲ ɪ ə vʲ ěː
žila	ʒʲ ɪ l ɐ
žilas	ʒʲ ɪ l ɐ s̪
žinduoliai	ʒʲ ɪ n d ʊ o lʲ ɛ j
žinduoliams	ʒʲ ɪ n d ʊ o lʲ ɛ m s
žinduolis	ʒʲ ɪ n d ʊ o lʲ ɪ s
žinduolius	ʒʲ ɪ n d ʊ o lʲ ʊ s
žirgas	ʒʲ ɪ r ɡ ɐ s
žiūri	ʒʲ u ɾʲ ɪ
žiūrime	ʒʲ u ɾʲ ɪ mʲ ɛ
žiūrinti	ʒʲ uː rʲ ɪ nʲ tʲ ɪ
žiūrintieji	ʒʲ uː rʲ ɪ nʲ tʲ j ɛ j ɪ
žiūrintiems	ʒʲ uː rʲ ɪ nʲ tʲ j ɛ m s
žiūrintiesiems	ʒʲ uː rʲ ɪ nʲ tʲ j ɛ sʲ j ɛ m s
žiūrintis	ʒʲ uː rʲ ɪ nʲ tʲ ɪ s
žiūrintys	ʒʲ uː rʲ ɪ nʲ tʲ iː s
žiūrinčiais	ʒʲ uː rʲ ɪ nʲ tʲ ʃʲ ɛ j s
žiūrinčiam	ʒʲ uː rʲ ɪ nʲ tʲ ʃʲ ɛ m
žiūrinčiojo	ʒʲ uː rʲ ɪ nʲ tʲ ʃʲ o j o
žiūrinčiojoje	ʒʲ uː rʲ ɪ nʲ tʲ ʃʲ o j o j ɛ
žiūrinčioms	ʒʲ uː rʲ ɪ nʲ tʲ ʃʲ o m s
žiūrinčios	ʒʲ uː rʲ ɪ nʲ tʲ ʃʲ o s
žiūrinčiuoju	ʒʲ uː rʲ ɪ nʲ tʲ ʃʲ ʊ o j ʊ
žiūrinčius	ʒʲ uː rʲ ɪ nʲ tʲ ʃʲ ʊ s
žiūrite	ʒʲ u ɾʲ ɪ tʲ ɛ
žiūriu	ʒʲ u ɾʲ ʊ
žiūrėjo	ʒʲ u ɾʲ eː j ɔ
žiūrėti	ʒʲ uː rʲ eː tʲ ɪ
žmogau	ʒ m o ɡ ɐ u
žmogaus	ʒ m o ɡ ɐ u s
žmogiška	ʒ m oː ɡʲ ɪ ʃ k ɐ
žmogiškai	ʒ m oː ɡʲ ɪ ʃ k ɐ j
žmogiškais	ʒ m oː ɡʲ ɪ ʃ k ɐ j s
žmogiškaisiais	ʒ m oː ɡʲ ɪ ʃ k ɐ j sʲ ɛ j s
žmogiškajam	ʒ m oː ɡʲ ɪ ʃ k ɐ j ɛ m
žmogiškajame	ʒ m oː ɡʲ ɪ ʃ k ɐ j ɛ mʲ ɛ
žmogiškame	ʒ m oː ɡʲ ɪ ʃ k ɐ mʲ ɛ
žmogiškas	ʒ m oː ɡʲ ɪ ʃ k ɐ s
žmogiškasis	ʒ m oː ɡʲ ɪ ʃ k ɐ sʲ ɪ s
žmogiškesnio	ʒ m o ɡʲ ɪ ʃʲ kʲ ɛ sʲ nʲ o
žmogiškesnės	ʒ m o ɡʲ ɪ ʃʲ kʲ ɛ sʲ nʲ eː s
žmogiški	ʒ m oː ɡʲ ɪ ʃʲ kʲ ɪ
žmogiškiausia	ʒ m o ɡʲ ɪ ʃʲ kʲ æː ʊ sʲ ɛ
žmogiškiausiai	ʒ m o ɡʲ ɪ ʃʲ kʲ æː ʊ sʲ ɛ j
žmogiškiausio	ʒ m o ɡʲ ɪ ʃʲ kʲ æː ʊ sʲ o
žmogiškiausiuosius	ʒ m o ɡʲ ɪ ʃʲ kʲ æː ʊ sʲ ʊ o sʲ ʊ s
žmogiškiems	ʒ m oː ɡʲ ɪ ʃʲ kʲ j ɛ m s
žmogiško	ʒ m oː ɡʲ ɪ ʃ k o
žmogiškoje	ʒ m oː ɡʲ ɪ ʃ k o j ɛ
žmogiškojo	ʒ m oː ɡʲ ɪ ʃ k o j o
žmogiškomis	ʒ m oː ɡʲ ɪ ʃ k o mʲ ɪ s
žmogiškoms	ʒ m oː ɡʲ ɪ ʃ k o m s
žmogiškos	ʒ m oː ɡʲ ɪ ʃ k o s
žmogiškosiomis	ʒ m oː ɡʲ ɪ ʃ k o sʲ o mʲ ɪ s
žmogiškosios	ʒ m oː ɡʲ ɪ ʃ k o sʲ o s
žmogišku	ʒ m oː ɡʲ ɪ ʃ k ʊ
žmogiškumas	ʒ m o ɡʲ ɪ ʃ k ʊ m ɐ s
žmogiškuoju	ʒ m oː ɡʲ ɪ ʃ k ʊ o j ʊ
žmogiškuosius	ʒ m oː ɡʲ ɪ ʃ k ʊ o sʲ ʊ s
žmogiškus	ʒ m oː ɡʲ ɪ ʃ k ʊ s
žmogišką	ʒ m oː ɡʲ ɪ ʃ k aː
žmogiškąja	ʒ m oː ɡʲ ɪ ʃ k aː j ɛ
žmogiškąją	ʒ m oː ɡʲ ɪ ʃ k aː j æː
žmogiškąjį	ʒ m oː ɡʲ ɪ ʃ k aː j iː
žmogiškąsias	ʒ m oː ɡʲ ɪ ʃ k aː sʲ ɛ s
žmogiškų	ʒ m oː ɡʲ ɪ ʃ k uː
žmogiškųjų	ʒ m oː ɡʲ ɪ ʃ k uː j uː
žmogui	ʒ m oː ɡ ʊ ɪ
žmoguje	ʒ m o ɡ ʊ j ɛ
žmogus	ʒ m o ɡ ʊ s
žmogų	ʒ m oː ɡ uː
žmones	ʒ m oː nʲ ɛ s
žmoniška	ʒ m oː nʲ ɪ ʃ k ɐ
žmoniškai	ʒ m oː nʲ ɪ ʃ k ɐ j
žmoniškesniajame	ʒ m o nʲ ɪ ʃʲ kʲ ɛ sʲ nʲ æː j ɛ mʲ ɛ
žmoniški	ʒ m oː nʲ ɪ ʃʲ kʲ ɪ
žmoniškiausia	ʒ m o nʲ ɪ ʃʲ kʲ æː ʊ sʲ ɛ
žmoniškiausiasis	ʒ m o nʲ ɪ ʃʲ kʲ æː ʊ sʲ ɛ sʲ ɪ s
žmoniškoji	ʒ m oː nʲ ɪ ʃ k o j ɪ
žmoniškus	ʒ m oː nʲ ɪ ʃ k ʊ s
žmonių	ʒ m o nʲ uː
žmonėmis	ʒ m o nʲ eː mʲ ɪ s
žmonėms	ʒ m o nʲ eː m s
žmonės	ʒ m oː nʲ eː s
žmonėse	ʒ m o nʲ eː sʲ ɛ
žodi	ʒ oː dʲ ɪ
žodyje	ʒ oː dʲ iː j ɛ
žodynai	ʒ o dʲ iː n ɐ j
žodynais	ʒ o dʲ iː n ɐ j s
žodynas	ʒ o dʲ iː n ɐ s
žodyne	ʒ o dʲ iː n ɛ
žodyno	ʒ o dʲ iː n o
žodynu	ʒ o dʲ iː n ʊ
žodynui	ʒ o dʲ iː n ʊ ɪ
žodynuose	ʒ o dʲ iː n ʊ o sʲ ɛ
žodynus	ʒ o dʲ iː n ʊ s
žodyną	ʒ o dʲ iː n aː
žodį	ʒ oː dʲ iː
žodžiai	ʒ oː dʲ ʒʲ ɛ j
žodžiais	ʒ oː dʲ ʒʲ ɛ j s
žodžiams	ʒ oː dʲ ʒʲ ɛ m s
žodžio	ʒ oː dʲ ʒʲ o
žodžiu	ʒ o dʲ ʒʲ ʊ
žodžiui	ʒ oː dʲ ʒʲ ʊ ɪ
žodžiuose	ʒ oː dʲ ʒʲ ʊ o sʲ ɛ
žodžius	ʒ o dʲ ʒʲ ʊ s
žodžių	ʒ oː dʲ ʒʲ uː
žolei	ʒ oː lʲ ɛ j
žoles	ʒ o lʲ ɛ s
žolių	ʒ o lʲ uː
žolė	ʒ o lʲ eː
žolėje	ʒ o lʲ eː j ɛ
žolėmis	ʒ o lʲ eː mʲ ɪ s
žolėms	ʒ o lʲ eː m s
žolę	ʒ oː lʲ æː
žudikas	ʒ ʊ dʲ ɪ k ɐ s
žvaigžde	ʒ ʋ ɐ j ɡʲ ʒʲ dʲ ɛ
žvaigždei	ʒ ʋ ɐ j ɡʲ ʒʲ dʲ ɛ j
žvaigždes	ʒ ʋ ɐ j ɡʲ ʒʲ dʲ ɛ s
žvaigždiniams	ʒ ʋ ɐ j ɡʲ ʒʲ dʲ ɪ nʲ ɛ m s
žvaigždinis	ʒ ʋ ɐ j ɡʲ ʒʲ dʲ ɪ nʲ ɪ s
žvaigždiniu	ʒ ʋ ɐ j ɡʲ ʒʲ dʲ ɪ nʲ ʊ
žvaigždinėms	ʒ ʋ ɐ j ɡʲ ʒʲ dʲ ɪ nʲ eː m s
žvaigždinės	ʒ ʋ ɐ j ɡʲ ʒʲ dʲ ɪ nʲ eː s
žvaigždiškam	ʒ ʋ ɐ j ɡʲ ʒʲ dʲ ɪ ʃ k ɐ m
žvaigždiškame	ʒ ʋ ɐ j ɡʲ ʒʲ dʲ ɪ ʃ k ɐ mʲ ɛ
žvaigždiškasis	ʒ ʋ ɐ j ɡʲ ʒʲ dʲ ɪ ʃ k ɐ sʲ ɪ s
žvaigždiškesnes	ʒ ʋ ɐ j ɡʲ ʒʲ dʲ ɪ ʃʲ kʲ ɛ sʲ nʲ ɛ s
žvaigždiškesniajam	ʒ ʋ ɐ j ɡʲ ʒʲ dʲ ɪ ʃʲ kʲ ɛ sʲ nʲ æː j ɛ m
žvaigždiškesniojoje	ʒ ʋ ɐ j ɡʲ ʒʲ dʲ ɪ ʃʲ kʲ ɛ sʲ nʲ oː j o j ɛ
žvaigždiškesniuose	ʒ ʋ ɐ j ɡʲ ʒʲ dʲ ɪ ʃʲ kʲ ɛ sʲ nʲ ʊ o sʲ ɛ
žvaigždiškesnėje	ʒ ʋ ɐ j ɡʲ ʒʲ dʲ ɪ ʃʲ kʲ ɛ sʲ nʲ eː j ɛ
žvaigždiškiausia	ʒ ʋ ɐ j ɡʲ ʒʲ dʲ ɪ ʃʲ kʲ æː ʊ sʲ ɛ
žvaigždiškiausiame	ʒ ʋ ɐ j ɡʲ ʒʲ dʲ ɪ ʃʲ kʲ æː ʊ sʲ ɛ mʲ ɛ
žvaigždiškiausiasis	ʒ ʋ ɐ j ɡʲ ʒʲ dʲ ɪ ʃʲ kʲ æː ʊ sʲ ɛ sʲ ɪ s
žvaigždiškiausiems	ʒ ʋ ɐ j ɡʲ ʒʲ dʲ ɪ ʃʲ kʲ æː ʊ sʲ j ɛ m s
žvaigždiškiausius	ʒ ʋ ɐ j ɡʲ ʒʲ dʲ ɪ ʃʲ kʲ æː ʊ sʲ ʊ s
žvaigždiškoji	ʒ ʋ ɐ j ɡʲ ʒʲ dʲ ɪ ʃ k o j ɪ
žvaigždiškos	ʒ ʋ ɐ j ɡʲ ʒʲ dʲ ɪ ʃ k o s
žvaigždiškosios	ʒ ʋ ɐ j ɡʲ ʒʲ dʲ ɪ ʃ k o sʲ o s
žvaigždiškosiose	ʒ ʋ ɐ j ɡʲ ʒʲ dʲ ɪ ʃ k o sʲ o sʲ ɛ
žvaigždišką	ʒ ʋ ɐ j ɡʲ ʒʲ dʲ ɪ ʃ k aː
žvaigždiškąją	ʒ ʋ ɐ j ɡʲ ʒʲ dʲ ɪ ʃ k aː j æː
žvaigždyne	ʒ ʋ ɐ j ɡʲ ʒʲ dʲ iː n ɛ
žvaigždyno	ʒ ʋ ɐ j ɡʲ ʒʲ dʲ iː n o
žvaigždynuose	ʒ ʋ ɐ j ɡʲ ʒʲ dʲ iː n ʊ o sʲ ɛ
žvaigždynų	ʒ ʋ ɐ j ɡʲ ʒʲ dʲ iː n uː
žvaigždė	ʒ ʋ ɐ j ɡʲ ʒʲ dʲ eː
žvaigždėje	ʒ ʋ ɐ j ɡʲ ʒʲ dʲ eː j ɛ
žvaigždėlapiai	ʒ ʋ ɐ j ɡʲ ʒʲ dʲ eː l ɐ pʲ ɛ j
žvaigždėlapiuose	ʒ ʋ ɐ j ɡʲ ʒʲ dʲ eː l ɐ pʲ ʊ o sʲ ɛ
žvaigždėms	ʒ ʋ ɐ j ɡʲ ʒʲ dʲ eː m s
žvaigždūne	ʒ ʋ ɐ j ɡ ʒ d uː nʲ ɛ
žvaigždūnės	ʒ ʋ ɐ j ɡ ʒ d uː nʲ eː s
žvaigždūnėse	ʒ ʋ ɐ j ɡ ʒ d uː nʲ eː sʲ ɛ
žvakutes	ʒ ʋ ɐ k ʊ tʲ ɛ s
žvakutė	ʒ ʋ ɐ k ʊ tʲ eː
žvakutėje	ʒ ʋ ɐ k ʊ tʲ eː j ɛ
žvakutėmis	ʒ ʋ ɐ k ʊ tʲ eː mʲ ɪ s
žvakutės	ʒ ʋ ɐ k ʊ tʲ eː s
žvakutę	ʒ ʋ ɐ k ʊ tʲ æː
žvakučių	ʒ ʋ ɐ k ʊ tʲ ʃʲ uː
žąsis	ʒ aː sʲ ɪ s
