a còng	ʔ aː ˧˧ k a w ŋ͡m ˨˩
a phú hãn	ʔ aː ˧˧ f u ˧˦ h aː n ˦˥
ambrôsiô	ʔ aː m ˧˧ ʔ ɓ ɹ o ˧˧ s i ˧˧ ʔ o ˧˧
an lạc	ʔ aː n ˧˧ l aː k̚ ˧˨ ʔ
an toàn	ʔ aː n ˧˧ t w aː n ˨˩
an táng	ʔ aː n ˧˧ t aː ŋ ˧˦
an tử	ʔ aː n ˧˧ t ɨ ˧˩
anh chồng	ʔ a j ŋ̟ ˧˧ t͡ɕ ə w ŋ͡m ˨˩
anh trai	ʔ a j ŋ̟ ˧˧ t͡ɕ aː j ˧˧
anh đào	ʔ a j ŋ̟ ˧˧ ʔ ɗ aː w ˨˩
asen	ʔ aː ˧˧ s ɛ n ˧˧
augustinô	ʔ a w ˧˧ ɣ u ˧˧ s t i n ˧˧ n o ˧˧
axit sunfurơ	ʔ aː ˧˧ s i t̚ ˧˧ s u n ˧˧ f u ˧˧ ɹ əː ˧˧
ba	ʔ ɓ aː ˧˧
ba bảy hai mốt ngày	ʔ ɓ aː ˧˧ ʔ ɓ a j ˧˩ h aː j ˧˧ m o t̚ ˧˦ ŋ a j ˨˩
ba gai	ʔ ɓ aː ˧˧ ɣ aː j ˧˧
ba lan	ʔ ɓ aː ˧˧ l aː n ˧˧
ba lê	ʔ ɓ aː ˧˧ l e ˧˧
ba lô	ʔ ɓ aː ˧˧ l o ˧˧
ba mươi sáu kế	ʔ ɓ aː ˧˧ m ɨ ə j ˧˧ s a w ˧˦ k e ˧˦
ba que	ʔ ɓ aː ˧˧ k w ɛ ˧˧
ba que xỏ lá	ʔ ɓ aː ˧˧ k w ɛ ˧˧ s ɔ ˧˩ l aː ˧˦
ba tây	ʔ ɓ aː ˧˧ t ə j ˧˧
ban đêm	ʔ ɓ aː n ˧˧ ʔ ɗ e m ˧˧
ban đầu	ʔ ɓ aː n ˧˧ ʔ ɗ ə w ˨˩
bang	ʔ ɓ aː ŋ ˧˧
bao báp	ʔ ɓ aː w ˧˧ ʔ ɓ aː p̚ ˧˦
bao cao su	ʔ ɓ aː w ˧˧ k aː w ˧˧ s u ˧˧
bao dương vật	ʔ ɓ aː w ˧˧ z ɨ ə ŋ ˧˧ v ə t̚ ˧˨ ʔ
bao lâu	ʔ ɓ aː w ˧˧ l ə w ˧˧
bao vây	ʔ ɓ aː w ˧˧ v ə j ˧˧
batôlômêô	ʔ ɓ aː ˧˧ t o ˧˧ l o ˧˧ m e ˧˧ ʔ o ˧˧
bay	ʔ ɓ a j ˧˧
be	ʔ ɓ ɛ ˧˧
beo	ʔ ɓ ɛ w ˧˧
beri	ʔ ɓ ɛ ˧˧ ɹ i ˧˧
bi	ʔ ɓ i ˧˧
bi kịch	ʔ ɓ i ˧˧ k ï k̟̚ ˧˨ ʔ
biên kịch	ʔ ɓ i ə n ˧˧ k ï k̟̚ ˧˨ ʔ
biên niên sử	ʔ ɓ i ə n ˧˧ n i ə n ˧˧ s ɨ ˧˩
biên xích	ʔ ɓ i ə n ˧˧ s ï k̟̚ ˧˦
biếc	ʔ ɓ i ə k̚ ˧˦
biến loạn	ʔ ɓ i ə n ˧˦ l w aː n ˧˨ ʔ
biến mất	ʔ ɓ i ə n ˧˦ m ə t̚ ˧˦
biến tấu	ʔ ɓ i ə n ˧˦ t ə w ˧˦
biết bao	ʔ ɓ i ə t̚ ˧˦ ʔ ɓ aː w ˧˧
biền	ʔ ɓ i ə n ˨˩
biển	ʔ ɓ i ə n ˧˩
biển cả	ʔ ɓ i ə n ˧˩ k aː ˧˩
biển đen	ʔ ɓ i ə n ˧˩ ʔ ɗ ɛ n ˧˧
biểu	ʔ ɓ i ə w ˧˩
biểu diễn	ʔ ɓ i ə w ˧˩ z i ə n ˦˥
biểu hiện	ʔ ɓ i ə w ˧˩ h i ə n ˧˨ ʔ
biện	ʔ ɓ i ə n ˧˨ ʔ
biện chứng duy vật	ʔ ɓ i ə n ˧˨ ʔ t͡ɕ ɨ ŋ ˧˦ z w i ˧˧ v ə t̚ ˧˨ ʔ
biệt danh	ʔ ɓ i ə t̚ ˧˨ ʔ z a j ŋ̟ ˧˧
biệt lập	ʔ ɓ i ə t̚ ˧˨ ʔ l ə p̚ ˧˨ ʔ
biệt thự	ʔ ɓ i ə t̚ ˧˨ ʔ tʰ ɨ ˧˨ ʔ
blu	ʔ ɓ l u ˧˧
boa	ʔ ɓ w aː ˧˧
bu	ʔ ɓ u ˧˧
buôn dưa lê	ʔ ɓ u ə n ˧˧ z ɨ ə ˧˧ l e ˧˧
buồn	ʔ ɓ u ə n ˨˩
buồn bã	ʔ ɓ u ə n ˨˩ ʔ ɓ aː ˦˥
buồn rầu	ʔ ɓ u ə n ˨˩ z ə w ˨˩
buồng trứng	ʔ ɓ u ə ŋ ˨˩ t͡ɕ ɨ ŋ ˧˦
buồng tắm	ʔ ɓ u ə ŋ ˨˩ t a m ˧˦
buột	ʔ ɓ u ə t̚ ˧˨ ʔ
buột miệng	ʔ ɓ u ə t̚ ˧˨ ʔ m i ə ŋ ˧˨ ʔ
bà con	ʔ ɓ aː ˨˩ k ɔ n ˧˧
bài thơ	ʔ ɓ aː j ˨˩ tʰ əː ˧˧
bàn cãi	ʔ ɓ aː n ˨˩ k aː j ˦˥
bàn ủi	ʔ ɓ aː n ˨˩ ʔ u j ˧˩
bàng hoàng	ʔ ɓ aː ŋ ˨˩ h w aː ŋ ˨˩
bàng quang	ʔ ɓ aː ŋ ˨˩ k w aː ŋ ˧˧
bành	ʔ ɓ a j ŋ̟ ˨˩
bào	ʔ ɓ aː w ˨˩
bày	ʔ ɓ a j ˨˩
bá láp	ʔ ɓ aː ˧˦ l aː p̚ ˧˦
bá quan	ʔ ɓ aː ˧˦ k w aː n ˧˧
bá tước	ʔ ɓ aː ˧˦ t ɨ ə k̚ ˧˦
bác học	ʔ ɓ aː k̚ ˧˦ h a w k͡p̚ ˧˨ ʔ
bác sĩ nhi	ʔ ɓ aː k̚ ˧˦ s i ˦˥ ɲ i ˧˧
bác vật quán	ʔ ɓ aː k̚ ˧˦ v ə t̚ ˧˨ ʔ k w aː n ˧˦
bách khoa toàn thư	ʔ ɓ a j k̟̚ ˧˦ x w aː ˧˧ t w aː n ˨˩ tʰ ɨ ˧˧
bách thú	ʔ ɓ a j k̟̚ ˧˦ tʰ u ˧˦
bán chạy	ʔ ɓ aː n ˧˦ t͡ɕ a j ˧˨ ʔ
bán kính	ʔ ɓ aː n ˧˦ k ï ŋ ˧˦
bán kết	ʔ ɓ aː n ˧˦ k e t̚ ˧˦
bán trú	ʔ ɓ aː n ˧˦ t͡ɕ u ˧˦
bán đảo	ʔ ɓ aː n ˧˦ ʔ ɗ aː w ˧˩
bánh bao	ʔ ɓ a j ŋ̟ ˧˦ ʔ ɓ aː w ˧˧
bánh bá trạng	ʔ ɓ a j ŋ̟ ˧˦ ʔ ɓ aː ˧˦ t͡ɕ aː ŋ ˧˨ ʔ
bánh bông lan	ʔ ɓ a j ŋ̟ ˧˦ ʔ ɓ ə w ŋ͡m ˧˧ l aː n ˧˧
bánh canh	ʔ ɓ a j ŋ̟ ˧˦ k a j ŋ̟ ˧˧
bánh kẹp	ʔ ɓ a j ŋ̟ ˧˦ k ɛ p̚ ˧˨ ʔ
bánh kếp	ʔ ɓ a j ŋ̟ ˧˦ k e p̚ ˧˦
bánh lễ	ʔ ɓ a j ŋ̟ ˧˦ l e ˦˥
bánh lọt	ʔ ɓ a j ŋ̟ ˧˦ l ɔ t̚ ˧˨ ʔ
bánh răng bừa	ʔ ɓ a j ŋ̟ ˧˦ z a ŋ ˧˧ ʔ ɓ ɨ ə ˨˩
bánh tét	ʔ ɓ a j ŋ̟ ˧˦ t ɛ t̚ ˧˦
bánh vòng	ʔ ɓ a j ŋ̟ ˧˦ v a w ŋ͡m ˨˩
bánh ú	ʔ ɓ a j ŋ̟ ˧˦ ʔ u ˧˦
báo cáo	ʔ ɓ aː w ˧˦ k aː w ˧˦
báo công	ʔ ɓ aː w ˧˦ k ə w ŋ͡m ˧˧
báo hoa mai	ʔ ɓ aː w ˧˦ h w aː ˧˧ m aː j ˧˧
báo động giả	ʔ ɓ aː w ˧˦ ʔ ɗ ə w ŋ͡m ˧˨ ʔ z aː ˧˩
bát hương	ʔ ɓ aː t̚ ˧˦ h ɨ ə ŋ ˧˧
bãi biển	ʔ ɓ aː j ˦˥ ʔ ɓ i ə n ˧˩
bão cát	ʔ ɓ aː w ˦˥ k aː t̚ ˧˦
bè lũ	ʔ ɓ ɛ ˨˩ l u ˦˥
bèo	ʔ ɓ ɛ w ˨˩
bé	ʔ ɓ ɛ ˧˦
bé bằng củ khoai, cứ vai mà gọi	ʔ ɓ ɛ ˧˦ ʔ ɓ a ŋ ˨˩ k u ˧˩ x w aː j ˧˧ k ɨ ˧˦ v aː j ˧˧ m aː ˨˩ ɣ ɔ j ˧˨ ʔ
bén	ʔ ɓ ɛ n ˧˦
béo	ʔ ɓ ɛ w ˧˦
bên	ʔ ɓ e n ˧˧
bênêđictô	ʔ ɓ e ˧˧ n e ˧˧ ʔ ɗ ï k̟̚ ˧˦ t o ˧˧
bêu	ʔ ɓ e w ˧˧
bình an	ʔ ɓ ï ŋ ˨˩ ʔ aː n ˧˧
bình bát	ʔ ɓ ï ŋ ˨˩ ʔ ɓ aː t̚ ˧˦
bình dị	ʔ ɓ ï ŋ ˨˩ z i ˧˨ ʔ
bình nhưỡng	ʔ ɓ ï ŋ ˨˩ ɲ ɨ ə ŋ ˦˥
bình phương	ʔ ɓ ï ŋ ˨˩ f ɨ ə ŋ ˧˧
bình phục	ʔ ɓ ï ŋ ˨˩ f ʊ w k͡p̚ ˧˨ ʔ
bình quyền	ʔ ɓ ï ŋ ˨˩ k w i ə n ˨˩
bình yên	ʔ ɓ ï ŋ ˨˩ ʔ i ə n ˧˧
bình đẳng	ʔ ɓ ï ŋ ˨˩ ʔ ɗ a ŋ ˧˩
bìu	ʔ ɓ i w ˨˩
bí quyết	ʔ ɓ i ˧˦ k w i ə t̚ ˧˦
bím	ʔ ɓ i m ˧˦
bính	ʔ ɓ ï ŋ ˧˦
bít tất	ʔ ɓ i t̚ ˧˦ t ə t̚ ˧˦
bò sát	ʔ ɓ ɔ ˨˩ s aː t̚ ˧˦
bó hoa	ʔ ɓ ɔ ˧˦ h w aː ˧˧
bó tay	ʔ ɓ ɔ ˧˦ t a j ˧˧
bóc	ʔ ɓ a w k͡p̚ ˧˦
bói cá	ʔ ɓ ɔ j ˧˦ k aː ˧˦
bón	ʔ ɓ ɔ n ˧˦
bóng bay	ʔ ɓ a w ŋ͡m ˧˦ ʔ ɓ a j ˧˧
bóng dáng	ʔ ɓ a w ŋ͡m ˧˦ z aː ŋ ˧˦
bóng ném	ʔ ɓ a w ŋ͡m ˧˦ n ɛ m ˧˦
bóng rổ	ʔ ɓ a w ŋ͡m ˧˦ z o ˧˩
bóng đá	ʔ ɓ a w ŋ͡m ˧˦ ʔ ɗ aː ˧˦
bóng đái	ʔ ɓ a w ŋ͡m ˧˦ ʔ ɗ aː j ˧˦
bóng đèn	ʔ ɓ a w ŋ͡m ˧˦ ʔ ɗ ɛ n ˨˩
bóp	ʔ ɓ ɔ p̚ ˧˦
bô	ʔ ɓ o ˧˧
bôn sê vích	ʔ ɓ o n ˧˧ s e ˧˧ v ï k̟̚ ˧˦
bông gòn	ʔ ɓ ə w ŋ͡m ˧˧ ɣ ɔ n ˨˩
bù xù	ʔ ɓ u ˨˩ s u ˨˩
bùa yêu	ʔ ɓ u ə ˨˩ ʔ i ə w ˧˧
bú	ʔ ɓ u ˧˦
bún	ʔ ɓ u n ˧˦
bún bò huế	ʔ ɓ u n ˧˦ ʔ ɓ ɔ ˨˩ h w e ˧˦
bún thịt nướng	ʔ ɓ u n ˧˦ tʰ i t̚ ˧˨ ʔ n ɨ ə ŋ ˧˦
búp	ʔ ɓ u p̚ ˧˦
bút máy	ʔ ɓ u t̚ ˧˦ m a j ˧˦
bút mực	ʔ ɓ u t̚ ˧˦ m ɨ k̚ ˧˨ ʔ
băng	ʔ ɓ a ŋ ˧˧
bĩ	ʔ ɓ i ˦˥
bơ vơ	ʔ ɓ əː ˧˧ v əː ˧˧
bơi	ʔ ɓ əː j ˧˧
bơi lội	ʔ ɓ əː j ˧˧ l o j ˧˨ ʔ
bưng	ʔ ɓ ɨ ŋ ˧˧
bưng bít	ʔ ɓ ɨ ŋ ˧˧ ʔ ɓ i t̚ ˧˦
bưu chính	ʔ ɓ i w ˧˧ t͡ɕ ï ŋ ˧˦
bươu	ʔ ɓ i ə w ˧˧
bướm đêm	ʔ ɓ ɨ ə m ˧˦ ʔ ɗ e m ˧˧
bưởi	ʔ ɓ ɨ ə j ˧˩
bạc bẽo	ʔ ɓ aː k̚ ˧˨ ʔ ʔ ɓ ɛ w ˦˥
bạch	ʔ ɓ a j k̟̚ ˧˨ ʔ
bạch thỏ	ʔ ɓ a j k̟̚ ˧˨ ʔ tʰ ɔ ˧˩
bạch tuột	ʔ ɓ a j k̟̚ ˧˨ ʔ t u ə t̚ ˧˨ ʔ
bại liệt	ʔ ɓ aː j ˧˨ ʔ l i ə t̚ ˧˨ ʔ
bạn	ʔ ɓ aː n ˧˨ ʔ
bạn gái	ʔ ɓ aː n ˧˨ ʔ ɣ aː j ˧˦
bạo chúa	ʔ ɓ aː w ˧˨ ʔ t͡ɕ u ə ˧˦
bạt	ʔ ɓ aː t̚ ˧˨ ʔ
bản chất	ʔ ɓ aː n ˧˩ t͡ɕ ə t̚ ˧˦
bản gốc	ʔ ɓ aː n ˧˩ ɣ ə w k͡p̚ ˧˦
bản ngã	ʔ ɓ aː n ˧˩ ŋ aː ˦˥
bản quyền	ʔ ɓ aː n ˧˩ k w i ə n ˨˩
bảng	ʔ ɓ aː ŋ ˧˩
bảng đen	ʔ ɓ aː ŋ ˧˩ ʔ ɗ ɛ n ˧˧
bảo dưỡng	ʔ ɓ aː w ˧˩ z ɨ ə ŋ ˦˥
bảo lãnh	ʔ ɓ aː w ˧˩ l a j ŋ̟ ˦˥
bảo trọng	ʔ ɓ aː w ˧˩ t͡ɕ a w ŋ͡m ˧˨ ʔ
bảo vệ	ʔ ɓ aː w ˧˩ v e ˧˨ ʔ
bảy	ʔ ɓ a j ˧˩
bất chợt	ʔ ɓ ə t̚ ˧˦ t͡ɕ əː t̚ ˧˨ ʔ
bất cẩn	ʔ ɓ ə t̚ ˧˦ k ə n ˧˩
bất diệt	ʔ ɓ ə t̚ ˧˦ z i ə t̚ ˧˨ ʔ
bất giác	ʔ ɓ ə t̚ ˧˦ z aː k̚ ˧˦
bất hoà	ʔ ɓ ə t̚ ˧˦ h w aː ˨˩
bất hợp pháp	ʔ ɓ ə t̚ ˧˦ h əː p̚ ˧˨ ʔ f aː p̚ ˧˦
bất kỳ ai	ʔ ɓ ə t̚ ˧˦ k i ˨˩ ʔ aː j ˧˧
bất nhất	ʔ ɓ ə t̚ ˧˦ ɲ ə t̚ ˧˦
bất phương trình	ʔ ɓ ə t̚ ˧˦ f ɨ ə ŋ ˧˧ t͡ɕ ï ŋ ˨˩
bất tài	ʔ ɓ ə t̚ ˧˦ t aː j ˨˩
bất tỉnh	ʔ ɓ ə t̚ ˧˦ t ï ŋ ˧˩
bất tử	ʔ ɓ ə t̚ ˧˦ t ɨ ˧˩
bất đẳng thức	ʔ ɓ ə t̚ ˧˦ ʔ ɗ a ŋ ˧˩ tʰ ɨ k̚ ˧˦
bất động sản	ʔ ɓ ə t̚ ˧˦ ʔ ɗ ə w ŋ͡m ˧˨ ʔ s aː n ˧˩
bấy	ʔ ɓ ə j ˧˦
bầu bạn	ʔ ɓ ə w ˨˩ ʔ ɓ aː n ˧˨ ʔ
bậc	ʔ ɓ ə k̚ ˧˨ ʔ
bận bịu	ʔ ɓ ə n ˧˨ ʔ ʔ ɓ i w ˧˨ ʔ
bập bẹ	ʔ ɓ ə p̚ ˧˨ ʔ ʔ ɓ ɛ ˧˨ ʔ
bật	ʔ ɓ ə t̚ ˧˨ ʔ
bật lửa	ʔ ɓ ə t̚ ˧˨ ʔ l ɨ ə ˧˩
bật đèn xanh	ʔ ɓ ə t̚ ˧˨ ʔ ʔ ɗ ɛ n ˨˩ s a j ŋ̟ ˧˧
bậu	ʔ ɓ ə w ˧˨ ʔ
bắc carolina	ʔ ɓ a k̚ ˧˦ k aː ˧˧ ɹ ɔ ˧˧ l i ˧˧ n aː ˧˧
bắc giải	ʔ ɓ a k̚ ˧˦ z aː j ˧˩
bắc hà	ʔ ɓ a k̚ ˧˦ h aː ˨˩
bắc kì	ʔ ɓ a k̚ ˧˦ k i ˨˩
bắc mĩ	ʔ ɓ a k̚ ˧˦ m i ˦˥
bắc ninh	ʔ ɓ a k̚ ˧˦ n ï ŋ ˧˧
bắc thuộc	ʔ ɓ a k̚ ˧˦ tʰ u ə k̚ ˧˨ ʔ
bắc triều tiên	ʔ ɓ a k̚ ˧˦ t͡ɕ i ə w ˨˩ t i ə n ˧˧
bắn	ʔ ɓ a n ˧˦
bắn súng	ʔ ɓ a n ˧˦ s ʊ w ŋ͡m ˧˦
bắn tỉa	ʔ ɓ a n ˧˦ t i ə ˧˩
bắp chân	ʔ ɓ a p̚ ˧˦ t͡ɕ ə n ˧˧
bắt buộc	ʔ ɓ a t̚ ˧˦ ʔ ɓ u ə k̚ ˧˨ ʔ
bắt chước	ʔ ɓ a t̚ ˧˦ t͡ɕ ɨ ə k̚ ˧˦
bằng	ʔ ɓ a ŋ ˨˩
bằng chứng	ʔ ɓ a ŋ ˨˩ t͡ɕ ɨ ŋ ˧˦
bằng niềm tin	ʔ ɓ a ŋ ˨˩ n i ə m ˨˩ t i n ˧˧
bẻ	ʔ ɓ ɛ ˧˩
bến	ʔ ɓ e n ˧˦
bến xe buýt	ʔ ɓ e n ˧˦ s ɛ ˧˧ ʔ ɓ w i t̚ ˧˦
bếp núc	ʔ ɓ e p̚ ˧˦ n ʊ w k͡p̚ ˧˦
bề	ʔ ɓ e ˨˩
bề mặt	ʔ ɓ e ˨˩ m a t̚ ˧˨ ʔ
bền	ʔ ɓ e n ˨˩
bền chặt	ʔ ɓ e n ˨˩ t͡ɕ a t̚ ˧˨ ʔ
bện	ʔ ɓ e n ˧˨ ʔ
bệnh lí học	ʔ ɓ ə j ŋ̟ ˧˨ ʔ l i ˧˦ h a w k͡p̚ ˧˨ ʔ
bệnh nhi	ʔ ɓ ə j ŋ̟ ˧˨ ʔ ɲ i ˧˧
bệnh sốt rét	ʔ ɓ ə j ŋ̟ ˧˨ ʔ s o t̚ ˧˦ z ɛ t̚ ˧˦
bệnh tâm thần	ʔ ɓ ə j ŋ̟ ˧˨ ʔ t ə m ˧˧ tʰ ə n ˨˩
bệnh án	ʔ ɓ ə j ŋ̟ ˧˨ ʔ ʔ aː n ˧˦
bệt	ʔ ɓ e t̚ ˧˨ ʔ
bị	ʔ ɓ i ˧˨ ʔ
bị cảm	ʔ ɓ i ˧˨ ʔ k aː m ˧˩
bị tào tháo đuổi	ʔ ɓ i ˧˨ ʔ t aː w ˨˩ tʰ aː w ˧˦ ʔ ɗ u ə j ˧˩
bịt	ʔ ɓ i t̚ ˧˨ ʔ
bọ hung	ʔ ɓ ɔ ˧˨ ʔ h ʊ w ŋ͡m ˧˧
bọ ngựa	ʔ ɓ ɔ ˧˨ ʔ ŋ ɨ ə ˧˨ ʔ
bọ rùa	ʔ ɓ ɔ ˧˨ ʔ z u ə ˨˩
bọt	ʔ ɓ ɔ t̚ ˧˨ ʔ
bỏ phiếu	ʔ ɓ ɔ ˧˩ f i ə w ˧˦
bỏ rơi	ʔ ɓ ɔ ˧˩ z əː j ˧˧
bỏ túi	ʔ ɓ ɔ ˧˩ t u j ˧˦
bố y	ʔ ɓ o ˧˦ ʔ i ˧˧
bốn bể	ʔ ɓ o n ˧˦ ʔ ɓ e ˧˩
bốp	ʔ ɓ o p̚ ˧˦
bốt	ʔ ɓ o t̚ ˧˦
bồ công anh	ʔ ɓ o ˨˩ k ə w ŋ͡m ˧˧ ʔ a j ŋ̟ ˧˧
bồ nhí	ʔ ɓ o ˨˩ ɲ i ˧˦
bồ nông	ʔ ɓ o ˨˩ n ə w ŋ͡m ˧˧
bồn địa	ʔ ɓ o n ˨˩ ʔ ɗ i ə ˧˨ ʔ
bổ	ʔ ɓ o ˧˩
bổ củi	ʔ ɓ o ˧˩ k u j ˧˩
bổ sung	ʔ ɓ o ˧˩ s ʊ w ŋ͡m ˧˧
bỗng dưng	ʔ ɓ ə w ŋ͡m ˦˥ z ɨ ŋ ˧˧
bộ chính trị	ʔ ɓ o ˧˨ ʔ t͡ɕ ï ŋ ˧˦ t͡ɕ i ˧˨ ʔ
bộ chế hoà khí	ʔ ɓ o ˧˨ ʔ t͡ɕ e ˧˦ h w aː ˨˩ x i ˧˦
bộ trưởng	ʔ ɓ o ˧˨ ʔ t͡ɕ ɨ ə ŋ ˧˩
bộ đôi	ʔ ɓ o ˧˨ ʔ ʔ ɗ o j ˧˧
bội	ʔ ɓ o j ˧˨ ʔ
bội chung nhỏ nhất	ʔ ɓ o j ˧˨ ʔ t͡ɕ ʊ w ŋ͡m ˧˧ ɲ ɔ ˧˩ ɲ ə t̚ ˧˦
bớ	ʔ ɓ əː ˧˦
bớt	ʔ ɓ əː t̚ ˧˦
bụt	ʔ ɓ u t̚ ˧˨ ʔ
bủa	ʔ ɓ u ə ˧˩
bủn rủn	ʔ ɓ u n ˧˩ z u n ˧˩
bứt	ʔ ɓ ɨ t̚ ˧˦
bựa	ʔ ɓ ɨ ə ˧˨ ʔ
bực bội	ʔ ɓ ɨ k̚ ˧˨ ʔ ʔ ɓ o j ˧˨ ʔ
ca kịch	k aː ˧˧ k ï k̟̚ ˧˨ ʔ
ca li	k aː ˧˧ l i ˧˧
ca ngợi	k aː ˧˧ ŋ əː j ˧˨ ʔ
ca ri	k aː ˧˧ z i ˧˧
cai nghiện	k aː j ˧˧ ŋ i ə n ˧˨ ʔ
cam bốt	k aː m ˧˧ ʔ ɓ o t̚ ˧˦
cam kết	k aː m ˧˧ k e t̚ ˧˦
cam sành	k aː m ˧˧ s a j ŋ̟ ˨˩
cam thảo	k aː m ˧˧ tʰ aː w ˧˩
cam tâm	k aː m ˧˧ t ə m ˧˧
can chi	k aː n ˧˧ t͡ɕ i ˧˧
can thiệp	k aː n ˧˧ tʰ i ə p̚ ˧˨ ʔ
canh	k a j ŋ̟ ˧˧
canh cánh	k a j ŋ̟ ˧˧ k a j ŋ̟ ˧˦
cao câu li	k aː w ˧˧ k ə w ˧˧ l i ˧˧
cao cả	k aː w ˧˧ k aː ˧˩
cao huyết áp	k aː w ˧˧ h w i ə t̚ ˧˦ ʔ aː p̚ ˧˦
cao học	k aː w ˧˧ h a w k͡p̚ ˧˨ ʔ
cao lệ	k aː w ˧˧ l e ˧˨ ʔ
cao nguyên	k aː w ˧˧ ŋ w i ə n ˧˧
cao sang	k aː w ˧˧ s aː ŋ ˧˧
cao su	k aː w ˧˧ s u ˧˧
cao thủ	k aː w ˧˧ tʰ u ˧˩
cao đẳng	k aː w ˧˧ ʔ ɗ a ŋ ˧˩
catarina	k aː ˧˧ t aː ˧˧ z i n ˧˧ n aː ˧˧
cha nào con nấy	t͡ɕ aː ˧˧ n aː w ˨˩ k ɔ n ˧˧ n ə j ˧˦
chao đảo	t͡ɕ aː w ˧˧ ʔ ɗ aː w ˧˩
che mờ	t͡ɕ ɛ ˧˧ m əː ˨˩
che đậy	t͡ɕ ɛ ˧˧ ʔ ɗ ə j ˧˨ ʔ
chia	t͡ɕ i ə ˧˧
chia cắt	t͡ɕ i ə ˧˧ k a t̚ ˧˦
chia động từ	t͡ɕ i ə ˧˧ ʔ ɗ ə w ŋ͡m ˧˨ ʔ t ɨ ˨˩
chim cánh cụt	t͡ɕ i m ˧˧ k a j ŋ̟ ˧˦ k u t̚ ˧˨ ʔ
chim ong	t͡ɕ i m ˧˧ ʔ a w ŋ͡m ˧˧
chiên	t͡ɕ i ə n ˧˧
chiêu	t͡ɕ i ə w ˧˧
chiêu hồi	t͡ɕ i ə w ˧˧ h o j ˨˩
chiếc	t͡ɕ i ə k̚ ˧˦
chiếm đoạt	t͡ɕ i ə m ˧˦ ʔ ɗ w aː t̚ ˧˨ ʔ
chiến quốc	t͡ɕ i ə n ˧˦ k u ə k̚ ˧˦
chiến sĩ	t͡ɕ i ə n ˧˦ s i ˦˥
chiến thắng	t͡ɕ i ə n ˧˦ tʰ a ŋ ˧˦
chiết giang	t͡ɕ i ə t̚ ˧˦ z aː ŋ ˧˧
cho phép	t͡ɕ ɔ ˧˧ f ɛ p̚ ˧˦
cho thuê	t͡ɕ ɔ ˧˧ tʰ w e ˧˧
cho thấy	t͡ɕ ɔ ˧˧ tʰ ə j ˧˦
choa	t͡ɕ w aː ˧˧
choét	t͡ɕ w ɛ t̚ ˧˦
choắt	t͡ɕ w a t̚ ˧˦
chu	t͡ɕ u ˧˧
chu ru	t͡ɕ u ˧˧ z u ˧˧
chu sa	t͡ɕ u ˧˧ s aː ˧˧
chu vi	t͡ɕ u ˧˧ v i ˧˧
chu đáo	t͡ɕ u ˧˧ ʔ ɗ aː w ˧˦
chung cư	t͡ɕ ʊ w ŋ͡m ˧˧ k ɨ ˧˧
chung khảo	t͡ɕ ʊ w ŋ͡m ˧˧ x aː w ˧˩
chung kết	t͡ɕ ʊ w ŋ͡m ˧˧ k e t̚ ˧˦
chung thân	t͡ɕ ʊ w ŋ͡m ˧˧ tʰ ə n ˧˧
chuyên gia	t͡ɕ w i ə n ˧˧ z aː ˧˧
chuyên khoa	t͡ɕ w i ə n ˧˧ x w aː ˧˧
chuyên môn	t͡ɕ w i ə n ˧˧ m o n ˧˧
chuyên nghiệp	t͡ɕ w i ə n ˧˧ ŋ i ə p̚ ˧˨ ʔ
chuyên tâm	t͡ɕ w i ə n ˧˧ t ə m ˧˧
chuyển biến	t͡ɕ w i ə n ˧˩ ʔ ɓ i ə n ˧˦
chuyển chú	t͡ɕ w i ə n ˧˩ t͡ɕ u ˧˦
chuyển dạ	t͡ɕ w i ə n ˧˩ z aː ˧˨ ʔ
chuyển hoá	t͡ɕ w i ə n ˧˩ h w aː ˧˦
chuyển tự	t͡ɕ w i ə n ˧˩ t ɨ ˧˨ ʔ
chuyển động	t͡ɕ w i ə n ˧˩ ʔ ɗ ə w ŋ͡m ˧˨ ʔ
chuyển động học	t͡ɕ w i ə n ˧˩ ʔ ɗ ə w ŋ͡m ˧˨ ʔ h a w k͡p̚ ˧˨ ʔ
chuyện	t͡ɕ w i ə n ˧˨ ʔ
chuẩn bị	t͡ɕ w ə n ˧˩ ʔ ɓ i ˧˨ ʔ
chuẩn mực	t͡ɕ w ə n ˧˩ m ɨ k̚ ˧˨ ʔ
chuối	t͡ɕ u ə j ˧˦
chuồng	t͡ɕ u ə ŋ ˨˩
chuột chũi	t͡ɕ u ə t̚ ˧˨ ʔ t͡ɕ u j ˦˥
chuột đồng	t͡ɕ u ə t̚ ˧˨ ʔ ʔ ɗ ə w ŋ͡m ˨˩
chà	t͡ɕ aː ˨˩
chài	t͡ɕ aː j ˨˩
chào đón	t͡ɕ aː w ˨˩ ʔ ɗ ɔ n ˧˦
chác	t͡ɕ aː k̚ ˧˦
chánh	t͡ɕ a j ŋ̟ ˧˦
chánh thức	t͡ɕ a j ŋ̟ ˧˦ tʰ ɨ k̚ ˧˦
cháo	t͡ɕ aː w ˧˦
cháo tiều	t͡ɕ aː w ˧˦ t i ə w ˨˩
chân chính	t͡ɕ ə n ˧˧ t͡ɕ ï ŋ ˧˦
chân dung	t͡ɕ ə n ˧˧ z ʊ w ŋ͡m ˧˧
chân nam đá chân chiêu	t͡ɕ ə n ˧˧ n aː m ˧˧ ʔ ɗ aː ˧˦ t͡ɕ ə n ˧˧ t͡ɕ i ə w ˧˧
chân trời	t͡ɕ ə n ˧˧ t͡ɕ əː j ˨˩
chân tình	t͡ɕ ə n ˧˧ t ï ŋ ˨˩
châu	t͡ɕ ə w ˧˧
châu lục	t͡ɕ ə w ˧˧ l ʊ w k͡p̚ ˧˨ ʔ
chèo	t͡ɕ ɛ w ˨˩
chén	t͡ɕ ɛ n ˧˦
chén uống trà	t͡ɕ ɛ n ˧˦ ʔ u ə ŋ ˧˦ t͡ɕ aː ˨˩
chê bai	t͡ɕ e ˧˧ ʔ ɓ aː j ˧˧
chênh vênh	t͡ɕ ə j ŋ̟ ˧˧ v ə j ŋ̟ ˧˧
chìa khoá	t͡ɕ i ə ˨˩ x w aː ˧˦
chí phèo	t͡ɕ i ˧˦ f ɛ w ˨˩
chích bông	t͡ɕ ï k̟̚ ˧˦ ʔ ɓ ə w ŋ͡m ˧˧
chín chắn	t͡ɕ i n ˧˦ t͡ɕ a n ˧˦
chính quy	t͡ɕ ï ŋ ˧˦ k w i ˧˧
chính uỷ	t͡ɕ ï ŋ ˧˦ ʔ w i ˧˩
chính đáng	t͡ɕ ï ŋ ˧˦ ʔ ɗ aː ŋ ˧˦
chính đảng	t͡ɕ ï ŋ ˧˦ ʔ ɗ aː ŋ ˧˩
chòm	t͡ɕ ɔ m ˨˩
chòm sao	t͡ɕ ɔ m ˨˩ s aː w ˧˧
chó má	t͡ɕ ɔ ˧˦ m aː ˧˦
chôm	t͡ɕ o m ˧˧
chôm chôm	t͡ɕ o m ˧˧ t͡ɕ o m ˧˧
chùa	t͡ɕ u ə ˨˩
chùi	t͡ɕ u j ˨˩
chùm ruột	t͡ɕ u m ˨˩ z u ə t̚ ˧˨ ʔ
chú	t͡ɕ u ˧˦
chú thích	t͡ɕ u ˧˦ tʰ ï k̟̚ ˧˦
chú tâm	t͡ɕ u ˧˦ t ə m ˧˧
chúa	t͡ɕ u ə ˧˦
chúa sơn lâm	t͡ɕ u ə ˧˦ s əː n ˧˧ l ə m ˧˧
chúc	t͡ɕ ʊ w k͡p̚ ˧˦
chúc mừng	t͡ɕ ʊ w k͡p̚ ˧˦ m ɨ ŋ ˨˩
chúc phúc	t͡ɕ ʊ w k͡p̚ ˧˦ f ʊ w k͡p̚ ˧˦
chúc tụng	t͡ɕ ʊ w k͡p̚ ˧˦ t ʊ w ŋ͡m ˧˨ ʔ
chăm chú	t͡ɕ a m ˧˧ t͡ɕ u ˧˦
chăm chỉ	t͡ɕ a m ˧˧ t͡ɕ i ˧˩
chăm nom	t͡ɕ a m ˧˧ n ɔ m ˧˧
chơi	t͡ɕ əː j ˧˧
chơi bời	t͡ɕ əː j ˧˧ ʔ ɓ əː j ˨˩
chơi vơi	t͡ɕ əː j ˧˧ v əː j ˧˧
chưng	t͡ɕ ɨ ŋ ˧˧
chương	t͡ɕ ɨ ə ŋ ˧˧
chướng	t͡ɕ ɨ ə ŋ ˧˦
chưởng	t͡ɕ ɨ ə ŋ ˧˩
chưởng dinh	t͡ɕ ɨ ə ŋ ˧˩ z ï ŋ ˧˧
chưởng doanh	t͡ɕ ɨ ə ŋ ˧˩ z w a j ŋ̟ ˧˧
chạng vạng	t͡ɕ aː ŋ ˧˨ ʔ v aː ŋ ˧˨ ʔ
chạnh lòng	t͡ɕ a j ŋ̟ ˧˨ ʔ l a w ŋ͡m ˨˩
chạo	t͡ɕ aː w ˧˨ ʔ
chạp	t͡ɕ aː p̚ ˧˨ ʔ
chảnh	t͡ɕ a j ŋ̟ ˧˩
chất diệp lục	t͡ɕ ə t̚ ˧˦ z i ə p̚ ˧˨ ʔ l ʊ w k͡p̚ ˧˨ ʔ
chất lượng	t͡ɕ ə t̚ ˧˦ l ɨ ə ŋ ˧˨ ʔ
chất độc	t͡ɕ ə t̚ ˧˦ ʔ ɗ ə w k͡p̚ ˧˨ ʔ
chầu	t͡ɕ ə w ˨˩
chập mạch	t͡ɕ ə p̚ ˧˨ ʔ m a j k̟̚ ˧˨ ʔ
chắc chắn	t͡ɕ a k̚ ˧˦ t͡ɕ a n ˧˦
chằng	t͡ɕ a ŋ ˨˩
chẳng	t͡ɕ a ŋ ˧˩
chặc	t͡ɕ a k̚ ˧˨ ʔ
chặn	t͡ɕ a n ˧˨ ʔ
chặn đầu	t͡ɕ a n ˧˨ ʔ ʔ ɗ ə w ˨˩
chặng	t͡ɕ a ŋ ˧˨ ʔ
chẽn	t͡ɕ ɛ n ˦˥
chế	t͡ɕ e ˧˦
chế giễu	t͡ɕ e ˧˦ z i ə w ˦˥
chế tác	t͡ɕ e ˧˦ t aː k̚ ˧˦
chế độ ăn kiêng	t͡ɕ e ˧˦ ʔ ɗ o ˧˨ ʔ ʔ a n ˧˧ k i ə ŋ ˧˧
chỉ huy	t͡ɕ i ˧˩ h w i ˧˧
chỉ số	t͡ɕ i ˧˩ s o ˧˦
chỉn chu	t͡ɕ i n ˧˩ t͡ɕ u ˧˧
chỉnh hình	t͡ɕ ï ŋ ˧˩ h ï ŋ ˨˩
chỉnh sửa	t͡ɕ ï ŋ ˧˩ s ɨ ə ˧˩
chị	t͡ɕ i ˧˨ ʔ
chịu chơi	t͡ɕ i w ˧˨ ʔ t͡ɕ əː j ˧˧
chịu đựng	t͡ɕ i w ˧˨ ʔ ʔ ɗ ɨ ŋ ˧˨ ʔ
chọc lét	t͡ɕ a w k͡p̚ ˧˨ ʔ l ɛ t̚ ˧˦
chọn lọc	t͡ɕ ɔ n ˧˨ ʔ l a w k͡p̚ ˧˨ ʔ
chối	t͡ɕ o j ˧˦
chồi	t͡ɕ o j ˨˩
chỗ	t͡ɕ o ˦˥
chộ	t͡ɕ o ˧˨ ʔ
chộp	t͡ɕ o p̚ ˧˨ ʔ
chớp	t͡ɕ əː p̚ ˧˦
chớp nhoáng	t͡ɕ əː p̚ ˧˦ ɲ w aː ŋ ˧˦
chợ	t͡ɕ əː ˧˨ ʔ
chục	t͡ɕ ʊ w k͡p̚ ˧˨ ʔ
chụm	t͡ɕ u m ˧˨ ʔ
chụp	t͡ɕ u p̚ ˧˨ ʔ
chụt	t͡ɕ u t̚ ˧˨ ʔ
chủ nghĩa cộng sản	t͡ɕ u ˧˩ ŋ i ə ˦˥ k ə w ŋ͡m ˧˨ ʔ s aː n ˧˩
chủ nghĩa thế tục	t͡ɕ u ˧˩ ŋ i ə ˦˥ tʰ e ˧˦ t ʊ w k͡p̚ ˧˨ ʔ
chủ nghĩa vô chính phủ	t͡ɕ u ˧˩ ŋ i ə ˦˥ v o ˧˧ t͡ɕ ï ŋ ˧˦ f u ˧˩
chủ nghĩa xét lại	t͡ɕ u ˧˩ ŋ i ə ˦˥ s ɛ t̚ ˧˦ l aː j ˧˨ ʔ
chủ quan	t͡ɕ u ˧˩ k w aː n ˧˧
chủ vắng nhà, gà vọc niêu tôm	t͡ɕ u ˧˩ v a ŋ ˧˦ ɲ aː ˨˩ ɣ aː ˨˩ v a w k͡p̚ ˧˨ ʔ n i ə w ˧˧ t o m ˧˧
chứa đựng	t͡ɕ ɨ ə ˧˦ ʔ ɗ ɨ ŋ ˧˨ ʔ
chứng bệnh	t͡ɕ ɨ ŋ ˧˦ ʔ ɓ ə j ŋ̟ ˧˨ ʔ
chứng chỉ	t͡ɕ ɨ ŋ ˧˦ t͡ɕ i ˧˩
chứng minh	t͡ɕ ɨ ŋ ˧˦ m ï ŋ ˧˧
chứng tỏ	t͡ɕ ɨ ŋ ˧˦ t ɔ ˧˩
chừa	t͡ɕ ɨ ə ˨˩
chừng	t͡ɕ ɨ ŋ ˨˩
chừng mực	t͡ɕ ɨ ŋ ˨˩ m ɨ k̚ ˧˨ ʔ
chửa	t͡ɕ ɨ ə ˧˩
chửa hoang	t͡ɕ ɨ ə ˧˩ h w aː ŋ ˧˧
chửi bới	t͡ɕ ɨ j ˧˩ ʔ ɓ əː j ˧˦
chữ kí	t͡ɕ ɨ ˦˥ k i ˧˦
chữ số có nghĩa	t͡ɕ ɨ ˦˥ s o ˧˦ k ɔ ˧˦ ŋ i ə ˦˥
chững chạc	t͡ɕ ɨ ŋ ˦˥ t͡ɕ aː k̚ ˧˨ ʔ
chực	t͡ɕ ɨ k̚ ˧˨ ʔ
coi	k ɔ j ˧˧
coi thường	k ɔ j ˧˧ tʰ ɨ ə ŋ ˨˩
con này	k ɔ n ˧˧ n a j ˨˩
con trai	k ɔ n ˧˧ t͡ɕ aː j ˧˧
con trai con đứa	k ɔ n ˧˧ t͡ɕ aː j ˧˧ k ɔ n ˧˧ ʔ ɗ ɨ ə ˧˦
con trâu là đầu cơ nghiệp	k ɔ n ˧˧ t͡ɕ ə w ˧˧ l aː ˨˩ ʔ ɗ ə w ˨˩ k əː ˧˧ ŋ i ə p̚ ˧˨ ʔ
con trỏ	k ɔ n ˧˧ t͡ɕ ɔ ˧˩
con đường tơ lụa	k ɔ n ˧˧ ʔ ɗ ɨ ə ŋ ˨˩ t əː ˧˧ l u ə ˧˨ ʔ
cu	k u ˧˧
cu li	k u ˧˧ l i ˧˧
cumingtonit	k əː ˧˧ m ï ŋ ˧˧ t o ˧˧ n i t̚ ˧˦
cun cút	k u n ˧˧ k u t̚ ˧˦
cung đấu	k ʊ w ŋ͡m ˧˧ ʔ ɗ ə w ˧˦
curi	k u ˧˧ ɹ i ˧˧
cuộc sống	k u ə k̚ ˧˨ ʔ s ə w ŋ͡m ˧˦
cà	k aː ˨˩
cà cuống	k aː ˨˩ k u ə ŋ ˧˦
cà dái dê	k aː ˨˩ z aː j ˧˦ z e ˧˧
cà giựt	k aː ˨˩ z ɨ t̚ ˧˨ ʔ
cà lăm	k aː ˨˩ l a m ˧˧
cà nhắc	k aː ˨˩ ɲ a k̚ ˧˦
cà nông	k aː ˨˩ n ə w ŋ͡m ˧˧
cà phê trứng	k aː ˨˩ f e ˧˧ t͡ɕ ɨ ŋ ˧˦
cà rem	k aː ˨˩ ɹ ɛ m ˧˧
cài	k aː j ˨˩
cá	k aː ˧˦
cá chép	k aː ˧˦ t͡ɕ ɛ p̚ ˧˦
cá giếc	k aː ˧˦ z i ə k̚ ˧˦
cá hồi	k aː ˧˦ h o j ˨˩
cá lòng tong	k aː ˧˦ l a w ŋ͡m ˨˩ t a w ŋ͡m ˧˧
cá mè một lứa	k aː ˧˦ m ɛ ˨˩ m o t̚ ˧˨ ʔ l ɨ ə ˧˦
cá mập	k aː ˧˦ m ə p̚ ˧˨ ʔ
cá nhám	k aː ˧˦ ɲ aː m ˧˦
cá nóc	k aː ˧˦ n a w k͡p̚ ˧˦
cá sấu	k aː ˧˦ s ə w ˧˦
cá vàng	k aː ˧˦ v aː ŋ ˨˩
cá đuối	k aː ˧˦ ʔ ɗ u ə j ˧˦
các tông	k aː k̚ ˧˦ t ə w ŋ͡m ˧˧
cách mạng	k a j k̟̚ ˧˦ m aː ŋ ˧˨ ʔ
cái	k aː j ˧˦
cái ghẻ	k aː j ˧˦ ɣ ɛ ˧˩
cái ngàn vàng	k aː j ˧˦ ŋ aː n ˨˩ v aː ŋ ˨˩
cánh cam	k a j ŋ̟ ˧˦ k aː m ˧˧
cánh tả	k a j ŋ̟ ˧˦ t aː ˧˩
cáo	k aː w ˧˦
cáp	k aː p̚ ˧˦
cáp ve	k aː p̚ ˧˦ v ɛ ˧˧
cát kết	k aː t̚ ˧˦ k e t̚ ˧˦
cát lâm	k aː t̚ ˧˦ l ə m ˧˧
cáy	k a j ˧˦
câm	k ə m ˧˧
cân xứng	k ə n ˧˧ s ɨ ŋ ˧˦
câu	k ə w ˧˧
câu chuyện	k ə w ˧˧ t͡ɕ w i ə n ˧˨ ʔ
câu hỏi	k ə w ˧˧ h ɔ j ˧˩
còm	k ɔ m ˨˩
còng	k a w ŋ͡m ˨˩
có công mài sắt có ngày nên kim	k ɔ ˧˦ k ə w ŋ͡m ˧˧ m aː j ˨˩ s a t̚ ˧˦ k ɔ ˧˦ ŋ a j ˨˩ n e n ˧˧ k i m ˧˧
có hậu	k ɔ ˧˦ h ə w ˧˨ ʔ
có thể	k ɔ ˧˦ tʰ e ˧˩
cót	k ɔ t̚ ˧˦
cô	k o ˧˧
cô lập	k o ˧˧ l ə p̚ ˧˨ ʔ
cô ta	k o ˧˧ t aː ˧˧
cô vy	k o ˧˧ v i ˧˧
côi	k o j ˧˧
côn trùng	k o n ˧˧ t͡ɕ ʊ w ŋ͡m ˨˩
công bố	k ə w ŋ͡m ˧˧ ʔ ɓ o ˧˦
công chúa	k ə w ŋ͡m ˧˧ t͡ɕ u ə ˧˦
công cuộc	k ə w ŋ͡m ˧˧ k u ə k̚ ˧˨ ʔ
công kích	k ə w ŋ͡m ˧˧ k ï k̟̚ ˧˦
công nông	k ə w ŋ͡m ˧˧ n ə w ŋ͡m ˧˧
công phu	k ə w ŋ͡m ˧˧ f u ˧˧
công quốc	k ə w ŋ͡m ˧˧ k u ə k̚ ˧˦
công thương	k ə w ŋ͡m ˧˧ tʰ ɨ ə ŋ ˧˧
công ti	k ə w ŋ͡m ˧˧ t i ˧˧
công trình	k ə w ŋ͡m ˧˧ t͡ɕ ï ŋ ˨˩
công tơ	k ə w ŋ͡m ˧˧ t əː ˧˧
công tước	k ə w ŋ͡m ˧˧ t ɨ ə k̚ ˧˦
công việc	k ə w ŋ͡m ˧˧ v i ə k̚ ˧˨ ʔ
công ước	k ə w ŋ͡m ˧˧ ʔ ɨ ə k̚ ˧˦
cù	k u ˨˩
cùi bắp	k u j ˨˩ ʔ ɓ a p̚ ˧˦
cúc	k ʊ w k͡p̚ ˧˦
căn hộ	k a n ˧˧ h o ˧˨ ʔ
căn thức	k a n ˧˧ tʰ ɨ k̚ ˧˦
căng	k a ŋ ˧˧
căng thẳng	k a ŋ ˧˧ tʰ a ŋ ˧˩
cũi	k u j ˦˥
cũng	k ʊ w ŋ͡m ˦˥
cơ	k əː ˧˧
cơ bản	k əː ˧˧ ʔ ɓ aː n ˧˩
cơ chế	k əː ˧˧ t͡ɕ e ˧˦
cơ học lượng tử	k əː ˧˧ h a w k͡p̚ ˧˨ ʔ l ɨ ə ŋ ˧˨ ʔ t ɨ ˧˩
cơ quan	k əː ˧˧ k w aː n ˧˧
cơ sở	k əː ˧˧ s əː ˧˩
cơ sở dữ liệu	k əː ˧˧ s əː ˧˩ z ɨ ˦˥ l i ə w ˧˨ ʔ
cơm	k əː m ˧˧
cơn	k əː n ˧˧
cương	k ɨ ə ŋ ˧˧
cướp biển	k ɨ ə p̚ ˧˦ ʔ ɓ i ə n ˧˩
cười	k ɨ ə j ˨˩
cườm	k ɨ ə m ˨˩
cường thuỷ	k ɨ ə ŋ ˨˩ tʰ w i ˧˩
cưỡng bức	k ɨ ə ŋ ˦˥ ʔ ɓ ɨ k̚ ˧˦
cưỡng dâm	k ɨ ə ŋ ˦˥ z ə m ˧˧
cưỡng hiếp	k ɨ ə ŋ ˦˥ h i ə p̚ ˧˦
cạ	k aː ˧˨ ʔ
cạm	k aː m ˧˨ ʔ
cạn lời	k aː n ˧˨ ʔ l əː j ˨˩
cạnh	k a j ŋ̟ ˧˨ ʔ
cạnh huyền	k a j ŋ̟ ˧˨ ʔ h w i ə n ˨˩
cạnh khoé	k a j ŋ̟ ˧˨ ʔ x w ɛ ˧˦
cạo	k aː w ˧˨ ʔ
cạy cục	k a j ˧˨ ʔ k ʊ w k͡p̚ ˧˨ ʔ
cải biến	k aː j ˧˩ ʔ ɓ i ə n ˧˦
cải bắp	k aː j ˧˩ ʔ ɓ a p̚ ˧˦
cải lương	k aː j ˧˩ l ɨ ə ŋ ˧˧
cảm hứng	k aː m ˧˩ h ɨ ŋ ˧˦
cảm nhận	k aː m ˧˩ ɲ ə n ˧˨ ʔ
cảm tình	k aː m ˧˩ t ï ŋ ˨˩
cảnh quan	k a j ŋ̟ ˧˩ k w aː n ˧˧
cảnh sát	k a j ŋ̟ ˧˩ s aː t̚ ˧˦
cấp độ	k ə p̚ ˧˦ ʔ ɗ o ˧˨ ʔ
cất	k ə t̚ ˧˦
cấu tạo	k ə w ˧˦ t aː w ˧˨ ʔ
cấy	k ə j ˧˦
cấy ghép	k ə j ˧˦ ɣ ɛ p̚ ˧˦
cần sa	k ə n ˨˩ s aː ˧˧
cần thiết	k ə n ˨˩ tʰ i ə t̚ ˧˦
cần thơ	k ə n ˨˩ tʰ əː ˧˧
cầu an	k ə w ˨˩ ʔ aː n ˧˧
cẩm nang	k ə m ˧˩ n aː ŋ ˧˧
cập nhật	k ə p̚ ˧˨ ʔ ɲ ə t̚ ˧˨ ʔ
cậu	k ə w ˧˨ ʔ
cắt	k a t̚ ˧˦
cốm	k o m ˧˦
cốp	k o p̚ ˧˦
cốt cách	k o t̚ ˧˦ k a j k̟̚ ˧˦
cổ hủ	k o ˧˩ h u ˧˩
cổ phần	k o ˧˩ f ə n ˨˩
cổ sinh vật học	k o ˧˩ s ï ŋ ˧˧ v ə t̚ ˧˨ ʔ h a w k͡p̚ ˧˨ ʔ
cổ sự ký	k o ˧˩ s ɨ ˧˨ ʔ k i ˧˦
cổ xưa	k o ˧˩ s ɨ ə ˧˧
cổ điển	k o ˧˩ ʔ ɗ i ə n ˧˩
cổ động	k o ˧˩ ʔ ɗ ə w ŋ͡m ˧˨ ʔ
cộ	k o ˧˨ ʔ
cội nguồn	k o j ˧˨ ʔ ŋ u ə n ˨˩
cộng hòa chuối	k ə w ŋ͡m ˧˨ ʔ h w aː ˨˩ t͡ɕ u ə j ˧˦
cộng sản chủ nghĩa	k ə w ŋ͡m ˧˨ ʔ s aː n ˧˩ t͡ɕ u ˧˩ ŋ i ə ˦˥
cớ	k əː ˧˦
cờ	k əː ˨˩
cờ cá ngựa	k əː ˨˩ k aː ˧˦ ŋ ɨ ə ˧˨ ʔ
cờ vua	k əː ˨˩ v u ə ˧˧
cờ vây	k əː ˨˩ v ə j ˧˧
cỡ	k əː ˦˥
cỡi	k əː j ˦˥
cụ	k u ˧˨ ʔ
cụ thể	k u ˧˨ ʔ tʰ e ˧˩
cục bộ	k ʊ w k͡p̚ ˧˨ ʔ ʔ ɓ o ˧˨ ʔ
cụt lủn	k u t̚ ˧˨ ʔ l u n ˧˩
củ	k u ˧˩
củ năng	k u ˧˩ n a ŋ ˧˧
củ đậu	k u ˧˩ ʔ ɗ ə w ˧˨ ʔ
củi	k u j ˧˩
cứ	k ɨ ˧˦
cứng	k ɨ ŋ ˧˦
cứng nhắc	k ɨ ŋ ˧˦ ɲ a k̚ ˧˦
cứng rắn	k ɨ ŋ ˧˦ z a n ˧˦
cứu chữa	k i w ˧˦ t͡ɕ ɨ ə ˦˥
cứu vớt	k i w ˧˦ v əː t̚ ˧˦
cử chỉ	k ɨ ˧˩ t͡ɕ i ˧˩
cử tạ	k ɨ ˧˩ t aː ˧˨ ʔ
cửa khẩu	k ɨ ə ˧˩ x ə w ˧˩
cửu	k i w ˧˩
cửu vạn	k i w ˧˩ v aː n ˧˨ ʔ
cự giải	k ɨ ˧˨ ʔ z aː j ˧˩
cự li	k ɨ ˧˨ ʔ l i ˧˧
cự đà	k ɨ ˧˨ ʔ ʔ ɗ aː ˨˩
cực khoái	k ɨ k̚ ˧˨ ʔ x w aː j ˧˦
cực kì	k ɨ k̚ ˧˨ ʔ k i ˨˩
cực tiểu	k ɨ k̚ ˧˨ ʔ t i ə w ˧˩
cực trị	k ɨ k̚ ˧˨ ʔ t͡ɕ i ˧˨ ʔ
cực đoan	k ɨ k̚ ˧˨ ʔ ʔ ɗ w aː n ˧˧
da diết	z aː ˧˧ z i ə t̚ ˧˦
da thuộc	z aː ˧˧ tʰ u ə k̚ ˧˨ ʔ
danh nghĩa	z a j ŋ̟ ˧˧ ŋ i ə ˦˥
danh sách	z a j ŋ̟ ˧˧ s a j k̟̚ ˧˦
danh tiếng	z a j ŋ̟ ˧˧ t i ə ŋ ˧˦
danh từ	z a j ŋ̟ ˧˧ t ɨ ˨˩
danh từ hoá	z a j ŋ̟ ˧˧ t ɨ ˨˩ h w aː ˧˦
dao găm	z aː w ˧˧ ɣ a m ˧˧
day dứt	z a j ˧˧ z ɨ t̚ ˧˦
di ngôn	z i ˧˧ ŋ o n ˧˧
di tích	z i ˧˧ t ï k̟̚ ˧˦
di động	z i ˧˧ ʔ ɗ ə w ŋ͡m ˧˨ ʔ
dinh dưỡng	z ï ŋ ˧˧ z ɨ ə ŋ ˦˥
diêm	z i ə m ˧˧
diên vĩ	z i ə n ˧˧ v i ˦˥
diễn	z i ə n ˦˥
diễu hành	z i ə w ˦˥ h a j ŋ̟ ˨˩
diện mạo	z i ə n ˧˨ ʔ m aː w ˧˨ ʔ
diệt chủng	z i ə t̚ ˧˨ ʔ t͡ɕ ʊ w ŋ͡m ˧˩
doanh số	z w a j ŋ̟ ˧˧ s o ˧˦
dong	z a w ŋ͡m ˧˧
dung	z ʊ w ŋ͡m ˧˧
dung dị	z ʊ w ŋ͡m ˧˧ z i ˧˨ ʔ
dung môi	z ʊ w ŋ͡m ˧˧ m o j ˧˧
dung nham	z ʊ w ŋ͡m ˧˧ ɲ aː m ˧˧
dung nhan	z ʊ w ŋ͡m ˧˧ ɲ aː n ˧˧
dung thứ	z ʊ w ŋ͡m ˧˧ tʰ ɨ ˧˦
dung tục	z ʊ w ŋ͡m ˧˧ t ʊ w k͡p̚ ˧˨ ʔ
duy nhất	z w i ˧˧ ɲ ə t̚ ˧˦
duyên phận	z w i ə n ˧˧ f ə n ˧˨ ʔ
duyệt	z w i ə t̚ ˧˨ ʔ
dái	z aː j ˧˦
dáng	z aː ŋ ˧˦
dâm bụt	z ə m ˧˧ ʔ ɓ u t̚ ˧˨ ʔ
dân dã	z ə n ˧˧ z aː ˦˥
dân tộc học	z ə n ˧˧ t ə w k͡p̚ ˧˨ ʔ h a w k͡p̚ ˧˨ ʔ
dâng	z ə ŋ ˧˧
dâu tây	z ə w ˧˧ t ə j ˧˧
dây dưa	z ə j ˧˧ z ɨ ə ˧˧
dây giày	z ə j ˧˧ z a j ˨˩
dây gắm	z ə j ˧˧ ɣ a m ˧˦
dây sống	z ə j ˧˧ s ə w ŋ͡m ˧˦
dã	z aː ˦˥
dè chừng	z ɛ ˨˩ t͡ɕ ɨ ŋ ˨˩
dè dặt	z ɛ ˨˩ z a t̚ ˧˨ ʔ
dìu dắt	z i w ˨˩ z a t̚ ˧˦
dính	z ï ŋ ˧˦
dò hỏi	z ɔ ˨˩ h ɔ j ˧˩
dòm ngó	z ɔ m ˨˩ ŋ ɔ ˧˦
dòng biển	z a w ŋ͡m ˨˩ ʔ ɓ i ə n ˧˩
dóc	z a w k͡p̚ ˧˦
dóm	z ɔ m ˧˦
dõi	z ɔ j ˦˥
dùi	z u j ˨˩
dùi mài	z u j ˨˩ m aː j ˨˩
dĩa bay	z i ə ˦˥ ʔ ɓ a j ˧˧
dũng cảm	z ʊ w ŋ͡m ˦˥ k aː m ˧˩
dơi quạ	z əː j ˧˧ k w aː ˧˨ ʔ
dư luận	z ɨ ˧˧ l w ə n ˧˨ ʔ
dư thừa	z ɨ ˧˧ tʰ ɨ ə ˨˩
dương	z ɨ ə ŋ ˧˧
dương cầm	z ɨ ə ŋ ˧˧ k ə m ˨˩
dương mai	z ɨ ə ŋ ˧˧ m aː j ˧˧
dương sóc	z ɨ ə ŋ ˧˧ s a w k͡p̚ ˧˦
dường nào	z ɨ ə ŋ ˨˩ n aː w ˨˩
dược phẩm	z ɨ ə k̚ ˧˨ ʔ f ə m ˧˩
dược sĩ	z ɨ ə k̚ ˧˨ ʔ s i ˦˥
dượng	z ɨ ə ŋ ˧˨ ʔ
dại dột	z aː j ˧˨ ʔ z o t̚ ˧˨ ʔ
dạng	z aː ŋ ˧˨ ʔ
dạy	z a j ˧˨ ʔ
dạy bảo	z a j ˧˨ ʔ ʔ ɓ aː w ˧˩
dấm đài	z ə m ˧˦ ʔ ɗ aː j ˨˩
dấu hỏi	z ə w ˧˦ h ɔ j ˧˩
dấu ngã	z ə w ˧˦ ŋ aː ˦˥
dầu cải dầu	z ə w ˨˩ k aː j ˧˩ z ə w ˨˩
dầu gan cá	z ə w ˨˩ ɣ aː n ˧˧ k aː ˧˦
dầu gió	z ə w ˨˩ z ɔ ˧˦
dầu hoả	z ə w ˨˩ h w aː ˧˩
dầu mỏ	z ə w ˨˩ m ɔ ˧˩
dẫn	z ə n ˦˥
dẫn dụ	z ə n ˦˥ z u ˧˨ ʔ
dẫn đầu	z ə n ˦˥ ʔ ɗ ə w ˨˩
dẫn độ	z ə n ˦˥ ʔ ɗ o ˧˨ ʔ
dậy thì	z ə j ˧˨ ʔ tʰ i ˨˩
dằm	z a m ˨˩
dằng dặc	z a ŋ ˨˩ z a k̚ ˧˨ ʔ
dặm	z a m ˧˨ ʔ
dẽ	z ɛ ˦˥
dế	z e ˧˦
dế nhũi	z e ˧˦ ɲ u j ˦˥
dễ dàng	z e ˦˥ z aː ŋ ˨˩
dị giáo	z i ˧˨ ʔ z aː w ˧˦
dị ứng	z i ˧˨ ʔ ʔ ɨ ŋ ˧˦
dịch thuật	z ï k̟̚ ˧˨ ʔ tʰ w ə t̚ ˧˨ ʔ
dỏ	z ɔ ˧˩
dốt	z o t̚ ˧˦
dồi	z o j ˨˩
dỗ	z o ˦˥
dở dở ương ương	z əː ˧˩ z əː ˧˩ ʔ ɨ ə ŋ ˧˧ ʔ ɨ ə ŋ ˧˧
dụ	z u ˧˨ ʔ
dứa	z ɨ ə ˧˦
dứt khoát	z ɨ t̚ ˧˦ x w aː t̚ ˧˦
dừng	z ɨ ŋ ˨˩
dự phòng	z ɨ ˧˨ ʔ f a w ŋ͡m ˨˩
dự trữ	z ɨ ˧˨ ʔ t͡ɕ ɨ ˦˥
dự đoán	z ɨ ˧˨ ʔ ʔ ɗ w aː n ˧˦
dựng xây	z ɨ ŋ ˧˨ ʔ s ə j ˧˧
e ngại	ʔ ɛ ˧˧ ŋ aː j ˧˨ ʔ
em vợ	ʔ ɛ m ˧˧ v əː ˧˨ ʔ
em yêu anh	ʔ ɛ m ˧˧ ʔ i ə w ˧˧ ʔ a j ŋ̟ ˧˧
eo	ʔ ɛ w ˧˧
flerovi	f l e ˧˧ ɹ ɔ ˧˧ v i ˧˧
franxi	f ɹ aː n ˧˧ s i ˧˧
gai	ɣ aː j ˧˧
gai góc	ɣ aː j ˧˧ ɣ a w k͡p̚ ˧˦
gan	ɣ aː n ˧˧
gan ngỗng béo	ɣ aː n ˧˧ ŋ ə w ŋ͡m ˦˥ ʔ ɓ ɛ w ˧˦
gan nhiễm mỡ	ɣ aː n ˧˧ ɲ i ə m ˦˥ m əː ˦˥
ghen tức	ɣ ɛ n ˧˧ t ɨ k̚ ˧˦
ghi nhận	ɣ i ˧˧ ɲ ə n ˧˨ ʔ
ghè	ɣ ɛ ˨˩
ghèn	ɣ ɛ n ˨˩
ghép	ɣ ɛ p̚ ˧˦
ghế	ɣ e ˧˦
ghệt	ɣ e t̚ ˧˨ ʔ
gia	z aː ˧˧
gia tốc	z aː ˧˧ t ə w k͡p̚ ˧˦
giai	z aː j ˧˧
giam	z aː m ˧˧
giang tô	z aː ŋ ˧˧ t o ˧˧
giao hoán	z aː w ˧˧ h w aː n ˧˦
giao hưởng	z aː w ˧˧ h ɨ ə ŋ ˧˩
giao thương	z aː w ˧˧ tʰ ɨ ə ŋ ˧˧
giao tiếp	z aː w ˧˧ t i ə p̚ ˧˦
giun tròn	z u n ˧˧ t͡ɕ ɔ n ˨˩
giuđa	z u ˧˧ ʔ ɗ aː ˧˧
giuđa ítcariốt	z u ˧˧ ʔ ɗ aː ˧˧ ʔ i t̚ ˧˦ k aː ˧˧ z i ˧˧ ʔ o t̚ ˧˦
già lam	z aː ˨˩ l aː m ˧˧
giàng	z aː ŋ ˨˩
giành	z a j ŋ̟ ˨˩
giành giật	z a j ŋ̟ ˨˩ z ə t̚ ˧˨ ʔ
giàu	z a w ˨˩
giày	z a j ˨˩
giá trị	z aː ˧˦ t͡ɕ i ˧˨ ʔ
giác quan	z aː k̚ ˧˦ k w aː n ˧˧
giáng	z aː ŋ ˧˦
giáng hạ	z aː ŋ ˧˦ h aː ˧˨ ʔ
giáng sinh	z aː ŋ ˧˦ s ï ŋ ˧˧
giáo dục quốc phòng	z aː w ˧˦ z ʊ w k͡p̚ ˧˨ ʔ k u ə k̚ ˧˦ f a w ŋ͡m ˨˩
giáo hội công giáo	z aː w ˧˦ h o j ˧˨ ʔ k ə w ŋ͡m ˧˧ z aː w ˧˦
giáp cốt văn	z aː p̚ ˧˦ k o t̚ ˧˦ v a n ˧˧
giây phút	z ə j ˧˧ f u t̚ ˧˦
giãi bày	z aː j ˦˥ ʔ ɓ a j ˨˩
giê	z e ˧˧
gió lốc	z ɔ ˧˦ l ə w k͡p̚ ˧˦
giăm	z a m ˧˧
giương	z ɨ ə ŋ ˧˧
giả bộ	z aː ˧˩ ʔ ɓ o ˧˨ ʔ
giả kim thuật	z aː ˧˩ k i m ˧˧ tʰ w ə t̚ ˧˨ ʔ
giả thiết	z aː ˧˩ tʰ i ə t̚ ˧˦
giả thuyết	z aː ˧˩ tʰ w i ə t̚ ˧˦
giả tá	z aː ˧˩ t aː ˧˦
giải khát	z aː j ˧˩ x aː t̚ ˧˦
giải phẫu học	z aː j ˧˩ f ə w ˦˥ h a w k͡p̚ ˧˨ ʔ
giải quyết	z aː j ˧˩ k w i ə t̚ ˧˦
giải tán	z aː j ˧˩ t aː n ˧˦
giảm tốc	z aː m ˧˩ t ə w k͡p̚ ˧˦
giản thể	z aː n ˧˩ tʰ e ˧˩
giản đơn	z aː n ˧˩ ʔ ɗ əː n ˧˧
giảng	z aː ŋ ˧˩
giảnh	z a j ŋ̟ ˧˩
giấm trắng	z ə m ˧˦ t͡ɕ a ŋ ˧˦
giấy bạc	z ə j ˧˦ ʔ ɓ aː k̚ ˧˨ ʔ
giấy nhám	z ə j ˧˦ ɲ aː m ˧˦
giấy ướt	z ə j ˧˦ ʔ ɨ ə t̚ ˧˦
giầy	z ə j ˨˩
giận dỗi	z ə n ˧˨ ʔ z o j ˦˥
giận dữ	z ə n ˧˨ ʔ z ɨ ˦˥
giật	z ə t̚ ˧˨ ʔ
giật mình	z ə t̚ ˧˨ ʔ m ï ŋ ˨˩
giậu	z ə w ˧˨ ʔ
giằm	z a m ˨˩
giặt giũ	z a t̚ ˧˨ ʔ z u ˦˥
giặt gỵa	z a t̚ ˧˨ ʔ z i ə ˧˨ ʔ
giẹp	z ɛ p̚ ˧˨ ʔ
giễu	z i ə w ˦˥
giỏ	z ɔ ˧˩
giống đực	z ə w ŋ͡m ˧˦ ʔ ɗ ɨ k̚ ˧˨ ʔ
giỗ	z o ˦˥
giờ dây thun	z əː ˨˩ z ə j ˧˧ tʰ u n ˧˧
giờ dậu	z əː ˨˩ z ə w ˧˨ ʔ
giờ khắc	z əː ˨˩ x a k̚ ˧˦
giờ mão	z əː ˨˩ m aː w ˦˥
giờ đây	z əː ˨˩ ʔ ɗ ə j ˧˧
giời leo	z əː j ˨˩ l ɛ w ˧˧
giữ	z ɨ ˦˥
giữ chỗ	z ɨ ˦˥ t͡ɕ o ˦˥
giựt	z ɨ t̚ ˧˨ ʔ
gom	ɣ ɔ m ˧˧
goá	ɣ w aː ˧˦
grêgôriô	z e ˧˧ ɣ o ˧˧ z i ˧˧ ʔ o ˧˧
gu	ɣ u ˧˧
guồng	ɣ u ə ŋ ˨˩
gài	ɣ aː j ˨˩
gàn	ɣ aː n ˨˩
gàu	ɣ a w ˨˩
gác bút	ɣ aː k̚ ˧˦ ʔ ɓ u t̚ ˧˦
gái bán hoa	ɣ aː j ˧˦ ʔ ɓ aː n ˧˦ h w aː ˧˧
gái nhảy	ɣ aː j ˧˦ ɲ a j ˧˩
gái điếm	ɣ aː j ˧˦ ʔ ɗ i ə m ˧˦
gán	ɣ aː n ˧˦
gây mê	ɣ ə j ˧˧ m e ˧˧
gãy	ɣ a j ˦˥
góc	ɣ a w k͡p̚ ˧˦
góc bẹt	ɣ a w k͡p̚ ˧˦ ʔ ɓ ɛ t̚ ˧˨ ʔ
góc cạnh	ɣ a w k͡p̚ ˧˦ k a j ŋ̟ ˧˨ ʔ
góc phương vị	ɣ a w k͡p̚ ˧˦ f ɨ ə ŋ ˧˧ v i ˧˨ ʔ
góp	ɣ ɔ p̚ ˧˦
góp ý	ɣ ɔ p̚ ˧˦ ʔ i ˧˦
gôn	ɣ o n ˧˧
gông	ɣ ə w ŋ͡m ˧˧
gù	ɣ u ˨˩
gút	ɣ u t̚ ˧˦
găng tay	ɣ a ŋ ˧˧ t a j ˧˧
gương mặt	ɣ ɨ ə ŋ ˧˧ m a t̚ ˧˨ ʔ
gượng	ɣ ɨ ə ŋ ˧˨ ʔ
gạo lứt	ɣ aː w ˧˨ ʔ l ɨ t̚ ˧˦
gạt tàn	ɣ aː t̚ ˧˨ ʔ t aː n ˨˩
gảy	ɣ a j ˧˩
gấc	ɣ ə k̚ ˧˦
gấp	ɣ ə p̚ ˧˦
gấu chó	ɣ ə w ˧˦ t͡ɕ ɔ ˧˦
gấu trúc	ɣ ə w ˧˦ t͡ɕ ʊ w k͡p̚ ˧˦
gấu túi	ɣ ə w ˧˦ t u j ˧˦
gấy	ɣ ə j ˧˦
gần gũi	ɣ ə n ˨˩ ɣ u j ˦˥
gần mực thì đen, gần đèn thì rạng	ɣ ə n ˨˩ m ɨ k̚ ˧˨ ʔ tʰ i ˨˩ ʔ ɗ ɛ n ˧˧ ɣ ə n ˨˩ ʔ ɗ ɛ n ˨˩ tʰ i ˨˩ z aː ŋ ˧˨ ʔ
gần như	ɣ ə n ˨˩ ɲ ɨ ˧˧
gật	ɣ ə t̚ ˧˨ ʔ
gặm	ɣ a m ˧˨ ʔ
gặp gỡ	ɣ a p̚ ˧˨ ʔ ɣ əː ˦˥
gọn	ɣ ɔ n ˧˨ ʔ
gọn gàng	ɣ ɔ n ˧˨ ʔ ɣ aː ŋ ˨˩
gỏi	ɣ ɔ j ˧˩
gỏi cuốn	ɣ ɔ j ˧˩ k u ə n ˧˦
gốc	ɣ ə w k͡p̚ ˧˦
gốc gác	ɣ ə w k͡p̚ ˧˦ ɣ aː k̚ ˧˦
gốc rễ	ɣ ə w k͡p̚ ˧˦ z e ˦˥
gồng	ɣ ə w ŋ͡m ˨˩
gộc	ɣ ə w k͡p̚ ˧˨ ʔ
gớm ghiếc	ɣ əː m ˧˦ ɣ i ə k̚ ˧˦
gờ kép	ɣ əː ˨˩ k ɛ p̚ ˧˦
gờm	ɣ əː m ˨˩
gỡ bỏ	ɣ əː ˦˥ ʔ ɓ ɔ ˧˩
gợi cảm	ɣ əː j ˧˨ ʔ k aː m ˧˩
gửi	ɣ ɨ j ˧˩
hai bà trưng	h aː j ˧˧ ʔ ɓ aː ˨˩ t͡ɕ ɨ ŋ ˧˧
hai chấm	h aː j ˧˧ t͡ɕ ə m ˧˦
hai lúa	h aː j ˧˧ l u ə ˧˦
ham	h aː m ˧˧
hao hao	h aː w ˧˧ h aː w ˧˧
heo	h ɛ w ˧˧
heo quay	h ɛ w ˧˧ k w a j ˧˧
hi hữu	h i ˧˧ h i w ˦˥
hia	h i ə ˧˧
hic	h ï k̟̚ ˧˦
hilariô	h i ˧˧ l aː ˧˧ z i ˧˧ ʔ o ˧˧
hiên	h i ə n ˧˧
hiếm khi	h i ə m ˧˦ x i ˧˧
hiến dâng	h i ə n ˧˦ z ə ŋ ˧˧
hiếp	h i ə p̚ ˧˦
hiếu học	h i ə w ˧˦ h a w k͡p̚ ˧˨ ʔ
hiếu kinh	h i ə w ˧˦ k ï ŋ ˧˧
hiền hoà	h i ə n ˨˩ h w aː ˨˩
hiền lành	h i ə n ˨˩ l a j ŋ̟ ˨˩
hiểm nguy	h i ə m ˧˩ ŋ w i ˧˧
hiển hiện	h i ə n ˧˩ h i ə n ˧˨ ʔ
hiệp sĩ	h i ə p̚ ˧˨ ʔ s i ˦˥
hiệp vần	h i ə p̚ ˧˨ ʔ v ə n ˨˩
hiệp định	h i ə p̚ ˧˨ ʔ ʔ ɗ ï ŋ ˧˨ ʔ
hiệu	h i ə w ˧˨ ʔ
hiệu phó	h i ə w ˧˨ ʔ f ɔ ˧˦
hiệu suất	h i ə w ˧˨ ʔ s w ə t̚ ˧˦
hiệu thuốc	h i ə w ˧˨ ʔ tʰ u ə k̚ ˧˦
hoa	h w aː ˧˧
hoa hồng	h w aː ˧˧ h ə w ŋ͡m ˨˩
hoa kim châm	h w aː ˧˧ k i m ˧˧ t͡ɕ ə m ˧˧
hoa lơ	h w aː ˧˧ l əː ˧˧
hoa quả	h w aː ˧˧ k w aː ˧˩
hoa thịnh đốn	h w aː ˧˧ tʰ ï ŋ ˧˨ ʔ ʔ ɗ o n ˧˦
hoang	h w aː ŋ ˧˧
hoà nhập	h w aː ˨˩ ɲ ə p̚ ˧˨ ʔ
hoài	h w aː j ˨˩
hoàn hảo	h w aː n ˨˩ h aː w ˧˩
hoàn mĩ	h w aː n ˨˩ m i ˦˥
hoàn vũ	h w aː n ˨˩ v u ˦˥
hoàng	h w aː ŋ ˨˩
hoàng hạc lâu	h w aː ŋ ˨˩ h aː k̚ ˧˨ ʔ l ə w ˧˧
hoàng sa	h w aː ŋ ˨˩ s aː ˧˧
hoá học vô cơ	h w aː ˧˦ h a w k͡p̚ ˧˨ ʔ v o ˧˧ k əː ˧˧
hoá trị	h w aː ˧˦ t͡ɕ i ˧˨ ʔ
hoá đơn	h w aː ˧˦ ʔ ɗ əː n ˧˧
hoè	h w ɛ ˨˩
hoạ sĩ	h w aː ˧˨ ʔ s i ˦˥
hoạt hình	h w aː t̚ ˧˨ ʔ h ï ŋ ˨˩
hoạt động	h w aː t̚ ˧˨ ʔ ʔ ɗ ə w ŋ͡m ˧˨ ʔ
hoả hoạn	h w aː ˧˩ h w aː n ˧˨ ʔ
hoảng	h w aː ŋ ˧˩
hoảng loạn	h w aː ŋ ˧˩ l w aː n ˧˨ ʔ
hoặc	h w a k̚ ˧˨ ʔ
hun	h u n ˧˧
hung hăng	h ʊ w ŋ͡m ˧˧ h a ŋ ˧˧
huy chương	h w i ˧˧ t͡ɕ ɨ ə ŋ ˧˧
huyết thanh	h w i ə t̚ ˧˦ tʰ a j ŋ̟ ˧˧
huyết áp	h w i ə t̚ ˧˦ ʔ aː p̚ ˧˦
huân chương	h w ə n ˧˧ t͡ɕ ɨ ə ŋ ˧˧
huấn luyện	h w ə n ˧˦ l w i ə n ˧˨ ʔ
huề	h w e ˨˩
huống	h u ə ŋ ˧˦
huống gì	h u ə ŋ ˧˦ z i ˨˩
huỳnh huỵch	h w ï ŋ̟ ˨˩ h w ï k̟̚ ˧˨ ʔ
hypebol	h i ˧˧ p ɛ ˧˧ ʔ ɓ ɔ n ˧˧
hà	h aː ˨˩
hà liên	h aː ˨˩ l i ə n ˧˧
hà lội	h aː ˨˩ l o j ˧˨ ʔ
hà nhì	h aː ˨˩ ɲ i ˨˩
hà nội	h aː ˨˩ n o j ˧˨ ʔ
hà thành	h aː ˨˩ tʰ a j ŋ̟ ˨˩
hà tĩnh	h aː ˨˩ t ï ŋ ˦˥
hài hoà	h aː j ˨˩ h w aː ˨˩
hàm lượng	h aː m ˨˩ l ɨ ə ŋ ˧˨ ʔ
hàm ý	h aː m ˨˩ ʔ i ˧˦
hàn gắn	h aː n ˨˩ ɣ a n ˧˦
hàng không vũ trụ	h aː ŋ ˨˩ x ə w ŋ͡m ˧˧ v u ˦˥ t͡ɕ u ˧˨ ʔ
hàng loạt	h aː ŋ ˨˩ l w aː t̚ ˧˨ ʔ
hàng xóm	h aː ŋ ˨˩ s ɔ m ˧˦
hành	h a j ŋ̟ ˨˩
hành hương	h a j ŋ̟ ˨˩ h ɨ ə ŋ ˧˧
hành nghề	h a j ŋ̟ ˨˩ ŋ e ˨˩
hành pháp	h a j ŋ̟ ˨˩ f aː p̚ ˧˦
hành xử	h a j ŋ̟ ˨˩ s ɨ ˧˩
hào hiệp	h aː w ˨˩ h i ə p̚ ˧˨ ʔ
hào kiệt	h aː w ˨˩ k i ə t̚ ˧˨ ʔ
hào phóng	h aː w ˨˩ f a w ŋ͡m ˧˦
hàu	h a w ˨˩
há	h aː ˧˦
hán học	h aː n ˧˦ h a w k͡p̚ ˧˨ ʔ
hán nô	h aː n ˧˦ n o ˧˧
hán tộc	h aː n ˧˦ t ə w k͡p̚ ˧˨ ʔ
hán việt	h aː n ˧˦ v i ə t̚ ˧˨ ʔ
hán văn	h aː n ˧˦ v a n ˧˧
hát	h aː t̚ ˧˦
hát hò	h aː t̚ ˧˦ h ɔ ˨˩
hát ru	h aː t̚ ˧˦ z u ˧˧
hát xướng	h aː t̚ ˧˦ s ɨ ə ŋ ˧˦
hãm hại	h aː m ˦˥ h aː j ˧˨ ʔ
hãn quốc	h aː n ˦˥ k u ə k̚ ˧˦
hãng	h aː ŋ ˦˥
hình bình hành	h ï ŋ ˨˩ ʔ ɓ ï ŋ ˨˩ h a j ŋ̟ ˨˩
hình chóp	h ï ŋ ˨˩ t͡ɕ ɔ p̚ ˧˦
hình nón	h ï ŋ ˨˩ n ɔ n ˧˦
hình phạt	h ï ŋ ˨˩ f aː t̚ ˧˨ ʔ
hình thức	h ï ŋ ˨˩ tʰ ɨ k̚ ˧˦
hình trụ	h ï ŋ ˨˩ t͡ɕ u ˧˨ ʔ
hình ảnh	h ï ŋ ˨˩ ʔ a j ŋ̟ ˧˩
hít thở	h i t̚ ˧˦ tʰ əː ˧˩
hò hẹn	h ɔ ˨˩ h ɛ n ˧˨ ʔ
hòm	h ɔ m ˨˩
hòn	h ɔ n ˨˩
hóa học vật lý	h w aː ˧˦ h a w k͡p̚ ˧˨ ʔ v ə t̚ ˧˨ ʔ l i ˧˦
hóng	h a w ŋ͡m ˧˦
hôn mê	h o n ˧˧ m e ˧˧
hôn nhân	h o n ˧˧ ɲ ə n ˧˧
hôn phu	h o n ˧˧ f u ˧˧
hôn thê	h o n ˧˧ tʰ e ˧˧
hôn thú	h o n ˧˧ tʰ u ˧˦
hông	h ə w ŋ͡m ˧˧
hù	h u ˨˩
hùm	h u m ˨˩
hùng	h ʊ w ŋ͡m ˨˩
hùng hùng hổ hổ	h ʊ w ŋ͡m ˨˩ h ʊ w ŋ͡m ˨˩ h o ˧˩ h o ˧˩
hú vía	h u ˧˦ v i ə ˧˦
húc	h ʊ w k͡p̚ ˧˦
hũ	h u ˦˥
hơ	h əː ˧˧
hơi bị	h əː j ˧˧ ʔ ɓ i ˧˨ ʔ
hơn	h əː n ˧˧
hơn cả	h əː n ˧˧ k aː ˧˩
hưng yên	h ɨ ŋ ˧˧ ʔ i ə n ˧˧
hưu bổng	h i w ˧˧ ʔ ɓ ə w ŋ͡m ˧˩
hưu trí	h i w ˧˧ t͡ɕ i ˧˦
hươu cao cổ	h i ə w ˧˧ k aː w ˧˧ k o ˧˩
hươu sao	h i ə w ˧˧ s aː w ˧˧
hưởng	h ɨ ə ŋ ˧˩
hạ	h aː ˧˨ ʔ
hạ cánh	h aː ˧˨ ʔ k a j ŋ̟ ˧˦
hạ sách	h aː ˧˨ ʔ s a j k̟̚ ˧˦
hạ sĩ quan	h aː ˧˨ ʔ s i ˦˥ k w aː n ˧˧
hạ uy di	h aː ˧˨ ʔ ʔ w i ˧˧ z i ˧˧
hạm	h aː m ˧˨ ʔ
hạn hán	h aː n ˧˨ ʔ h aː n ˧˦
hạo	h aː w ˧˨ ʔ
hạt cải dầu	h aː t̚ ˧˨ ʔ k aː j ˧˩ z ə w ˨˩
hải cẩu	h aː j ˧˩ k ə w ˧˩
hải lưu	h aː j ˧˩ l i w ˧˧
hải nam	h aː j ˧˩ n aː m ˧˧
hải ngoại	h aː j ˧˩ ŋ w aː j ˧˨ ʔ
hải quỳ	h aː j ˧˩ k w i ˨˩
hải sâm	h aː j ˧˩ s ə m ˧˧
hải sản	h aː j ˧˩ s aː n ˧˩
hải vương tinh	h aː j ˧˩ v ɨ ə ŋ ˧˧ t ï ŋ ˧˧
hải vị	h aː j ˧˩ v i ˧˨ ʔ
hảo ngọt	h aː w ˧˩ ŋ ɔ t̚ ˧˨ ʔ
hấp thu	h ə p̚ ˧˦ tʰ u ˧˧
hầu	h ə w ˨˩
hậu quả	h ə w ˧˨ ʔ k w aː ˧˩
hắc	h a k̚ ˧˦
hắt	h a t̚ ˧˦
hắt hơi	h a t̚ ˧˦ h əː j ˧˧
hằng nga	h a ŋ ˨˩ ŋ aː ˧˧
hằng số	h a ŋ ˨˩ s o ˧˦
hẳn	h a n ˧˩
hếch	h ə j k̟̚ ˧˦
hết mình	h e t̚ ˧˦ m ï ŋ ˨˩
hết mực	h e t̚ ˧˦ m ɨ k̚ ˧˨ ʔ
hết trơn	h e t̚ ˧˦ t͡ɕ əː n ˧˧
hệ thống	h e ˧˨ ʔ tʰ ə w ŋ͡m ˧˦
hệ toạ độ	h e ˧˨ ʔ t w aː ˧˨ ʔ ʔ ɗ o ˧˨ ʔ
hệ trọng	h e ˧˨ ʔ t͡ɕ a w ŋ͡m ˧˨ ʔ
hệt	h e t̚ ˧˨ ʔ
họ	h ɔ ˧˨ ʔ
học hành	h a w k͡p̚ ˧˨ ʔ h a j ŋ̟ ˨˩
học nhi bất tư, tắc võng	h a w k͡p̚ ˧˨ ʔ ɲ i ˧˧ ʔ ɓ ə t̚ ˧˦ t ɨ ˧˧ t a k̚ ˧˦ v a w ŋ͡m ˦˥
học thêm	h a w k͡p̚ ˧˨ ʔ tʰ e m ˧˧
học viện	h a w k͡p̚ ˧˨ ʔ v i ə n ˧˨ ʔ
họp hành	h ɔ p̚ ˧˨ ʔ h a j ŋ̟ ˨˩
hỏi han	h ɔ j ˧˩ h aː n ˧˧
hố	h o ˧˦
hố phân	h o ˧˦ f ə n ˧˧
hố xí	h o ˧˦ s i ˧˦
hốc	h ə w k͡p̚ ˧˦
hối	h o j ˧˦
hối hận	h o j ˧˦ h ə n ˧˨ ʔ
hồ bắc	h o ˨˩ ʔ ɓ a k̚ ˧˦
hồ chí minh	h o ˨˩ t͡ɕ i ˧˦ m ï ŋ ˧˧
hồ hoàn kiếm	h o ˨˩ h w aː n ˨˩ k i ə m ˧˦
hồ tây	h o ˨˩ t ə j ˧˧
hồi sức	h o j ˨˩ s ɨ k̚ ˧˦
hồn	h o n ˨˩
hồng mao	h ə w ŋ͡m ˨˩ m aː w ˧˧
hổ	h o ˧˩
hổ sư	h o ˧˩ s ɨ ˧˧
hổi	h o j ˧˩
hổm	h o m ˧˩
hội hè	h o j ˧˨ ʔ h ɛ ˨˩
hội đồng nhân dân	h o j ˧˨ ʔ ʔ ɗ ə w ŋ͡m ˨˩ ɲ ə n ˧˧ z ə n ˧˧
hột vịt lộn	h o t̚ ˧˨ ʔ v i t̚ ˧˨ ʔ l o n ˧˨ ʔ
hớn hở	h əː n ˧˦ h əː ˧˩
hớt tóc	h əː t̚ ˧˦ t a w k͡p̚ ˧˦
hở	h əː ˧˩
hợi	h əː j ˧˨ ʔ
hợp	h əː p̚ ˧˨ ʔ
hợp chúng quốc	h əː p̚ ˧˨ ʔ t͡ɕ ʊ w ŋ͡m ˧˦ k u ə k̚ ˧˦
hợp chủng quốc	h əː p̚ ˧˨ ʔ t͡ɕ ʊ w ŋ͡m ˧˩ k u ə k̚ ˧˦
hợp kim	h əː p̚ ˧˨ ʔ k i m ˧˧
hợp âm	h əː p̚ ˧˨ ʔ ʔ ə m ˧˧
hợp âm rải	h əː p̚ ˧˨ ʔ ʔ ə m ˧˧ z aː j ˧˩
hợp đồng	h əː p̚ ˧˨ ʔ ʔ ɗ ə w ŋ͡m ˨˩
hụp	h u p̚ ˧˨ ʔ
hủ mộc bất khả điêu	h u ˧˩ m ə w k͡p̚ ˧˨ ʔ ʔ ɓ ə t̚ ˧˦ x aː ˧˩ ʔ ɗ i ə w ˧˧
hửi	h ɨ j ˧˩
hữu cơ	h i w ˦˥ k əː ˧˧
im ắng	ʔ i m ˧˧ ʔ a ŋ ˧˦
in	ʔ i n ˧˧
in ấn	ʔ i n ˧˧ ʔ ə n ˧˦
iu	ʔ i w ˧˧
kem	k ɛ m ˧˧
kem dâu	k ɛ m ˧˧ z ə w ˧˧
kem đánh răng	k ɛ m ˧˧ ʔ ɗ a j ŋ̟ ˧˦ z a ŋ ˧˧
ken	k ɛ n ˧˧
keo kiệt	k ɛ w ˧˧ k i ə t̚ ˧˨ ʔ
khai hoá	x aː j ˧˧ h w aː ˧˦
khai huyệt	x aː j ˧˧ h w i ə t̚ ˧˨ ʔ
khai quật	x aː j ˧˧ k w ə t̚ ˧˨ ʔ
khay	x a j ˧˧
khinh	x ï ŋ ˧˧
khinh khí cầu	x ï ŋ ˧˧ x i ˧˦ k ə w ˨˩
khinh thị	x ï ŋ ˧˧ tʰ i ˧˨ ʔ
khiếm thị	x i ə m ˧˦ tʰ i ˧˨ ʔ
khiến	x i ə n ˧˦
khiếu	x i ə w ˧˦
khoa học thần kinh	x w aː ˧˧ h a w k͡p̚ ˧˨ ʔ tʰ ə n ˨˩ k ï ŋ ˧˧
khoai tây chiên	x w aː j ˧˧ t ə j ˧˧ t͡ɕ i ə n ˧˧
khoái	x w aː j ˧˦
khoáng vật học	x w aː ŋ ˧˦ v ə t̚ ˧˨ ʔ h a w k͡p̚ ˧˨ ʔ
khoé	x w ɛ ˧˦
khoảng	x w aː ŋ ˧˩
khoảng cách	x w aː ŋ ˧˩ k a j k̟̚ ˧˦
khuya	x w i ə ˧˧
khuyên	x w i ə n ˧˧
khuyến khích	x w i ə n ˧˦ x ï k̟̚ ˧˦
khuyến nông	x w i ə n ˧˦ n ə w ŋ͡m ˧˧
khuyết tịch	x w i ə t̚ ˧˦ t ï k̟̚ ˧˨ ʔ
khuôn mẫu	x u ə n ˧˧ m ə w ˦˥
khuôn mặt	x u ə n ˧˧ m a t̚ ˧˨ ʔ
khuất	x w ə t̚ ˧˦
khuỷu	x w i w ˧˩
khàn	x aː n ˨˩
khám bệnh	x aː m ˧˦ ʔ ɓ ə j ŋ̟ ˧˨ ʔ
kháng cáo	x aː ŋ ˧˦ k aː w ˧˦
khánh	x a j ŋ̟ ˧˦
khánh hoà	x a j ŋ̟ ˧˦ h w aː ˨˩
khát vọng	x aː t̚ ˧˦ v a w ŋ͡m ˧˨ ʔ
khéo	x ɛ w ˧˦
khét tiếng	x ɛ t̚ ˧˦ t i ə ŋ ˧˦
khêu	x e w ˧˧
khí	x i ˧˦
khí cầu	x i ˧˦ k ə w ˨˩
khí hậu	x i ˧˦ h ə w ˧˨ ʔ
khí khổng	x i ˧˦ x ə w ŋ͡m ˧˩
khí lí tưởng	x i ˧˦ l i ˧˦ t ɨ ə ŋ ˧˩
khía	x i ə ˧˦
khía cạnh	x i ə ˧˦ k a j ŋ̟ ˧˨ ʔ
khó khăn	x ɔ ˧˦ x a n ˧˧
khóc	x a w k͡p̚ ˧˦
khóm	x ɔ m ˧˦
khô khan	x o ˧˧ x aː n ˧˧
khôi	x o j ˧˧
khôn ba năm, dại một giờ	x o n ˧˧ ʔ ɓ aː ˧˧ n a m ˧˧ z aː j ˧˨ ʔ m o t̚ ˧˨ ʔ z əː ˨˩
khôn lường	x o n ˧˧ l ɨ ə ŋ ˨˩
không bao giờ	x ə w ŋ͡m ˧˧ ʔ ɓ aː w ˧˧ z əː ˨˩
không có chi	x ə w ŋ͡m ˧˧ k ɔ ˧˦ t͡ɕ i ˧˧
không có lửa làm sao có khói	x ə w ŋ͡m ˧˧ k ɔ ˧˦ l ɨ ə ˧˩ l aː m ˨˩ s aː w ˧˧ k ɔ ˧˦ x ɔ j ˧˦
không khí	x ə w ŋ͡m ˧˧ x i ˧˦
không thành kế	x ə w ŋ͡m ˧˧ tʰ a j ŋ̟ ˨˩ k e ˧˦
không tưởng	x ə w ŋ͡m ˧˧ t ɨ ə ŋ ˧˩
khùng	x ʊ w ŋ͡m ˨˩
khùng khục	x ʊ w ŋ͡m ˨˩ x ʊ w k͡p̚ ˧˨ ʔ
khúc xạ	x ʊ w k͡p̚ ˧˦ s aː ˧˨ ʔ
khăm	x a m ˧˧
khăn	x a n ˧˧
khăn lau	x a n ˧˧ l a w ˧˧
khăn mùi soa	x a n ˧˧ m u j ˨˩ s w aː ˧˧
khăn quàng	x a n ˧˧ k w aː ŋ ˨˩
khương	x ɨ ə ŋ ˧˧
khạc	x aː k̚ ˧˨ ʔ
khả năng	x aː ˧˩ n a ŋ ˧˧
khả quan	x aː ˧˩ k w aː n ˧˧
khải	x aː j ˧˩
khảo thí	x aː w ˧˩ tʰ i ˧˦
khẩn cấp	x ə n ˧˩ k ə p̚ ˧˦
khẩn thiết	x ə n ˧˩ tʰ i ə t̚ ˧˦
khẩu hiệu	x ə w ˧˩ h i ə w ˧˨ ʔ
khẩu nghiệp	x ə w ˧˩ ŋ i ə p̚ ˧˨ ʔ
khẩu âm	x ə w ˧˩ ʔ ə m ˧˧
khắc	x a k̚ ˧˦
khắc phục	x a k̚ ˧˦ f ʊ w k͡p̚ ˧˨ ʔ
khắm	x a m ˧˦
khắp	x a p̚ ˧˦
khế	x e ˧˦
khế ước	x e ˧˦ ʔ ɨ ə k̚ ˧˦
khỉ ho cò gáy	x i ˧˩ h ɔ ˧˧ k ɔ ˨˩ ɣ a j ˧˦
khỉ đầu chó	x i ˧˩ ʔ ɗ ə w ˨˩ t͡ɕ ɔ ˧˦
khỏ	x ɔ ˧˩
khố	x o ˧˦
khống chế	x ə w ŋ͡m ˧˦ t͡ɕ e ˧˦
khổ dịch	x o ˧˩ z ï k̟̚ ˧˨ ʔ
khởi nghĩa	x əː j ˧˩ ŋ i ə ˦˥
khởi phát	x əː j ˧˩ f aː t̚ ˧˦
khủng khiếp	x ʊ w ŋ͡m ˧˩ x i ə p̚ ˧˦
khủng long bạo chúa	x ʊ w ŋ͡m ˧˩ l a w ŋ͡m ˧˧ ʔ ɓ aː w ˧˨ ʔ t͡ɕ u ə ˧˦
khứng	x ɨ ŋ ˧˦
khựa	x ɨ ə ˧˨ ʔ
kilôoat	k i ˧˧ l o ˧˧ ʔ w aː t̚ ˧˦
kim	k i m ˧˧
kim cang	k i m ˧˧ k aː ŋ ˧˧
kim ngân	k i m ˧˧ ŋ ə n ˧˧
kinh	k ï ŋ ˧˧
kinh khủng khiếp	k ï ŋ ˧˧ x ʊ w ŋ͡m ˧˩ x i ə p̚ ˧˦
kinh phí	k ï ŋ ˧˧ f i ˧˦
kinh thánh	k ï ŋ ˧˧ tʰ a j ŋ̟ ˧˦
kinh tuyến	k ï ŋ ˧˧ t w i ə n ˧˦
kirixitô	k i ˧˧ z i ˧˧ s i ˧˧ t o ˧˧
kiên	k i ə n ˧˧
kiên giang	k i ə n ˧˧ z aː ŋ ˧˧
kiên quyết	k i ə n ˧˧ k w i ə t̚ ˧˦
kiêng	k i ə ŋ ˧˧
kiêu	k i ə w ˧˧
kiêu căng	k i ə w ˧˧ k a ŋ ˧˧
kiêu xa	k i ə w ˧˧ s aː ˧˧
kiến lửa	k i ə n ˧˦ l ɨ ə ˧˩
kiến tập	k i ə n ˧˦ t ə p̚ ˧˨ ʔ
kiếng	k i ə ŋ ˧˦
kiếp	k i ə p̚ ˧˦
kiềm	k i ə m ˨˩
kiềm chế	k i ə m ˨˩ t͡ɕ e ˧˦
kiểm duyệt	k i ə m ˧˩ z w i ə t̚ ˧˨ ʔ
kiểm kê dân số	k i ə m ˧˩ k e ˧˧ z ə n ˧˧ s o ˧˦
kiểm soát	k i ə m ˧˩ s w aː t̚ ˧˦
kiểu cách	k i ə w ˧˩ k a j k̟̚ ˧˦
kiểu gõ	k i ə w ˧˩ ɣ ɔ ˦˥
kiệt sức	k i ə t̚ ˧˨ ʔ s ɨ k̚ ˧˦
kiệt xuất	k i ə t̚ ˧˨ ʔ s w ə t̚ ˧˦
kiệu	k i ə w ˧˨ ʔ
kripton	k ɹ i p̚ ˧˦ t ə w ŋ͡m ˧˧
kute	k u ˧˧ t ɛ ˧˧
kè	k ɛ ˨˩
kèm	k ɛ m ˨˩
kèn	k ɛ n ˨˩
kèn ôboa	k ɛ n ˨˩ ʔ o ˧˧ ʔ ɓ w aː ˧˧
kém	k ɛ m ˧˦
kê khai	k e ˧˧ x aː j ˧˧
kêu	k e w ˧˧
kì diệu	k i ˨˩ z i ə w ˧˨ ʔ
kì quái	k i ˨˩ k w aː j ˧˦
kì thị	k i ˨˩ tʰ i ˧˨ ʔ
kì thực	k i ˨˩ tʰ ɨ k̚ ˧˨ ʔ
kì tích	k i ˨˩ t ï k̟̚ ˧˦
kình	k ï ŋ ˨˩
kình ngư	k ï ŋ ˨˩ ŋ ɨ ˧˧
kí tên	k i ˧˦ t e n ˧˧
kí túc xá	k i ˧˦ t ʊ w k͡p̚ ˧˦ s aː ˧˦
kích bác	k ï k̟̚ ˧˦ ʔ ɓ aː k̚ ˧˦
kính	k ï ŋ ˧˦
kính hiển vi	k ï ŋ ˧˦ h i ə n ˧˩ v i ˧˧
kính lão đắc thọ	k ï ŋ ˧˦ l aː w ˦˥ ʔ ɗ a k̚ ˧˦ tʰ ɔ ˧˨ ʔ
kính quý	k ï ŋ ˧˦ k w i ˧˦
kính trọng	k ï ŋ ˧˦ t͡ɕ a w ŋ͡m ˧˨ ʔ
kính vạn hoa	k ï ŋ ˧˦ v aː n ˧˨ ʔ h w aː ˧˧
kẹp giấy	k ɛ p̚ ˧˨ ʔ z ə j ˧˦
kẹt	k ɛ t̚ ˧˨ ʔ
kẻ đắp chăn bông kẻ lạnh lùng	k ɛ ˧˩ ʔ ɗ a p̚ ˧˦ t͡ɕ a n ˧˧ ʔ ɓ ə w ŋ͡m ˧˧ k ɛ ˧˩ l a j ŋ̟ ˧˨ ʔ l ʊ w ŋ͡m ˨˩
kẽ	k ɛ ˦˥
kẽ hở	k ɛ ˦˥ h əː ˧˩
kế	k e ˧˦
kế hoạch hoá gia đình	k e ˧˦ h w a j k̟̚ ˧˨ ʔ h w aː ˧˦ z aː ˧˧ ʔ ɗ ï ŋ ˨˩
kế sách	k e ˧˦ s a j k̟̚ ˧˦
kếp tao	k e p̚ ˧˦ t aː w ˧˧
kết	k e t̚ ˧˦
kết bạn	k e t̚ ˧˦ ʔ ɓ aː n ˧˨ ʔ
kết giới	k e t̚ ˧˦ z əː j ˧˦
kết giới sư	k e t̚ ˧˦ z əː j ˧˦ s ɨ ˧˧
kết hôn	k e t̚ ˧˦ h o n ˧˧
kết luận	k e t̚ ˧˦ l w ə n ˧˨ ʔ
kết từ	k e t̚ ˧˦ t ɨ ˨˩
kết án	k e t̚ ˧˦ ʔ aː n ˧˦
kềnh	k ə j ŋ̟ ˨˩
kể	k e ˧˩
kể cả	k e ˧˩ k aː ˧˩
kịch bản	k ï k̟̚ ˧˨ ʔ ʔ ɓ aː n ˧˩
la bàn	l aː ˧˧ ʔ ɓ aː n ˨˩
la chí	l aː ˧˧ t͡ɕ i ˧˦
lai châu	l aː j ˧˧ t͡ɕ ə w ˧˧
lai láng	l aː j ˧˧ l aː ŋ ˧˦
lam	l aː m ˧˧
lan	l aː n ˧˧
lao động	l aː w ˧˧ ʔ ɗ ə w ŋ͡m ˧˨ ʔ
latinh	l aː ˧˧ t ï ŋ ˧˧
leo thang	l ɛ w ˧˧ tʰ aː ŋ ˧˧
li dị	l i ˧˧ z i ˧˨ ʔ
lim	l i m ˧˧
linh cữu	l ï ŋ ˧˧ k i w ˦˥
linh dương	l ï ŋ ˧˧ z ɨ ə ŋ ˧˧
linh hồn	l ï ŋ ˧˧ h o n ˨˩
linh miêu	l ï ŋ ˧˧ m i ə w ˧˧
linh động	l ï ŋ ˧˧ ʔ ɗ ə w ŋ͡m ˧˨ ʔ
livermori	l i ˧˧ v əː ˧˧ m ɔ ˧˧ ɹ i ˧˧
liêm chính	l i ə m ˧˧ t͡ɕ ï ŋ ˧˦
liên	l i ə n ˧˧
liên hoan	l i ə n ˧˧ h w aː n ˧˧
liến thoắng	l i ə n ˧˦ tʰ w a ŋ ˧˦
liền tay	l i ə n ˨˩ t a j ˧˧
liễu	l i ə w ˦˥
liệng	l i ə ŋ ˧˨ ʔ
liệt dương	l i ə t̚ ˧˨ ʔ z ɨ ə ŋ ˧˧
liệt kháng	l i ə t̚ ˧˨ ʔ x aː ŋ ˧˦
liệt sĩ	l i ə t̚ ˧˨ ʔ s i ˦˥
liệu	l i ə w ˧˨ ʔ
liệu hồn	l i ə w ˧˨ ʔ h o n ˨˩
lo ngại	l ɔ ˧˧ ŋ aː j ˧˨ ʔ
lo sợ	l ɔ ˧˧ s əː ˧˨ ʔ
lo toan	l ɔ ˧˧ t w aː n ˧˧
lo âu	l ɔ ˧˧ ʔ ə w ˧˧
loa	l w aː ˧˧
loan	l w aː n ˧˧
loan báo	l w aː n ˧˧ ʔ ɓ aː w ˧˦
loang	l w aː ŋ ˧˧
long nhãn	l a w ŋ͡m ˧˧ ɲ aː n ˦˥
long não	l a w ŋ͡m ˧˧ n aː w ˦˥
loạn	l w aː n ˧˨ ʔ
loạt	l w aː t̚ ˧˨ ʔ
luciô	l u ˧˧ s i ˧˧ ʔ o ˧˧
lutexi	l u ˧˧ t e ˧˧ s i ˧˧
luyện	l w i ə n ˧˨ ʔ
luân đôn	l w ə n ˧˧ ʔ ɗ o n ˧˧
luôn luôn	l u ə n ˧˧ l u ə n ˧˧
luẩn quẩn	l w ə n ˧˩ k w ə n ˧˩
luận	l w ə n ˧˨ ʔ
luật lệ	l w ə t̚ ˧˨ ʔ l e ˧˨ ʔ
luồn	l u ə n ˨˩
là	l aː ˨˩
lài	l aː j ˨˩
làm biếng	l aː m ˨˩ ʔ ɓ i ə ŋ ˧˦
làm mối	l aː m ˨˩ m o j ˧˦
làn sóng	l aː n ˨˩ s a w ŋ͡m ˧˦
làn đường	l aː n ˨˩ ʔ ɗ ɨ ə ŋ ˨˩
lành	l a j ŋ̟ ˨˩
lác	l aː k̚ ˧˦
lách	l a j k̟̚ ˧˦
láng	l aː ŋ ˧˦
láo	l aː w ˧˦
lát	l aː t̚ ˧˦
lâm nguy	l ə m ˧˧ ŋ w i ˧˧
lâm đồng	l ə m ˧˧ ʔ ɗ ə w ŋ͡m ˨˩
lân	l ə n ˧˧
lâu đài	l ə w ˧˧ ʔ ɗ aː j ˨˩
lây lan	l ə j ˧˧ l aː n ˧˧
lãng	l aː ŋ ˦˥
lãng khách	l aː ŋ ˦˥ x a j k̟̚ ˧˦
lãng xẹt	l aː ŋ ˦˥ s ɛ t̚ ˧˨ ʔ
lãnh thổ	l a j ŋ̟ ˦˥ tʰ o ˧˩
lãnh đạo	l a j ŋ̟ ˦˥ ʔ ɗ aː w ˧˨ ʔ
lão	l aː w ˦˥
lão thị	l aː w ˦˥ tʰ i ˧˨ ʔ
lè	l ɛ ˨˩
lè tè	l ɛ ˨˩ t ɛ ˨˩
lèm bèm	l ɛ m ˨˩ ʔ ɓ ɛ m ˨˩
lén	l ɛ n ˧˦
lép vế	l ɛ p̚ ˧˦ v e ˧˦
lê	l e ˧˧
lê la	l e ˧˧ l aː ˧˧
lê minh	l e ˧˧ m ï ŋ ˧˧
lên giường	l e n ˧˧ z ɨ ə ŋ ˨˩
lênh láng	l ə j ŋ̟ ˧˧ l aː ŋ ˧˦
lêu têu	l e w ˧˧ t e w ˧˧
lì	l i ˨˩
lìn	l i n ˨˩
lí	l i ˧˦
lí do lí trấu	l i ˧˦ z ɔ ˧˧ l i ˧˦ t͡ɕ ə w ˧˦
lí nhí	l i ˧˦ ɲ i ˧˦
lính phòng không	l ï ŋ ˧˦ f a w ŋ͡m ˨˩ x ə w ŋ͡m ˧˧
lò sưởi	l ɔ ˨˩ s ɨ ə j ˧˩
lòn	l ɔ n ˨˩
lòng lang dạ thú	l a w ŋ͡m ˨˩ l aː ŋ ˧˧ z aː ˧˨ ʔ tʰ u ˧˦
lòng trắng	l a w ŋ͡m ˨˩ t͡ɕ a ŋ ˧˦
lót	l ɔ t̚ ˧˦
lô hội	l o ˧˧ h o j ˧˨ ʔ
lô lô	l o ˧˧ l o ˧˧
lôi kéo	l o j ˧˧ k ɛ w ˧˦
lôrensô	l o ˧˧ z ɛ n ˧˧ s o ˧˧
lõ	l ɔ ˦˥
lõi	l ɔ j ˦˥
lùa	l u ə ˨˩
lùi	l u j ˨˩
lùm	l u m ˨˩
lùn	l u n ˨˩
lú	l u ˧˦
lúa chiêm	l u ə ˧˦ t͡ɕ i ə m ˧˧
lúa miến	l u ə ˧˦ m i ə n ˧˦
lún	l u n ˧˦
lúng túng	l ʊ w ŋ͡m ˧˦ t ʊ w ŋ͡m ˧˦
lý tính	l i ˧˦ t ï ŋ ˧˦
lăng	l a ŋ ˧˧
lơ xê mi	l əː ˧˧ s e ˧˧ m i ˧˧
lưng	l ɨ ŋ ˧˧
lưu cầu	l i w ˧˧ k ə w ˨˩
lưu hoàng	l i w ˧˧ h w aː ŋ ˨˩
lương hưu	l ɨ ə ŋ ˧˧ h i w ˧˧
lườn	l ɨ ə n ˨˩
lường	l ɨ ə ŋ ˨˩
lường gạt	l ɨ ə ŋ ˨˩ ɣ aː t̚ ˧˨ ʔ
lưỡi hái	l ɨ ə j ˦˥ h aː j ˧˦
lưỡi lê	l ɨ ə j ˦˥ l e ˧˧
lưỡng lự	l ɨ ə ŋ ˦˥ l ɨ ˧˨ ʔ
lượn	l ɨ ə n ˧˨ ʔ
lượng	l ɨ ə ŋ ˧˨ ʔ
lạ	l aː ˧˨ ʔ
lạ lùng	l aː ˧˨ ʔ l ʊ w ŋ͡m ˨˩
lạc hậu	l aː k̚ ˧˨ ʔ h ə w ˧˨ ʔ
lạch	l a j k̟̚ ˧˨ ʔ
lạm phát phi mã	l aː m ˧˨ ʔ f aː t̚ ˧˦ f i ˧˧ m aː ˦˥
lạng sơn	l aː ŋ ˧˨ ʔ s əː n ˧˧
lải nhải	l aː j ˧˩ ɲ aː j ˧˩
lấp	l ə p̚ ˧˦
lầm lì	l ə m ˨˩ l i ˨˩
lẩn	l ə n ˧˩
lẩn mẩn	l ə n ˧˩ m ə n ˧˩
lẩn quẩn	l ə n ˧˩ k w ə n ˧˩
lẫm cẫm	l ə m ˦˥ k ə m ˦˥
lận	l ə n ˧˨ ʔ
lập	l ə p̚ ˧˨ ʔ
lập luận	l ə p̚ ˧˨ ʔ l w ə n ˧˨ ʔ
lập quốc	l ə p̚ ˧˨ ʔ k u ə k̚ ˧˦
lập tức	l ə p̚ ˧˨ ʔ t ɨ k̚ ˧˦
lắt lay	l a t̚ ˧˦ l a j ˧˧
lằn	l a n ˨˩
lặn lội	l a n ˧˨ ʔ l o j ˧˨ ʔ
lặng lẽ	l a ŋ ˧˨ ʔ l ɛ ˦˥
lặp	l a p̚ ˧˨ ʔ
lề	l e ˨˩
lề lối	l e ˨˩ l o j ˧˦
lễ các đẳng linh hồn	l e ˦˥ k aː k̚ ˧˦ ʔ ɗ a ŋ ˧˩ l ï ŋ ˧˧ h o n ˨˩
lễ giáng sinh	l e ˦˥ z aː ŋ ˧˦ s ï ŋ ˧˧
lễ phục sinh	l e ˦˥ f ʊ w k͡p̚ ˧˨ ʔ s ï ŋ ˧˧
lệ như	l e ˧˨ ʔ ɲ ɨ ˧˧
lệch pha	l ə j k̟̚ ˧˨ ʔ f aː ˧˧
lịch	l ï k̟̚ ˧˨ ʔ
lịch lãm	l ï k̟̚ ˧˨ ʔ l aː m ˦˥
lịch sử	l ï k̟̚ ˧˨ ʔ s ɨ ˧˩
lịm	l i m ˧˨ ʔ
lốc	l ə w k͡p̚ ˧˦
lồng lộng	l ə w ŋ͡m ˨˩ l ə w ŋ͡m ˧˨ ʔ
lỗ ma ni	l o ˦˥ m aː ˧˧ n i ˧˧
lỗ trôn	l o ˦˥ t͡ɕ o n ˧˧
lộ	l o ˧˨ ʔ
lội	l o j ˧˨ ʔ
lớn hơn	l əː n ˧˦ h əː n ˧˧
lớn lao	l əː n ˧˦ l aː w ˧˧
lớt phớt	l əː t̚ ˧˦ f əː t̚ ˧˦
lời lãi	l əː j ˨˩ l aː j ˦˥
lợi dụng	l əː j ˧˨ ʔ z ʊ w ŋ͡m ˧˨ ʔ
lợi hại	l əː j ˧˨ ʔ h aː j ˧˨ ʔ
lợi nhuận	l əː j ˧˨ ʔ ɲ w ə n ˧˨ ʔ
lợi thế	l əː j ˧˨ ʔ tʰ e ˧˦
lợi ích	l əː j ˧˨ ʔ ʔ ï k̟̚ ˧˦
lợn	l əː n ˧˨ ʔ
lợn lòi	l əː n ˧˨ ʔ l ɔ j ˨˩
lợn rừng	l əː n ˧˨ ʔ z ɨ ŋ ˨˩
lục	l ʊ w k͡p̚ ˧˨ ʔ
lục bình	l ʊ w k͡p̚ ˧˨ ʔ ʔ ɓ ï ŋ ˨˩
lừa	l ɨ ə ˨˩
lửng	l ɨ ŋ ˧˩
lự	l ɨ ˧˨ ʔ
lực lượng	l ɨ k̚ ˧˨ ʔ l ɨ ə ŋ ˧˨ ʔ
lựu đạn	l i w ˧˨ ʔ ʔ ɗ aː n ˧˨ ʔ
ma kết	m aː ˧˧ k e t̚ ˧˦
ma men	m aː ˧˧ m ɛ n ˧˧
ma nữ	m aː ˧˧ n ɨ ˦˥
ma sát	m aː ˧˧ s aː t̚ ˧˦
ma trơi	m aː ˧˧ t͡ɕ əː j ˧˧
mai	m aː j ˧˧
mai mối	m aː j ˧˧ m o j ˧˦
man	m aː n ˧˧
mang	m aː ŋ ˧˧
may mắn	m a j ˧˧ m a n ˧˦
me tây	m ɛ ˧˧ t ə j ˧˧
mi mắt	m i ˧˧ m a t̚ ˧˦
micae	m i ˧˧ k aː ˧˧ ʔ ɛ ˧˧
minh chứng	m ï ŋ ˧˧ t͡ɕ ɨ ŋ ˧˦
minh quản	m ï ŋ ˧˧ k w aː n ˧˩
minh ti	m ï ŋ ˧˧ t i ˧˧
miu	m i w ˧˧
miên man	m i ə n ˧˧ m aː n ˧˧
miểng	m i ə ŋ ˧˩
moa	m w aː ˧˧
moóc	m ɔ k̚ ˧˦
muôn tâu	m u ə n ˧˧ t ə w ˧˧
muối	m u ə j ˧˦
muốn	m u ə n ˧˦
muội	m u ə j ˧˨ ʔ
muộn phiền	m u ə n ˧˨ ʔ f i ə n ˨˩
màn cửa	m aː n ˨˩ k ɨ ə ˧˩
màn thầu	m aː n ˨˩ tʰ ə w ˨˩
màn trời chiếu đất	m aː n ˨˩ t͡ɕ əː j ˨˩ t͡ɕ i ə w ˧˦ ʔ ɗ ə t̚ ˧˦
màn ảnh	m aː n ˨˩ ʔ a j ŋ̟ ˧˩
mào	m aː w ˨˩
mày	m a j ˨˩
mày tao chi tớ	m a j ˨˩ t aː w ˧˧ t͡ɕ i ˧˧ t əː ˧˦
má	m aː ˧˦
mách	m a j k̟̚ ˧˦
mách lẻo	m a j k̟̚ ˧˦ l ɛ w ˧˩
mái ngố	m aː j ˧˦ ŋ o ˧˦
máng	m aː ŋ ˧˦
mánh	m a j ŋ̟ ˧˦
mát	m aː t̚ ˧˦
mát mẻ	m aː t̚ ˧˦ m ɛ ˧˩
máu cam	m a w ˧˦ k aː m ˧˧
máu hoạn thư	m a w ˧˦ h w aː n ˧˨ ʔ tʰ ɨ ˧˧
máy bay lên thẳng	m a j ˧˦ ʔ ɓ a j ˧˧ l e n ˧˧ tʰ a ŋ ˧˩
máy bán hàng	m a j ˧˦ ʔ ɓ aː n ˧˦ h aː ŋ ˨˩
máy chụp hình	m a j ˧˦ t͡ɕ u p̚ ˧˨ ʔ h ï ŋ ˨˩
máy chữ	m a j ˧˦ t͡ɕ ɨ ˦˥
máy giặt	m a j ˧˦ z a t̚ ˧˨ ʔ
máy hút bụi	m a j ˧˦ h u t̚ ˧˦ ʔ ɓ u j ˧˨ ʔ
máy in	m a j ˧˦ ʔ i n ˧˧
máy khâu	m a j ˧˦ x ə w ˧˧
máy tính	m a j ˧˦ t ï ŋ ˧˦
máy điện	m a j ˧˦ ʔ ɗ i ə n ˧˨ ʔ
máy ảnh	m a j ˧˦ ʔ a j ŋ̟ ˧˩
mã hàn	m aː ˦˥ h aː n ˨˩
mã lực	m aː ˦˥ l ɨ k̚ ˧˨ ʔ
mã nguồn	m aː ˦˥ ŋ u ə n ˨˩
mãi mãi	m aː j ˦˥ m aː j ˦˥
mãn	m aː n ˦˥
mèo già hoá cáo	m ɛ w ˨˩ z aː ˨˩ h w aː ˧˦ k aː w ˧˦
mèo khen mèo dài đuôi	m ɛ w ˨˩ x ɛ n ˧˧ m ɛ w ˨˩ z aː j ˨˩ ʔ ɗ u ə j ˧˧
mèo rừng	m ɛ w ˨˩ z ɨ ŋ ˨˩
méc	m ɛ k̚ ˧˦
méo mó	m ɛ w ˧˦ m ɔ ˧˦
mê mẩn	m e ˧˧ m ə n ˧˩
mì ăn liền	m i ˨˩ ʔ a n ˧˧ l i ə n ˨˩
mò	m ɔ ˨˩
mòn mỏi	m ɔ n ˨˩ m ɔ j ˧˩
mòng két	m a w ŋ͡m ˨˩ k ɛ t̚ ˧˦
móc chìa khoá	m a w k͡p̚ ˧˦ t͡ɕ i ə ˨˩ x w aː ˧˦
móc túi	m a w k͡p̚ ˧˦ t u j ˧˦
móng tay	m a w ŋ͡m ˧˦ t a j ˧˧
mô phật	m o ˧˧ f ə t̚ ˧˨ ʔ
môi	m o j ˧˧
môn	m o n ˧˧
mông cổ	m ə w ŋ͡m ˧˧ k o ˧˩
mônica	m o n ˧˧ n i ˧˧ k aː ˧˧
mõm	m ɔ m ˦˥
mù	m u ˨˩
mùa xuân	m u ə ˨˩ s w ə n ˧˧
mùi soa	m u j ˨˩ s w aː ˧˧
mùn cưa	m u n ˨˩ k ɨ ə ˧˧
múc	m ʊ w k͡p̚ ˧˦
múi	m u j ˧˦
múi giờ	m u j ˧˦ z əː ˨˩
múp	m u p̚ ˧˦
măng	m a ŋ ˧˧
măng đá	m a ŋ ˧˧ ʔ ɗ aː ˧˦
mĩ kim	m i ˦˥ k i m ˧˧
mĩ quốc	m i ˦˥ k u ə k̚ ˧˦
mĩ tho	m i ˦˥ tʰ ɔ ˧˧
mũi tên	m u j ˦˥ t e n ˧˧
mũm mĩm	m u m ˦˥ m i m ˦˥
mơ	m əː ˧˧
mơ hồ	m əː ˧˧ h o ˨˩
mơ ước	m əː ˧˧ ʔ ɨ ə k̚ ˧˦
mưa phùn	m ɨ ə ˧˧ f u n ˨˩
mưu cầu	m i w ˧˧ k ə w ˨˩
mười	m ɨ ə j ˨˩
mười sáu	m ɨ ə j ˨˩ s a w ˧˦
mạc phủ	m aː k̚ ˧˨ ʔ f u ˧˩
mạng	m aː ŋ ˧˨ ʔ
mạng lưới	m aː ŋ ˧˨ ʔ l ɨ ə j ˧˦
mạng nhện	m aː ŋ ˧˨ ʔ ɲ e n ˧˨ ʔ
mạnh tử	m a j ŋ̟ ˧˨ ʔ t ɨ ˧˩
mạo	m aː w ˧˨ ʔ
mạo hiểm	m aː w ˧˨ ʔ h i ə m ˧˩
mạo từ	m aː w ˧˨ ʔ t ɨ ˨˩
mạt chược	m aː t̚ ˧˨ ʔ t͡ɕ ɨ ə k̚ ˧˨ ʔ
mạt kiếp	m aː t̚ ˧˨ ʔ k i ə p̚ ˧˦
mạt trà	m aː t̚ ˧˨ ʔ t͡ɕ aː ˨˩
mả	m aː ˧˩
mảnh	m a j ŋ̟ ˧˩
mảy may	m a j ˧˩ m a j ˧˧
mấn	m ə n ˧˦
mất dạy	m ə t̚ ˧˦ z a j ˧˨ ʔ
mấy	m ə j ˧˦
mầm	m ə m ˨˩
mẩu	m ə w ˧˩
mẫn	m ə n ˦˥
mẫn cán	m ə n ˦˥ k aː n ˧˦
mẫu quốc	m ə w ˦˥ k u ə k̚ ˧˦
mẫu vật	m ə w ˦˥ v ə t̚ ˧˨ ʔ
mẫu đơn	m ə w ˦˥ ʔ ɗ əː n ˧˧
mập mờ	m ə p̚ ˧˨ ʔ m əː ˨˩
mật	m ə t̚ ˧˨ ʔ
mật khẩu	m ə t̚ ˧˨ ʔ x ə w ˧˩
mậu	m ə w ˧˨ ʔ
mậu dịch	m ə w ˧˨ ʔ z ï k̟̚ ˧˨ ʔ
mắc cười	m a k̚ ˧˦ k ɨ ə j ˨˩
mắc cỡ	m a k̚ ˧˦ k əː ˦˥
mắc kẹt	m a k̚ ˧˦ k ɛ t̚ ˧˨ ʔ
mắng	m a ŋ ˧˦
mắng mỏ	m a ŋ ˧˦ m ɔ ˧˩
mắt chữ o mồm chữ a	m a t̚ ˧˦ t͡ɕ ɨ ˦˥ ʔ ɔ ˧˧ m o m ˨˩ t͡ɕ ɨ ˦˥ ʔ aː ˧˧
mắt nhắm mắt mở	m a t̚ ˧˦ ɲ a m ˧˦ m a t̚ ˧˦ m əː ˧˩
mặc dầu	m a k̚ ˧˨ ʔ z ə w ˨˩
mặc gia	m a k̚ ˧˨ ʔ z aː ˧˧
mặc định	m a k̚ ˧˨ ʔ ʔ ɗ ï ŋ ˧˨ ʔ
mặn mà	m a n ˧˨ ʔ m aː ˨˩
mặn nồng	m a n ˧˨ ʔ n ə w ŋ͡m ˨˩
mặt hàng	m a t̚ ˧˨ ʔ h aː ŋ ˨˩
mặt nạ	m a t̚ ˧˨ ʔ n aː ˧˨ ʔ
mặt trăng	m a t̚ ˧˨ ʔ t͡ɕ a ŋ ˧˧
mặt trận dân tộc giải phóng miền nam việt nam	m a t̚ ˧˨ ʔ t͡ɕ ə n ˧˨ ʔ z ə n ˧˧ t ə w k͡p̚ ˧˨ ʔ z aː j ˧˩ f a w ŋ͡m ˧˦ m i ə n ˨˩ n aː m ˧˧ v i ə t̚ ˧˨ ʔ n aː m ˧˧
mẹ kế	m ɛ ˧˨ ʔ k e ˧˦
mẹ đẻ	m ɛ ˧˨ ʔ ʔ ɗ ɛ ˧˩
mề	m e ˨˩
mề đay	m e ˨˩ ʔ ɗ a j ˧˧
mệnh	m ə j ŋ̟ ˧˨ ʔ
mệnh danh	m ə j ŋ̟ ˧˨ ʔ z a j ŋ̟ ˧˧
mỉa	m i ə ˧˩
mịn màng	m i n ˧˨ ʔ m aː ŋ ˨˩
mịt	m i t̚ ˧˨ ʔ
mỏ cày	m ɔ ˧˩ k a j ˨˩
mỏ hàn	m ɔ ˧˩ h aː n ˨˩
mỏ lết	m ɔ ˧˩ l e t̚ ˧˦
mỏi	m ɔ j ˧˩
mỏng	m a w ŋ͡m ˧˩
mồm	m o m ˨˩
mồng	m ə w ŋ͡m ˨˩
mộ	m o ˧˨ ʔ
mộ gió	m o ˧˨ ʔ z ɔ ˧˦
mộc mạc	m ə w k͡p̚ ˧˨ ʔ m aː k̚ ˧˨ ʔ
mộc nhĩ	m ə w k͡p̚ ˧˨ ʔ ɲ i ˦˥
mộc nhĩ đen	m ə w k͡p̚ ˧˨ ʔ ɲ i ˦˥ ʔ ɗ ɛ n ˧˧
mộc qua	m ə w k͡p̚ ˧˨ ʔ k w aː ˧˧
mộc tinh	m ə w k͡p̚ ˧˨ ʔ t ï ŋ ˧˧
mộng	m ə w ŋ͡m ˧˨ ʔ
một giọt máu đào hơn ao nước lã	m o t̚ ˧˨ ʔ z ɔ t̚ ˧˨ ʔ m a w ˧˦ ʔ ɗ aː w ˨˩ h əː n ˧˧ ʔ aː w ˧˧ n ɨ ə k̚ ˧˦ l aː ˦˥
một mình	m o t̚ ˧˨ ʔ m ï ŋ ˨˩
một mực	m o t̚ ˧˨ ʔ m ɨ k̚ ˧˨ ʔ
một vài	m o t̚ ˧˨ ʔ v aː j ˨˩
một ít	m o t̚ ˧˨ ʔ ʔ i t̚ ˧˦
mới	m əː j ˧˦
mời	m əː j ˨˩
mở toang	m əː ˧˩ t w aː ŋ ˧˧
mục sư	m ʊ w k͡p̚ ˧˨ ʔ s ɨ ˧˧
mục vụ	m ʊ w k͡p̚ ˧˨ ʔ v u ˧˨ ʔ
mụn	m u n ˧˨ ʔ
mức độ	m ɨ k̚ ˧˦ ʔ ɗ o ˧˨ ʔ
mừng tuổi	m ɨ ŋ ˨˩ t u ə j ˧˩
na ná	n aː ˧˧ n aː ˧˦
nai	n aː j ˧˧
nam	n aː m ˧˧
nam mô a di đà phật	n aː m ˧˧ m o ˧˧ ʔ aː ˧˧ z i ˧˧ ʔ ɗ aː ˨˩ f ə t̚ ˧˨ ʔ
nam nữ	n aː m ˧˧ n ɨ ˦˥
nam nữ thụ thụ bất thân	n aː m ˧˧ n ɨ ˦˥ tʰ u ˧˨ ʔ tʰ u ˧˨ ʔ ʔ ɓ ə t̚ ˧˦ tʰ ə n ˧˧
nam thực như hổ, nữ thực như miêu	n aː m ˧˧ tʰ ɨ k̚ ˧˨ ʔ ɲ ɨ ˧˧ h o ˧˩ n ɨ ˦˥ tʰ ɨ k̚ ˧˨ ʔ ɲ ɨ ˧˧ m i ə w ˧˧
nam tào	n aː m ˧˧ t aː w ˨˩
nam tính	n aː m ˧˧ t ï ŋ ˧˦
nao nao	n aː w ˧˧ n aː w ˧˧
napan	n aː ˧˧ p aː n ˧˧
nem	n ɛ m ˧˧
nga ngố	ŋ aː ˧˧ ŋ o ˧˦
ngang	ŋ aː ŋ ˧˧
ngang bướng	ŋ aː ŋ ˧˧ ʔ ɓ ɨ ə ŋ ˧˦
ngang ngược	ŋ aː ŋ ˧˧ ŋ ɨ ə k̚ ˧˨ ʔ
ngao	ŋ aː w ˧˧
ngay	ŋ a j ˧˧
ngay cả	ŋ a j ˧˧ k aː ˧˩
ngay lập tức	ŋ a j ˧˧ l ə p̚ ˧˨ ʔ t ɨ k̚ ˧˦
ngay tức thì	ŋ a j ˧˧ t ɨ k̚ ˧˦ tʰ i ˨˩
nghe nói	ŋ ɛ ˧˧ n ɔ j ˧˦
nghi	ŋ i ˧˧
nghi ngờ	ŋ i ˧˧ ŋ əː ˨˩
nghi vấn	ŋ i ˧˧ v ə n ˧˦
nghi án	ŋ i ˧˧ ʔ aː n ˧˦
nghiêm	ŋ i ə m ˧˧
nghiên cứu	ŋ i ə n ˧˧ k i w ˧˦
nghiêng nghiêng	ŋ i ə ŋ ˧˧ ŋ i ə ŋ ˧˧
nghiền	ŋ i ə n ˨˩
nghèo khó	ŋ ɛ w ˨˩ x ɔ ˧˦
nghèo rớt mồng tơi	ŋ ɛ w ˨˩ z əː t̚ ˧˦ m ə w ŋ͡m ˨˩ t əː j ˧˧
nghìn lẻ một đêm	ŋ i n ˨˩ l ɛ ˧˩ m o t̚ ˧˨ ʔ ʔ ɗ e m ˧˧
nghĩa	ŋ i ə ˦˥
nghĩa vụ	ŋ i ə ˦˥ v u ˧˨ ʔ
nghẹn ngào	ŋ ɛ n ˧˨ ʔ ŋ aː w ˨˩
nghệ nhân	ŋ e ˧˨ ʔ ɲ ə n ˧˧
nghệ tây	ŋ e ˧˨ ʔ t ə j ˧˧
nghệ tĩnh	ŋ e ˧˨ ʔ t ï ŋ ˦˥
nghị viện	ŋ i ˧˨ ʔ v i ə n ˧˨ ʔ
nghịch cảnh	ŋ ï k̟̚ ˧˨ ʔ k a j ŋ̟ ˧˩
ngoài	ŋ w aː j ˨˩
ngoém	ŋ w ɛ m ˧˦
ngoại giao	ŋ w aː j ˧˨ ʔ z aː w ˧˧
ngoại khoa	ŋ w aː j ˧˨ ʔ x w aː ˧˧
ngoại tình	ŋ w aː j ˧˨ ʔ t ï ŋ ˨˩
ngoại tệ	ŋ w aː j ˧˨ ʔ t e ˧˨ ʔ
ngoại ô	ŋ w aː j ˧˨ ʔ ʔ o ˧˧
ngoảnh đi ngoảnh lại	ŋ w a j ŋ̟ ˧˩ ʔ ɗ i ˧˧ ŋ w a j ŋ̟ ˧˩ l aː j ˧˨ ʔ
ngoặt	ŋ w a t̚ ˧˨ ʔ
nguy cơ	ŋ w i ˧˧ k əː ˧˧
nguy hiểm	ŋ w i ˧˧ h i ə m ˧˩
nguyên cớ	ŋ w i ə n ˧˧ k əː ˧˦
nguyên hình	ŋ w i ə n ˧˧ h ï ŋ ˨˩
nguyên mẫu	ŋ w i ə n ˧˧ m ə w ˦˥
nguyên thủ quốc gia	ŋ w i ə n ˧˧ tʰ u ˧˩ k u ə k̚ ˧˦ z aː ˧˧
nguyên thủy	ŋ w i ə n ˧˧ tʰ w i ˧˩
nguyên tắc	ŋ w i ə n ˧˧ t a k̚ ˧˦
nguyền	ŋ w i ə n ˨˩
nguyễn	ŋ w i ə n ˦˥
nguyễn văn a	ŋ w i ə n ˦˥ v a n ˧˧ ʔ aː ˧˧
nguyện	ŋ w i ə n ˧˨ ʔ
nguôi	ŋ u ə j ˧˧
nguồn cội	ŋ u ə n ˨˩ k o j ˧˨ ʔ
nguỵ	ŋ w i ˧˨ ʔ
ngài	ŋ aː j ˨˩
ngàn	ŋ aː n ˨˩
ngành	ŋ a j ŋ̟ ˨˩
ngày cá tháng tư	ŋ a j ˨˩ k aː ˧˦ tʰ aː ŋ ˧˦ t ɨ ˧˧
ngày lễ các thánh	ŋ a j ˨˩ l e ˦˥ k aː k̚ ˧˦ tʰ a j ŋ̟ ˧˦
ngày mai	ŋ a j ˨˩ m aː j ˧˧
ngày ngày	ŋ a j ˨˩ ŋ a j ˨˩
ngày sinh	ŋ a j ˨˩ s ï ŋ ˧˧
ngách	ŋ a j k̟̚ ˧˦
ngái	ŋ aː j ˧˦
ngán	ŋ aː n ˧˦
ngán ngẩm	ŋ aː n ˧˦ ŋ ə m ˧˩
ngâu	ŋ ə w ˧˧
ngây thơ	ŋ ə j ˧˧ tʰ əː ˧˧
ngã	ŋ aː ˦˥
ngã tư	ŋ aː ˦˥ t ɨ ˧˧
ngò rí	ŋ ɔ ˨˩ z i ˧˦
ngòi bút	ŋ ɔ j ˨˩ ʔ ɓ u t̚ ˧˦
ngòi nổ	ŋ ɔ j ˨˩ n o ˧˩
ngón	ŋ ɔ n ˧˦
ngón cái	ŋ ɔ n ˧˦ k aː j ˧˦
ngón út	ŋ ɔ n ˧˦ ʔ u t̚ ˧˦
ngôi	ŋ o j ˧˧
ngôn	ŋ o n ˧˧
ngôn ngữ	ŋ o n ˧˧ ŋ ɨ ˦˥
ngôn từ	ŋ o n ˧˧ t ɨ ˨˩
ngõ	ŋ ɔ ˦˥
ngõi	ŋ ɔ j ˦˥
ngù	ŋ u ˨˩
ngùi	ŋ u j ˨˩
ngăn cách	ŋ a n ˧˧ k a j k̟̚ ˧˦
ngăn cản	ŋ a n ˧˧ k aː n ˧˩
ngũ	ŋ u ˦˥
ngũ cốc	ŋ u ˦˥ k ə w k͡p̚ ˧˦
ngũ ngôn	ŋ u ˦˥ ŋ o n ˧˧
ngũ quả	ŋ u ˦˥ k w aː ˧˩
ngũ đại hồ	ŋ u ˦˥ ʔ ɗ aː j ˧˨ ʔ h o ˨˩
ngư nghiệp	ŋ ɨ ˧˧ ŋ i ə p̚ ˧˨ ʔ
ngưu bàng	ŋ i w ˧˧ ʔ ɓ aː ŋ ˨˩
ngươi	ŋ ɨ ə j ˧˧
người da đỏ	ŋ ɨ ə j ˨˩ z aː ˧˧ ʔ ɗ ɔ ˧˩
người lạ	ŋ ɨ ə j ˨˩ l aː ˧˨ ʔ
người mĩ	ŋ ɨ ə j ˨˩ m i ˦˥
người ngoại quốc	ŋ ɨ ə j ˨˩ ŋ w aː j ˧˨ ʔ k u ə k̚ ˧˦
người nước ngoài	ŋ ɨ ə j ˨˩ n ɨ ə k̚ ˧˦ ŋ w aː j ˨˩
người trần mắt thịt	ŋ ɨ ə j ˨˩ t͡ɕ ə n ˨˩ m a t̚ ˧˦ tʰ i t̚ ˧˨ ʔ
người việt nam	ŋ ɨ ə j ˨˩ v i ə t̚ ˧˨ ʔ n aː m ˧˧
người đầu bạc tiễn kẻ đầu xanh	ŋ ɨ ə j ˨˩ ʔ ɗ ə w ˨˩ ʔ ɓ aː k̚ ˧˨ ʔ t i ə n ˦˥ k ɛ ˧˩ ʔ ɗ ə w ˨˩ s a j ŋ̟ ˧˧
người đời	ŋ ɨ ə j ˨˩ ʔ ɗ əː j ˨˩
ngưỡng mộ	ŋ ɨ ə ŋ ˦˥ m o ˧˨ ʔ
ngấm	ŋ ə m ˧˦
ngất xỉu	ŋ ə t̚ ˧˦ s i w ˧˩
ngấy	ŋ ə j ˧˦
ngần	ŋ ə n ˨˩
ngần ngại	ŋ ə n ˨˩ ŋ aː j ˧˨ ʔ
ngập	ŋ ə p̚ ˧˨ ʔ
ngắm	ŋ a m ˧˦
ngắt	ŋ a t̚ ˧˦
ngắt lời	ŋ a t̚ ˧˦ l əː j ˨˩
ngọ	ŋ ɔ ˧˨ ʔ
ngọc nữ	ŋ a w k͡p̚ ˧˨ ʔ n ɨ ˦˥
ngọc thạch	ŋ a w k͡p̚ ˧˨ ʔ tʰ a j k̟̚ ˧˨ ʔ
ngọc trai	ŋ a w k͡p̚ ˧˨ ʔ t͡ɕ aː j ˧˧
ngọt	ŋ ɔ t̚ ˧˨ ʔ
ngố	ŋ o ˧˦
ngốc nghếch	ŋ ə w k͡p̚ ˧˦ ŋ ə j k̟̚ ˧˦
ngốn	ŋ o n ˧˦
ngồ ngộ	ŋ o ˨˩ ŋ o ˧˨ ʔ
ngồi tù	ŋ o j ˨˩ t u ˨˩
ngồi xổm	ŋ o j ˨˩ s o m ˧˩
ngộ nhận	ŋ o ˧˨ ʔ ɲ ə n ˧˨ ʔ
ngộ ái nị	ŋ o ˧˨ ʔ ʔ aː j ˧˦ n i ˧˨ ʔ
ngộ độc	ŋ o ˧˨ ʔ ʔ ɗ ə w k͡p̚ ˧˨ ʔ
ngột ngạt	ŋ o t̚ ˧˨ ʔ ŋ aː t̚ ˧˨ ʔ
ngớ	ŋ əː ˧˦
ngớ ngẩn	ŋ əː ˧˦ ŋ ə n ˧˩
ngợm	ŋ əː m ˧˨ ʔ
ngụ ý	ŋ u ˧˨ ʔ ʔ i ˧˦
ngủ	ŋ u ˧˩
ngủ chay	ŋ u ˧˩ t͡ɕ a j ˧˧
ngủ nướng	ŋ u ˧˩ n ɨ ə ŋ ˧˦
ngứa	ŋ ɨ ə ˧˦
ngứa mắt	ŋ ɨ ə ˧˦ m a t̚ ˧˦
ngứa mồm	ŋ ɨ ə ˧˦ m o m ˨˩
ngửa	ŋ ɨ ə ˧˩
ngữ	ŋ ɨ ˦˥
ngữ nguyên học	ŋ ɨ ˦˥ ŋ w i ə n ˧˧ h a w k͡p̚ ˧˨ ʔ
ngựa quen đường cũ	ŋ ɨ ə ˧˨ ʔ k w ɛ n ˧˧ ʔ ɗ ɨ ə ŋ ˨˩ k u ˦˥
nha khoa	ɲ aː ˧˧ x w aː ˧˧
nha phiến	ɲ aː ˧˧ f i ə n ˧˦
nha đam	ɲ aː ˧˧ ʔ ɗ aː m ˧˧
nhanh	ɲ a j ŋ̟ ˧˧
nhe	ɲ ɛ ˧˧
nhem nhuốc	ɲ ɛ m ˧˧ ɲ u ə k̚ ˧˦
nheo	ɲ ɛ w ˧˧
nhiên liệu	ɲ i ə n ˧˧ l i ə w ˧˨ ʔ
nhiếc	ɲ i ə k̚ ˧˦
nhiếp ảnh	ɲ i ə p̚ ˧˦ ʔ a j ŋ̟ ˧˩
nhiếp ảnh gia	ɲ i ə p̚ ˧˦ ʔ a j ŋ̟ ˧˩ z aː ˧˧
nhiễu	ɲ i ə w ˦˥
nhiệt liệt	ɲ i ə t̚ ˧˨ ʔ l i ə t̚ ˧˨ ʔ
nhiệt năng	ɲ i ə t̚ ˧˨ ʔ n a ŋ ˧˧
nhiệt độ tuyệt đối	ɲ i ə t̚ ˧˨ ʔ ʔ ɗ o ˧˨ ʔ t w i ə t̚ ˧˨ ʔ ʔ ɗ o j ˧˦
nho giáo	ɲ ɔ ˧˧ z aː w ˧˦
nhung	ɲ ʊ w ŋ͡m ˧˧
nhà cầu	ɲ aː ˨˩ k ə w ˨˩
nhà giam	ɲ aː ˨˩ z aː m ˧˧
nhà giáo	ɲ aː ˨˩ z aː w ˧˦
nhà máy	ɲ aː ˨˩ m a j ˧˦
nhà nghỉ	ɲ aː ˨˩ ŋ i ˧˩
nhà nguyện	ɲ aː ˨˩ ŋ w i ə n ˧˨ ʔ
nhà sàn	ɲ aː ˨˩ s aː n ˨˩
nhà thờ	ɲ aː ˨˩ tʰ əː ˨˩
nhà vô địch	ɲ aː ˨˩ v o ˧˧ ʔ ɗ ï k̟̚ ˧˨ ʔ
nhà văn	ɲ aː ˨˩ v a n ˧˧
nhà vệ sinh	ɲ aː ˨˩ v e ˧˨ ʔ s ï ŋ ˧˧
nhà xe	ɲ aː ˨˩ s ɛ ˧˧
nhà xác	ɲ aː ˨˩ s aː k̚ ˧˦
nhá	ɲ aː ˧˦
nhách	ɲ a j k̟̚ ˧˦
nhân	ɲ ə n ˧˧
nhân chủng học	ɲ ə n ˧˧ t͡ɕ ʊ w ŋ͡m ˧˩ h a w k͡p̚ ˧˨ ʔ
nhân danh	ɲ ə n ˧˧ z a j ŋ̟ ˧˧
nhân khẩu học	ɲ ə n ˧˧ x ə w ˧˩ h a w k͡p̚ ˧˨ ʔ
nhân loại học	ɲ ə n ˧˧ l w aː j ˧˨ ʔ h a w k͡p̚ ˧˨ ʔ
nhân lực	ɲ ə n ˧˧ l ɨ k̚ ˧˨ ʔ
nhân ngư	ɲ ə n ˧˧ ŋ ɨ ˧˧
nhân sự	ɲ ə n ˧˧ s ɨ ˧˨ ʔ
nhân tình	ɲ ə n ˧˧ t ï ŋ ˨˩
nhã	ɲ aː ˦˥
nhãng	ɲ aː ŋ ˦˥
nhé	ɲ ɛ ˧˦
nhì	ɲ i ˨˩
nhíp	ɲ i p̚ ˧˦
nhóm máu	ɲ ɔ m ˧˦ m a w ˧˦
nhót	ɲ ɔ t̚ ˧˦
nhăn nhó	ɲ a n ˧˧ ɲ ɔ ˧˦
nhơ	ɲ əː ˧˧
như đúng rồi	ɲ ɨ ˧˧ ʔ ɗ ʊ w ŋ͡m ˧˦ z o j ˨˩
nhướn	ɲ ɨ ə n ˧˦
nhượng	ɲ ɨ ə ŋ ˧˨ ʔ
nhạc mẫu	ɲ aː k̚ ˧˨ ʔ m ə w ˦˥
nhạc viện	ɲ aː k̚ ˧˨ ʔ v i ə n ˧˨ ʔ
nhảm nhí	ɲ aː m ˧˩ ɲ i ˧˦
nhảy dây	ɲ a j ˧˩ z ə j ˧˧
nhấc	ɲ ə k̚ ˧˦
nhấm	ɲ ə m ˧˦
nhấn	ɲ ə n ˧˦
nhấn mạnh	ɲ ə n ˧˦ m a j ŋ̟ ˧˨ ʔ
nhấp	ɲ ə p̚ ˧˦
nhất gái hơn hai, nhì trai hơn một	ɲ ə t̚ ˧˦ ɣ aː j ˧˦ h əː n ˧˧ h aː j ˧˧ ɲ i ˨˩ t͡ɕ aː j ˧˧ h əː n ˧˧ m o t̚ ˧˨ ʔ
nhất nam viết hữu, thập nữ viết vô	ɲ ə t̚ ˧˦ n aː m ˧˧ v i ə t̚ ˧˦ h i w ˦˥ tʰ ə p̚ ˧˨ ʔ n ɨ ˦˥ v i ə t̚ ˧˦ v o ˧˧
nhầy	ɲ ə j ˨˩
nhận biết	ɲ ə n ˧˨ ʔ ʔ ɓ i ə t̚ ˧˦
nhận ra	ɲ ə n ˧˨ ʔ z aː ˧˧
nhận xét	ɲ ə n ˧˨ ʔ s ɛ t̚ ˧˦
nhận định	ɲ ə n ˧˨ ʔ ʔ ɗ ï ŋ ˧˨ ʔ
nhập	ɲ ə p̚ ˧˨ ʔ
nhập cư	ɲ ə p̚ ˧˨ ʔ k ɨ ˧˧
nhập gia tuỳ tục	ɲ ə p̚ ˧˨ ʔ z aː ˧˧ t w i ˨˩ t ʊ w k͡p̚ ˧˨ ʔ
nhập viện	ɲ ə p̚ ˧˨ ʔ v i ə n ˧˨ ʔ
nhật báo	ɲ ə t̚ ˧˨ ʔ ʔ ɓ aː w ˧˦
nhật hoàng	ɲ ə t̚ ˧˨ ʔ h w aː ŋ ˨˩
nhắc	ɲ a k̚ ˧˦
nhắn gửi	ɲ a n ˧˦ ɣ ɨ j ˧˩
nhắn nhủ	ɲ a n ˧˦ ɲ u ˧˩
nhẵn	ɲ a n ˦˥
nhịn	ɲ i n ˧˨ ʔ
nhịp điệu	ɲ i p̚ ˧˨ ʔ ʔ ɗ i ə w ˧˨ ʔ
nhọc nhằn	ɲ a w k͡p̚ ˧˨ ʔ ɲ a n ˨˩
nhỏ bé	ɲ ɔ ˧˩ ʔ ɓ ɛ ˧˦
nhỏ nhặt	ɲ ɔ ˧˩ ɲ a t̚ ˧˨ ʔ
nhốt	ɲ o t̚ ˧˦
nhồi máu cơ tim	ɲ o j ˨˩ m a w ˧˦ k əː ˧˧ t i m ˧˧
nhồi nhét	ɲ o j ˨˩ ɲ ɛ t̚ ˧˦
nhổ	ɲ o ˧˩
nhộn	ɲ o n ˧˨ ʔ
nhột	ɲ o t̚ ˧˨ ʔ
nhớ đời	ɲ əː ˧˦ ʔ ɗ əː j ˨˩
nhởi	ɲ əː j ˧˩
nhỡ	ɲ əː ˦˥
nhức	ɲ ɨ k̚ ˧˦
nhừ	ɲ ɨ ˨˩
nhử	ɲ ɨ ˧˩
nhựa	ɲ ɨ ə ˧˨ ʔ
ni	n i ˧˧
ni lông	n i ˧˧ l ə w ŋ͡m ˧˧
niken	n i ˧˧ k ɛ n ˧˧
ninh	n ï ŋ ˧˧
niên đại học	n i ə n ˧˧ ʔ ɗ aː j ˧˨ ʔ h a w k͡p̚ ˧˨ ʔ
niêu	n i ə w ˧˧
niềm	n i ə m ˨˩
niềm vui	n i ə m ˨˩ v u j ˧˧
noãn hoàng	n w aː n ˦˥ h w aː ŋ ˨˩
nuy	n w i ˧˧
nuốt	n u ə t̚ ˧˦
nài	n aː j ˨˩
nào	n aː w ˨˩
nào giờ	n aː w ˨˩ z əː ˨˩
nách	n a j k̟̚ ˧˦
náu	n a w ˧˦
nâng	n ə ŋ ˧˧
nâng cao	n ə ŋ ˧˧ k aː w ˧˧
nâng niu	n ə ŋ ˧˧ n i w ˧˧
nã	n aː ˦˥
nãy	n a j ˦˥
nè	n ɛ ˨˩
nêm	n e m ˧˧
ních	n ï k̟̚ ˧˦
níu	n i w ˧˦
nóc	n a w k͡p̚ ˧˦
nói chơi thôi	n ɔ j ˧˦ t͡ɕ əː j ˧˧ tʰ o j ˧˧
nói năng	n ɔ j ˧˦ n a ŋ ˧˧
nói riêng	n ɔ j ˧˦ z i ə ŋ ˧˧
nói thầm	n ɔ j ˧˦ tʰ ə m ˨˩
nón ba tầm	n ɔ n ˧˦ ʔ ɓ aː ˧˧ t ə m ˨˩
nón bảo hiểm	n ɔ n ˧˦ ʔ ɓ aː w ˧˩ h i ə m ˧˩
nón mũ	n ɔ n ˧˦ m u ˦˥
nóng	n a w ŋ͡m ˧˦
nóng vội	n a w ŋ͡m ˧˦ v o j ˧˨ ʔ
nôn	n o n ˧˧
nôn nao	n o n ˧˧ n aː w ˧˧
nông cạn	n ə w ŋ͡m ˧˧ k aː n ˧˨ ʔ
nông học	n ə w ŋ͡m ˧˧ h a w k͡p̚ ˧˨ ʔ
nông nô	n ə w ŋ͡m ˧˧ n o ˧˧
nõn	n ɔ n ˦˥
nùi	n u j ˨˩
núi sông	n u j ˧˦ s ə w ŋ͡m ˧˧
núp	n u p̚ ˧˦
năm mười	n a m ˧˧ m ɨ ə j ˨˩
năn ngọt	n a n ˧˧ ŋ ɔ t̚ ˧˨ ʔ
năng động	n a ŋ ˧˧ ʔ ɗ ə w ŋ͡m ˧˨ ʔ
nơ	n əː ˧˧
nơi nơi	n əː j ˧˧ n əː j ˧˧
nơtron	n əː ˧˧ t͡ɕ ə w ŋ͡m ˧˧
nước	n ɨ ə k̚ ˧˦
nước da	n ɨ ə k̚ ˧˦ z aː ˧˧
nước dừa	n ɨ ə k̚ ˧˦ z ɨ ə ˨˩
nước kết tinh	n ɨ ə k̚ ˧˦ k e t̚ ˧˦ t ï ŋ ˧˧
nước lã	n ɨ ə k̚ ˧˦ l aː ˦˥
nước miếng	n ɨ ə k̚ ˧˦ m i ə ŋ ˧˦
nước mía	n ɨ ə k̚ ˧˦ m i ə ˧˦
nước mĩ	n ɨ ə k̚ ˧˦ m i ˦˥
nước mắm	n ɨ ə k̚ ˧˦ m a m ˧˦
nước mắt	n ɨ ə k̚ ˧˦ m a t̚ ˧˦
nước mắt cá sấu	n ɨ ə k̚ ˧˦ m a t̚ ˧˦ k aː ˧˦ s ə w ˧˦
nước ngoài	n ɨ ə k̚ ˧˦ ŋ w aː j ˨˩
nước sốt	n ɨ ə k̚ ˧˦ s o t̚ ˧˦
nước tàu	n ɨ ə k̚ ˧˦ t a w ˨˩
nước xốt	n ɨ ə k̚ ˧˦ s o t̚ ˧˦
nướu	n i ə w ˧˦
nạm	n aː m ˧˨ ʔ
nạn lụt	n aː n ˧˨ ʔ l u t̚ ˧˨ ʔ
nấm linh chi	n ə m ˧˦ l ï ŋ ˧˧ t͡ɕ i ˧˧
nấm rơm	n ə m ˧˦ z əː m ˧˧
nấm tuyết	n ə m ˧˦ t w i ə t̚ ˧˦
nấu	n ə w ˧˦
nấu bếp	n ə w ˧˦ ʔ ɓ e p̚ ˧˦
nấu nướng	n ə w ˧˦ n ɨ ə ŋ ˧˦
nắn	n a n ˧˦
nằm xuống	n a m ˨˩ s u ə ŋ ˧˦
nặc	n a k̚ ˧˨ ʔ
nếm	n e m ˧˦
nến	n e n ˧˦
nền nếp	n e n ˨˩ n e p̚ ˧˦
nền tảng	n e n ˨˩ t aː ŋ ˧˩
nệm	n e m ˧˨ ʔ
nịt	n i t̚ ˧˨ ʔ
nịt vú	n i t̚ ˧˨ ʔ v u ˧˦
nọc nọc	n a w k͡p̚ ˧˨ ʔ n a w k͡p̚ ˧˨ ʔ
nốc	n ə w k͡p̚ ˧˦
nối	n o j ˧˦
nối tiếp	n o j ˧˦ t i ə p̚ ˧˦
nốt	n o t̚ ˧˦
nồi cơm điện	n o j ˨˩ k əː m ˧˧ ʔ ɗ i ə n ˧˨ ʔ
nồng nàn	n ə w ŋ͡m ˨˩ n aː n ˨˩
nổi dậy	n o j ˧˩ z ə j ˧˨ ʔ
nỗ lực	n o ˦˥ l ɨ k̚ ˧˨ ʔ
nội dung	n o j ˧˨ ʔ z ʊ w ŋ͡m ˧˧
nội mông	n o j ˧˨ ʔ m ə w ŋ͡m ˧˧
nội mông cổ	n o j ˧˨ ʔ m ə w ŋ͡m ˧˧ k o ˧˩
nội quy	n o j ˧˨ ʔ k w i ˧˧
nội trú	n o j ˧˨ ʔ t͡ɕ u ˧˦
nội vụ	n o j ˧˨ ʔ v u ˧˨ ʔ
nở	n əː ˧˩
nở rộ	n əː ˧˩ z o ˧˨ ʔ
nức nở	n ɨ k̚ ˧˦ n əː ˧˩
nứt	n ɨ t̚ ˧˦
nữ chân	n ɨ ˦˥ t͡ɕ ə n ˧˧
nữ công gia chánh	n ɨ ˦˥ k ə w ŋ͡m ˧˧ z aː ˧˧ t͡ɕ a j ŋ̟ ˧˦
nữa	n ɨ ə ˦˥
nữu ước	n i w ˦˥ ʔ ɨ ə k̚ ˧˦
nực	n ɨ k̚ ˧˨ ʔ
nực cười	n ɨ k̚ ˧˨ ʔ k ɨ ə j ˨˩
om	ʔ ɔ m ˧˧
ong ong	ʔ a w ŋ͡m ˧˧ ʔ a w ŋ͡m ˧˧
oxi	ʔ o ˧˧ s i ˧˧
oách	ʔ w a j k̟̚ ˧˦
palađi	p aː ˧˧ l aː ˧˧ ʔ ɗ i ˧˧
panh	p a j ŋ̟ ˧˧
pha lê	f aː ˧˧ l e ˧˧
phan xi păng	f aː n ˧˧ s i ˧˧ p a ŋ ˧˧
phanh	f a j ŋ̟ ˧˧
phiêu lưu	f i ə w ˧˧ l i w ˧˧
phiền muộn	f i ə n ˨˩ m u ə n ˧˨ ʔ
phong cách	f a w ŋ͡m ˧˧ k a j k̟̚ ˧˦
phong kiến	f a w ŋ͡m ˧˧ k i ə n ˧˦
phong độ	f a w ŋ͡m ˧˧ ʔ ɗ o ˧˨ ʔ
photpho	f o t̚ ˧˦ f ɔ ˧˧
phu nhân	f u ˧˧ ɲ ə n ˧˧
phu phụ	f u ˧˧ f u ˧˨ ʔ
phu xe	f u ˧˧ s ɛ ˧˧
phà	f aː ˨˩
phá	f aː ˧˦
phá bỏ	f aː ˧˦ ʔ ɓ ɔ ˧˩
phá giá	f aː ˧˦ z aː ˧˦
phác	f aː k̚ ˧˦
phác đồ	f aː k̚ ˧˦ ʔ ɗ o ˨˩
phách	f a j k̟̚ ˧˦
phái	f aː j ˧˦
phái sinh	f aː j ˧˦ s ï ŋ ˧˧
phái đoàn	f aː j ˧˦ ʔ ɗ w aː n ˨˩
phái đẹp	f aː j ˧˦ ʔ ɗ ɛ p̚ ˧˨ ʔ
phán xử	f aː n ˧˦ s ɨ ˧˩
pháp luân công	f aː p̚ ˧˦ l w ə n ˧˧ k ə w ŋ͡m ˧˧
pháp luân đại pháp	f aː p̚ ˧˦ l w ə n ˧˧ ʔ ɗ aː j ˧˨ ʔ f aː p̚ ˧˦
phát	f aː t̚ ˧˦
phát biểu	f aː t̚ ˧˦ ʔ ɓ i ə w ˧˩
phát dục	f aː t̚ ˧˦ z ʊ w k͡p̚ ˧˨ ʔ
phát hành	f aː t̚ ˧˦ h a j ŋ̟ ˨˩
phát thanh	f aː t̚ ˧˦ tʰ a j ŋ̟ ˧˧
phát tán	f aː t̚ ˧˦ t aː n ˧˦
phát đạt	f aː t̚ ˧˦ ʔ ɗ aː t̚ ˧˨ ʔ
phân bố	f ə n ˧˧ ʔ ɓ o ˧˦
phân chia	f ə n ˧˧ t͡ɕ i ə ˧˧
phân khối	f ə n ˧˧ x o j ˧˦
phân số	f ə n ˧˧ s o ˧˦
phân từ	f ə n ˧˧ t ɨ ˨˩
phân tử	f ə n ˧˧ t ɨ ˧˩
phân định	f ə n ˧˧ ʔ ɗ ï ŋ ˧˨ ʔ
phép chia	f ɛ p̚ ˧˦ t͡ɕ i ə ˧˧
phép nhân	f ɛ p̚ ˧˦ ɲ ə n ˧˧
phép thắng lợi tinh thần	f ɛ p̚ ˧˦ tʰ a ŋ ˧˦ l əː j ˧˨ ʔ t ï ŋ ˧˧ tʰ ə n ˨˩
phên	f e n ˧˧
phình	f ï ŋ ˨˩
phích	f ï k̟̚ ˧˦
phò mã	f ɔ ˨˩ m aː ˦˥
phòi	f ɔ j ˨˩
phòng	f a w ŋ͡m ˨˩
phòng ngủ	f a w ŋ͡m ˨˩ ŋ u ˧˩
phó tế	f ɔ ˧˦ t e ˧˦
phóng hoả	f a w ŋ͡m ˧˦ h w aː ˧˩
phóng sinh	f a w ŋ͡m ˧˦ s ï ŋ ˧˧
phóng sự	f a w ŋ͡m ˧˦ s ɨ ˧˨ ʔ
phóng tác	f a w ŋ͡m ˧˦ t aː k̚ ˧˦
phóng viên	f a w ŋ͡m ˧˦ v i ə n ˧˧
phóng xạ	f a w ŋ͡m ˧˦ s aː ˧˨ ʔ
phô mai	f o ˧˧ m aː j ˧˧
phôi thai	f o j ˧˧ tʰ aː j ˧˧
phù	f u ˨˩
phù tang	f u ˨˩ t aː ŋ ˧˧
phù thuỷ	f u ˨˩ tʰ w i ˧˩
phú	f u ˧˦
phú xuân	f u ˧˦ s w ə n ˧˧
phúc kiến	f ʊ w k͡p̚ ˧˦ k i ə n ˧˦
phúc đức	f ʊ w k͡p̚ ˧˦ ʔ ɗ ɨ k̚ ˧˦
phũ	f u ˦˥
phơi	f əː j ˧˧
phương hướng	f ɨ ə ŋ ˧˧ h ɨ ə ŋ ˧˦
phương phi	f ɨ ə ŋ ˧˧ f i ˧˧
phương trình	f ɨ ə ŋ ˧˧ t͡ɕ ï ŋ ˨˩
phương tây	f ɨ ə ŋ ˧˧ t ə j ˧˧
phạm	f aː m ˧˨ ʔ
phải	f aː j ˧˩
phản bội	f aː n ˧˩ ʔ ɓ o j ˧˨ ʔ
phản hồi	f aː n ˧˩ h o j ˨˩
phản kháng	f aː n ˧˩ x aː ŋ ˧˦
phản quốc	f aː n ˧˩ k u ə k̚ ˧˦
phản vật chất	f aː n ˧˩ v ə t̚ ˧˨ ʔ t͡ɕ ə t̚ ˧˦
phản ánh	f aː n ˧˩ ʔ a j ŋ̟ ˧˦
phấn khởi	f ə n ˧˦ x əː j ˧˩
phất	f ə t̚ ˧˦
phần trăm	f ə n ˨˩ t͡ɕ a m ˧˧
phẩm chất	f ə m ˧˩ t͡ɕ ə t̚ ˧˦
phận	f ə n ˧˨ ʔ
phật	f ə t̚ ˧˨ ʔ
phật giáo	f ə t̚ ˧˨ ʔ z aː w ˧˦
phật thủ	f ə t̚ ˧˨ ʔ tʰ u ˧˩
phẳng phiu	f a ŋ ˧˩ f i w ˧˧
phếch	f ə j k̟̚ ˧˦
phệ	f e ˧˨ ʔ
phọt	f ɔ t̚ ˧˨ ʔ
phỏng vấn	f a w ŋ͡m ˧˩ v ə n ˧˦
phỏng đoán	f a w ŋ͡m ˧˩ ʔ ɗ w aː n ˧˦
phố	f o ˧˦
phối	f o j ˧˦
phốt	f o t̚ ˧˦
phồn thực	f o n ˨˩ tʰ ɨ k̚ ˧˨ ʔ
phổ biến	f o ˧˩ ʔ ɓ i ə n ˧˦
phổ quát	f o ˧˩ k w aː t̚ ˧˦
phổi	f o j ˧˩
phụ	f u ˧˨ ʔ
phụ huynh	f u ˧˨ ʔ h w ï ŋ̟ ˧˧
phụ hệ	f u ˧˨ ʔ h e ˧˨ ʔ
phụ thuộc	f u ˧˨ ʔ tʰ u ə k̚ ˧˨ ʔ
phục dựng	f ʊ w k͡p̚ ˧˨ ʔ z ɨ ŋ ˧˨ ʔ
phục hồi	f ʊ w k͡p̚ ˧˨ ʔ h o j ˨˩
phụng phịu	f ʊ w ŋ͡m ˧˨ ʔ f i w ˧˨ ʔ
phủi	f u j ˧˩
piô	p i ˧˧ ʔ o ˧˧
pleiku	p əː ˨˩ l ə j ˧˧ k u ˧˧
plây ku	p l ə j ˧˧ k u ˧˧
prometi	p ɹ o ˧˧ m e ˧˧ t i ˧˧
protactini	ʔ u ˧˧ ɹ aː ˧˧ n i ˧˧
pê	p e ˧˧
píp	p i p̚ ˧˦
qua loa	k w aː ˧˧ l w aː ˧˧
quan âm	k w aː n ˧˧ ʔ ə m ˧˧
quan điểm	k w aː n ˧˧ ʔ ɗ i ə m ˧˩
quang hợp	k w aː ŋ ˧˧ h əː p̚ ˧˨ ʔ
quay cóp	k w a j ˧˧ k ɔ p̚ ˧˦
quay tay	k w a j ˧˧ t a j ˧˧
quen	k w ɛ n ˧˧
quy chuẩn	k w i ˧˧ t͡ɕ w ə n ˧˩
quy củ	k w i ˧˧ k u ˧˩
quy kết	k w i ˧˧ k e t̚ ˧˦
quy nhơn	k w i ˧˧ ɲ əː n ˧˧
quy tắc	k w i ˧˧ t a k̚ ˧˦
quy tắc tam suất	k w i ˧˧ t a k̚ ˧˦ t aː m ˧˧ s w ə t̚ ˧˦
quy tụ	k w i ˧˧ t u ˧˨ ʔ
quyên góp	k w i ə n ˧˧ ɣ ɔ p̚ ˧˦
quyết liệt	k w i ə t̚ ˧˦ l i ə t̚ ˧˨ ʔ
quyền anh	k w i ə n ˨˩ ʔ a j ŋ̟ ˧˧
quà	k w aː ˨˩
quàng	k w aː ŋ ˨˩
quá	k w aː ˧˦
quá cố	k w aː ˧˦ k o ˧˦
quá khứ	k w aː ˧˦ x ɨ ˧˦
quá khứ phân từ	k w aː ˧˦ x ɨ ˧˦ f ə n ˧˧ t ɨ ˨˩
quái vật	k w aː j ˧˦ v ə t̚ ˧˨ ʔ
quán cà phê	k w aː n ˧˦ k aː ˨˩ f e ˧˧
quát	k w aː t̚ ˧˦
quân chủ lập hiến	k w ə n ˧˧ t͡ɕ u ˧˩ l ə p̚ ˧˨ ʔ h i ə n ˧˦
qué	k w ɛ ˧˦
quên lãng	k w e n ˧˧ l aː ŋ ˦˥
quý giá	k w i ˧˦ z aː ˧˦
quýu	k w i w ˧˦
quạnh	k w a j ŋ̟ ˧˨ ʔ
quạt	k w aː t̚ ˧˨ ʔ
quạt máy	k w aː t̚ ˧˨ ʔ m a j ˧˦
quạt điện	k w aː t̚ ˧˨ ʔ ʔ ɗ i ə n ˧˨ ʔ
quả thực	k w aː ˧˩ tʰ ɨ k̚ ˧˨ ʔ
quản cơ	k w aː n ˧˩ k əː ˧˧
quản lí	k w aː n ˧˩ l i ˧˦
quảng	k w aː ŋ ˧˩
quảng cáo	k w aː ŋ ˧˩ k aː w ˧˦
quảng ngãi	k w aː ŋ ˧˩ ŋ aː j ˦˥
quảng ninh	k w aː ŋ ˧˩ n ï ŋ ˧˧
quảy	k w a j ˧˩
quấy	k w ə j ˧˦
quần chíp	k w ə n ˨˩ t͡ɕ i p̚ ˧˦
quần chúng	k w ə n ˨˩ t͡ɕ ʊ w ŋ͡m ˧˦
quần què	k w ə n ˨˩ k w ɛ ˨˩
quần vợt	k w ə n ˨˩ v əː t̚ ˧˨ ʔ
quần đảo	k w ə n ˨˩ ʔ ɗ aː w ˧˩
quầy	k w ə j ˨˩
quận chúa	k w ə n ˧˨ ʔ t͡ɕ u ə ˧˦
quặng	k w a ŋ ˧˨ ʔ
quốc huy	k u ə k̚ ˧˦ h w i ˧˧
quốc tịch	k u ə k̚ ˧˦ t ï k̟̚ ˧˨ ʔ
quốc vương	k u ə k̚ ˧˦ v ɨ ə ŋ ˧˧
quỵ	k w i ˧˨ ʔ
quỵt	k w i t̚ ˧˨ ʔ
ra chơi	z aː ˧˧ t͡ɕ əː j ˧˧
ran	z aː n ˧˧
rau dớn	z a w ˧˧ z əː n ˧˦
rau má	z a w ˧˧ m aː ˧˦
ria	z i ə ˧˧
riêu	z i ə w ˧˧
riết	z i ə t̚ ˧˦
run rẩy	z u n ˧˧ z ə j ˧˩
ruteni	ɹ u ˧˧ t e ˧˧ n i ˧˧
ruồi	z u ə j ˨˩
ruột	z u ə t̚ ˧˨ ʔ
ruột già	z u ə t̚ ˧˨ ʔ z aː ˨˩
ruột thịt	z u ə t̚ ˧˨ ʔ tʰ i t̚ ˧˨ ʔ
ruột thừa	z u ə t̚ ˧˨ ʔ tʰ ɨ ə ˨˩
ràng	z aː ŋ ˨˩
ràng buộc	z aː ŋ ˨˩ ʔ ɓ u ə k̚ ˧˨ ʔ
rành	z a j ŋ̟ ˨˩
rào cản	z aː w ˨˩ k aː n ˧˩
rách rưới	z a j k̟̚ ˧˦ z ɨ ə j ˧˦
rán	z aː n ˧˦
ráng	z aː ŋ ˧˦
râm	z ə m ˧˧
râu mép	z ə w ˧˧ m ɛ p̚ ˧˦
rê	z e ˧˧
rên rỉ	z e n ˧˧ z i ˧˩
rình	z ï ŋ ˨˩
rình rập	z ï ŋ ˨˩ z ə p̚ ˧˨ ʔ
rìu	z i w ˨˩
rích	z ï k̟̚ ˧˦
ròng	z a w ŋ͡m ˨˩
rô	z o ˧˧
rõ	z ɔ ˦˥
rùa	z u ə ˨˩
rú	z u ˧˦
rúc	z ʊ w k͡p̚ ˧˦
răng cửa	z a ŋ ˧˧ k ɨ ə ˧˩
răng sữa	z a ŋ ˧˧ s ɨ ə ˦˥
rườm rà	z ɨ ə m ˨˩ z aː ˨˩
rượu	z i ə w ˧˨ ʔ
rượu bia	z i ə w ˧˨ ʔ ʔ ɓ i ə ˧˧
rượu cốctay	z i ə w ˧˨ ʔ k ə w k͡p̚ ˧˦ t a j ˧˧
rượu táo	z i ə w ˧˨ ʔ t aː w ˧˦
rạn	z aː n ˧˨ ʔ
rạn nứt	z aː n ˧˨ ʔ n ɨ t̚ ˧˦
rạng	z aː ŋ ˧˨ ʔ
rạng ngời	z aː ŋ ˧˨ ʔ ŋ əː j ˨˩
rải	z aː j ˧˩
rấp	z ə p̚ ˧˦
rất mực	z ə t̚ ˧˦ m ɨ k̚ ˧˨ ʔ
rầm	z ə m ˨˩
rầu	z ə w ˨˩
rắn cạp nia	z a n ˧˦ k aː p̚ ˧˨ ʔ n i ə ˧˧
rắn cạp nia biển	z a n ˧˦ k aː p̚ ˧˨ ʔ n i ə ˧˧ ʔ ɓ i ə n ˧˩
rắn mối	z a n ˧˦ m o j ˧˦
rắn đuôi chuông	z a n ˧˦ ʔ ɗ u ə j ˧˧ t͡ɕ u ə ŋ ˧˧
rắp	z a p̚ ˧˦
rằm	z a m ˨˩
rết	z e t̚ ˧˦
rỉa rói	z i ə ˧˩ z ɔ j ˧˦
rọi	z ɔ j ˧˨ ʔ
rốt cuộc	z o t̚ ˧˦ k u ə k̚ ˧˨ ʔ
rộn rã	z o n ˧˨ ʔ z aː ˦˥
rộng mở	z ə w ŋ͡m ˧˨ ʔ m əː ˧˩
rời khỏi	z əː j ˨˩ x ɔ j ˧˩
rỡ	z əː ˦˥
rục rịch	z ʊ w k͡p̚ ˧˨ ʔ z ï k̟̚ ˧˨ ʔ
rụt rè	z u t̚ ˧˨ ʔ z ɛ ˨˩
rủ	z u ˧˩
rủi ro	z u j ˧˩ z ɔ ˧˧
rủng rỉnh	z ʊ w ŋ͡m ˧˩ z ï ŋ ˧˩
rứt	z ɨ t̚ ˧˦
rừng ngập mặn	z ɨ ŋ ˨˩ ŋ ə p̚ ˧˨ ʔ m a n ˧˨ ʔ
rữa	z ɨ ə ˦˥
rực rỡ	z ɨ k̚ ˧˨ ʔ z əː ˦˥
sa	s aː ˧˧
sa giông	s aː ˧˧ z ə w ŋ͡m ˧˧
sa ngã	s aː ˧˧ ŋ aː ˦˥
sa đéc	s aː ˧˧ ʔ ɗ ɛ k̚ ˧˦
sai lầm	s aː j ˧˧ l ə m ˨˩
sai phạm	s aː j ˧˧ f aː m ˧˨ ʔ
sai sót	s aː j ˧˧ s ɔ t̚ ˧˦
sang	s aː ŋ ˧˧
sang tên	s aː ŋ ˧˧ t e n ˧˧
sao	s aː w ˧˧
sao biển	s aː w ˧˧ ʔ ɓ i ə n ˧˩
sao khổng lồ đỏ	s aː w ˧˧ x ə w ŋ͡m ˧˩ l o ˨˩ ʔ ɗ ɔ ˧˩
sao lùn trắng	s aː w ˧˧ l u n ˨˩ t͡ɕ a ŋ ˧˦
sao thuỷ	s aː w ˧˧ tʰ w i ˧˩
say nắng	s a j ˧˧ n a ŋ ˧˦
say rượu	s a j ˧˧ z i ə w ˧˨ ʔ
say sưa	s a j ˧˧ s ɨ ə ˧˧
say đắm	s a j ˧˧ ʔ ɗ a m ˧˦
sg.	s ə w ŋ͡m ˧˧
si la	s i ˧˧ l aː ˧˧
sida	s i ˧˧ ʔ ɗ aː ˧˧
silic	s i ˧˧ l ï k̟̚ ˧˦
sim	s i m ˧˧
sinh thiết	s ï ŋ ˧˧ tʰ i ə t̚ ˧˦
sinh tồn	s ï ŋ ˧˧ t o n ˨˩
siêu máy tính	s i ə w ˧˧ m a j ˧˦ t ï ŋ ˧˦
siêu mẫu	s i ə w ˧˧ m ə w ˦˥
siêu nhân	s i ə w ˧˧ ɲ ə n ˧˧
siêu thị	s i ə w ˧˧ tʰ i ˧˨ ʔ
siêu vi	s i ə w ˧˧ v i ˧˧
siêu vi corona	s i ə w ˧˧ v i ˧˧ k ɔ ˧˧ z o ˧˧ n aː ˧˧
so	s ɔ ˧˧
so bì	s ɔ ˧˧ ʔ ɓ i ˨˩
so le trong	s ɔ ˧˧ l ɛ ˧˧ t͡ɕ a w ŋ͡m ˧˧
son	s ɔ n ˧˧
song	s a w ŋ͡m ˧˧
song thân	s a w ŋ͡m ˧˧ tʰ ə n ˧˧
song tiết	s a w ŋ͡m ˧˧ t i ə t̚ ˧˦
soát xét	s w aː t̚ ˧˦ s ɛ t̚ ˧˦
soạn thảo	s w aː n ˧˨ ʔ tʰ aː w ˧˩
su hào	s u ˧˧ h aː w ˨˩
sung	s ʊ w ŋ͡m ˧˧
suy hao	s w i ˧˧ h aː w ˧˧
suy tư	s w i ˧˧ t ɨ ˧˧
suy xét	s w i ˧˧ s ɛ t̚ ˧˦
suy yếu	s w i ˧˧ ʔ i ə w ˧˦
suôn	s u ə n ˧˧
suối vàng	s u ə j ˧˦ v aː ŋ ˨˩
suốt	s u ə t̚ ˧˦
sài thành	s aː j ˨˩ tʰ a j ŋ̟ ˨˩
sàn diễn	s aː n ˨˩ z i ə n ˦˥
sàn nhà	s aː n ˨˩ ɲ aː ˨˩
sàng	s aː ŋ ˨˩
sàng lọc	s aː ŋ ˨˩ l a w k͡p̚ ˧˨ ʔ
sành	s a j ŋ̟ ˨˩
sách gối đầu giường	s a j k̟̚ ˧˦ ɣ o j ˧˦ ʔ ɗ ə w ˨˩ z ɨ ə ŋ ˨˩
sán chay	s aː n ˧˦ t͡ɕ a j ˧˧
sáng sớm	s aː ŋ ˧˦ s əː m ˧˦
sáng thế kí	s aː ŋ ˧˦ tʰ e ˧˦ k i ˧˦
sáo	s aː w ˧˦
sáo nhỏ	s aː w ˧˦ ɲ ɔ ˧˩
sáp	s aː p̚ ˧˦
sát hại	s aː t̚ ˧˦ h aː j ˧˨ ʔ
sát khuẩn	s aː t̚ ˧˦ x w ə n ˧˩
sát nút	s aː t̚ ˧˦ n u t̚ ˧˦
sâm	s ə m ˧˧
sâm bổ lượng	s ə m ˧˧ ʔ ɓ o ˧˩ l ɨ ə ŋ ˧˨ ʔ
sân bay quốc tế	s ə n ˧˧ ʔ ɓ a j ˧˧ k u ə k̚ ˧˦ t e ˧˦
sân chơi	s ə n ˧˧ t͡ɕ əː j ˧˧
sâu rộng	s ə w ˧˧ z ə w ŋ͡m ˧˨ ʔ
sâu đậm	s ə w ˧˧ ʔ ɗ ə m ˧˨ ʔ
sênh	s ə j ŋ̟ ˧˧
síp	s i p̚ ˧˦
sò	s ɔ ˨˩
sòng bạc	s a w ŋ͡m ˨˩ ʔ ɓ aː k̚ ˧˨ ʔ
sóc vọng	s a w k͡p̚ ˧˦ v a w ŋ͡m ˧˨ ʔ
sóng	s a w ŋ͡m ˧˦
sông cửu long	s ə w ŋ͡m ˧˧ k i w ˧˩ l a w ŋ͡m ˧˧
sông suối	s ə w ŋ͡m ˧˧ s u ə j ˧˦
sùng kính	s ʊ w ŋ͡m ˨˩ k ï ŋ ˧˦
súc	s ʊ w k͡p̚ ˧˦
súng trường	s ʊ w ŋ͡m ˧˦ t͡ɕ ɨ ə ŋ ˨˩
súng đạn	s ʊ w ŋ͡m ˧˦ ʔ ɗ aː n ˧˨ ʔ
sút	s u t̚ ˧˦
săm	s a m ˧˧
săn	s a n ˧˧
săn chắc	s a n ˧˧ t͡ɕ a k̚ ˧˦
sĩ	s i ˦˥
sĩ diện	s i ˦˥ z i ə n ˧˨ ʔ
sĩ tử	s i ˦˥ t ɨ ˧˩
sơ	s əː ˧˧
sơ sinh	s əː ˧˧ s ï ŋ ˧˧
sơ đồ	s əː ˧˧ ʔ ɗ o ˨˩
sơn tây	s əː n ˧˧ t ə j ˧˧
sư mẫu	s ɨ ˧˧ m ə w ˦˥
sư tỉ	s ɨ ˧˧ t i ˧˩
sư tử	s ɨ ˧˧ t ɨ ˧˩
sương sâm	s ɨ ə ŋ ˧˧ s ə m ˧˧
sướng	s ɨ ə ŋ ˧˦
sạt nghiệp	s aː t̚ ˧˨ ʔ ŋ i ə p̚ ˧˨ ʔ
sả	s aː ˧˩
sản nghiệp	s aː n ˧˩ ŋ i ə p̚ ˧˨ ʔ
sản phụ	s aː n ˧˩ f u ˧˨ ʔ
sản sinh	s aː n ˧˩ s ï ŋ ˧˧
sản xuất	s aː n ˧˩ s w ə t̚ ˧˦
sấm	s ə m ˧˦
sấu	s ə w ˧˦
sầm sập	s ə m ˨˩ s ə p̚ ˧˨ ʔ
sầu riêng	s ə w ˨˩ z i ə ŋ ˧˧
sầy	s ə j ˨˩
sậm	s ə m ˧˨ ʔ
sậy	s ə j ˧˨ ʔ
sắc tố	s a k̚ ˧˦ t o ˧˦
sắc tộc	s a k̚ ˧˦ t ə w k͡p̚ ˧˨ ʔ
sắc đẹp	s a k̚ ˧˦ ʔ ɗ ɛ p̚ ˧˨ ʔ
sặc sỡ	s a k̚ ˧˨ ʔ s əː ˦˥
sẽ	s ɛ ˦˥
sến	s e n ˧˦
sến sẩm	s e n ˧˦ s ə m ˧˩
sỉ	s i ˧˩
số	s o ˧˦
số chia	s o ˧˦ t͡ɕ i ə ˧˧
số phận	s o ˧˦ f ə n ˧˨ ʔ
sốc phản vệ	s ə w k͡p̚ ˧˦ f aː n ˧˩ v e ˧˨ ʔ
sốt	s o t̚ ˧˦
sốt rét	s o t̚ ˧˦ z ɛ t̚ ˧˦
sổ mũi	s o ˧˩ m u j ˦˥
sở hữu	s əː ˧˩ h i w ˦˥
sở trường	s əː ˧˩ t͡ɕ ɨ ə ŋ ˨˩
sở đoản	s əː ˧˩ ʔ ɗ w aː n ˧˩
sởi	s əː j ˧˩
sục sạo	s ʊ w k͡p̚ ˧˨ ʔ s aː w ˧˨ ʔ
sụp đổ	s u p̚ ˧˨ ʔ ʔ ɗ o ˧˩
sụt	s u t̚ ˧˨ ʔ
sủa	s u ə ˧˩
sủi	s u j ˧˩
sức sống	s ɨ k̚ ˧˦ s ə w ŋ͡m ˧˦
sứt	s ɨ t̚ ˧˦
sừng	s ɨ ŋ ˨˩
sửa	s ɨ ə ˧˩
sữa đặc	s ɨ ə ˦˥ ʔ ɗ a k̚ ˧˨ ʔ
sự thật	s ɨ ˧˨ ʔ tʰ ə t̚ ˧˨ ʔ
sự tích	s ɨ ˧˨ ʔ t ï k̟̚ ˧˦
sự đời	s ɨ ˧˨ ʔ ʔ ɗ əː j ˨˩
sực	s ɨ k̚ ˧˨ ʔ
tai hoạ	t aː j ˧˧ h w aː ˧˨ ʔ
tam giác	t aː m ˧˧ z aː k̚ ˧˦
tan	t aː n ˧˧
tan vỡ	t aː n ˧˧ v əː ˦˥
tau	t a w ˧˧
tecnexi	t ɛ k̚ ˧˦ n e ˧˧ s i ˧˧
telu	t ɛ ˧˧ l u ˧˧
tgp	t ə w ŋ͡m ˧˩ z aː w ˧˦ f ə n ˧˨ ʔ
tham thì thâm	tʰ aː m ˧˧ tʰ i ˨˩ tʰ ə m ˧˧
than vãn	tʰ aː n ˧˧ v aː n ˦˥
than ôi	tʰ aː n ˧˧ ʔ o j ˧˧
thang máy	tʰ aː ŋ ˧˧ m a j ˧˦
thanh	tʰ a j ŋ̟ ˧˧
thanh hoá	tʰ a j ŋ̟ ˧˧ h w aː ˧˦
thanh môn	tʰ a j ŋ̟ ˧˧ m o n ˧˧
thanh nhã	tʰ a j ŋ̟ ˧˧ ɲ aː ˦˥
thanh niên	tʰ a j ŋ̟ ˧˧ n i ə n ˧˧
thanh quản	tʰ a j ŋ̟ ˧˧ k w aː n ˧˩
thanh thoát	tʰ a j ŋ̟ ˧˧ tʰ w aː t̚ ˧˦
thanh toán	tʰ a j ŋ̟ ˧˧ t w aː n ˧˦
thanh điệu	tʰ a j ŋ̟ ˧˧ ʔ ɗ i ə w ˧˨ ʔ
thay thế	tʰ a j ˧˧ tʰ e ˧˦
thcs	t͡ɕ ʊ w ŋ͡m ˧˧ h a w k͡p̚ ˧˨ ʔ k əː ˧˧ s əː ˧˩
theo dõi	tʰ ɛ w ˧˧ z ɔ j ˦˥
theo đuổi	tʰ ɛ w ˧˧ ʔ ɗ u ə j ˧˩
thi hành	tʰ i ˧˧ h a j ŋ̟ ˨˩
thi nhân	tʰ i ˧˧ ɲ ə n ˧˧
thiên hà	tʰ i ə n ˧˧ h aː ˨˩
thiên hạt	tʰ i ə n ˧˧ h aː t̚ ˧˨ ʔ
thiên nga	tʰ i ə n ˧˧ ŋ aː ˧˧
thiên thần sa ngã	tʰ i ə n ˧˧ tʰ ə n ˨˩ s aː ˧˧ ŋ aː ˦˥
thiên thặng chi quốc	tʰ i ə n ˧˧ tʰ a ŋ ˧˨ ʔ t͡ɕ i ˧˧ k u ə k̚ ˧˦
thiên xứng	tʰ i ə n ˧˧ s ɨ ŋ ˧˦
thiên đàng	tʰ i ə n ˧˧ ʔ ɗ aː ŋ ˨˩
thiêng liêng	tʰ i ə ŋ ˧˧ l i ə ŋ ˧˧
thiến	tʰ i ə n ˧˦
thiếp	tʰ i ə p̚ ˧˦
thiết bị	tʰ i ə t̚ ˧˦ ʔ ɓ i ˧˨ ʔ
thiết lập	tʰ i ə t̚ ˧˦ l ə p̚ ˧˨ ʔ
thiết tha	tʰ i ə t̚ ˧˦ tʰ aː ˧˧
thiếu nhi	tʰ i ə w ˧˦ ɲ i ˧˧
thiếu sót	tʰ i ə w ˧˦ s ɔ t̚ ˧˦
thiếu vắng	tʰ i ə w ˧˦ v a ŋ ˧˦
thiểm tây	tʰ i ə m ˧˩ t ə j ˧˧
thiển cận	tʰ i ə n ˧˩ k ə n ˧˨ ʔ
thiện	tʰ i ə n ˧˨ ʔ
thiện cảm	tʰ i ə n ˧˨ ʔ k aː m ˧˩
thoi thóp	tʰ ɔ j ˧˧ tʰ ɔ p̚ ˧˦
thon	tʰ ɔ n ˧˧
thon thả	tʰ ɔ n ˧˧ tʰ aː ˧˩
thong thả	tʰ a w ŋ͡m ˧˧ tʰ aː ˧˩
thoát	tʰ w aː t̚ ˧˦
thoại	tʰ w aː j ˧˨ ʔ
thoả	tʰ w aː ˧˩
thoảng	tʰ w aː ŋ ˧˩
thpt	t͡ɕ ʊ w ŋ͡m ˧˧ h a w k͡p̚ ˧˨ ʔ f o ˧˩ tʰ ə w ŋ͡m ˧˧
thu	tʰ u ˧˧
thu hút	tʰ u ˧˧ h u t̚ ˧˦
thu nhập	tʰ u ˧˧ ɲ ə p̚ ˧˨ ʔ
thun	tʰ u n ˧˧
thuyên chuyển	tʰ w i ə n ˧˧ t͡ɕ w i ə n ˧˩
thuyên tắc ối	tʰ w i ə n ˧˧ t a k̚ ˧˦ ʔ o j ˧˦
thuyết minh	tʰ w i ə t̚ ˧˦ m ï ŋ ˧˧
thuyết trình	tʰ w i ə t̚ ˧˦ t͡ɕ ï ŋ ˨˩
thuyền nhân	tʰ w i ə n ˨˩ ɲ ə n ˧˧
thuý	tʰ w i ˧˦
thuần	tʰ w ə n ˨˩
thuần việt	tʰ w ə n ˨˩ v i ə t̚ ˧˨ ʔ
thuận	tʰ w ə n ˧˨ ʔ
thuận hoá	tʰ w ə n ˧˨ ʔ h w aː ˧˦
thuận tiện	tʰ w ə n ˧˨ ʔ t i ə n ˧˨ ʔ
thuật chiêm tinh	tʰ w ə t̚ ˧˨ ʔ t͡ɕ i ə m ˧˧ t ï ŋ ˧˧
thuật giả kim	tʰ w ə t̚ ˧˨ ʔ z aː ˧˩ k i m ˧˧
thuật toán	tʰ w ə t̚ ˧˨ ʔ t w aː n ˧˦
thuốc lào	tʰ u ə k̚ ˧˦ l aː w ˨˩
thuốc lá	tʰ u ə k̚ ˧˦ l aː ˧˦
thuốc men	tʰ u ə k̚ ˧˦ m ɛ n ˧˧
thuộc địa	tʰ u ə k̚ ˧˨ ʔ ʔ ɗ i ə ˧˨ ʔ
thuỷ chiến	tʰ w i ˧˩ t͡ɕ i ə n ˧˦
thuỷ chung	tʰ w i ˧˩ t͡ɕ ʊ w ŋ͡m ˧˧
thuỷ tinh thể	tʰ w i ˧˩ t ï ŋ ˧˧ tʰ e ˧˩
thuỷ tức	tʰ w i ˧˩ t ɨ k̚ ˧˦
thà	tʰ aː ˨˩
thành hoàng	tʰ a j ŋ̟ ˨˩ h w aː ŋ ˨˩
thành ngữ	tʰ a j ŋ̟ ˨˩ ŋ ɨ ˦˥
thành niên	tʰ a j ŋ̟ ˨˩ n i ə n ˧˧
thành thạo	tʰ a j ŋ̟ ˨˩ tʰ aː w ˧˨ ʔ
thành uỷ	tʰ a j ŋ̟ ˨˩ ʔ w i ˧˩
thái bình	tʰ aː j ˧˦ ʔ ɓ ï ŋ ˨˩
thái bình dương	tʰ aː j ˧˦ ʔ ɓ ï ŋ ˨˩ z ɨ ə ŋ ˧˧
thái cực quyền	tʰ aː j ˧˦ k ɨ k̚ ˧˨ ʔ k w i ə n ˨˩
thái giám	tʰ aː j ˧˦ z aː m ˧˦
thái lan	tʰ aː j ˧˦ l aː n ˧˧
thái nguyên	tʰ aː j ˧˦ ŋ w i ə n ˧˧
thám tử	tʰ aː m ˧˦ t ɨ ˧˩
thán khí	tʰ aː n ˧˦ x i ˧˦
tháng sáu	tʰ aː ŋ ˧˦ s a w ˧˦
thánh thần	tʰ a j ŋ̟ ˧˦ tʰ ə n ˨˩
tháp ngà	tʰ aː p̚ ˧˦ ŋ aː ˨˩
thâm	tʰ ə m ˧˧
thâm quyến	tʰ ə m ˧˧ k w i ə n ˧˦
thân binh	tʰ ə n ˧˧ ʔ ɓ ï ŋ ˧˧
thân hình	tʰ ə n ˧˧ h ï ŋ ˨˩
thân mình	tʰ ə n ˧˧ m ï ŋ ˨˩
thân thiết	tʰ ə n ˧˧ tʰ i ə t̚ ˧˦
thân thuộc	tʰ ə n ˧˧ tʰ u ə k̚ ˧˨ ʔ
thân thế	tʰ ə n ˧˧ tʰ e ˧˦
thân thể	tʰ ə n ˧˧ tʰ e ˧˩
thâu	tʰ ə w ˧˧
thèm	tʰ ɛ m ˨˩
thê lương	tʰ e ˧˧ l ɨ ə ŋ ˧˧
thê thảm	tʰ e ˧˧ tʰ aː m ˧˩
thêu thùa	tʰ e w ˧˧ tʰ u ə ˨˩
thêôđorô	tʰ e ˧˧ ʔ o ˧˧ ʔ ɗ ɔ ˧˧ z o ˧˧
thì là	tʰ i ˨˩ l aː ˨˩
thì thào	tʰ i ˨˩ tʰ aː w ˨˩
thí	tʰ i ˧˦
thích	tʰ ï k̟̚ ˧˦
thím	tʰ i m ˧˦
thính giác	tʰ ï ŋ ˧˦ z aː k̚ ˧˦
thò	tʰ ɔ ˨˩
thóp	tʰ ɔ p̚ ˧˦
thông cảm	tʰ ə w ŋ͡m ˧˧ k aː m ˧˩
thông minh	tʰ ə w ŋ͡m ˧˧ m ï ŋ ˧˧
thông tục	tʰ ə w ŋ͡m ˧˧ t ʊ w k͡p̚ ˧˨ ʔ
thùa	tʰ u ə ˨˩
thùng rỗng kêu to	tʰ ʊ w ŋ͡m ˨˩ z ə w ŋ͡m ˦˥ k e w ˧˧ t ɔ ˧˧
thú mỏ vịt	tʰ u ˧˦ m ɔ ˧˩ v i t̚ ˧˨ ʔ
thú vật	tʰ u ˧˦ v ə t̚ ˧˨ ʔ
thú ăn kiến	tʰ u ˧˦ ʔ a n ˧˧ k i ə n ˧˦
thúc phụ	tʰ ʊ w k͡p̚ ˧˦ f u ˧˨ ʔ
thúng	tʰ ʊ w ŋ͡m ˧˦
thăm hỏi	tʰ a m ˧˧ h ɔ j ˧˩
thăm quan	tʰ a m ˧˧ k w aː n ˧˧
thăm thẳm	tʰ a m ˧˧ tʰ a m ˧˩
thăng	tʰ a ŋ ˧˧
thăng bằng	tʰ a ŋ ˧˧ ʔ ɓ a ŋ ˨˩
thăng long	tʰ a ŋ ˧˧ l a w ŋ͡m ˧˧
thơ	tʰ əː ˧˧
thư kí	tʰ ɨ ˧˧ k i ˧˦
thưa thớt	tʰ ɨ ə ˧˧ tʰ əː t̚ ˧˦
thương	tʰ ɨ ə ŋ ˧˧
thương nghiệp	tʰ ɨ ə ŋ ˧˧ ŋ i ə p̚ ˧˨ ʔ
thương người như thể thương thân	tʰ ɨ ə ŋ ˧˧ ŋ ɨ ə j ˨˩ ɲ ɨ ˧˧ tʰ e ˧˩ tʰ ɨ ə ŋ ˧˧ tʰ ə n ˧˧
thương đội	tʰ ɨ ə ŋ ˧˧ ʔ ɗ o j ˧˨ ʔ
thường niên	tʰ ɨ ə ŋ ˨˩ n i ə n ˧˧
thường thường	tʰ ɨ ə ŋ ˨˩ tʰ ɨ ə ŋ ˨˩
thường trú dân	tʰ ɨ ə ŋ ˨˩ t͡ɕ u ˧˦ z ə n ˧˧
thưởng	tʰ ɨ ə ŋ ˧˩
thưởng thức	tʰ ɨ ə ŋ ˧˩ tʰ ɨ k̚ ˧˦
thượng du	tʰ ɨ ə ŋ ˧˨ ʔ z u ˧˧
thượng hạng	tʰ ɨ ə ŋ ˧˨ ʔ h aː ŋ ˧˨ ʔ
thượng nghị viện	tʰ ɨ ə ŋ ˧˨ ʔ ŋ i ˧˨ ʔ v i ə n ˧˨ ʔ
thượng tá	tʰ ɨ ə ŋ ˧˨ ʔ t aː ˧˦
thượng đế	tʰ ɨ ə ŋ ˧˨ ʔ ʔ ɗ e ˧˦
thạc sĩ	tʰ aː k̚ ˧˨ ʔ s i ˦˥
thạch tín	tʰ a j k̟̚ ˧˨ ʔ t i n ˧˦
thải	tʰ aː j ˧˩
thảm sát	tʰ aː m ˧˩ s aː t̚ ˧˦
thảo nào	tʰ aː w ˧˩ n aː w ˨˩
thấm thía	tʰ ə m ˧˦ tʰ i ə ˧˦
thấp	tʰ ə p̚ ˧˦
thấp thoáng	tʰ ə p̚ ˧˦ tʰ w aː ŋ ˧˦
thất nữ	tʰ ə t̚ ˧˦ n ɨ ˦˥
thất thanh	tʰ ə t̚ ˧˦ tʰ a j ŋ̟ ˧˧
thất tịch	tʰ ə t̚ ˧˦ t ï k̟̚ ˧˨ ʔ
thấu	tʰ ə w ˧˦
thấy	tʰ ə j ˧˦
thần học	tʰ ə n ˨˩ h a w k͡p̚ ˧˨ ʔ
thần kinh	tʰ ə n ˨˩ k ï ŋ ˧˧
thần nông	tʰ ə n ˨˩ n ə w ŋ͡m ˧˧
thần phong	tʰ ə n ˨˩ f a w ŋ͡m ˧˧
thần thoại	tʰ ə n ˨˩ tʰ w aː j ˧˨ ʔ
thần thái	tʰ ə n ˨˩ tʰ aː j ˧˦
thầu dầu	tʰ ə w ˨˩ z ə w ˨˩
thầy bói	tʰ ə j ˨˩ ʔ ɓ ɔ j ˧˦
thầy lang	tʰ ə j ˨˩ l aː ŋ ˧˧
thầy thuốc	tʰ ə j ˨˩ tʰ u ə k̚ ˧˦
thẩm mĩ viện	tʰ ə m ˧˩ m i ˦˥ v i ə n ˧˨ ʔ
thẩm quyền	tʰ ə m ˧˩ k w i ə n ˨˩
thẩm định	tʰ ə m ˧˩ ʔ ɗ ï ŋ ˧˨ ʔ
thẩy	tʰ ə j ˧˩
thận trọng	tʰ ə n ˧˨ ʔ t͡ɕ a w ŋ͡m ˧˨ ʔ
thập lục phân	tʰ ə p̚ ˧˨ ʔ l ʊ w k͡p̚ ˧˨ ʔ f ə n ˧˧
thắm thiết	tʰ a m ˧˦ tʰ i ə t̚ ˧˦
thắp	tʰ a p̚ ˧˦
thắt	tʰ a t̚ ˧˦
thằn lằn bóng	tʰ a n ˨˩ l a n ˨˩ ʔ ɓ a w ŋ͡m ˧˦
thằng cha	tʰ a ŋ ˨˩ t͡ɕ aː ˧˧
thẳng	tʰ a ŋ ˧˩
thẳng thắn	tʰ a ŋ ˧˩ tʰ a n ˧˦
thẳng thớm	tʰ a ŋ ˧˩ tʰ əː m ˧˦
thẻ tín dụng	tʰ ɛ ˧˩ t i n ˧˦ z ʊ w ŋ͡m ˧˨ ʔ
thẻ xanh	tʰ ɛ ˧˩ s a j ŋ̟ ˧˧
thế kỉ ánh sáng	tʰ e ˧˦ k i ˧˩ ʔ a j ŋ̟ ˧˦ s aː ŋ ˧˦
thế năng	tʰ e ˧˦ n a ŋ ˧˧
thềm	tʰ e m ˨˩
thể	tʰ e ˧˩
thể dục nghệ thuật	tʰ e ˧˩ z ʊ w k͡p̚ ˧˨ ʔ ŋ e ˧˨ ʔ tʰ w ə t̚ ˧˨ ʔ
thể loại	tʰ e ˧˩ l w aː j ˧˨ ʔ
thị	tʰ i ˧˨ ʔ
thị chính	tʰ i ˧˨ ʔ t͡ɕ ï ŋ ˧˦
thị giác	tʰ i ˧˨ ʔ z aː k̚ ˧˦
thị trấn	tʰ i ˧˨ ʔ t͡ɕ ə n ˧˦
thịnh hành	tʰ ï ŋ ˧˨ ʔ h a j ŋ̟ ˨˩
thống kê	tʰ ə w ŋ͡m ˧˦ k e ˧˧
thống phong	tʰ ə w ŋ͡m ˧˦ f a w ŋ͡m ˧˧
thổi	tʰ o j ˧˩
thời	tʰ əː j ˨˩
thời giờ	tʰ əː j ˨˩ z əː ˨˩
thời khắc	tʰ əː j ˨˩ x a k̚ ˧˦
thời quá khứ	tʰ əː j ˨˩ k w aː ˧˦ x ɨ ˧˦
thời sự	tʰ əː j ˨˩ s ɨ ˧˨ ʔ
thời điểm	tʰ əː j ˨˩ ʔ ɗ i ə m ˧˩
thở dài	tʰ əː ˧˩ z aː j ˨˩
thở than	tʰ əː ˧˩ tʰ aː n ˧˧
thụ hưởng	tʰ u ˧˨ ʔ h ɨ ə ŋ ˧˩
thủ	tʰ u ˧˩
thủ công	tʰ u ˧˩ k ə w ŋ͡m ˧˧
thủ thỉ	tʰ u ˧˩ tʰ i ˧˩
thủm	tʰ u m ˧˩
thứ bảy	tʰ ɨ ˧˦ ʔ ɓ a j ˧˩
thứ năm	tʰ ɨ ˧˦ n a m ˧˧
thứ tư	tʰ ɨ ˧˦ t ɨ ˧˧
thức dậy	tʰ ɨ k̚ ˧˦ z ə j ˧˨ ʔ
thức ăn nhanh	tʰ ɨ k̚ ˧˦ ʔ a n ˧˧ ɲ a j ŋ̟ ˧˧
thừa hưởng	tʰ ɨ ə ˨˩ h ɨ ə ŋ ˧˩
thừa nhận	tʰ ɨ ə ˨˩ ɲ ə n ˧˨ ʔ
thừa phì mã, ý khinh cừu	tʰ ɨ ə ˨˩ f i ˨˩ m aː ˦˥ ʔ i ˧˦ x ï ŋ ˧˧ k i w ˨˩
thừng	tʰ ɨ ŋ ˨˩
thực dụng	tʰ ɨ k̚ ˧˨ ʔ z ʊ w ŋ͡m ˧˨ ʔ
thực hiện	tʰ ɨ k̚ ˧˨ ʔ h i ə n ˧˨ ʔ
thực hành	tʰ ɨ k̚ ˧˨ ʔ h a j ŋ̟ ˨˩
thực nghiệm	tʰ ɨ k̚ ˧˨ ʔ ŋ i ə m ˧˨ ʔ
thực thà	tʰ ɨ k̚ ˧˨ ʔ tʰ aː ˨˩
thực trạng	tʰ ɨ k̚ ˧˨ ʔ t͡ɕ aː ŋ ˧˨ ʔ
thực tại	tʰ ɨ k̚ ˧˨ ʔ t aː j ˧˨ ʔ
thực tế tăng cường	tʰ ɨ k̚ ˧˨ ʔ t e ˧˦ t a ŋ ˧˧ k ɨ ə ŋ ˨˩
thực tế ảo	tʰ ɨ k̚ ˧˨ ʔ t e ˧˦ ʔ aː w ˧˩
thực vật	tʰ ɨ k̚ ˧˨ ʔ v ə t̚ ˧˨ ʔ
ti vi	t i ˧˧ v i ˧˧
tia số	t i ə ˧˧ s o ˧˦
tin học	t i n ˧˧ h a w k͡p̚ ˧˨ ʔ
tin đồn	t i n ˧˧ ʔ ɗ o n ˨˩
tinh dầu	t ï ŋ ˧˧ z ə w ˨˩
tinh nghịch	t ï ŋ ˧˧ ŋ ï k̟̚ ˧˨ ʔ
tinh thần	t ï ŋ ˧˧ tʰ ə n ˨˩
tinh thể	t ï ŋ ˧˧ tʰ e ˧˩
tinh tuý	t ï ŋ ˧˧ t w i ˧˦
tiên	t i ə n ˧˧
tiên lượng	t i ə n ˧˧ l ɨ ə ŋ ˧˨ ʔ
tiên tiến	t i ə n ˧˧ t i ə n ˧˦
tiêu	t i ə w ˧˧
tiêu chảy	t i ə w ˧˧ t͡ɕ a j ˧˩
tiêu ngữ	t i ə w ˧˧ ŋ ɨ ˦˥
tiêu điểm	t i ə w ˧˧ ʔ ɗ i ə m ˧˩
tiếc	t i ə k̚ ˧˦
tiến bộ	t i ə n ˧˦ ʔ ɓ o ˧˨ ʔ
tiến quân ca	t i ə n ˧˦ k w ə n ˧˧ k aː ˧˧
tiến thoái lưỡng nan	t i ə n ˧˦ tʰ w aː j ˧˦ l ɨ ə ŋ ˦˥ n aː n ˧˧
tiếng mãn	t i ə ŋ ˧˦ m aː n ˦˥
tiếng mễ	t i ə ŋ ˧˦ m e ˦˥
tiếng nga	t i ə ŋ ˧˦ ŋ aː ˧˧
tiếng phạn	t i ə ŋ ˧˦ f aː n ˧˨ ʔ
tiếng phổ thông	t i ə ŋ ˧˦ f o ˧˩ tʰ ə w ŋ͡m ˧˧
tiếp	t i ə p̚ ˧˦
tiếp cận	t i ə p̚ ˧˦ k ə n ˧˨ ʔ
tiếp diễn	t i ə p̚ ˧˦ z i ə n ˦˥
tiếp thị	t i ə p̚ ˧˦ tʰ i ˧˨ ʔ
tiếp viên	t i ə p̚ ˧˦ v i ə n ˧˧
tiếp vĩ ngữ	t i ə p̚ ˧˦ v i ˦˥ ŋ ɨ ˦˥
tiết	t i ə t̚ ˧˦
tiết lộ	t i ə t̚ ˧˦ l o ˧˨ ʔ
tiền bo	t i ə n ˨˩ ʔ ɓ ɔ ˧˧
tiền lương	t i ə n ˨˩ l ɨ ə ŋ ˧˧
tiền lệ	t i ə n ˨˩ l e ˧˨ ʔ
tiền nhuận bút	t i ə n ˨˩ ɲ w ə n ˧˨ ʔ ʔ ɓ u t̚ ˧˦
tiền tệ	t i ə n ˨˩ t e ˧˨ ʔ
tiểu hành tinh	t i ə w ˧˩ h a j ŋ̟ ˨˩ t ï ŋ ˧˧
tiểu hồi hương	t i ə w ˧˩ h o j ˨˩ h ɨ ə ŋ ˧˧
tiểu phẫu	t i ə w ˧˩ f ə w ˦˥
tiểu thuyết	t i ə w ˧˩ tʰ w i ə t̚ ˧˦
tiểu thương	t i ə w ˧˩ tʰ ɨ ə ŋ ˧˧
tiểu tiện	t i ə w ˧˩ t i ə n ˧˨ ʔ
tiểu vương quốc	t i ə w ˧˩ v ɨ ə ŋ ˧˧ k u ə k̚ ˧˦
tiểu đoàn	t i ə w ˧˩ ʔ ɗ w aː n ˨˩
tiểu đường	t i ə w ˧˩ ʔ ɗ ɨ ə ŋ ˨˩
tiệc	t i ə k̚ ˧˨ ʔ
to gan	t ɔ ˧˧ ɣ aː n ˧˧
to gan lớn mật	t ɔ ˧˧ ɣ aː n ˧˧ l əː n ˧˦ m ə t̚ ˧˨ ʔ
toà lãnh sự	t w aː ˨˩ l a j ŋ̟ ˦˥ s ɨ ˧˨ ʔ
toà nhà	t w aː ˨˩ ɲ aː ˨˩
toà án	t w aː ˨˩ ʔ aː n ˧˦
toàn bộ	t w aː n ˨˩ ʔ ɓ o ˧˨ ʔ
toàn cầu	t w aː n ˨˩ k ə w ˨˩
toác	t w aː k̚ ˧˦
tra tấn	t͡ɕ aː ˧˧ t ə n ˧˦
trang trí	t͡ɕ aː ŋ ˧˧ t͡ɕ i ˧˦
trang trại	t͡ɕ aː ŋ ˧˧ t͡ɕ aː j ˧˨ ʔ
trang viên	t͡ɕ aː ŋ ˧˧ v i ə n ˧˧
trang web	t͡ɕ aː ŋ ˧˧ ʔ w ɛ p̚ ˧˦
trang điểm	t͡ɕ aː ŋ ˧˧ ʔ ɗ i ə m ˧˩
tranh	t͡ɕ a j ŋ̟ ˧˧
tranh cãi	t͡ɕ a j ŋ̟ ˧˧ k aː j ˦˥
tranh luận	t͡ɕ a j ŋ̟ ˧˧ l w ə n ˧˨ ʔ
trau	t͡ɕ a w ˧˧
tre pheo	t͡ɕ ɛ ˧˧ f ɛ w ˧˧
tri thức luận	t͡ɕ i ˧˧ tʰ ɨ k̚ ˧˦ l w ə n ˧˨ ʔ
trinh sát	t͡ɕ ï ŋ ˧˧ s aː t̚ ˧˦
triều	t͡ɕ i ə w ˨˩
triều kém	t͡ɕ i ə w ˨˩ k ɛ m ˧˦
triều tiên	t͡ɕ i ə w ˨˩ t i ə n ˧˧
triển khai	t͡ɕ i ə n ˧˩ x aː j ˧˧
triện	t͡ɕ i ə n ˧˨ ʔ
triệt	t͡ɕ i ə t̚ ˧˨ ʔ
triệt phá	t͡ɕ i ə t̚ ˧˨ ʔ f aː ˧˦
triệt sản	t͡ɕ i ə t̚ ˧˨ ʔ s aː n ˧˩
triệt tiêu	t͡ɕ i ə t̚ ˧˨ ʔ t i ə w ˧˧
triệu	t͡ɕ i ə w ˧˨ ʔ
triệu chứng	t͡ɕ i ə w ˧˨ ʔ t͡ɕ ɨ ŋ ˧˦
triệu phú	t͡ɕ i ə w ˧˨ ʔ f u ˧˦
trong khi	t͡ɕ a w ŋ͡m ˧˧ x i ˧˧
trong trẻo	t͡ɕ a w ŋ͡m ˧˧ t͡ɕ ɛ w ˧˩
trung bình	t͡ɕ ʊ w ŋ͡m ˧˧ ʔ ɓ ï ŋ ˨˩
trung du	t͡ɕ ʊ w ŋ͡m ˧˧ z u ˧˧
trung dung	t͡ɕ ʊ w ŋ͡m ˧˧ z ʊ w ŋ͡m ˧˧
trung gian	t͡ɕ ʊ w ŋ͡m ˧˧ z aː n ˧˧
trung hoa	t͡ɕ ʊ w ŋ͡m ˧˧ h w aː ˧˧
trung hoa dân quốc	t͡ɕ ʊ w ŋ͡m ˧˧ h w aː ˧˧ z ə n ˧˧ k u ə k̚ ˧˦
trung học	t͡ɕ ʊ w ŋ͡m ˧˧ h a w k͡p̚ ˧˨ ʔ
trung học cơ sở	t͡ɕ ʊ w ŋ͡m ˧˧ h a w k͡p̚ ˧˨ ʔ k əː ˧˧ s əː ˧˩
trung phong	t͡ɕ ʊ w ŋ͡m ˧˧ f a w ŋ͡m ˧˧
trung sĩ	t͡ɕ ʊ w ŋ͡m ˧˧ s i ˦˥
trung thành	t͡ɕ ʊ w ŋ͡m ˧˧ tʰ a j ŋ̟ ˨˩
trung đông	t͡ɕ ʊ w ŋ͡m ˧˧ ʔ ɗ ə w ŋ͡m ˧˧
trung đại	t͡ɕ ʊ w ŋ͡m ˧˧ ʔ ɗ aː j ˧˨ ʔ
trung ương	t͡ɕ ʊ w ŋ͡m ˧˧ ʔ ɨ ə ŋ ˧˧
trung ấn	t͡ɕ ʊ w ŋ͡m ˧˧ ʔ ə n ˧˦
truy tố	t͡ɕ w i ˧˧ t o ˧˦
truyền	t͡ɕ w i ə n ˨˩
trà sữa	t͡ɕ aː ˨˩ s ɨ ə ˦˥
trà vinh	t͡ɕ aː ˨˩ v ï ŋ ˧˧
tràng	t͡ɕ aː ŋ ˨˩
trách nhiệm	t͡ɕ a j k̟̚ ˧˦ ɲ i ə m ˧˨ ʔ
trái ngang	t͡ɕ aː j ˧˦ ŋ aː ŋ ˧˧
trân châu	t͡ɕ ə n ˧˧ t͡ɕ ə w ˧˧
trân trối	t͡ɕ ə n ˧˧ t͡ɕ o j ˧˦
trâu già gặm cỏ non	t͡ɕ ə w ˧˧ z aː ˨˩ ɣ a m ˧˨ ʔ k ɔ ˧˩ n ɔ n ˧˧
trèo	t͡ɕ ɛ w ˨˩
trèo cây	t͡ɕ ɛ w ˨˩ k ə j ˧˧
trét	t͡ɕ ɛ t̚ ˧˦
trên	t͡ɕ e n ˧˧
trêu	t͡ɕ e w ˧˧
trình diễn	t͡ɕ ï ŋ ˨˩ z i ə n ˦˥
trìu mến	t͡ɕ i w ˨˩ m e n ˧˦
trí	t͡ɕ i ˧˦
trí tử	t͡ɕ i ˧˦ t ɨ ˧˩
trích	t͡ɕ ï k̟̚ ˧˦
trò chuyện	t͡ɕ ɔ ˨˩ t͡ɕ w i ə n ˧˨ ʔ
tróc	t͡ɕ a w k͡p̚ ˧˦
trói buộc	t͡ɕ ɔ j ˧˦ ʔ ɓ u ə k̚ ˧˨ ʔ
trót	t͡ɕ ɔ t̚ ˧˦
trông cậy	t͡ɕ ə w ŋ͡m ˧˧ k ə j ˧˨ ʔ
trù phú	t͡ɕ u ˨˩ f u ˧˦
trùn	t͡ɕ u n ˨˩
trúng thực	t͡ɕ ʊ w ŋ͡m ˧˦ tʰ ɨ k̚ ˧˨ ʔ
trăm	t͡ɕ a m ˧˧
trưng bày	t͡ɕ ɨ ŋ ˧˧ ʔ ɓ a j ˨˩
trưng cầu	t͡ɕ ɨ ŋ ˧˧ k ə w ˨˩
trước	t͡ɕ ɨ ə k̚ ˧˦
trườn	t͡ɕ ɨ ə n ˨˩
trường hợp	t͡ɕ ɨ ə ŋ ˨˩ h əː p̚ ˧˨ ʔ
trường sơn	t͡ɕ ɨ ə ŋ ˨˩ s əː n ˧˧
trường trung học cơ sở	t͡ɕ ɨ ə ŋ ˨˩ t͡ɕ ʊ w ŋ͡m ˧˧ h a w k͡p̚ ˧˨ ʔ k əː ˧˧ s əː ˧˩
trường trung học phổ thông	t͡ɕ ɨ ə ŋ ˨˩ t͡ɕ ʊ w ŋ͡m ˧˧ h a w k͡p̚ ˧˨ ʔ f o ˧˩ tʰ ə w ŋ͡m ˧˧
trường độ	t͡ɕ ɨ ə ŋ ˨˩ ʔ ɗ o ˧˨ ʔ
trưởng nữ	t͡ɕ ɨ ə ŋ ˧˩ n ɨ ˦˥
trại tập trung	t͡ɕ aː j ˧˨ ʔ t ə p̚ ˧˨ ʔ t͡ɕ ʊ w ŋ͡m ˧˧
trạm xe buýt	t͡ɕ aː m ˧˨ ʔ s ɛ ˧˧ ʔ ɓ w i t̚ ˧˦
trạng thái	t͡ɕ aː ŋ ˧˨ ʔ tʰ aː j ˧˦
trả lời	t͡ɕ aː ˧˩ l əː j ˨˩
trả đũa	t͡ɕ aː ˧˩ ʔ ɗ u ə ˦˥
trảng	t͡ɕ aː ŋ ˧˩
trầm mình	t͡ɕ ə m ˨˩ m ï ŋ ˨˩
trầm trồ	t͡ɕ ə m ˨˩ t͡ɕ o ˨˩
trần	t͡ɕ ə n ˨˩
trần truồng	t͡ɕ ə n ˨˩ t͡ɕ u ə ŋ ˨˩
trầu	t͡ɕ ə w ˨˩
trắc trở	t͡ɕ a k̚ ˧˦ t͡ɕ əː ˧˩
trằn trọc	t͡ɕ a n ˨˩ t͡ɕ a w k͡p̚ ˧˨ ʔ
trẻ em	t͡ɕ ɛ ˧˩ ʔ ɛ m ˧˧
trển	t͡ɕ e n ˧˩
trị vì	t͡ɕ i ˧˨ ʔ v i ˨˩
trịnh	t͡ɕ ï ŋ ˧˨ ʔ
trốn	t͡ɕ o n ˧˦
trống prôvăng	t͡ɕ ə w ŋ͡m ˧˦ p ɹ o ˧˧ v a ŋ ˧˧
trội	t͡ɕ o j ˧˨ ʔ
trời đất ơi	t͡ɕ əː j ˨˩ ʔ ɗ ə t̚ ˧˦ ʔ əː j ˧˧
trở lại	t͡ɕ əː ˧˩ l aː j ˧˨ ʔ
trở nên	t͡ɕ əː ˧˩ n e n ˧˧
trục	t͡ɕ ʊ w k͡p̚ ˧˨ ʔ
trục cao	t͡ɕ ʊ w k͡p̚ ˧˨ ʔ k aː w ˧˧
trụi	t͡ɕ u j ˧˨ ʔ
trụng	t͡ɕ ʊ w ŋ͡m ˧˨ ʔ
trủ	t͡ɕ u ˧˩
trứng cá	t͡ɕ ɨ ŋ ˧˦ k aː ˧˦
trừng phạt	t͡ɕ ɨ ŋ ˨˩ f aː t̚ ˧˨ ʔ
trực nhật	t͡ɕ ɨ k̚ ˧˨ ʔ ɲ ə t̚ ˧˨ ʔ
trực thuộc	t͡ɕ ɨ k̚ ˧˨ ʔ tʰ u ə k̚ ˧˨ ʔ
trực thăng	t͡ɕ ɨ k̚ ˧˨ ʔ tʰ a ŋ ˧˧
trực tâm	t͡ɕ ɨ k̚ ˧˨ ʔ t ə m ˧˧
tu từ học	t u ˧˧ t ɨ ˨˩ h a w k͡p̚ ˧˨ ʔ
tua	t u ə ˧˧
tuy	t w i ˧˧
tuy nhiên	t w i ˧˧ ɲ i ə n ˧˧
tuyến	t w i ə n ˧˦
tuyệt sắc giai nhân	t w i ə t̚ ˧˨ ʔ s a k̚ ˧˦ z aː j ˧˧ ɲ ə n ˧˧
tuân	t w ə n ˧˧
tuất	t w ə t̚ ˧˦
tuần	t w ə n ˨˩
tuần tra	t w ə n ˨˩ t͡ɕ aː ˧˧
tuổi thọ	t u ə j ˧˩ tʰ ɔ ˧˨ ʔ
tuổi tây	t u ə j ˧˩ t ə j ˧˧
tuỳ tiện	t w i ˨˩ t i ə n ˧˨ ʔ
tuỷ	t w i ˧˩
tv	t i ˧˧ v i ˧˧
tà đạo	t aː ˨˩ ʔ ɗ aː w ˧˨ ʔ
tài phiệt	t aː j ˨˩ f i ə t̚ ˧˨ ʔ
tài sản	t aː j ˨˩ s aː n ˧˩
tài xế	t aː j ˨˩ s e ˧˦
tàn nhẫn	t aː n ˨˩ ɲ ə n ˦˥
tàng trữ	t aː ŋ ˨˩ t͡ɕ ɨ ˦˥
tào tháo rượt	t aː w ˨˩ tʰ aː w ˧˦ z ɨ ə t̚ ˧˨ ʔ
tàu hoả	t a w ˨˩ h w aː ˧˩
tàu hủ	t a w ˨˩ h u ˧˩
tàu sân bay	t a w ˨˩ s ə n ˧˧ ʔ ɓ a j ˧˧
tác nhân	t aː k̚ ˧˦ ɲ ə n ˧˧
tách rời	t a j k̟̚ ˧˦ z əː j ˨˩
tái lập	t aː j ˧˦ l ə p̚ ˧˨ ʔ
táng	t aː ŋ ˧˦
táo tây	t aː w ˧˦ t ə j ˧˧
tâm hồn	t ə m ˧˧ h o n ˨˩
tâm khảm	t ə m ˧˧ x aː m ˧˩
tâm lí	t ə m ˧˧ l i ˧˦
tâm nhĩ	t ə m ˧˧ ɲ i ˦˥
tâm điểm	t ə m ˧˧ ʔ ɗ i ə m ˧˩
tân cương	t ə n ˧˧ k ɨ ə ŋ ˧˧
tân hôn	t ə n ˧˧ h o n ˧˧
tân tinh	t ə n ˧˧ t ï ŋ ˧˧
tâu	t ə w ˧˧
tây	t ə j ˧˧
tây ba lô	t ə j ˧˧ ʔ ɓ aː ˧˧ l o ˧˧
tây ban nha	t ə j ˧˧ ʔ ɓ aː n ˧˧ ɲ aː ˧˧
tây tạng	t ə j ˧˧ t aː ŋ ˧˨ ʔ
tây úc	t ə j ˧˧ ʔ ʊ w k͡p̚ ˧˦
tây ấn	t ə j ˧˧ ʔ ə n ˧˦
té	t ɛ ˧˦
tép	t ɛ p̚ ˧˦
tê	t e ˧˧
tên chữ	t e n ˧˧ t͡ɕ ɨ ˦˥
tên hiệu	t e n ˧˧ h i ə w ˧˨ ʔ
tên họ	t e n ˧˧ h ɔ ˧˨ ʔ
tên lót	t e n ˧˧ l ɔ t̚ ˧˦
tên tuổi	t e n ˧˧ t u ə j ˧˩
têooc	t e ˧˧ ʔ ɔ k̚ ˧˧
tình	t ï ŋ ˨˩
tình ca	t ï ŋ ˨˩ k aː ˧˧
tình cảnh	t ï ŋ ˨˩ k a j ŋ̟ ˧˩
tình cờ	t ï ŋ ˨˩ k əː ˨˩
tình dục học	t ï ŋ ˨˩ z ʊ w k͡p̚ ˧˨ ʔ h a w k͡p̚ ˧˨ ʔ
tình huống	t ï ŋ ˨˩ h u ə ŋ ˧˦
tình một đêm	t ï ŋ ˨˩ m o t̚ ˧˨ ʔ ʔ ɗ e m ˧˧
tình thương	t ï ŋ ˨˩ tʰ ɨ ə ŋ ˧˧
tình thế	t ï ŋ ˨˩ tʰ e ˧˦
tình tiết	t ï ŋ ˨˩ t i ə t̚ ˧˦
tía	t i ə ˧˦
tía má ơi	t i ə ˧˦ m aː ˧˦ ʔ əː j ˧˧
tím	t i m ˧˦
tín nhiệm	t i n ˧˦ ɲ i ə m ˧˨ ʔ
tính	t ï ŋ ˧˦
tính nết	t ï ŋ ˧˦ n e t̚ ˧˦
tính tiền	t ï ŋ ˧˦ t i ə n ˨˩
tính tình	t ï ŋ ˧˦ t ï ŋ ˨˩
tít tắp	t i t̚ ˧˦ t a p̚ ˧˦
tóc	t a w k͡p̚ ˧˦
tóm tắt	t ɔ m ˧˦ t a t̚ ˧˦
tô	t o ˧˧
tôm	t o m ˧˧
tôm hùm	t o m ˧˧ h u m ˨˩
tôm tít	t o m ˧˧ t i t̚ ˧˦
tôn ngộ không	t o n ˧˧ ŋ o ˧˨ ʔ x ə w ŋ͡m ˧˧
tôn trọng	t o n ˧˧ t͡ɕ a w ŋ͡m ˧˨ ʔ
tông	t ə w ŋ͡m ˧˧
tõm	t ɔ m ˦˥
tù	t u ˨˩
túm	t u m ˧˦
tút	t u t̚ ˧˦
tăng giá	t a ŋ ˧˧ z aː ˧˦
tĩnh mịch	t ï ŋ ˦˥ m ï k̟̚ ˧˨ ʔ
tơ	t əː ˧˧
tơ tưởng	t əː ˧˧ t ɨ ə ŋ ˧˩
tư bản	t ɨ ˧˧ ʔ ɓ aː n ˧˩
tư bản chủ nghĩa	t ɨ ˧˧ ʔ ɓ aː n ˧˩ t͡ɕ u ˧˩ ŋ i ə ˦˥
tư cách	t ɨ ˧˧ k a j k̟̚ ˧˦
tưng bừng	t ɨ ŋ ˧˧ ʔ ɓ ɨ ŋ ˨˩
tưng tưng	t ɨ ŋ ˧˧ t ɨ ŋ ˧˧
tươi tắn	t ɨ ə j ˧˧ t a n ˧˦
tươm	t ɨ ə m ˧˧
tương tác	t ɨ ə ŋ ˧˧ t aː k̚ ˧˦
tương tự	t ɨ ə ŋ ˧˧ t ɨ ˧˨ ʔ
tương đối	t ɨ ə ŋ ˧˧ ʔ ɗ o j ˧˦
tương ớt	t ɨ ə ŋ ˧˧ ʔ əː t̚ ˧˦
tước	t ɨ ə k̚ ˧˦
tướng quân	t ɨ ə ŋ ˧˦ k w ə n ˧˧
tườu	t i ə w ˨˩
tưởng tượng	t ɨ ə ŋ ˧˩ t ɨ ə ŋ ˧˨ ʔ
tượng đài	t ɨ ə ŋ ˧˨ ʔ ʔ ɗ aː j ˨˩
tạc	t aː k̚ ˧˨ ʔ
tại hạ	t aː j ˧˨ ʔ h aː ˧˨ ʔ
tại sao	t aː j ˧˨ ʔ s aː w ˧˧
tạo	t aː w ˧˨ ʔ
tạp chủng	t aː p̚ ˧˨ ʔ t͡ɕ ʊ w ŋ͡m ˧˩
tạp dề	t aː p̚ ˧˨ ʔ z e ˨˩
tạt	t aː t̚ ˧˨ ʔ
tải	t aː j ˧˩
tảng	t aː ŋ ˧˩
tảo	t aː w ˧˩
tấc	t ə k̚ ˧˦
tấn	t ə n ˧˦
tấp nập	t ə p̚ ˧˦ n ə p̚ ˧˨ ʔ
tầm gửi	t ə m ˨˩ ɣ ɨ j ˧˩
tầm mắt	t ə m ˨˩ m a t̚ ˧˦
tầm phào	t ə m ˨˩ f aː w ˨˩
tầm quan trọng	t ə m ˨˩ k w aː n ˧˧ t͡ɕ a w ŋ͡m ˧˨ ʔ
tần số	t ə n ˨˩ s o ˧˦
tầng ôzôn	t ə ŋ ˨˩ ʔ o ˧˧ z o n ˧˧
tẩm	t ə m ˧˩
tẩu vi thượng sách	t ə w ˧˩ v i ˧˧ tʰ ɨ ə ŋ ˧˨ ʔ s a j k̟̚ ˧˦
tẩy chay	t ə j ˧˩ t͡ɕ a j ˧˧
tận	t ə n ˧˨ ʔ
tận tình	t ə n ˧˨ ʔ t ï ŋ ˨˩
tập	t ə p̚ ˧˨ ʔ
tập kích	t ə p̚ ˧˨ ʔ k ï k̟̚ ˧˦
tắc nghẽn	t a k̚ ˧˦ ŋ ɛ n ˦˥
tắc tị	t a k̚ ˧˦ t i ˧˨ ʔ
tặng	t a ŋ ˧˨ ʔ
tẹo	t ɛ w ˧˨ ʔ
tẹt	t ɛ t̚ ˧˨ ʔ
tẻ	t ɛ ˧˩
tế bào chất	t e ˧˦ ʔ ɓ aː w ˨˩ t͡ɕ ə t̚ ˧˦
tết nguyên đán	t e t̚ ˧˦ ŋ w i ə n ˧˧ ʔ ɗ aː n ˧˦
tết trung thu	t e t̚ ˧˦ t͡ɕ ʊ w ŋ͡m ˧˧ tʰ u ˧˧
tệ nạn	t e ˧˨ ʔ n aː n ˧˨ ʔ
tỉ lệ	t i ˧˩ l e ˧˨ ʔ
tỉnh bơ	t ï ŋ ˧˩ ʔ ɓ əː ˧˧
tỏi tây	t ɔ j ˧˩ t ə j ˧˧
tỏm	t ɔ m ˧˩
tố tụng	t o ˧˦ t ʊ w ŋ͡m ˧˨ ʔ
tối cao	t o j ˧˦ k aː w ˧˧
tối om	t o j ˧˦ ʔ ɔ m ˧˧
tốp	t o p̚ ˧˦
tốt bụng	t o t̚ ˧˦ ʔ ɓ ʊ w ŋ͡m ˧˨ ʔ
tồi tệ	t o j ˨˩ t e ˧˨ ʔ
tổ lái	t o ˧˩ l aː j ˧˦
tổ tiên	t o ˧˩ t i ə n ˧˧
tổ ấm	t o ˧˩ ʔ ə m ˧˦
tổng biên tập	t ə w ŋ͡m ˧˩ ʔ ɓ i ə n ˧˧ t ə p̚ ˧˨ ʔ
tổng cộng	t ə w ŋ͡m ˧˩ k ə w ŋ͡m ˧˨ ʔ
tổng hành dinh	t ə w ŋ͡m ˧˩ h a j ŋ̟ ˨˩ z ï ŋ ˧˧
tổng lãnh thiên thần	t ə w ŋ͡m ˧˩ l a j ŋ̟ ˦˥ tʰ i ə n ˧˧ tʰ ə n ˨˩
tổng quan	t ə w ŋ͡m ˧˩ k w aː n ˧˧
tổng thể	t ə w ŋ͡m ˧˩ tʰ e ˧˩
tổng đài	t ə w ŋ͡m ˧˩ ʔ ɗ aː j ˨˩
tổng đốc	t ə w ŋ͡m ˧˩ ʔ ɗ ə w k͡p̚ ˧˦
tội lỗi	t o j ˧˨ ʔ l o j ˦˥
tột độ	t o t̚ ˧˨ ʔ ʔ ɗ o ˧˨ ʔ
tới	t əː j ˧˦
tợ	t əː ˧˨ ʔ
tụ họp	t u ˧˨ ʔ h ɔ p̚ ˧˨ ʔ
tục biên	t ʊ w k͡p̚ ˧˨ ʔ ʔ ɓ i ə n ˧˧
tục lệ	t ʊ w k͡p̚ ˧˨ ʔ l e ˧˨ ʔ
tủ lạnh	t u ˧˩ l a j ŋ̟ ˧˨ ʔ
tứ linh	t ɨ ˧˦ l ï ŋ ˧˧
tứ xuyên	t ɨ ˧˦ s w i ə n ˧˧
tứ đại mĩ nhân	t ɨ ˧˦ ʔ ɗ aː j ˧˨ ʔ m i ˦˥ ɲ ə n ˧˧
tức	t ɨ k̚ ˧˦
từ	t ɨ ˨˩
từ ghép	t ɨ ˨˩ ɣ ɛ p̚ ˧˦
từ láy	t ɨ ˨˩ l a j ˧˦
từ ngoại lai	t ɨ ˨˩ ŋ w aː j ˧˨ ʔ l aː j ˧˧
từ nguyên học	t ɨ ˨˩ ŋ w i ə n ˧˧ h a w k͡p̚ ˧˨ ʔ
từ thiện	t ɨ ˨˩ tʰ i ə n ˧˨ ʔ
từ từ	t ɨ ˨˩ t ɨ ˨˩
tử huyệt	t ɨ ˧˩ h w i ə t̚ ˧˨ ʔ
tử ngoại	t ɨ ˧˩ ŋ w aː j ˧˨ ʔ
tử trận	t ɨ ˧˩ t͡ɕ ə n ˧˨ ʔ
tửu lượng	t i w ˧˩ l ɨ ə ŋ ˧˨ ʔ
tự bạch	t ɨ ˧˨ ʔ ʔ ɓ a j k̟̚ ˧˨ ʔ
tự chủ	t ɨ ˧˨ ʔ t͡ɕ u ˧˩
tự kỉ	t ɨ ˧˨ ʔ k i ˧˩
tự nhiên	t ɨ ˧˨ ʔ ɲ i ə n ˧˧
tự sự	t ɨ ˧˨ ʔ s ɨ ˧˨ ʔ
tự thú	t ɨ ˧˨ ʔ tʰ u ˧˦
tự truyện	t ɨ ˧˨ ʔ t͡ɕ w i ə n ˧˨ ʔ
tự vẫn	t ɨ ˧˨ ʔ v ə n ˦˥
tự ái	t ɨ ˧˨ ʔ ʔ aː j ˧˦
tựu trường	t i w ˧˨ ʔ t͡ɕ ɨ ə ŋ ˨˩
um sùm	ʔ u m ˧˧ s u m ˨˩
ung dung	ʔ ʊ w ŋ͡m ˧˧ z ʊ w ŋ͡m ˧˧
ung thư cổ tử cung	ʔ ʊ w ŋ͡m ˧˧ tʰ ɨ ˧˧ k o ˧˩ t ɨ ˧˩ k ʊ w ŋ͡m ˧˧
uý	ʔ w i ˧˦
uổng	ʔ u ə ŋ ˧˩
uỷ mị	ʔ w i ˧˩ m i ˧˨ ʔ
uỷ viên	ʔ w i ˧˩ v i ə n ˧˧
vai vế	v aː j ˧˧ v e ˧˦
valentinô	v aː ˧˧ l ɛ n ˧˧ t i n ˧˧ n o ˧˧
vang dội	v aː ŋ ˧˧ z o j ˧˨ ʔ
ve vãn	v ɛ ˧˧ v aː n ˦˥
victor	v ï k̟̚ ˧˦ t ɔ ˧˧
viêm	v i ə m ˧˧
viêm khớp	v i ə m ˧˧ x əː p̚ ˧˦
viên chức	v i ə n ˧˧ t͡ɕ ɨ k̚ ˧˦
viếng	v i ə ŋ ˧˦
việt bính	v i ə t̚ ˧˨ ʔ ʔ ɓ ï ŋ ˧˦
việt gian	v i ə t̚ ˧˨ ʔ z aː n ˧˧
việt quất	v i ə t̚ ˧˨ ʔ k w ə t̚ ˧˦
voa	v w aː ˧˧
voan	v w aː n ˧˧
vonfam	v o n ˧˧ f aː m ˧˧
vu lan	v u ˧˧ l aː n ˧˧
vun	v u n ˧˧
vun đắp	v u n ˧˧ ʔ ɗ a p̚ ˧˦
vuông góc	v u ə ŋ ˧˧ ɣ a w k͡p̚ ˧˦
vuột	v u ə t̚ ˧˨ ʔ
vy	v i ˧˧
vàng	v aː ŋ ˨˩
vàng khè	v aː ŋ ˨˩ x ɛ ˨˩
vành móng ngựa	v a j ŋ̟ ˨˩ m a w ŋ͡m ˧˦ ŋ ɨ ə ˧˨ ʔ
vác	v aː k̚ ˧˦
váy	v a j ˧˦
vân nam	v ə n ˧˧ n aː m ˧˧
vân vân	v ə n ˧˧ v ə n ˧˧
vân vân mây mây	v ə n ˧˧ v ə n ˧˧ m ə j ˧˧ m ə j ˧˧
vâng	v ə ŋ ˧˧
vâng dạ	v ə ŋ ˧˧ z aː ˧˨ ʔ
vây	v ə j ˧˧
vãi cả lồn	v aː j ˦˥ k aː ˧˩ l o n ˨˩
vãn hồi	v aː n ˦˥ h o j ˨˩
véo	v ɛ w ˧˦
vê đúp	v e ˧˧ ʔ ɗ u p̚ ˧˦
vì	v i ˨˩
vì sao	v i ˨˩ s aː w ˧˧
vía van	v i ə ˧˦ v aː n ˧˧
vòi	v ɔ j ˨˩
vòng tránh thai	v a w ŋ͡m ˨˩ t͡ɕ a j ŋ̟ ˧˦ tʰ aː j ˧˧
vô căn	v o ˧˧ k a n ˧˧
vô cơ	v o ˧˧ k əː ˧˧
vô cực	v o ˧˧ k ɨ k̚ ˧˨ ʔ
vô duyên	v o ˧˧ z w i ə n ˧˧
vô dụng	v o ˧˧ z ʊ w ŋ͡m ˧˨ ʔ
vô giá	v o ˧˧ z aː ˧˦
vô hình	v o ˧˧ h ï ŋ ˨˩
vô hữu bất như kỉ giả	v o ˧˧ h i w ˦˥ ʔ ɓ ə t̚ ˧˦ ɲ ɨ ˧˧ k i ˧˩ z aː ˧˩
vô lí	v o ˧˧ l i ˧˦
vô thần luận	v o ˧˧ tʰ ə n ˨˩ l w ə n ˧˨ ʔ
vô tuyến truyền hình	v o ˧˧ t w i ə n ˧˦ t͡ɕ w i ə n ˨˩ h ï ŋ ˨˩
vô vọng	v o ˧˧ v a w ŋ͡m ˧˨ ʔ
vô ý	v o ˧˧ ʔ i ˧˦
vôi	v o j ˧˧
vôn	v o n ˧˧
võ	v ɔ ˦˥
vùng	v ʊ w ŋ͡m ˨˩
vú sữa	v u ˧˦ s ɨ ə ˦˥
văn	v a n ˧˧
văn bản	v a n ˧˧ ʔ ɓ aː n ˧˩
văn học	v a n ˧˧ h a w k͡p̚ ˧˨ ʔ
văn lang	v a n ˧˧ l aː ŋ ˧˧
văn minh	v a n ˧˧ m ï ŋ ˧˧
văn phòng	v a n ˧˧ f a w ŋ͡m ˨˩
vĩ mô	v i ˦˥ m o ˧˧
vĩ đại	v i ˦˥ ʔ ɗ aː j ˧˨ ʔ
vĩ độ	v i ˦˥ ʔ ɗ o ˧˨ ʔ
vũ	v u ˦˥
vũ trang	v u ˦˥ t͡ɕ aː ŋ ˧˧
vũ đài	v u ˦˥ ʔ ɗ aː j ˨˩
vơi	v əː j ˧˧
vương hậu	v ɨ ə ŋ ˧˧ h ə w ˧˨ ʔ
vương triều	v ɨ ə ŋ ˧˧ t͡ɕ i ə w ˨˩
vướng	v ɨ ə ŋ ˧˦
vướng mắc	v ɨ ə ŋ ˧˦ m a k̚ ˧˦
vườn bách thú	v ɨ ə n ˨˩ ʔ ɓ a j k̟̚ ˧˦ tʰ u ˧˦
vượt bậc	v ɨ ə t̚ ˧˨ ʔ ʔ ɓ ə k̚ ˧˨ ʔ
vạ	v aː ˧˨ ʔ
vạn	v aː n ˧˨ ʔ
vạn bất đắc dĩ	v aː n ˧˨ ʔ ʔ ɓ ə t̚ ˧˦ ʔ ɗ a k̚ ˧˦ z i ˦˥
vạn lí trường thành	v aː n ˧˨ ʔ l i ˧˦ t͡ɕ ɨ ə ŋ ˨˩ tʰ a j ŋ̟ ˨˩
vạn sự như ý	v aː n ˧˨ ʔ s ɨ ˧˨ ʔ ɲ ɨ ˧˧ ʔ i ˧˦
vải vóc	v aː j ˧˩ v a w k͡p̚ ˧˦
vấp ngã	v ə p̚ ˧˦ ŋ aː ˦˥
vấp váp	v ə p̚ ˧˦ v aː p̚ ˧˦
vất vả	v ə t̚ ˧˦ v aː ˧˩
vật	v ə t̚ ˧˨ ʔ
vật chất tối	v ə t̚ ˧˨ ʔ t͡ɕ ə t̚ ˧˦ t o j ˧˦
vật chứng	v ə t̚ ˧˨ ʔ t͡ɕ ɨ ŋ ˧˦
vật liệu	v ə t̚ ˧˨ ʔ l i ə w ˧˨ ʔ
vật lý hóa học	v ə t̚ ˧˨ ʔ l i ˧˦ h w aː ˧˦ h a w k͡p̚ ˧˨ ʔ
vật vờ	v ə t̚ ˧˨ ʔ v əː ˨˩
vắng mặt	v a ŋ ˧˦ m a t̚ ˧˨ ʔ
vằng vặc	v a ŋ ˨˩ v a k̚ ˧˨ ʔ
vặc	v a k̚ ˧˨ ʔ
vặn	v a n ˧˨ ʔ
vết	v e t̚ ˧˦
vết thương	v e t̚ ˧˦ tʰ ɨ ə ŋ ˧˧
vệ tinh	v e ˧˨ ʔ t ï ŋ ˧˧
vỉa	v i ə ˧˩
vị trí	v i ˧˨ ʔ t͡ɕ i ˧˦
vọng ngoại	v a w ŋ͡m ˧˨ ʔ ŋ w aː j ˧˨ ʔ
vỏ	v ɔ ˧˩
vồ	v o ˨˩
vồ vập	v o ˨˩ v ə p̚ ˧˨ ʔ
vội vã	v o j ˧˨ ʔ v aː ˦˥
vớt	v əː t̚ ˧˦
vờ	v əː ˨˩
vờn	v əː n ˨˩
vợ	v əː ˧˨ ʔ
vụ kiện	v u ˧˨ ʔ k i ə n ˧˨ ʔ
vụng về	v ʊ w ŋ͡m ˧˨ ʔ v e ˨˩
vứt	v ɨ t̚ ˧˦
vừa miệng	v ɨ ə ˨˩ m i ə ŋ ˧˨ ʔ
vừa mắt	v ɨ ə ˨˩ m a t̚ ˧˦
vừng	v ɨ ŋ ˨˩
vững vàng	v ɨ ŋ ˦˥ v aː ŋ ˨˩
vực	v ɨ k̚ ˧˨ ʔ
xa lạ	s aː ˧˧ l aː ˧˨ ʔ
xanh lá cây	s a j ŋ̟ ˧˧ l aː ˧˦ k ə j ˧˧
xaviê	s aː ˧˧ v i ˧˧ ʔ e ˧˧
xay	s a j ˧˧
xe	s ɛ ˧˧
xe ba gác	s ɛ ˧˧ ʔ ɓ aː ˧˧ ɣ aː k̚ ˧˦
xe cấp cứu	s ɛ ˧˧ k ə p̚ ˧˦ k i w ˧˦
xe lửa	s ɛ ˧˧ l ɨ ə ˧˩
xe mô tô	s ɛ ˧˧ m o ˧˧ t o ˧˧
xem	s ɛ m ˧˧
xenon	s e ˧˧ n ə w ŋ͡m ˧˧
xesi	s e ˧˧ s i ˧˧
xin	s i n ˧˧
xiêu	s i ə w ˧˧
xiêu lòng	s i ə w ˧˧ l a w ŋ͡m ˨˩
xiềng	s i ə ŋ ˨˩
xoang	s w aː ŋ ˧˧
xoay xở	s w a j ˧˧ s əː ˧˩
xoi	s ɔ j ˧˧
xong	s a w ŋ͡m ˧˧
xung	s ʊ w ŋ͡m ˧˧
xuyên sơn	s w i ə n ˧˧ s əː n ˧˧
xuyên tạc	s w i ə n ˧˧ t aː k̚ ˧˨ ʔ
xuôi	s u ə j ˧˧
xuất cảnh	s w ə t̚ ˧˦ k a j ŋ̟ ˧˩
xuất gia	s w ə t̚ ˧˦ z aː ˧˧
xuất khẩu	s w ə t̚ ˧˦ x ə w ˧˩
xuất tinh	s w ə t̚ ˧˦ t ï ŋ ˧˧
xà cột	s aː ˨˩ k o t̚ ˧˨ ʔ
xào	s aː w ˨˩
xác suất	s aː k̚ ˧˦ s w ə t̚ ˧˦
xác định	s aː k̚ ˧˦ ʔ ɗ ï ŋ ˧˨ ʔ
xác ướp	s aː k̚ ˧˦ ʔ ɨ ə p̚ ˧˦
xái	s aː j ˧˦
xáo trộn	s aː w ˧˦ t͡ɕ o n ˧˨ ʔ
xã	s aː ˦˥
xã hội	s aː ˦˥ h o j ˧˨ ʔ
xã hội chủ nghĩa	s aː ˦˥ h o j ˧˨ ʔ t͡ɕ u ˧˩ ŋ i ə ˦˥
xã hội đen	s aː ˦˥ h o j ˧˨ ʔ ʔ ɗ ɛ n ˧˧
xèng	s ɛ ŋ ˨˩
xén	s ɛ n ˧˦
xén tóc	s ɛ n ˧˦ t a w k͡p̚ ˧˦
xét nghiệm	s ɛ t̚ ˧˦ ŋ i ə m ˧˨ ʔ
xét nét	s ɛ t̚ ˧˦ n ɛ t̚ ˧˦
xì	s i ˨˩
xì trum	s i ˨˩ t͡ɕ u m ˧˧
xì tố	s i ˨˩ t o ˧˦
xí	s i ˧˦
xí hổ	s i ˧˦ h o ˧˩
xí muội	s i ˧˦ m u ə j ˧˨ ʔ
xích kim	s ï k̟̚ ˧˦ k i m ˧˧
xó	s ɔ ˧˦
xôi	s o j ˧˧
xông nhà	s ə w ŋ͡m ˧˧ ɲ aː ˨˩
xông xáo	s ə w ŋ͡m ˧˧ s aː w ˧˦
xúc động	s ʊ w k͡p̚ ˧˦ ʔ ɗ ə w ŋ͡m ˧˨ ʔ
xúm	s u m ˧˦
xơ	s əː ˧˧
xơ đăng	s əː ˧˧ ʔ ɗ a ŋ ˧˧
xưa	s ɨ ə ˧˧
xưa lắc xưa lơ	s ɨ ə ˧˧ l a k̚ ˧˦ s ɨ ə ˧˧ l əː ˧˧
xương dăm	s ɨ ə ŋ ˧˧ z a m ˧˧
xương rồng	s ɨ ə ŋ ˧˧ z ə w ŋ͡m ˨˩
xương sườn	s ɨ ə ŋ ˧˧ s ɨ ə n ˨˩
xương sống	s ɨ ə ŋ ˧˧ s ə w ŋ͡m ˧˦
xạ khuẩn	s aː ˧˨ ʔ x w ə n ˧˩
xạ thủ	s aː ˧˨ ʔ tʰ u ˧˩
xả	s aː ˧˩
xả láng	s aː ˧˩ l aː ŋ ˧˦
xảo quyệt	s aː w ˧˩ k w i ə t̚ ˧˨ ʔ
xấp	s ə p̚ ˧˦
xấu hoắc	s ə w ˧˦ h w a k̚ ˧˦
xấu xí	s ə w ˧˦ s i ˧˦
xắn	s a n ˧˦
xắt	s a t̚ ˧˦
xế hộp	s e ˧˦ h o p̚ ˧˨ ʔ
xếp hạng	s e p̚ ˧˦ h aː ŋ ˧˨ ʔ
xịn	s i n ˧˨ ʔ
xịt	s i t̚ ˧˨ ʔ
xỏ lá	s ɔ ˧˩ l aː ˧˦
xới	s əː j ˧˦
xử phạt	s ɨ ˧˩ f aː t̚ ˧˨ ʔ
xử trí	s ɨ ˧˩ t͡ɕ i ˧˦
y chang	ʔ i ˧˧ t͡ɕ aː ŋ ˧˧
y học	ʔ i ˧˧ h a w k͡p̚ ˧˨ ʔ
y khoa	ʔ i ˧˧ x w aː ˧˧
y pha nho	ʔ i ˧˧ f aː ˧˧ ɲ ɔ ˧˧
yên tâm	ʔ i ə n ˧˧ t ə m ˧˧
yên tĩnh	ʔ i ə n ˧˧ t ï ŋ ˦˥
yên ổn	ʔ i ə n ˧˧ ʔ o n ˧˩
yêu thích	ʔ i ə w ˧˧ tʰ ï k̟̚ ˧˦
yêu thương	ʔ i ə w ˧˧ tʰ ɨ ə ŋ ˧˧
yết hầu	ʔ i ə t̚ ˧˦ h ə w ˨˩
yếu điểm	ʔ i ə w ˧˦ ʔ ɗ i ə m ˧˩
yểm	ʔ i ə m ˧˩
ào	ʔ aː w ˨˩
ác	ʔ aː k̚ ˧˦
ác mộng	ʔ aː k̚ ˧˦ m ə w ŋ͡m ˧˨ ʔ
ác thú	ʔ aː k̚ ˧˦ tʰ u ˧˦
ái hữu	ʔ aː j ˧˦ h i w ˦˥
ái khanh	ʔ aː j ˧˦ x a j ŋ̟ ˧˧
ái nhĩ lan	ʔ aː j ˧˦ ɲ i ˦˥ l aː n ˧˧
án	ʔ aː n ˧˦
án treo	ʔ aː n ˧˦ t͡ɕ ɛ w ˧˧
ánh	ʔ a j ŋ̟ ˧˦
ánh sáng	ʔ a j ŋ̟ ˧˦ s aː ŋ ˧˦
áo dài	ʔ aː w ˧˦ z aː j ˨˩
áo gấm	ʔ aː w ˧˦ ɣ ə m ˧˦
áo phông	ʔ aː w ˧˦ f ə w ŋ͡m ˧˧
áo thun	ʔ aː w ˧˦ tʰ u n ˧˧
áo tắm hai mảnh	ʔ aː w ˧˦ t a m ˧˦ h aː j ˧˧ m a j ŋ̟ ˧˩
áo địa lợi	ʔ aː w ˧˦ ʔ ɗ i ə ˧˨ ʔ l əː j ˧˨ ʔ
áp đảo	ʔ aː p̚ ˧˦ ʔ ɗ aː w ˧˩
áp đặt	ʔ aː p̚ ˧˦ ʔ ɗ a t̚ ˧˨ ʔ
âm	ʔ ə m ˧˧
âm chủ	ʔ ə m ˧˧ t͡ɕ u ˧˩
âm dương	ʔ ə m ˧˧ z ɨ ə ŋ ˧˧
âm thanh	ʔ ə m ˧˧ tʰ a j ŋ̟ ˧˧
âm thịnh dương suy	ʔ ə m ˧˧ tʰ ï ŋ ˧˨ ʔ z ɨ ə ŋ ˧˧ s w i ˧˧
âm tính	ʔ ə m ˧˧ t ï ŋ ˧˦
âm tố	ʔ ə m ˧˧ t o ˧˦
ân hận	ʔ ə n ˧˧ h ə n ˧˨ ʔ
âu	ʔ ə w ˧˧
én	ʔ ɛ n ˧˦
éo	ʔ ɛ w ˧˦
ép	ʔ ɛ p̚ ˧˦
ê ẩm	ʔ e ˧˧ ʔ ə m ˧˩
êugêniô	ʔ e w ˧˧ ɣ e n ˧˧ n i ˧˧ ʔ o ˧˧
ì ạch	ʔ i ˨˩ ʔ a j k̟̚ ˧˨ ʔ
ít khi	ʔ i t̚ ˧˦ x i ˧˧
ô hoàn	ʔ o ˧˧ h w aː n ˨˩
ô ten	ʔ o ˧˧ t ɛ n ˧˧
ông bà anh chị em	ʔ ə w ŋ͡m ˧˧ ʔ ɓ aː ˨˩ ʔ a j ŋ̟ ˧˧ t͡ɕ i ˧˨ ʔ ʔ ɛ m ˧˧
ông chủ	ʔ ə w ŋ͡m ˧˧ t͡ɕ u ˧˩
ông già	ʔ ə w ŋ͡m ˧˧ z aː ˨˩
ông vải	ʔ ə w ŋ͡m ˧˧ v aː j ˧˩
ông đồ	ʔ ə w ŋ͡m ˧˧ ʔ ɗ o ˨˩
ù tai	ʔ u ˨˩ t aː j ˧˧
ùn	ʔ u n ˨˩
úa	ʔ u ə ˧˦
úi	ʔ u j ˧˦
úp	ʔ u p̚ ˧˦
ăn cắp	ʔ a n ˧˧ k a p̚ ˧˦
ăn hàng	ʔ a n ˧˧ h aː ŋ ˨˩
ăn kem trước cổng	ʔ a n ˧˧ k ɛ m ˧˧ t͡ɕ ɨ ə k̚ ˧˦ k ə w ŋ͡m ˧˩
ăn mặc	ʔ a n ˧˧ m a k̚ ˧˨ ʔ
ăn nhậu	ʔ a n ˧˧ ɲ ə w ˧˨ ʔ
ăn nên làm ra	ʔ a n ˧˧ n e n ˧˧ l aː m ˨˩ z aː ˧˧
ăn nói	ʔ a n ˧˧ n ɔ j ˧˦
ăn phở	ʔ a n ˧˧ f əː ˧˩
ăn trộm	ʔ a n ˧˧ t͡ɕ o m ˧˨ ʔ
ăn vã	ʔ a n ˧˧ v aː ˦˥
ăn ý	ʔ a n ˧˧ ʔ i ˧˦
đa dạng	ʔ ɗ aː ˧˧ z aː ŋ ˧˨ ʔ
đa minh	ʔ ɗ aː ˧˧ m ï ŋ ˧˧
đa nghi như tào tháo	ʔ ɗ aː ˧˧ ŋ i ˧˧ ɲ ɨ ˧˧ t aː w ˨˩ tʰ aː w ˧˦
đa thức	ʔ ɗ aː ˧˧ tʰ ɨ k̚ ˧˦
đa đa	ʔ ɗ aː ˧˧ ʔ ɗ aː ˧˧
đai an toàn	ʔ ɗ aː j ˧˧ ʔ aː n ˧˧ t w aː n ˨˩
đam	ʔ ɗ aː m ˧˧
đau	ʔ ɗ a w ˧˧
đau đớn	ʔ ɗ a w ˧˧ ʔ ɗ əː n ˧˦
đcg	ʔ ɗ ɨ k̚ ˧˦ t͡ɕ u ə ˧˦ z e ˧˧ s u ˧˧
đem con bỏ chợ	ʔ ɗ ɛ m ˧˧ k ɔ n ˧˧ ʔ ɓ ɔ ˧˩ t͡ɕ əː ˧˨ ʔ
đi công tác	ʔ ɗ i ˧˧ k ə w ŋ͡m ˧˧ t aː k̚ ˧˦
đi ngoài	ʔ ɗ i ˧˧ ŋ w aː j ˨˩
đi nhờ	ʔ ɗ i ˧˧ ɲ əː ˨˩
điên	ʔ ɗ i ə n ˧˧
điên rồ	ʔ ɗ i ə n ˧˧ z o ˨˩
điều chỉnh	ʔ ɗ i ə w ˨˩ t͡ɕ ï ŋ ˧˩
điều hoà	ʔ ɗ i ə w ˨˩ h w aː ˨˩
điều khoản	ʔ ɗ i ə w ˨˩ x w aː n ˧˩
điều trị	ʔ ɗ i ə w ˨˩ t͡ɕ i ˧˨ ʔ
điều động	ʔ ɗ i ə w ˨˩ ʔ ɗ ə w ŋ͡m ˧˨ ʔ
điểm danh	ʔ ɗ i ə m ˧˩ z a j ŋ̟ ˧˧
điểm tâm	ʔ ɗ i ə m ˧˩ t ə m ˧˧
điển hình	ʔ ɗ i ə n ˧˩ h ï ŋ ˨˩
điện	ʔ ɗ i ə n ˧˨ ʔ
điện lực	ʔ ɗ i ə n ˧˨ ʔ l ɨ k̚ ˧˨ ʔ
điện thoại	ʔ ɗ i ə n ˧˨ ʔ tʰ w aː j ˧˨ ʔ
điện thoại bàn	ʔ ɗ i ə n ˧˨ ʔ tʰ w aː j ˧˨ ʔ ʔ ɓ aː n ˨˩
điện thoại công cộng	ʔ ɗ i ə n ˧˨ ʔ tʰ w aː j ˧˨ ʔ k ə w ŋ͡m ˧˧ k ə w ŋ͡m ˧˨ ʔ
điện trở	ʔ ɗ i ə n ˧˨ ʔ t͡ɕ əː ˧˩
điện áp	ʔ ɗ i ə n ˧˨ ʔ ʔ aː p̚ ˧˦
đm	ʔ ɗ əː ˨˩ m əː ˨˩
đo đạc	ʔ ɗ ɔ ˧˧ ʔ ɗ aː k̚ ˧˨ ʔ
đo đạt	ʔ ɗ ɔ ˧˧ ʔ ɗ aː t̚ ˧˨ ʔ
đong	ʔ ɗ a w ŋ͡m ˧˧
đoá	ʔ ɗ w aː ˧˦
đu	ʔ ɗ u ˧˧
đu đủ	ʔ ɗ u ˧˧ ʔ ɗ u ˧˩
đua ô tô	ʔ ɗ u ə ˧˧ ʔ o ˧˧ t o ˧˧
đun	ʔ ɗ u n ˧˧
đung đưa	ʔ ɗ ʊ w ŋ͡m ˧˧ ʔ ɗ ɨ ə ˧˧
đà	ʔ ɗ aː ˨˩
đàm	ʔ ɗ aː m ˨˩
đàm phán	ʔ ɗ aː m ˨˩ f aː n ˧˦
đàm tiếu	ʔ ɗ aː m ˨˩ t i ə w ˧˦
đàn	ʔ ɗ aː n ˨˩
đàn luýt	ʔ ɗ aː n ˨˩ l w i t̚ ˧˦
đàn tam	ʔ ɗ aː n ˨˩ t aː m ˧˧
đàng trong	ʔ ɗ aː ŋ ˨˩ t͡ɕ a w ŋ͡m ˧˧
đành	ʔ ɗ a j ŋ̟ ˨˩
đào hoa	ʔ ɗ aː w ˨˩ h w aː ˧˧
đào lộn hột	ʔ ɗ aː w ˨˩ l o n ˧˨ ʔ h o t̚ ˧˨ ʔ
đá	ʔ ɗ aː ˧˦
đá gà	ʔ ɗ aː ˧˦ ɣ aː ˨˩
đá hoa	ʔ ɗ aː ˧˦ h w aː ˧˧
đái	ʔ ɗ aː j ˧˦
đám đông	ʔ ɗ aː m ˧˦ ʔ ɗ ə w ŋ͡m ˧˧
đáng	ʔ ɗ aː ŋ ˧˦
đáng giá	ʔ ɗ aː ŋ ˧˦ z aː ˧˦
đáng kể	ʔ ɗ aː ŋ ˧˦ k e ˧˩
đáng ngại	ʔ ɗ aː ŋ ˧˦ ŋ aː j ˧˨ ʔ
đáng yêu	ʔ ɗ aː ŋ ˧˦ ʔ i ə w ˧˧
đánh cắp	ʔ ɗ a j ŋ̟ ˧˦ k a p̚ ˧˦
đánh thắng	ʔ ɗ a j ŋ̟ ˧˦ tʰ a ŋ ˧˦
đánh trống lảng	ʔ ɗ a j ŋ̟ ˧˦ t͡ɕ ə w ŋ͡m ˧˦ l aː ŋ ˧˩
đáy	ʔ ɗ a j ˧˦
đâu đó	ʔ ɗ ə w ˧˧ ʔ ɗ ɔ ˧˦
đèn điện	ʔ ɗ ɛ n ˨˩ ʔ ɗ i ə n ˧˨ ʔ
đèo	ʔ ɗ ɛ w ˨˩
đèo núi	ʔ ɗ ɛ w ˨˩ n u j ˧˦
đê tiện	ʔ ɗ e ˧˧ t i ə n ˧˨ ʔ
đình	ʔ ɗ ï ŋ ˨˩
đình chiến	ʔ ɗ ï ŋ ˨˩ t͡ɕ i ə n ˧˦
đình công	ʔ ɗ ï ŋ ˨˩ k ə w ŋ͡m ˧˧
đích tôn	ʔ ɗ ï k̟̚ ˧˦ t o n ˧˧
đòm	ʔ ɗ ɔ m ˨˩
đòn gánh	ʔ ɗ ɔ n ˨˩ ɣ a j ŋ̟ ˧˦
đóng	ʔ ɗ a w ŋ͡m ˧˦
đóng băng	ʔ ɗ a w ŋ͡m ˧˦ ʔ ɓ a ŋ ˧˧
đóng cửa	ʔ ɗ a w ŋ͡m ˧˦ k ɨ ə ˧˩
đô la	ʔ ɗ o ˧˧ l aː ˧˧
đô thị	ʔ ɗ o ˧˧ tʰ i ˧˨ ʔ
đô trưởng	ʔ ɗ o ˧˧ t͡ɕ ɨ ə ŋ ˧˩
đôi	ʔ ɗ o j ˧˧
đôi khi	ʔ ɗ o j ˧˧ x i ˧˧
đông du	ʔ ɗ ə w ŋ͡m ˧˧ z u ˧˧
đông kinh	ʔ ɗ ə w ŋ͡m ˧˧ k ï ŋ ˧˧
đông y	ʔ ɗ ə w ŋ͡m ˧˧ ʔ i ˧˧
đông đảo	ʔ ɗ ə w ŋ͡m ˧˧ ʔ ɗ aː w ˧˩
đăng	ʔ ɗ a ŋ ˧˧
đăng tải	ʔ ɗ a ŋ ˧˧ t aː j ˧˩
đĩa cứng	ʔ ɗ i ə ˦˥ k ɨ ŋ ˧˦
đĩa mềm	ʔ ɗ i ə ˦˥ m e m ˨˩
đũy	ʔ ɗ w i ˦˥
đơn	ʔ ɗ əː n ˧˧
đơn cử	ʔ ɗ əː n ˧˧ k ɨ ˧˩
đơn thân	ʔ ɗ əː n ˧˧ tʰ ə n ˧˧
đương nhiệm	ʔ ɗ ɨ ə ŋ ˧˧ ɲ i ə m ˧˨ ʔ
đường cônic	ʔ ɗ ɨ ə ŋ ˨˩ k o ˧˧ n ï k̟̚ ˧˧
đường dây	ʔ ɗ ɨ ə ŋ ˨˩ z ə j ˧˧
đường huyết	ʔ ɗ ɨ ə ŋ ˨˩ h w i ə t̚ ˧˦
đường nét	ʔ ɗ ɨ ə ŋ ˨˩ n ɛ t̚ ˧˦
đại	ʔ ɗ aː j ˧˨ ʔ
đại biểu	ʔ ɗ aː j ˧˨ ʔ ʔ ɓ i ə w ˧˩
đại ca	ʔ ɗ aː j ˧˨ ʔ k aː ˧˧
đại dịch	ʔ ɗ aː j ˧˨ ʔ z ï k̟̚ ˧˨ ʔ
đại gia	ʔ ɗ aː j ˧˨ ʔ z aː ˧˧
đại hội	ʔ ɗ aː j ˧˨ ʔ h o j ˧˨ ʔ
đại khái	ʔ ɗ aː j ˧˨ ʔ x aː j ˧˦
đại khủng hoảng	ʔ ɗ aː j ˧˨ ʔ x ʊ w ŋ͡m ˧˩ h w aː ŋ ˧˩
đại kiện tướng	ʔ ɗ aː j ˧˨ ʔ k i ə n ˧˨ ʔ t ɨ ə ŋ ˧˦
đại nam	ʔ ɗ aː j ˧˨ ʔ n aː m ˧˧
đại nhân	ʔ ɗ aː j ˧˨ ʔ ɲ ə n ˧˧
đại số	ʔ ɗ aː j ˧˨ ʔ s o ˧˦
đại số học	ʔ ɗ aː j ˧˨ ʔ s o ˧˦ h a w k͡p̚ ˧˨ ʔ
đại sứ	ʔ ɗ aː j ˧˨ ʔ s ɨ ˧˦
đại trượng phu	ʔ ɗ aː j ˧˨ ʔ t͡ɕ ɨ ə ŋ ˧˨ ʔ f u ˧˧
đạm	ʔ ɗ aː m ˧˨ ʔ
đạo hoà hảo	ʔ ɗ aː w ˧˨ ʔ h w aː ˨˩ h aː w ˧˩
đạo thiên chúa	ʔ ɗ aː w ˧˨ ʔ tʰ i ə n ˧˧ t͡ɕ u ə ˧˦
đạo đức giả	ʔ ɗ aː w ˧˨ ʔ ʔ ɗ ɨ k̚ ˧˦ z aː ˧˩
đả	ʔ ɗ aː ˧˩
đảm bảo	ʔ ɗ aː m ˧˩ ʔ ɓ aː w ˧˩
đảm nhiệm	ʔ ɗ aː m ˧˩ ɲ i ə m ˧˨ ʔ
đảng bộ	ʔ ɗ aː ŋ ˧˩ ʔ ɓ o ˧˨ ʔ
đảo quốc	ʔ ɗ aː w ˧˩ k u ə k̚ ˧˦
đấm bóp	ʔ ɗ ə m ˧˦ ʔ ɓ ɔ p̚ ˧˦
đấu	ʔ ɗ ə w ˧˦
đấu củng	ʔ ɗ ə w ˧˦ k ʊ w ŋ͡m ˧˩
đấu kiếm	ʔ ɗ ə w ˧˦ k i ə m ˧˦
đầm	ʔ ɗ ə m ˨˩
đầm lầy	ʔ ɗ ə m ˨˩ l ə j ˨˩
đầm ấm	ʔ ɗ ə m ˨˩ ʔ ə m ˧˦
đần độn	ʔ ɗ ə n ˨˩ ʔ ɗ o n ˧˨ ʔ
đầu gối	ʔ ɗ ə w ˨˩ ɣ o j ˧˦
đầu hàng	ʔ ɗ ə w ˨˩ h aː ŋ ˨˩
đầu quân	ʔ ɗ ə w ˨˩ k w ə n ˧˧
đầu thú	ʔ ɗ ə w ˨˩ tʰ u ˧˦
đầu tư	ʔ ɗ ə w ˨˩ t ɨ ˧˧
đầy rẫy	ʔ ɗ ə j ˨˩ z ə j ˦˥
đập	ʔ ɗ ə p̚ ˧˨ ʔ
đập phá	ʔ ɗ ə p̚ ˧˨ ʔ f aː ˧˦
đậu	ʔ ɗ ə w ˧˨ ʔ
đậu hủ	ʔ ɗ ə w ˧˨ ʔ h u ˧˩
đậu nành	ʔ ɗ ə w ˧˨ ʔ n a j ŋ̟ ˨˩
đậu phộng rau má	ʔ ɗ ə w ˧˨ ʔ f ə w ŋ͡m ˧˨ ʔ z a w ˧˧ m aː ˧˦
đậu tương	ʔ ɗ ə w ˧˨ ʔ t ɨ ə ŋ ˧˧
đậu ve	ʔ ɗ ə w ˧˨ ʔ v ɛ ˧˧
đậu ván	ʔ ɗ ə w ˧˨ ʔ v aː n ˧˦
đậu đen	ʔ ɗ ə w ˧˨ ʔ ʔ ɗ ɛ n ˧˧
đậu đỏ	ʔ ɗ ə w ˧˨ ʔ ʔ ɗ ɔ ˧˩
đậy	ʔ ɗ ə j ˧˨ ʔ
đắm đuối	ʔ ɗ a m ˧˦ ʔ ɗ u ə j ˧˦
đắng	ʔ ɗ a ŋ ˧˦
đắng lòng	ʔ ɗ a ŋ ˧˦ l a w ŋ͡m ˨˩
đắt đỏ	ʔ ɗ a t̚ ˧˦ ʔ ɗ ɔ ˧˩
đằm thắm	ʔ ɗ a m ˨˩ tʰ a m ˧˦
đặc hiệu	ʔ ɗ a k̚ ˧˨ ʔ h i ə w ˧˨ ʔ
đặc khu kinh tế	ʔ ɗ a k̚ ˧˨ ʔ x u ˧˧ k ï ŋ ˧˧ t e ˧˦
đặc quyền	ʔ ɗ a k̚ ˧˨ ʔ k w i ə n ˨˩
đặc ân	ʔ ɗ a k̚ ˧˨ ʔ ʔ ə n ˧˧
đặng	ʔ ɗ a ŋ ˧˨ ʔ
đặt tên	ʔ ɗ a t̚ ˧˨ ʔ t e n ˧˧
đặt vòng	ʔ ɗ a t̚ ˧˨ ʔ v a w ŋ͡m ˨˩
đến	ʔ ɗ e n ˧˦
đề kháng	ʔ ɗ e ˨˩ x aː ŋ ˧˦
đề đốc	ʔ ɗ e ˨˩ ʔ ɗ ə w k͡p̚ ˧˦
đệ tử	ʔ ɗ e ˧˨ ʔ t ɨ ˧˩
đỉa trâu	ʔ ɗ i ə ˧˩ t͡ɕ ə w ˧˧
địa bàn	ʔ ɗ i ə ˧˨ ʔ ʔ ɓ aː n ˨˩
địa chấn học	ʔ ɗ i ə ˧˨ ʔ t͡ɕ ə n ˧˦ h a w k͡p̚ ˧˨ ʔ
địa danh	ʔ ɗ i ə ˧˨ ʔ z a j ŋ̟ ˧˧
địa giới	ʔ ɗ i ə ˧˨ ʔ z əː j ˧˦
địa vị	ʔ ɗ i ə ˧˨ ʔ v i ˧˨ ʔ
địa đầu	ʔ ɗ i ə ˧˨ ʔ ʔ ɗ ə w ˨˩
địch	ʔ ɗ ï k̟̚ ˧˨ ʔ
định luật	ʔ ɗ ï ŋ ˧˨ ʔ l w ə t̚ ˧˨ ʔ
định mệnh	ʔ ɗ ï ŋ ˧˨ ʔ m ə j ŋ̟ ˧˨ ʔ
đọi	ʔ ɗ ɔ j ˧˨ ʔ
đọng	ʔ ɗ a w ŋ͡m ˧˨ ʔ
đọt mọt	ʔ ɗ ɔ t̚ ˧˨ ʔ m ɔ t̚ ˧˨ ʔ
đố	ʔ ɗ o ˧˦
đối chiếu	ʔ ɗ o j ˧˦ t͡ɕ i ə w ˧˦
đối tác	ʔ ɗ o j ˧˦ t aː k̚ ˧˦
đốn	ʔ ɗ o n ˧˦
đống	ʔ ɗ ə w ŋ͡m ˧˦
đốt phá	ʔ ɗ o t̚ ˧˦ f aː ˧˦
đồ bơi	ʔ ɗ o ˨˩ ʔ ɓ əː j ˧˧
đồ hộp	ʔ ɗ o ˨˩ h o p̚ ˧˨ ʔ
đồ vật	ʔ ɗ o ˨˩ v ə t̚ ˧˨ ʔ
đồi mồi	ʔ ɗ o j ˨˩ m o j ˨˩
đồng loạt	ʔ ɗ ə w ŋ͡m ˨˩ l w aː t̚ ˧˨ ʔ
đồng lương	ʔ ɗ ə w ŋ͡m ˨˩ l ɨ ə ŋ ˧˧
đồng thoại	ʔ ɗ ə w ŋ͡m ˨˩ tʰ w aː j ˧˨ ʔ
đồng thuận	ʔ ɗ ə w ŋ͡m ˨˩ tʰ w ə n ˧˨ ʔ
đồng tháp	ʔ ɗ ə w ŋ͡m ˨˩ tʰ aː p̚ ˧˦
đồng điệu	ʔ ɗ ə w ŋ͡m ˨˩ ʔ ɗ i ə w ˧˨ ʔ
đổ	ʔ ɗ o ˧˩
đổ bể	ʔ ɗ o ˧˩ ʔ ɓ e ˧˩
đổi chủ dịch nô	ʔ ɗ o j ˧˩ t͡ɕ u ˧˩ z ï k̟̚ ˧˨ ʔ n o ˧˧
độ c	ʔ ɗ o ˧˨ ʔ s e ˧˧
độc lập	ʔ ɗ ə w k͡p̚ ˧˨ ʔ l ə p̚ ˧˨ ʔ
độc ác	ʔ ɗ ə w k͡p̚ ˧˨ ʔ ʔ aː k̚ ˧˦
độc đáo	ʔ ɗ ə w k͡p̚ ˧˨ ʔ ʔ ɗ aː w ˧˦
đội	ʔ ɗ o j ˧˨ ʔ
đội hình	ʔ ɗ o j ˧˨ ʔ h ï ŋ ˨˩
đội viên	ʔ ɗ o j ˧˨ ʔ v i ə n ˧˧
động	ʔ ɗ ə w ŋ͡m ˧˨ ʔ
động kinh	ʔ ɗ ə w ŋ͡m ˧˨ ʔ k ï ŋ ˧˧
động mạch	ʔ ɗ ə w ŋ͡m ˧˨ ʔ m a j k̟̚ ˧˨ ʔ
động mạch chủ	ʔ ɗ ə w ŋ͡m ˧˨ ʔ m a j k̟̚ ˧˨ ʔ t͡ɕ u ˧˩
động năng	ʔ ɗ ə w ŋ͡m ˧˨ ʔ n a ŋ ˧˧
động từ	ʔ ɗ ə w ŋ͡m ˧˨ ʔ t ɨ ˨˩
đột nhiên	ʔ ɗ o t̚ ˧˨ ʔ ɲ i ə n ˧˧
đột quyết	ʔ ɗ o t̚ ˧˨ ʔ k w i ə t̚ ˧˦
đột quỵ	ʔ ɗ o t̚ ˧˨ ʔ k w i ˧˨ ʔ
đột xuất	ʔ ɗ o t̚ ˧˨ ʔ s w ə t̚ ˧˦
đớn đau	ʔ ɗ əː n ˧˦ ʔ ɗ a w ˧˧
đớp thính	ʔ ɗ əː p̚ ˧˦ tʰ ï ŋ ˧˦
đời	ʔ ɗ əː j ˨˩
đỡ	ʔ ɗ əː ˦˥
đợi	ʔ ɗ əː j ˧˨ ʔ
đụng chạm	ʔ ɗ ʊ w ŋ͡m ˧˨ ʔ t͡ɕ aː m ˧˨ ʔ
đụng độ	ʔ ɗ ʊ w ŋ͡m ˧˨ ʔ ʔ ɗ o ˧˨ ʔ
đức	ʔ ɗ ɨ k̚ ˧˦
đứng hình	ʔ ɗ ɨ ŋ ˧˦ h ï ŋ ˨˩
đứng núi này trông núi nọ	ʔ ɗ ɨ ŋ ˧˦ n u j ˧˦ n a j ˨˩ t͡ɕ ə w ŋ͡m ˧˧ n u j ˧˦ n ɔ ˧˨ ʔ
đừng	ʔ ɗ ɨ ŋ ˨˩
ơ đu	ʔ əː ˧˧ ʔ ɗ u ˧˧
ơi	ʔ əː j ˧˧
ưng ý	ʔ ɨ ŋ ˧˧ ʔ i ˧˦
ươn	ʔ ɨ ə n ˧˧
ước bang	ʔ ɨ ə k̚ ˧˦ ʔ ɓ aː ŋ ˧˧
ước mơ	ʔ ɨ ə k̚ ˧˦ m əː ˧˧
ước tính	ʔ ɨ ə k̚ ˧˦ t ï ŋ ˧˦
ướt át	ʔ ɨ ə t̚ ˧˦ ʔ aː t̚ ˧˦
ảm đạm	ʔ aː m ˧˩ ʔ ɗ aː m ˧˨ ʔ
ảnh hưởng	ʔ a j ŋ̟ ˧˩ h ɨ ə ŋ ˧˩
ảo tượng	ʔ aː w ˧˩ t ɨ ə ŋ ˧˨ ʔ
ấn	ʔ ə n ˧˦
ấn loát	ʔ ə n ˧˦ l w aː t̚ ˧˦
ấp ủ	ʔ ə p̚ ˧˦ ʔ u ˧˩
ầm	ʔ ə m ˨˩
ẩm thực	ʔ ə m ˧˩ tʰ ɨ k̚ ˧˨ ʔ
ậm ừ	ʔ ə m ˧˨ ʔ ʔ ɨ ˨˩
ẻm	ʔ ɛ m ˧˩
ếch	ʔ ə j k̟̚ ˧˦
ềnh	ʔ ə j ŋ̟ ˨˩
ễnh ương	ʔ ə j ŋ̟ ˦˥ ʔ ɨ ə ŋ ˧˧
ỉa	ʔ i ə ˧˩
ỉm	ʔ i m ˧˩
ỉn	ʔ i n ˧˩
ỉu	ʔ i w ˧˩
ịch	ʔ ï k̟̚ ˧˨ ʔ
ốc bươu	ʔ ə w k͡p̚ ˧˦ ʔ ɓ i ə w ˧˧
ối	ʔ o j ˧˦
ống	ʔ ə w ŋ͡m ˧˦
ống chích	ʔ ə w ŋ͡m ˧˦ t͡ɕ ï k̟̚ ˧˦
ống hút	ʔ ə w ŋ͡m ˧˦ h u t̚ ˧˦
ống tiêm	ʔ ə w ŋ͡m ˧˦ t i ə m ˧˧
ồn	ʔ o n ˨˩
ổ mắt	ʔ o ˧˩ m a t̚ ˧˦
ổ đĩa	ʔ o ˧˩ ʔ ɗ i ə ˦˥
ổng	ʔ ə w ŋ͡m ˧˩
ộp	ʔ o p̚ ˧˨ ʔ
ớt đỏ	ʔ əː t̚ ˧˦ ʔ ɗ ɔ ˧˩
ở lại	ʔ əː ˧˩ l aː j ˧˨ ʔ
ở ẩn	ʔ əː ˧˩ ʔ ə n ˧˩
ủi	ʔ u j ˧˩
ủng hộ	ʔ ʊ w ŋ͡m ˧˩ h o ˧˨ ʔ
ứng cử viên	ʔ ɨ ŋ ˧˦ k ɨ ˧˩ v i ə n ˧˧
ứng dụng	ʔ ɨ ŋ ˧˦ z ʊ w ŋ͡m ˧˨ ʔ
ứng tác	ʔ ɨ ŋ ˧˦ t aː k̚ ˧˦
ửng	ʔ ɨ ŋ ˧˩
