s ơ n	s ơ n
r ò m	r ò m
t ớ i	t ớ i
x o e	x o e
r ì a	r ì a
c ầ y	c ầ y
l ù m	l ù m
i n h	i n h
n ô n	n ô n
g ỏ i	g ỏ i
t a y	t a y
v ờ i	v ờ i
h u y	h u y
v ả y	v ả y
g á i	g á i
m ồ m	m ồ m
t ấ n	t ấ n
v ă n	v ă n
t à u	t à u
v á y	v á y
m a i	m a i
r ũ a	r ũ a
m á i	m á i
t a m	t a m
h o à	h o à
t o a	t o a
s ẵ n	s ẵ n
t r ị	t r ị
m ề n	m ề n
m ấ y	m ấ y
x o á	x o á
l õ m	l õ m
l á i	l á i
r ố n	r ố n
n o m	n o m
h ó t	h ó t
h á t	h á t
x í a	x í a
h u n	h u n
d ấ u	d ấ u
c h ộ	c h ộ
s ủ i	s ủ i
h ổ i	h ổ i
h ò n	h ò n
h é t	h é t
n õ n	n õ n
r ớ t	r ớ t
h ẳ n	h ẳ n
h ã i	h ã i
r ấ p	r ấ p
h ư u	h ư u
k í n	k í n
h ố t	h ố t
d u y	d u y
t h ị	t h ị
h e o	h e o
x o a	x o a
l a u	l a u
m u a	m u a
t ố n	t ố n
v í u	v í u
c ẩ m	c ẩ m
m ẩ y	m ẩ y
n ấ y	n ấ y
r ỉ a	r ỉ a
r í u	r í u
m ư u	m ư u
m ứ c	m ứ c
c ủ a	c ủ a
h o a	h o a
v o a	v o a
c ú m	c ú m
n í n	n í n
p í p	p í p
c ấ p	c ấ p
s á u	s á u
n ấ p	n ấ p
v à o	v à o
s a y	x a y
d é t	r é t
q u ẻ	q u ẻ
k i m	k i m
l ờ i	l ờ i
l a n	l a n
d ờ i	r ờ i
h a y	h a y
s ă n	s ă n
m é c	m é c
m é o	m é o
x ó t	x ó t
n e o	n e o
g ố i	g ố i
s á p	s á p
g ã y	g ã y
h u ơ	h u ơ
l í t	l í t
h u ế	h u ế
t ê m	t ê m
g â u	g â u
g ắ t	g ắ t
t a o	t a o
r ê n	r ê n
d ẻ o	r ẻ o
t o ả	t o ả
s a m	s a m
h ắ c	h ắ c
n ú m	n ú m
r ằ n	r ằ n
c ở i	c ở i
s ẫ m	s ẫ m
t í p	t í p
g ã i	g ã i
m ẫ n	m ẫ n
x í u	x í u
g à u	g à u
v í a	v í a
g i ề n	r ề n
t r ó t	t r ó t
c h a i	t r a i
n h ở i	n h ở i
n h o à	n h o à
t h ư a	t h ư a
c h ơ i	c h ơ i
t r ớ n	t r ớ n
p h i m	p h i m
c h ổ i	c h ổ i
n h ã n	n h ã n
c h ê m	c h ê m
v i n h	v i n h
t r è o	c h è o
n g h ệ	n g h ệ
t h ủ a	t h ủ a
t r ấ u	t r ấ u
l a n g	l a n g
c h é o	c h é o
n h ơ i	n h ơ i
n g õ i	n g õ i
d ừ n g	d ừ n g
k h o ẻ	k h o ẻ
k h á n	k h á n
g i a n	g i a n
m ắ n g	m ắ n g
t h u ỳ	t h u ỳ
k h o m	k h o m
c h ố t	c h ố t
c h ì m	c h ì m
c h ầ u	t r ầ u
t h u ý	t h u ý
v ữ n g	v ữ n g
g i ỡ n	r ỡ n
n h à n	n h à n
c h ô m	c h ô m
t r à o	t r à o
p h ấ n	p h ấ n
c h u i	c h u i
c h á c	t r á c
k h ắ m	k h ắ m
p h o i	p h o i
n g á t	n g á t
n h ớ t	n h ớ t
c h a o	t r a o
r ì n h	r ì n h
g a n g	g a n g
c h é n	c h é n
t h ấ p	t h ấ p
n h a i	n h a i
t h u a	t h u a
t r ả m	t r ả m
s ì n h	s ì n h
k h ắ p	k h ắ p
r i n h	d i n h
r ằ n g	r ằ n g
n h ú n	n h ú n
h ứ n g	h ứ n g
r ù a	r ù a
h è n	h è n
q u á	q u á
t ẩ m	t ẩ m
c ắ c	c ắ c
ư n g	ư n g
m ì n	m ì n
t ả n	t ả n
m õ m	m õ m
l õ i	l õ i
t ắ c	t ắ c
g ó p	g ó p
x u a	x u a
q u è	q u è
l ù n	l ù n
h ớ n	h ớ n
h u ỷ	h u ỷ
c à y	c à y
h ớ t	h ớ t
d a i	d a i
r è n	r è n
m ú t	m ú t
r á p	r á p
s i n	s i n
x e m	x e m
k e m	k e m
t ế t	t ế t
t ầ m	t ầ m
k ế t	k ế t
r ẫ y	r ẫ y
g i á c	r á c
r ồ i	r ồ i
n ỗ i	n ỗ i
m ầ m	m ầ m
n ẳ m	n ẳ m
n ắ m	n ắ m
s ồ i	s ồ i
m ố t	m ố t
r ù m	r ù m
m è m	m è m
c â u	c â u
n ẩ u	n ẩ u
c ố m	c ố m
c ù m	c ù m
t ồ n	t ồ n
h ồ i	h ồ i
l ắ c	l ắ c
x ú i	x ú i
g ầ n	g ầ n
g á y	g á y
h ẻ m	h ẻ m
s ế n	s ế n
m à i	m à i
t ă m	t ă m
s o i	x o i
s ó i	s ó i
h i a	h i a
c ử i	c ử i
m í t	m í t
l e o	l e o
q u à	q u à
m ắ n	m ắ n
s à i	s à i
r ắ m	r ắ m
m ấ u	m ấ u
n ứ a	n ứ a
m o ả	m o ả
l ồ i	l ồ i
c à i	c à i
n ấ c	n ấ c
c ũ i	c ũ i
m ú i	m ú i
x ó m	x ó m
v ò i	v ò i
n ứ t	n ứ t
k é p	k é p
n á m	n á m
r é n	r é n
m ầ y	m ầ y
h ô n	h ô n
x ô i	x ô i
x ơ i	x ơ i
t ấ t	t ấ t
m á u	m á u
r ì u	r ì u
n ử a	n ử a
c à o	c à o
s ế p	s ế p
h ô m	h ô m
s ắ n	s ắ n
c ố t	c ố t
í c h	í c h
d ú i	d ú i
n ố t	n ố t
v ế t	v ế t
t ú t	t ú t
r ằ m	r ằ m
m é t	m é t
x á c	x á c
d ã i	d ã i
h ù m	h ù m
s u i	x u i
m ứ a	m ứ a
s ử u	s ử u
c ấ u	c ấ u
r ớ m	r ớ m
h è m	h è m
l ắ m	l ắ m
m ũ i	m ũ i
m ó n	m ó n
r ơ i	r ơ i
r ắ c	r ắ c
m ủ i	m ủ i
t ỏ i	t ỏ i
x ế p	s ế p
t á m	t á m
n a n	n a n
g ấ m	g ấ m
v ằ n	v ằ n
x u i	x u i
h é o	h é o
l â m	l â m
l ừ a	l ừ a
n ẫ u	n ẫ u
h ấ p	h ấ p
t ú m	t ú m
m í m	m í m
g à o	g à o
s ở i	s ở i
t u ỳ	t u ỳ
n ố i	n ố i
x o ã	x o ã
s ấ u	s ấ u
n h ị	n h ị
r ó t	r ó t
l ă m	l ă m
x o è	x o è
r ă n	r ă n
d â u	d â u
l ẫ y	l ẫ y
ử n g	ử n g
c ă n	c ă n
s a i	s a i
c ầ n	c ầ n
t ố p	t ố p
s ấ p	s ấ p
v ỉ a	v ỉ a
r ờ i	r ờ i
k ì m	k ì m
v é o	v é o
r i a	r i a
n ú t	n ú t
t ố i	t ố i
d ề n	r ề n
n ắ p	n ắ p
m é p	m é p
v ế u	v ế u
c õ i	c õ i
x ắ t	x ắ t
r è m	r è m
v ớ t	v ớ t
g ú t	g ú t
g á o	g á o
d ứ a	r ứ a
m ắ t	m ắ t
t ẩ u	t ẩ u
r a m	r a m
t í a	t í a
l ờ n	l ờ n
r á c	r á c
s o n	s o n
c ò n	c ò n
t a n	t a n
l ù i	l ù i
k ê u	k ê u
h e n	h e n
k ẻ o	k ẻ o
r ở m	r ở m
s ử a	s ử a
n é n	n é n
v ã i	v ã i
m ế n	m ế n
m ù n	m ù n
h ế t	h ế t
v a y	v a y
l ẫ n	l ẫ n
n ó n	n ó n
t a u	t a u
r ú t	r ú t
h ỡ i	h ỡ i
c ả i	c ả i
t r ụ	t r ụ
h ả i	h ả i
m ã i	m ã i
n ổ i	n ổ i
c a o	c a o
x â y	x â y
c u a	c u a
l ầ y	l ầ y
r é o	r é o
h ú t	h ú t
c ú p	c ú p
h ó i	h ó i
d o m	d o m
l a o	l a o
r é t	r é t
c ơ n	c ơ n
c á i	c á i
h ố i	h ố i
t i m	t i m
x é t	x é t
v o i	v o i
s ă m	s ă m
r o i	r o i
c ù i	c ù i
c ò i	c ò i
c ắ t	c ắ t
v ầ n	v ầ n
t ố t	t ố t
m ã o	m ã o
h ờ i	h ờ i
h à i	h à i
g ẫ m	g ẫ m
t ỏ m	t ỏ m
t ẩ y	t ẩ y
v ả i	v ả i
t â n	t â n
t à n	t à n
c á y	c á y
g ử i	g ử i
x á t	s á t
d ầ m	r ầ m
t é p	t é p
t á o	t á o
d í m	d í m
l é p	l é p
r ố i	r ố i
q u ý	q u ý
t â y	t â y
h ứ c	h ứ c
r ủ a	r ủ a
c á c	c á c
s u n	s u n
c ú n	c ú n
n ầ y	n ầ y
l i a	l i a
h ỏ i	h ỏ i
t o à	t o à
n g ộ	n g ộ
h a o	h a o
v e n	v e n
x ă m	s ă m
d á n	d á n
d ỏ m	d ỏ m
r ử a	r ử a
l ỏ m	l ỏ m
h ê n	h ê n
d ớ t	r ớ t
r ủ i	r ủ i
n á t	n á t
s ư a	s ư a
d ắ t	r ắ t
d a o	d a o
h ẩ y	h ẩ y
q u ỳ	q u ỳ
n u y	n u y
x é m	x é m
g ả y	g ả y
n í u	n í u
c ắ p	c ắ p
c ử a	c ử a
n ê n	n ê n
l u i	l u i
h ồ n	h ồ n
h ấ t	h ấ t
t i n	t i n
n g ồ i	n g ồ i
d ú m	d ú m
s ố t	s ố t
g à n	g à n
h à n	h à n
s a n	s a n
c à n	c à n
l â y	l â y
x à i	s à i
h ò m	h ò m
c ứ u	c ứ u
s ớ m	s ớ m
s í t	s í t
s ả i	s ả i
n g ù i	n g ù i
t r á n	t r á n
n h ò m	n h ò m
t r ố n	t r ố n
n h e o	n h e o
n h ứ c	n h ứ c
t r ă m	t r ă m
t h ê u	t h ê u
t r á p	t r á p
p h ẫ u	p h ẫ u
p h ố i	p h ố i
g i ũ a	r ũ a
k h a i	k h a i
t r ả i	c h ả i
k h ả i	k h ả i
t í c h	t í c h
c h ú t	t r ú t
t h è m	t h è m
l à n g	l à n g
k ẻ n g	k ẻ n g
c h ò i	c h ò i
c à n g	c à n g
s ừ n g	s ừ n g
p h ê n	p h ê n
t r ù n	t r ù n
v í c h	v í c h
n g o i	n g o i
p h a u	p h a u
n h ă m	n h ă m
n h í p	n h í p
v ầ n g	v ầ n g
n g ắ t	n g ắ t
k h é p	k h é p
t h â m	t h â m
t h ấ m	t h ấ m
p h i n	p h i n
n h ì n	n h ì n
t r ò n	t r ò n
c h à i	c h à i
n g ấ m	n g ấ m
k h a n	k h a n
c h ớ m	c h ớ m
c h u ỳ	c h u ỳ
n g ô i	n g ô i
c h o a	c h o a
t h u ỷ	t h u ỷ
p h à m	p h à m
k e n g	k e n g
n g á i	n g á i
t h u n	t h u n
n h ấ m	n h ấ m
p h ễ u	p h ễ u
c h ú i	c h ú i
c h ư a	c h ư a
t r ê n	t r ê n
c h ò m	c h ò m
l á n g	l á n g
l ừ n g	l ừ n g
l ắ n g	l ắ n g
t h u ê	t h u ê
c h ù i	c h ù i
t h ả i	t h ả i
k h ó m	k h ó m
n g ừ a	n g ừ a
n h ó t	n h ó t
n h ẫ n	n h ẫ n
n h ằ m	n h ằ m
k h o á	k h o á
r a n g	d a n g
n g ầ m	n g ầ m
t à n g	t à n g
k h á i	k h á i
n g ủ m	n g ủ m
c h ắ t	c h ắ t
g i ả o	g i ả o
n h ó n	n h ó n
k i n h	k i n h
p h ố t	p h ố t
t h ă m	t h ă m
t r ầ u	t r ầ u
k h ớ p	k h ớ p
k h á m	k h á m
g i e o	r e o
n g ó t	n g ó t
p h ú t	p h ú t
n h a u	n h a u
t r ĩ u	t r ĩ u
l ĩ n h	l ĩ n h
k h e n	k h e n
t r à n	t r à n
d ử n g	d ử n g
n h ó m	n h ó m
g i ầ y	r ầ y
k h é o	k h é o
n h é o	n h é o
c h ớ p	c h ớ p
t r a u	t r a u
c h ứ a	c h ứ a
v à n g	v à n g
g i ữ a	r ữ a
l ử n g	l ử n g
k h ẩ u	k h ẩ u
g i ầ u	r ầ u
t h ê m	t h ê m
l i n h	l i n h
t r ù m	t r ù m
t h ố i	t h ố i
c h á u	t r á u
t h ủ m	t h ủ m
l ư n g	l ư n g
g h e n	g h e n
k h ă n	k h ă n
g i á y	r á y
t h ừ a	t h ừ a
c h ó i	c h ó i
t h ô i	t h ô i
n g ừ n g	n g ừ n g
g i à n g	r à n g
t h á n g	t h á n g
t r á n g	t r á n g
p h ẳ n g	p h ẳ n g
c h í c h	t r í c h
c h ă n g	t r ă n g
t r ắ n g	t r ắ n g
t h í c h	t h í c h
n g ẩ n g	n g ẩ n g
c h ỉ n h	c h ỉ n h
n h ỉ n h	n h ỉ n h
t r ả n g	t r ả n g
c h i n h	t r i n h
n h ã n g	n h ã n g
n g h í a	n g h í a
t h a n g	t h a n g
n g h è o	n g h è o
k h í c h	k h í c h
g i ả n g	g i ả n g
p h í c h	p h í c h
n g h ẽ n	n g h ẽ n
x o o n g	x o o n g
t r a n g	t r a n g
c h á n	t r á n
g i ả m	g i ả m
p h ổ i	p h ổ i
n h í m	n h í m
m ì n h	m ì n h
n h í c h	n h í c h
g i á n g	d á n g
n h a n g	n h a n g
c h ừ n g	t r ừ n g
n g a n g	n g a n g
t h ă n g	t h ă n g
n g ư n g	n g ư n g
t r i n h	t r i n h
c h à n g	t r à n g
n g h é n	n g h é n
t r ứ n g	t r ứ n g
g i ă n g	r ă n g
n g h ĩ a	n g h ĩ a
t h í n h	t h í n h
c h ứ n g	t r ứ n g
k h á c	k h á c
t r ì n h	t r ì n h
t r í c h	t r í c h
k h á n g	k h á n g
n g h ê u	n g h ê u
c h ằ n g	c h ằ n g
t h ẳ n g	t h ẳ n g
c h ẳ n g	c h ẳ n g
n g h ì m	n g h ì m
p h a n g	p h a n g
c h ư n g	c h ư n g
t r à n g	t r à n g
k h i n h	k h i n h
t h ằ n g	t h ằ n g
p h ả n	p h ả n
n g à i	n g à i
n á n g	n á n g
d ư n g	d ư n g
n g ử i	n g ử i
g i ấ y	d ấ y
l ẵ n g	l ẵ n g
t h í m	t h í m
n h é t	n h é t
m o ó c	m o ó c
d i n h	d i n h
c h ú a	c h ú a
n í c h	n í c h
c á n g	c á n g
t h o n	t h o n
c h ắ p	c h ắ p
n h ẵ n	n h ẵ n
c h ử i	c h ử i
t r ê u	t r ê u
n g á n	n g á n
g ắ n g	g ắ n g
k í c h	k í c h
t h o i	t h o i
c h á i	t r á i
t h ấ t	t h ấ t
n h á p	n h á p
g i a i	d a i
c h è n	c h è n
t h ắ t	t h ắ t
g h i m	g h i m
n h o i	n h o i
r í c h	r í c h
t h ì a	t h ì a
t á n g	t á n g
t h ắ p	t h ắ p
g i ả i	g i ả i
n h ấ c	n h ấ c
h á n g	h á n g
t h ơ m	t h ơ m
t h ù a	t h ù a
c h ù n	t r ù n
l ã n g	l ã n g
k h ấ u	k h ấ u
g i à y	d à y
c h u m	t r u m
p h u y	p h u y
t h ấ u	t h ấ u
t h ề m	t h ề m
t h ấ y	t h ấ y
t h ố t	t h ố t
t ư n g	t ư n g
d í n h	d í n h
g i à n	d à n
k h a y	k h a y
c h u a	c h u a
p h í m	p h í m
c h ấ n	t r ấ n
n g u y	n g u y
n g ớ t	n g ớ t
n g â y	n g â y
k h í a	k h í a
n g ờ i	n g ờ i
c ả n g	c ả n g
t h ố n	t h ố n
n g ầ n	n g ầ n
g i ấ m	r ấ m
c h ừ a	c h ừ a
n h ũ n	n h ũ n
n g ô n	n g ô n
t h ẩ y	t h ẩ y
g i u n	r u n
k h ả o	k h ả o
t h á i	t h á i
n h ả y	n h ả y
p h ẩ m	p h ẩ m
n g a o	n g a o
p h ế t	p h ế t
n h ờ i	n h ờ i
n g ắ n	n g ắ n
t h ờ i	t h ờ i
n ừ n g	n ừ n g
n g h ẹ	n g h ẹ
n h ắ n	n h ắ n
g i ú p	r ú p
t r ầ n	t r ầ n
k h ê u	k h ê u
c h í p	c h í p
c h ồ m	c h ồ m
p h ô i	p h ô i
t h ẳ m	t h ẳ m
n g ứ a	n g ứ a
c h a y	c h a y
n h á c	n h á c
n h à i	n h à i
t r ẩ u	t r ẩ u
c ă n g	c ă n g
g i ỏ i	r ỏ i
c h è o	c h è o
n h ớ p	n h ớ p
k h ó i	k h ó i
n h ấ n	n h ấ n
p h a n	p h a n
g i ằ m	r ằ m
n g ấ t	n g ấ t
n g á o	n g á o
k h ứ a	k h ứ a
g i á n	d á n
k h o é	k h o é
k h ắ c	k h ắ c
h à n g	h à n g
c h á o	t r á o
t h ớ t	t h ớ t
p h è o	p h è o
v ă n g	v ă n g
c h ế t	c h ế t
t h â u	t h â u
n â n g	n â n g
n h ẩ m	n h ẩ m
c h a u	t r a u
c h ứ c	c h ứ c
g i ớ i	r ớ i
t ỉ n h	t ỉ n h
c h é m	c h é m
t h á c	t h á c
p h í a	p h í a
c ẳ n g	c ẳ n g
c h à m	t r à m
c h ó t	t r ó t
m ừ n g	m ừ n g
t r ắ m	t r ắ m
p h â n	p h â n
n h á t	n h á t
t r ầ m	t r ầ m
k h ô i	k h ô i
g i á o	r á o
n h é p	n h é p
n à n g	n à n g
n h ổ m	n h ổ m
p h á t	p h á t
c h á y	c h á y
t h ả o	t h ả o
c h ồ n	t r ồ n
t r â m	t r â m
p h á p	p h á p
n h ú m	n h ú m
k h o e	k h o e
g i ò n	g i ò n
k h à n	k h à n
t h u i	t h u i
n g à y	n g à y
n h á o	n h á o
t r ẫ m	t r ẫ m
p í c h	p í c h
k h u i	k h u i
t r ấ n	t r ấ n
g i ã y	d ã y
n g ẩ n	n g ẩ n
t i n h	t i n h
n g a i	n g a i
n h á i	n h á i
n g o n	n g o n
n h ằ n	n h ằ n
n h ă n	n h ă n
p h u n	p h u n
c h ắ n	c h ắ n
g i ờ i	r ờ i
k h á t	k h á t
t ă n g	t ă n g
k h â u	k h â u
t h a n	t h a n
c h ì a	c h ì a
n h ấ p	n h ấ p
p h á i	p h á i
m a n g	m a n g
k h é t	k h é t
c h ố i	c h ố i
g i à u	r à u
p h ù n	p h ù n
m i n h	m i n h
k h ơ i	k h ơ i
c h é p	c h é p
n ă n g	n ă n g
x è n g	x è n g
n g ấ y	n g ấ y
c h ứ t	c h ứ t
c h ô n	c h ô n
s í n h	s í n h
c h e o	c h e o
m à n g	m à n g
n h ầ y	n h ầ y
k h á y	k h á y
t h e n	t h e n
t r á o	t r á o
p h è n	p h è n
c h ả i	c h ả i
t h a y	t h a y
x ă n g	x ă n g
g ă n g	g ă n g
t h o ả	t h o ả
c h ắ c	c h ắ c
p h ủ i	p h ủ i
c h ả y	c h ả y
g i ã i	d ã i
n h â m	n h â m
n a n g	n a n g
c h à o	t r à o
g i ă m	r ă m
t r e o	c h e o
n g ó n	n g ó n
p h ớ i	p h ớ i
t h ứ c	t h ứ c
t r ú t	t r ú t
m ả n g	m ả n g
t r a o	t r a o
n g ớ p	n g ớ p
n h ô m	n h ô m
c ứ n g	c ứ n g
t a n g	t a n g
c h ó p	c h ó p
g i ò i	r ò i
t r ể n	t r ể n
c h ả o	c h ả o
g i ẫ m	d ẫ m
t h ầ u	t h ầ u
h ử n g	h ử n g
n g h ị	n g h ị
t r à m	t r à m
p h e n	p h e n
s a n g	s a n g
c h í n	t r í n
c h ù m	t r ù m
p h ầ n	p h ầ n
g h é t	g h é t
c h á t	t r á t
v ắ n g	v ắ n g
n g ò i	n g ò i
n g a y	n g a y
c h ữ a	c h ữ a
p h á c	p h á c
c h ù a	c h ù a
t r ắ c	c h ắ c
h ã n g	h ã n g
t h á p	t h á p
t h ồ n	t h ồ n
t h ô n	t h ô n
d á n g	d á n g
c h â u	c h â u
c h ấ t	t r ấ t
c h ấ m	c h ấ m
t h ổ i	t h ổ i
g i ã n	g i ã n
t h ầ y	t h ầ y
t r ầ y	t r ầ y
p h ẩ y	p h ẩ y
t r ó i	c h ó i
c h ẽ n	c h ẽ n
g h é p	g h é p
t h á o	t h á o
v a n g	v a n g
t h u ế	t h u ế
c h ử a	c h ử a
n g a n	n g a n
c h ỏ m	c h ỏ m
k h o ả	k h o ả
t ả n g	t ả n g
p h é p	p h é p
x i n h	s i n h
d a n g	d a n g
t r á i	t r á i
g o l f	g ô n
g i ầ m	r ầ m
k ì n h	k ì n h
t h ì n	t h ì n
c h ấ y	c h ấ y
n g á p	n g á p
t h i u	t h i u
t h ọ	t h ọ
s à n g	s à n g
k h u m	k h u m
n g o a	n g o a
k h o a	k h o a
t h ú i	t h ú i
n g ơ i	n g ơ i
n h à m	n h à m
k í n h	k í n h
n g à n	n g à n
c h ẵ n	c h ẵ n
g i a m	r a m
t ì n h	t ì n h
t h é p	t h é p
r ắ n	r ắ n
n e m	n e m
n à i	n à i
s á n	s á n
l a i	l a i
g ầ m	g ầ m
d ă m	r ă m
l ó t	l ó t
r a u	r a u
m à u	m à u
h ú p	h ú p
c á u	c á u
k ề n	k ề n
n ồ i	n ồ i
t ẩ n	t ẩ n
h ả o	h ả o
g ù i	g ù i
g o m	g o m
m ầ u	m ầ u
n ả i	n ả i
v ố n	v ố n
m á t	m á t
s i m	s i m
c ú t	c ú t
n ế m	n ế m
s ứ a	s ứ a
m o a	m o a
s ắ c	s ắ c
q u <<unk>>	q u <unk>
h à u	h à u
c ấ y	c ấ y
d à n	d à n
h ù a	h ù a
ắ p	ắ p
r ệ	r ệ
đ á	đ á
b ề	b ề
đ i	đ i
ă n	ă n
b à	b à
đ ẻ	đ ẻ
s ự	s ự
r ạ	r ạ
á i	á i
đ ò	đ ò
t ộ	t ộ
đ ớ	đ ớ
r ộ	r ộ
ớ n	ớ n
ứ c	ứ c
n ả y	n ả y
c ọ	c ọ
ỉ n	ỉ n
đ ể	đ ể
k ệ	k ệ
đ ồ	đ ồ
ầ m	ầ m
l ẻ n	l ẻ n
m ề m	m ề m
d à y	d à y
r á i	d á i
v ẫ n	v ẫ n
m o l	m o l
l ô i	l ô i
d ì m	d ì m
s á o	s á o
v ô n	v ô n
t ứ c	t ứ c
x ả y	x ả y
t u ế	t u ế
x á o	s á o
s ô i	x ô i
v á i	v á i
n ề n	n ề n
h ầ u	h ầ u
t e m	t e m
g ắ p	g ắ p
s ở n	s ở n
l ẩ n	l ẩ n
n ô m	n ô m
m ó t	m ó t
v ư u	v ư u
l ấ n	l ấ n
s ủ a	s ủ a
l ê n	l ê n
t ê n	t ê n
n ô i	n ô i
t ó m	t ó m
k è n	k è n
n a o	n a o
m ú a	m ú a
d ã y	d ã y
c ấ t	c ấ t
g a i	g a i
n o i	n o i
l ò n	l ò n
v ẫ y	v ẫ y
m o i	m o i
d ứ t	r ứ t
r ầ u	r ầ u
n u i	n u i
s à n	s à n
d ỗ i	r ỗ i
h ơ n	h ơ n
á n g	á n g
s ả o	x ả o
c a i	c a i
n é p	n é p
g ằ n	g ằ n
t á i	t á i
m ắ m	m ắ m
v à i	v à i
k e n	k e n
r ế t	r ế t
l à n	l à n
ấ u	ấ u
h ử i	h ử i
n é t	n é t
s ê n	s ê n
t h ụ	t h ụ
l ấ m	l ấ m
h a m	h a m
l ú n	l ú n
s ư u	s ư u
c ú i	c ú i
l ằ n	l ằ n
s ắ p	s ắ p
s ấ y	s ấ y
h í t	h í t
r ê u	r ê u
m ứ t	m ứ t
v ị	v ị
ỉ m	ỉ m
đ ỏ	đ ỏ
b ú	b ú
b ĩ	b ĩ
l ộ	l ộ
ó t	ó t
b é	b é
đ ổ	đ ổ
b ỏ	b ỏ
ủ a	ủ a
l ự	l ự
v ụ	v ụ
đ ô	đ ô
m ẹ	m ẹ
b i	b i
b ì	b ì
e o	e o
x ị	x ị
b ê	b ê
đ ờ	đ ờ
a i	a i
ấ n	ấ n
l ọ	l ọ
ừ a	ừ a
o m	o m
a m	a m
đ a	đ a
đ ù	đ ù
b ổ	b ổ
đ ơ	đ ơ
l ạ	l ạ
b u	b u
đ ả	đ ả
b ù	b ù
n ợ	n ợ
c ự	c ự
ồ n	ồ n
b è	b è
ủ i	ủ i
t ạ	t ạ
ẩ m	ẩ m
ù n	ù n
đ ố	đ ố
d ạ	r ạ
b ư	b ư
đ e	đ e
ú i	ú i
a o	a o
s ợ	s ợ
t ự	t ự
ớ t	ớ t
ô m	ô m
á c	á c
v ợ	v ợ
ô n	ô n
l ệ	l ệ
i m	i m
b ể	b ể
é t	é t
m ạ	m ạ
e m	e m
o à	o à
b ồ	b ồ
d ự	d ự
i u	i u
c ộ	c ộ
đ ề	đ ề
h ẹ	h ẹ
d ụ	d ụ
c ạ	c ạ
h ộ	h ộ
á t	á t
ấ t	ấ t
đ ỡ	đ ỡ
ê m	ê m
ừ m	ừ m
ú p	ú p
b e	b e
ú a	ú a
v ạ	v ạ
b ế	b ế
đ ỗ	đ ỗ
à o	à o
t ệ	t ệ
ẵ m	ẵ m
ơ n	ơ n
ố p	ố p
a u	a u
ỉ a	ỉ a
é c	é c
ú t	ú t
ẩ u	ẩ u
ả i	ả i
n ụ	n ụ
a n	a n
đ u	đ u
m ệ	m ệ
đ ĩ	đ ĩ
g ạ	g ạ
ỉ u	ỉ u
m ộ	m ộ
đ ú	đ ú
b ò	b ò
b o	b o
b ẻ	b ẻ
á n	á n
x ệ	x ệ
b ờ	b ờ
ư a	ư a
l ị	l ị
đ ê	đ ê
b ớ	b ớ
ẩ n	ẩ n
đ ế	đ ế
v u a	v u a
u ý	u ý
s ọ	s ọ
b ả	b ả
n ọ	n ọ
b ơ	b ơ
đ ó	đ ó
b ỉ	b ỉ
á p	á p
b ô	b ô
đ o	đ o
ứ a	ứ a
ố m	ố m
đ à	đ à
é n	é n
h ạ	h ạ
t i a	t i a
v ấ t	v ấ t
c ố i	c ố i
t u i	t u i
l ứ a	l ứ a
t ắ t	t ắ t
r ứ t	r ứ t
m ế u	m ế u
s e n	s e n
l e m	l e m
m à y	m à y
l ầ m	l ầ m
t r ọ	t r ọ
c ố p	c ố p
g ắ n	g ắ n
x ú m	x ú m
m ố i	m ố i
g ờ m	g ờ m
s í p	s í p
q u ế	q u ế
h ớ p	h ớ p
t ở n	t ở n
r ấ m	r ấ m
v é t	v é t
n ắ n	n ắ n
l ă n	l ă n
d ẫ n	d ẫ n
c ả m	c ả m
t ấ c	t ấ c
h ó p	h ó p
n ê u	n ê u
q u ê	q u ê
n a m	n a m
l ớ p	l ớ p
l ã o	l ã o
c ử u	c ử u
d ì u	r ì u
c ắ m	c ắ m
c o n	c o n
n ã y	n ã y
h ã n	h ã n
c ứ t	c ứ t
n ú i	n ú i
c h ợ	c h ợ
t à y	t à y
n ù i	n ù i
t ằ m	t ằ m
r ả y	r ả y
d á i	d á i
r ấ t	r ấ t
x ắ n	s ắ n
l ớ n	l ớ n
t ì m	t ì m
l e n	l e n
d ứ c	r ứ c
h ầ m	h ầ m
x à o	x à o
g ấ c	g ấ c
l ù a	l ù a
s á i	s á i
g ở i	g ở i
d ù m	r ù m
l ế t	l ế t
m ã n	m ã n
n ế n	n ế n
k é o	k é o
t ủ i	t ủ i
q u ơ	q u ơ
n ê m	n ê m
r á o	r á o
d ấ y	d ấ y
m ó p	m ó p
m ả i	m ả i
g ấ y	g ấ y
h o è	h o è
x é n	x é n
l ầ u	l ầ u
q u y	q u y
p h ụ	p h ụ
t ô m	t ô m
m ờ i	m ờ i
s a o	s a o
d ơ i	r ơ i
l a y	l a y
n ớ i	n ớ i
q u ở	q u ở
l á o	l á o
k é t	k é t
x o i	x o i
x ứ c	s ứ c
d à i	d à i
c ứ a	c ứ a
t ử u	t ử u
g ớ m	g ớ m
h ứ a	h ứ a
n ã o	n ã o
s ả n	s ả n
p h ị	p h ị
t ấ u	t ấ u
m ủ n	m ủ n
h á n	h á n
s ú n	s ú n
c ỡ i	c ỡ i
c a y	c a y
t u y	t u y
s é c	s é c
x ú t	x ú t
r ẻ o	r ẻ o
r ỗ i	r ỗ i
l á t	l á t
o ó c	o ó c
s ứ c	s ứ c
r ữ a	r ữ a
v ừ a	v ừ a
h ơ i	h ơ i
c ó t	c ó t
g ă m	g ă m
l ơ i	l ơ i
n ữ a	n ữ a
n ò i	n ò i
n ă m	n ă m
h à m	h à m
s ẩ y	s ẩ y
v ơ i	v ơ i
d ư a	d ư a
d ĩ a	d ĩ a
t é m	t é m
c á o	c á o
d a m	r a m
c ầ u	c ầ u
c á t	c á t
t o é	t o é
m a y	m a y
r à y	d à y
h ắ t	h ắ t
h i c	h i c
n á n	n á n
l ấ y	l ấ y
r ắ p	r ắ p
a n g	a n g
ẳ n g	ẳ n g
x ư a	s ư a
ứ n g	ứ n g
m ô i	m ô i
c á n	c á n
l i m	l i m
t â u	t â u
t õ m	t õ m
v á c	v á c
x ớ i	x ớ i
s ờ n	s ờ n
m ớ m	m ớ m
d é p	r é p
c ấ m	c ấ m
l a m	l a m
v ứ t	v ứ t
l ấ p	l ấ p
m ó m	m ó m
m ù a	m ù a
d ằ n	r ằ n
h ế n	h ế n
h o á	h o á
m ấ t	m ấ t
x a y	x a y
h ắ n	h ắ n
r ầ m	r ầ m
m à o	m à o
s â m	s â m
m á y	m á y
v ù i	v ù i
d ố i	r ố i
c ã i	c ã i
k ì a	k ì a
x à m	x à m
t ở m	t ở m
g h ẹ	g h ẹ
h ổ m	h ổ m
m ă m	m ă m
c ô n	c ô n
l í p	l í p
t ồ i	t ồ i
h u ề	h u ề
m à n	m à n
n g ọ	n g ọ
v ó t	v ó t
g ấ p	g ấ p
c ơ m	c ơ m
s á t	s á t
s é t	x é t
x ú p	x ú p
d á m	r á m
n ĩ a	n ĩ a
c ớ m	c ớ m
m ò n	m ò n
n h ọ	n h ọ
g a n	g a n
m ẩ u	m ẩ u
p a o	p a o
t ú a	t ú a
n ế p	n ế p
m ỏ i	m ỏ i
c ô i	c ô i
h ỗ n	h ỗ n
t á t	t á t
t o i	t o i
r í t	r í t
g ì n	d ì n
h ô i	h ô i
n ẻ o	n ẻ o
v ấ n	v ấ n
h r ê	h r ê
s ó t	x ó t
l à o	l à o
c â m	c â m
v u i	v u i
t é t	t é t
m ỉ m	m ỉ m
g ấ u	g ấ u
s e o	s e o
v ấ p	v ấ p
r ú n	r ú n
l ì n	l ì n
m ư a	m ư a
g ô n	g ô n
c ỗ i	c ỗ i
h ờ n	h ờ n
t ú i	t ú i
d ớ p	r ớ p
r e n	r e n
n a y	n a y
t ô i	t ô i
l o á	l o á
s u y	s u y
x ả o	x ả o
t u m	t u m
c ả n	c ả n
n ấ u	n ấ u
d ẫ u	d ẫ u
t ả o	t ả o
g ó t	g ó t
v ớ i	v ớ i
r ố t	r ố t
r u n	r u n
n é m	n é m
n á i	n á i
m ù i	m ù i
v é n	v é n
x á m	x á m
d ấ n	d ấ n
l á n	l á n
l ẩ u	l ẩ u
c ă m	c ă m
k ẽ m	k ẽ m
k i a	k i a
c l o	c l o
s ớ t	s ớ t
k í p	k í p
t o e	t o e
g a m	g a m
v ú t	v ú t
d ò m	r ò m
l ẽ	l ẽ
r ú	r ú
c ố	c ố
x e	x e
h ủ	h ủ
r é	r é
c o	c o
g u	g u
s ở	s ở
m u	m u
m ũ	m ũ
g o	g o
m ỏ	m ỏ
c ơ	c ơ
h ễ	h ễ
x à	x à
c ử	c ử
r ỡ	r ỡ
k ẻ	k ẻ
l ề	l ề
l ò	l ò
h ố	h ố
s ô	s ô
r ơ	r ơ
k è	k è
r ô	r ô
x ỏ	x ỏ
s á	s á
h i	h i
m ì	m ì
r ử	r ử
x ứ	s ứ
t ẻ	t ẻ
t ớ	t ớ
c ứ	c ứ
r ổ	r ổ
l ì	l ì
v ớ	v ớ
t ế	t ế
v ế	v ế
n ó	n ó
m ờ	m ờ
d è	d è
l à	l à
t ỉ	t ỉ
m ẻ	m ẻ
m e	m e
k i	k i
n è	n è
c ủ	c ủ
r ễ	r ễ
d ê	r ê
m ẽ	m ẽ
l á	l á
d u	r u
v ả	v ả
v ê	v ê
l è	l è
s o	s o
h í	h í
d ư	d ư
c ô	c ô
l e	l e
l ơ	l ơ
m a	m a
s i	s i
v ẻ	v ẻ
s ổ	s ổ
n ổ	n ổ
s ỉ	s ỉ
v e	v e
h à	h à
v ù	v ù
n ữ	n ữ
t i	t i
l ỗ	l ỗ
g õ	g õ
v ề	v ề
h ở	h ở
x ử	x ử
d o	r o
t ừ	t ừ
s ờ	s ờ
x ù	x ù
h ỗ	h ỗ
t à	t à
t o	t o
t ổ	t ổ
t í	t í
m ê	m ê
h ú	h ú
c ỏ	c ỏ
v ỉ	v ỉ
l ẻ	l ẻ
l ờ	l ờ
r ờ	r ờ
c ù	c ù
d ẽ	d ẽ
v i	v i
m ớ	m ớ
p ô	p ô
r à	r à
v ó	v ó
k ỉ	k ỉ
r ã	r ã
c ó	c ó
r u	r u
t á	t á
l ê	l ê
x á	s á
d ỡ	r ỡ
g i	r i
d ỗ	r ỗ
v ỡ	v ỡ
s ỏ	x ỏ
c á	c á
x ế	x ế
c ớ	c ớ
r õ	r õ
c ỗ	c ỗ
v ô	v ô
h ũ	h ũ
d ế	r ế
h a	h a
m ĩ	m ĩ
m ơ	m ơ
h ỉ	h ỉ
c ổ	c ổ
x ó	x ó
k ề	k ề
t ù	t ù
d ữ	d ữ
c ò	c ò
r ũ	r ũ
r ồ	r ồ
v o	v o
g ò	g ò
l ở	l ở
k ì	k ì
l ỡ	l ỡ
m è	m è
n o	n o
v é	v é
s ử	x ử
n á	n á
x ơ	x ơ
m õ	m õ
c ú	c ú
g ì	d ì
s ả	x ả
t a	t a
l õ	l õ
m í	m í
x ả	x ả
x u	x u
h ư	h ư
m ủ	m ủ
m i	m i
r ò	r ò
k ế	k ế
n ã	n ã
n ê	n ê
x ẻ	x ẻ
x ì	x ì
v õ	v õ
x ã	x ã
g ờ	g ờ
d ĩ	d ĩ
t ỏ	t ỏ
d ơ	r ơ
r ủ	r ủ
h ả	h ả
v ì	v ì
d ẻ	r ẻ
t è	t è
v y	v i
n ể	n ể
s ú	s ú
h á	h á
t ã	t ã
l o	l o
l ó	l ó
s ứ	s ứ
v ú	v ú
v ỏ	v ỏ
x é	x é
d ù	r ù
t ờ	t ờ
c à	c à
s ĩ	s ĩ
s a	s a
n y	n y
v ỗ	v ỗ
r ề	r ề
h o	h o
d ì	d ì
r ê	r ê
m ỡ	m ỡ
n a	n a
h è	h è
c ũ	c ũ
h ò	h ò
t h ì	t h ì
c h è	c h è
g h ế	g h ế
t r ổ	t r ổ
p h ở	p h ở
n g ả	n g ả
p h ả	p h ả
t h i	t h i
t r u	t r u
c h ó	c h ó
k h ế	k h ế
n h ỏ	n h ỏ
n h ổ	n h ổ
t h ổ	t h ổ
c h ê	c h ê
n g ờ	n g ờ
g h ì	g h ì
g i ú	r ú
k h ổ	k h ổ
c h ớ	c h ớ
p h á	p h á
t h e	t h e
t r ễ	t r ễ
k h á	k h á
c h ỉ	c h ỉ
n h u	n h u
p h ê	p h ê
n h o	n h o
c h ì	c h ì
n h é	n h é
g i ũ	r ũ
g i ã	r ã
t h à	t h à
t r ề	t r ề
c h ỗ	c h ỗ
n h ã	n h ã
t r ú	t r ú
n h ì	n h ì
c h ử	c h ử
p h o	p h o
t r ủ	t r ủ
t r e	c h e
p h í	p h í
k h ờ	k h ờ
t r ĩ	t r ĩ
n g u	n g u
p h ú	p h ú
t h ừ	t h ừ
t h ẻ	t h ẻ
g i a	g i a
n h ư	n h ư
t h ề	t h ề
t h ế	t h ế
n h ô	n h ô
t r í	t r í
g i ơ	r ơ
n g ù	n g ù
g i o	r o
t r ơ	t r ơ
k h ử	k h ử
t h ử	t h ử
c h é	c h é
t r ẻ	t r ẻ
n g ố	n g ố
n g õ	n g õ
c h i	c h i
t r ở	t r ở
t h ù	t h ù
p h a	p h a
t h è	t h è
k h ố	k h ố
g h e	g h e
n g h e	n g h e
n g h ê	n g h ê
n g h é	n g h é
n g h i	n g h i
k ĩ	k ĩ
p h ò	p h ò
c h e	c h e
c h ả	t r ả
c h à	t r à
g i ả	g i ả
n h e	n h e
n g ũ	n g ũ
n h è	n h è
n g a	n g a
g i à	r à
n g ư	n g ư
t h ô	t h ô
n h ú	n h ú
n g ủ	n g ủ
n g ữ	n g ữ
n h ủ	n h ủ
c h ú	t r ú
n g ỏ	n g ỏ
n g ớ	n g ớ
n h ừ	n h ừ
t h ò	t h ò
t r ừ	c h ừ
n g ã	n g ã
n h í	n h í
p h ổ	p h ổ
m ễ	m ễ
d ã	r ã
n õ	n õ
n ỏ	n ỏ
d ử	r ử
r ể	r ể
d ô	r ô
g ã	g ã
g ỉ	g ỉ
k ể	k ể
s ò	s ò
v ĩ	v ĩ
p ê	p ê
r ớ	r ớ
v ở	v ở
t ô	t ô
h é	h é
d í	d í
v ũ	v ũ
v ò	v ò
m ổ	m ổ
g à	g à
v è	v è
t ử	t ử
k í	k í
k ẽ	k ẽ
g ù	g ù
s ư	s ư
m ô	m ô
m ù	m ù
x í	x í
d ò	r ò
h ô	h ô
l é	l é
v ờ	v ờ
k e	k e
v á	v á
c ư	c ư
g ở	g ở
m ả	m ả
v ã	v ã
g ỗ	g ỗ
r á	r á
s ẽ	s ẽ
t ư	t ư
g ả	g ả
s ố	s ố
v ẽ	v ẽ
s ơ	x ơ
n ơ	n ơ
r i	r i
n h ỉ	n h ỉ
k h ê	k h ê
g i ỗ	r ỗ
g i á	r á
g h i	g h i
t h a	t h a
t r a	t r a
t r à	t r à
n h á	n h á
t r ữ	t r ữ
k h ô	k h ô
t h ả	t h ả
g h ê	g h ê
t r ỏ	t r ỏ
k h u	k h u
p h ế	p h ế
p h ó	p h ó
t h ứ	t h ứ
c h ờ	c h ờ
n h ớ	n h ớ
n h ờ	n h ờ
c h ữ	t r ữ
t r ù	t r ù
c h o	c h o
c h ừ	c h ừ
n g ò	n g ò
k h e	k h e
k h ó	k h ó
n h ử	n h ử
c h ẻ	t r ẻ
n h ơ	n h ơ
k h ỏ	k h ỏ
n h à	n h à
n g ó	n g ó
t h ư	t h ư
k h o	k h o
p h è	p h è
t h ủ	t h ủ
l ú	l ú
p h i	p h i
n h a	n h a
t h ờ	t h ờ
c h ở	t r ở
c h ế	c h ế
g i ữ	d ữ
t h í	t h í
p h e	p h e
k h i	k h i
p h ù	p h ù
g i ẻ	r ẻ
d a g à	d a g à
v é s ố	v é s ố
k ệ c h	k ệ c h
d i ệ c	d i ệ c
d i ệ n	d i ệ n
l a h ủ	l a h ủ
q u ạ t	q u ạ t
l ư ợ t	l ư ợ t
b ư ở i	b ư ở i
h ọ n g	h ọ n g
o á c h	o á c h
n i t ơ	n i t ơ
g ạ c h	g ạ c h
m ồ m ả	m ồ m ả
k i ệ t	k i ệ t
b i ế t	b i ế t
v ư ợ t	v ư ợ t
b ỗ n g	b ỗ n g
h ệ c h	h ệ c h
b ổ n g	b ổ n g
đ u ổ i	đ u ổ i
n h ọ c	n h ọ c
s i l a	s i l a
k a k i	k a k i
b ư ớ m	b ư ớ m
n h ụ c	n h ụ c
t ỉ m ỉ	t ỉ m ỉ
b ú n g	b ú n g
l í d o	l í d o
c ạ c h	c ạ c h
b u ồ m	b u ồ m
t h ụ c	t h ụ c
q u ặ m	q u ặ m
t ò v ò	t ò v ò
đ a n h	đ a n h
n h ư ý	n h ư ý
n g ụ c	n g ụ c
t ử s ố	t ử s ố
b ị c h	b ị c h
l ơ m ơ	l ơ m ơ
n u ộ t	n u ộ t
f a r a	p h a r a
đ à n h	đ à n h
m u ộ i	m u ộ i
g ò m á	g ò m á
t u ộ t	t u ộ t
t i ệ m	t i ệ m
c ờ h ó	c ờ h ó
s ĩ t ử	s ĩ t ử
v ạ c h	v ạ c h
x o ạ c	x o ạ c
ở g i á	ở g i á
v ô t ư	v ô t ư
q u ậ y	q u ậ y
r i ệ u	r i ệ u
p h ụ c	p h ụ c
v i ệ c	v i ệ c
s ạ c h	s ạ c h
h ạ c h	h ạ c h
k ể t ừ	k ể t ừ
r u ộ t	r u ộ t
k ể r a	k ể r a
l ệ n h	l ệ n h
t u h ú	t u h ú
l i ệ t	l i ệ t
m ư ợ t	m ư ợ t
l o ạ i	l o ạ i
m a t ổ	m a t ổ
l ệ c h	l ệ c h
b ù n g	b ù n g
c ọ n g	c ọ n g
t ờ m ờ	t ờ m ờ
q u ặ t	q u ặ t
m ơ h ồ	m ơ h ồ
h e l i	h e l i
t r ọ c	t r ọ c
s o ạ n	x o ạ n
l e l e	l e l e
h o ạ n	h o ạ n
k ĩ s ư	k ĩ s ư
b i ế u	b i ế u
q u ẹ o	q u ẹ o
c ỗ x e	c ỗ x e
m ô t ê	m ô t ê
m a n ữ	m a n ữ
b u ồ i	b u ồ i
d i ệ u	r i ệ u
t i ệ c	t i ệ c
b ư ơ i	b ư ơ i
đ i ể n	đ i ể n
c o r o	c o r o
l ò x o	l ò x o
c ỏ g à	c ỏ g à
l ư ợ c	l ư ợ c
m ư ợ n	m ư ợ n
s ơ r i	s ơ r i
x ù x ì	x ù x ì
x e l u	x e l u
c ụ c	c ụ c
l ê ô	l ê ô
v ọ c	v ọ c
m ì ý	m ì ý
b ậ t	b ậ t
đ ị t	đ ị t
đ ậ p	đ ậ p
m ộ c	m ộ c
n ọ c	n ọ c
đ ụ n	đ ụ n
e d è	e d è
ủ s u	ủ s u
b ố c	b ố c
p i ô	p i ô
l ộ c	l ộ c
b ó c	b ó c
b ậ n	b ậ n
đ ự c	đ ự c
b ụ t	b ụ t
b ệ t	b ệ t
o ặ t	o ặ t
đ ạ o	đ ạ o
b ụ i	b ụ i
b ậ y	b ậ y
đ ộ i	đ ộ i
b ị p	b ị p
e u	e u
t v	t v
b ạ c	b ạ c
s ụ c	s ụ c
đ ạ p	đ ạ p
đ ọ t	đ ọ t
đ ợ i	đ ợ i
đ ộ n	đ ộ n
đ ẹ t	đ ẹ t
đ ậ m	đ ậ m
ủ r ũ	ủ r ũ
b ụ m	b ụ m
d ọ c	d ọ c
y t ế	y t ế
b ạ t	b ạ t
b ậ u	b ậ u
o x i	o x i
r ụ c	d ụ c
đ ụ t	đ ụ t
đ ọ i	đ ọ i
b ạ o	b ạ o
đ ạ n	đ ạ n
b ự a	b ự a
c u ộ n	c u ộ n
l i ệ u	l i ệ u
c h ọ c	t r ọ c
b u ô n	b u ô n
t ạ n h	t ạ n h
đ u ô i	đ u ô i
c á m ú	c á m ú
l o ạ n	l o ạ n
t à t à	t à t à
n h ã ý	n h ã ý
v ô t ỉ	v ô t ỉ
s ơ h ở	s ơ h ở
q u ẹ t	q u ẹ t
m u ộ n	m u ộ n
x à c ừ	x à c ừ
đ ị n h	đ ị n h
g ư ợ m	g ư ợ m
v õ s ĩ	v õ s ĩ
s ư h ổ	s ư h ổ
b á n h	b á n h
đ i ê u	đ i ê u
b i ê n	b i ê n
h i ệ n	h i ệ n
c ô v y	c ô v y
s a p a	s a p a
đ ệ m	đ ệ m
b ị t	b ị t
m ụ c	m ụ c
t ụ c	t ụ c
đ ậ u	đ ậ u
đ ệ t	đ ệ t
đ ộ t	đ ộ t
h ọ c	h ọ c
l ụ c	l ụ c
đ ố c	đ ố c
v ô ý	v ô ý
đ ặ t	đ ặ t
t u y ế n	t u y ế n
g ộ c	g ộ c
đ ợ t	đ ợ t
đ ạ c	đ ạ c
y s ĩ	y s ĩ
đ ạ m	đ ạ m
d ộ c	d ộ c
d ụ c	d ụ c
b ự c	b ự c
b ị a	b ị a
đ ạ t	đ ạ t
đ ậ y	đ ậ y
c h u r u	c h u r u
g i ê s u	r ê s u
c à p h ê	c à p h ê
l í n h í	l í n h í
m ĩ t h o	m ĩ t h o
n h ỏ t o	n h ỏ t o
c h ệ c h	c h ệ c h
n g ư ợ c	n g ư ợ c
v ô g i á	v ô g i á
c h í s ĩ	c h í s ĩ
t r i ệ t	t r i ệ t
g i á c ả	g i á c ả
c h ữ s ố	c h ữ s ố
s ư ợ n g	s ư ợ n g
c h u ộ t	c h u ộ t
t u y ế t	t u y ế t
n h u ộ m	n h u ộ m
c ơ t h ủ	c ơ t h ủ
t r ư ợ t	t r ư ợ t
c h ữ k í	c h ữ k í
n g o ặ t	n g o ặ t
t r i ệ u	c h i ệ u
q u à n h	q u à n h
n g o ạ m	n g o ạ m
ý n g h ĩ	ý n g h ĩ
x i n h ê	x i n h ê
n a t r i	n a t r i
n h à t ù	n h à t ù
c h ó m á	c h ó m á
v ì t h ế	v ì t h ế
c a t r ù	c a t r ù
t r ọ n g	t r ọ n g
n g u ộ i	n g u ộ i
d u y ê n	d u y ê n
đ ư ơ n g	đ ư ơ n g
t ứ p h ủ	t ứ p h ủ
t h u ộ c	t h u ộ c
b ư ớ n g	b ư ớ n g
t ỉ g i á	t ỉ g i á
p h ư ợ t	p h ư ợ t
t ỉ p h ú	t ỉ p h ú
t h ì l à	t h ì l à
n h i ệ t	n h i ệ t
b i ế n g	b i ế n g
k h ơ m ú	k h ơ m ú
c ử t r i	c ử t r i
t h ơ c a	t h ơ c a
t h ổ t ả	t h ổ t ả
p h a l ê	p h a l ê
x u y ê n	x u y ê n
q u y ế n	q u y ế n
t r ụ n g	t r ụ n g
t h í m ồ	t h í m ồ
p h ê r ô	p h ê r ô
b u ô n g	b u ô n g
q u á c h	q u á c h
v ũ p h u	v ũ p h u
t h ô l ỗ	t h ô l ỗ
b u ồ n g	b u ồ n g
c á t r a	c á t r a
g i ọ n g	d ọ n g
l u y ế n	l u y ế n
q u a n h	q u a n h
c ơ c h ế	c ơ c h ế
p h á v ỡ	p h á v ỡ
x u y ế n	x u y ế n
p h i l ê	p h i l ê
n h ộ n g	n h ộ n g
n h a s ĩ	n h a s ĩ
n g o ạ i	n g o ạ i
p h ú s ĩ	p h ú s ĩ
t r i ệ n	t r i ệ n
l è p h è	l è p h è
q u ạ u	q u ạ u
n h ỏ l ẻ	n h ỏ l ẻ
c h ạ n h	c h ạ n h
k h í t ê	k h í t ê
t r í t ử	t r í t ử
k ẻ t h ù	k ẻ t h ù
c ả n h à	c ả n h à
l i ệ n g	l i ệ n g
đ ư ờ n g	đ ư ờ n g
c h u v i	c h u v i
k h ổ s ở	k h ổ s ở
n h ừ t ử	n h ừ t ử
g i u ộ c	r u ộ c
l ì x ì	l ì x ì
v ô n g ã	v ô n g ã
t h ạ c h	t h ạ c h
q u y ể n	q u y ể n
c ó t h ể	c ó t h ể
c h u ộ c	c h u ộ c
t h ứ t ư	t h ứ t ư
p h ù d u	p h ù d u
n h à s ư	n h à s ư
t h i ệ t	t h i ệ t
đ u ô n g	đ u ô n g
t h i ệ n	t h i ệ n
c ạ n h	c ạ n h
l ạ n h	l ạ n h
h ổ s ư	h ổ s ư
b u ổ i	b u ổ i
c u l i	c u l i
d ư ợ c	d ư ợ c
s a k ê	s a k ê
đ i ê n	đ i ê n
b u ồ n	b u ồ n
g a t ô	g a t ô
c ư ợ c	c ư ợ c
m a c ô	m a c ô
m ạ n h	m ạ n h
q u ậ n	q u ậ n
b i ể n	b i ể n
đ i ế c	đ i ế c
đ i ể m	đ i ể m
s ư c ô	s ư c ô
c ổ h ủ	c ổ h ủ
k i ệ n	k i ệ n
đ o à n	đ o à n
d ộ n g	r ộ n g
đ ù n g	đ ù n g
l ô l ô	l ô l ô
m ạ c h	m ạ c h
d ụ n g	r ụ n g
m a g i e	m a g i e
c á m è	c á m è
đ ặ n g	đ ặ n g
g a l i	g a l i
h ạ n h	h ạ n h
h i ệ p	h i ệ p
m ổ c ò	m ổ c ò
c ơ t u	c ơ t u
c á r ô	c á r ô
đ á n h	đ á n h
q u ậ t	q u ậ t
v ư ợ n g	v ư ợ n g
đ ị c h	đ ị c h
r ư ợ u	r i ệ u
d i ệ p	d i ệ p
r ư ợ t	r ư ợ t
đ o n g	đ o n g
b ị n h	b ị n h
l ờ m ờ	l ờ m ờ
đ ồ n g	đ ồ n g
đ ư ớ c	đ ư ớ c
m ọ n g	m ọ n g
b ồ n g	b ồ n g
n ọ n g	n ọ n g
x ì t ố	x ì t ố
b o n g	b o n g
s a d i	s a d i
l ạ c h	l ạ c h
đ ú n g	đ ú n g
b a n h	b a n h
r ụ n g	r ụ n g
x ứ s ở	x ứ s ở
c ụ n g	c ụ n g
t ò m ò	t ò m ò
v i ệ t	v i ệ t
đ o á n	đ o á n
b i ề n	b i ề n
t h ọ c	t h ọ c
c h ú ý	c h ú ý
d ư ợ t	r ư ợ t
v ô c ơ	v ô c ơ
v ĩ m ô	v ĩ m ô
c a v e	c a v e
m ã s ố	m ã s ố
v a n i	v a n i
đ ó n g	đ ó n g
l u ộ c	l u ộ c
v ư ợ n	v ư ợ n
t e l u	t e l u
đ i ề n	đ i ề n
đ ô n g	đ ô n g
b ỏ n g	b ỏ n g
t i ệ n	t i ệ n
b á c h	b á c h
đ i ế m	đ i ế m
h ủ n ữ	h ủ n ữ
l u c a	l u c a
b à n h	b à n h
b ư ơ u	b i ê u
l ư ợ n	l ư ợ n
s ư t ử	s ư t ử
b i ế n	b i ế n
h i ệ u	h i ệ u
l u ậ t	l u ậ t
q u ạ c	q u ạ c
g a t o	g a t o
n i ệ t	n i ệ t
k i ệ u	k i ệ u
đ ũ n g	đ ũ n g
đ i ề u	đ i ề u
r ô n g	r ô n g
b ứ n g	b ứ n g
c ả n h	c ả n h
n h ạ c	n h ạ c
x u ô i	x u ô i
c h ạ m	c h ạ m
t u n g	t u n g
x a n h	x a n h
n g ợ i	n g ợ i
m á c h	m á c h
t á n h	t á n h
s u ấ t	x u ấ t
g i ế t	r i ế t
x o ắ n	x o ắ n
l i ế m	l i ế m
c h ậ t	t r ậ t
k h ổ n g	k h ổ n g
t r i ề n	t r i ề n
h o ả n g	h o ả n g
l ư ờ n g	l ư ờ n g
p h i ề n	p h i ề n
k h u ấ y	k h u ấ y
c h ậ c	t r ậ c
h i ê n	h i ê n
t r ọ i	t r ọ i
b à n g	b à n g
q u ẩ y	q u ẩ y
r á c h	r á c h
n g ố c	n g ố c
t á c h	t á c h
m ư ớ n	m ư ớ n
n h ậ p	n h ậ p
n u ô i	n u ô i
t r ệ t	t r ệ t
n g u ỵ	n g u ỵ
c h ự c	t r ự c
c h ạ o	c h ạ o
t ố n g	t ố n g
q u ả y	q u ả y
t u ô n	t u ô n
s ô n g	x ô n g
s à n h	s à n h
l u ố c	l u ố c
x u ý t	x u ý t
p h i ế n	p h i ế n
c h i ế c	c h i ế c
v ư ơ n g	v ư ơ n g
c ư ờ n g	c ư ờ n g
c h u ồ n	c h u ồ n
p h i ế m	p h i ế m
k h o a n	k h o a n
r i ê n g	r i ê n g
t h ô n g	t h ô n g
k h o ằ m	k h o ằ m
h o à n g	h o à n g
n g u ô i	n g u ô i
k h o a i	k h o a i
k h o á n	k h o á n
h u y n h	h u y n h
n g à n h	n g à n h
h ư ớ n g	h ư ớ n g
k i ể n g	k i ể n g
k h o á i	k h o á i
c h ó n g	t r ó n g
n g u ồ n	n g u ồ n
t h u ố c	t h u ố c
n g o ắ t	n g o ắ t
n h a n h	n h a n h
k h ể n h	k h ể n h
g i à n h	r à n h
c h u ố c	c h u ố c
n g ư ơ i	n g ư ơ i
t ư ở n g	t ư ở n g
t h á n h	t h á n h
k h u ấ t	k h u ấ t
k h á n h	k h á n h
t r ò n g	t r ò n g
t i ế n g	t i ế n g
r ư ơ n g	d ư ơ n g
t h á c h	t h á c h
t r i ế t	t r i ế t
s ư ớ n g	x ư ớ n g
g i ố n g	r ố n g
c h á n h	t r á n h
t h ù n g	t h ù n g
p h ó n g	p h ó n g
l u ố n g	l u ố n g
l u ồ n g	l u ồ n g
t r a n h	t r a n h
n h ọ n	n h ọ n
n ạ n g	n ạ n g
d u ỗ i	r u ỗ i
h u ý t	h u ý t
c à n h	c à n h
b ư n g	b ư n g
m u ố n	m u ố n
g ặ n g	g ặ n g
m i ế u	m i ế u
t r ộ n	t r ộ n
h o à n	h o à n
c h ợ t	c h ợ t
đ ằ n g	đ ằ n g
h o e n	h o e n
c ư ỡ i	c ư ỡ i
r u ố c	r u ố c
v ư ơ n	v ư ơ n
c ó n g	c ó n g
t i ế c	t i ế c
v o ọ c	v o ọ c
c h ộ t	c h ộ t
l ư ớ i	l ư ớ i
đ í c h	đ í c h
k ế c h	k ế c h
r i ế t	r i ế t
b í n h	b í n h
m ư ơ i	m ư ơ i
c h ậ m	t r ậ m
d ự n g	d ự n g
s ù n g	s ù n g
c h ặ c	c h ặ c
g i ậ n	r ậ n
h i ể m	h i ể m
t r ộ m	t r ộ m
x u n g	x u n g
h ù n g	h ù n g
n a n h	n a n h
t r ợ n	t r ợ n
u ổ n g	u ổ n g
c h ọ i	t r ọ i
t r ó c	t r ó c
v ê n h	v ê n h
c ư ờ i	c ư ờ i
t r ậ n	t r ậ n
c o n g	c o n g
k i ê m	k i ê m
t ạ n g	t ạ n g
l ư ờ n	l ư ờ n
c h ú c	t r ú c
đ i n h	đ i n h
t i ê m	t i ê m
t o é t	t o é t
t a n h	t a n h
s u n g	x u n g
b i n h	b i n h
k i ê u	k i ê u
q u ấ y	q u ấ y
k i ề m	k i ề m
đ ỉ n h	đ ỉ n h
t h ậ t	t h ậ t
n g ậ y	n g ậ y
t u ý p	t u ý p
m ư ớ p	m ư ớ p
d ô n g	r ô n g
v ũ n g	v ũ n g
d i ê m	d i ê m
h ị c h	h ị c h
b ă n g	b ă n g
m ò n g	m ò n g
k i ế m	k i ế m
l ị c h	l ị c h
c õ n g	c õ n g
b ừ n g	b ừ n g
c á c h	c á c h
m i ễ n	m i ễ n
k i ế n	k i ế n
v ể n h	v ể n h
q u ố c	q u ố c
k h ự a	k h ự a
n á c h	n á c h
q u a n	q u a n
h ồ n g	h ồ n g
k ê n h	k ê n h
c h ặ t	c h ặ t
k h ó c	k h ó c
n ự n g	n ự n g
s u ố t	s u ố t
r o n g	r o n g
t i ê n	t i ê n
n g ạ i	n g ạ i
n h ỏ n g	n h ỏ n g
l ư ơ n g	l ư ơ n g
l o ã n g	l o ã n g
c h ồ n g	t r ồ n g
t h ủ n g	t h ủ n g
t h i ế c	t h i ế c
c h ư ớ c	c h ư ớ c
n h o ẻ n	n h o ẻ n
n h i ễ m	n h i ễ m
q u ả n g	q u ả n g
t h i ế u	t h i ế u
x i ề n g	x i ề n g
c h ặ n g	c h ặ n g
t h i ề n	t h i ề n
n g ư ớ c	n g ư ớ c
h ư ơ n g	h ư ơ n g
r i ề n g	r i ề n g
t r á c h	t r á c h
k h o e o	k h o e o
d ư ỡ n g	d ư ỡ n g
c h ị c h	c h ị c h
t r o n g	t r o n g
g h i ề n	g h i ề n
k h ả n h	k h ả n h
c h i ế n	c h i ế n
p h ồ n g	p h ồ n g
m i ể n g	m i ể n g
q u a n g	q u a n g
n g o ắ c	n g o ắ c
n g ư ờ i	n g ư ờ i
h ư ờ n g	h ư ờ n g
c h i ê u	c h i ê u
k h o á c	k h o á c
p h ị c h	p h ị c h
p h ỏ n g	p h ỏ n g
c ư ỡ n g	c ư ỡ n g
n h u n g	n h u n g
k h ô n g	k h ô n g
n g o a n	n g o a n
n g h ẹ n	n g h ẹ n
t o a n g	t o a n g
l o a n g	l o a n g
n h ế c h	n h ế c h
n i ễ n g	n i ễ n g
t r ạ n g	t r ạ n g
n h o á n g	n h o á n g
k h i ê n g	k h i ê n g
t r u ô n g	t r u ô n g
t h ư ơ n g	t h ư ơ n g
k h o a n g	k h o a n g
n h ư ờ n g	n h ư ờ n g
n g ư ỡ n g	n g ư ỡ n g
n g h ê n h	n g h ê n h
k h o ả n g	k h o ả n g
t r ư ơ n g	t r ư ơ n g
t r u ồ n g	t r u ồ n g
t h ư ờ n g	t h ư ờ n g
t r ư ở n g	t r ư ở n g
n g h i ê n	n g h i ê n
t r ư ờ n g	t r ư ờ n g
p h ư ờ n g	p h ư ờ n g
g i ư ơ n g	d ư ơ n g
c h u ồ n g	t r u ồ n g
t h o ả n g	t h o ả n g
p h ư ơ n g	p h ư ơ n g
g i ư ờ n g	r ư ờ n g
n g h i ê n g	n g h i ê n g
x ô n g	x ô n g
k h ự n g	k h ự n g
p h ò n g	p h ò n g
x u ồ n g	x u ồ n g
n g o á y	n g o á y
r ư ờ n g	r ư ờ n g
n g o á i	n g o á i
k i ê n g	k i ê n g
c h i ê m	c h i ê m
t h u ô n	t h u ô n
n g ô n g	n g ô n g
h u ỳ n h	h u ỳ n h
t r ồ n g	t r ồ n g
t r ư ớ c	c h ư ớ c
k i ế n g	k i ế n g
c h u ẩ n	c h u ẩ n
t r ị n h	t r ị n h
c h ư ơ n g	t r ư ơ n g
t h o á n g	t h o á n g
k h o á n g	k h o á n g
n g h i ế n	n g h i ế n
t h u ổ n g	t h u ổ n g
n g h i ê m	n g h i ê m
g u ồ n g	g u ồ n g
t h ố n g	t h ố n g
t r ũ n g	t r ũ n g
t r ô n g	t r ô n g
c h ê n h	c h ê n h
h u ố n g	h u ố n g
c h ố n g	t r ố n g
k h á c h	k h á c h
t h i ế p	t h i ế p
t ư ơ n g	t ư ơ n g
t h u ầ n	t h u ầ n
q u ă n g	q u ă n g
t h a n h	t h a n h
n g h ẹ t	n g h ẹ t
g i ê n g	r i ê n g
n ư ớ n g	n ư ớ n g
n g á c h	n g á c h
c ư ơ n g	c ư ơ n g
g i o a n	g i o a n
t h i ế n	t h i ế n
c h i ê n	c h i ê n
q u à n g	q u à n g
t r u n g	t r u n g
h o a n g	h o a n g
h ư ở n g	h ư ở n g
c h i ế p	c h i ế p
c h i ề u	c h i ề u
t r ỏ n g	t r ỏ n g
c h ả n h	c h ả n h
n h á n h	n h á n h
t r ố n g	t r ố n g
m u ố n g	m u ố n g
t r ú n g	t r ú n g
n g o à i	n g o à i
t o á n g	t o á n g
n h ư ớ n	n h ư ớ n
d ư ờ n g	r ư ờ n g
n h i ễ u	n h i ễ u
x ư ớ n g	x ư ớ n g
p h i ê n	p h i ê n
t h u n g	t h u n g
t ư ờ n g	t ư ờ n g
t h o ả i	t h o ả i
g ư ơ n g	g ư ơ n g
t h à n h	t h à n h
c h ủ n g	c h ủ n g
c h u n g	t r u n g
n g o ả y	n g o ả y
p h á c h	p h á c h
k h u y a	k h u y a
t ư ớ n g	t ư ớ n g
g i ô n g	r ô n g
t r ư ờ n	t r ư ờ n
k h i ế n	k h i ế n
k h o á t	k h o á t
n h á c h	n h á c h
c h i ề n	t r i ề n
x o a n g	x o a n g
n h i ề u	n h i ề u
c u ồ n g	c u ồ n g
n h ô n g	n h ô n g
t h ú n g	t h ú n g
x ư ở n g	x ư ở n g
q u ý n h	q u ý n h
g i ồ n g	r ồ n g
t u ồ n g	t u ồ n g
c h ú n g	t r ú n g
t r á n h	t r á n h
p h ù n g	p h ù n g
n h u ố m	n h u ố m
t r u ấ t	t r u ấ t
t h ò n g	t h ò n g
n g h ẹ o	n g h ẹ o
g i ề n g	r i ề n g
c h u ỗ i	c h u ỗ i
v ư ớ n g	v ư ớ n g
k h i ê n	k h i ê n
n g ó n g	n g ó n g
c h ạ n g	t r ạ n g
c h ô n g	t r ô n g
n g h ị t	n g h ị t
t h ị c h	t h ị c h
k h o ả n	k h o ả n
v i ế n g	v i ế n g
t h ư ớ c	t h ư ớ c
q u ã n g	q u ã n g
m ư ơ n g	m ư ơ n g
p h ư ớ c	p h ư ớ c
m u ô n g	m u ô n g
k ị p	k ị p
g ạ o	g ạ o
o a i	o a i
b ú p	b ú p
g ợ n	g ợ n
b ầ m	b ầ m
c ự u	c ự u
x ú c	s ú c
b ó t	b ó t
b á t	b á t
l ậ n	l ậ n
b ó n	b ó n
đ à y	đ à y
b ỉ m	b ỉ m
t ó c	t ó c
l ự c	l ự c
l ự a	l ự a
đ ể u	đ ể u
s ạ n	s ạ n
b ĩ u	b ĩ u
đ ẩ u	đ ẩ u
r ợ p	r ợ p
đ ố n	đ ố n
v ị n	v ị n
m ạ t	m ạ t
l ụ t	l ụ t
t ợ p	t ợ p
đ ầ u	đ ầ u
ư ơ n	ư ơ n
m ặ c	m ặ c
m ị t	m ị t
r ọ i	r ọ i
đ ă m	đ ă m
l ạ y	l ạ y
đ ẩ y	đ ẩ y
l ố c	l ố c
đ ũ y	đ ũ y
b ử a	b ử a
s ạ c	s ạ c
k ẹ t	k ẹ t
b á c	b á c
b ồ n	b ồ n
l ụ m	l ụ m
b à y	b à y
đ í a	đ í a
b ẩ y	b ẩ y
g ặ m	g ặ m
s ẹ o	s ẹ o
b ế n	b ế n
v ẹ m	v ẹ m
b ừ a	b ừ a
m ặ t	m ặ t
b á u	b á u
t ẹ o	t ẹ o
đ ĩ a	đ ĩ a
b ầ n	b ầ n
m ậ t	m ậ t
đ ó i	đ ó i
đ á m	đ á m
n ạ t	n ạ t
b ờ m	b ờ m
g ố c	g ố c
m ự c	m ự c
r ạ c	r ạ c
b à o	b à o
l ộ i	l ộ i
v ộ i	v ộ i
o ả i	o ả i
t ậ p	t ậ p
đ à m	đ à m
đ ư a	đ ư a
ễ n h	ễ n h
g ạ c	g ạ c
đ à o	đ à o
l ạ t	l ạ t
b ả o	b ả o
b i t	b i t
n ậ y	n ậ y
đ ắ t	đ ắ t
b è n	b è n
r ự a	r ự a
y ể u	y ể u
ố n g	ố n g
l ộ n	l ộ n
v ị t	v ị t
t ậ t	t ậ t
h o ạ	h o ạ
ị c h	ị c h
m ụ t	m ụ t
b ề n	b ề n
l ộ t	l ộ t
h ụ p	h ụ p
m ị n	m ị n
v ậ n	v ậ n
c ọ p	c ọ p
h ợ m	h ợ m
ư ớ p	ư ớ p
c ạ o	c ạ o
b ầ y	b ầ y
s ụ p	s ụ p
t ụ i	t ụ i
b í u	b í u
á c h	á c h
đ è o	đ è o
x ị t	x ị t
á n h	á n h
đ ố i	đ ố i
l ạ c	l ạ c
m ạ o	m ạ o
đ e n	đ e n
b á n	b á n
đ á i	đ á i
n ệ n	n ệ n
t ụ m	t ụ m
m ọ n	m ọ n
h ọ p	h ọ p
đ ớ i	đ ớ i
đ e o	đ e o
b ẩ n	b ẩ n
h ộ i	h ộ i
đ ò i	đ ò i
o n g	o n g
đ ẫ m	đ ẫ m
y ế n	y ế n
đ a m	đ a m
v ậ t	v ậ t
b ế t	b ế t
v ọ t	v ọ t
m ú c	m ú c
b ả y	b ả y
l ợ p	l ợ p
r ệ p	r ệ p
d ậ u	d ậ u
đ ế m	đ ế m
n ạ m	n ạ m
b ù i	b ù i
đ u a	đ u a
c ự c	c ự c
r ự c	r ự c
t ự a	t ự a
đ ờ i	đ ờ i
đ ỉ a	đ ỉ a
l ó c	l ó c
b ắ p	b ắ p
v ạ t	v ạ t
g ợ i	g ợ i
s ự c	s ự c
đ á t	đ á t
d ộ t	r ộ t
y ể m	y ể m
đ â m	đ â m
c ặ p	c ặ p
đ ằ m	đ ằ m
đ a y	đ a y
b é n	b é n
k ẹ p	k ẹ p
n ạ n	n ạ n
đ à n	đ à n
b ớ t	b ớ t
l ự u	l ự u
c ụ t	c ụ t
m ạ n	m ạ n
đ ê m	đ ê m
m ậ n	m ậ n
d ẹ p	d ẹ p
d ó c	d ó c
d ậ p	r ậ p
đ ã i	đ ã i
h ạ p	h ạ p
h ố c	h ố c
t ạ c	t ạ c
đ a u	đ a u
đ ầ m	đ ầ m
c ộ t	c ộ t
h ạ t	h ạ t
đ è n	đ è n
h ạ o	h ạ o
đ ó n	đ ó n
đ ấ u	đ ấ u
h ợ p	h ợ p
b ơ m	b ơ m
ổ n g	ổ n g
l ợ n	l ợ n
b o a	b o a
b ẩ m	b ẩ m
b a n	b a n
h ộ p	h ộ p
b ấ t	b ấ t
r ạ p	r ạ p
t ố c	t ố c
đ ỏ m	đ ỏ m
đ ơ n	đ ơ n
t ạ i	t ạ i
đ ú t	đ ú t
u ố n	u ố n
b ã i	b ã i
ề n h	ề n h
b ô i	b ô i
d ị u	d ị u
t ậ n	t ậ n
g ộ i	g ộ i
x ị n	x ị n
b ư u	b ư u
d ậ y	d ậ y
b ã o	b ã o
t ạ o	t ạ o
r ậ n	r ậ n
y ê u	y ê u
v ệ t	v ệ t
l ặ n	l ặ n
m ậ u	m ậ u
d ị p	d ị p
b ồ i	b ồ i
s ụ t	s ụ t
b ù a	b ù a
b ò n	b ò n
v ợ t	v ợ t
y ê n	y ê n
đ ắ m	đ ắ m
g ậ y	g ậ y
b ê u	b ê u
đ ì a	đ ì a
r ộ n	r ộ n
l ặ p	l ặ p
b ứ c	b ứ c
l ọ t	l ọ t
m ọ t	m ọ t
b ổ n	b ổ n
đ á p	đ á p
b ứ a	b ứ a
đ ắ p	đ ắ p
đ ò m	đ ò m
h ạ m	h ạ m
h ậ n	h ậ n
b ệ	b ệ
ú n g	ú n g
b ấ y	b ấ y
r ợ n	r ợ n
b ế p	b ế p
b ố t	b ố t
b ô m	b ô m
b a y	b a y
đ ộ	đ ộ
đ ụ	đ ụ
b ẹ	b ẹ
ị n	ị n
n ạ o	n ạ o
ó c	ó c
ộ p	ộ p
ự c	ự c
b ạ	b ạ
b ị	b ị
ọ e	ọ e
ậ p	ậ p
b ự	b ự
b ộ	b ộ
đ ệ	đ ệ
đ ớ p	đ ớ p
n ị t	n ị t
đ ỗ i	đ ỗ i
đ o á	đ o á
q u ỵ	q u ỵ
b ớ i	b ớ i
đ ố t	đ ố t
b á o	b á o
c ạ p	c ạ p
đ á y	đ á y
c ạ y	c ạ y
b í m	b í m
n ộ m	n ộ m
t ọ p	t ọ p
g ạ t	g ạ t
c ậ u	c ậ u
c ó c	c ó c
b ố p	b ố p
l ậ p	l ậ p
đ ồ i	đ ồ i
v ó c	v ó c
b ú a	b ú a
l ậ u	l ậ u
đ ờ m	đ ờ m
c ụ p	c ụ p
b ă m	b ă m
d ặ n	r ặ n
g ậ p	g ậ p
h ó c	h ó c
s ạ t	s ạ t
n ự c	n ự c
v ạ n	v ạ n
b é o	b é o
c ộ m	c ộ m
n ệ m	n ệ m
s ậ p	s ậ p
đ í t	đ í t
b i a	b i a
v ạ c	v ạ c
h ạ n	h ạ n
đ ả o	đ ả o
r ặ n	r ặ n
g ó c	g ó c
u n g	u n g
s ọ t	s ọ t
r ụ t	r ụ t
k ẹ c	k ẹ c
đ à i	đ à i
d ạ y	d ạ y
m ụ n	m ụ n
b í p	b í p
đ ú p	đ ú p
g ặ t	g ặ t
đ ù m	đ ù m
n ạ y	n ạ y
u ô n	u ô n
g ặ p	g ặ p
c ộ i	c ộ i
b ơ i	b ơ i
b ắ c	b ắ c
n ạ p	n ạ p
b a o	b a o
g ọ i	g ọ i
b ê n	b ê n
h ẹ p	h ẹ p
đ ề n	đ ề n
đ á n	đ á n
s ặ c	s ặ c
t ạ t	t ạ t
c ặ c	c ặ c
t ậ u	t ậ u
n ộ i	n ộ i
b o m	b o m
h ộ t	h ộ t
x ạ o	x ạ o
đ ù i	đ ù i
g ọ n	g ọ n
đ ẽ o	đ ẽ o
b à u	b à u
b ữ a	b ữ a
l ợ i	l ợ i
b ớ p	b ớ p
v ự a	v ự a
h ú c	h ú c
n ố c	n ố c
b ó p	b ó p
l ặ t	l ặ t
b ổ i	b ổ i
đ u n	đ u n
đ a o	đ a o
đ â y	đ â y
ế c h	ế c h
đ ố m	đ ố m
ó n g	ó n g
c ặ n	c ặ n
b o n	b o n
l ụ a	l ụ a
b ỡ n	b ỡ n
ả n h	ả n h
x ố c	x ố c
b ù m	b ù m
h ạ c	h ạ c
l ú c	l ú c
t u ỵ	t u ỵ
d ọ n	r ọ n
c u ố i	c u ố i
đ ầ n	đ ầ n
đ ờ n	đ ờ n
s ó c	s ó c
h ẹ n	h ẹ n
x ẹ p	x ẹ p
t ụ t	t ụ t
đ ế n	đ ế n
l ạ i	l ạ i
d ệ t	r ệ t
g ộ p	g ộ p
s ư ờ n	s ư ờ n
d u n g	r u n g
t h ẹ o	t h ẹ o
t i ê u	t i ê u
t i ễ n	t i ễ n
t i ề u	t i ề u
t h ọ t	t h ọ t
p h ậ t	p h ậ t
n g ụ p	n g ụ p
l u n g	l u n g
s ổ n g	s ổ n g
x o à n	x o à n
m ố n g	m ố n g
k i ê n	k i ê n
h ỏ n g	h ỏ n g
b á n g	b á n g
k i ể m	k i ể m
q u ý u	q u ý u
m i ề n	m i ề n
c h ặ n	c h ặ n
q u ê n	q u ê n
n h u ỵ	n h u ỵ
d i ề u	r i ề u
n ị n h	n ị n h
x o ă n	x o ă n
o ẳ n g	o ẳ n g
c h ụ t	c h ụ t
h à n h	h à n h
m u ố i	m u ố i
l i ế c	l i ế c
p h ậ n	p h ậ n
p h ụ t	p h ụ t
g h ệ t	g h ệ t
r ố n g	r ố n g
m ả n h	m ả n h
r ặ n g	r ặ n g
n ô n g	n ô n g
t o á t	t o á t
c a n h	c a n h
g i ế m	d i ế m
k i ế u	k i ế u
c u ố c	q u ố c
x o à i	x o à i
n h ệ n	n h ệ n
x ư ớ c	x ư ớ c
l ồ n g	l ồ n g
đ ứ n g	đ ứ n g
m ư ớ t	m ư ớ t
h o à i	h o à i
s ó n g	s ó n g
t r ố c	t r ố c
s ũ n g	s ũ n g
n g ọ t	n g ọ t
v o a n	v o a n
g i ộ i	d ộ i
t ư ớ i	t ư ớ i
n i ề m	n i ề m
t ế c h	t ế c h
s á n h	s á n h
q u ả n	q u ả n
t r ạ i	c h ạ i
q u à o	q u à o
l õ n g	l õ n g
s i ê u	s i ê u
q u ă n	q u ă n
l i ê n	l i ê n
m ô n g	m ô n g
x ế c h	x ế c h
b ả n g	b ả n g
l i ề n	l i ề n
g i ặ c	r ặ c
t r ạ m	c h ạ m
s o ọ c	s o ọ c
n g ó c	n g ó c
t o à n	t o à n
c á n h	c á n h
g i ậ u	d ậ u
t h ó c	t h ó c
l ò n g	l ò n g
l ư ơ n	l ư ơ n
t r ộ i	t r ộ i
h i ề n	h i ề n
s o á t	s o á t
h ế c h	h ế c h
n i ê u	n i ê u
c ũ n g	c ũ n g
c h ụ m	c h ụ m
k h ạ c	k h ạ c
t h ị t	t h ị t
m a n h	m a n h
g i ễ u	d i ễ u
c ù n g	c ù n g
h o ắ c	h o ắ c
t ư ờ u	t i ề u
x i ê u	s i ê u
g ư ơ m	g ư ơ m
q u ầ n	q u ầ n
s ư ở i	s ư ở i
t h ẹ n	t h ẹ n
c h ợ p	c h ợ p
r ồ n g	r ồ n g
q u ý t	q u ý t
c ư ớ i	c ư ớ i
h i ể n	h i ể n
s ú n g	s ú n g
g u ố c	g u ố c
q u ấ n	q u ấ n
x i ế c	x i ế c
l à n h	l à n h
q u e n	q u e n
n h ạ n	n h ạ n
t ư ơ i	t ư ơ i
n h ị n	n h ị n
g i ậ p	r ậ p
t r ặ c	c h ặ c
l ó n g	l ó n g
đ ả n g	đ ả n g
c ư ơ i	c ư ơ i
l á n h	l á n h
v u ố t	v u ố t
r i ê u	r i ê u
l ã n h	l ã n h
l ô n g	l ô n g
g i ẹ p	d ẹ p
q u a y	q u a y
m á n h	m á n h
đ à n g	đ à n g
t r ậ t	t r ậ t
r ư ớ m	r ư ớ m
n h ự a	n h ự a
r ả n h	r ả n h
t i ế n	t i ế n
r ế c h	r ế c h
r u n g	r u n g
t h ạ o	t h ạ o
m ạ n g	m ạ n g
m ồ n g	m ồ n g
g i ạ t	r ạ t
c h ậ u	c h ậ u
k ề n h	k ề n h
l ặ n g	l ặ n g
t ị c h	t ị c h
đ ấ n g	đ ấ n g
t h ậ p	t h ậ p
h i ế m	h i ế m
q u á i	q u á i
t h ú c	t h ú c
n g ợ m	n g ợ m
l ư ờ m	l ư ờ m
h ó n g	h ó n g
c h ọ t	t r ọ t
t i ế t	t i ế t
b a n g	b a n g
n g ộ t	n g ộ t
h ò n g	h ò n g
r ư ớ c	r ư ớ c
c h ạ y	c h ạ y
t i ế p	t i ế p
l ư ỡ i	l ư ỡ i
t u ầ n	t u ầ n
r u ồ i	r u ồ i
n o ã n	n o ã n
n g ạ o	n g ạ o
g i ụ i	d ụ i
p h ọ t	p h ọ t
d a n h	d a n h
x o a y	x o a y
g a n h	g a n h
l ù n g	l ù n g
n h ộ n	n h ộ n
n h ặ t	n h ặ t
l u ô n	l u ô n
l i ề m	l i ề m
q u ẫ y	q u ẫ y
c ư ờ m	c ư ờ m
r ạ n	r ạ n
q u a i	q u a i
v ù n g	v ù n g
k h ú c	k h ú c
v i ế t	v i ế t
r ỗ n g	r ỗ n g
h i ể u	h i ể u
m u ô i	m u ô i
t o á n	t o á n
p h ạ m	p h ạ m
c ư ớ c	c ư ớ c
b ì u	b ì u
t h u ỵ	t h u ỵ
m ó c	m ó c
s ố c	x ố c
b ì a	b ì a
m ẹ o	m ẹ o
đ ớ n	đ ớ n
b é t	b é t
s ú c	s ú c
c ậ n	c ậ n
b ằ m	b ằ m
đ ấ y	đ ấ y
q u é t	q u é t
v ặ n	v ặ n
ư ơ i	ư ơ i
u ê n	u ê n
b ú n	b ú n
y ế u	y ế u
b á m	b á m
b ắ n	b ắ n
n ó c	n ó c
m ặ n	m ặ n
d ộ i	d ộ i
n ẹ p	n ẹ p
s a n h	x a n h
n h ậ t	n h ậ t
v u n g	v u n g
đ a n g	đ a n g
n h ậ u	n h ậ u
c h ụ p	c h ụ p
k h ẹ c	k h ẹ c
r ạ n g	r ạ n g
x o n g	x o n g
g ô n g	g ô n g
d o n g	r o n g
u ố n g	u ố n g
đ ấ t	đ ấ t
t u ấ t	t u ấ t
h ư ơ u	h i ê u
n h ậ n	n h ậ n
r ư ở i	r ư ở i
g i ậ m	d ậ m
q u í t	q u ý t
t u ố t	t u ố t
s o n g	x o n g
l ư ớ t	l ư ớ t
m ù n g	m ù n g
t ộ t	t ộ t
o ằ n	o ằ n
v ụ n	v ụ n
b l u	b l u
k ẹ o	k ẹ o
b e o	b e o
v ẹ o	v ẹ o
v ặ t	v ặ t
đ ơ m	đ ơ m
d o ạ	d o ạ
đ ù a	đ ù a
d ạ o	d ạ o
s ậ y	s ậ y
l ậ t	l ậ t
d ẹ t	d ẹ t
d ợ m	r ợ m
c ạ c	c ạ c
n ặ n	n ặ n
b ú i	b ú i
v ậ y	v ậ y
n ặ c	n ặ c
c ạ n	c ạ n
c ậ t	c ậ t
d ạ n	r ạ n
b ầ u	b ầ u
đ ứ c	đ ứ c
h ụ t	h ụ t
n ú c	n ú c
u ấ t	u ấ t
b ù n	b ù n
m ọ i	m ọ i
s ệ t	s ệ t
h ậ u	h ậ u
b ú t	b ú t
b ắ t	b ắ t
n g ụ m	n g ụ m
s ụ n	s ụ n
ư ớ t	ư ớ t
c ố c	c ố c
đ ô i	đ ô i
l ọ n	l ọ n
ư ớ c	ư ớ c
đ ứ a	đ ứ a
d ố c	d ố c
r ậ p	r ậ p
m ậ p	m ậ p
g i ặ t	g i ặ t
d à n h	r à n h
r ò n g	r ò n g
k h ị t	k h ị t
s ê n h	s ê n h
v i ề n	v i ề n
r ư ỡ i	r ư ỡ i
d ư ớ i	d ư ớ i
n ư ớ u	n i ế u
n g ợ p	n g ợ p
n o n g	n o n g
t o n g	t o n g
m u ô n	m u ô n
c ố n g	c ố n g
v ò n g	v ò n g
c ư ớ p	c ư ớ p
m ư ờ i	m ư ờ i
n g ự c	n g ự c
n h ạ y	n h ạ y
l á c h	l á c h
q u á t	q u á t
d u ố i	r u ố i
n ó n g	n ó n g
s ò n g	s ò n g
m u ỗ i	m u ỗ i
h ạ n g	h ạ n g
t i ể u	t i ể u
n g ọ n	n g ọ n
d i ễ n	d i ễ n
t u ấ n	t u ấ n
đ á n g	đ á n g
l o é t	l o é t
s u ố i	s u ố i
q u ấ c	q u ấ c
g i ọ t	r ọ t
đ ắ n g	đ ắ n g
r à n h	r à n h
n h ộ t	n h ộ t
h o ã n	h o ã n
t ổ n g	t ổ n g
t r ọ n	t r ọ n
p h ú c	p h ú c
p a n h	p a n h
m ỏ n g	m ỏ n g
s ố n g	s ố n g
q u ầ y	q u ầ y
l ỏ n g	l ỏ n g
n h ọ t	n h ọ t
k i ế p	k i ế p
b í c h	b í c h
d i ế p	d i ế p
n g ậ m	n g ậ m
l i ễ u	l i ễ u
l o à i	l o à i
c ò n g	c ò n g
n g ạ t	n g ạ t
b ằ n g	b ằ n g
t ê n h	t ê n h
t r ú c	t r ú c
l i ê m	l i ê m
g i ự t	d ự t
c h ố c	t r ố c
c u n g	c u n g
c ồ n g	c ồ n g
d ò n g	r ò n g
s á c h	s á c h
l u ồ n	l u ồ n
đ í n h	đ í n h
q u ắ t	q u ắ t
n h ị p	n h ị p
k ị c h	k ị c h
m i ê n	m i ê n
l o n g	l o n g
c h ộ p	c h ộ p
t r ự c	t r ự c
t r ạ c	t r ạ c
n ồ n g	n ồ n g
t h ụ t	t h ụ t
r ư ớ i	d ư ớ i
l o a n	l o a n
x u ấ t	x u ấ t
h u n g	h u n g
l ạ n g	l ạ n g
l ư ờ i	l ư ờ i
c h ạ p	c h ạ p
l i ề u	l i ề u
g i ậ t	g i ậ t
h u â n	h u â n
v õ n g	v õ n g
g i ọ i	r ọ i
t ô n g	t ô n g
c ú n g	c ú n g
t ư ớ c	t ư ớ c
g i a n g	d a n g
n h ô ô n g	n h ô ô ô n g
t h i n h	t h i n h
k ế t q u ả	k ế t q u ả
d ự t h ả o	d ự t h ả o
ỉ a c h ả y	ỉ a c h ả y
c á n g ự a	c á n g ự a
m à n c ử a	m à n c ử a
x o a y x ở	x o a y x ở
d ị c h t ễ	d ị c h t ễ
n ề n n ế p	n ề n n ế p
h ư h ỏ n g	h ư h ỏ n g
t i ể u t ừ	t i ể u t ừ
t h ờ i v ụ	t h ờ i v ụ
ở k h ô n g	ở k h ô n g
s ở t ạ i	s ở t ạ i
h ợ p l í	h ợ p l í
b ộ n h ớ	b ộ n h ớ
đ a m l a	đ a m l a
m ạ i v ô	m ạ i v ô
c ả m t ạ	c ả m t ạ
x e đ ẩ y	x e đ ẩ y
a n n a m	a n n a m
d ị g i á o	d ị g i á o
x ô v i ế t	x ô v i ế t
n h ẹ t a y	n h ẹ t a y
d u l ị c h	d u l ị c h
s ầ n s ù i	s ầ n s ù i
r a u c â u	r a u c â u
t â m h ồ n	t â m h ồ n
s u y h a o	s u y h a o
t ạ p c h í	t ạ p c h í
c h ơ i á c	c h ơ i á c
t ắ c t ị	t ắ c t ị
v í t i ề n	v í t i ề n
s ắ m s ử a	s ắ m s ử a
t ổ n g s ố	t ổ n g s ố
p h ả n v ệ	p h ả n v ệ
ô n g c h ủ	ô n g c h ủ
b ứ t p h á	b ứ t p h á
t u n g h ô	t u n g h ô
v ô c ù n g	v ô c ù n g
s o s á n h	s o s á n h
a h o à n	a h o à n
t e l e x	t e l e x
c á c ó c	c á c ó c
v ậ t v ờ	v ậ t v ờ
c ơ b ắ p	c ơ b ắ p
h o ạ s ĩ	h o ạ s ĩ
g â y s ự	g â y s ự
k ẹ t x e	k ẹ t x e
v ạ m v ỡ	v ạ m v ỡ
v ồ v ậ p	v ồ v ậ p
e m g á i	e m g á i
d ạ c o n	d ạ c o n
á o m ư a	á o m ư a
t â y h ạ	t â y h ạ
n ị t v ú	n ị t v ú
c á ô n g	c á ô n g
b à y t ỏ	b à y t ỏ
v ũ đ à i	v ũ đ à i
m a l ự c	m a l ự c
t i ể u á	t i ể u á
c á n ó c	c á n ó c
x ế h ộ p	x ế h ộ p
c á s ụ n	c á s ụ n
n ợ n ầ n	n ợ n ầ n
k ì h ạ m	k ì h ạ m
y ế u t ố	y ế u t ố
m ê đ ắ m	m ê đ ắ m
đ i c ầ u	đ i c ầ u
s ặ c s ỡ	s ặ c s ỡ
q u y b a	q u y b a
c à g i ự t	c à d ự t
b ấ t c ứ	b ấ t c ứ
b a o l a	b a o l a
m ạ o t ừ	m ạ o t ừ
ư ớ c m ơ	ư ớ c m ơ
x ô đ ẩ y	x ô đ ẩ y
g ố c r ễ	g ố c r ễ
m ộ t s ố	m ộ t s ố
b à n c ổ	b à n c ổ
t ê d ạ i	t ê d ạ i
h ơ i c a y	h ơ i c a y
h à t i ê n	h à t i ê n
p h á t l ộ	p h á t l ộ
c à n ô n g	c à n ô n g
đ à n ẵ n g	đ à n ẵ n g
đ ầ u t h ú	đ ầ u t h ú
d â u t ằ m	d â u t ằ m
p h á t â m	p h á t â m
q u ế l â m	q u ế l â m
m ẫ n c á n	m ẫ n c á n
k è o n è o	k è o n è o
h ấ p d ẫ n	h ấ p d ẫ n
t ù m l u m	t ù m l u m
d ư a l e o	d ư a l e o
t r ở l ạ i	t r ở l ạ i
t h u ỵ s ĩ	t h u ỵ s ĩ
t à i c á n	t à i c á n
đ á n h á m	đ á n h á m
r ỉ a r ó i	r ỉ a r ó i
n g h ệ a n	n g h ệ a n
đ ố i t h ủ	đ ố i t h ủ
h ổ n h ể n	h ổ n h ể n
t â n h ô n	t â n h ô n
t à u h o ả	t à u h o ả
n i l ô n g	n i l ô n g
l ã o t h ị	l ã o t h ị
h à i h o à	h à i h o à
t ê n l ử a	t ê n l ử a
r â m r a n	d â m r a n
g i ờ h ợ i	g i ờ h ợ i
n ă m m ớ i	n ă m m ớ i
m u a s ắ m	m u a s ắ m
g h ế đ ẩ u	g h ế đ ẩ u
d â u t â y	d â u t â y
t h ế l ự c	t h ế l ự c
s ứ t m ô i	s ứ t m ô i
n g ũ c ố c	n g ũ c ố c
k ế t n ố i	k ế t n ố i
h ả i s â m	h ả i s â m
t ư c á c h	t ư c á c h
n g õ c ụ t	n g õ c ụ t
f r a n x i	f r a n x i
t h ợ m á y	t h ợ m á y
g i ả t ạ o	g i ả t ạ o
n ử a v ờ i	n ử a v ờ i
h i ế u k ì	h i ế u k ì
c ả m ứ n g	c ả m ứ n g
d u y t â m	d u y t â m
g i ò l ụ a	g i ò l ụ a
n h ậ t k ì	n h ậ t k ì
t à u l ử a	t à u l ử a
c á t l â m	c á t l â m
t r ạ m x á	t r ạ m x á
c a o k ề u	c a o k ề u
l a n t a n	l a n t a n
p h ù h ợ p	p h ù h ợ p
t h i đ ấ u	t h i đ ấ u
t a n t ầ m	t a n t ầ m
b ả n n g ã	b ả n n g ã
l u â n l í	l u â n l í
d â y g ắ m	d â y g ắ m
v ắ t s ữ a	v ắ t s ữ a
v ừ a m ắ t	v ừ a m ắ t
n h u y ế u	n h u y ế u
h ẻ m n ú i	h ẻ m n ú i
h ỏ i h a n	h ỏ i h a n
t h ờ i s ự	t h ờ i s ự
h u n g n ô	h u n g n ô
k h ă n ă n	k h ă n ă n
l ờ i h ứ a	l ờ i h ứ a
g ó c t ù	g ó c t ù
v ã n h ồ i	v ã n h ồ i
ă n h à n g	ă n h à n g
m a i h o a	m a i h o a
n í u k é o	n í u k é o
c ơ m t ấ m	c ơ m t ấ m
h o a m ắ t	h o a m ắ t
p h ẫ n n ộ	p h ẫ n n ộ
g i à d ặ n	g i à d ặ n
x e n o n	x e n o n
c ơ b ả n	c ơ b ả n
g ắ n b ó	g ắ n b ó
t ố i d ạ	t ố i d ạ
t ứ đ ứ c	t ứ đ ứ c
b ắ c m ĩ	b ắ c m ĩ
c o b a n	c o b a n
u m s ù m	u m s ù m
l ì l ợ m	l ì l ợ m
m ặ c c ả	m ặ c c ả
l ô h ộ i	l ô h ộ i
v ô t ộ i	v ô t ộ i
l ỗ đ e n	l ỗ đ e n
l ũ ố n g	l ũ ố n g
t ư b ả n	t ư b ả n
đ á q u ý	đ á q u ý
t ự t r ị	t ự t r ị
đ ơ n c ử	đ ơ n c ử
t ụ c ầ u	t ụ c ầ u
l à m ơ n	l à m ơ n
v ợ l ớ n	v ợ l ớ n
đ i v à o	đ i v à o
d ẫ n d ụ	d ẫ n d ụ
ố n g p ô	ố n g p ô
b a t à u	b a t à u
v ê đ ú p	v ê đ ú p
t ế b à o	t ế b à o
e n g ạ i	e n g ạ i
m ẫ u t ự	m ẫ u t ự
đ a t à i	đ a t à i
c ả m ơ n	c ả m ơ n
á y n á y	á y n á y
đ ề t à i	đ ề t à i
á o g ấ m	á o g ấ m
b ế t ắ c	b ế t ắ c
t â m s ự	t â m s ự
x ã h ộ i	x ã h ộ i
d ă m b a	d ă m b a
b ổ í c h	b ổ í c h
b à c o n	b à c o n
ồ n à o	ồ n à o
b à b a	b à b a
m ạ l ị	m ạ l ị
đ ô h ộ	đ ô h ộ
b o b o	b o b o
v ĩ đ ộ	v ĩ đ ộ
á i â n	á i â n
n e o n	n e o n
a g o n	a g o n
c ự đ à	c ự đ à
d ở ẹ c	r ở ẹ c
đ ệ t ử	đ ệ t ử
s ơ b ộ	s ơ b ộ
á r ậ p	á r ậ p
i m ỉ m	i m ỉ m
ớ t đ ỏ	ớ t đ ỏ
b ổ đ ề	b ổ đ ề
ấ m ứ c	ấ m ứ c
i o n	i o n
t p	t h à n h p h ố
b ố m ẹ	b ố m ẹ
đ ố k ị	đ ố k ị
m ẹ đ ẻ	m ẹ đ ẻ
b à đ ỡ	b à đ ỡ
ô m ấ p	ô m ấ p
u ỷ m ị	u ỷ m ị
i n đ i	i n đ i
đ a t ạ	đ a t ạ
ê m á i	ê m á i
y h ệ t	y h ệ t
h i l ạ p	h i l ạ p
n ộ i y	n ộ i y
b é t ị	b é t ị
n ộ i ô	n ộ i ô
b ỏ b ê	b ỏ b ê
b à ấ y	b à ấ y
d ự á n	d ự á n
đ ồ ă n	đ ồ ă n
â m h ộ	â m h ộ
n h ẹ d ạ	n h ẹ d ạ
x o á b ỏ	x o á b ỏ
d ấ u ấ n	d ấ u ấ n
c ủ a n ợ	c ủ a n ợ
b ồ c â u	b ồ c â u
l ễ h ộ i	l ễ h ộ i
ă n t ế t	ă n t ế t
a i n ấ y	a i n ấ y
b a l ă m	b a l ă m
b à n m ổ	b à n m ổ
đ ỏ h ỏ n	đ ỏ h ỏ n
c ầ u a n	c ầ u a n
đ á c ầ u	đ á c ầ u
m ớ i l ạ	m ớ i l ạ
đ ẻ n o n	đ ẻ n o n
r a đ ờ i	r a đ ờ i
đ ố i x ử	đ ố i x ử
h ạ t d ẻ	h ạ t d ẻ
m ó n ă n	m ó n ă n
đ a m m ê	đ a m m ê
d ù m ặ c	d ù m ặ c
a i l a o	a i l a o
a n c o l	a n c o l
â m m ư u	â m m ư u
g ồ m b a	g ồ m b a
p h ụ â m	p h ụ â m
đ ồ t h ị	đ ồ t h ị
a n t ô n	a n t ô n
s ạ t l ở	s ạ t l ở
p h ụ h ệ	p h ụ h ệ
đ a c ấ p	đ a c ấ p
c ú c v u	c ú c v u
ă n n ó i	ă n n ó i
b á l á p	b á l á p
đ ơ n l ẻ	đ ơ n l ẻ
d ơ b ẩ n	d ơ b ẩ n
ă n h ỏ i	ă n h ỏ i
c ứ u h ộ	c ứ u h ộ
c ổ v ậ t	c ổ v ậ t
b ồ c á c	b ồ c á c
ô h o à n	ô h o à n
m ù t ạ t	m ù t ạ t
s a m ạ c	s a m ạ c
m ờ m ị t	m ờ m ị t
b ó t a y	b ó t a y
b ỏ q u a	b ỏ q u a
h i đ r o	h i đ r o
c ô đ ơ n	c ô đ ơ n
a n t â m	a n t â m
h ộ i h è	h ộ i h è
c ô n đ ồ	c ô n đ ồ
k ỉ y ế u	k ỉ y ế u
t ổ h ợ p	t ổ h ợ p
b ã o t ố	b ã o t ố
c ơ h ộ i	c ơ h ộ i
c á l ó c	c á l ó c
h ố i l ộ	h ố i l ộ
h á t b è	h á t b è
t r í ó c	c h í ó c
ă n x i n	ă n x i n
r ộ n r ã	r ộ n r ã
b a t â y	b a t â y
x ạ t r ị	x ạ t r ị
đ ầ u t ư	đ ầ u t ư
q u y t ụ	q u y t ụ
g ặ p g ỡ	g ặ p g ỡ
r õ r ệ t	r õ r ệ t
d ữ d ộ i	d ữ d ộ i
x ì x ụ p	x ì x ụ p
m ặ n m à	m ặ n m à
s ố n h i ề u	s ố n h i ề u
h à l ộ i	h à l ộ i
t ê n t ự	t ê n t ự
m ở đ ầ u	m ở đ ầ u
a n t ô n	a n t ô n
đ i l à m	đ i l à m
m ư u đ ồ	m ư u đ ồ
g a n d ạ	g a n d ạ
r ă n đ e	r ă n đ e
c h ữ v ạ n	c h ữ v ạ n
v ệ t i n h	v ệ t i n h
n ư ớ c l ã	n ư ớ c l ã
p h ủ đ ầ u	p h ủ đ ầ u
đ ứ a t r ẻ	đ ứ a t r ẻ
l ạ p t h ể	l ạ p t h ể
g i ậ n d ữ	d ậ n d ữ
đ a u k h ổ	đ a u k h ổ
g õ k i ế n	g õ k i ế n
h o a t h ị	h o a t h ị
s a o k i m	s a o k i m
c h ả l ụ a	c h ả l ụ a
â n n h â n	â n n h â n
q u ả n c ơ	q u ả n c ơ
b ú n c h ả	b ú n c h ả
n ữ c ô n g	n ữ c ô n g
l ũ q u é t	l ũ q u é t
c h ị g á i	c h ị g á i
h ờ n d ỗ i	h ờ n d ỗ i
á o t h u n	á o t h u n
l ặ n g l ẽ	l ặ n g l ẽ
v ô d a n h	v ô d a n h
n ó i l á i	n ó i l á i
d ù i c u i	d ù i c u i
h o a v ă n	h o a v ă n
d u n h ậ p	d u n h ậ p
c h ó đ ố m	c h ó đ ố m
đ ố t p h á	đ ố t p h á
b ù n h ì n	b ù n h ì n
h ơ n n ữ a	h ơ n n ữ a
s a y s ư a	s a y s ư a
b a p h ả i	b a p h ả i
q u ố c t ế	q u ố c t ế
b í n g ò i	b í n g ò i
k e m m ứ t	k e m m ứ t
s á c h v ở	s á c h v ở
g â y r ố i	g â y r ố i
c ứ t r á y	c ứ t r á y
l a n t o ả	l a n t o ả
v ù i l ấ p	v ù i l ấ p
x ú p c u a	x ú p c u a
n ô n n a o	n ô n n a o
m â y m ư a	m â y m ư a
q u á i x ế	q u á i x ế
h ả i s ả n	h ả i s ả n
b ỏ t r ố n	b ỏ t r ố n
b i n h s ĩ	b i n h s ĩ
t à i t r ợ	t à i t r ợ
m ạ c p h ủ	m ạ c p h ủ
c ồ n c à o	c ồ n c à o
m à i m ò n	m à i m ò n
m a n g a n	m a n g a n
c h a n ộ i	t r a n ộ i
đ a k h o a	đ a k h o a
t h ứ c ă n	t h ứ c ă n
c ô n g t ử	c ô n g t ử
c ủ a c ả i	c ủ a c ả i
c ơ i n ớ i	c ơ i n ớ i
k ế s á c h	k ế s á c h
â u t i n h	â u t i n h
h ớ t h ả i	h ớ t h ả i
n h ư v ậ y	n h ư v ậ y
h à n g ắ n	h à n g ắ n
c ố i x a y	c ố i x a y
x ô n x a o	x ô n x a o
t h o á t y	t h o á t y
t ỏ i t â y	t ỏ i t â y
c ă m h ờ n	c ă m h ờ n
đ ấ u g i á	đ ấ u g i á
c o n n à y	c o n n à y
r â u m é p	r â u m é p
m ấ t m á t	m ấ t m á t
c ấ p c ứ u	c ấ p c ứ u
c a o v ú t	c a o v ú t
a n h n g ữ	a n h n g ữ
s ủ i d ì n	s ủ i d ì n
c á m h ấ p	c á m h ấ p
s ở n g á y	s ở n g á y
t h ậ p k ỉ	t h ậ p k ỉ
p h u q u â n	p h u q u â n
c ả m t ì n h	c ả m t ì n h
l i n h h ồ n	l i n h h ồ n
g i a n l a o	g i a n l a o
q u ố c g i a	q u ố c g i a
t ì m t h ấ y	t ì m t h ấ y
k h ổ n g t ử	k h ổ n g t ử
n g ũ t ạ n g	n g ũ t ạ n g
n g ủ q u ê n	n g ủ q u ê n
n h ẹ n h õ m	n h ẹ n h õ m
n ư ớ c n h à	n ư ớ c n h à
k h o a i m ì	k h o a i m ì
c ả i t á n g	c ả i t á n g
s á t n h â n	s á t n h â n
c á c h u ố i	c á c h u ố i
t h á i l a n	t h á i l a n
p h ả n ứ n g	p h ả n ứ n g
n h â n q u ả	n h â n q u ả
m ã n g u ồ n	m ã n g u ồ n
t r ơ t r ọ i	t r ơ t r ọ i
s ử n g s ố t	x ử n g s ố t
s a o t h u ỷ	s a o t h u ỷ
t i n m ừ n g	t i n m ừ n g
t â n t i n h	t â n t i n h
c h ế g i ễ u	c h ế g i ễ u
t r â n q u ý	c h â n q u ý
s i n h h o á	s i n h h o á
t h u a k é m	t h u a k é m
t h á n h l ễ	t h á n h l ễ
n a m v a n g	n a m v a n g
m o n g c h ờ	m o n g t r ờ
t i ế n g m ễ	t i ế n g m ễ
x à p h ò n g	x à p h ò n g
c ứ n g c á p	c ứ n g c á p
q u ả n h â n	q u ả n h â n
t h i c ô n g	t h i c ô n g
p h ấ n s á p	p h ấ n s á p
n h ó t t â y	n h ó t t â y
d a i d ẳ n g	d a i d ẳ n g
t h ủ t i ê u	t h ủ t i ê u
n ơ i n ơ i	n ơ i n ơ i
d ư a g a n g	d ư a g a n g
t ố i g i ả n	t ố i g i ả n
n g o à i r a	n g o à i r a
t á c n h â n	t á c n h â n
h u ố n g h ồ	h u ố n g h ồ
l â m s à n g	l â m s à n g
t h i ê n h à	t h i ê n h à
g ă n g t a y	g ă n g t a y
t h ô n ấ p	t h ô n ấ p
t â m t h ấ t	t â m t h ấ t
v ừ a m ớ i	v ừ a m ớ i
l ờ i n ó i	l ờ i n ó i
â m t í n h	â m t í n h
c á n h t ả	c á n h t ả
t h ầ n b í	t h ầ n b í
s o n g h ỉ	s o n g h ỉ
đ a t h ứ c	đ a t h ứ c
h ả o c ả m	h ả o c ả m
v o n f a m	v ô n p h a m
m á y t í n h	m á y t í n h
n g o a n c ố	n g o a n c ố
n ơ i s i n h	n ơ i s i n h
c h ị h ằ n g	c h ị h ằ n g
m i n h t r ị	m i n h t r ị
g h e n t ứ c	g h e n t ứ c
t r u n g t á	t r u n g t á
s â u t h ẳ m	s â u t h ẳ m
h ế t t h ờ i	h ế t t h ờ i
k h a i h o ả	k h a i h o ả
h á o h ứ c	h á o h ứ c
t h á i q u á	t h á i q u á
c h i m s â u	c h i m s â u
s á n c h a y	s á n c h a y
t é g i ế n g	t é g i ế n g
c o n t r a i	c o n t r a i
c à c u ố n g	c à c u ố n g
c ư ớ c p h í	c ư ớ c p h í
k h é o l é o	k h é o l é o
s o n g t ử	s o n g t ử
h á n n ô m	h á n n ô m
t h ợ m a y	t h ợ m a y
m à u s ắ c	m à u s ắ c
g i ế t m ổ	d i ế t m ổ
t a y l á i	t a y l á i
t h à n h ý	t h à n h ý
g ấ p r ú t	g ấ p r ú t
r é o r ắ t	r é o r ắ t
l a n c a n	l a n c a n
h ả i c ẩ u	h ả i c ẩ u
m <<unk>> n ô n g	m ơ n ô n g
s u ô n s ẻ	s u ô n s ẻ
n h à đ ấ t	n h à đ ấ t
t ự g i á c	t ự g i á c
d i ễ n r a	d i ễ n r a
d ễ c h ị u	d ễ c h ị u
m ả n h d ẻ	m ả n h d ẻ
h ô m n a y	h ô m n a y
ô n h i ễ m	ô n h i ễ m
r ư a r ứ a	d ư a r ứ a
n h ậ p c ư	n h ậ p c ư
s ơ s u ấ t	s ơ s u ấ t
m ơ n m ở n	m ơ n m ở n
c o g i ậ t	c o g i ậ t
v ã i l ồ n	v ã i l ồ n
ý t ư ở n g	ý t ư ở n g
h ấ p t ấ p	h ấ p t ấ p
h ô n h í t	h ô n h í t
l ớ n h ơ n	l ớ n h ơ n
ứ n g t á c	ứ n g t á c
c ô n g s ở	c ô n g s ở
t i ể u s ử	t i ể u s ử
c á c h l i	c á c h l i
k h ẩ u v ị	k h ẩ u v ị
h ậ n t h ù	h ậ n t h ù
v í a v a n	v í a v a n
t ừ v ự n g	t ừ v ự n g
t â y h ồ i	t â y h ồ i
q u á n x á	q u á n x á
g i a h ạ n	g i a h ạ n
m ù a m ư a	m ù a m ư a
t u ổ i t a	t u ổ i t a
c ả i d ầ u	c ả i d ầ u
d ẫ n d ắ t	d ẫ n d ắ t
s á n d ì u	s á n d ì u
t ó m t ắ t	t ó m t ắ t
k ế c h x ù	k ế c h x ù
l ờ i l ã i	l ờ i l ã i
t ự d ư n g	t ự d ư n g
c o n g á i	c o n g á i
x ử p h ạ t	x ử p h ạ t
t í t t ắ p	t í t t ắ p
t r ờ i ơ i	t r ờ i ơ i
t h i ể n ý	t h i ể n ý
h ì n h s ự	h ì n h s ự
l í l ị c h	l í l ị c h
h o a q u ả	h o a q u ả
t à i s ả n	t à i s ả n
k h a i v ị	k h a i v ị
t ả n m á t	t ả n m á t
d ị c h t ả	d ị c h t ả
c h è n é p	c h è n é p
t ê n l ó t	t ê n l ó t
c h u đ á o	c h u đ á o
x a n h l è	x a n h l è
h o a m à u	h o a m à u
t ừ l ó n g	t ừ l ó n g
q u á t ả i	q u á t ả i
c á g i ế c	c á g i ế c
c ậ u n h ỏ	c ậ u n h ỏ
â u c h â u	â u c h â u
c h â u â u	c h â u â u
m a y m ắ n	m a y m ắ n
t ù b i n h	t ù b i n h
g u ố c l ẻ	g u ố c l ẻ
s a o l ù n	s a o l ù n
g o á p h ụ	g o á p h ụ
h ố i l ỗ i	h ố i l ỗ i
n i n h h ạ	n i n h h ạ
d a d i ế t	d a d i ế t
h à o h o a	h à o h o a
n ô n g n ô	n ô n g n ô
t i ề n m ê	t i ề n m ê
t a n t a n	t a n t a n
b ắ t g i ữ	b ắ t g i ữ
b ả n n g ữ	b ả n n g ữ
b ú t c h ì	b ú t c h ì
c h o đ ế n	c h o đ ế n
t h ứ b ố n	t h ứ b ố n
c ứ u v ớ t	c ứ u v ớ t
d ù i m à i	d ù i m à i
d a l i ễ u	d a l i ễ u
m ò n m ỏ i	m ò n m ỏ i
k ì q u á i	k ì q u á i
n ư ớ c m ĩ	n ư ớ c m ĩ
ô n g g i à	ô n g g i à
h à l i ê n	h à l i ê n
đ a g i á c	đ a g i á c
t à i s ắ c	t à i s ắ c
s ứ c h ú t	x ứ c h ú t
h ắ t h ơ i	h ắ t h ơ i
c ự c k h ổ	c ự c k h ổ
k i n h đ ô	k i n h đ ô
k e n v i n	k e n v i n
h à n h x ử	h à n h x ử
h ộ s i n h	h ộ s i n h
h ầ u g á i	h ầ u g á i
x ó i m ò n	x ó i m ò n
c á t k ế t	c á t k ế t
h ô m q u a	h ô m q u a
c h ợ l ớ n	t r ợ l ớ n
l ừ a d ố i	l ừ a d ố i
c a o t a y	c a o t a y
c h ủ y ế u	c h ủ y ế u
r â u r i a	r â u r i a
n a o n a o	n a o n a o
b á n t r ú	b á n t r ú
t h a n ô i	t h a n ô i
d ấ u h ỏ i	d ấ u h ỏ i
s a y x ỉ n	s a y x ỉ n
t ă m t ố i	t ă m t ố i
t i ế n g ý	t i ế n g ý
s ế n s ẩ m	s ế n s ẩ m
n e m r á n	n e m g i á n
h ả o t â m	h ả o t â m
k h ế ư ớ c	k h ế ư ớ c
l o a k è n	l o a k è n
b â y g i ờ	b â y r ờ
q u ý m ế n	q u ý m ế n
q u ố c x ã	q u ố c x ã
đ ố i p h ó	đ ố i p h ó
c ử a h à n	c ử a h à n
k ế t i ế p	k ế t i ế p
m ặ c g i a	m ặ c g i a
d â y n ó i	d â y n ó i
t r ắ c ẩ n	t r ắ c ẩ n
t ẩ y n ã o	t ẩ y n ã o
c ầ u m a y	c ầ u m a y
h à i c ố t	h à i c ố t
n g ó n ú t	n g ó n ú t
x ắ c c ố t	x ắ c c ố t
v i n h d ự	v i n h d ự
c á i n à y	c á i n à y
t ầ m g ử i	t ầ m g ử i
c ô n g s ứ	c ô n g s ứ
t i ề n s ử	t i ề n s ử
d ậ y t h ì	d ậ y t h ì
l ư ỡ i g à	l ư ỡ i g à
s ư u t ầ m	s ư u t ầ m
c ấ y h á i	c ấ y h á i
s ố t r é t	s ố t r é t
g i a s ú c	g i a s ú c
g i ó b ấ c	g i ó b ấ c
s ĩ q u a n	s ĩ q u a n
l à m c ả m	l à m c ả m
c a n g ợ i	c a n g ợ i
k h ă n đ ỏ	k h ă n đ ỏ
t r ắ n g d ã	t r ắ n g d ã
c h ó r ừ n g	c h ó r ừ n g
n g ủ c h a y	n g ủ c h a y
n h ắ n n h ủ	n h ắ n n h ủ
g i ờ t h ì n	g i ờ t h ì n
g i ả m g i á	g i ả m g i á
t h ở t h a n	t h ở t h a n
s ở t h í c h	s ở t h í c h
t r ò c h ơ i	t r ò c h ơ i
h ứ n g t h ú	h ứ n g t h ú
k h ổ t h â n	k h ổ t h â n
t h ấ t t h u	t h ấ t t h u
n g h ỉ m á t	n g h ỉ m á t
k h ó k h ă n	k h ó k h ă n
x e g o ò n g	x e g o ò n g
n h à t r ầ n	n h à t r ầ n
g i ả i n g ũ	g i ả i n g ũ
c h í n h p h ủ	c h í n h p h ủ
n g h i t h ứ c	n g h i t h ứ c
n g h ỉ n g ơ i	n g h ỉ n g ơ i
c h ủ n g h ĩ a	c h ủ n g h ĩ a
n g h i n g ú t	n g h i n g ú t
p h ũ p h à n g	p h ũ p h à n g
n g h ỉ p h é p	n g h ỉ p h é p
n h a t r a n g	n h a t r a n g
n g h è o k h ó	n g h è o k h ó
n g ẫ m n g h ĩ	n g ẫ m n g h ĩ
n g ữ n g h ĩ a	n g ữ n g h ĩ a
t r a n g t r í	t r a n g t r í
n g ỡ n g à n g	n g ỡ n g à n g
n h ỏ n h ắ n	n h ỏ n h ắ n
t ờ r ơ i	t ờ r ơ i
d u y t u	d u y t u
d ự t h i	d ự t h i
m ũ n ồ i	m ũ n ồ i
l ỗ m ũ i	l ỗ m ũ i
n a m k ì	n a m k ì
c a o s u	c a o s u
m é o m ó	m é o m ó
d ầ n d à	d ầ n d à
c ờ v â y	c ờ v â y
c a m g o	c a m g o
c á m d ỗ	c á m d ỗ
q u y ệ n	q u y ệ n
s ở h ữ u	s ở h ữ u
x e r ù a	x e r ù a
c ủ c ả i	c ủ c ả i
c á p v e	c á p v e
r ã r ờ i	r ã r ờ i
s u y t ư	s u y t ư
s ư m ẫ u	s ư m ẫ u
x à í c h	x à í c h
c ô g á i	c ô g á i
h ữ u t ỉ	h ữ u t ỉ
m ồ h ô i	m ồ h ô i
p h á p y	p h á p y
b ỏ n g ỏ	b ỏ n g ỏ
m á c c ô	m á c c ô
k ơ n i a	k ơ n i a
l ã o t ử	l ã o t ử
l à m h ư	l à m h ư
t i t a n	t i t a n
c ú m è o	c ú m è o
q u y ệ t	q u y ệ t
t h ứ t ự	t h ứ t ự
h o a k ì	h o a k ì
c h ỉ s ự	c h ỉ s ự
r ủ i r o	r ủ i r o
n i k e n	n i k e n
c ắ t c ổ	c ắ t c ổ
t ầ n s ố	t ầ n s ố
t a n v ỡ	t a n v ỡ
x ơ g a n	x ơ g a n
c ử a s ổ	c ử a s ổ
g ử i r ể	g ử i r ể
q u y c ủ	q u y c ủ
s â u x a	s â u x a
v õ l â m	v õ l â m
d â n c ư	d â n c ư
v e c t ơ	v e c t ơ
l u y ệ n	l u y ệ n
c á v o i	c á v o i
v ấ t v ả	v ấ t v ả
t h ỏ đ ế	t h ỏ đ ế
k ì l â n	k ì l â n
m ẫ u s ố	m ẫ u s ố
c à m a u	c à m a u
k ê u c a	k ê u c a
t r ợ t ừ	t r ợ t ừ
t ổ l á i	t ổ l á i
c á i g ì	c á i g ì
c á t ầ m	c á t ầ m
d ự t r ữ	d ự t r ữ
m ê t í n	m ê t í n
h ả i m ã	h ả i m ã
c á q u ả	c á q u ả
n a p a n	n a p a n
l i h ô n	l i h ô n
x e m á y	x e m á y
y k h o a	y k h o a
b ề t h ế	b ề t h ế
x a x ô i	x a x ô i
t à u h ủ	t à u h ủ
h a m m ê	h a m m ê
h ổ c á p	h ổ c á p
c à t í m	c à t í m
h u y ệ t	h u y ệ t
k ì t h ị	k ì t h ị
c ổ x ư a	c ổ x ư a
t r i â n	c h i â n
x ì x à o	x ì x à o
l á l ố t	l á l ố t
v ũ h á n	v ũ h á n
h ú v í a	h ú v í a
c â y s ố	c â y s ố
t ừ l á y	t ừ l á y
t ư s ả n	t ư s ả n
d ế d ũ i	d ế d ũ i
b ố k h ỉ	b ố k h ỉ
h u y ệ n	h u y ệ n
l é p v ế	l é p v ế
g à s a o	g à s a o
ứ n g c ử	ứ n g c ử
m e t â y	m e t â y
m a m ú t	m a m ú t
b ể k h ổ	b ể k h ổ
ý t h ứ c	ý t h ứ c
t h í m ẹ	t h í m ẹ
l ề l ố i	l ề l ố i
c ổ v ă n	c ổ v ă n
t ư d u y	t ư d u y
m ắ c m ỏ	m ắ c m ỏ
n g ò ô m	n g ò ô m
m ỏ h à n	m ỏ h à n
v u l a n	v u l a n
h o a l ơ	h o a l ơ
t á c t a	t á c t a
s u h à o	s u h à o
m ù a h è	m ù a h è
t ứ h ả i	t ứ h ả i
c a k í p	c a k í p
l ô g i c	l ô g i c
n ô m n a	n ô m n a
d ầ u m ỏ	d ầ u m ỏ
t â n c ử	t â n c ử
h ớ n h ở	h ớ n h ở
d i t ả n	d i t ả n
m a t u ý	m a t u ý
m á t m ẻ	m á t m ẻ
t h ú v ị	t h ú v ị
l ễ t â n	l ễ t â n
l ầ m l ì	l ầ m l ì
n g ữ â m	n g ữ â m
s á t n a	s á t n a
c á t c ứ	c á t c ứ
x e c ú p	x e c ú p
x e k é o	x e k é o
h ỏ a x a	h o ả x a
h ư c ấ u	h ư c ấ u
l ú l ẫ n	l ú l ẫ n
v ỉ a h è	v ỉ a h è
x ì d ầ u	x ì d ầ u
d u y ệ t	d u y ệ t
h o n m i	h ô n m i
v ô c ă n	v ô c ă n
m ồ c ô i	m ồ c ô i
d i s ả n	d i s ả n
t h ủ đ ô	t h ủ đ ô
t ê o o c	t ê o o o c
r ơ m ă m	d ơ m ă m
m a q u ỷ	m a q u ỷ
x i v ư u	x i v ư u
h ô n m ê	h ô n m ê
t o t á c	t o t á c
l a h a y	l a h a y
v ô í c h	v ô í c h
c ă n c ứ	c ă n c ứ
s ư p h ụ	s ư p h ụ
h ồ t â y	h ồ t â y
x e l ă n	x e l ă n
m ẹ n ó	m ẹ n ó
c ú v ọ	c ú v ọ
b ệ n h	b ệ n h
b ể c á	b ể c á
v i b a	v i b a
b ỏ d ở	b ỏ d ở
v ô ơ n	v ô ơ n
ổ m ề m	ổ m ề m
t e b i	t e b i
đ i ệ u	đ i ệ u
x e c ộ	x e c ộ
c ử t ạ	c ử t ạ
d ạ c ỏ	d ạ c ỏ
x á x ị	x á x ị
x e đ ò	x e đ ò
t ạ t ừ	t ạ t ừ
đ ộ n g	đ ộ n g
đ ư ợ m	đ ư ợ m
b a r i	b a r i
b ỏ l ỡ	b ỏ l ỡ
b a l ô	b a l ô
b a n a	b a n a
đ ề c ử	đ ề c ử
b ộ n g	b ộ n g
đ á g à	đ á g à
t ự k ỉ	t ự k ỉ
ô <<unk>> ô n	ô n d ô n
b à c ô	b à c ô
e h è m	e h è m
b ệ c h	b ệ c h
b ố n ó	b ố n ó
s ơ đ ồ	s ơ đ ồ
b ụ n g	b ụ n g
á k i m	á k i m
a s e n	a s e n
h ế t ý	h ế t ý
t ì b à	t ì b à
b a <<unk>> ơ	b a <unk> ơ
ơ đ u	ơ đ u
s i d a	s i d a
ô t e n	ô t e n
r a đ i	r a đ i
d ê c ụ	d ê c ụ
đ ể ý	đ ể ý
ấ p ủ	ấ p ủ
t ự ý	t ự ý
a n ê	a n ê
e ấ p	e ấ p
h ạ d u	h ạ d u
ế ẩ m	ế ẩ m
á c ý	á c ý
b ọ c	b ọ c
đ ụ c	đ ụ c
đ ọ c	đ ọ c
m c	m i
c h	s ê h á t
đ m	đ ờ m ờ
i r ắ c	i r ắ c
x a l ộ	x a l ộ
đ ọ n g	đ ọ n g
d â m ô	d â m ô
á n t ù	á n t ù
ẻ o l ả	ẻ o l ả
a x i t	a x í t
b ơ v ơ	b ơ v ơ
a i d è	a i d è
c ố đ ô	c ố đ ô
t ự t ử	t ự t ử
b é t í	b é t í
c á đ ù	c á đ ù
t ỉ l ệ	t ỉ l ệ
đ i ệ n	đ i ệ n
b i ệ n	b i ệ n
đ ụ n g	đ ụ n g
t u ỳ ý	t u ỳ ý
m ĩ k i m	m ĩ k i m
t ư v ấ n	t ư v ấ n
v ô v à n	v ô v à n
c ổ x u ý	c ổ x u ý
t ứ k ế t	t ứ k ế t
h ả i s ư	h ả i s ư
â m p h ủ	â m p h ủ
d â m d ê	d â m d ê
c ả i r ổ	c ả i r ổ
m ù s o a	m ù s o a
g ò v ấ p	g ò v ấ p
s e l e n	s e l e n
x ấ u x í	x ấ u x í
c ô d â u	c ô d â u
h à n a m	h à n a m
c ờ v u a	c ờ v u a
t r ợ l í	t r ợ l í
m ã h à n	m ã h à n
h a y h o	h a y h o
m ở c ử a	m ở c ử a
v ô t â m	v ô t â m
n ề n ế p	n ề n ế p
n a m t ư	n a m t ư
t o g a n	t o g a n
k í k ế t	k í k ế t
h á t h ò	h á t h ò
t h ổ l ộ	t h ổ l ộ
q u á c ố	q u á c ố
x ấ u s ố	x ấ u s ố
n ó n l á	n ó n l á
v ồ n v ã	v ồ n v ã
q u á x á	q u á x á
n ỉ n o n	n ỉ n o n
l a h é t	l a h é t
c ầ n c ù	c ầ n c ù
t ố t s ố	t ố t s ố
v a i v ế	v a i v ế
b i ệ t	b i ệ t
k ì l ạ	k ì l ạ
đ i ệ p	đ i ệ p
t ừ v ị	t ừ v ị
b u ộ c	b u ộ c
k í ứ c	k í ứ c
ê k i p	ê k i p
l o â u	l o â u
l ư u ý	l ư u ý
d o d ự	d o d ự
đ o ạ t	đ o ạ t
c ô ấ y	c ô ấ y
đ ư ợ c	đ ư ợ c
a x í t	a x í t
v ừ a ý	v ừ a ý
u i d a	u i d a
b ạ c h	b ạ c h
n a u y	n a u y
v ị k ỉ	v ị k ỉ
m ô t e n	m ô t e n
l ú a m ì	l ú a m ì
ứ n g x ử	ứ n g x ử
h ố i h ả	h ố i h ả
v ô h ồ n	v ô h ồ n
t r à đ á	t r à đ á
h i h ữ u	h i h ữ u
t ự n h ủ	t ự n h ủ
á c h â u	á c h â u
t h ờ i g i ờ	t h ờ i r ờ
l ẻ l o i	l ẻ l o i
s i l i c	s i l i c
s o t à i	s o t à i
b u ộ t	b u ộ t
x a l ạ	x a l ạ
t ầ n ô	t ầ n ô
d ư v ị	d ư v ị
ẩ n s ố	ẩ n s ố
c ô g i á o	c ô g i á o
t í n h t ừ	t í n h t ừ
d ở d a n g	d ở d a n g
x ư n g h ô	x ư n g h ô
t h ử s ứ c	t h ử s ứ c
n h à c ử a	n h à c ử a
t ì n h c ờ	t ì n h c ờ
c h i a r ẽ	c h i a r ẽ
l a t i n h	l a t i n h
v ề p h í a	v ề p h í a
r ừ n g r ú	r ừ n g r ú
s i n h t ố	s i n h t ố
n ỗ i n h ớ	n ỗ i n h ớ
t ừ k h o á	t ừ k h o á
t ứ l i n h	t ứ l i n h
t h ờ i k ì	t h ờ i k ì
k ĩ n ă n g	k ĩ n ă n g
g i ấ y t ờ	g i ấ y t ờ
n h â n t ử	n h â n t ử
l ễ p h é p	l ễ p h é p
n g ũ g i á c	n g ũ g i á c
n h i k h o a	n h i k h o a
n ữ c h í n h	n ữ c h í n h
t r i n h n ữ	t r i n h n ữ
t h ể t h a o	t h ể t h a o
t h ư g i ã n	t h ư g i ã n
t ố c h ấ t	t ố c h ấ t
d a n g d ở	d a n g d ở
g i á o s ĩ	g i á o s ĩ
c à k h e o	c à k h e o
l í t í n h	l í t í n h
t ê t h ấ p	t ê t h ấ p
c h o t ê n	c h o t ê n
g i ả i m ã	g i ả i m ã
h à t ĩ n h	h à t ĩ n h
p h ố t à u	p h ố t à u
k i n h t ế	k i n h t ế
p h ô m a i	p h ô m a i
t h ă m d ò	t h ă m d ò
l ố l ă n g	l ố l ă n g
t r a h ỏ i	t r a h ỏ i
t h ấ y m ồ	t h ấ y m ồ
g h i t ê n	g h i t ê n
c ó c h ử a	c ó c h ử a
x i n h a n	x i n h a n
n g à y l ễ	n g à y l ễ
v a i t r ò	v a i t r ò
v ô t í n h	v ô t í n h
c ả n g à y	c ả n g à y
d ư t h ừ a	d ư t h ừ a
r ẻ t h ố i	r ẻ t h ố i
t â n g i a	t â n g i a
k h i n à o	k h i n à o
c á l i n h	c á l i n h
c ổ t í c h	c ổ t í c h
n g u y ệ n	n g u y ệ n
s ố k h ố i	s ố k h ố i
p h â n t ử	p h â n t ử
s ẻ c h i a	x ẻ c h i a
n g u y ệ t	n g u y ệ t
l ư u g i ữ	l ư u g i ữ
t ố g i á c	t ố g i á c
n g ư d â n	n g ư d â n
t ê g i á c	t ê g i á c
c h ú l ù n	c h ú l ù n
l ã o g i a	l ã o g i a
c h ú g i ả i	c h ú g i ả i
c ù n h â y	c ù n h â y
g i á o l ý	g i á o l ý
s u i g i a	s u i g i a
t r a i l ơ	t r a i l ơ
x ã g i a o	x ã g i a o
d o t h á i	d o t h á i
d â n c h ủ	d â n c h ủ
t h ị p h i	t h ị p h i
k h í t r ờ i	k h í t r ờ i
p h ê p h á n	p h ê p h á n
g i a o p h ó	g i a o p h ó
k i n h p h í	k i n h p h í
t h ủ l ĩ n h	t h ủ l ĩ n h
p h ô i p h a	p h ô i p h a
t h ì t h à o	t h ì t h à o
n g h ĩ s a o	n g h ĩ s a o
t h â n t h ể	t h â n t h ể
k h ó t í n h	k h ó t í n h
n g ữ p h á p	n g ữ p h á p
c h ó v à n g	c h ó v à n g
n g â y n g ô	n g â y n g ô
t r ă n t r ở	t r ă n t r ở
h ì n h t h ể	h ì n h t h ể
l i n h n g ữ	l i n h n g ữ
p h ế t í c h	p h ế t í c h
n ữ t r a n g	n ữ t r a n g
p h ù t h u ỷ	p h ù t h u ỷ
t h ẫ n t h ờ	t h ẫ n t h ờ
k h ắ t k h e	k h ắ t k h e
n h à c h ứ a	n h à c h ứ a
s á n g g i á	s á n g g i á
n h o g i á o	n h o g i á o
n h ở n n h ơ	n h ở n n h ơ
t r ầ m t r ồ	t r ầ m t r ồ
c h é m g i ó	c h é m g i ó
t h ơ m t h o	t h ơ m t h o
p h ù t a n g	p h ù t a n g
h ằ n g n g a	h ằ n g n g a
t á t r à n g	t á t r à n g
l ử n g c h ó	l ử n g c h ó
k h í c h ấ t	k h í c h ấ t
t h ế c h â n	t h ế c h â n
t r ầ m k h a	t r ầ m k h a
t h ỏ r ừ n g	t h ỏ r ừ n g
p h é p t r ừ	p h é p t r ừ
n g h i v ấ n	n g h i v ấ n
p h ả i g i ó	p h ả i g i ó
n h ắ c n h ở	n h ắ c n h ở
p h i p h á p	p h i p h á p
c h ứ n g c ớ	c h ứ n g c ớ
g i a n k h ó	g i a n k h ó
n g à n t h u	n g à n t h u
c h ứ n g t ừ	c h ứ n g t ừ
p h ả i c h i	p h ả i c h i
k h á m p h á	k h á m p h á
c h ă m c h ỉ	c h ă m c h ỉ
g i ả i t r í	g i ả i t r í
p h é p t h ử	p h é p t h ử
t r ẻ t r â u	t r ẻ t r â u
n h â m n h i	n h â m n h i
c h i p h ố i	c h i p h ố i
t h á p n g à	t h á p n g à
t a i n g h e	t a i n g e
n g ó n t r ỏ	n g ó n t r ỏ
t r í t h ứ c	t r í t h ứ c
c h ứ n g t ỏ	c h ứ n g t ỏ
n g ũ n g ô n	n g ũ n g ô n
c ổ t r a n g	c ổ t r a n g
t h ế g i ớ i	t h ế g i ớ i
g i a n g h ồ	g i a n g h ồ
t r i g i á c	t r i g i á c
t r ầ n t h ế	t r ầ n t h ế
n g ủ n g o n	n g ủ n g o n
c ơ v â n	c ơ v â n
h à g i a n g	h à g i a n g
t h á n g t ư	t h á n g t ư
s u y n g h ĩ	s u y n g h ĩ
g i ả n t h ể	g i ả n t h ể
n h ă n n h ó	n h ă n n h ó
g i á n t h u	g i á n t h u
p h o t p h o	p h o t p h o
n h ò m n g ó	n h ò m n g ó
t à n p h ế	t à n p h ế
s ư t h ầ y	s ư t h ầ y
ý n g h ĩ a	ý n g h ĩ a
s ử u n h i	s ử u n h i
h ư u t r í	h ư u t r í
t ú i n g ủ	t ú i n g ủ
c ầ n t h ơ	c ầ n t h ơ
h ô n p h u	h ô n p h u
c ù i c h ỏ	c ù i c h ỏ
t á i c h ế	t á i c h ế
t ứ c t h ì	t ứ c t h ì
c h ủ m ư u	c h ủ m ư u
n ữ c h â n	n ữ c h â n
d u y t r ì	d u y t r ì
t ì n h t ứ	t ì n h t ứ
g i ớ i t ừ	r ớ i t ừ
t h a n g ỗ	t h a n g ỗ
n ã y g i ờ	n ã y r ờ
c ầ m t h ú	c ầ m t h ú
n g ò g a i	n g ò g a i
l ễ t á n g	l ễ t á n g
t ử h ì n h	t ử h ì n h
g i à l a m	g i à l a m
x í c h l ô	x í c h l ô
p h ú q u ý	p h ú q u ý
d u k í c h	d u k í c h
p h á p s ư	p h á p s ư
k h o a c ử	k h o a c ử
m á y c h ữ	m á y c h ữ
c ó t h a i	c ó t h a i
c ẩ u t h ả	c ẩ u t h ả
n h ũ h o a	n h ũ h o a
c ấ m c h ỉ	c ấ m c h ỉ
c ă m t h ù	c ă m t h ù
n à o n g ờ	n à o n g ờ
t ổ c h ứ c	t ổ c h ứ c
n g a y c ả	n g a y c ả
v ị t r í	v ị t r í
d è s ẻ n	d è s ẻ n
h à l a n	h à l a n
c a i c ơ	c a i c ơ
h o ả m ù	h o ả m ù
f e c m i	f e c m i
p u p é o	p u p é o
c a n x i	c a n x i
m a m e n	m a m e n
s a o l a	s a o l a
p h á b ỏ	p h á b ỏ
ổ n h ó m	ổ n h ó m
s ơ c ấ p	s ơ c ấ p
n ó n m ũ	n ó n m ũ
v u i v ẻ	v u i v ẻ
đ ể c h o	đ ể c h o
d i c ă n	d i c ă n
m ã h o á	m ã h o á
d a m à u	d a m à u
s à n n h à	s à n n h à
s á t t h ủ	s á t t h ủ
t í n c h ỉ	t í n c h ỉ
s a o t h ổ	s a o t h ổ
m a t r ơ i	m a c h ơ i
c h o h a y	c h o h a y
s ố p h ứ c	s ố p h ứ c
t r u y ệ n	c h u y ệ n
s i n h l í	s i n h l í
k ê k h a i	k ê k h a i
t h á n t ừ	t h á n t ừ
t r ì t r ệ	t r ì t r ệ
l i t h â n	l i t h â n
c á s ấ u	c á s ấ u
b ồ n h í	b ồ n h í
c á h e o	c á h e o
x ấ u h ổ	x ấ u h ổ
k h í c ụ	k h í c ụ
t r ầ m t ư	t r ầ m t ư
c â u g i ờ	c â u g i ờ
d ễ t í n h	d ễ t í n h
t ê n c h ữ	t ê n c h ữ
n ớ i g i á	n ớ i g i á
t h ờ i c ơ	t h ờ i c ơ
v e c h a i	v e c h a i
n g h ệ s ĩ	n g h ệ s ĩ
t ừ t r ầ n	t ừ t r ầ n
r a c h ơ i	r a c h ơ i
v ấ p n g ã	v ấ p n g ã
t h ừ a s ố	t h ừ a s ố
p h u p h ụ	p h u p h ụ
k h ở i t ố	k h ở i t ố
t a o n h ã	t a o n h ã
n g ò i n ổ	n g ò i n ổ
s i n h r a	s i n h r a
g i ẻ c ù i	g i ẻ c ù i
k í n h n ể	k í n h n ể
t h ở d à i	t h ở d à i
t h ủ m ô n	t h ủ m ô n
d ò m n g ó	d ò m n g ó
c ử a n g õ	c ử a n g õ
v i c t o r	v i c t o
p h a o l ô	p h a o l ô
p h â n t ừ	p h â n t ừ
t â m n h ĩ	t â m n h ĩ
d ế c h ũ i	d ế c h ũ i
s ơ s i n h	s ơ s i n h
g i ả c ầ y	g i ả c ầ y
c ố t ì n h	c ố t ì n h
t r u y n ã	t r u y n ã
g i a r a i	g i a r a i
c h ă m l o	c h ă m l o
g i a s ả n	g i a s ả n
c á l ă n g	c á l ă n g
n h à x á c	n h à x á c
d ấ u n g ã	d ấ u n g ã
t ừ c h ố i	t ừ c h ố i
t â m t r í	t â m t r í
m ừ n g r ỡ	m ừ n g r ỡ
k ì t í c h	k ì t í c h
n h ũ m ẫ u	n h ũ m ẫ u
t h i h à i	t h i h à i
l ơ l ử n g	l ơ l ử n g
c h u c ấ p	c h u c ấ p
s ơ n t r a	s ơ n t r a
c h i a s ẻ	c h i a s ẻ
c h ế t à i	c h ế t à i
l í g i ả i	l í g i ả i
t h ứ h a i	t h ứ h a i
k ĩ c à n g	k ĩ c à n g
g i a l a i	g i a l a i
t r a v ấ n	t r a v ấ n
t h ô r á p	t h ô r á p
s á o n h ỏ	s á o n h ỏ
l ư u t r ú	l ư u t r ú
n ữ g i ớ i	n ữ g i ớ i
s a n g s ố	s a n g s ố
p h o m á t	p h o m á t
t h ứ s á u	t h ứ s á u
p h i t ầ n	p h i t ầ n
g i á o x ứ	g i á o x ứ
g ầ m g h ì	g ầ m g h ì
g i ờ n g ọ	r ờ n g ọ
r ả r í c h	g i ả r í c h
l a i t h ế	l a i t h ế
l ỡ l à n g	l ỡ l à n g
m ú i g i ờ	m ú i r ờ
v ắ n g v ẻ	v ắ n g v ẻ
t r ị g i á	t r ị g i á
g i ó m ù a	r ó m ù a
m ĩ p h ẩ m	m ĩ p h ẩ m
m ở m a n g	m ở m a n g
t h ủ t h ỉ	t h ủ t h ỉ
p h i n g ã	p h i n g ã
n h ư ợ n g	n h ư ợ n g
n g h i ệ n	n g h i ệ n
t h i t h ố	t h i t h ố
n h í n h ố	n h í n h ố
t h ì g i ờ	t h ì g i ờ
n h o n h ỏ	n h o n h ỏ
t r u y ề n	t r u y ề n
n g u y ê n	n g u y ê n
t r ả t h ù	t r ả t h ù
g i ò t h ủ	g i ò t h ủ
n g u y ễ n	n g u y ễ n
t h ư ợ n g	t h ư ợ n g
n g u y ề n	n g u y ề n
k h ư k h ư	k h ư k h ư
c h ủ n g ữ	c h ủ n g ữ
n g ã t ư	n g ã t ư
p h u x e	p h u x e
q u y ế t	q u y ế t
k h i d ễ	k h i d ễ
t h o ạ t	t h o ạ t
m i ệ n g	m i ệ n g
k ì t h ủ	k ì t h ủ
q u ặ n g	q u ặ n g
h u y ế t	h u y ế t
l ơ n g ơ	l ơ n g ơ
h u y ề n	h u y ề n
t ư t h ế	t ư t h ế
q u y ê n	q u y ê n
t ử t h i	t ử t h i
t h u ậ t	t h u ậ t
p h ù l á	p h ù l á
c h e m ờ	c h e m ờ
n g h i ệ p	n g h i ệ p
t h u y ề n	t h u y ề n
n h u y ễ n	n h u y ễ n
n g a n g ố	n g a n g ố
k h u ế c h	k h u ế c h
k h o ả n h	k h o ả n h
t h ổ n g ữ	t h ổ n g ữ
k h u p h ố	k h u p h ố
c h ữ n h o	c h ữ n h o
t r ừ k h ử	t r ừ k h ử
g i a c h ủ	g i a c h ủ
c h u y ể n	c h u y ể n
k h ề k h à	k h ề k h à
n g h i ệ m	n g h i ệ m
c h ả g i ò	c h ả g i ò
n h à n g h ề	n h à n g h ề
n g h i n g ờ	n g h i n g ờ
c ư t r ú	c ư t r ú
g i à k h ú	g i à k h ú
n g o ả n h	n g o ả n h
k h u y ế t	k h u y ế t
c h u ộ n g	c h u ộ n g
n h ư t h ế	n h ư t h ế
t h ủ p h ủ	t h ủ p h ủ
n g h i ệ t	n g h i ệ t
c h í k h í	c h í k h í
k h o a n h	k h o a n h
p h á g i á	p h á g i á
t h ủ t h ư	t h ủ t h ư
c h u y ế n	c h u y ế n
c h u y ê n	c h u y ê n
k h u y ế n	k h u y ế n
p h ư ợ n g	p h ư ợ n g
k h ò k h è	k h ò k h è
n g ư ợ n g	n g ư ợ n g
h ọ c p h í	h ọ c p h í
s ứ m ệ n h	s ứ m ệ n h
g ầ n g ụ i	g ầ n g ụ i
l ư u v ự c	l ư u v ự c
k í h i ệ u	k í h i ệ u
h à n h h ạ	h à n h h ạ
b á n h l ễ	b á n h l ễ
t ậ n t a y	t ậ n t a y
c ố c t a i	c ố c t a i
x e m b ó i	x e m b ó i
t i n đ ồ n	t i n đ ồ n
đ ầ u t ê u	đ ầ u t ê u
v ấ n n ạ n	v ấ n n ạ n
h i ể m á c	h i ể m á c
v ậ n m a y	v ậ n m a y
k i ế n b ò	k i ế n b ò
b i q u a n	b i q u a n
c h ờ đ ợ i	c h ờ đ ợ i
c ự c t r ị	c ự c t r ị
l ậ p t ứ c	l ậ p t ứ c
k ỉ l u ậ t	k ỉ l u ậ t
b ò v i ê n	b ò v i ê n
â m n h ạ c	â m n h ạ c
l ữ đ o à n	l ữ đ o à n
c ô n g a n	c ô n g a n
n ư ớ c l ợ	n ư ớ c l ợ
d ữ l i ệ u	d ữ l i ệ u
é p x u n g	é p x u n g
v ô b i ê n	v ô b i ê n
x á c l ậ p	x á c l ậ p
h ả i t ặ c	h ả i t ặ c
d á n g b ộ	r á n g b ộ
g ạ t t à n	g ạ t t à n
b á n h m ì	b á n h m ì
đ ấ t s é t	đ ấ t s é t
d ằ n m ặ t	r ằ n m ặ t
k e o o n g	k e o o n g
b à n t á n	b à n t á n
ă n c ư ớ p	ă n c ư ớ p
s ắ c b é n	s ắ c b é n
y ế t h ầ u	y ế t h ầ u
đ ố i l ư u	đ ố i l ư u
đ i n h b a	đ i n h b a
x í m u ộ i	x í m u ộ i
r o i v ọ t	r o i v ọ t
s â n b a y	s â n b a y
x ế đ i ế c	x ế đ i ế c
g i u l i ô	g i u l i ô
u ỷ v i ê n	u ỷ v i ê n
n g ậ u s ị	n g ậ u s ị
c ầ m đ ầ u	c ầ m đ ầ u
b u l ô n g	b u l ô n g
c ô n g c ụ	c ô n g c ụ
m a y m ặ c	m a y m ặ c
b á c h t ế	b á c h t ế
k h ỉ đ ộ t	k h ỉ đ ộ t
t u v i ệ n	t u v i ệ n
t h á i đ ộ	t h á i đ ộ
c a m b ố t	c a m b ố t
m ã v ạ c h	m ã v ạ c h
ô n d ị c h	ô n d ị c h
m ạ n h t ử	m ạ n h t ử
c ả i b ắ p	c ả i b ắ p
h í t đ ấ t	h í t đ ấ t
b ẫ y m ì n	b ẫ y m ì n
đ e n t ố i	đ e n t ố i
b ư ớ u c ổ	b i ế u c ổ
c h e đ ậ y	c h e đ ậ y
t h ị l ự c	t h ị l ự c
x a p ô c h ê	x a p ô c h ê
t h â n m ậ t	t h â n m ậ t
h ậ u p h ẫ u	h ậ u p h ẫ u
p h ổ b i ế n	p h ổ b i ế n
t a n g t ó c	t a n g t ó c
g i ậ n d ỗ i	d ậ n d ỗ i
b ắ c g i ả i	b ắ c g i ả i
l â n c ậ n	l â n c ậ n
v ó c d á n g	v ó c d á n g
s ố đ ô n g	s ố đ ô n g
ả i q u a n	ả i q u a n
h ợ p t á c	h ợ p t á c
l ụ c p h ủ	l ụ c p h ủ
s ử a đ ổ i	s ử a đ ổ i
s ầ m s ậ p	s ầ m s ậ p
g ợ i c ả m	g ợ i c ả m
k i m t i ề n	k i m t i ề n
t h ấ t l ạ c	t h ấ t l ạ c
t â y l i ê u	t â y l i ê u
t h á i h ậ u	t h á i h ậ u
t u ầ n s a n	t u ầ n s a n
c ử a x o a y	c ử a x o a y
g i u n đ ũ a	r u n đ ũ a
v ò n g t a y	v ò n g t a y
s t r o n t i	s t r o n t i
v i ê m đ ế	v i ê m đ ế
q u ả t h ậ t	q u ả t h ậ t
t ạ o h ì n h	t ạ o h ì n h
t r u n g u ý	t r u n g u ý
n e m c u ố n	n e m c u ố n
t r a o đ ổ i	t r a o đ ổ i
n í n n h ị n	n í n n h ị n
đ ầ u t h a i	đ ầ u t h a i
l ẩ y b ẩ y	l ẩ y b ẩ y
t h ế đ ạ i	t h ế đ ạ i
đ à i c á c	đ à i c á c
t á i l ậ p	t á i l ậ p
l ặ n g i m	l ặ n g i m
đ ị a c h ỉ	đ ị a c h ỉ
m ớ i đ â y	m ớ i đ â y
b i ế n c ố	b i ế n c ố
g ó p m ặ t	g ó p m ặ t
b ê t ô n g	b ê t ô n g
b à n h t ô	b à n h t ô
n ổ i d ậ y	n ổ i d ậ y
h y g i n ô	h y g i n ô
b ọ c h é t	b ọ c h é t
m ỏ i m ệ t	m ỏ i m ệ t
t ứ d i ệ n	t ứ d i ệ n
g ặ p m a y	g ặ p m a y
s ố n g ả o	s ố n g ả o
m ẫ u v ậ t	m ẫ u v ậ t
đ à n x ế p	đ à n x ế p
h i v ọ n g	h i v ọ n g
á p s u ấ t	á p s u ấ t
v ô v ọ n g	v ô v ọ n g
á m t i ê u	á m t i ê u
t ê r ê s a	t ê r ê s a
m ấ t d ạ y	m ấ t d ạ y
b ồ h ó n g	b ồ h ó n g
q u a n â m	q u a n â m
t i ê n đ ề	t i ê n đ ề
đ ị a c h i	đ ị a c h i
ư u t i ê n	ư u t i ê n
x ẹ p l é p	x ẹ p l é p
y ê u m ế n	y ê u m ế n
h o á n v ị	h o á n v ị
n ấ u b ế p	n ấ u b ế p
t ộ i l ỗ i	t ộ i l ỗ i
s i ê u â m	s i ê u â m
b í n h â m	b í n h â m
l ẩ m b ẩ m	l ẩ m b ẩ m
m á y m ó c	m á y m ó c
s ả n v ậ t	s ả n v ậ t
v ô h i ệ u	v ô h i ệ u
b ì n h d ị	b ì n h d ị
d ư ợ c s ĩ	d ư ợ c s ĩ
g a i g ó c	g a i g ó c
y ê u q u ý	y ê u q u ý
đ ổ i m ớ i	đ ổ i m ớ i
đ ị n h c ư	đ ị n h c ư
n g o ạ i ô	n g o ạ i ô
m ặ c d ầ u	m ặ c d ầ u
r a o v ặ t	g i a o v ặ t
b ả n s a o	b ả n s a o
d â y n ị t	d â y n ị t
b ó n g r ổ	b ó n g r ổ
q u a n h ệ	q u a n h ệ
v õ b i ề n	v õ b i ề n
t r ụ c s ố	t r ụ c s ố
đ è n p i n	đ è n p i n
u ố n v á n	u ố n v á n
b í t t ế t	b í t t ế t
ă n n h ậ u	ă n n h ậ u
n ụ c ư ờ i	n ụ c ư ờ i
t â m l ự c	t â m l ự c
b á o s ă n	b á o s ă n
c a o t ố c	c a o t ố c
đ a t ạ n g	đ a t ạ n g
m à n ả n h	m à n ả n h
h à t h ủ ô	h à t h ủ ô
đ ồ i n ã o	đ ồ i n ã o
t a i h o ạ	t a i h o ạ
c ử u v ạ n	c ử u v ạ n
b á n h x e	b á n h x e
s ư m u ộ i	s ư m u ộ i
l í l u ậ n	l í l u ậ n
đ ặ c t h ù	đ ặ c t h ù
l ê u b ê u	l ê u b ê u
đ ắ k l ắ k	đ ắ k l ắ k
đ ệ n h ấ t	đ ệ n h ấ t
b i a h ơ i	b i a h ơ i
l ộ t x á c	l ộ t x á c
b ù n g n ổ	b ù n g n ổ
l o ạ i t ừ	l o ạ i t ừ
h ờ i h ợ t	h ờ i h ợ t
v ò i v ọ i	v ò i v ọ i
t ê n g ọ i	t ê n g ọ i
s ủ n g á i	s ủ n g á i
q u a đ ờ i	q u a đ ờ i
c ă n d ặ n	c ă n d ặ n
v õ h i ệ p	v õ h i ệ p
b á n k ế t	b á n k ế t
s ầ u đ â u	s ầ u đ â u
t á o b ó n	t á o b ó n
c â u đ ố i	c â u đ ố i
c ô n g b ố	c ô n g b ố
t ạ i s a o	t ạ i s a o
s ố m ệ n h	s ố m ệ n h
c a c b o n	c a c b o n
x ử d ụ n g	x ử d ụ n g
t ạ p h o á	t ạ p h o á
n ư ớ c đ á	n ư ớ c đ á
x o a d ị u	x o a d ị u
g ạ o l ứ t	g ạ o l ứ t
v ă n b ả n	v ă n b ả n
đ ạ i n g u	đ ạ i n g u
m ư ờ i b a	m ư ờ i b a
x á n l ạ n	x á n l ạ n
b á n h t ẻ	b á n h t ẻ
h ẹ p h ò i	h ẹ p h ò i
s ự t h ậ t	s ự t h ậ t
x e m ô t ô	x e m ô t ô
đ ò i h ỏ i	đ ò i h ỏ i
m ê h o ặ c	m ê h o ặ c
t ố t ụ n g	t ố t ụ n g
y ế u k é m	y ế u k é m
c ấ u t ạ o	c ấ u t ạ o
n h ạ c c ụ	n h ạ c c ụ
đ ầ y r ẫ y	đ ầ y r ẫ y
l u ậ t s ư	l u ậ t s ư
đ ầ u g ấ u	đ ầ u g ấ u
x e m m ặ t	x e m m ặ t
p h ụ c h y	p h ụ c h y
đ ộ t p h á	đ ộ t p h á
v ô đ ị c h	v ô đ ị c h
đ à o h o a	đ à o h o a
b ữ a h ổ m	b ữ a h ổ m
b a o c ấ p	b a o c ấ p
h ợ p k i m	h ợ p k i m
t ụ c n g ữ	t ụ c n g ữ
b i ể n c ả	b i ể n c ả
k í n đ á o	k í n đ á o
đ ĩ a m ề m	đ ĩ a m ề m
d u n g d ị	d u n g d ị
b ắ t c o n	b ắ t c o n
r ộ n g m ở	r ộ n g m ở
q u ầ n á o	q u ầ n á o
h o á đ ơ n	h o á đ ơ n
b ữ a c ơ m	b ữ a c ơ m
đ à n n h ị	đ à n n h ị
b ì u d á i	b ì u d á i
d ạ t d à o	d ạ t d à o
p h ì đ ạ i	p h ì đ ạ i
t i ề m ẩ n	t i ề m ẩ n
m ử a m ậ t	m ử a m ậ t
t h ổ đ ị a	t h ổ đ ị a
a n l à n h	a n l à n h
c h â u ú c	c h â u ú c
t h ô b ạ o	t h ô b ạ o
b ã o c á t	b ã o c á t
l ợ i í c h	l ợ i í c h
đ à n t a m	đ à n t a m
m ạ n h m ẽ	m ạ n h m ẽ
đ ấ t m ũ i	đ ấ t m ũ i
t i ề n b o	t i ề n b o
t r à đ ạ o	t r à đ ạ o
h ạ c á n h	h ạ c á n h
c ứ l i ệ u	c ứ l i ệ u
t i ê u c ự	t i ê u c ự
k ị b i n h	k ị b i n h
n ộ i q u y	n ộ i q u y
c ứ t l ợ n	c ứ t l ợ n
t ậ p t i n	t ậ p t i n
l ẽ o đ ẽ o	l ẽ o đ ẽ o
b à n t í n h	b à n t í n h
b ô i n h ọ	b ô i n h ọ
m ó c l ố p	m ó c l ố p
đ ố i v ớ i	đ ố i v ớ i
t h ợ l ặ n	t h ợ l ặ n
l ạ l ù n g	l ạ l ù n g
n ộ i t r ợ	n ộ i t r ợ
l ỗ m a n i	l ỗ m a n i
h ả i đ ă n g	h ả i đ ă n g
t h ờ i b á o	t h ờ i b á o
t i ế p t h ị	t i ế p t h ị
p h ả n h ạ t	p h ả n h ạ t
m ư ờ i t á m	m ư ờ i t á m
c h ợ p m ắ t	c h ợ p m ắ t
ố n g k í n h	ố n g k í n h
h e o q u a y	h e o q u a y
t h ầ y b ó i	t h ầ y b ó i
p h ó n g s ự	p h ó n g s ự
s ố n g m á i	s ố n g m á i
b á c h t h ú	b á c h h ú
t r ì n h đ ộ	t r ì n h đ ộ
l ấ p l á n h	l ấ p l á n h
t a m q u ố c	t a m q u ố c
c a m s à n h	c a m s à n h
n ư ớ c x ố t	n ư ớ c x ố t
v ă n p h ạ m	v ă n p h ạ m
g ấ u t r ú c	g ấ u t r ú c
c ầ u v ồ n g	c ầ u v ồ n g
m ẫ u q u ố c	m ẫ u q u ố c
ế c h g i u n	ế c h r u n
n ư ớ c n a m	n ư ớ c n a m
k ế t t h ú c	k ế t t h ú c
n g ò i b ú t	n g ò i b ú t
b ằ n g h ữ u	b ằ n g h ữ u
t ầ m v ô n g	t ầ m v ô n g
t à n k h ố c	t à n k h ố c
d i ề u h â u	d i ề u h â u
b ì n h d â n	b ì n h d â n
p h ấ n đ ấ u	p h ấ n đ ấ u
p h ế l i ệ u	p h ế l i ệ u
p h í a b ắ c	p h í a b ắ c
k h a i m ạ c	k h a i m ạ c
m ạ c t í n h	m ạ c t í n h
s á n g t ạ o	s á n g t ạ o
v ô d u y ê n	v ô d u y ê n
m á c h l ẻ o	m á c h l ẻ o
l u â n h ồ i	l u â n h ồ i
x ạ h ư ơ n g	x ạ h ư ơ n g
l ô n g m a o	l ô n g m a o
h ồ n g m a o	h ồ n g m a o
b á n k í n h	b á n k í n h
n ă m m ư ờ i	n ă m m ư ờ i
h ú n g q u ế	h ú n g q u ế
t h o á t v ị	t h o á t v ị
t h ấ u đ á o	t h ấ u đ á o
đ ư ờ n g s á	đ ư ờ n g s á
c h ă m s ó c	c h ă m s ó c
d à n n h ạ c	d à n n h ạ c
t ầ m x u â n	t ầ m x u â n
m ắ c c ư ờ i	m ắ c c ư ờ i
n ạ n n h â n	n ạ n n h â n
b à n c h ả i	b à n c h ả i
l ạ n g s ơ n	l ạ n g s ơ n
t i ể u t â m	t i ể u t â m
t h a b ổ n g	t h a b ổ n g
t h o á i v ị	t h o á i v ị
r ả n h r ỗ i	r ả n h r ỗ i
c ờ t ỉ p h ú	c ờ t ỉ p h ú
t i ể u c ầ u	t i ể u c ầ u
h à i h ư ớ c	h à i h ư ớ c
l ớ n t u ổ i	l ớ n t u ổ i
n h â n v ậ t	n h â n v ậ t
m ă n g c ụ t	m ă n g c ụ t
v i ễ n t h ị	v i ễ n t h ị
h ộ i t h a o	h ộ i t h a o
c ả n h s ắ c	c ả n h s ắ c
m á y q u a y	m á y q u a y
p h ủ đ ị n h	p h ủ đ ị n h
c h i đ o à n	c h i đ o à n
r á o t r ọ i	g i á o t r ọ i
n h â n l ự c	n h â n l ự c
m u ô n v à n	m u ô n v à n
q u â n h à m	q u â n h à m
h i ế p d â m	h i ế p d â m
c h ố c l á t	c h ố c l á t
p h ứ c t ạ p	p h ứ c t ạ p
l ư ợ n g t ừ	l ư ợ n g t ừ
v õ t h u ậ t	v õ t h u ậ t
đ a c h i ề u	đ a c h i ề u
l ĩ n h v ự c	l ĩ n h v ự c
b ả n c h ấ t	b ả n c h ấ t
k h o á c á o	k h o á c á o
t i ê u h o á	t i ê u h o á
ư ớ c t í n h	ư ớ c t í n h
g i ả m b ớ t	g i ả m b ớ t
p h ù đ i ê u	p h ù đ i ê u
h ộ i c h ẩ n	h ộ i c h ẩ n
g h ẻ l ạ n h	g h ẻ l ạ n h
n ư ớ c l à o	n ư ớ c l à o
đ ô n g c h í	đ ô n g c h í
n ớ i l ỏ n g	n ớ i l ỏ n g
c h ù m b a o	c h ù m b a o
m ạ c h n h a	m ạ c h n h a
h à i k ị c h	h à i k ị c h
g i a o n ộ p	g i a o n ộ p
t h ể l o ạ i	t h ể l o ạ i
m ấ t c ô n g	m ấ t c ô n g
t h ỏ n g ọ c	t h ỏ n g ọ c
đ í n h h ô n	đ í n h h ô n
d à i d ò n g	d à i d ò n g
t i ể u n ã o	t i ể u n ã o
l ư u m a n h	l ư u m a n h
h ồ n g h à o	h ồ n g h à o
t a m t ò n g	t a m t ò n g
l u ậ t g i a	l u ậ t g i a
v i ê m g a n	v i ê m g a n
c ứ u m ạ n g	c ứ u m ạ n g
c h à b ô n g	c h à b ô n g
v ù n g v ẫ y	v ù n g v ẫ y
h à n g đ ầ u	h à n g đ ầ u
b ấ t c h ấ p	b ấ t c h ấ p
q u ầ n q u è	q u ầ n q u è
b á t g i á c	b á t g i á c
n ư ớ c s ô i	n ư ớ c s ô i
m è o m ư ớ p	m è o m ư ớ p
c ô n g d â n	c ô n g d â n
m ấ t l ò n g	m ấ t l ò n g
t u ổ i t h ọ	t u ổ i t h ọ
t u ỷ s ố n g	t u ỷ s ố n g
b i ể u n g ữ	b i ể u n g ữ
l à n s ó n g	l à n s ó n g
c á r ô p h i	c á r ô p h i
m ộ t n g à n	m ộ t n g à n
b à h o à n g	b à h o à n g
n ă n n g ọ t	n ă n n g ọ t
c h à o đ ó n	t r à o đ ó n
l ư ỡ i h á i	l ư ỡ i h á i
n ú i s ô n g	n ú i s ô n g
b ó n g g i ó	b ó n g g i ó
h ả i p h ậ n	h ả i p h ậ n
b á n h p h ở	b á n h p h ở
s ú n g s á u	s ú n g s á u
c u ồ n g n ộ	c u ồ n g n ộ
t h ị h i ế u	t h ị h i ế u
c ầ u t o à n	c ầ u t o à n
c h ấ y r ậ n	c h ấ y r ậ n
n h ã đ i ể n	n h ã đ i ể n
d ự p h ò n g	d ự p h ò n g
s o á t x é t	s o á t x é t
n ă n g l ự c	n ă n g l ự c
h a i m ư ơ i	h a i m ư ơ i
s i ê u s a o	s i ê u s a o
c ô n g s ứ c	c ô n g s ứ c
h ộ i n g h ị	h ộ i n g h ị
h i ề n h o à	h i ề n h o à
s à n d i ễ n	s à n d i ễ n
c h i ế u x ạ	c h i ế u x ạ
t r u n g ấ n	t r u n g ấ n
n h ậ n x é t	n h ậ n x é t
n ư ớ c m í a	n ư ớ c m í a
đ ằ m t h ắ m	đ ằ m t h ắ m
s a y s ó n g	s a y s ó n g
m i n h h o ạ	m i n h h o ạ
s ỏ i t h ậ n	s ỏ i t h ậ n
s ở đ o ả n g	s ở đ o ả n g
g i ấ y b ồ i	d ấ y b ồ i
b a n n g à y	b a n n g à y
p h ạ m l ỗ i	p h ạ m l ỗ i
m ề m l ò n g	m ề m l ò n g
l ậ p p h á p	l ậ p p h á p
h o a k i ề u	h o a k i ề u
t h u ố c b ổ	t h u ố c b ổ
n h ụ c n h ã	n h ụ c n h ã
d i ễ n t ấ u	d i ễ n t ấ u
b u ồ n n g ủ	b u ồ n n g ủ
g i á l ạ n h	g i á l ạ n h
c á n h h ữ u	c á n h h ữ u
c a y đ ắ n g	c a y đ ắ n g
c ú n g c ơ m	c ú n g c ơ m
r ì n h r ậ p	r ì n h r ậ p
s á n g l ậ p	s á n g l ậ p
s ú c t í c h	s ú c t í c h
t i ế n g ồ n	t i ế n g ồ n
r ê n s i ế t	r ê n x i ế t
t ư ơ n g ớ t	t ư ơ n g ớ t
v i ệ t n g ữ	v i ệ t n g ữ
n ư ớ c n ô i	n ư ớ c n ô i
s a o b ă n g	s a o b ă n g
q u ấ y r ầ y	q u ấ y r ầ y
c á c h t â n	c á c h t â n
h o a l i ễ u	h o a l i ễ u
x ạ k h u ẩ n	x ạ k h u ẩ n
d ũ n g c ả m	d ũ n g c ả m
t i ế p s ứ c	t i ế p s ứ c
x á c s u ấ t	x á c s u ấ t
n ư ớ c h o a	n ư ớ c h o a
t á o q u â n	t á o q u â n
d ị u d à n g	d ị u d à n g
h i ế m h o i	h i ế m h o i
c ă n c ư ớ c	c ă n c ư ớ c
y ê n t ĩ n h	y ê n t ĩ n h
h ậ u n g h ệ	h ậ u n g h ệ
n g ắ n h ạ n	n g ắ n h ạ n
n h â n d ị p	n h â n d ị p
h ạ n g u ồ n	h ạ n g u ồ n
v i ê n m ã n	v i ê n m ã n
c u ộ c t h i	q u ộ c t h i
t ư ơ i t ắ n	t ư ơ i t ắ n
c ấ t c á n h	c ấ t c á n h
x â y d ự n g	x â y d ự n g
l u n g l a y	l u n g l a y
t ứ c g i ậ n	t ứ c g i ậ n
đ à m p h á n	đ à m p h á n
m ư ờ i s á u	m ư ờ i s á u
s á t n h ậ p	s á t n h ậ p
m ĩ t h u ậ t	m ĩ t h u ậ t
đ ĩ a c ứ n g	đ ĩ a c ứ n g
a m t ư ờ n g	a m t ư ờ n g
c u n g c ầ u	c u n g c ầ u
q u a y t a y	q u a y t a y
x â m p h ạ m	x â m p h ạ m
b ỏ p h i ế u	b ỏ p h i ế u
â m t h a n h	â m t h a n h
p h o n g b ì	p h o n g b ì
ứ n g v i ê n	ứ n g v i ê n
k h o a i s ọ	k h o a i s ọ
n h ậ t t â m	n h ậ t t â m
b í c h q u y	b í c h q u y
k h ú c m ắ c	k h ú c m ắ c
l ư u l o á t	l ư u l o á t
c h i m l ạ c	c h i m l ạ c
t h â n y ê u	t h â n y ê u
b ù i n g ù i	b ù i n g ù i
c ứ u c á n h	c ứ u c á n h
t h à n h đ ô	t h à n h đ ô
v u i n h ộ n	v u i n h ộ n
n ồ n g n à n	n ồ n g n à n
c a n h g á c	c a n h g á c
g i a đ ị n h	g i a đ ị n h
h ợ p c h ấ t	h ợ p c h ấ t
c ầ u l ô n g	c ầ u l ô n g
t r u y c ậ p	c h u y c ậ p
n g u y h ạ i	n g u y h ạ i
b ả n t í n h	b ả n t í n h
b ề n v ữ n g	b ề n v ữ n g
h o à n h ậ p	h o à n h ậ p
h ả i q u a n	h ả i q u a n
g i a o ư ớ c	g i a o ư ớ c
b ồ n c h ồ n	b ồ n c h ồ n
b ắ p c h â n	b ắ p c h â n
k ế t l i ễ u	k ế t l i ễ u
c ả i t i ế n	c ả i t i ế n
b ắ c k i n h	b ắ c k i n h
k i ề u h ố i	k i ề u h ố i
s ố n g c ò n	s ố n g c ò n
h ú n g l ì u	h ú n g l ì u
c a i q u ả n	c a i q u ả n
t h a y m ặ t	t h a y m ặ t
l a n g b ă m	l a n g b ă m
m ắ t x a n h	m ắ t x a n h
m ồ n g t ơ i	m ồ n g t ơ i
p h ố i h ợ p	p h ố i h ợ p
k ĩ t h u ậ t	k ĩ t h u ậ t
á n h n h ì n	á n h n h ì n
t a i ư ơ n g	t a i ư ơ n g
h o à n h ả o	h o à n h ả o
đ ổ i t h a y	đ ổ i t h a y
h ố i t i ế c	h ố i t i ế c
l ợ n r ừ n g	l ợ n r ừ n g
h ệ t h ố n g	h ệ t h ố n g
n ư ớ c c ấ t	n ư ớ c c ấ t
q u ê q u á n	q u ê q u á n
t r ự c h ệ	t r ự c h ệ
k h ủ n g b ố	k h ủ n g b ố
n ư ớ c d ừ a	n ư ớ c d ừ a
c h è o b ẻ o	c h è o b ẻ o
v u i t ư ơ i	v u i t ư ơ i
c ơ m m u ố i	c ơ m m u ố i
n a m q u ố c	n a m q u ố c
c á c h ạ c h	c á c h ạ c h
a m o n i	a m o n i
c a o ố c	c a o ố c
đ ầ m ấ m	đ ầ m ấ m
ă n ả n h	ă n ả n h
b ạ c m á	b ạ c m á
đ â u đ ó	đ â u đ ó
ê m d ị u	ê m d ị u
a o ư ớ c	a o ư ớ c
r a đ o n	r a đ o n
ô n g ấ y	ô n g ấ y
đ à l ạ t	đ à l ạ t
đ ủ đ ầ y	đ ủ đ ầ y
b ọ r ù a	b ọ r ù a
a n l ạ c	a n l ạ c
s ự v ậ t	s ự v ậ t
đ ạ i s ố	đ ạ i s ố
c ờ b ạ c	c ờ b ạ c
b ú t b i	b ú t b i
đ á o n g	đ á o n g
a n h v ợ	a n h v ợ
á đ ô n g	á đ ô n g
l ậ p d ị	l ậ p d ị
g ạ o đ ỏ	g ạ o đ ỏ
m ộ t í t	m ộ t í t
ẩ n h o ạ	ẩ n h o ạ
m ặ t n ạ	m ặ t n ạ
y ê n ổ n	y ê n ổ n
b a o b ì	b a o b ì
đ ề n b ù	đ ề n b ù
t ạ i h ạ	t ạ i h ạ
t â y ú c	t â y ú c
b ù đ ầ u	b ù đ ầ u
đ ộ f	đ ộ f
h ạ b ệ	h ạ b ệ
y h ọ c	y h ọ c
b ộ h ạ	b ộ h ạ
đ i b ộ	đ i b ộ
ì ạ c h	ì ạ c h
đ ạ i ý	đ ạ i ý
đ ị a y	đ ị a y
h ợ p â m	h ợ p â m
t ệ n ạ n	t ệ n ạ n
c á n b ộ	c á n b ộ
đ á o đ ể	đ á o đ ể
ỉ a đ ù n	ỉ a đ ù n
b ọ x í t	b ọ x í t
á p l ự c	á p l ự c
b ì n h a n	b ì n h a n
u ể o ả i	u ể o ả i
o s i m i	o x i m i
m a r i a	m a r i a
s ợ s ệ t	s ợ s ệ t
k ỉ l ụ c	k ỉ l ụ c
a n h ấ y	a n h ấ y
s â u b ọ	s â u b ọ
ủ n g h ộ	ủ n g h ộ
t ụ t ậ p	t ụ t ậ p
đ ị a l í	đ ị a l í
u r a n i	u r a n i
đ ệ n h ị	đ ệ n h ị
d ự b á o	d ự b á o
b ả o v ệ	b ả o v ệ
n ộ i t h ị	n ộ i t h ị
ư u đ ã i	ư u đ ã i
ă n m ặ c	ă n m ặ c
đ ứ c b à	đ ứ c b à
đ à n á p	đ à n á p
l ạ c đ à	l ạ c đ à
b ú p b ê	b ú p b ê
t ị n ạ n	t ị n ạ n
x a v i ê	x a v i ê
h ộ i â m	h ộ i â m
ô n g k ẹ	ô n g k ẹ
đ ạ i s ứ	đ ạ i s ứ
a n b à i	a n b à i
d ư l u ậ n	d ư l u ậ n
l ị c h s ự	l ị c h s ự
s á t s ạ t	s á t s ạ t
h ì h ụ c	h ì h ụ c
h ồ đ ồ n g	h ồ đ ồ n g
d ẫ n đ ầ u	d ẫ n đ ầ u
s a y đ ắ m	s a y đ ắ m
h ậ u m ô n	h ậ u m ô n
x â m h ạ i	x â m h ạ i
t ứ c t ố c	t ứ c t ố c
b á n c ầ u	b á n c ầ u
b ủ n x ỉ n	b ủ n x ỉ n
b à n t a y	b à n t a y
q u â n s ự	q u â n s ự
r ấ t m ự c	r ấ t m ự c
p r ô t o n	p r ô t o n
c a o đ à i	c a o đ à i
d u m ụ c	d u m ụ c
y v i ệ n	y v i ệ n
t ụ h ọ p	t ụ h ọ p
b ậ t m í	b ậ t m í
b í đ a o	b í đ a o
đ è n đ ỏ	đ è n đ ỏ
b ả o a n	b ả o a n
y l ệ n h	y l ệ n h
đ ạ i l í	đ ạ i l í
đ ô n g á	đ ô n g á
b ò c ạ p	b ò c ạ p
b ề m ặ t	b ề m ặ t
b ố n b ể	b ố n b ể
u ỷ b a n	u ỷ b a n
đ ồ h ộ p	đ ồ h ộ p
ô n t ậ p	ô n t ậ p
n a m b ộ	n a m b ộ
ý đ ị n h	ý đ ị n h
c a o đ ộ	c a o đ ộ
b ị c a n	b ị c a n
a t u l a	a t u l a
đ ộ i c a	đ ộ i c a
m ứ c đ ộ	m ứ c đ ộ
đ ạ i t á	đ ạ i t á
c ơ h ọ c	c ơ h ọ c
b ộ t m ì	b ộ t m ì
x ế đ ộ p	x ế đ ộ p
â u l ạ c	â u l ạ c
k ì h ọ c	k ì h ọ c
đ ạ i t ừ	đ ạ i t ừ
đ a đ ả o	đ a đ ả o
t ủ i t h â n	t ủ i t h â n
t h u ỷ l ô i	t h u ỷ l ô i
k i ể u c h ữ	k i ể u c h ữ
t ẩ y c h a y	t ẩ y c h a y
t h u ố c m ê	t h u ố c m ê
c h i t i ế t	t r i t i ế t
d ũ n g k h í	d ũ n g k h í
t i n h d ầ u	t i n h d ầ u
n a m t í n h	n a m t í n h
l à m t ì n h	l à m t ì n h
h o à n g t ử	h o à n g t ử
s ố n g t h ử	s ố n g t h ử
g i a n h ậ p	g i a n h ậ p
t h u n h ậ p	t h u n h ậ p
r ă n g c ấ m	r ă n g c ấ m
t h ị t r ấ n	t h ị t r ấ n
p h á t t á n	p h á t t á n
t r á n h r a	t r á n h r a
t í c h t ắ c	t í c h t ắ c
n h á t c á y	n h á t c á y
t r á i t i m	t r á i t i m
l à n g x ó m	l à n g x ó m
h ì n h m ẫ u	h ì n h m ẫ u
m ì n h m ẩ y	m ì n h m ẩ y
k h ấ n v á i	k h ấ n v á i
p h ạ m t r ù	p h ạ m t r ù
l ộ t r ì n h	l ộ t r ì n h
s i n h s ô i	s i n h s ô i
c h ữ a t r ị	c h ữ a t r ị
t ầ m p h à o	t ầ m p h à o
m ã n g c ầ u	m ã n g c ầ u
t ư ơ i t r ẻ	t ư ơ i t r ẻ
t h ấ u t h ị	t h ấ u t h ị
m i ễ n p h í	m i ễ n p h í
l a i c h â u	l a i c h â u
c â n x ứ n g	c â n x ứ n g
n ó i t h ầ m	n ó i t h ầ m
n h â n d â n	n h â n d â n
c a o s a n g	c a o s a n g
t h a m l a m	t h a m l a m
p h á t x í t	p h á t x í t
c h ấ t x á m	c h ấ t x á m
t r u n g s ĩ	t r u n g s ĩ
l i n h c ữ u	l i n h c ữ u
s ơ n t i n h	s ơ n t i n h
t ổ n g t h ể	t ổ n g t h ể
t r è o c â y	t r è o c â y
x i n h m u n	s i n h m u n
d ĩ n h i ê n	d ĩ n h i ê n
m a n h n h a	m a n h n h a
n h ũ d a n h	n h ũ d a n h
l i n h c ả m	l i n h c ả m
q u a n g t ử	q u a n g t ử
h à o h ứ n g	h à o h ứ n g
m ớ i t i n h	m ớ i t i n h
n g â n q u <<unk>>	n g â n q u <unk>
n g ắ t l ờ i	n g ắ t l ờ i
n g à y n a y	n g à y n a y
v u k h ố n g	v u k h ố n g
t ầ n g l ớ p	t ầ n g l ớ p
c ả m h ứ n g	c ả m h ứ n g
l í t ư ở n g	l í t ư ở n g
s a o c h ổ i	s a o c h ổ i
l ư ỡ n g h à	l ư ỡ n g h à
k i ể m t r a	k i ể m t r a
t h ò i l ò i	t h ò i l ò i
n h ạ c t r ẻ	n h ạ c t r ẻ
s i n h t ồ n	s i n h t ồ n
p h ú n ô n g	p h ú n ô n g
t i ể u t h ư	t i ể u t h ư
m ã n t í n h	m ã n t í n h
t h a n v ã n	t h a n v ã n
c h ỉ t i ê u	c h ỉ t i ê u
k í n h r â m	k í n h r â m
k i m n g â n	k i m n g â n
t h ố n g k ê	t h ố n g k ê
p h é p m ầ u	p h é p m ầ u
t r ợ g i ú p	t r ợ g i ú p
p h a o c â u	p h a o c â u
d ấ n t h â n	d ấ n t h â n
t i n h c ầ u	t i n h c ầ u
b a t o o n g	b a t o o n g
n g ứ a m ắ t	n g ứ a m ắ t
s ử a c h ữ a	s ử a c h ữ a
d u n g t h ứ	d u n g t h ứ
d u n g t h a	d u n g t h a
c h ế n h ạ o	c h ế n h ạ o
c â n n h ắ c	c â n n h ắ c
x u h ư ớ n g	x u h ư ớ n g
s ữ a c h u a	s ữ a c h u a
h o ả t á n g	h o ả t á n g
l ở m c h ở m	l ở m c h ở m
t r ò n x o e	t r ò n x o e
t â n t h ờ i	t â n t h ờ i
g i ẻ r á c h	r ẻ r á c h
r ă n g c ử a	r ă n g c ử a
p h ầ n l ớ n	p h ầ n l ớ n
n h ã n h ặ n	n h ã n h ặ n
l â m t h ờ i	l â m t h ờ i
c h ỗ đ ứ n g	c h ỗ đ ứ n g
t h ự c t h à	t h ự c t h à
t h u t h ậ p	t h u t h ậ p
n h ả y d â y	n h ả y d â y
g i á m t h ị	g i á m t h ị
r i ê n g r ẽ	r i ê n g r ẽ
n g à y t ế t	n g à y t ế t
b i n h n h ì	b i n h n h ì
v ô h ư ớ n g	v ô h ư ớ n g
p h á o t a y	p h á o t a y
k h ạ c n h ổ	k h ạ c n h ổ
s o n g n g ữ	s o n g n g ữ
m ù q u á n g	m ù q u á n g
h o ả t i n h	h o ả t i n h
s ắ c t h á i	s ắ c t h á i
g á i n h ả y	g á i n h ả y
c ắ m s ừ n g	c ắ m s ừ n g
h à n g x ó m	h à n g x ó m
c h i a t a y	c h i a t a y
t h ụ t i n h	t h ụ t i n h
h ô n n h â n	h ô n n h â n
c h ồ m h ỗ m	c h ồ m h ỗ m
s ơ n t h u ỷ	s ơ n t h u ỷ
c o n c h á u	c o n c h á u
p h a t r ộ n	p h a t r ộ n
c h ủ t ị c h	c h ủ t ị c h
r i ê n g l ẻ	r i ê n g l ẻ
c h ú n g n ó	c h ú n g n ó
t h i ê n s ứ	t h i ê n s ứ
t h i ể u s ố	t h i ể u s ố
q u â n c h ủ	q u â n c h ủ
c h ế x u ấ t	c h ế x u ấ t
l ă n g t r ụ	l ă n g t r ụ
v i t r ù n g	v i t r ù n g
g i ặ t g i ũ	d ặ t g i ũ
t r ạ n g t ừ	t r ạ n g t ừ
c ả m n ắ n g	c ả m n ắ n g
t ô n x ư n g	t ô n x ư n g
n e m c h u a	n e m c h u a
k h í h i ế m	k h í h i ế m
c h ủ q u a n	c h ủ q u a n
v ế t t í c h	v ế t t í c h
g i a n d ố i	g i a n d ố i
s ă n c h ắ c	s ă n c h ắ c
s a h o à n g	s a h o à n g
v i n h s ơ n	v i n h s ơ n
h à n g r à o	h à n g r à o
d u y n h ấ t	d u y n h ấ t
t r à o l ư u	t r à o l ư u
p h ò n g m ổ	p h ò n g m ổ
g i ố n g m á	r ố n g m á
g i ả i c ứ u	g i ả i c ứ u
k i ê n t r ì	k i ê n t r ì
p h â n t á n	p h â n t á n
p h à n n à n	p h à n n à n
g i a đ ì n h	g i a đ ì n h
n h ả y m ú a	n h ả y m ú a
t u ổ i t h ơ	t u ổ i t h ơ
c a m t h ả o	c a m t h ả o
c ổ p h i ế u	c ổ p h i ế u
t ô n t h ấ t	t ô n t h ấ t
y ê n n g h ỉ	y ê n n g h ỉ
s o n g n g ư	s o n g n g ư
l ô i t h ô i	l ô i t h ô i
p h ả n c ả m	p h ả n c ả m
g i ả i t á n	g i ả i t á n
t h ị t c h ó	t h ị t c h ó
h ổ p h á c h	h ổ p h á c h
t r ố n t ì m	t r ố n t ì m
s ư n ư ơ n g	s ư n ư ơ n g
c á n h ồ n g	c á n h ồ n g
c h ầ u v ă n	c h ầ u v ă n
t ư t ư ở n g	t ư t ư ở n g
p h i c ô n g	p h i c ô n g
k h í c h l ệ	k h í c h l ệ
v ề h ư ớ n g	v ề h ư ớ n g
t h ì n h à n	t h ì n h à n
t i ê u c h í	t i ê u c h í
s ẵ n s à n g	s ẵ n s à n g
h ì n h c ầ u	h ì n h c ầ u
t h e o d õ i	t h e o d õ i
l ắ p g h é p	l ắ p g h é p
c h ặ t c h ẽ	c h ặ t c h ẽ
g h i n h ậ n	g h i n h ậ n
h ă n g h á i	h ă n g h á i
n a m c h â m	n a m c h â m
c ứ n g r ắ n	c ứ n g r ắ n
c ả m g i á c	c ả m g i á c
c h i a c ắ t	c h i a c ắ t
c h à o m ờ i	c h à o m ờ i
n h â n t h ọ	n h â n t h ọ
m à n g m ề m	m à n g m ề m
s a i t r á i	s a i t r á i
x ô n g n h à	x ô n g n h à
v ằ n t h ắ n	v ằ n t h ắ n
b ă n g g h ế	b ă n g g h ế
t r á i c â y	t r á i c â y
c ứ u t i n h	c ứ u t i n h
l ê t r i ề u	l ê t r i ề u
h o à n g s a	h o à n g s a
d â y g i à y	d â y g i à y
h à n g h ả i	h à n g h ả i
n a m t r ầ m	n a m t r ầ m
t í n h n ế t	t í n h n ế t
h o a g i á p	h o a g i á p
h o à n g h à	h o à n g h à
n h à b i n h	n h à b i n h
t à i n ă n g	t à i n ă n g
t â m t í n h	t â m t í n h
t h i ề n v u	t h i ề n v u
t h á n h t ổ	t h á n h t ổ
t r ă m n ă m	c h ă m n ă m
t r ừ n g t r ị	t r ừ n g t r ị
p h ầ n c ứ n g	p h ầ n c ứ n g
n g à n v à n g	n g à n v à n g
n h ấ p n h á y	n h ấ p n h á y
t h â n m ì n h	t h â n m ì n h
t h ủ t h à n h	t h ủ t h à n h
n g ư ờ i n h à	n g ư ờ i n h à
n h ố n n h á o	n h ố n n h á o
t h ố n g c h ế	t h ố n g c h ế
c h á n n g ấ y	t r á n n g ấ y
c h ô m c h ô m	c h ô m c h ô m
c h ư n g c ấ t	t r ư n g c ấ t
t h à n h n g ữ	t h à n h n g ữ
n h a p h i ế n	n h a p h i ế n
t r a n h t h ủ	t r a n h t h ủ
t r â n t r ố i	t r â n t r ố i
k h ử t r ù n g	k h ử t r ù n g
t h a m k h ả o	t h a m k h ả o
c h e o c h e o	c h e o c h e o
n g a y n g ắ n	n g a y n g ắ n
g i ả i k h á t	g i ả i k h á t
t h ô n g g i a	t h ô n g r a
n g ứ a n g á y	n g ứ a n g á y
n h ú t n h á t	n h ú t n h á t
h o à n g p h i	h o à n g p h i
h o a n g p h í	h o a n g p h í
k h á t k h a o	k h á t k h a o
n g à y s i n h	n g à y s i n h
t ì n h h ì n h	t ì n h h ì n h
t ì n h n h â n	t ì n h n h â n
n h ả y n h ó t	n h ả y n h ó t
t ắ c n g h ẽ n	t ắ c n g h ẽ n
g i a n h à n g	g i a n h à n g
g i ấ y p h é p	d ấ y p h é p
s ở t r ư ờ n g	s ở t r ư ờ n g
t h ầ n t h á i	t h ầ n t h á i
q u á k h í c h	q u á k h í c h
n h á o n h à o	n h á o n h à o
t h ử t h á c h	t h ử t h á c h
n h ấ t t h ờ i	n h ấ t t h ờ i
h ồ i t r à n g	h ồ i t r à n g
m i n h t i n h	m i n h t i n h
t h ế c h i ế n	t h ế c h i ế n
n a m c h í n h	n a m c h í n h
t i n h t i n h	t i n h t i n h
g i u n t r ò n	r u n t r ò n
p h o n g p h ú	p h o n g p h ú
c h i p h i ế u	c h i p h i ế u
t h ấ t t ì n h	t h ấ t t ì n h
t à i c h í n h	t à i c h í n h
t h ằ n g n à y	t h ằ n g n à y
t h ầ y g i á o	t h ầ y g i á o
t à n n h a n g	t à n n h a n g
p h ấ n t r ắ n g	p h ấ n t r ắ n g
t r a n g t r ả i	t r a n g t r ả i
t h ỉ n h g i á o	t h ỉ n h d á o
c ă n g t h ẳ n g	c ă n g t h ẳ n g
p h ả n k h á n g	p h ả n k h á n g
c h â n c h í n h	c h â n c h í n h
p h ấ n k h í c h	p h ấ n k h í c h
t h ủ t r ư ở n g	t h ủ t r ư ở n g
t h â n t h í c h	t h â n t h í c h
m à n g t r i n h	m à n g t r i n h
c h ấ n c h ỉ n h	c h ấ n c h ỉ n h
t r à n g p h á o	t r à n g p h á o
n g a n g t à n g	n g a n g t à n g
t h ư ờ n g t r ú	t h ư ờ n g t r ú
n g à y t h á n g	n g à y t h á n g
p h i t r ư ờ n g	p h i t r ư ờ n g
t r ă n g t r ò n	t r ă n g t r ò n
g i á n g s i n h	g i á n g s i n h
p h ẳ n g p h i u	p h ẳ n g p h i u
n g h ỉ d ư ỡ n g	n g h ỉ d ư ỡ n g
c h í n h t h ứ c	c h í n h t h ứ c
p h ư ơ n g p h i	p h ư ơ n g p h i
n g à n h n g h ề	n g à n h n g h ề
c h ỉ n h t r a n g	c h ỉ n h t r a n g
l o o n g t o o n g	l o o n g t o n g
c h í n h n g h ĩ a	c h í n h n g h ĩ a
t h á n g c h í n	t h á n g c h í n
t h ứ c t ỉ n h	t h ứ c t ỉ n h
t h à n h p h ố	t h à n h p h ố
t h i ê n t h ể	t h i ê n t h ể
t h u ế k h o á	t h u ế k h o á
t r u n g t h u	t r u n g t h u
t ư n g h ử n g	t ư n g h ử n g
t r á i n g a n g	t r á i n g a n g
n h à t r ư ờ n g	n h à t r ư ờ n g
p h ố p h ư ờ n g	p h ố p h ư ờ n g
g i ỏ i g i a n g	r ỏ i g i a n g
t h ư ơ n g g i a	t h ư ơ n g r a
g i ẻ t r i ê n g	g i ẻ t r i ê n g
t h â n h ì n h	t h â n h ì n h
k í c h t h í c h	k í c h t h í c h
n h â n c h ứ n g	n h â n c h ứ n g
t h a i n g h é n	t h a i n g h é n
s á n g t r ư n g	s á n g t r ư n g
t r ứ n g c h ấ y	c h ứ n g c h ấ y
t h ứ t r ư ở n g	t h ứ t r ư ở n g
m i n h c h ứ n g	m i n h c h ứ n g
g i ả i t h í c h	g i ả i t h í c h
l ă n g n h ă n g	l ă n g n h ă n g
c h ứ n g m i n h	c h ứ n g m i n h
t h ẳ n g t h ắ n	t h ẳ n g t h ắ n
t r ò n t r ĩ n h	t r ò n t r ĩ n h
t r ă n g n o n	t r ă n g n o n
c h ư ở n g c ơ	c h ư ở n g c ơ
c h ấ t p h á c	c h ấ t p h á c
t h ấ y c h ư a	t h ấ y c h ư a
t h ủ t ư ớ n g	t h ủ t ư ớ n g
n h â n t h â n	n h â n t h â n
t h ắ t l ư n g	t h ắ t l ư n g
s a n g c h ấ n	s a n g c h ấ n
t i n h t h ầ n	t i n h t h ầ n
l ã n g n h â n	l ã n g n h â n
q u á t r ì n h	q u á t r ì n h
t h a n g m á y	t h a n g m á y
n g à y n g à y	n g à y n g à y
c ư ơ n g t h i	c ư ơ n g t h i
k h á c n h a u	k h á c n h a u
l i n h t i n h	l i n h t i n h
p h ê c h u ẩ n	p h ê c h u ẩ n
c h i ê u t r ò	c h i ê u t r ò
n h á o n h á c	n h á o n h á c
n h á y n h á y	n h á y n h á y
c h ắ c c h ắ n	c h ắ c c h ắ n
n h ồ i n h é t	n h ồ i n h é t
v ư ơ n g g i a	v ư ơ n g g i a
t h á n g t á m	t h á n g t á m
n g ẫ u h ứ n g	n g ẫ u h ứ n g
t r ẻ t r u n g	t r ẻ t r u n g
c h ố n g t r ả	c h ố n g t r ả
t à u n g ầ m	t à u n g ầ m
k h a i t â m	k h a i t â m
n h ắ n g ử i	n h ắ n g ử i
q u ầ n t h ể	q u ầ n t h ể
ố n g n g h e	ố n g n g h e
c ấ u h ì n h	c ấ u h ì n h
q u y n h ơ n	q u y n h ơ n
t r ù n g t u	t r ù n g t u
t h â n m ẫ u	t h â n m ẫ u
n g ứ a t a y	n g ứ a t a y
c h ò m s a o	c h ò m s a o
t i ế n g m ĩ	t i ế n g m ĩ
n g ó n t a y	n g ó n t a y
n g ă n n g ừ a	n g ă n n g ừ a
p h ì c ư ờ i	p h ì c ư ờ i
t i ề u p h u	t i ề u p h u
s u y t í n h	s u y t í n h
p h ò n g n g ủ	p h ò n g n g ủ
p h a n r a n g	p h a n r a n g
n g â n h à n g	n g â n h à n g
t ả k h u y n h	t ả k h u y n h
h ì n h t h ứ c	h ì n h t h ứ c
p h ì n h i ê u	p h ì n h i ê u
h à n h n g h ề	h à n h n g h ề
n ó i t h ẳ n g	n ó i t h ẳ n g
n g h ẽ n t ắ c	n g h ẽ n t ắ c
d ẫ n c h ứ n g	d ẫ n c h ứ n g
k h ố n g c h ế	k h ố n g c h ế
t h ắ n g d ề n	t h ắ n g d ề n
r ừ n g t h ư a	r ừ n g t h ư a
t h a o t h a o	t h a o t h a o
h à n g n g à y	h à n g n g à y
n g h ệ t ĩ n h	n g h ệ t ĩ n h
c ơ t r ư ở n g	c ơ t r ư ở n g
n h â n g i a n	n h â n g i a n
c h à o m ừ n g	c h à o m ừ n g
p h ấ n k h ở i	p h ấ n k h ở i
g i a o p h ố i	g i a o p h ố i
t h a n h n h ã	t h a n h n h ã
c h ứ c n ă n g	c h ứ c n ă n g
v ữ n g c h ắ c	v ữ n g c h ắ c
p h ổ t h ô n g	p h ổ t h ô n g
n h â n t í n h	n h â n t í n h
t h ă m t h ẳ m	t h ă m t h ẳ m
p h ă n g t e o	p h ă n g t e o
t r ô i c h ả y	c h ô i c h ả y
g i a i t h ừ a	g i a i t h ừ a
q u a n g p h ổ	q u a n g p h ổ
h ì n h d á n g	h ì n h d á n g
h ứ n g k h ở i	h ứ n g k h ở i
c h â n t r ờ i	c h â n t r ờ i
t h ơ m n g á t	t h ơ m n g á t
t r ư ờ n g k ỉ	t r ư ờ n g k ỉ
t h á n g s á u	t h á n g s á u
g i ả i p h á p	g i ả i p h á p
t h o i t h ó p	t h o i t h ó p
t ừ n g t r ả i	t ừ n g t r ả i
t h i ê n n g a	t h i ê n n g a
t h á n h g i a	t h á n h g i a
m à n g n h ầ y	m à n g n h ầ y
t í n h t ì n h	t í n h t ì n h
k h a o k h á t	k h a o k h á t
c o c k t a i l	c o c k t a y
n g h i p h ạ m	n g h i p h ạ m
n h ấ p n h ỏ m	n h ấ p n h ỏ m
s á n g s ớ m	s á n g s ớ m
t h á n g n ă m	t h á n g n ă m
g i a n g t â y	g i a n g t â y
t h ờ i k h ắ c	t h ờ i k h ắ c
n ă m t h á n g	n ă m t h á n g
n h â n t h ầ n	n h â n t h ầ n
t r ắ n g h ế u	t r ắ n g h ế
d â u t r ắ n g	d â u t r ắ n g
p h ẩ m c h ấ t	p h ẩ m c h ấ t
t í n h n ă n g	t í n h n ă n g
t h ẩ m p h á n	t h ẩ m p h á n
n h à k h á c h	n h à k h á c h
h ì n h c h ó p	h ì n h c h ó p
s ù n g b á i	s ù n g b á i
đ ị a g i ớ i	đ ị a g i ớ i
x e t ắ c x i	x e t ắ c x i
r ố i l o ạ n	r ố i l o ạ n
b á n h k e m	b á n h k e m
đ á n h r ắ m	đ á n h r ắ m
s i n h d ụ c	s i n h d ụ c
n g u ỵ t ạ o	n g u ỵ t ạ o
v i ệ t t â n	v i ệ t t â n
v õ n g m ạ c	v õ n g m ạ c
v ị t x i ê m	v ị t x i ê m
c ộ n g h o à	c ộ n g h o à
c ộ t s ố n g	c ộ t s ố n g
p h ạ m t ộ i	p h ạ m t ộ i
t i ể u b a n	t i ể u b a n
l ú a m ạ c h	l ú a m ạ c h
ứ n g d ụ n g	ứ n g d ụ n g
k i ệ t s ứ c	k i ệ t s ứ c
c h ọ c l é t	t r ọ c l é t
h i ệ u q u ả	h i ệ u q u ả
m ặ t đ ứ n g	m ặ t đ ứ n g
đ i ế u c à y	đ i ế u c à y
t u y ế n l ệ	t u y ế n l ệ
p r o m e t i	p r o m e t i
h à o h i ệ p	h à o h i ệ p
b á n h l á i	b á n h l á i
t h ầ n đ ạ o	t h ầ n đ ạ o
t h u ộ c h ạ	t h u ộ c h ạ
n ộ i d u n g	n ộ i d u n g
đ ô n g n a m	đ ô n g n a m
t ê n h i ệ u	t ê n h i ệ u
b a o d u n g	b a o d u n g
b ả n h m ắ t	b ả n h m ắ t
m ộ c t i n h	m ộ c t i n h
đ è n l ồ n g	đ è n l ồ n g
đ ứ n g đ ắ n	đ ứ n g đ ắ n
h i ề n h ậ u	h i ề n h ậ u
l ự a c h ọ n	l ự a c h ọ n
g i ặ t g ỵ a	g i ặ t g ị a
y ê u s á c h	y ê u s á c h
v i ệ t n a m	v i ệ t n a m
t r i ệ t đ ể	t r i ệ t đ ể
t u y ê n b ố	t u y ê n b ố
n ặ c d a n h	n ặ c d a n h
đ ắ k n ô n g	đ ắ k n ô n g
m ư ờ i b ố n	m ư ờ i b ố n
n g ụ c t ố t	n g ụ c t ố t
h u y ề n b í	h u y ề n b í
b ả o h i ể m	b ả o h i ể m
m ặ n n ồ n g	m ặ n n ồ n g
p h ú c l ợ i	p h ú c l ợ i
đ ị a c h ấ n	đ ị a c h ấ n
l i n h m ụ c	l i n h m ụ c
l ạ n h l ẽ o	l ạ n h l ẽ o
n ổ i l o ạ n	n ổ i l o ạ n
đ à n l u ý t	đ à n l u ý t
b u ồ n r ầ u	b u ồ n r ầ u
b ả o b ì n h	b ả o b ì n h
t u ỳ t i ệ n	t u ỳ t i ệ n
f l e r o v i	f l e r o v i
c ạ c m ạ n g	c ạ c m ạ n g
u n g d u n g	u n g d u n g
b á q u y ề n	b á q u y ề n
đ ồ n g t â m	đ ồ n g t â m
v e n b i ể n	v e n b i ể n
c ấ p b á c h	c ấ p b á c h
q u y l u ậ t	q u y l u ậ t
n g ọ c l a n	n g ọ c l a n
v ư ợ n c á o	v ư ợ n c á o
q u ạ t m á y	q u ạ t m á y
đ ầ u q u â n	đ ầ u q u â n
đ ậ u l ă n g	đ ậ u l ă n g
ý n g u y ệ n	ý n g u y ệ n
b a o q u á t	b a o q u á t
b ả o l ã n h	b ả o l ã n h
l ô g a r i t	l ô g a r i t
b ó n g m ề m	b ó n g m ề m
r ư ợ u t á o	d i ệ u t á o
đ á m c ư ớ i	đ á m c ư ớ i
b ề n c h ặ t	b ề n c h ặ t
c h ậ t v ậ t	c h ậ t v ậ t
đ á n h c ắ p	đ á n h c ắ p
l â m đ ồ n g	l â m đ ồ n g
b á n h p í a	b á n h p í a
b ộ i p h ả n	b ộ i p h ả n
b ấ t c ô n g	b ấ t c ô n g
t i ệ n í c h	t i ệ n í c h
t r ụ c c a o	t r ụ c c a o
m a r t i n ô	m a t i n ô
t e c n e x i	t e c n e x i
c a m đ o a n	c a m đ o a n
h ì n h h ọ c	h ì n h h ọ c
q u á i v ậ t	q u á i v ậ t
n h ậ t b á o	n h ậ t b á o
b í c h h o ạ	b í c h h o ạ
đ ồ n g n a i	đ ồ n g n a i
a n h q u ố c	a n h q u ố c
b ạ o c h ú a	b ạ o c h ú a
q u y đ ị n h	q u y đ ị n h
t u ầ n b á o	t u ầ n b á o
d i ễ n đ ơ n	d i ễ n đ ơ n
đ ô n g l à o	đ ô n g l à o
đ ố t s ố n g	đ ố t s ố n g
k i l ô m é t	k i l ô m e t
b ắ n c u n g	b ắ n c u n g
đ ó n t i ế p	đ ó n t i ế p
d a n h h o ạ	d a n h h o ạ
đ ó n g g ó p	đ ó n g g ó p
c ư ờ n g đ ộ	c ư ờ n g đ ộ
h ọ p h à n h	h ọ p h à n h
đ ộ i h ì n h	đ ộ i h ì n h
b ó n g t ố i	b ó n g t ố i
m ư ờ i b ả y	m ư ờ i b ả y
y ê u q u á i	y ê u q u á i
t i ề n m ặ t	t i ề n m ặ t
b á n c h ạ y	b á n c h ạ y
v ặ t v ã n h	v ặ t v ã n h
t í n d ụ n g	t í n d ụ n g
c ả n h v ậ t	c ả n h v ậ t
h ệ t r ọ n g	h ệ t r ọ n g
n i ê m m ạ c	n i ê m m ạ c
đ ấ t n ư ớ c	đ ấ t n ư ớ c
k ị c h b ả n	k ị c h b ả n
h ạ t t i ê u	h ạ t t i ê u
ư ớ c m u ố n	ư ớ c m u ố n
l ồ n g đ è n	l ồ n g đ è n
v ă n h ọ c	v ă n h ọ c
b a o b á p	b a o b á p
đ ạ i n ã o	đ ạ i n ã o
a t a t i n	a t a t i n
c ô đ ọ n g	c ô đ ọ n g
đ ặ c h ữ u	đ ặ c h ữ u
đ ĩ a đ ơ n	đ ĩ a đ ơ n
đ à o b ớ i	đ à o b ớ i
v a n a đ i	v a n a đ i
b ệ n h l í	b ệ n h l í
đ à đ i ể u	đ à đ i ể u
d ị đ o a n	d ị đ o a n
l ồ n g l ộ n	l ồ n g l ộ n
b i ế t m ấ y	b i ế t m ấ y
đ è n x a n h	đ è n x a n h
t ự đ i ể n	t ự đ i ể n
n h ậ t b ổ n	n h ậ t b ổ n
l o r e n x i	l o r e n x i
đ ầ u l ò n g	đ ầ u l ò n g
m ặ t t i ề n	m ặ t t i ề n
t á c d ụ n g	t á c d ụ n g
s â m b a n h	s â m b a n h
c u n g đ ấ u	c u n g đ ấ u
p h ú c h ậ u	p h ú c h ậ u
t i ế p x ú c	t i ế p s ú c
g i a c ô b ê	g i a c ô b ê
t i ề n b ố i	t i ề n b ố i
n h ậ t b ả n	n h ậ t b ả n
h ỏ n g h ó c	h ỏ n g h ó c
n ô n g s ợ t	n ô n g s ợ t
c ự c t i ể u	c ự c t i ể u
b ạ n g á i	b ạ n g á i
b ắ c k ạ n	b ắ c k ạ n
n ộ i l ự c	n ộ i l ự c
ư u v i ệ t	ư u v i ệ t
m ô n i c a	m ô n i c a
d ạ i d ộ t	d ạ i d ộ t
b ứ c b ố i	b ứ c b ố i
v i ệ t v ị	v i ệ t v ị
ô n g n ộ i	ô n g n ộ i
h ộ p đ ê m	h ộ p đ ê m
b á n h b ó	b á n h b ó
s ô i s ụ c	x ô i s ụ c
b ọ n g ự a	b ọ n g ự a
b a n đ ê m	b a n đ ê m
m ậ p m ạ p	m ậ p m ạ p
c ạ m b ẫ y	c ạ m b ẫ y
p h á t đ ạ t	p h á t đ ạ t
b ò n b o n	b ò n b o n
á c m ộ n g	á c m ộ n g
p a l a đ i	p a l a đ i
đ ị a c ầ u	đ ị a c ầ u
h o a l ụ c	h o a l ụ c
đ á n h đ u	đ á n h đ u
đ ấ m b ó p	đ ấ m b ó p
l ò v i b a	l ò v i b a
h ọ c h ỏ i	h ọ c h ỏ i
t o ạ đ à m	t o ạ đ à m
x e đ i ệ n	x e đ i ệ n
b ắ c đ ẩ u	b ắ c đ ẩ u
b ắ t c ó c	b ắ t c ó c
c ử đ ộ n g	c ử đ ộ n g
t ậ p q u á n	t ậ p q u á n
q u ầ n s ị p	q u ầ n s ị p
đ ấ u c ủ n g	đ ấ u c ủ n g
c h ạ y đ u a	c h ạ y đ u a
q u ầ n v ợ t	q u ầ n v ợ t
p l u t o n i	p l u t o n i
x â m l ư ợ c	x â m l ư ợ c
đ á n h d ấ u	đ á n h d ấ u
s ầ u m u ộ n	s ầ u m u ộ n
t ậ p t à n h	t ậ p t à n h
d â n b i ể u	d â n b i ể u
b á n h h ỏ i	b á n h h ỏ i
r ộ n g r ã i	r ộ n g r ã i
n g o ạ i t ệ	n g o ạ i t ệ
h ồ n g h ạ c	h ồ n g h ạ c
g i á o d ụ c	g i á o d ụ c
t h ự c đ ơ n	t h ự c đ ơ n
c à d á i d ê	c à d á i d ê
b ú n r i ê u	b ú n r i ê u
x ố c x ế c h	x ố c x ế c h
b i ế n t ấ u	b i ế n t ấ u
k i l ô m e t	k i l ô m e t
t à i l i ệ u	t à i l i ệ u
b ộ t n ă n g	b ộ t n ă n g
đ ồ n g d a o	đ ồ n g d a o
d ậ p d ề n h	d ậ p d ề n h
t r ọ n v ẹ n	t r ọ n v ẹ n
l ạ c q u a n	l ạ c q u a n
t h ự c l ự c	t h ự c l ự c
c ả i b i ê n	c ả i b i ê n
đ i ề u h o à	đ i ề u h o à
b á n h d à y	b á n h d à y
h ư u b ổ n g	h ư u b ổ n g
h u y n h đ ệ	h u y n h đ ệ
b ô n g g ò n	b ô n g g ò n
m ậ u t u ấ t	m ậ u t u ấ t
k h ó c l ó c	k h ó c l ó c
b ă n g đ ả o	b ă n g đ ả o
đ ứ n g d ậ y	đ ứ n g d ậ y
h o à đ ồ n g	h o à đ ồ n g
c ạ p n o n g	c ạ p n o n g
h ậ u c u n g	h ậ u c u n g
h ọ c t h ê m	h ọ c t h ê m
c ô n g ư ớ c	c ô n g ư ớ c
h i ệ p v ầ n	h i ệ p v ầ n
đ ơ n t i ế t	đ ơ n t i ế t
h ộ i n h ậ p	h ộ i n h ậ p
x u â n đ à o	x u â n đ à o
t â y d u k í	t â y d u k í
b a n n h ạ c	b a n n h ạ c
l a n h l ợ i	l a n h l ợ i
t a i b i ế n	t a i b i ế n
m ặ t t r ậ n	m ặ t t r ậ n
r ư ợ u m ù i	r ư ợ u m ù i
c á c h đ â y	c á c h đ â y
a n h h ù n g	a n h h ù n g
q u ố c h ộ i	q u ố c h ộ i
k i m l o ạ i	k i m l o ạ i
x í c h đ ạ o	x í c h đ ạ o
t h ự c t ạ i	t h ự c t ạ i
b a o k i ế m	b a o k i ế m
n g ọ t l ị m	n g ọ t l ị m
m ô n g l u n g	m ô n g l u n g
n h i ế p ả n h	n h i ế p ả n h
v ư ơ n g h ậ u	v ư ơ n g h ậ u
l i ê n q u a n	l i ê n q u a n
đ i ể n t r a i	đ i ể n t r a i
l ạ t n h á c h	l ạ t n h á c h
v i ệ t g i a n	v i ệ t g i a n
đ ê m t r ư ớ c	đ ê m t r ư ớ c
đ í c h đ á n g	đ í c h đ á n g
c h i m đ i ê n	c h i m đ i ê n
đ i ề u t r ầ n	đ i ề u t r ầ n
q u a n h n ă m	q u a n h n ă m
k h á i n i ệ m	k h á i n i ệ m
t ô n t r ọ n g	t ô n t r ọ n g
d à n h d à n h	d à n h d à n h
c h u ộ t l ắ t	c h u ộ t l ắ t
s ú n g n ư ớ c	s ú n g n ư ớ c
q u á n q u â n	q u á n q u â n
t h i ế u h ụ t	t h i ế u h ụ t
c h i ế n h ạ m	c h i ế n h ạ m
c ô n g b ì n h	c ô n g b ì n h
t h ư ợ n g u ý	t h ư ợ n g u ý
l i ê n h o a n	l i ê n h o a n
b a o n h i ê u	b a o n h i ê u
t h ư ợ n g đ ế	t h ư ợ n g đ ế
đ ồ n g t h á p	đ ồ n g t h á p
q u y ế t t â m	q u y ế t t â m
p h é p c ộ n g	p h é p c ộ n g
t h ự c h à n h	t h ự c h à n h
c ô n g d a n h	c ô n g d a n h
đ ồ n g t í n h	đ ồ n g t í n h
c o n đ ư ờ n g	c o n đ ư ờ n g
b ư u t h i ế p	b ư u t h i ế p
n h ậ t t h ự c	n h ậ t t h ự c
c h ế t đ u ố i	c h ế t đ u ố i
d a n h s á c h	d a n h s á c h
h o à n k i ế m	h o à n k i ế m
p h á n đ o á n	p h á n đ o á n
l ú n g t ú n g	l ú n g t ú n g
k h â m p h ụ c	k h â m p h ụ c
đ ấ u t r a n h	đ ấ u t r a n h
k h í a c ạ n h	k h í a c ạ n h
h o à n g h ậ u	h o à n g h ậ u
t í n h m ệ n h	t í n h m ệ n h
b ó n g c h à y	b ó n g c h à y
n g h ị v i ệ n	n g h ị v i ệ n
t h i ế t l ậ p	t h i ế t l ậ p
b ó n g d á n g	b ó n g d á n g
m o n g m u ố n	m o n g m u ố n
r ộ n g r i n h	r ộ n g r i n h
h ả i đ ư ờ n g	h ả i đ ư ờ n g
c ự c k h o á i	c ự c k h o á i
v i ệ t m i n h	v i ệ t m i n h
đ ị n h h ì n h	đ ị n h h ì n h
s o n g s o n g	s o n g s o n g
t ổ n g b i n h	t ổ n g b i n h
l i ệ u p h á p	l i ệ u p h á p
c a n t h i ệ p	c a n t h i ệ p
t i ế n g a n h	t i ế n g a n h
r o n g r u ổ i	r o n g r u ổ i
t r ự c q u a n	t r ự c q u a n
d ư ơ n g đ à o	d ư ơ n g đ à o
c h ù m r u ộ t	c h ù m r u ộ t
k h ố i l ư ợ n g	k h ố i l ư ợ n g
x ư ơ n g s ố n g	x ư ơ n g s ố n g
c h u y ê n s â u	c h u y ê n s â u
b ă n g t h ô n g	b ă n g t h ô n g
l ậ p t r ư ờ n g	l ậ p t r ư ờ n g
n h a n h n h ẹ n	n h a n h n h ẹ n
t h a n h d i ê u	t h a n h d i ê u
n h i ệ t n ă n g	n h i ệ t n ă n g
t h i ê n h i ế t	t h i ê n h i ế t
h ồ c h í m i n h	h ồ c h í m i n h
g i ả i q u y ế t	g i ả i q u y ế t
t r ơ n t r ư ợ t	t r ơ n t r ư ợ t
m a n h g i ô n g	m a n h d ô n g
t h o ả t h u ậ n	t h o ả t h u ậ n
n ư ớ c n g o à i	n ư ớ c n g o à i
t h i ệ t t h ò i	t h i ệ t t h ò i
s â n t h ư ợ n g	s â n t h ư ợ n g
c h í n h d i ệ n	c h í n h d i ệ n
n g o n m i ệ n g	n g o n m i ệ n g
t r ò c h u y ệ n	t r ò c h u y ệ n
c h i n h p h ụ c	t r i n h p h ụ c
t r ú n g t h ự c	t r ú n g t h ự c
b ấ t t h ư ờ n g	b ấ t t h ư ờ n g
p h o n g c ả n h	p h o n g c ả n h
c h á n h đ ả n g	t r á n h đ ả n g
n h ấ p c h u ộ t	n h ấ p c h u ộ t
k i n h d o a n h	k i n h d o a n h
t h ị n h h à n h	t h ị n h h à n h
l ư ợ n g g i á c	l ư ợ n g g i á c
c h ê n h v ê n h	c h ê n h v ê n h
h o à t h ư ợ n g	h o à t h ư ợ n g
t h ư ơ n g m ạ i	t h ư ơ n g m ạ i
h o á t h ạ c h	h o á t h ạ c h
đ ồ n g n h ấ t	đ ồ n g n h ấ t
đ ă m c h i ê u	đ ă m c h i ê u
d ấ u h u y ề n	d ấ u h u y ề n
k i ế n t r ú c	k i ế n t r ú c
t h i ê n đ à n g	t h i ê n đ à n g
d u y n g ô n h ĩ	d u y n g ô n h ĩ
t i ế n t r i ể n	t i ế n t r i ể n
k h ủ n g l o n g	k h ủ n g l o n g
c h ứ c q u y ề n	c h ứ c q u y ề n
t r ư ờ n g h ợ p	t r ư ờ n g h ợ p
đ i n h h ư ơ n g	đ i n h h ư ơ n g
x ư ơ n g r ồ n g	x ư ơ n g r ồ n g
m o n g n g ó n g	m o n g n g ó n g
g i ế t n g ư ờ i	d i ế t n g ư ờ i
n h ạ c c ô n g	n h ạ c c ô n g
t i ế n g l ó n g	t i ế n g l ó n g
n i ê m p h o n g	n i ê m p h o n g
c h u y ê n t â m	c h u y ê n t â m
k i n h t u y ế n	k i n h t u y ế n
q u ả n g b ì n h	q u ả n g b ì n h
n h ạ t t h ế c h	n h ạ t t h ế c h
t r u y ề n t h ụ	t r u y ề n t h ụ
n g h i ê m t ú c	n g h i ê m t ú c
k í n h t r ọ n g	k í n h t r ọ n g
k h u ế c h t á n	k h u ế c h t á n
n g o ạ i g i a o	n g o ạ i g i a o
t h à n h t h ạ o	t h à n h t h ạ o
c h ạ n g v ạ n g	t r ạ n g v ạ n g
t h ầ n t h o ạ i	t h ầ n t h o ạ i
b á c h t h ả o	b á c h t h ả o
k h ô i p h ụ c	k h ô i p h ụ c
s o n g t i ế t	s o n g t i ế t
s ô n g h ồ n g	x ô n g h ồ n g
đ ư ơ n g q u y	đ ư ơ n g q u y
c h i ê m b a o	c h i ê m b a o
b i ê n x í c h	b i ê n x í c h
n ô n g t r ạ i	n ô n g t r ạ i
d i ễ u h à n h	d i ễ u h à n h
c h i ế n đ ấ u	c h i ế n đ ấ u
t h u ố c b ắ c	t h u ố c b ắ c
c ộ n g s i n h	c ộ n g s i n h
n g ư ờ i y ê u	n g ư ờ i y ê u
đ i ể n h ì n h	đ i ể n h ì n h
b á o t ư ờ n g	b á o t ư ờ n g
t h u ộ c c ấ p	t h u ộ c c ấ p
s ô n g b ă n g	s ô n g b ă n g
đ u a t r a n h	đ u a t r a n h
n g ộ t n g ạ t	n g ộ t n g ạ t
c ồ n g k ề n h	c ồ n g k ề n h
r a n h m ã n h	d a n h m ã n h
t i ể u l i ê n	t i ể u l i ê n
c ư ỡ n g b ứ c	c ư ỡ n g b ứ c
g i ọ n g n ó i	r ọ n g n ó i
p h â n h i ệ u	p h â n h i ệ u
c ố n g h i ế n	c ố n g h i ế n
t i ề n đ ì n h	t i ề n đ ì n h
k h o ẻ m ạ n h	k h o ẻ m ạ n h
q u ả q u y ế t	q u ả q u y ế t
đ ơ n t h u ầ n	đ ơ n t h u ầ n
t h i ê n y ế t	t h i ê n y ế t
x ư n g h i ệ u	x ư n g h i ệ u
t i ề n n o n g	t i ề n n o n g
m i ệ t t h ị	m i ệ t t h ị
b ả y m ư ơ i	b ả y m ư ơ i
l ộ n g l ẫ y	l ộ n g l ẫ y
p h ò n g ố c	p h ò n g ố c
y ê u k i ề u	y ê u k i ề u
c ả m l ạ n h	c ả m l ạ n h
s ứ c m ạ n h	s ứ c m ạ n h
d u n g m ạ o	d u n g m ạ o
k i l ô g a m	k i l ô g a m
n h ậ u n h ẹ t	n h ậ u n h ẹ t
c ẩ m t h ạ c h	c ẩ m t h ạ c h
b ú a k h o a n	b ú a k h o a n
k i m t u y ế n	k i m t u y ế n
n h ọ c n h ằ n	n h ọ c n h ằ n
đ ố i c h i ế u	đ ố i c h i ế u
n ấ m t u y ế t	n ấ m t u y ế t
k i n h đ i ể n	k i n h đ i ể n
x u ấ t c ả n h	x u ấ t c ả n h
h à n h t u n g	h à n h t u n g
đ ư ờ n g c a o	đ ư ờ n g c a o
t h i ê n h ậ u	t h i ê n h ậ u
c o i t r ọ n g	c o i t r ọ n g
b á c h k h o a	b á c h k h o a
t h a m v ọ n g	t h a m v ọ n g
t ổ n g q u a n	t ổ n g q u a n
r ồ n g r ồ n g	r ồ n g r ồ n g
đ i ê u k h ắ c	đ i ê u k h ắ c
n h ấ n m ạ n h	n h ấ n m ạ n h
r u ộ t t h ừ a	r u ộ t t h ừ a
p h á i đ o à n	p h á i đ o à n
q u ạ t t r ầ n	q u ạ t t r ầ n
b ắ t n g u ồ n	b ắ t n g u ồ n
b ì n h đ ẳ n g	b ì n h đ ẳ n g
đ ắ n g l ò n g	đ ắ n g l ò n g
t h ạ c h t í n	t h ạ c h t í n
m u a c h u ộ c	m u a c h u ộ c
t h ầ n d ư ợ c	t h ầ n d ư ợ c
d u n g d ị c h	d u n g d ị c h
t r i ệ u h ồ i	c h i ệ u h ồ i
b ă n k h o ă n	b ă n k h o ă n
t ử u l ư ợ n g	t ử u l ư ợ n g
g i ả o h o ạ t	g i ả o h o ạ t
đ ư ờ n g n é t	đ ư ờ n g n é t
p h ú c k i ế n	p h ú c k i ế n
b ấ t t h à n h	b ấ t t h à n h
đ ồ n g t h a u	đ ồ n g t h a u
v ẫ n t h ạ c h	v ẫ n t h ạ c h
k í c h h o ạ t	k í c h h o ạ t
m ó n g v u ố t	m ó n g v u ố t
d ị n g u y ê n	d ị n g u y ê n
t h ậ p n i ê n	t h ậ p n i ê n
d ư ơ n g s ó c	d ư ơ n g s ó c
c ô n g q u ố c	c ô n g q u ố c
t i ể u b a n g	t i ể u b a n g
c á h ổ k ì n h	c á h ổ k ì n h
t i ế p d i ễ n	t i ế p d i ễ n
l u ẩ n q u ẩ n	l u ẩ n q u ẩ n
đ á n h r ă n g	đ á n h r ă n g
l à m b i ế n g	l à m b i ế n g
c a n h c á n h	c a n h c á n h
k h a i q u ậ t	k h a i q u ậ t
q u a n g h ợ p	q u a n g h ợ p
c h u y ê n đ ề	c h u y ê n đ ề
t h à n h t ự u	t h à n h t ự u
r ư ợ u v a n g	r i ệ u v a n g
g ồ n g g á n h	g ồ n g g á n h
o ả i h ư ơ n g	o ả i h ư ơ n g
t ạ p c h ủ n g	t ạ p c h ủ n g
t ă n g v i ệ n	t ă n g v i ệ n
l i ê n k h ú c	l i ê n k h ú c
h à m l ư ợ n g	h à m l ư ợ n g
k i ể m t o á n	k i ể m t o á n
t r ù n g h ợ p	t r ù n g h ợ p
đ ứ n g t u ổ i	đ ứ n g t u ổ i
m ĩ n h â n k ế	m ĩ n h â n k ế
n h ấ t đ ị n h	n h ấ t đ ị n h
b ù n g p h á t	b ù n g p h á t
t u n g đ ộ	t u n g đ ộ
đ i ề n k i n h	đ i ề n k i n h
đ ầ u p h i ế u	đ ầ u p h i ế u
b ì n h c h ọ n	b ì n h c h ọ n
h o a n g m ạ c	h o a n g m ạ c
l i ê n d a n h	l i ê n d a n h
n g h ĩ a đ ị a	n g h ĩ a đ ị a
l i ê n b a n g	l i ê n b a n g
t i ế p n h ậ n	t i ế p n h ậ n
đ ậ u t r ắ n g	đ ậ u t r ắ n g
p h i ê n b ả n	p h i ê n b ả n
đ ồ n g t h ờ i	đ ồ n g t h ờ i
p h a n x i c ô	p h a n x i c ô
m ọ i n g ư ờ i	m ọ i n g ư ờ i
h i ệ u n ă n g	h i ệ u n ă n g
t ấ t b ậ t	t ấ t b ậ t
l ợ n đ ấ t	l ợ n đ ấ t
đ á n h đ ố	đ á n h đ ố
đ ĩ đ i ế m	đ ĩ đ i ế m
ổ n đ ị n h	ổ n đ ị n h
đ à n đ á y	đ à n đ á y
t à n b ạ o	t à n b ạ o
b ạ c h m ã	b ạ c h m ã
b ồ i b ú t	b ồ i b ú t
đ ầ m đ ì a	đ ầ m đ ì a
đ ớ n đ a u	đ ớ n đ a u
b ó c t e m	b ó c t e m
h ọ c l ỏ m	h ọ c l ỏ m
v ụ k i ệ n	v ụ k i ệ n
h ó c b ú a	h ó c b ú a
b á n h b ò	b á n h b ò
đ ố i đ ầ u	đ ố i đ ầ u
h ạ l ệ n h	h ạ l ệ n h
s ặ c s ụ a	s ặ c s ụ a
đ ư a đ ẩ y	đ ư a đ ẩ y
r ắ n l ụ c	r ắ n l ụ c
a c t i n i	a c t i n i
c ụ c c ằ n	c ụ c c ằ n
b ơ i l ộ i	b ơ i l ộ i
b ố c ụ c	b ố c ụ c
f a	é p p h ờ
b ắ c b ộ	b ắ c b ộ
b ọ c ạ p	b ọ c ạ p
b ị h ạ i	b ị h ạ i
â m đ ạ o	â m đ ạ o
b ộ b ả y	b ộ b ả y
đ ậ u đ ỏ	đ ậ u đ ỏ
h ọ c v ị	h ọ c v ị
đ ề b ạ t	đ ề b ạ t
t a đ ê ô	t a đ ê ô
đ o đ ạ c	đ o đ ạ c
d ạ y đ ờ i	d ạ y đ ờ i
b ọ g ậ y	b ọ g ậ y
t ộ t đ ộ	t ộ t đ ộ
t ệ b ạ c	t ệ b ạ c
n i o b i	n i o b i
đ o đ ạ t	đ o đ ạ t
b è b ạ n	b è b ạ n
v ậ t đ e n	v ậ t đ e n
b á n h đ a	b á n h đ a
b ó n g đ á	b ó n g đ á
y ê n b á i	y ê n b á i
b e r i l i	b e r i l i
l ặ n l ộ i	l ặ n l ộ i
n h ị p đ ộ	n h ị p đ ộ
đ ô n g â u	đ ô n g â u
ư u đ i ể m	ư u đ i ể m
đ ị a l ô i	đ ị a l ô i
đ ò n b ẩ y	đ ò n b ẩ y
d i đ ộ n g	d i đ ộ n g
c o n b ạ c	c o n b ạ c
g o á b ụ a	g o á b ụ a
n o b e l i	n o b e l i
t i ế n b ộ	t i ế n b ộ
đ ộ c g i ả	đ ộ c g i ả
đ à n b ầ u	đ à n b ầ u
p l e i k u	p l e i k u
đ o m đ ó m	đ o m đ ó m
đ e n đ ủ i	đ e n đ ủ i
o n g m ậ t	o n g m ậ t
đ à o t ạ o	đ à o t ạ o
b ấ t l ợ i	b ấ t l ợ i
đ ố i m ặ t	đ ố i m ặ t
ă n d i ệ n	ă n d i ệ n
đ ặ t t ê n	đ ặ t t ê n
l ặ t v ặ t	l ặ t v ặ t
b i m b i m	b i m b i m
đ à n h ặ c	đ à n h ặ c
l o ạ i b ỏ	l o ạ i b ỏ
d ự l u ậ t	d ự l u ậ t
b é b ỏ n g	b é b ỏ n g
đ à n ô n g	đ à n ô n g
p h ụ c v ụ	p h ụ c v ụ
s ắ p đ ặ t	s ắ p đ ặ t
l ọ c l õ i	l ọ c l õ i
h ậ m h ự c	h ậ m h ự c
t o ạ l ạ c	t o ạ l ạ c
t ừ b i ệ t	t ừ b i ệ t
b ể đ ô n g	b ể đ ô n g
đ u a đ ò i	đ u a đ ò i
s â u đ ậ m	s â u đ ậ m
đ ị a t â m	đ ị a t â m
v ụ n v ặ t	v ụ n v ặ t
t i ế n đ ộ	t i ế n đ ộ
đ ộ n g c ơ	đ ộ n g c ơ
đ ê t i ệ n	đ ê t i ệ n
b ậ t l ử a	b ậ t l ử a
h á n t h à n h	h á n t h à n h
t h ó i q u e n	t h ó i q u e n
t ả i x u ố n g	t ả i x u ố n g
t i ê n s i n h	t i ê n s i n h
t h ự c c h ấ t	t h ự c c h ấ t
t h á n g b ả y	t h á n g b ả y
n g u y ê n t ử	n g u y ê n t ử
n g ừ n g b ắ n	n g ừ n g b ắ n
q u e n t h ó i	q u e n t h ó i
c h ú t r ọ n g	c h ú t r ọ n g
t h ấ t t ị c h	t h ấ t t ị c h
t h i ê n t â n	t h i ê n t â n
t ấ t n h i ê n	t ấ t n h i ê n
n g ư ờ i t à u	n g ư ờ i t à u
k h u ô n m ẫ u	k h u ô n m ẫ u
t u n g t í c h	t u n g t í c h
g i á n c á c h	g i á n c á c h
đ á n g g h é t	đ á n g g h é t
c á c h t h ứ c	c á c h t h ứ c
k h i ế m t h ị	k h i ế m t h ị
t h ự c p h ẩ m	t h ự c p h ẩ m
t o à n n ă n g	t o à n n ă n g
v i ê m p h ổ i	v i ê m p h ổ i
v ĩ n h p h ú c	v ĩ n h p h ú c
n e m n ư ớ n g	n e m n ư ớ n g
n g u y n g ậ p	n g u y n g ậ p
t h u ố c m e n	t h u ố c m e n
s i n h m ạ n g	s i n h m ạ n g
n g â m n g ợ i	n g â m n g ợ i
t h ổ h u y ế t	t h ổ h u y ế t
c a n h c h u a	c a n h c h u a
t r ầ y t r ậ t	t r ầ y t r ậ t
y ê u t h í c h	y ê u t h í c h
t i ế n g t â y	t i ế n g t â y
t r à n n g ậ p	t r à n n g ậ p
g i ả n g d ạ y	g i ả n g d ạ y
l u n g l i n h	l u n g l i n h
k h e n n g ợ i	k h e n n g ợ i
t h a n h h ỏ i	t h a n h h ỏ i
c h a n h d â y	t r a n h d â y
c h ừ n g m ự c	t r ừ n g m ự c
ấ n c h ư ơ n g	ấ n c h ư ơ n g
l ư u h o à n g	l ư u h o à n g
c ư ờ n g h o á	c ư ờ n g h o á
c h ú a n h ậ t	c h ú a n h ậ t
h u n g h ă n g	h u n g h ă n g
n g ă n c h ặ n	n g ă n c h ặ n
q u a n c h ứ c	q u a n c h ứ c
q u ả n g t â y	q u ả n g t â y
t ư ơ n g t á c	t ư ơ n g t á c
c h ấ t l ỏ n g	c h ấ t l ỏ n g
t h i ê n t à i	t h i ê n t à i
n ư ớ c t h ả i	n ư ớ c t h ả i
t h a m q u a n	t h a m q u a n
c h â n d u n g	c h â n d u n g
t â n c ư ơ n g	t â n c ư ơ n g
t r u n g t â m	t r u n g t â m
h i ế n p h á p	h i ế n p h á p
t h ắ t c h ặ t	t h ắ t c h ặ t
s i ê u n h â n	s i ê u n h â n
h à n h p h á p	h à n h p h á p
t h i ế u m á u	t h i ế u m á u
t í n h m ạ n g	t í n h m ạ n g
t r ầ n t r ụ i	t r ầ n t r ụ i
b i n h n h ấ t	b i n h n h ấ t
k i ế n g i ả i	k i ế n g i ả i
x ứ n g đ á n g	x ứ n g đ á n g
c a m n h ô n g	c a m n h ô n g
g i a o t i ế p	g i a o t i ế p
t h i ế u s ó t	t h i ế u s ó t
r ạ n g n g ờ i	r ạ n g n g ờ i
v i ễ n t h á m	v i ễ n t h á m
t r a n h c ã i	t r a n h c ã i
t h u ỷ b ì n h	t h u ỷ b ì n h
t h ổ n h ĩ k ì	t h ổ n h ĩ k ì
k h o á n s ả n	k h o á n s ả n
a n h t r a i	a n h t r a i
h i ế u t h ả o	h i ế u t h ả o
v i n h d a n h	v i n h d a n h
t ì n h c ả n h	t ì n h c ả n h
t h à n h q u ả	t h à n h q u ả
n à n g t i ê n	n à n g t i ê n
t u y n h i ê n	t u y n h i ê n
m ó c n g h é o	m ó c n g h é o
n g h ệ d a n h	n g h ệ d a n h
t ư ơ n g l a i	t ư ơ n g l a i
t h ư ợ n g d u	t h ư ợ n g d u
d ị t h ư ờ n g	d ị t h ư ờ n g
m u ô n t h u ở	m u ô n t h u ở
d u t h u y ề n	d u t h u y ề n
t h â n b i n h	t h â n b i n h
c ô n g g i á o	c ô n g g i á o
h ữ u t h a n h	h ữ u t h a n h
c h ắ c n ị c h	c h ắ c n ị c h
t i ế p t h e o	t i ế p t h e o
c h ị u c h ơ i	c h ị u c h ơ i
c h ú c m ừ n g	c h ú c m ừ n g
t ư ờ n g l ử a	t ư ờ n g l ử a
t r u n g h o a	t r u n g h o a
g i a q u y ề n	g i a q u y ề n
v ư ớ n g m ắ c	v ư ớ n g m ắ c
n ó i c h u n g	n ó i c h u n g
l ã i s u ấ t	l ã i s u ấ t
t h i ế u u ý	t h i ế u ý
b ù i n h ù i	b ù i n h ù i
s ò h u y ế t	s ò h u y ế t
b ả n n ă n g	b ả n n ă n g
c ả i c á c h	c ả i c á c h
h ồ n g c ầ u	h ồ n g c ầ u
r ê n x i ế t	r ê n x i ế t
t ứ x u y ê n	t ứ x u y ê n
c u ố n h ú t	c u ố n h ú t
đ o l ư ờ n g	đ o l ư ờ n g
n h à o l ộ n	n h à o l ộ n
c ầ u t i ê u	c ầ u t i ê u
x â m t h ự c	x â m t h ự c
l i ề u l ĩ n h	l i ề u l ĩ n h
p h i ê u l ư u	p h i ê u l ư u
n h ì n n h ậ n	n h ì n n h ậ n
c h i ề u d à i	c h i ề u d à i
s o n g t h â n	s o n g t h â n
t h ô n g c á o	t h ô n g c á o
n g h i ệ p d ư	n g h i ệ p d ư
n g o ạ i t r ừ	n g o ạ i t r ừ
k h o á c l á c	k h o á c l á c
s ư ơ n g s â m	x ư ơ n g s â m
n h ạ t n h o à	n h ạ t n h o à
p h á o b i n h	p h á o b i n h
t í c h c ự c	t í c h c ự c
g i ớ i h ạ n	g i ớ i h ạ n
h o à b ì n h	h o à b ì n h
d â y s ố n g	d â y s ố n g
h ẻ o l á n h	h ẻ o l á n h
n g ọ t x ớ t	n g ọ t x ớ t
t ử n g o ạ i	t ử n g o ạ i
c h ế b i ế n	c h ế b i ế n
n ô n n ó n g	n ô n n ó n g
d a t h u ộ c	d a t h u ộ c
k i ế n l ử a	k i ế n l ử a
t h ị n h n ộ	t h ị n h n ộ
t ư ơ m t ấ t	t ư ơ m t ấ t
x ư ơ n g r ắ n	x ư ơ n g r ắ n
s i ê u m ẫ u	s i ê u m ẫ u
s o n g n a m	s o n g n a m
đ i n g o à i	đ i n g o à i
t h à n h u ỷ	t h à n h u ỷ
g i ả i đ á p	g i ả i đ á p
n ổ i t r ộ i	n ổ i t r ộ i
m ặ t h à n g	m ặ t h à n g
g i ã i b à y	d ã i b à y
b ấ t t ỉ n h	b ấ t t ỉ n h
n ư ớ c d ã i	n ư ớ c d ã i
q u ý h i ế m	q u ý h i ế m
p h ò n g t ắ m	p h ò n g t ắ m
c h i m c ô n g	c h i m c ô n g
t h ể t h u ậ t	t h ể t h u ậ t
t r ì n h b à y	t r ì n h b à y
t h á n g m ộ t	t h á n g m ộ t
n g u y ê n t ố	n g u y ê n t ố
h à n h t i n h	h à n h t i n h
b ì n h c h â n	b ì n h c h â n
t h â n q u e n	t h â n q u e n
t i ê n g i ớ i	t i ê n g i ớ i
t h u ố c t â y	t h u ố c t â y
s ố n g u y ê n	s ố n g u y ê n
c h í n s u ố i	c h í n s u ố i
n g ậ m n g ù i	n g ậ m n g ù i
q u ả n g c á o	q u ả n g c á o
p h ậ t g i á o	p h ậ t g i á o
d u n g n h a n	d u n g n h a n
t r u n g n ã o	t r u n g n ã o
r u n g r i n h	r u n g r i n h
n h ạ t n h ẽ o	n h ạ t n h ẽ o
v ĩ n h l o n g	v ĩ n h l o n g
n ó i r i ê n g	n ó i r i ê n g
đ ô t r ư ở n g	đ ô t r ư ở n g
p h ả n p h ú c	p h ả n p h ú c
n h a n h l ê n	n h a n h l ê n
h o à n g h ả i	h o à n g h ả i
t ừ n g u y ê n	t ừ n g u y ê n
h o à n g h ô n	h o à n g h ô n
t i n h b i n h	t i u b i n h
n g h ị v i ê n	n g h ị v i ê n
c h ầ m c h ậ m	t r ầ m t r ậ m
t í n h t o á n	t í n h t o á n
c ô n t r ù n g	c ô n t r ù n g
h ồ n g n h a n	h ồ n g n h a n
c á p q u a n g	c á p q u a n g
t h ư ớ c t â y	t h ư ớ c t â y
c ô n g k h a i	c ô n g k h a i
c ù n g n h a u	c ù n g n h a u
c h ậ t n í c h	c h ậ t n í c h
s ó c t r ă n g	s ó c t r ă n g
s ú n g n g ắ n	s ú n g n g ắ n
l ã n g q u ê n	l ã n g q u ê n
t h ừ a n h ậ n	t h ừ a n h ậ n
q u ả n h i ê n	q u ả n h i ê n
t r u n g c ấ p	t r u n g c ấ p
c h á o l ò n g	c h á o l ò n g
s i n h t i ề n	s i n h t i ề n
k ỉ n g u y ê n	k ỉ n g u y ê n
l à m p h i ề n	l à m p h i ề n
t h ô n g t i n	t h ô n g t i n
n h u t h u ậ t	n h u t h u ậ t
t r ừ n g p h ạ t	t r ừ n g p h ạ t
c h ú n g s i n h	c h ú n g s i n h
l ã n g k h á c h	l ã n g k h á c h
v i ê n g c h ă n	v i ê n g c h ă n
t ư ơ n g x ứ n g	t ư ơ n g x ứ n g
t h i ế u v ắ n g	t h i ế u v ắ n g
b ằ n g p h ẳ n g	b ằ n g p h ẳ n g
t h a m c h i ế u	t h a m c h i ế u
t r ạ n g t h á i	t r ạ n g t h á i
t h ầ y t h u ố c	t h ầ y t h u ố c
t h í c h đ á n g	t h í c h đ á n g
c ô n g t r ì n h	c ô n g t r ì n h
l i ê m c h í n h	l i ê m c h í n h
t r ố n t r á n h	t r ố n t r á n h
t h ô n g m i n h	t h ô n g m i n h
t ư ờ n g m i n h	t ư ờ n g m i n h
t r ự c t r à n g	t r ự c t r à n g
n h ú c n h í c h	n h ú c n h í c h
n g ậ p n g ừ n g	n g ậ p n g ừ n g
n ă n g k h i ế u	n ă n g k h i ế u
t h i ê u t h â n	t h i ê u t h â n
c h í n h t r ự c	c h í n h t r ự c
t r a n g v i ê n	t r a n g v i ê n
k h ẩ n t h i ế t	k h ẩ n t h i ế t
t r u n g g i a n	t r u n g r a n
t h u ỷ c h u n g	t h u ỷ c h u n g
g i ế n g t r ờ i	r i ế n g t r ờ i
t ì n h t r ạ n g	t ì n h t r ạ n g
t h â n t h i ế t	t h â n t h i ế t
c h í n h s á c h	c h í n h s á c h
c h ú n g m ì n h	c h ú n g m ì n h
g i ố n g n h a u	g i ố n g n h a u
c o i t h ư ờ n g	c o i t h ư ờ n g
c h u n g t h â n	t r u n g t h â n
n h õ n g n h ẽ o	n h õ n g n h ẽ o
h ư ơ n g c ả n g	h ư ơ n g c ả n g
h à n h t r ì n h	h à n h t r ì n h
c h ứ c t r á c h	c h ứ c t r á c h
t r ầ n t r i ề u	t r ầ n t r i ề u
t h ư ơ n g h à n	t h ư ơ n g h à n
p h ầ n n h i ề u	p h ầ n n h i ề u
t h a n h t h ả n	t h a n h t h ả n
c h u n g t h u ỷ	t r u n g t h u ỷ
p h a n t h i ế t	p h a n t h i ế t
c h ứ n g n h ậ n	c h ứ n g n h ậ n
c h ứ n g k i ế n	c h ứ n g k i ế n
t h ố n g n h ấ t	t h ố n g n h ấ t
v ă n c h ư ơ n g	v ă n c h ư ơ n g
t h i ế u t h ố n	t h i ế u t h ố n
m ô i t r ư ờ n g	m ô i t r ư ờ n g
q u ả n g n g ã i	q u ả n g n g ã i
t ì n h t h ư ơ n g	t ì n h t h ư ơ n g
t h i ê n x ứ n g	t h i ê n x ứ n g
k h ô n n g o a n	k h ô n n g o a n
t h á n h t h ầ n	t h á n h t h ầ n
g i ả t h u y ế t	g i ả t h u y ế t
t h á i d ư ơ n g	t h á i d ư ơ n g
n h ị p n h à n g	n h ị p n h à n g
p h ư ơ n g t h ứ c	p h ư ơ n g t h ứ c
t r ư ờ n g p h á i	t r ư ờ n g p h á i
c ư ờ n g t r á n g	c ư ờ n g t r á n g
t h ấ p t h o á n g	t h ấ p t h o á n g
n g h i ê m k h ắ c	n g h i ê m k h ắ c
k h i ế m t h í n h	k h i ế m t h í n h
c h í n h q u ố c	c h í n h q u ố c
n g h i ề n n g ẫ m	n g h i ề n n g ẫ m
t h ấ t t h ư ờ n g	t h ấ t t h ư ờ n g
t h ư ở n g t h ứ c	t h ư ở n g t h ứ c
c h i ế n t h ắ n g	c h i ế n t h ắ n g
g i a o t h ư ơ n g	g i a o t h ư ơ n g
c h í n h t h ố n g	c h í n h t h ố n g
k h o e k h o a n g	k h o e k h o a n g
c h ư ở n g d i n h	c h ư ở n g d i n h
c h o á n g v á n g	c h o á n g v á n g
k h a i t r ư ơ n g	k h a i t r ư ơ n g
c h ư ơ n g t r ì n h	c h ư ơ n g t r ì n h
k h i n h t h ư ờ n g	k h i n h t h ư ờ n g
t h i ế t g i á p	t h i ế t g i á p
t h ấ t t h a n h	t h ấ t t h a n h
p h ổ n g p h a o	p h ổ n g p h a o
t ổ n t h ư ơ n g	t ổ n t h ư ơ n g
t h á n h l i n h	t h á n h l i n h
k i n h k h ủ n g	k i n h k h ủ n g
h i ể m n g h è o	h i ể m n g h è o
t h a m c h i ế n	t h a m c h i ế n
k h u y ê n n h ủ	k h u y ê n n h ủ
g i á o h o à n g	g i á o h o à n g
d ư ơ n g t í n h	d ư ơ n g t í n h
c h â m c h ư ớ c	c h â m c h ư ớ c
n h ậ t t r ì n h	n h ậ t t r ì n h
k h ở i n g u ồ n	k h ở i n g u ồ n
t h ừ a h ư ở n g	t h ừ a h ư ở n g
n g h ẹ n n g à o	n g h ẹ n n g à o
p h o n g t h ấ p	p h o n g t h ấ p
t h á n h k i n h	t h á n h k i n h
p h ò n g n g ừ a	p h ò n g n g ừ a
x ó t t h ư ơ n g	x ó t t h ư ơ n g
t i ề n g i a n g	t i ề n g i a n g
h u y c h ư ơ n g	h u y c h ư ơ n g
t h ắ m t h i ế t	t h ắ m t h i ế t
g i á o d ư ỡ n g	g i á o d ư ỡ n g
g i ả i t h o á t	g i ả i t h o á t
t r ì n h b á o	t r ì n h b á o
q u ả n g t r ị	q u ả n g t r ị
t h ủ t h u ậ t	t h ủ t h u ậ t
t h í n h l ự c	t h í n h l ự c
c h ắ n s o n g	c h ắ n s o n g
b ư u c h í n h	b ư u c h í n h
l i ê n m i n h	l i ê n m i n h
b i n h l í n h	b i n h l í n h
v i ê n c h ứ c	v i ê n c h ứ c
k h á i q u á t	k h á i q u á t
p h á p l u â n	p h á p l u â n
l ư ơ n g h ư u	l ư ơ n g h ư u
x í n g h i ệ p	x í n g h i ệ p
g i ố n g c á i	g i ố n g c á i
s i ê u h ì n h	s i ê u h ì n h
t o à n t h â n	t o à n t h â n
c h i ê u h ồ i	c h i ê u h ồ i
t r a n h t à i	t r a n h t à i
s á n g k i ế n	s á n g k i ế n
g i ậ p g i ờ n	r ậ p g i ờ n
c h í n m u ồ i	c h í n m u ồ i
c u n g k í n h	c u n g k í n h
n h ẫ n n h ị n	n h ẫ n n h ị n
c ơ m c h i ê n	c ơ m c h i ê n
l ấ n c h i ế m	l ấ n c h i ế m
t h u ố c l ắ c	t h u ố c l ắ c
n g ư ỡ n g m ộ	n g ư ỡ n g m ộ
p h i ề n n ã o	p h i ề n n ã o
x u ấ t t h â n	x u ấ t t h â n
k i ê n n h ẫ n	k i ê n n h ẫ n
x u ấ t k h ẩ u	x u ấ t k h ẩ u
h o a n g t à n	h o a n g t à n
l ư u h u ỳ n h	l ư u h u ỳ n h
b ì n h t h u ỷ	b ì n h t h u ỷ
k h ở i h à n h	k h ở i h à n h
r ủ n g r ỉ n h	r ủ n g r ỉ n h
p h á t s ó n g	p h á t s ó n g
l ã n g đ ã n g	l ã n g đ ã n g
c h ấ n s o n g	c h ấ n s o n g
r u ồ i t r â u	r u ồ i t r â u
đ ớ p t h í n h	đ ớ p t h í n h
t i ể u p h ẫ u	t i ể u p h ẫ u
b ì n h t ĩ n h	b ì n h t ĩ n h
p h ư ơ n g á n	p h ư ơ n g á n
m ặ t p h ẳ n g	m ặ t p h ẳ n g
t h i ê n v ă n	t h i ê n v ă n
t à i k h o ả n	t à i k h o ả n
t u ỷ x ư ơ n g	t u ỷ x ư ơ n g
t í n h c á c h	t í n h c á c h
s i n h v i ê n	s i n h v i ê n
n ó n g t í n h	n ó n g t í n h
k h a i t r i ể n	k h a i t r i ể n
p h o n g t r à o	p h o n g t r à o
n g ẫ u n h i ê n	n g ẫ u n h i ê n
n h â n t r u n g	n h â n t r u n g
t h á n h t í c h	t h á n h t í c h
l ớ p t r ư ở n g	l ớ p t r ư ở n g
t r a n g m ạ n g	t r a n g m ạ n g
h à n g k h ô n g	h à n g k h ô n g
đ ắ n g n g h é t	đ ắ n g n g h é t
k i ê n g i a n g	k i ê n g i a n g
m i n h t r i ế t	m i n h t r i ế t
t ư ơ n g p h ả n	t ư ơ n g p h ả n
p h á t t h a n h	p h á t t h a n h
l á n g g i ề n g	l á n g d i ề n g
k h ă n q u à n g	k h ă n q u à n g
t r ư ờ n g v ố n	t r ư ờ n g v ố n
c h u n g t ì n h	t r u n g t ì n h
t ì n h h u ố n g	t ì n h h u ố n g
l i n h d ư ơ n g	l i n h d ư ơ n g
k h ẩ u c h i ế n	k h ẩ u c h i ế n
h o à n c h ỉ n h	h o à n c h ỉ n h
t h ẳ n g đ ứ n g	t h ẳ n g đ ứ n g
t r a n g t r ạ i	t r a n g t r ạ i
h ì n h t h à n h	h ì n h t h à n h
t r ắ n g t o á t	t r ắ n g t o á t
t h ừ a t h i ê n	t h ừ a t h i ê n
c ô n g k í c h	c ô n g k í c h
n h ề n n h ệ n	n h ề n n h ệ n
n g h ĩ a đ e n	n g h ĩ a đ e n
ố n g c h í c h	ố n g c h í c h
d ự t h ư ở n g	d ự t h ư ở n g
k h ô n g d á m	k h ô n g d á m
t h u ậ t n g ữ	t h u ậ t n g ữ
m ư ờ i c h í n	m ư ờ i c h í n
k h o a i t â y	k h o a i t â y
n g o n l à n h	n g o n l à n h
n ị n h t h ầ n	n ị n h t h ầ n
h o à n g l a n	h o à n g l a n
c h i ề u c a o	c h i ề u c a o
d ò n g c h ả y	d ò n g c h ả y
t h ă m q u a n	t h ă m q u a n
n g u y ê n l í	n g u y ê n l í
x ư ơ n g x ẩ u	x ư ơ n g x ẩ u
p h o n g l ư u	p h o n g l ư u
d i c h u y ể n	d i c h u y ể n
c h ấ p n h ậ n	c h ấ p n h ậ n
n g u y ê n c ớ	n g u y ê n c ớ
g i a o h o á n	g i a o h o á n
g i a o d ị c h	g i a o d ị c h
p h o n g t h á i	p h o n g t h á i
t i ế n g v a n g	t i ế n g v a n g
d u h ọ c s i n h	d u h ọ c s i n h
g a n b à n t a y	g a n b à n t a y
đ ứ c q u ố c x ã	đ ứ c q u ố c x ã
t à u s â n b a y	t à u s â n b a y
m ũ b ả o h i ể m	m ũ b ả o h i ể m
s i n h l ý h ọ c	s i n h l í h ọ c
n a m b á n c ầ u	n a m b á n c ầ u
b á o h o a m a i	b á o h o a m a i
k ẹ o b ơ c ứ n g	k ẹ o b ơ c ứ n g
k h ả o c ổ h ọ c	k h ả o c ổ h ọ c
b á n h d a h e o	b á n h d a h e o
v ũ t r ụ l u ậ n	v ũ t r ụ l u ậ n
t h ư đ i ệ n t ử	t h ư đ i ệ n t ử
đ ộ n g l ư ợ n g	đ ộ n g l ư ợ n g
c a t a r i n a	c a t a r i n a
b á n đ ấ u g i á	b á n đ ấ u g i á
h o ạ c h đ ị n h	h o ạ c h đ ị n h
n ộ i m ô n g c ổ	n ộ i m ô n g c ổ
n ộ i t i ế t t ố	n ộ i t i ế t t ố
t ế t â m l ị c h	t ế t â m l ị c h
đ i c ô n g t á c	đ i c ô n g t á c
m ạ n g x ã h ộ i	m ạ n g x ã h ộ i
g ấ p l à m đ ô i	g ấ p l à m đ ô i
r ắ n c ạ p n i a	r ắ n c ạ p n i a
b ờ b i ể n n g à	b ờ b i ể n g à
b ả o g i a l ợ i	b ả o g i a l ợ i
g á i m ạ i d â m	g á i m ạ i d â m
p h ó đ ô đ ố c	p h ó đ ô đ ố c
a c e	a n h c h ị e m
b ạ n đ ọ c	b ạ n đ ọ c
n ọ c đ ộ c	n ọ c đ ộ c
đ ặ c b i ệ t	đ ặ c b i ệ t
ố c a n h v ũ	ố c a n h v ũ
đ ộ n g đ ự c	đ ộ n g đ ự c
b i ệ t đ ộ i	b i ệ t đ ộ i
đ i ệ n b i ê n	đ i ệ n b i ê n
đ ậ u h à l a n	đ ậ u h à l a n
t â m l í h ọ c	t â m l í h ọ c
h o ạ t đ ộ n g	h o ạ t đ ộ n g
b ệ n h v i ệ n	b ệ n h v i ệ n
đ ồ n g đ i ệ u	đ ồ n g đ i ệ u
t h á p d i n h d ư ỡ n g	t h á p d i n h d ư ỡ n g
a n h c h ị e m	a n h c h ị e m
b ấ t đ ắ c d ĩ	b ấ t đ ắ c d ĩ
đ ứ c h ồ n g y	đ ứ c h ồ n g y
đ ộ c q u y ề n	đ ộ c q u y ề n
đ ộ n g m ạ c h	đ ộ n g m ạ c h
n g ữ â m h ọ c	n g ữ â m h ọ c
q u ạ t đ i ệ n	q u ạ t đ i ệ n
h ợ p â m r ả i	h ợ p â m r ả i
n ộ i b à o t ử	n ộ i b à o t ử
đ ô n g n a m á	đ ô n g n a m á
b ạ c h t u ộ c	b ạ c h t u ộ c
b ạ c h t u ộ t	b ạ c h t u ộ t
t r ư ờ n g m ầ m n o n	t r ư ờ n g m ầ m n o n
g i ả k i m t h u ậ t	g i ả k i m t h u ậ t
k h ô n g b a o g i ờ	k h ô n g b a o g i ờ
d a n h t ừ c h u n g	d a n h t ừ c h u n g
n h i ế p ả n h g i a	n h i ế p ả n h g i a
c à p h ê c à p h á o	c à p h ê c à p h á o
n g o ạ i t r u y ệ n	n g o ạ i t r u y ệ n
t h ứ c ă n n h a n h	t h ứ c ă n n h a n h
t h i ê n n i ê n k ỉ	t h i ê n n i ê n k ỉ
s i ê u t â n t i n h	s i ê u t â n t i n h
c ô n g t h ứ c m á u	c ô n g t h ứ c m á u
m ã n g c ầ u x i ê m	m ã n g c ầ u x i ê m
t â y v ư ơ n g m ẫ u	t â y v ư ơ n g m ẫ u
h ằ n g đ ẳ n g t h ứ c	h ằ n g đ ẳ n g t h ứ c
l u y ệ n n g ụ c	l u y ệ n g ụ c
t h a n h t r a v i ê n	t h a n h t r a v i ê n
h ắ c l o n g g i a n g	h ắ c l o n g g i a n g
c h ữ t r u n g q u ố c	c h ữ t r u n g q u ố c
p h á t n g ô n v i ê n	p h á t n g ô n v i ê n
s á c h g i á o k h o a	s á c h g i á o k h o a
k h ô n g q u ố c g i a	k h ô n g q u ố c g i a
t h á n g m ư ờ i h a i	t h á n g m ư ờ i h a i
h ả i v ư ơ n g t i n h	h ả i v ư ơ n g t i n h
c h ữ s ố c ó n g h ĩ a	c h ữ s ố c ó n g h ĩ a
t a m g i á c v u ô n g	t a m g i á c v u ô n g
t h ư ợ n g n g h ị s ĩ	t h ư ợ n g n g h ị s ĩ
b ạ c h t h o ạ i	b ạ c h t h o ạ i
t à u c á n h n g ầ m	t à u c á n h n g ầ m
t h ả o c ầ m v i ê n	t h ả o c ầ m v i ê n
t h ợ s ă n ả n h	t h ợ s ă n ả n h
t a m g i á c đ ề u	t a m g i á c đ ề u
p h i l u ậ t t â n	p h i l u ậ t t â n
c h u y ể n đ ộ n g	c h u y ể n đ ộ n g
t i n h t h ể h ọ c	t i n h t h ể h ọ c
k h ú c c ô n c ầ u	k h ú c c ô n c ầ u
b ỏ n g o à i t a i	b ỏ n g o à i t a i
ả o t h u ậ t g i a	ả o t h u ậ t g i a
k í n h đ e o m ắ t	k í n h đ e o m ắ t
t h ờ i b a o c ấ p	t h ờ i b a o c ấ p
h ợ p p h á p h o á	h ợ p p h á p h o á
n h à ả o t h u ậ t	n h à ả o t h u ậ t
n ư ớ c r ử a t a y	n ư ớ c d ử a t a y
t ụ c ầ u k h u ẩ n	t ụ c ầ u k h u ẩ n
t r i t h ứ c l u ậ n	t r i t h ứ c l u ậ n
c ô n g t ố v i ê n	c ô n g t ố v i ê n
n ộ i k h í q u ả n	n ộ i k h í q u ả n
n h ư đ ú n g r ồ i	n h ư đ ú n g r ồ i
s ơ n h ả i q u a n	s ơ n h ả i q u a n
t h ự c d â n h o á	t h ự c d â n h o á
r â u q u a i n ó n	r â u q u a i n ó n
n g ô n n g ữ h ọ c	n g ô n n g ữ h ọ c
đ ư ờ n g c ô n i c	đ ư ờ n g c ô n i c
n h à k h o a h ọ c	n h à k h o a h ọ c
n h ị p đ i ệ u	n h ị p đ i ệ u
m o l i p đ e n	m ô l i p đ e n
a l ị c h s ơ n	a l ị c h s ơ n
<<unk>> i r i c o n i	d i r i c o n i
f a n h â m m ộ	p h a n h â m ộ
đ ụ n g c h ạ m	đ ụ n g c h ạ m
á c ă n đ ì n h	á c ă n đ ì n h
đ ư ơ n g đ ạ i	đ ư ơ n g đ ạ i
đ i ệ n t o á n	đ i ệ n t o á n
s ố n g đ ộ n g	s ố n g đ ộ n g
t h ự c t ế ả o	t h ự c t ế ả o
b ư ơ m b ư ớ m	b ư ơ m b ư ớ m
b ò n g b ò n g	b ò n g b ò n g
k ẹ o c a o s u	k ẹ o c a o s u
v i ệ t c ộ n g	v i ệ t c ộ n g
n g o ạ n m ụ c	n g o ạ n m ụ c
b i ế n l o ạ n	b i ế n l o ạ n
đ ị n h l u ậ t	đ ị n h l u ậ t
s ê v ê r i n ô	s ê v ê r i n ô
đ ỏ n g đ ả n h	đ ỏ n g đ ả n h
b ồ đ à o n h a	b ồ đ à o n h a
đ ô n g l ạ n h	đ ô n g l ạ n h
t à u c h ợ l ớ n	t à u c h ợ l ớ n
t u y ệ t t h ự c	t u y ệ t t h ự c
h u ấ n l u y ệ n	h u ấ n l u y ệ n
n h i ệ t l i ệ t	n h i ệ t l i ệ t
s i ê u v i r u s	s i ê u v i r u s
đ ộ n g v i ê n	đ ộ n g v i ê n
n h i ễ m đ ộ c	n h i ễ m đ ộ c
c ô r n ê l i ô	c ô n ê l i ô
b ặ t t h i ệ p	b ặ t t h i ệ p
đ o ả n m ạ c h	đ o ả n m ạ c h
b a c o n s ó i	b a c o n s ó i
h ợ p t á c x ã	h ợ p t á c x ã
b ệ n h d ị c h	b ệ n h d ị c h
h ạ s ĩ q u a n	h ạ s ĩ q u a n
đ ồ n g p h ụ c	đ ồ n g p h ụ c
m ệ n h l ệ n h	m ệ n h l ệ n h
c ô n g đ o ạ n	c ô n g đ o ạ n
t u y ệ t đ ố i	t u y ệ t đ ố i
s à n h đ i ệ u	s à n h đ i ệ u
h i ệ p đ ị n h	h i ệ p đ ị n h
đ ộ t q u y ế t	đ ộ t q u y ế t
đ ạ i h ọ c	đ ạ i h ọ c
t ử v ì đ ạ o	t ử v ì đ ạ o
h ọ c b ổ n g	h ọ c b ổ n g
d ư ợ c h ọ c	d ư ợ c h ọ c
đ i ệ n l ự c	đ i ệ n l ự c
t u t ừ h ọ c	t u t ừ h ọ c
đ ị a đ i ể m	đ ị a đ i ể m
đ ộ t b i ế n	đ ộ t b i ế n
đ è n đ i ệ n	đ è n đ i ệ n
b ậ n b ị u	b ậ n b ị u
b ị đ ộ n g	b ị đ ộ n g
đ á n h b ạ c	đ á n h b ạ c
x q u a n g	x q u a n g
u r b a n ô	u r b a n ô
b ụ i b ặ m	b ụ i b ặ m
b ị a đ ặ t	b ị a đ ặ t
đ ầ u đ ộ c	đ ầ u đ ộ c
đ ộ c đ á o	đ ộ c đ á o
b ự c d ọ c	b ự c d ọ c
đ ạ i l ụ c	đ ạ i l ụ c
t t x	t h ô n g t ấ n x ã
đ ế q u ố c m ĩ	đ ế q u ố c m ĩ
đ ị a n g ụ c	đ ị a n g ụ c
m ặ c t â y c a	m ặ c t â y c a
n ó n b a t ầ m	n ó n b a t ầ m
b ọ t b i ể n	b ọ t b i ể n
đ ạ i d i ệ n	đ ạ i d i ệ n
b i ệ t l ậ p	b i ệ t l ậ p
đ ộ n g l ự c	đ ộ n g l ự c
t ụ c b i ê n	t ụ c b i ê n
b ắ t b u ộ c	b ắ t b u ộ c
đ i ệ n đ à m	đ i ệ n đ à m
v õ s ĩ đ ạ o	v õ s ĩ đ ạ o
e l e c t r o n	e l e c t r o n
b ư u đ i ệ n	b ư u đ i ệ n
b á o đ ộ n g	b á o đ ộ n g
đ ặ c đ i ể m	đ ặ c đ i ể m
đ ồ n g đ ộ i	đ ồ n g đ ộ i
i n h a x i ô	i n h a x i ô
đ ồ n g b ạ c	đ ồ n g b ạ c
t ạ m b i ệ t	t ạ m b i ệ t
đ á n h b ạ i	đ á n h b ạ i
b ệ n h t ậ t	b ệ n h t ậ t
b u ồ n b ự c	b u ồ n b ự c
g a n n h i ễ m m ỡ	g a n n h i ễ m m ỡ
n h i ệ t l ư ợ n g	n h i ệ t l ư ợ n g
t h u y ế t p h ụ c	t h u y ế t p h ụ c
s ố t h ậ p p h â n	s ố t h ậ p p h â n
g i ấ y v ệ s i n h	d ấ y v ệ s i n h
g ỗ t r ô i g i ạ t	g ỗ t r ô i g i ạ t
t a m g i á c c â n	t a m g i á c c â n
n g ư ờ i t h ứ b a	n g ư ờ i t h ứ b a
t i ề n t r u y ệ n	t i ề n t r u y ệ n
n h u y ế u p h ẩ m	n h u y ế u p h ẩ m
c á m ặ t t r ă n g	c á m ặ t t r ă n g
t r ọ n g l ư ợ n g	t r ọ n g l ư ợ n g
p h ầ n m ề m x ấ u	p h ầ n m ề m x ấ u
q u ố c t ử g i á m	q u ố c t ử g i á m
đ ư ơ n g n h i ệ m	đ ư ơ n g n h i ệ m
p h ậ t l ã n g s a	p h ậ t l ã n g s a
n g u y ê n l i ệ u	n g u y ê n l i ệ u
q u y ế n t h u ộ c	q u y ế n t h u ộ c
t u y ệ t c h i ê u	t u y ệ t c h i ê u
c h ú a s ơ n l â m	c h ú a s ơ n l â m
c h u y ê n d ụ n g	c h u y ê n d ụ n g
k í n h h i ể n v i	k í n h h i ể n v i
s i n h t h ự c k h í	s i n h t h ự c k h í
n h à n g h i ê n c ứ u	n h à n g h i ê n c ứ u
c h u y ê n n g h i ệ p	c h u y ê n n g h i ệ p
t r â n c h â u c ả n g	c h â n c h â u c ả n g
t h u y ê n c h u y ể n	t h u y ê n c h u y ể n
t r ă m p h ầ n t r ă m	t r ă m p h ầ n t r ă m
t u y ê n t r u y ề n	t u y ê n t r u y ề n
c h è t r ô i n ư ớ c	c h è t r ô i n ư ớ c
t i ế n g n ữ c h â n	t i ế n g n ữ c h â n
p h á g i a c h i t ử	p h á g i a c h i t ử
t h ế g i ớ i q u a n	t h ế g i ớ i q u a n
k h ổ n h ụ c k ế	k h ổ n h ụ c k ế
t h ú l ô n g n h í m	t h ú l ô n g n h í m
t r ú c p h u n h â n	c h ú c p h u n h â n
n h i ễ m s ắ c t h ể	n h i ễ m s ắ c t h ể
h ì n h c h ữ n h ậ t	h ì n h c h ữ n h ậ t
x e c ứ u t h ư ơ n g	x e c ứ u t h ư ơ n g
p h ế c ầ u k h u ẩ n	p h ế c ầ u k h u ẩ n
l o a n h q u a n h	l o a n h q u a n h
h a i b à t r ư n g	h a i b à t r ư n g
đ ư ờ n g h u y ế t	đ ư ờ n g h u y ế t
s ả n p h ụ k h o a	s ả n p h ụ k h o a
t ế b à o c h ấ t	t ế b à o c h ấ t
h ọ c t h u y ế t	h ọ c t h u y ế t
v ũ l ư ợ n g k ế	v ũ l ư ợ n g k ế
a n p h o n g s ô	a n p h o n g s ô
u n g t h ư g a n	u n g t h ư g a n
q u a n t h ế â m	q u a n t h ế â m
k i ể m d u y ệ t	k i ể m d u y ệ t
b ư ớ c đ ư ờ n g	b ư ớ c đ ư ờ n g
q u y ế t đ ị n h	q u y ế t đ ị n h
r ộ n g l ư ợ n g	r ộ n g l ư ợ n g
q u ầ n x à l ỏ n	q u ầ n x à l ỏ n
đ ồ n g t h u ậ n	đ ồ n g t h u ậ n
n h i ệ t b i ể u	n h i ệ t b i ể u
n h ư ợ c đ i ể m	n h ư ợ c đ i ể m
k h u ế c h đ ạ i	k h u ế c h đ ạ i
t h a n h đ i ệ u	t h a n h đ i ệ u
b ạ c h d ư ơ n g	b ạ c h d ư ơ n g
t â n t â y l a n	t â n t â y l a n
n g ư ờ i d a đ ỏ	n g ư ờ i d a đ ỏ
k i m t ự t h á p	k i m t ự t h á p
h o à i n a m t ử	h o à i n a m t ử
l ễ c á c t h á n h	l ễ c á c t h á n h
b ô n g t u y ế t	b ô n g t u y ế t
b ằ n g l á i x e	b ằ n g l á i x e
q u y ế t l i ệ t	q u y ế t l i ệ t
t r ọ n g v ọ n g	t r ọ n g v ọ n g
s ố t ự n h i ê n	s ố t ự n h i ê n
q u á n t h ế â m	q u á n t h ế â m
đ i ể m x u y ế t	đ i ể m x u y ế t
b i ể u t ư ợ n g	b i ể u t ư ợ n g
đ ộ n g p h ò n g	đ ộ n g p h ò n g
k ĩ t h u ậ t s ố	k ĩ t h u ậ t s ố
n ấ m đ ầ u k h ỉ	n ấ m đ ầ u k h ỉ
h ầ m b à l ằ n g	h ầ m b à l ằ n g
t ố i h ậ u t h ư	t ố i h ậ u t h ư
c h ó s ó i đ ấ t	c h ó s ó i đ ấ t
t ô c á c h l a n	t ô c á c h l a n
v ò i h o a s e n	v ò i h o a s e n
đ ồ n g r u ộ n g	đ ồ n g r u ộ n g
b i ể u q u y ế t	b i ể u q u y ế t
t â y b a n n h a	t â y b a n n h a
l ễ c á c đ ẳ n g	l ễ c á c đ ẳ n g
t h ơ c o n c ó c	t h ơ c o n c ó c
v ò n g q u a n h	v ò n g q u a n h
c h i ề u r ộ n g	c h i ề u r ộ n g
r ỗ n g t u ế c h	r ỗ n g t u ế c h
đ a n g ô n n g ữ	đ a n g ô n n g ữ
t i ế n g v i ệ t	t i ế n g v i ệ t
c h ứ n g b ệ n h	c h ứ n g b ệ n h
x u n g q u a n h	x u n g q u a n h
t r i ể n v ọ n g	c h i ể n v ọ n g
b i ể u d ư ơ n g	b i ể u d ư ơ n g
m ở n ắ p c h a i	m ở n ắ p c h a i
c h ê n h l ệ c h	c h ê n h l ệ c h
t r ự c t h u ộ c	t r ự c t h u ộ c
k h ỉ đ ầ u c h ó	k h ỉ đ ầ u c h ó
m ã n g c ầ u t a	m ã n g c ầ u t a
k h i ế u k i ệ n	k h i ế u k i ệ n
đ i ề u d ư ỡ n g	đ i ề u d ư ỡ n g
b ă n g h u y ế t	b ă n g h u y ế t
t r i n h b ạ c h	t r i n h b ạ c h
k h a i h u y ệ t	k h a i h u y ệ t
n h à v ă n h o á	n h à v ă n h o á
t r u y ề n đ ơ n	t r u y ề n đ ơ n
l i ệ t d ư ơ n g	l i ệ t d ư ơ n g
n g u y ệ t c ầ m	n g u y ệ t c ầ m
c ả n h t ư ợ n g	c ả n h t ư ợ n g
l ư ờ i b i ế n g	l ư ờ i b i ế n g
k h ỉ m ặ t c h ó	k h ỉ m ặ t c h ó
đ à i n g u y ê n	đ à i n g u y ê n
c h ó s ó i l ử a	c h ó s ó i l ử a
p h ỏ n g đ o á n	p h ỏ n g đ o á n
q u ố c d o a n h	q u ố c d o a n h
t r u n g đ ô n g	t r u n g đ ô n g
b ấ t k h ả t h i	b ấ t k h ả t h i
n g o ạ i m ô n g	n g o ạ i m ô n g
d o a n h t r ạ i	d o a n h t r ạ i
c u n g p h ụ n g	c u n g p h ụ n g
n ồ n g n h i ệ t	n ồ n g n h i ệ t
n g u y ê n đ á n	n g u y ê n đ á n
c ố t t r u y ệ n	c ố t t r u y ệ n
l ư ỡ n g v i ệ n	l ư ỡ n g v i ệ n
b á c h t h a n h	b á c h t h a c
n g o ạ i q u ố c	n g o ạ i q u ố c
t r ự c t u y ế n	t r ự c t u y ế n
k h ù n g k h ụ c	k h ù n g k h ụ c
x u ấ t h u y ế t	x u ấ t h u y ế t
c h i ế n l ư ợ c	c h i ế n l ư ợ c
q u ả n t ư ợ n g	q u ả n t ư ợ n g
t r u n g t i ệ n	t r u n g t i ệ n
t h u ầ n v i ệ t	t h u ầ n v i ệ t
t h ị n h s o ạ n	t h ị n h s o ạ n
n h à v ệ s i n h	n h à v ệ s i n h
q u e n t h u ộ c	q u e n t h u ộ c
l o n g t r ọ n g	l o n g t r ọ n g
đ i ề u t i ế n g	đ i ề u t i ế n g
n ã o c á v à n g	n ã o c á v à n g
n ó i c h u y ệ n	n ó i c h u y ệ n
t h ư ơ n g đ ộ i	t h ư ơ n g đ ộ i
p h i v ậ t t h ể	p h i v ậ t t h ể
ố n g n g h i ệ m	ố n g n g h i ệ m
b u ồ n p h i ề n	b u ồ n p h i ề n
t h ư ơ n g l ư ợ n g	t h ư ơ n g l ư ợ n g
t h à n h q u á c h	t h à n h q u á c h
k h í l í t ư ở n g	k h í l í t ư ở n g
k h u y ế t d a n h	k h u y ế t d a n h
k h ệ n h k h ạ n g	k h ệ n h k h ạ n g
q u y ể n t r u n g	q u y ể n t r u n g
t i ể u t h u y ế t	t i ể u t h u y ế t
t h ư ợ n g s á c h	t h ư ợ n g s á c h
đ ư ơ n g n h i ê n	đ ư ơ n g n h i ê n
p h ư ơ n g đ ô n g	p h ư ơ n g đ ô n g
t r ì n h d u y ệ t	t r ì n h d u y ệ t
t h i ê n đ ư ờ n g	t h i ê n đ ư ờ n g
t r à t r â n c h â u	t r à t r â n c h â u
n g h ề c ủ a n à n g	n g h ề c ủ a n à n g
c h u y ê n t r á c h	c h u y ê n t r á c h
c h u n g q u a n h	t r u n g q u a n h
t r u n g n g u y ê n	t r u n g n g u y ê n
n g ư ờ i t h ư ợ n g	n g ư ờ i t h ư ợ n g
t h u ỷ t i n h t h ể	t h u ỷ t i n h t h ể
n g o ạ i t h ư ơ n g	n g o ạ i t h ư ơ n g
t h ư ờ n g x u y ê n	t h ư ờ n g x u y ê n
t r u y ề n t h ô n g	t r u y ề n t h ô n g
t h a m t h ì t h â m	t h a m t h ì t h â m
n g o à i g i á t h ú	n g o à i g i á t h ú
n g ư ợ n g n g h ị u	n g ư ợ n g n g h ị u
n h à c h í n h t r ị	n h à c h í n h t r ị
c h ủ n g h ĩ a m á c	c h ủ n g h ĩ a m á c
t h ư ơ n g n g h i ệ p	t h ư ơ n g g h i ệ p
k h á n t h í n h g i ả	k h á n t h í n h g i ả
đ ồ n g l ư ơ n g	đ ồ n g l ư ơ n g
t h u ố c p h i ệ n	t h u ố c p h i ệ n
l ò s á t s i n h	l ò s á t s i n h
t r i ề u p h ụ c	c h i ề u p h ụ c
t h ậ n t r ọ n g	t h ậ n t r ọ n g
c h u y ể n đ ổ i	c h u y ể n đ ổ i
t r o n g s ạ c h	t r o n g s ạ c h
b ồ n g c h a n h	b ồ n g c h a n h
b ì n h t h u ậ n	b ì n h t h u ậ n
c h ố n g n ạ n h	c h ố n g n ạ n h
k i ế m t h u ậ t	k i ế m t h u ậ t
t i ể u đ ư ờ n g	t i ể u đ ư ờ n g
n g o ạ i t i ế p	n g o ạ i t i ế p
đ i ề u k h i ể n	đ i ề u k h i ể n
h i ệ u t h u ố c	h i ệ u t h u ố c
t ư ờ n g t h u ậ t	t ư ờ n g t h u ậ t
đ ộ i t r ư ở n g	đ ộ i t r ư ở n g
h o a n g đ ư ờ n g	h o a n g đ ư ờ n g
v i t í c h p h â n	v i t í c h p h â n
h i ệ n t r ư ờ n g	h i ệ n t r ư ờ n g
k i ể m n g h i ệ m	k i ể m n g h i ệ m
t h ự c n g h i ệ m	t h ự c n g h i ệ m
n g a y t ứ c t h ì	n g a y t ứ c t h ì
n a m n h â n n g ư	n a m n h â n n g ư
n g u y ê n s o á i	n g u y ê n s o á i
c h i ế n t h u ậ t	c h i ế n t h u ậ t
h u y ế t t ư ơ n g	h u y ế t t ư ơ n g
n g o ặ c v u ô n g	n g o ặ c v u ô n g
d o t h á i g i á o	d o t h á i g i á o
t h ư ơ n g h i ệ u	t h ư ơ n g h i ệ u
k h u y ế t t ị c h	k h u y ế t t ị c h
đ ặ c c ô n g	đ ặ c c ô n g
n ư ớ c b ọ t	n ư ớ c b ọ t
t i ể u đ ộ i	t i ể u đ ộ i
đ i p r o <<unk>> i	đ i p r o <unk> i
đ ạ o d i ễ n	đ ạ o d i ễ n
a n t i m o n	a n t i m o n
đ ậ u r ồ n g	đ ậ u r ồ n g
x e h o n d a	x e h o n d a
đ ư ờ i ư ơ i	đ ư ờ i ư ơ i
đ ầ u đ u ô i	đ ầ u đ u ô i
m á y đ i ệ n	m á y đ i ệ n
b ã i b i ể n	b ã i b i ể n
c ư ớ p b ó c	c ư ớ p b ó c
b i ể n đ ứ c	b i ể n đ ứ c
b á n h b è o	b á n h b è o
đ ạ i d ị c h	đ ạ i d ị c h
h ọ c v i ê n	h ọ c v i ê n
t ậ n d ụ n g	t ậ n d ụ n g
o ẳ n t ù t ì	o ẳ n t ù t ì
t i ể u h ọ c	t i ể u h ọ c
h ọ c h à n h	h ọ c h à n h
b á n h b í a	b á n h b í a
đ ạ i l i ê n	đ ạ i l i ê n
đ ô n g b ắ c	đ ô n g b ắ c
s ô i đ ộ n g	x ô i đ ộ n g
d i ễ n đ ạ t	d i ễ n đ ạ t
b ì n h đ ị a	b ì n h đ ị a
b á n h l ọ t	b á n h l ọ t
g ó c c ạ n h	g ó c c ạ n h
t ậ p d ư ợ t	t ậ p d ư ợ t
l ụ c b ì n h	l ụ c b ì n h
b á n h b a o	b á n h b a o
h ợ p đ ồ n g	h ợ p đ ồ n g
b ó n g đ á i	b ó n g đ á i
m ạ n h d ạ n	m ạ n h d ạ n
b ê n c ạ n h	b ê n c ạ n h
b u ô n l ậ u	b u ô n l ậ u
k i l ô o a t	k i l ô o a t
b ấ t b i ế n	b ấ t b i ế n
l ạ c v i ệ t	l ạ c v i ệ t
đ ẩ y m ạ n h	đ ẩ y m ạ n h
m ặ c đ ị n h	m ặ c đ ị n h
c ờ b a q u e	c ờ b a q u e
b ạ c h k i m	b ạ c h k i m
p a r a b o l	p a r a b o l
b ạ c h h ầ u	b ạ c h h ầ u
t i ế t m ụ c	t i ế t m ụ c
t á c đ ộ n g	t á c đ ộ n g
l ã n h đ ạ o	l ã n h đ ạ o
đ á n h đ ổ i	đ á n h đ ổ i
r ụ c r ị c h	r ụ c r ị c h
đ ắ m đ u ố i	đ ắ m đ u ố i
n ò n g n ọ c	n ò n g n ọ c
đ ậ u n à n h	đ ậ u n à n h
m ạ c h l ạ c	m ạ c h l ạ c
đ ĩ n h đ ạ c	đ ĩ n h đ ạ c
đ i ê n đ ả o	đ i ê n đ ả o
đ ặ t v ò n g	đ ặ t v ò n g
h i ế u h ọ c	h i ế u h ọ c
đ a u b u ồ n	đ a u b u ồ n
b ư ớ m đ ê m	b ư ớ m đ ê m
l ậ t đ ậ t	l ậ t đ ậ t
đ ấ m b ố c	đ ấ m b ố c
n g ộ đ ộ c	n g ộ đ ộ c
c ậ y c ụ c	c ậ y c ụ c
đ ạ i n ộ i	đ ạ i n ộ i
á o b a l ỗ	á o b a l ỗ
đ ạ i b á c	đ ạ i b á c
m ụ c s ú c	m ụ c s ú c
h ọ c t ậ p	h ọ c t ậ p
m ộ c m ạ c	m ộ c m ạ c
l ê t h ị b	l ê t h ị b
b ậ p b õ m	b ậ p b õ m
g ậ y g ộ c	g ậ y g ộ c
đ ề u đ ặ n	đ ề u đ ặ n
b ạ o l ự c	b ạ o l ự c
h ạ m đ ộ i	h ạ m đ ộ i
b ạ c b ẽ o	b ạ c b ẽ o
b ạ n đ ờ i	b ạ n đ ờ i
đ ầ u đ ạ n	đ ầ u đ ạ n
g ó c b ẹ t	g ó c b ẹ t
b ê n a đ ô	b ê n a đ ô
b ả n đ ị a	b ả n đ ị a
r u b i đ i	r u b i đ i
b à y đ ặ t	b à y đ ặ t
b ó b u ộ c	b ó b u ộ c
y t e c b i	y t e c b i
h ọ c l ự c	h ọ c l ự c
đ ộ c á c	đ ộ c á c
c ụ c b ộ	c ụ c b ộ
b ộ đ ộ i	b ộ đ ộ i
b ậ p b ẹ	b ậ p b ẹ
b ộ t g i ặ t	b ộ t g i ặ t
đ ậ u x a n h	đ ậ u x a n h
b i ệ n h à n	b i ệ n h à n
l a o đ ộ n g	l a o đ ộ n g
k ẹ o đ ồ n g	k ẹ o đ ồ n g
t a m â m l a	t a m â m l a
r ư ợ u b i a	r i ệ u b i a
l i ê n đ ộ i	l i ê n đ ộ i
h i ệ p h ộ i	h i ệ p h ộ i
đ ộ t n h ậ p	đ ộ t n h ậ p
l ụ c q u â n	l ụ c q u â n
v ậ n m ệ n h	v ậ n m ệ n h
m o n g đ ợ i	m o n g đ ợ i
b i ệ t t h ự	b i ệ t t h ự
d ẹ p t i ệ m	d ẹ p t i ệ m
p h ò n g m ạ c h	p h ò n g m ạ c h
t u ầ n l ộ c	t u ầ n l ộ c
h ộ p q u ẹ t	h ộ p q u ẹ t
b ệ n h á n	b ệ n h á n
b à i h ọ c	b à i h ọ c
b ì m b ị p	b ì m b ị p
v ẩ n đ ụ c	v ẩ n đ ụ c
c ự c đ ạ i	c ự c đ ạ i
ố c b ư ơ u	ố c b ư ơ u
b à n b ạ c	b à n b ạ c
đ ị a đ ầ u	đ ị a đ ầ u
b ụ n g d ạ	b ụ n g d ạ
s ụ c s ạ o	s ụ c s ạ o
l ễ t ạ ơ n	l ễ t ạ ơ n
b á c h ọ c	b á c h ọ c
b á n h c u ố n	b á n h c u ố n
g i a i đ o ạ n	d a i đ o ạ n
c ư ớ p b i ể n	c ư ớ p b i ể n
n h ạ c v i ệ n	n h ạ c v i ệ n
c ô n g đ o à n	c ô n g đ o à n
c á n h q u ạ t	c á n h q u ạ t
k i ể m đ ị n h	k i ể m đ ị n h
b ệ n h t h a n	b ệ n h t h a n
h i ệ u s u ấ t	h i ệ u s u ấ t
t r i ề u đ ạ i	c h i ề u đ ạ i
q u e n b i ế t	q u e n b i ế t
đ ạ i c h ú n g	đ ạ i c h ú n g
t h ạ c h l ự u	t h ạ c h l ự u
b ì n h d i ệ n	b ì n h d i ệ n
m i n h b ạ c h	m i n h b ạ c h
ô n g n g o ạ i	ô n g n g o ạ i
h o ạ t c ả n h	h o ạ t c ả n h
b ấ m c h u ộ t	b ấ m c h u ộ t
g i ố n g đ ự c	r ố n g đ ự c
t o à n d i ệ n	t o à n d i ệ n
t i ê u đ i ể m	t i ê u đ i ể m
t h ụ c m ạ n g	t h ụ c m ạ n g
ố n g q u y ể n	ố n g q u y ể n
m ệ n h d a n h	m ệ n h d a n h
y ê u t h u ậ t	y ê u t h u ậ t
h i ể u b i ế t	h i ể u b i ế t
s i n h đ ộ n g	s i n h đ ộ n g
k h á c b i ệ t	k h á c b i ệ t
r ạ n g đ ô n g	r ạ n g đ ô n g
b ệ n h n h â n	b ệ n h n h â n
b ộ t c h i ê n	b ộ t c h i ê n
t u y ể n t ậ p	t u y ể n t ậ p
m ụ c t i ê u	m ụ c t i ê u
t r ư ờ n g h ọ c	t r ư ờ n g h ọ c
b i ế n t h à n h	b i ế n t h à n h
m ã n n g u y ệ n	m ã n n g u y ệ n
q u ố c t ế n g ữ	q u ố c t ế n g ữ
q u ả n g đ ô n g	q u ả n g đ ô n g
h o à n t h i ệ n	h o à n t h i ệ n
p h ụ n g p h ị u	p h ụ n g p h ị u
q u a n đ i ể m	q u a n đ i ể m
đ ồ n g b ằ n g	đ ồ n g b ằ n g
l i n h đ ộ n g	l i n h đ ộ n g
đ á d a t r ờ i	đ á d a t r ờ i
t u y ế n đ ầ u	t u y ế n đ ầ u
l i ê n đ o à n	l i ê n đ o à n
a n l ê m â n	a n l ê m â n
ô k h ắ c l a n	ô k h ắ c l a n
l o ạ n l u â n	l o ạ n l u â n
b á c s ĩ n h i	b á c s ĩ n h i
c ổ t ử c u n g	c ổ t ử c u n g
t h ự c d ụ n g	t h ự c d ụ n g
t h u ậ n l ợ i	t h u ậ n l ợ i
đ ồ n g h à n h	đ ồ n g h à n h
c ô n g c u ộ c	c ô n g c u ộ c
đ i ể m d a n h	đ i ể m d a n h
đ ị n h d a n h	đ ị n h d a n h
l ợ i n h u ậ n	l ợ i n h u ậ n
t ổ n g c ộ n g	t ổ n g c ộ n
x e c ấ p c ứ u	x e c ấ p c ứ u
p h â n b i ệ t	p h â n b i ệ t
t ư ợ n g đ à i	t ư ợ n g đ à i
b ì n h l u ậ n	b ì n h l u ậ n
p h ụ c t ù n g	p h ụ c t ù n g
t i ể u l u ậ n	t i ể u l u ậ n
c a n h k i n a	c a n h k i n a
t ạ i n g o ạ i	t ạ i n g o ạ i
t h ố n g đ ố c	t h ố n g đ ố c
đ ậ u t ư ơ n g	đ ậ u t ư ơ n g
đ ộ n g n ă n g	đ ộ n g n ă n g
q u â n đ o à n	q u â n đ o à n
m ặ t đ ư ờ n g	m ặ t đ ư ờ n g
r u ộ t t h ị t	r u ộ t t h ị t
b á n h c ố n g	b á n h c ố n g
đ o à n v i ê n	đ o à n v i ê n
p h o n g t ụ c	p h o n g t ụ c
b i ê n n h ậ n	b i ê n n h ậ n
t i ể u đ o à n	t i ể u đ o à n
t i ể u m ạ c h	t i ể u m ạ c h
l i ê n h i ệ p	l i ê n h i ệ p
t r ọ n g y ế u	t r ọ n g y ế u
c ô n g c ộ n g	c ô n g c ộ n g
đ ứ t b ó n g	đ ứ t b ó n g
b i ể n đ e n	b i ể n đ e n
đ u n g đ ư a	đ u n g đ ư a
k í t ú c x á	k í t ú c x á
x e b a g á c	x e b a g á c
h y p e b o l	h y p e b o l
b ấ t h ạ n h	b ấ t h ạ n h
đ ị a p h ậ n	đ ị a p h ậ n
t i ê u b i ể u	t i ê u b i ể u
k i ế n s ư t ử	k i ế n s ư t ử
v i ê m h ọ n g	v i ê m h ọ n g
h ạ c h s á c h	h ạ c h s á c h
s ố d â y n ó i	s ố d â y n ó i
p h ả n b i ệ n	p h ả n b i ệ n
l i ễ u h ạ n h	l i ễ u h ạ n h
c h u ộ t s ó c	c h u ộ t s ó c
b ư n g b i ề n	b ư n g b i ề n
d ò n g b i ể n	d ò n g b i ể n
m ò n g b i ể n	m ò n g b i ể n
s á c h l ư ợ c	s á c h l ư ợ c
đ ộ n g t h á i	đ ộ n g t h á i
k h ố c l i ệ t	k h ố c l i ệ t
t i ệ c t ù n g	t i ệ c t ù n g
b ệ n h t ì n h	b ệ n h t ì n h
k h á m b ệ n h	k h á m b ệ n h
đ ạ i d ư ơ n g	đ ạ i d ư ơ n g
h i ế m m u ộ n	h i ế m m u ộ n
c h u y ệ n đ ó	c h u y ệ n đ ó
b ẫ y c h u ộ t	b ẫ y c h u ộ t
n h ậ p c u ộ c	n h ậ p c u ộ c
n g ư ợ c đ ã i	n g ư ợ c đ ã i
t r i ế t h ọ c	c h i ế t h ọ c
c ờ c á n g ự a	c ờ c á n g ự a
h i ệ u s á c h	h i ệ u s á c h
t ự t r u y ệ n	t ự t r u y ệ n
b i ê n k ị c h	b i ê n k ị c h
l ạ m q u y ề n	l ạ m q u y ề n
v ô t í c h s ự	v ô t í c h s ự
t h à n h v i ê n	t h à n h v i ê n
t h a n h b ì n h	t h a n h b ì n h
l ư ơ n g t h ự c	l ư ơ n g t h ự c
c a o n g u y ê n	c a o n g u y ê n
t ổ n g t h ố n g	t ổ n g t h ố n
t ư ớ n g q u â n	t ư ớ n g q u â n
t h ẩ m q u y ế n	t h ẩ m q u y ế n
s ả n n g h i ệ p	s ả n n g h i ệ p
p h ó n g t ú n g	p h ó n g t ú n g
c h ổ n g k ề n h	c h ổ n g k ề n h
k h ẳ n g đ ị n h	k h ẳ n g đ ị n h
c h u ộ t l a n g	c h u ộ t l a n g
đ ố i n g h ị c h	đ ố i n g h ị c h
c h u y ể n h o á	c h u y ể n h o á
q u ố c k h á n h	q u ố c k h á n h
n h ậ t h o à n g	n h ậ t h o à n g
q u a n g g á n h	q u a n g g á n h
đ ồ n g p h ẳ n g	đ ồ n g p h ẳ n g
n h i ệ t t ì n h	n h i ệ t t ì n h
t h â n t h i ệ n	t h â n t h i ệ n
n g ọ n n g u ồ n	n g ọ n n g u ồ n
x a n h d ư ơ n g	x a n h d ư ơ n g
đ ị n h n g h ĩ a	đ ị n h n g h ĩ a
t i ê u k h i ể n	t i ê u k h i ể n
p h ó n g đ ã n g	p h ó n g đ ã n g
b á n h t r á n g	b á n h t r á n g
n ư ớ c m i ế n g	n ư ớ c m i ế n g
d u y ê n d á n g	d u y ê n d á n g
n ặ n g t r ị c h	n ặ n g t r ị c h
c h ấ p t h u ậ n	c h ấ p t h u ậ n
p h é p t h u ậ t	p h é p t h u ậ t
n h ấ n c h u ộ t	n h ấ n c h u ộ t
k h u n g c ả n h	k h u n g c ả n h
v i ễ n t ư ở n g	v i ễ n t ư ở n g
n i n h t h u ậ n	n i n h t h u ậ n
n h à n g u y ệ n	n h à n g u y ệ n
t r u n g t u ầ n	t r u n g t u ầ n
đ à n g h o à n g	đ à n g h o à n g
k h u y ế n m ã i	k h u y ế n m ã i
đ i ề u c h ỉ n h	đ i ề u c h ỉ n h
t r o n g l à n h	t r o n g l à n h
h i ế u k h á c h	h i ế u k h á c h
x o à i r i ê n g	x o à i r i ê n g
t h â n n h i ệ t	t h â n n h i ệ t
đ ơ n p h ư ơ n g	đ ơ n p h ư ơ n g
n g h ĩ a b ó n g	n g h ĩ a b ó n g
k h o a n h ồ n g	k h o a n h ồ n g
n g ạ i n g ù n g	n g ạ i n g ù n g
l ồ n g t i ế n g	l ồ n g t i ế n g
t ì n h d u y ê n	t ì n h d u y ê n
h i ể n n h i ê n	h i ể n n h i ê n
t ư ơ n g q u a n	t ư ơ n g q u a n
l ờ i k h u y ê n	l ờ i k h u y ê n
t h ẩ m q u y ề n	t h ẩ m q u y ề n
t r ầ m t r ọ n g	t r ầ m t r ọ n g
t à i n g u y ê n	t à i n g u y ê n
đ à n g n g o à i	đ à n g n g o à i
n g o ạ i t h ấ t	n g o ạ i t h ấ t
c a i n g h i ệ n	c a i n g h i ệ n
đ ì n h c h i ế n	đ ì n h c h i ế n
n g h ị c h đ ả o	n g h ị c h đ ả o
t ố t n g h i ệ p	t ố t n g h i ệ p
n h i ệ t g i a i	n h i ệ t g i a i
v i ê m x o a n g	v i ê m x o a n g
p h á n q u y ế t	p h á n q u y ế t
p h i ề n t o á i	p h i ề n t o á i
đ a y n g h i ế n	đ a y n g h i ế n
t h i ê n t r ú c	t h i ê n t r ú c
đ ồ n g n g h ĩ a	đ ồ n g n g h ĩ a
t h u ố c s ú n g	t h u ố c s ú n g
t h i ế t t h ự c	t h i ế t t h ự c
m ĩ n h â n n g ư	m ĩ n h â n g ư
t h ầ n t ư ợ n g	t h ầ n t ư ợ n g
p h ư ơ n g h ạ i	p h ư ơ n g h ạ i
t r a n g p h ụ c	t r a n g p h ụ c
d a n h t i ế n g	d a n h t i ế n g
n ă n g l ư ợ n g	n ă n g l ư ợ n g
b ồ i t h ư ờ n g	b ồ i t h ư ờ n g
t h u y ê n t ắ c	t h u y ê n t ắ c
k h o ả n g c á c h	k h o ả n g c á c h
b ì n h t h ư ờ n g	b ì n h t h ư ờ n g
n ô n g t r ư ờ n g	n ô n g t r ư ờ n g
c h i ế n t r a n h	c h i ế n t r a n h
n g u y ê n h ì n h	n g u y ê n h ì n h
t r u y ề n h ì n h	t r u y ề n h ì n h
h o a n n g h ê n h	h o a n n g h ê n h
t h ư ờ n g n h ậ t	t h ư ờ n g n h ậ t
g i ả n g đ ư ờ n g	g i ả n g đ ư ờ n g
b ì n h n h ư ỡ n g	b ì n h n h ư ỡ n g
t r ư ờ n g q u a y	t r ư ờ n g q u a y
c h u n g c h u n g	t r u n g t r u n
t h a n h t h o á t	t h a n h t h o á t
c h i ề u h ư ớ n g	c h i ề u h ư ớ n g
p h ò n g k h ô n g	p h ò n g k h ô n g
n g o a n n g o ã n	n g o a n n g o ã n
c h ư ớ n g n g ạ i	c h ư ớ n g n g ạ i
p h o n g t h á n h	p h o n g t h á n h
k h ở i n g h i ệ p	k h ở i n g h i ệ p
h ư ớ n g d ư ơ n g	h ư ớ n g d ư ơ n g
t h u y ề n n h â n	t h u y ề n n h â n
n g ó c n g á c h	n g ó c n g á c h
n g h i ê n g n g h i ê n g	n g h i ê n g n g h i ê n g
t h ư ờ n g t h ư ờ n g	t h ư ờ n g t h ư ờ n g
k h u y n h h ư ớ n g	k h u y n h h ư ớ n g
t h ô n g t h o á n g	t h ô n g t h o á n g
t h i ê n g l i ê n g	t h i ê n g l i ê n g
k h i ê m n h ư ờ n g	k h i ê m n h ư ờ n g
t h à n h h o à n g	t h à n h h o à n g
n g a n g b ư ớ n g	n g a n g b ư ớ n g
b ì n h p h ư ơ n g	b ì n h p h ư ơ n g
s ú n g t r ư ờ n g	s ú n g t r ư ờ n g
n g h i ê m n g ặ t	n g h i ê m n g ặ t
t h i ê n n h i ê n	t h i ê n n h i ê n
h u â n c h ư ơ n g	h u â n c h ư ơ n g
l ò n g t h ư ơ n g	l ò n g t h ư ơ n g
t h ư ơ n g b i n h	t h ư ơ n g b i n h
t h u y ê n g i ả m	t h u y ê n g i ả m
c h u ồ n c h u ồ n	c h u ồ n c h u ồ n
c h ứ c n g h i ệ p	c h ứ c n g h i ệ p
q u ố c p h ò n g	q u ố c p h ò n g
p h ò n g c h ố n g	p h ò n g c h ố n g
n g ô n g c u ồ n g	n g ô n g c u ồ n g
l ó n g n g ó n g	l ó n g n g ó n g
b i ế n c h ứ n g	b i ế n c h ứ n g
s a n g t r ọ n g	s a n g t r ọ n g
n ư ớ c t ư ơ n g	n ư ớ c t ư ơ n g
n g o ạ i k h o á	n g o ạ i k h o á
đ á n h t h ắ n g	đ á n h t h ắ n g
m i ễ n c ư ỡ n g	m i ễ n c ư ỡ n g
l i ế n t h o ắ n g	l i ế n t h o ắ n g
g i a o t h i ệ p	g i a o t h i ệ p
h à n h k h á c h	h à n h k h á c h
g i a o t u y ế n	g i a o t u y ế n
t h à n h t h ậ t	t h à n h t h ậ t
k h o a i n ư ớ c	k h o a i n ư ớ c
l o à i n g ư ờ i	l o à i n g ư ờ i
t r ừ u t ư ợ n g	t r ừ u t ư ợ n g
g ắ n g g ư ợ n g	g ắ n g g ư ợ n g
n g o ạ i k h o a	n g o ạ i k h o a
t h a n h k h i ế t	t h a n h k h i ế t
t h u y ế t g i á o	t h u y ế t g i á o
k h ậ p k h i ễ n g	k h ậ p k h i ễ n g
l u ố n g c u ố n g	l u ố n g c u ố n g
t h ư ợ n g t ầ n g	t h ư ợ n g t ầ n g
k h o ả n h k h ắ c	k h o ả n h k h ắ c
k h ẩ u n g h i ệ p	k h ẩ u n g h i ệ p
t h ế g i ớ i n g ữ	t h ế g i ớ i n g ữ
t i ề n t h ư ở n g	t i ề n t h ư ở n g
n ư ớ c k h o á n g	n ư ớ c k h o á n g
n g ẫ u t ư ợ n g	n g ẫ u t ư ợ n g
b u ồ n g t r ứ n g	b u ồ n g t r ứ n g
p h o n g v ư ơ n g	p h o n g v ư ơ n g
n g u y ê n n h â n	n g u y ê n n h â n
k h ủ n g h o ả n g	k h ủ n g h o ả n g
n h ư ờ n g n h ị n	n h ư ờ n g n h ị n
c ô n g t h ư ơ n g	c ô n g t h ư ơ n g
c h ố n g c h ế n h	c h ố n g c h ế n h
t r á n g m i ệ n g	t r á n g m i ệ n g
h o a n h à i c ắ m b ã i c ứ t t r â u	h o a n h à i c ắ m b ã i c ứ t r
c o n t r â u l à đ ầ u c ơ n g h i ệ p	c o n t r â u l à đ ầ u k i ệ p
đ ả n g c ộ n g s ả n v i ệ t n a m	đ ả n g c ộ n g s ả n v i ệ t n
c h i ế n t r a n h t h ế g i ớ i t h ứ n h ấ t	c h i ế n t r a n h t h ế g i ớ i t h ấ t
t r ư ờ n g t r u n g h ọ c p h ổ t h ô n g	t r ư ờ n g t r u n g h ọ c p h ô n g
t r á n h v ỏ d ư a g ặ p v ỏ d ừ a	t r á n h v ỏ d ư a g ặ p v ỏ d ừ a
n a m n ữ t h ụ t h ụ b ấ t t h â n	n a m n ữ t h ụ t h ụ b ấ t
t r â u b u ộ c g h é t t r â u ă n	c h â u b u ộ c g h é t r â u ă n
c h ắ c n h ư đ i n h đ ó n g c ộ t	c h ắ c n h ư đ i n h đ ó n g c ộ t
đ i ệ n t h o ạ i d i đ ộ n g	đ i ệ n t h o ạ i d i đ ộ n g
t h a n h t h i ê n b ạ c h n h ậ t	t h a n h t h i ê n b ạ c h
đ ặ c đ i ể m n ổ i b ậ t	đ ặ c đ i ể m n ổ i b ậ t
n a m m ô a d i đ à p h ậ t	n a m m ô a d i đ à p h ậ t
m ộ t c ô n g đ ô i c h u y ệ n	m ộ t c ô n g đ ô i c h u y ệ n
n g o ả n h đ i n g o ả n h l ạ i	n g o ả n h đ i n g o ả n h l ạ i
đ ư ợ c v o i đ ò i t i ê n	đ ư ợ c v o i đ ò i t i ê n
đ i ệ n t o á n đ á m m â y	đ i ệ n t o á n đ á m m â y
p h o n g t ụ c t ậ p q u á n	p h o n g t ụ c t ậ p q u á n
đ ư ờ n g đ i n ư ớ c b ư ớ c	đ ư ờ n g đ i n ư ớ c b ư ớ c
b ệ n h t a y c h â n m i ệ n g	b ệ n h t a y c h â n m i ệ n g
v ô h ữ u b ấ t n h ư k ỉ g i ả	v ô h ữ u b ấ t n h ư k ỉ g i ả
c h â n n a m đ á c h â n x i ê u	c h â n n a m đ á c h â n s u y ê u
d i ệ n t í c h x u n g q u a n h	d i ệ n t í c h x u n g q u a n h
b ộ i s ố c h u n g n h ỏ n h ấ t	b ộ i s ố c h u n g n h ỏ n h ấ t
n g ọ c h o à n g t h ư ợ n g đ ế	n g ọ c h o à n g t h ư ợ n g đ ế
ư ớ c s ố c h u n g l ớ n n h ấ t	ư ớ c s ố c h u n g l ớ n n h ấ t
đ ư ờ n g t r ò n n g o ạ i t i ế p	đ ư ờ n g t r ò n n g o ạ i t i ế p
c h â n n a m đ á c h â n c h i ê u	c h â n n a m đ á c h â n c h i ê u
p h ư ơ n g t i ệ n g i a o t h ô n g	p h ư ơ n g t i ệ n g i a o t h ô n g
t ế b à o q u a n g đ i ệ n	t ế b à o q u a n g đ i ệ n
n g ộ đ ộ c t h ự c p h ẩ m	n g ộ đ ộ c t h ự c p h ẩ m
k h o a h ọ c ứ n g d ụ n g	k h o a h ọ c ứ n g d ụ n g
m ú a r ì u q u a m ắ t t h ợ	m ú a r ì u q u a m ắ t t h ợ
a n t o à n l à t r ê n h ế t	a n t o à n l à t r ê n h ế t
l ụ c c u n g t h á n h m ẫ u	l ụ c c u n g t h á n h m ẫ u
t h i ê n b i ế n v ạ n h o á	t h i ê n b i ế n v ạ n h o á
r ồ n g b a y p h ụ n g m ú a	r ồ n g b a y p h ụ n g m ú a
k h a i t h i ê n l ậ p đ ị a	k h a i t h i ê n l ậ p đ ị a
n h ư n ư ớ c đ ổ l á k h o a i	n h ư n ư ớ c đ ổ l á k h o a i
t h a o t h a o b ấ t t u y ệ t	t h a o t h a o b ấ t u y ệ t
l ễ c á c đ ẳ n g l i n h h ồ n	l ễ c á c đ ẳ n g l i n h h ồ n
h ộ i n g h ị t h ư ợ n g đ ỉ n h	h ộ i n g h ị t h ư ợ n g đ ỉ n h
t h i ê n h ư ớ n g t ì n h d ụ c	t h i ê n h ư ớ n g t ì n h d ụ c
k i ế n t r ú c t h ư ợ n g t ầ n g	k i ế n t r ú c t h ư ợ n g t ầ n g
g i á o d ụ c q u ố c p h ò n g	g i á o d ụ c q u ố c p h ò n g
n g h i ê n g n ư ớ c n g h i ê n g t h à n h	n g h i ê n g n ư ớ c n g h i ê n h
t h i ê n t h ầ n h ộ m ệ n h	t h i ê n t h ầ n h ộ m ệ n h
v â n v â n v à m â y m â y	v â n v â n v à m â y m â y
đ ầ u t r â u m ặ t n g ự a	đ ầ u t r â u m ặ t n g ự a
n g ũ đ ạ i t h ậ p q u ố c	n g ũ đ ạ i t h ậ p q u ố c
t ổ n g l ã n h s ự q u á n	t ổ n g l ã n h s ự q u á n
m ộ t s ớ m m ộ t c h i ề u	m ộ t s ớ m m ộ t c h i ề u
c h u y ể n đ ộ n g h ọ c	c h u y ể n đ ộ n g h ọ c
c ổ n h â n l o ạ i h ọ c	c ổ n h â n l o ạ i h ọ c
t h ể d ụ c d ụ n g c ụ	t h ể d ụ c d ụ n g c ụ
t ự b i ê n t ự d i ễ n	t ự b i ê n t ự d i ễ n
đ è n x a n h đ è n đ ỏ	đ è n x a n h đ è n đ ỏ
đ à n ô n g đ à n a n g	đ à n ô n g đ à n a n g
ú m b a l a x ì b ù a	ú m b a l a x ì b ù a
t h p t	t r u n g h ọ c p h ổ t h ô n g
a n k h a n g t h ị n h v ư ợ n g	a n k h a n g t h ị n h v ậ n g
t h u ầ n p h o n g m ĩ t ụ c	t h u ầ n p h o n g m ĩ t ụ c
n h â n đ ị n h t h ắ n g t h i ê n	n h â n đ ị n h t h ắ n g t h i ê n
v ô t u y ế n t r u y ề n h ì n h	v ô t u y ế n t r u y ề n h ì n h
t h ể d ụ c n g h ệ t h u ậ t	t h ể d ụ c n g h ệ t h u ậ t
t i ế n t h o á i l ư ỡ n g n a n	t i ế n t h o á i l ư ỡ n g n a n
t u y ệ t s ắ c g i a i n h â n	t u y ệ t s ắ c g i a i n h â n
d i ệ n t í c h t o à n p h ầ n	d i ệ n t í c h t o à n p h ầ n
p h ẫ u t h u ậ t t ạ o h ì n h	p h ẫ u t h u ậ t t ạ o h ì n h
b à n c h ả i đ á n h r ă n g	b à n c h ả i đ á n h r ă n g
c ô n g n g h ệ s i n h h ọ c	c ô n g n g h ệ s i n h h ọ c
n g ự a q u e n đ ư ờ n g c ũ	n g ự a q u e n đ ư ờ n g c ũ
l a o đ ộ n g p h ổ t h ô n g	l a o đ ộ n g p h ổ t h ô n g
t h i ê n h ậ u t h á n h m ẫ u	t h i ê n h ậ u t h á n h m ẫ u
b ớ i l ô n g t ì m v ế t	b ớ i l ô n g t ì m v ế t
đ i ệ n t h o ạ i v i ê n	đ i ệ n t h o ạ i v ậ n
đ ề n ơ n đ á p n g h ĩ a	đ ề n ơ n đ á p n g h ĩ a
đ ồ n g h ồ q u ả q u ý t	đ ồ n g h ồ q u ả q u ý t
c o n đ ư ờ n g t ơ l ụ a	c o n đ ư ờ n g t ơ l ụ a
t ư l i ệ u s ả n x u ấ t	t ư l i ệ u s ả n x u ấ t
q u â n c h ủ l ậ p h i ế n	q u â n c h ủ l ậ p h i ế n
g ư ơ n g v ỡ l ạ i l à n h	g ư ơ n g v ỡ l ạ i l à n h
l i ê n b a n g x ô v i ế t	l i ê n b a n g x ô v i ế t
c o n l ạ c c h á u h ồ n g	c o n l ạ c h á u h ồ n g
k i m l o ạ i k i ề m t h ổ	k i m l o ạ i k i ề m t h ổ
t h e o d õ i l i ê n l ạ c	t h e o d õ i l i ê n l ạ c
n h ậ p g i a t u ỳ t ụ c	n h ậ p g i a t u ỳ t ụ c
c h ấ t đ ộ c d a c a m	c h ấ t đ ộ c d a c a m
v i s i n h v ậ t h ọ c	v i s i n h v ậ t h ọ c
h i ệ n t ư ợ n g h ọ c	h i ệ n t ư ợ n g h ọ c
v ạ n v ậ t h ấ p d ẫ n	v ạ n v ậ t h ấ p d ẫ n
n u ô i o n g t a y á o	n u ô i o n g t a y á o
t a m t h ậ p l ụ c k ế	t a m t h ậ p l ụ c k ế
s ó i đ ộ i l ố t c ừ u	s ó i đ ộ i l ố t c ừ u
v ậ t l ý h ó a h ọ c	v ậ t l í h o á h ọ c
đ ộ n g l ự c h ọ c	đ ộ n g l ự c h ọ c
t p h c m	t h à n h p h ố h ồ c h i n h
t ô i l à n g ư ờ i v i ệ t	t ô i l à n g ư ờ i v i ệ t
ă n k e m t r ư ớ c c ổ n g	ă n k e m t r ư ớ c c ổ n g
m i n h t i n h m à n b ạ c	m i n h t i n h m à n b ạ c
t h á i t r ư ở n g c ô n g c h ú a	t h á i t r ư ở n g c ô n g c h ú a
t h i ê n t h ặ n g c h i q u ố c	t h i ê n t h ặ n g c h i ế
c h ú c c ả n h à n g ủ n g o n	c h ú c c ả n h à n g ủ n g o n
r ừ n g n h o b i ể n t h á n h	r ừ n g n h o b i ể n t h á n h
t ư ơ n g t h â n t ư ơ n g á i	t ư ơ n g t h â n t ư ơ n g á i
v i ê m k h ớ p d ạ n g t h ấ p	v i ê m k h ớ p d ạ n g t h ấ p
t a m q u ố c d i ễ n n g h ĩ a	t a m q u ố c d i ễ n g h ĩ a
đ a n g h i n h ư t à o t h á o	đ a n g h i n h ư t à o t h á o
t h á i h o à n g t h á i h ậ u	t h á i h o à n g t h á i h ậ u
c h ú c m ừ n g s i n h n h ậ t	c h ú c m ừ n g s i n h n h ậ t
h à n g k h ô n g m ẫ u h ạ m	h à n g k h ô n g m ẫ u h ạ m
b á c h k h o a t o à n t h ư	b á c h k h o a t o à n t h ư
c ộ n g h o à t r u n g p h i	c ộ n g h o à t r u n g p h i
â m t h ị n h d ư ơ n g s u y	â m t h ị n h d ư ơ n g s u y
m à n t r ờ i c h i ế u đ ấ t	m à n t r ờ i c h i ế u đ ấ t
t r u n g h o a d â n q u ố c	t r u n g h o a d â n q u ố c
n h ấ t c ử l ư ỡ n g t i ệ n	n h ấ t c ử l ư ỡ n g t i ệ n
k h o a h ọ c t h ầ n k i n h	k h o a h ọ c t h ầ n k i n h
t ẩ u v i t h ư ợ n g s á c h	t ẩ u v i t h ư ợ n g s á c h
c à n g đ ô n g c à n g v u i	c à n g đ ô n g c à n g v u i
g i á o h ộ i c ô n g g i á o	g i á o h ộ i c ô n g g g i á o
m á y b a y t r ự c t h ă n g	m á y b a y t r ự c t h ă n g
e o b i ể n m a n c h e	e o b i ể n m a n g s ơ
t o à n t â m t o à n ý	t o à n t â m t o à n ý
c h ế đ ộ ă n k i ê n g	c h ế đ ộ ă n k i ê n g
s â n b a y q u ố c t ế	s â n b a y q u ố c t ế
b ạ c h h u y ế t c ầ u	b ạ c h h u y ế t c ầ u
c a o c h ạ y x a b a y	c a o c h ạ y x a b a y
c o n g á i c o n đ ứ a	c o n g á i c o n đ ứ a
n ư ớ c c h ả y đ á m ò n	n ư ớ c c h ả y đ á m ò n
h ữ u d a n h v ô t h ự c	h ữ u d a n h v ô t h ự c
r ồ n g đ ế n n h à t ô m	r ồ n g đ ế n n h à t ô m
l ụ c p h ủ n g ũ t ạ n g	l ụ c p h ủ n g ũ t ạ n g
l ờ i o n g t i ế n g v e	l ờ i o n g t i ế n g v e
c ổ s i n h t h á i h ọ c	c ổ s i n h t h á i h ọ c
t r ư ờ n g đ ạ i h ọ c	t r ư ờ n g đ ạ i h ọ c
k h o a h ọ c v ũ t r ụ	k h o a h ọ c v ũ t r ụ
c ổ k h í h ậ u h ọ c	c ổ k h í h ậ u h ọ c
b a h ồ n b ả y v í a	b a h ồ n b ả y v í a
đ e m c o n b ỏ c h ợ	đ e m c o n b ỏ c h ợ
c á c ó c t a m đ ả o	c á c ó c t a m đ ả o
s i n h b ệ n h h ọ c	s i n h b ệ n h h ọ c
b ắ c c a r o l i n a	b ắ c c a r o l i n a
v ò đ ầ u b ứ t t a i	v ò đ ầ u b ứ t t a i
đ à i q u y ề n đ ạ o	đ à i q u y ề n đ ạ o
a x i t s u n f u r ơ	a x i t s u n f u r ơ
n g ọ c l ụ c b ả o	n g ọ c l ụ c b ả o
đ ị a d a n h h ọ c	đ ị a d a n h h ọ c
b ô n i f a c i ô	b ô n i f a c i ô
v i t r ù n g c o r o n a	v i t r ù n g c o r o n a
v ă n v õ s o n g t o à n	v ă n v õ s o n g t o à n
c h ủ n g h ĩ a v ô c h í n h p h ủ	c h ủ n g h ĩ a v ô c h í n h p h ủ
t r ă m t r ậ n t r ă m t h ắ n g	t r ă m t r ậ n t r ă m t h ắ n g
n g u y ê n t h ủ q u ố c g i a	n g u y ê n t h ủ q u ố c g i a
k h o ả n g c á c h x ã g i a o	k h o ả n g c á c h x ã g i a o
c ộ n g s ả n c h ủ n g h ĩ a	c ộ n g s ả n c h ủ n g h ĩ a
ă n m i ế n g t r ả m i ế n g	ă n m i ế n g t r ả m i ế n g
l i ê n m i n h c h â u â u	l i ê n m i n h c h â u â u
l à m t r â u l à m n g ự a	l à m t r â u l à m n g ự a
đ ư ờ n g h ô h ấ p t r ê n	đ ư ờ n g h ô h ấ p t r ê n
h i ệ u ứ n g n h à k í n h	h i ệ u ứ n g n h à k í n h
h ì n h h ộ p c h ữ n h ậ t	h ì n h h ộ p c h ữ n h ậ t
c h ú c a n h n g ủ n g o n	c h ú c a n h n g ủ n g o n
c h ú c m ừ n g n ă m m ớ i	c h ú c m ừ n g n ă m m ớ i
c h ủ n g h ĩ a d â n t ộ c	c h ủ n g h ĩ a d â n t ộ c
n g h ì n l ẻ m ộ t đ ê m	n g h ì n l ẻ m ộ t đ ê m
q u y t ắ c t a m s u ấ t	q u y t ắ c t a m s u ấ t
c ộ n g h o à n a m p h i	c ộ n g h o à n a m p h i
h ổ p h ụ s i n h h ổ t ử	h ổ p h ụ s i n h h ổ t ử
c h è s â m b ổ l ư ợ n g	c h è s â m b ổ l ư ợ n g
r ồ n g r ắ n l ê n m â y	r ồ n g r ắ n l ê n m â y
t u y ế n t i ề n l i ệ t	t u y ế n t i ề n l i ệ t
g à t r ố n g n u ô i c o n	g à t r ố n g n u ô i c o n
t h ù n g r ỗ n g k ê u t o	t h ù n g r ỗ n g k ê u t o
c á i g a i t r o n g m ắ t	c á i g a i t r o n g m ắ t
t h à n h p h ố m é x i c o	t h à n h p h ố m i c ô
h à n h l a n g p h á p l í	h à n h l a n g p h á p l í
c h ủ n g h ĩ a x é t l ạ i	c h ủ n g h ĩ a x é t l ạ i
s i n h n h ậ t v u i v ẻ	s i n h n h ậ t v u i v ẻ
h ì n h b á n n g u y ệ t	h ì n h b á n n g u y ệ t
t h ể d ụ c t h ể t h a o	t h ể d ụ c t h ể t h a o
c h ú c e m n g ủ n g o n	c h ú c e m n g ủ n g o n
đ ạ i k h ủ n g h o ả n g	đ ạ i k h ủ n g h o ả n g
v ị n h x u â n q u y ề n	v ị n h x u â n q u y ề n
l i ê n đ ộ i t r ư ở n g	l i ê n đ ộ i t r ư ở n g
l ò n g l a n g d ạ t h ú	l ò n g l a n g d ạ t h ú
t h à n h c á t t ư h ã n	t h à n h c á t t ư h ã n
h o a h ậ u t h ế g i ớ i	h o a h ậ u t h ế g i ớ i
đ i ề u d ư ỡ n g v i ê n	đ i ề u d ư ỡ n g v i ê n
đ ệ n h ấ t p h u n h â n	đ ệ n h ấ t p h u n h â n
c o n ô n g c h á u c h a	c o n ô n g c h á u c h a
c h â m d ầ u v à o l ử a	c h â m d ầ u v à o l ử a
n g à y x ử a n g à y x ư a	n g à y x ử a n g à y x ư a
t h ư ợ n g n g h ị v i ệ n	t h ư ợ n g n g h ị v i ệ n
c ơ q u a n c h ứ c n ă n g	c ơ q u a n t r ứ c n ă n g
q u â n t ì n h n g u y ệ n	q u â n t ì n h n g u y ệ n
t r ư ờ n g t r u n g h ọ c	t r ư ờ n g t r u n g h ọ c
n g à y l ễ c á c t h á n h	n g à y l ễ c á c t h á n h
t ù n h â n l ư ơ n g t â m	t ù n h â n l ư ơ n g t â m
c h i ế n t r a n h l ạ n h	c h i ế n t r a n h l ạ n h
n g ư ờ i k h u y ế t t ậ t	n g ư ờ i k h u y ế t t ậ t
l ê n v o i x u ố n g c h ó	l ê n v o i x u ố n g c h ó
m ạ n h t h ư ờ n g q u â n	m ạ n h t h ư ờ n g q u â n
đ ế q u ố c c h ủ n g h ĩ a	đ ế q u ố c c h ủ n g h ĩ a
c h ả y m á u c h ấ t x á m	c h ả y m á u c h ấ t x á m
n g à y s i n h t h á n g đ ẻ	n g à y s i n h t h á n g đ ẻ
c h ủ n g h ĩ a k h ủ n g b ố	c h ủ n g h ĩ a k h ủ n b ố
đ ổ i c h ủ d ị c h n ô	đ ổ i c h ủ d ị c h n ô
c ô n g t i d u l ị c h	c ô n g t i d u l ị c h
t c n	c h ư ớ c c ô n g n g u y ê n
ú c đ ạ i l ợ i	ú c đ ạ i l ợ i
v ạ n v ậ t h ọ c	v ạ n v ậ t h ọ c
b a t ô l ô m ê ô	b a t ô l ô m ê ô
đ i ệ n t ừ h ọ c	đ i ệ n t ừ h ọ c
p o l y e t y l e n	p o l y e t y l e n
b ậ t đ è n x a n h	b ậ t đ è n x a n h
v ạ n d i ệ p t ậ p	v ạ n d i ệ p t ậ p
t h ề m l ụ c đ ị a	t h ề m l ụ c đ ị a
h o á h ọ c v ô c ơ	h o á h ọ c v ô c ơ
b i ể n h o a đ ô n g	b i ể n h o a đ ô n g
t ổ n g b i ê n t ậ p	t ổ n g b i ê n t ậ p
b ắ t c á h a i t a y	b ắ t c á h a i t a y
đ ạ i c ô n g q u ố c	đ ạ i c ô n g q u ố c
c o n s t a n t i n ô	c o n s t a n t i n ô
c h ấ t d i ệ p l ụ c	c h ấ t d i ệ p l ụ c
h i ệ u đ i ệ n t h ế	h i ệ u đ i ệ n t h ế
n g ũ v ị t ô n q u a n	n g ũ v ị t ô n q u a n
d ở d ở ư ơ n g ư ơ n g	d ở d ở ư ơ n g ư ơ n g
l i ê n h i ệ p q u ố c	l i ê n h i ệ p q u ố c
n ư ớ c m ắ t c á s ấ u	n ư ớ c m ắ t c á s ấ u
m a n g c o n b ỏ c h ợ	m a n g c o n b ỏ c h ợ
v â n v â n m â y m â y	v â n v â n m â y m â y
m i ễ n d ị c h h ọ c	m i ễ n d ị c h h ọ c
b á n h d ẻ o l ạ n h	b á n h d ẻ o l ạ n h
b á t c ự c q u y ề n	b á t c ự c q u y ề n
t o g a n l ớ n m ậ t	t o g a n l ớ n m ậ t
b i ê n t ậ p v i ê n	b i ê n t ậ p v i ê n
s ố đ i ệ n t h o ạ i	s ố đ i ệ n t h o ạ i
l ụ c h u y ề n c ầ m	l ụ c h u y ề n c ầ m
d i t r u y ề n h ọ c	d i t r u y ề n h ọ c
b ộ c h ế h o à k h í	b ộ c h ế h o à k h í
đ ị a t r u n g h ả i	đ ị a t r u n g h ả i
t h ậ p l ụ c p h â n	t h ậ p l ụ c p h â n
b a o d ư ơ n g v ậ t	b a o d ư ơ n g v ậ t
v ù n g d ư ớ i đ ồ i	v ù n g d ư ớ i đ ồ i
c ộ n g s ả n đ ả n g	c ộ n g s ả n đ ả n g
r ồ n g k o m o d o	r ồ n g c o m o đ ô
h ạ t đ i ề u m à u	h ạ t đ i ề u m à u
b ệ n h s ố t r é t	b ệ n h s ố t r é t
b á n h b á t r ạ n g	b á n h b á t r ạ n g
q u a n g h o á h ọ c	q u a n g h o á h ọ c
s ở h ữ u t r í t u ệ	s ở h ữ u t r í t u ệ
l ạ c l o n g q u â n	l ạ c l o n g q u â n
đ ặ c p h á i v i ê n	đ ặ c p h á i v i ê n
á i t â n g i á c l a	á i t â n g i á c l a
l ú m đ ồ n g t i ề n	l ú m đ ồ n g t i ề n
x ư a l ắ c x ư a l ơ	x ư a l ắ c x ư a l ơ
k i ể m k ê d â n s ố	k i ể m k ê d â n s ố
l u ậ n l í h ọ c	l u ậ n l í h ọ c
k h í t ư ợ n g h ọ c	k h í t ư ợ n g h ọ c
b ê n ê đ i c t ô	b ê n ê đ i c t ô
c s d l	c ơ s ở d ữ l i ệ u
đ ạ i s ố h ọ c	đ ạ i s ố h ọ c
a l e x a n đ ê	a l e x a n đ ê
â m n h ạ c h ọ c	â m n h ạ c h ọ c
t ự đ ộ n g h o á	t ự đ ộ n g h o á
h ộ t v ị t l ộ n	h ộ t v ị t l ộ n
d ư ợ c l í h ọ c	d ư ợ c l í h ọ c
đ ạ o c a o đ à i	đ ạ o c a o đ à i
đ à o l ộ n h ộ t	đ à o l ộ n h ộ t
l ự u đ ạ n c a y	l ự u đ ạ n c a y
c ẩ n t ắ c v ô ư u	c ẩ n t ắ c v ô ư u
s i n h v ậ t h ọ c	s i n h v ậ t h ọ c
b à n m ô n đ i ế m	b à n m ô n đ i ế m
n g ữ d ụ n g h ọ c	n g ữ d ụ n g h ọ c
v i ệ t n g ữ h ọ c	v i ệ t n g ữ h ọ c
b á c v ậ t q u á n	b á c v ậ t q u á n
g ó c đ ố i đ ỉ n h	g ó c đ ố i đ ỉ n h
đ ạ o đ ứ c k i n h	đ ạ o đ ứ c k i n h
c á m è m ộ t l ứ a	c á m è m ộ t l ứ a
d a b ọ c x ư ơ n g	d a b ọ c x ư ơ n g
x ã h ộ i c h ủ n g h ĩ a	x ã h ộ i c h ủ n g h ĩ a
s ố t x u ấ t h u y ế t	s ố t x u ấ t h u y ế t
đ ạ i t r ư ợ n g p h u	đ ạ i t r ư ợ n g p h u
t ế t n g u y ê n đ á n	t ế t n g u y ê n đ á n
t i ế n g m ễ t â y c ơ	t i ế n g m ễ t â y c ơ
v ô c ô n g r ồ i n g h ề	v ô c ô n g r ồ i n g h ề
c h ủ n g h ĩ a x ã h ộ i	c h ủ n g h ĩ a x ã h ộ i
đ á n h t r ố n g l ả n g	đ á n h t r ố n g l ả n g
n g ư ờ i đ ồ n g t í n h	n g ư ờ i đ ồ n g t í n h
k h ô n g q u ố c t ị c h	k h ô n g q u ố c t ị c h
c ả n h s á t b i ể n	c ả n h s á t b i ể n
s i ê u a n h h ù n g	s i ê u a n h h ù n g
n ư ớ c c ư ờ n g t o a n	n ư ớ c c ư ờ n g t o a n
c ô n g n g h i ệ p h o á	c ô n g n g h i ệ p h o á
c ô n g b i n h x ư ở n g	c ô n g b i n h x ư ở n g
s ó c t h i ê n v ư ơ n g	s ó c t h i ê n v ư ơ n g
t i ể u v ư ơ n g q u ố c	t i ể u v ư ơ n g q u ố c
n g à y l ễ t ì n h n h â n	n g à y l ễ t ì n h n h â n
g i á n g s i n h v u i v ẻ	g i á n g s i n h v u i v ẻ
c h ủ n g h ĩ a q u ố c x ã	c h ủ n g h ĩ a q u ố c x ã
c h ủ n g h ĩ a p h á t x í t	c h ủ n g h ĩ a p h á t x í t
n g ư ờ i v i ệ t n a m	n g ư ờ i v i ệ t n a m
v i ê m r u ộ t t h ừ a	v i ê m r u ộ t t h ừ a
h ợ p c h ú n g q u ố c	h ợ p c h ú n g q u ố c
n h â n c h ủ n g h ọ c	n h â n c h ủ n g h ọ c
đ ư ờ n g t i ê u h o á	đ ư ờ n g t i ê u h o á
h ợ p c h ủ n g q u ố c	h ợ p c h ủ n g q u ố c
b ắ c t r i ề u t i ê n	b ắ c t r i ề u t i ê n
b á n h s i n h n h ậ t	b á n h s i n h n h ậ t
n a m t h a n h n ữ t ú	n a m t h a n h n ữ t ú
đ á i t h á o đ ư ờ n g	đ á i t h á o đ ư ờ n g
b ú n t h ị t n ư ớ n g	b ú n t h ị t n ư ớ n g
t h ế k ỉ á n h s á n g	t h ế k ỉ á n h s á n g
t a m v ị n h ấ t t h ể	t a m v ị n h ấ t t h ể
t r ạ i t ậ p t r u n g	t r ạ i t ậ p t r u n g
c h i ê m t i n h h ọ c	c h i ê m t i n h h ọ c
t h á i c ự c q u y ề n	t h á i c ự c q u y ề n
t r ư n g c ầ u d â n ý	t r ư n g c ầ u d â n ý
đ ạ o t h i ê n c h ú a	đ ạ o t h i ê n c h ú a
c ự u c h i ế n b i n h	c ự u c h i ế n b i n h
c h â u đ ạ i d ư ơ n g	c h â u đ ạ i d ư ơ n g
t h u ỷ v ă n h ọ c	t h u ỷ v ă n h ọ c
v ù n g n h ớ đ ệ m	v ù n g n h ớ đ ệ m
n g u y ễ n t h ị b	n g u y ễ n t h ị b
t ế t đ o a n n g ọ	t ế t đ o a n n g ọ
h ạ n g h ị v i ệ n	h ạ n g h ị v i ệ n
n a m t ô n n ữ t i	n a m t ô n n ữ t i
t ì n h m ộ t đ ê m	t ì n h m ộ t đ ê m
k h u t r ụ c h ạ m	k h u t r ụ c h ạ m
đ ạ i g i a đ ì n h	đ ạ i g i a đ ì n h
s â m b ổ l ư ợ n g	x â m b ổ l ư ợ n g
b ế n x e b u ý t	b ế n x e b u ý t
b á n h d a l ợ n	b á n h d a l ợ n
h à n l â m v i ệ n	h à n l â m v i ệ n
đ ứ c p h ậ t m ẫ u	đ ứ c p h ậ t m ẫ u
ô n c ố t r i t â n	ô n c ố t r i t â n
v i k h u ẩ n h ọ c	v i k h u ẩ n h ọ c
b ọ c á n h c ứ n g	b ọ c á n h c ứ n g
c á đ i ê u h ồ n g	c á đ i ê u h ồ n g
l u ậ t q u ố c t ế	l u ậ t q u ố c t ế
n g ư ờ i l ạ m ặ t	n g ư ờ i l ạ m ặ t
p h ả n a n h h ù n g	p h ả n a n h h ù n g
t h ằ n l ằ n b ó n g	t h ằ n l ằ n b ó n g
t g p	t ổ n g d á o p h ậ n
h o à n g h ạ c l â u	h o à n g h ạ c l â u
d ị c h t ễ h ọ c	d ị c h t ễ h ọ c
h ệ t o ạ đ ộ	h ệ t o ạ đ ộ
b ộ c b ạ c h	b ộ c b ạ c h
ê u g ê n i ô	ê u g ê n i ô
h ỉ n ộ á i ố	h ỉ n ộ á i ố
a n h y ê u e m	a n h y ê u e m
b ô l ô b a l a	b ô l ô b a l a
e m y ê u a n h	e m y ê u a n h
c â u l ạ c b ộ	c â u l ạ c b ộ
đ i ệ n đ ộ n g	đ i ệ n đ ộ n g
t ế b à o h ọ c	t ế b à o h ọ c
t ử v o n g h ọ c	t ử v o n g h ọ c
a n h c á t l ợ i	a n h c á t l ợ i
đ ạ i s ứ q u á n	đ ạ i s ứ q u á n
t r ợ đ ộ n g t ừ	t r ợ đ ộ n g t ừ
c ă n b ậ c h a i	c ă n b ậ c h a i
l u â n l í h ọ c	l u â n l í h ọ c
đ ạ o h o à h ả o	đ ạ o h o à h ả o
b á n h g ậ t g ù	b á n h g ậ t g ù
o n g b ắ p c à y	o n g b ắ p c à y
đ a i a n t o à n	đ a i a n t o à n
m e n đ e l e v i	m e n đ e l e v i
b ắ c b á n c ầ u	b ắ c b á n c ầ u
v i ê m x ư ơ n g k h ớ p	v i ê m x ư ơ n g k h ớ p
l ậ p t r ì n h v i ê n	l ậ p t r ì n h v i ê n
p h á p l u â n c ô n g	p h á p l u â n c ô n g
t h i ế t g i á p h ạ m	t h i ế t g i á p h ạ m
t à u t u ầ n d ư ơ n g	t à u t u ầ n d ư ơ n g
c h i ế n l ợ i p h ẩ m	c h i ế n l ợ i p h ẩ m
k i m n h ậ t t h à n h	k i m n h ậ t t h à n h
g à c ô n g n g h i ệ p	g à c ô n g n g h i ệ p
t r u n g q u ố c h o á	t r u n g q u ố c h o á
t ổ n g g i á o p h ậ n	t ổ n g d á o p h ậ n
g i á t r ị n h ỏ n h ấ t	g i á t r ị n h ỏ n h ấ t
p h ổ t h ô n g t h o ạ i	p h ổ t h ô n g t h o ạ i
s ô n g c ử u l o n g	x ô n g c ử u l o n g
h ì n h l ậ p p h ư ơ n g	h ì n h l ậ p p h ư ơ n g
d i ê m v ư ơ n g t i n h	d i ê m v ư ơ n g t i n h
t r ư ờ n g m ĩ t h u ậ t	t r ư ờ n g m ĩ t h u ậ t
t r ồ n g c â y c h u ố i	t r ồ n g c â y c h u ố i
m ô i t r ư ờ n g s ố n g	m ô i t r ư ờ n g s ố n g
t i ể u t h u y ế t g i a	t i ể u t h u y ế t g i a
l i n h d ư ơ n g h o ẵ n g	l i n h d ư ơ n g h o ẵ n g
t h i ê n v ư ơ n g t i n h	t h i ê n v ư ơ n g t i n h
l í n h p h ò n g k h ô n g	l í n h p h ò n g k h ô n g
t r ư ở n g c ô n g c h ú a	c h ư ở n g c ô n g c h ú a
c h u y ệ n c ổ t í c h	c h u y ệ n c ổ t í c h
m à y t a o c h i t ớ	m à y t a o c h i t ớ
v ư ờ n b á c h t h ú	v ư ờ n b á c h t h ú
t h ầ n k i n h h ọ c	t h ầ n k i n h h ọ c
c h i m c á n h c ụ t	c h i m c á n h c ụ t
h ì n h t h á i h ọ c	h ì n h t h á i h ọ c
c h ấ t b ả o q u ả n	c h ấ t b ả o q u ả n
k e m đ á n h r ă n g	k e m đ á n h r ă n g
r ừ n g n g ậ p m ặ n	r ừ n g n g ậ p m ặ n
b ấ t đ ẳ n g t h ứ c	b ấ t đ ẳ n g t h ứ c
c u m i n g t o n i t	c ơ m i n g t o n i t
t à o t h á o r ư ợ t	t à o t h á o r ư ợ t
t r ứ n g v ị t l ộ n	c h ứ n g v ị t l ộ n
s i n h t h á i h ọ c	s i n h t h á i h ọ c
t i ề n s ả n g i ậ t	t i ề n s ả n g i ậ t
k i ể m s á t v i ê n	k i ể m s á t v i ê n
h o à n g t h á i h ậ u	h o à n g t h á i h ậ u
t ổ n g h à n h d i n h	t ổ n g h à n h d i n h
t h ờ i k h o á b i ể u	t h ờ i k h o á b i ể u
h ư ớ n g d ẫ n v i ê n	h ư ớ n g d ẫ n v i ê n
r ạ p c h i ế u p h i m	r ạ p c h i ế u p h i m
t i ể u h ồ i h ư ơ n g	t i ể u h ồ i h ư ơ n g
t i ể u h à n h t i n h	t i ể u h à n h t i n h
t i ế n g p h ổ t h ô n g	t i ế n g p h ổ t h ô n g
h ộ i đ ồ n g b ả o a n l i ê n h i ệ p q u ố c	h ộ i đ ồ n g b ả o a n l i ệ p q u ố c
c h x h c n v n	c ộ n g h o à x ã h ộ i c h ổ i
h ộ i c h ứ n g s u y g i ả m m i ễ n d ị c h m ắ c p h ả i	h ộ i c h ứ n g s u y g i ả m m i ễ n d ị c h m i ễ n d ị c p h ả i
c á i r ă n g c á i t ó c l à g ó c c o n n g ư ờ i	c á i r ă n g c á i t ó c l à g ư ờ i
k ẻ đ ắ p c h ă n b ô n g k ẻ l ạ n h l ù n g	k ẻ đ ắ p c h ă n b ô n g k ẻ l ạ n h l ù n g
c ó c ô n g m à i s ắ t c ó n g à y n ê n k i m	c ó c ô n g m à i s ắ t c ó n g à y n
p h i c ô n g t r ẻ l á i m á y b a y b à g i à	p h i c ô n g t r ẻ l á i m á y b à
c h ủ n g h ĩ a p h â n b i ệ t c h ủ n g t ộ c	c h ủ n g h ĩ a p h â n b i ệ t c h ủ n g t ộ c
c h ữ a l ợ n l à n h t h à n h l ợ n q u è	c h ữ a l ợ n l à n h t h à n h l ợ
đ ạ i đ ạ o t a m k ỳ p h ổ đ ộ	đ ạ i đ ạ o t a m k i p h ổ đ ộ
n ú i c a o c ò n c ó n ú i c a o h ơ n	n ú i c a o c ò n c ó n ú i c a o h ơ
c ộ n g h o à n h â n d â n t r u n g h o a	c ộ n g h o à n h â n d â n t r u n g h o a
c h ủ n g h ĩ a d u y v ậ t b i ệ n c h ứ n g	c h ủ n g h ĩ a d u y v ậ t b i ệ n g
đ ứ n g n ú i n à y t r ô n g n ú i n ọ	đ ứ n g n ú i n à y t r ô n g n ú i n ọ
đ ứ n g n ú i n à y t r ô n g n ú i k i a	đ ứ n g n ú i n à y t r ô n g n ú i a
t h ư ơ n g n g ư ờ i n h ư t h ể t h ư ơ n g t h â n	t h ư ơ n g n g ư ờ i n h ư t h ể t h â n
